date,county,fips,population,confirmed_cases,reported_cases,probable_cases,reported_and_probable_cases,reported_deaths
2022-09-20,Alameda,001,1643700,345345,345351,19609,364960,2012
2022-09-20,Alpine,003,1148,134,134,1,135,0
2022-09-20,Amador,005,37829,9953,9954,918,10872,90
2022-09-20,Butte,007,227075,39282,39282,8921,48203,453
2022-09-20,Calaveras,009,45235,8475,8475,523,8998,133
2022-09-20,Colusa,011,21464,3773,3775,1272,5047,22
2022-09-20,Contra Costa,013,1133247,248050,248053,20350,268403,1424
2022-09-20,Del Norte,015,27424,7402,7403,404,7807,57
2022-09-20,El Dorado,017,186661,32159,32159,4221,36380,231
2022-09-20,Fresno,019,978130,273379,273381,30482,303863,2850
2022-09-20,Glenn,021,27897,5494,5494,1859,7353,48
2022-09-20,Humboldt,023,135768,21638,21641,4928,26569,156
2022-09-20,Imperial,025,180216,65297,65297,15529,80826,957
2022-09-20,Inyo,027,18085,4481,4481,932,5413,59
2022-09-20,Kern,029,883053,218402,218413,59358,277771,2408
2022-09-20,Kings,031,150075,59286,59288,4057,63345,456
2022-09-20,Lake,033,64148,12731,12731,1160,13891,146
2022-09-20,Lassen,035,31185,9947,9947,983,10930,65
2022-09-20,Los Angeles,037,10098052,3263252,3263510,177672,3441182,33258
2022-09-20,Madera,039,155013,43908,43910,8185,52095,374
2022-09-20,Marin,041,260295,44819,44823,5259,50082,310
2022-09-20,Mariposa,043,17540,3074,3074,355,3429,31
2022-09-20,Mendocino,045,87422,15911,15911,4439,20350,136
2022-09-20,Merced,047,269075,71872,71875,11563,83438,862
2022-09-20,Modoc,049,8938,872,872,316,1188,11
2022-09-20,Mono,051,14174,3198,3198,246,3444,7
2022-09-20,Monterey,053,433212,93828,93829,20810,114639,766
2022-09-20,Napa,055,140530,32093,32094,1410,33504,160
2022-09-20,Nevada,057,99092,18856,18861,1810,20671,132
2022-09-20,Orange,059,3164182,664262,664263,60663,724926,7425
2022-09-20,Placer,061,380077,75381,75381,9319,84700,660
2022-09-20,Plumas,063,18699,3632,3632,431,4063,13
2022-09-20,Riverside,065,2383286,692981,693038,34930,727968,6610
2022-09-20,Sacramento,067,1510023,344744,344748,33304,378052,3282
2022-09-20,San Benito,069,59416,16112,16114,955,17069,106
2022-09-20,San Bernardino,071,2135413,667063,667124,30420,697544,8097
2022-09-20,San Diego,073,3302833,920118,920118,70637,990755,5487
2022-09-20,San Francisco,075,870044,176879,176887,11958,188845,1031
2022-09-20,San Joaquin,077,732212,196565,196573,14178,210751,2306
2022-09-20,San Luis Obispo,079,281455,62936,62950,7070,70020,522
2022-09-20,San Mateo,081,765935,167121,167123,10502,177625,736
2022-09-20,Santa Barbara,083,443738,105185,105185,6834,112019,720
2022-09-20,Santa Clara,085,1922200,429316,429334,18685,448019,2486
2022-09-20,Santa Cruz,087,273765,62704,62704,3398,66102,274
2022-09-20,Shasta,089,179085,34762,34762,7298,42060,592
2022-09-20,Sierra,091,2930,303,303,60,363,5
2022-09-20,Siskiyou,093,43540,5243,5243,3292,8535,90
2022-09-20,Solano,095,438530,104371,104383,7657,112040,463
2022-09-20,Sonoma,097,501317,106315,106322,5266,111588,519
2022-09-20,Stanislaus,099,539301,137321,137340,20915,158255,1752
2022-09-20,Sutter,101,95872,24193,24198,2463,26661,232
2022-09-20,Tehama,103,63373,13528,13528,3059,16587,210
2022-09-20,Trinity,105,12862,1390,1390,378,1768,20
2022-09-20,Tulare,107,460477,121445,121446,36013,157459,1530
2022-09-20,Tuolumne,109,53932,15468,15469,920,16389,196
2022-09-20,Ventura,111,848112,207681,207684,15365,223049,1566
2022-09-20,Yolo,113,214977,47147,47147,4341,51488,335
2022-09-20,Yuba,115,75493,18830,18834,1683,20517,129
2022-09-19,Alameda,001,1643700,345345,344045,19609,363654,2007
2022-09-19,Alpine,003,1148,134,134,1,135,0
2022-09-19,Amador,005,37829,9953,9908,918,10826,90
2022-09-19,Butte,007,227075,39282,39155,8921,48076,453
2022-09-19,Calaveras,009,45235,8475,8455,523,8978,133
2022-09-19,Colusa,011,21464,3773,3765,1272,5037,22
2022-09-19,Contra Costa,013,1133247,248050,247095,20350,267445,1423
2022-09-19,Del Norte,015,27424,7402,7381,404,7785,56
2022-09-19,El Dorado,017,186661,32159,32088,4221,36309,231
2022-09-19,Fresno,019,978130,273379,272774,30482,303256,2839
2022-09-19,Glenn,021,27897,5494,5481,1859,7340,48
2022-09-19,Humboldt,023,135768,21638,21561,4928,26489,155
2022-09-19,Imperial,025,180216,65297,65099,15529,80628,956
2022-09-19,Inyo,027,18085,4481,4472,932,5404,59
2022-09-19,Kern,029,883053,218402,217694,59358,277052,2405
2022-09-19,Kings,031,150075,59286,59122,4057,63179,456
2022-09-19,Lake,033,64148,12731,12696,1160,13856,144
2022-09-19,Lassen,035,31185,9947,9938,983,10921,65
2022-09-19,Los Angeles,037,10098052,3263252,3253906,177672,3431578,33160
2022-09-19,Madera,039,155013,43908,43782,8185,51967,373
2022-09-19,Marin,041,260295,44819,44702,5259,49961,309
2022-09-19,Mariposa,043,17540,3074,3064,355,3419,31
2022-09-19,Mendocino,045,87422,15911,15872,4439,20311,136
2022-09-19,Merced,047,269075,71872,71732,11563,83295,862
2022-09-19,Modoc,049,8938,872,872,316,1188,11
2022-09-19,Mono,051,14174,3198,3191,246,3437,7
2022-09-19,Monterey,053,433212,93828,93692,20810,114502,762
2022-09-19,Napa,055,140530,32093,31979,1410,33389,160
2022-09-19,Nevada,057,99092,18856,18824,1810,20634,132
2022-09-19,Orange,059,3164182,664262,662784,60663,723447,7398
2022-09-19,Placer,061,380077,75381,75159,9319,84478,660
2022-09-19,Plumas,063,18699,3632,3609,431,4040,13
2022-09-19,Riverside,065,2383286,692981,691630,34930,726560,6608
2022-09-19,Sacramento,067,1510023,344744,343926,33304,377230,3267
2022-09-19,San Benito,069,59416,16112,16057,955,17012,106
2022-09-19,San Bernardino,071,2135413,667063,664360,30420,694780,8074
2022-09-19,San Diego,073,3302833,920118,917229,70637,987866,5479
2022-09-19,San Francisco,075,870044,176879,176724,11958,188682,1025
2022-09-19,San Joaquin,077,732212,196565,196128,14178,210306,2304
2022-09-19,San Luis Obispo,079,281455,62936,62716,7070,69786,520
2022-09-19,San Mateo,081,765935,167121,166572,10502,177074,735
2022-09-19,Santa Barbara,083,443738,105185,104912,6834,111746,718
2022-09-19,Santa Clara,085,1922200,429316,428065,18685,446750,2473
2022-09-19,Santa Cruz,087,273765,62704,62480,3398,65878,274
2022-09-19,Shasta,089,179085,34762,34648,7298,41946,591
2022-09-19,Sierra,091,2930,303,303,60,363,5
2022-09-19,Siskiyou,093,43540,5243,5226,3292,8518,90
2022-09-19,Solano,095,438530,104371,104085,7657,111742,462
2022-09-19,Sonoma,097,501317,106315,106028,5266,111294,518
2022-09-19,Stanislaus,099,539301,137321,136981,20915,157896,1727
2022-09-19,Sutter,101,95872,24193,24119,2463,26582,232
2022-09-19,Tehama,103,63373,13528,13503,3059,16562,210
2022-09-19,Trinity,105,12862,1390,1385,378,1763,20
2022-09-19,Tulare,107,460477,121445,121230,36013,157243,1531
2022-09-19,Tuolumne,109,53932,15468,15411,920,16331,196
2022-09-19,Ventura,111,848112,207681,207049,15365,222414,1563
2022-09-19,Yolo,113,214977,47147,47085,4341,51426,334
2022-09-19,Yuba,115,75493,18830,18764,1683,20447,129
2022-09-18,Alameda,001,1643700,345272,344045,19609,363654,2007
2022-09-18,Alpine,003,1148,134,134,1,135,0
2022-09-18,Amador,005,37829,9953,9908,918,10826,90
2022-09-18,Butte,007,227075,39279,39155,8921,48076,453
2022-09-18,Calaveras,009,45235,8470,8455,523,8978,133
2022-09-18,Colusa,011,21464,3770,3765,1272,5037,22
2022-09-18,Contra Costa,013,1133247,248020,247095,20350,267445,1423
2022-09-18,Del Norte,015,27424,7401,7381,404,7785,56
2022-09-18,El Dorado,017,186661,32157,32088,4221,36309,231
2022-09-18,Fresno,019,978130,273354,272774,30482,303256,2839
2022-09-18,Glenn,021,27897,5492,5481,1859,7340,48
2022-09-18,Humboldt,023,135768,21637,21561,4928,26489,155
2022-09-18,Imperial,025,180216,65293,65099,15529,80628,956
2022-09-18,Inyo,027,18085,4480,4472,932,5404,59
2022-09-18,Kern,029,883053,218390,217694,59358,277052,2405
2022-09-18,Kings,031,150075,59281,59122,4057,63179,456
2022-09-18,Lake,033,64148,12730,12696,1160,13856,144
2022-09-18,Lassen,035,31185,9947,9938,983,10921,65
2022-09-18,Los Angeles,037,10098052,3263210,3253906,177672,3431578,33160
2022-09-18,Madera,039,155013,43908,43782,8185,51967,373
2022-09-18,Marin,041,260295,44811,44702,5259,49961,309
2022-09-18,Mariposa,043,17540,3074,3064,355,3419,31
2022-09-18,Mendocino,045,87422,15909,15872,4439,20311,136
2022-09-18,Merced,047,269075,71871,71732,11563,83295,862
2022-09-18,Modoc,049,8938,872,872,316,1188,11
2022-09-18,Mono,051,14174,3198,3191,246,3437,7
2022-09-18,Monterey,053,433212,93818,93692,20810,114502,762
2022-09-18,Napa,055,140530,32090,31979,1410,33389,160
2022-09-18,Nevada,057,99092,18853,18824,1810,20634,132
2022-09-18,Orange,059,3164182,664192,662784,60663,723447,7398
2022-09-18,Placer,061,380077,75371,75159,9319,84478,660
2022-09-18,Plumas,063,18699,3626,3609,431,4040,13
2022-09-18,Riverside,065,2383286,692934,691630,34930,726560,6608
2022-09-18,Sacramento,067,1510023,344710,343926,33304,377230,3267
2022-09-18,San Benito,069,59416,16108,16057,955,17012,106
2022-09-18,San Bernardino,071,2135413,667038,664360,30420,694780,8074
2022-09-18,San Diego,073,3302833,920030,917229,70637,987866,5479
2022-09-18,San Francisco,075,870044,176856,176724,11958,188682,1025
2022-09-18,San Joaquin,077,732212,196528,196128,14178,210306,2304
2022-09-18,San Luis Obispo,079,281455,62935,62716,7070,69786,520
2022-09-18,San Mateo,081,765935,167090,166572,10502,177074,735
2022-09-18,Santa Barbara,083,443738,105176,104912,6834,111746,718
2022-09-18,Santa Clara,085,1922200,429284,428065,18685,446750,2473
2022-09-18,Santa Cruz,087,273765,62703,62480,3398,65878,274
2022-09-18,Shasta,089,179085,34759,34648,7298,41946,591
2022-09-18,Sierra,091,2930,303,303,60,363,5
2022-09-18,Siskiyou,093,43540,5240,5226,3292,8518,90
2022-09-18,Solano,095,438530,104340,104085,7657,111742,462
2022-09-18,Sonoma,097,501317,106292,106028,5266,111294,518
2022-09-18,Stanislaus,099,539301,137303,136981,20915,157896,1727
2022-09-18,Sutter,101,95872,24184,24119,2463,26582,232
2022-09-18,Tehama,103,63373,13528,13503,3059,16562,210
2022-09-18,Trinity,105,12862,1390,1385,378,1763,20
2022-09-18,Tulare,107,460477,121427,121230,36013,157243,1531
2022-09-18,Tuolumne,109,53932,15464,15411,920,16331,196
2022-09-18,Ventura,111,848112,207657,207049,15365,222414,1563
2022-09-18,Yolo,113,214977,47146,47085,4341,51426,334
2022-09-18,Yuba,115,75493,18822,18764,1683,20447,129
2022-09-17,Alameda,001,1643700,345203,344045,19609,363654,2007
2022-09-17,Alpine,003,1148,134,134,1,135,0
2022-09-17,Amador,005,37829,9952,9908,918,10826,90
2022-09-17,Butte,007,227075,39274,39155,8921,48076,453
2022-09-17,Calaveras,009,45235,8469,8455,523,8978,133
2022-09-17,Colusa,011,21464,3770,3765,1272,5037,22
2022-09-17,Contra Costa,013,1133247,247971,247095,20350,267445,1423
2022-09-17,Del Norte,015,27424,7399,7381,404,7785,56
2022-09-17,El Dorado,017,186661,32155,32088,4221,36309,231
2022-09-17,Fresno,019,978130,273324,272774,30482,303256,2839
2022-09-17,Glenn,021,27897,5490,5481,1859,7340,48
2022-09-17,Humboldt,023,135768,21634,21561,4928,26489,155
2022-09-17,Imperial,025,180216,65289,65099,15529,80628,956
2022-09-17,Inyo,027,18085,4480,4472,932,5404,59
2022-09-17,Kern,029,883053,218375,217694,59358,277052,2405
2022-09-17,Kings,031,150075,59271,59122,4057,63179,456
2022-09-17,Lake,033,64148,12729,12696,1160,13856,144
2022-09-17,Lassen,035,31185,9947,9938,983,10921,65
2022-09-17,Los Angeles,037,10098052,3262973,3253906,177672,3431578,33160
2022-09-17,Madera,039,155013,43903,43782,8185,51967,373
2022-09-17,Marin,041,260295,44801,44702,5259,49961,309
2022-09-17,Mariposa,043,17540,3073,3064,355,3419,31
2022-09-17,Mendocino,045,87422,15908,15872,4439,20311,136
2022-09-17,Merced,047,269075,71861,71732,11563,83295,862
2022-09-17,Modoc,049,8938,872,872,316,1188,11
2022-09-17,Mono,051,14174,3198,3191,246,3437,7
2022-09-17,Monterey,053,433212,93812,93692,20810,114502,762
2022-09-17,Napa,055,140530,32087,31979,1410,33389,160
2022-09-17,Nevada,057,99092,18851,18824,1810,20634,132
2022-09-17,Orange,059,3164182,664099,662784,60663,723447,7398
2022-09-17,Placer,061,380077,75350,75159,9319,84478,660
2022-09-17,Plumas,063,18699,3625,3609,431,4040,13
2022-09-17,Riverside,065,2383286,692865,691630,34930,726560,6608
2022-09-17,Sacramento,067,1510023,344661,343926,33304,377230,3267
2022-09-17,San Benito,069,59416,16108,16057,955,17012,106
2022-09-17,San Bernardino,071,2135413,666976,664360,30420,694780,8074
2022-09-17,San Diego,073,3302833,919903,917229,70637,987866,5479
2022-09-17,San Francisco,075,870044,176841,176724,11958,188682,1025
2022-09-17,San Joaquin,077,732212,196515,196128,14178,210306,2304
2022-09-17,San Luis Obispo,079,281455,62929,62716,7070,69786,520
2022-09-17,San Mateo,081,765935,167058,166572,10502,177074,735
2022-09-17,Santa Barbara,083,443738,105154,104912,6834,111746,718
2022-09-17,Santa Clara,085,1922200,429176,428065,18685,446750,2473
2022-09-17,Santa Cruz,087,273765,62703,62480,3398,65878,274
2022-09-17,Shasta,089,179085,34759,34648,7298,41946,591
2022-09-17,Sierra,091,2930,303,303,60,363,5
2022-09-17,Siskiyou,093,43540,5238,5226,3292,8518,90
2022-09-17,Solano,095,438530,104332,104085,7657,111742,462
2022-09-17,Sonoma,097,501317,106280,106028,5266,111294,518
2022-09-17,Stanislaus,099,539301,137287,136981,20915,157896,1727
2022-09-17,Sutter,101,95872,24178,24119,2463,26582,232
2022-09-17,Tehama,103,63373,13528,13503,3059,16562,210
2022-09-17,Trinity,105,12862,1390,1385,378,1763,20
2022-09-17,Tulare,107,460477,121417,121230,36013,157243,1531
2022-09-17,Tuolumne,109,53932,15462,15411,920,16331,196
2022-09-17,Ventura,111,848112,207622,207049,15365,222414,1563
2022-09-17,Yolo,113,214977,47144,47085,4341,51426,334
2022-09-17,Yuba,115,75493,18819,18764,1683,20447,129
2022-09-16,Alameda,001,1643700,345111,344045,19609,363654,2007
2022-09-16,Alpine,003,1148,134,134,1,135,0
2022-09-16,Amador,005,37829,9950,9908,918,10826,90
2022-09-16,Butte,007,227075,39266,39155,8921,48076,453
2022-09-16,Calaveras,009,45235,8466,8455,523,8978,133
2022-09-16,Colusa,011,21464,3770,3765,1272,5037,22
2022-09-16,Contra Costa,013,1133247,247918,247095,20350,267445,1423
2022-09-16,Del Norte,015,27424,7398,7381,404,7785,56
2022-09-16,El Dorado,017,186661,32153,32088,4221,36309,231
2022-09-16,Fresno,019,978130,273278,272774,30482,303256,2839
2022-09-16,Glenn,021,27897,5490,5481,1859,7340,48
2022-09-16,Humboldt,023,135768,21628,21561,4928,26489,155
2022-09-16,Imperial,025,180216,65274,65099,15529,80628,956
2022-09-16,Inyo,027,18085,4480,4472,932,5404,59
2022-09-16,Kern,029,883053,218346,217694,59358,277052,2405
2022-09-16,Kings,031,150075,59260,59122,4057,63179,456
2022-09-16,Lake,033,64148,12725,12696,1160,13856,144
2022-09-16,Lassen,035,31185,9946,9938,983,10921,65
2022-09-16,Los Angeles,037,10098052,3262353,3253906,177672,3431578,33160
2022-09-16,Madera,039,155013,43892,43782,8185,51967,373
2022-09-16,Marin,041,260295,44785,44702,5259,49961,309
2022-09-16,Mariposa,043,17540,3073,3064,355,3419,31
2022-09-16,Mendocino,045,87422,15902,15872,4439,20311,136
2022-09-16,Merced,047,269075,71854,71732,11563,83295,862
2022-09-16,Modoc,049,8938,872,872,316,1188,11
2022-09-16,Mono,051,14174,3198,3191,246,3437,7
2022-09-16,Monterey,053,433212,93800,93692,20810,114502,762
2022-09-16,Napa,055,140530,32076,31979,1410,33389,160
2022-09-16,Nevada,057,99092,18850,18824,1810,20634,132
2022-09-16,Orange,059,3164182,663946,662784,60663,723447,7398
2022-09-16,Placer,061,380077,75338,75159,9319,84478,660
2022-09-16,Plumas,063,18699,3624,3609,431,4040,13
2022-09-16,Riverside,065,2383286,692766,691630,34930,726560,6608
2022-09-16,Sacramento,067,1510023,344583,343926,33304,377230,3267
2022-09-16,San Benito,069,59416,16100,16057,955,17012,106
2022-09-16,San Bernardino,071,2135413,666885,664360,30420,694780,8074
2022-09-16,San Diego,073,3302833,919672,917229,70637,987866,5479
2022-09-16,San Francisco,075,870044,176827,176724,11958,188682,1025
2022-09-16,San Joaquin,077,732212,196497,196128,14178,210306,2304
2022-09-16,San Luis Obispo,079,281455,62920,62716,7070,69786,520
2022-09-16,San Mateo,081,765935,167015,166572,10502,177074,735
2022-09-16,Santa Barbara,083,443738,105135,104912,6834,111746,718
2022-09-16,Santa Clara,085,1922200,429067,428065,18685,446750,2473
2022-09-16,Santa Cruz,087,273765,62694,62480,3398,65878,274
2022-09-16,Shasta,089,179085,34754,34648,7298,41946,591
2022-09-16,Sierra,091,2930,303,303,60,363,5
2022-09-16,Siskiyou,093,43540,5238,5226,3292,8518,90
2022-09-16,Solano,095,438530,104309,104085,7657,111742,462
2022-09-16,Sonoma,097,501317,106255,106028,5266,111294,518
2022-09-16,Stanislaus,099,539301,137260,136981,20915,157896,1727
2022-09-16,Sutter,101,95872,24165,24119,2463,26582,232
2022-09-16,Tehama,103,63373,13527,13503,3059,16562,210
2022-09-16,Trinity,105,12862,1390,1385,378,1763,20
2022-09-16,Tulare,107,460477,121401,121230,36013,157243,1531
2022-09-16,Tuolumne,109,53932,15457,15411,920,16331,196
2022-09-16,Ventura,111,848112,207574,207049,15365,222414,1563
2022-09-16,Yolo,113,214977,47139,47085,4341,51426,334
2022-09-16,Yuba,115,75493,18814,18764,1683,20447,129
2022-09-15,Alameda,001,1643700,344956,344045,19609,363654,2007
2022-09-15,Alpine,003,1148,134,134,1,135,0
2022-09-15,Amador,005,37829,9945,9908,918,10826,90
2022-09-15,Butte,007,227075,39258,39155,8921,48076,453
2022-09-15,Calaveras,009,45235,8464,8455,523,8978,133
2022-09-15,Colusa,011,21464,3770,3765,1272,5037,22
2022-09-15,Contra Costa,013,1133247,247811,247095,20350,267445,1423
2022-09-15,Del Norte,015,27424,7395,7381,404,7785,56
2022-09-15,El Dorado,017,186661,32145,32088,4221,36309,231
2022-09-15,Fresno,019,978130,273189,272774,30482,303256,2839
2022-09-15,Glenn,021,27897,5490,5481,1859,7340,48
2022-09-15,Humboldt,023,135768,21619,21561,4928,26489,155
2022-09-15,Imperial,025,180216,65247,65099,15529,80628,956
2022-09-15,Inyo,027,18085,4480,4472,932,5404,59
2022-09-15,Kern,029,883053,218297,217694,59358,277052,2405
2022-09-15,Kings,031,150075,59243,59122,4057,63179,456
2022-09-15,Lake,033,64148,12723,12696,1160,13856,144
2022-09-15,Lassen,035,31185,9945,9938,983,10921,65
2022-09-15,Los Angeles,037,10098052,3261356,3253906,177672,3431578,33160
2022-09-15,Madera,039,155013,43880,43782,8185,51967,373
2022-09-15,Marin,041,260295,44769,44702,5259,49961,309
2022-09-15,Mariposa,043,17540,3072,3064,355,3419,31
2022-09-15,Mendocino,045,87422,15895,15872,4439,20311,136
2022-09-15,Merced,047,269075,71837,71732,11563,83295,862
2022-09-15,Modoc,049,8938,872,872,316,1188,11
2022-09-15,Mono,051,14174,3198,3191,246,3437,7
2022-09-15,Monterey,053,433212,93782,93692,20810,114502,762
2022-09-15,Napa,055,140530,32065,31979,1410,33389,160
2022-09-15,Nevada,057,99092,18848,18824,1810,20634,132
2022-09-15,Orange,059,3164182,663726,662784,60663,723447,7398
2022-09-15,Placer,061,380077,75305,75159,9319,84478,660
2022-09-15,Plumas,063,18699,3624,3609,431,4040,13
2022-09-15,Riverside,065,2383286,692619,691630,34930,726560,6608
2022-09-15,Sacramento,067,1510023,344443,343926,33304,377230,3267
2022-09-15,San Benito,069,59416,16094,16057,955,17012,106
2022-09-15,San Bernardino,071,2135413,666721,664360,30420,694780,8074
2022-09-15,San Diego,073,3302833,919335,917229,70637,987866,5479
2022-09-15,San Francisco,075,870044,176792,176724,11958,188682,1025
2022-09-15,San Joaquin,077,732212,196446,196128,14178,210306,2304
2022-09-15,San Luis Obispo,079,281455,62899,62716,7070,69786,520
2022-09-15,San Mateo,081,765935,166945,166572,10502,177074,735
2022-09-15,Santa Barbara,083,443738,105103,104912,6834,111746,718
2022-09-15,Santa Clara,085,1922200,428893,428065,18685,446750,2473
2022-09-15,Santa Cruz,087,273765,62680,62480,3398,65878,274
2022-09-15,Shasta,089,179085,34747,34648,7298,41946,591
2022-09-15,Sierra,091,2930,303,303,60,363,5
2022-09-15,Siskiyou,093,43540,5235,5226,3292,8518,90
2022-09-15,Solano,095,438530,104270,104085,7657,111742,462
2022-09-15,Sonoma,097,501317,106222,106028,5266,111294,518
2022-09-15,Stanislaus,099,539301,137228,136981,20915,157896,1727
2022-09-15,Sutter,101,95872,24158,24119,2463,26582,232
2022-09-15,Tehama,103,63373,13523,13503,3059,16562,210
2022-09-15,Trinity,105,12862,1390,1385,378,1763,20
2022-09-15,Tulare,107,460477,121374,121230,36013,157243,1531
2022-09-15,Tuolumne,109,53932,15452,15411,920,16331,196
2022-09-15,Ventura,111,848112,207495,207049,15365,222414,1563
2022-09-15,Yolo,113,214977,47129,47085,4341,51426,334
2022-09-15,Yuba,115,75493,18807,18764,1683,20447,129
2022-09-14,Alameda,001,1643700,344779,344045,19609,363654,2007
2022-09-14,Alpine,003,1148,134,134,1,135,0
2022-09-14,Amador,005,37829,9938,9908,918,10826,90
2022-09-14,Butte,007,227075,39243,39155,8921,48076,453
2022-09-14,Calaveras,009,45235,8457,8455,523,8978,133
2022-09-14,Colusa,011,21464,3767,3765,1272,5037,22
2022-09-14,Contra Costa,013,1133247,247724,247095,20350,267445,1423
2022-09-14,Del Norte,015,27424,7392,7381,404,7785,56
2022-09-14,El Dorado,017,186661,32137,32088,4221,36309,231
2022-09-14,Fresno,019,978130,273103,272774,30482,303256,2839
2022-09-14,Glenn,021,27897,5490,5481,1859,7340,48
2022-09-14,Humboldt,023,135768,21602,21561,4928,26489,155
2022-09-14,Imperial,025,180216,65228,65099,15529,80628,956
2022-09-14,Inyo,027,18085,4478,4472,932,5404,59
2022-09-14,Kern,029,883053,218244,217694,59358,277052,2405
2022-09-14,Kings,031,150075,59223,59122,4057,63179,456
2022-09-14,Lake,033,64148,12718,12696,1160,13856,144
2022-09-14,Lassen,035,31185,9945,9938,983,10921,65
2022-09-14,Los Angeles,037,10098052,3260192,3253906,177672,3431578,33160
2022-09-14,Madera,039,155013,43856,43782,8185,51967,373
2022-09-14,Marin,041,260295,44752,44702,5259,49961,309
2022-09-14,Mariposa,043,17540,3072,3064,355,3419,31
2022-09-14,Mendocino,045,87422,15893,15872,4439,20311,136
2022-09-14,Merced,047,269075,71822,71732,11563,83295,862
2022-09-14,Modoc,049,8938,872,872,316,1188,11
2022-09-14,Mono,051,14174,3198,3191,246,3437,7
2022-09-14,Monterey,053,433212,93769,93692,20810,114502,762
2022-09-14,Napa,055,140530,32054,31979,1410,33389,160
2022-09-14,Nevada,057,99092,18842,18824,1810,20634,132
2022-09-14,Orange,059,3164182,663443,662784,60663,723447,7398
2022-09-14,Placer,061,380077,75276,75159,9319,84478,660
2022-09-14,Plumas,063,18699,3619,3609,431,4040,13
2022-09-14,Riverside,065,2383286,692415,691630,34930,726560,6608
2022-09-14,Sacramento,067,1510023,344310,343926,33304,377230,3267
2022-09-14,San Benito,069,59416,16089,16057,955,17012,106
2022-09-14,San Bernardino,071,2135413,666549,664360,30420,694780,8074
2022-09-14,San Diego,073,3302833,918969,917229,70637,987866,5479
2022-09-14,San Francisco,075,870044,176766,176724,11958,188682,1025
2022-09-14,San Joaquin,077,732212,196388,196128,14178,210306,2304
2022-09-14,San Luis Obispo,079,281455,62879,62716,7070,69786,520
2022-09-14,San Mateo,081,765935,166882,166572,10502,177074,735
2022-09-14,Santa Barbara,083,443738,105074,104912,6834,111746,718
2022-09-14,Santa Clara,085,1922200,428730,428065,18685,446750,2473
2022-09-14,Santa Cruz,087,273765,62668,62480,3398,65878,274
2022-09-14,Shasta,089,179085,34740,34648,7298,41946,591
2022-09-14,Sierra,091,2930,303,303,60,363,5
2022-09-14,Siskiyou,093,43540,5232,5226,3292,8518,90
2022-09-14,Solano,095,438530,104239,104085,7657,111742,462
2022-09-14,Sonoma,097,501317,106173,106028,5266,111294,518
2022-09-14,Stanislaus,099,539301,137167,136981,20915,157896,1727
2022-09-14,Sutter,101,95872,24147,24119,2463,26582,232
2022-09-14,Tehama,103,63373,13522,13503,3059,16562,210
2022-09-14,Trinity,105,12862,1390,1385,378,1763,20
2022-09-14,Tulare,107,460477,121352,121230,36013,157243,1531
2022-09-14,Tuolumne,109,53932,15448,15411,920,16331,196
2022-09-14,Ventura,111,848112,207428,207049,15365,222414,1563
2022-09-14,Yolo,113,214977,47123,47085,4341,51426,334
2022-09-14,Yuba,115,75493,18800,18764,1683,20447,129
2022-09-13,Alameda,001,1643700,344606,344045,19609,363654,2007
2022-09-13,Alpine,003,1148,134,134,1,135,0
2022-09-13,Amador,005,37829,9933,9908,918,10826,90
2022-09-13,Butte,007,227075,39220,39155,8921,48076,453
2022-09-13,Calaveras,009,45235,8455,8455,523,8978,133
2022-09-13,Colusa,011,21464,3766,3765,1272,5037,22
2022-09-13,Contra Costa,013,1133247,247602,247095,20350,267445,1423
2022-09-13,Del Norte,015,27424,7388,7381,404,7785,56
2022-09-13,El Dorado,017,186661,32128,32088,4221,36309,231
2022-09-13,Fresno,019,978130,273012,272774,30482,303256,2839
2022-09-13,Glenn,021,27897,5489,5481,1859,7340,48
2022-09-13,Humboldt,023,135768,21586,21561,4928,26489,155
2022-09-13,Imperial,025,180216,65208,65099,15529,80628,956
2022-09-13,Inyo,027,18085,4476,4472,932,5404,59
2022-09-13,Kern,029,883053,218164,217694,59358,277052,2405
2022-09-13,Kings,031,150075,59187,59122,4057,63179,456
2022-09-13,Lake,033,64148,12713,12696,1160,13856,144
2022-09-13,Lassen,035,31185,9945,9938,983,10921,65
2022-09-13,Los Angeles,037,10098052,3258877,3253906,177672,3431578,33160
2022-09-13,Madera,039,155013,43846,43782,8185,51967,373
2022-09-13,Marin,041,260295,44740,44702,5259,49961,309
2022-09-13,Mariposa,043,17540,3070,3064,355,3419,31
2022-09-13,Mendocino,045,87422,15889,15872,4439,20311,136
2022-09-13,Merced,047,269075,71806,71732,11563,83295,862
2022-09-13,Modoc,049,8938,872,872,316,1188,11
2022-09-13,Mono,051,14174,3197,3191,246,3437,7
2022-09-13,Monterey,053,433212,93744,93692,20810,114502,762
2022-09-13,Napa,055,140530,32040,31979,1410,33389,160
2022-09-13,Nevada,057,99092,18837,18824,1810,20634,132
2022-09-13,Orange,059,3164182,663168,662784,60663,723447,7398
2022-09-13,Placer,061,380077,75246,75159,9319,84478,660
2022-09-13,Plumas,063,18699,3617,3609,431,4040,13
2022-09-13,Riverside,065,2383286,692221,691630,34930,726560,6608
2022-09-13,Sacramento,067,1510023,344150,343926,33304,377230,3267
2022-09-13,San Benito,069,59416,16080,16057,955,17012,106
2022-09-13,San Bernardino,071,2135413,666323,664360,30420,694780,8074
2022-09-13,San Diego,073,3302833,918607,917229,70637,987866,5479
2022-09-13,San Francisco,075,870044,176742,176724,11958,188682,1025
2022-09-13,San Joaquin,077,732212,196314,196128,14178,210306,2304
2022-09-13,San Luis Obispo,079,281455,62848,62716,7070,69786,520
2022-09-13,San Mateo,081,765935,166808,166572,10502,177074,735
2022-09-13,Santa Barbara,083,443738,105025,104912,6834,111746,718
2022-09-13,Santa Clara,085,1922200,428515,428065,18685,446750,2473
2022-09-13,Santa Cruz,087,273765,62646,62480,3398,65878,274
2022-09-13,Shasta,089,179085,34723,34648,7298,41946,591
2022-09-13,Sierra,091,2930,303,303,60,363,5
2022-09-13,Siskiyou,093,43540,5230,5226,3292,8518,90
2022-09-13,Solano,095,438530,104184,104085,7657,111742,462
2022-09-13,Sonoma,097,501317,106123,106028,5266,111294,518
2022-09-13,Stanislaus,099,539301,137120,136981,20915,157896,1727
2022-09-13,Sutter,101,95872,24137,24119,2463,26582,232
2022-09-13,Tehama,103,63373,13514,13503,3059,16562,210
2022-09-13,Trinity,105,12862,1389,1385,378,1763,20
2022-09-13,Tulare,107,460477,121322,121230,36013,157243,1531
2022-09-13,Tuolumne,109,53932,15442,15411,920,16331,196
2022-09-13,Ventura,111,848112,207343,207049,15365,222414,1563
2022-09-13,Yolo,113,214977,47114,47085,4341,51426,334
2022-09-13,Yuba,115,75493,18792,18764,1683,20447,129
2022-09-12,Alameda,001,1643700,344412,343017,19609,362626,2006
2022-09-12,Alpine,003,1148,134,134,1,135,0
2022-09-12,Amador,005,37829,9926,9890,918,10808,89
2022-09-12,Butte,007,227075,39205,39049,8921,47970,453
2022-09-12,Calaveras,009,45235,8452,8444,523,8967,133
2022-09-12,Colusa,011,21464,3766,3755,1272,5027,22
2022-09-12,Contra Costa,013,1133247,247479,246174,20350,266524,1415
2022-09-12,Del Norte,015,27424,7385,7354,404,7758,56
2022-09-12,El Dorado,017,186661,32112,32027,4221,36248,229
2022-09-12,Fresno,019,978130,272902,272161,30482,302643,2835
2022-09-12,Glenn,021,27897,5486,5473,1859,7332,48
2022-09-12,Humboldt,023,135768,21575,21494,4928,26422,155
2022-09-12,Imperial,025,180216,65184,64926,15529,80455,956
2022-09-12,Inyo,027,18085,4474,4465,932,5397,59
2022-09-12,Kern,029,883053,218099,217203,59358,276561,2404
2022-09-12,Kings,031,150075,59169,58980,4057,63037,455
2022-09-12,Lake,033,64148,12704,12663,1160,13823,144
2022-09-12,Lassen,035,31185,9944,9931,983,10914,64
2022-09-12,Los Angeles,037,10098052,3257344,3246402,177672,3424074,33094
2022-09-12,Madera,039,155013,43835,43599,8185,51784,373
2022-09-12,Marin,041,260295,44720,44584,5259,49843,305
2022-09-12,Mariposa,043,17540,3067,3058,355,3413,31
2022-09-12,Mendocino,045,87422,15884,15853,4439,20292,135
2022-09-12,Merced,047,269075,71779,71563,11563,83126,856
2022-09-12,Modoc,049,8938,872,872,316,1188,11
2022-09-12,Mono,051,14174,3195,3188,246,3434,7
2022-09-12,Monterey,053,433212,93715,93513,20810,114323,762
2022-09-12,Napa,055,140530,32020,31910,1410,33320,158
2022-09-12,Nevada,057,99092,18831,18784,1810,20594,132
2022-09-12,Orange,059,3164182,662884,661329,60663,721992,7371
2022-09-12,Placer,061,380077,75218,74994,9319,84313,657
2022-09-12,Plumas,063,18699,3615,3594,431,4025,13
2022-09-12,Riverside,065,2383286,691955,690018,34930,724948,6596
2022-09-12,Sacramento,067,1510023,344001,343048,33304,376352,3254
2022-09-12,San Benito,069,59416,16066,16000,955,16955,103
2022-09-12,San Bernardino,071,2135413,666030,662248,30420,692668,8057
2022-09-12,San Diego,073,3302833,918151,915648,70637,986285,5474
2022-09-12,San Francisco,075,870044,176694,176512,11958,188470,1022
2022-09-12,San Joaquin,077,732212,196221,195697,14178,209875,2303
2022-09-12,San Luis Obispo,079,281455,62821,62569,7070,69639,519
2022-09-12,San Mateo,081,765935,166719,166165,10502,176667,735
2022-09-12,Santa Barbara,083,443738,104992,104627,6834,111461,717
2022-09-12,Santa Clara,085,1922200,428273,426854,18685,445539,2478
2022-09-12,Santa Cruz,087,273765,62621,62255,3398,65653,274
2022-09-12,Shasta,089,179085,34706,34531,7298,41829,591
2022-09-12,Sierra,091,2930,303,303,60,363,5
2022-09-12,Siskiyou,093,43540,5228,5197,3292,8489,90
2022-09-12,Solano,095,438530,104133,103841,7657,111498,461
2022-09-12,Sonoma,097,501317,106078,105778,5266,111044,521
2022-09-12,Stanislaus,099,539301,137066,136674,20915,157589,1726
2022-09-12,Sutter,101,95872,24123,24037,2463,26500,228
2022-09-12,Tehama,103,63373,13509,13471,3059,16530,210
2022-09-12,Trinity,105,12862,1388,1383,378,1761,20
2022-09-12,Tulare,107,460477,121275,120972,36013,156985,1529
2022-09-12,Tuolumne,109,53932,15433,15362,920,16282,196
2022-09-12,Ventura,111,848112,207242,206442,15365,221807,1558
2022-09-12,Yolo,113,214977,47105,46989,4341,51330,334
2022-09-12,Yuba,115,75493,18778,18709,1683,20392,129
2022-09-11,Alameda,001,1643700,344159,343017,19609,362626,2006
2022-09-11,Alpine,003,1148,134,134,1,135,0
2022-09-11,Amador,005,37829,9918,9890,918,10808,89
2022-09-11,Butte,007,227075,39173,39049,8921,47970,453
2022-09-11,Calaveras,009,45235,8449,8444,523,8967,133
2022-09-11,Colusa,011,21464,3765,3755,1253,5008,22
2022-09-11,Contra Costa,013,1133247,247325,246174,20350,266524,1415
2022-09-11,Del Norte,015,27424,7380,7354,404,7758,56
2022-09-11,El Dorado,017,186661,32098,32027,4221,36248,229
2022-09-11,Fresno,019,978130,272792,272161,30482,302643,2835
2022-09-11,Glenn,021,27897,5484,5473,1859,7332,48
2022-09-11,Humboldt,023,135768,21560,21494,4928,26422,155
2022-09-11,Imperial,025,180216,65142,64926,15529,80455,956
2022-09-11,Inyo,027,18085,4473,4465,932,5397,59
2022-09-11,Kern,029,883053,218003,217203,59356,276559,2404
2022-09-11,Kings,031,150075,59133,58980,4057,63037,455
2022-09-11,Lake,033,64148,12691,12663,1160,13823,144
2022-09-11,Lassen,035,31185,9938,9931,983,10914,64
2022-09-11,Los Angeles,037,10098052,3255702,3246402,177666,3424068,33094
2022-09-11,Madera,039,155013,43806,43599,8185,51784,373
2022-09-11,Marin,041,260295,44697,44584,5259,49843,305
2022-09-11,Mariposa,043,17540,3065,3058,355,3413,31
2022-09-11,Mendocino,045,87422,15877,15853,4439,20292,135
2022-09-11,Merced,047,269075,71750,71563,11563,83126,856
2022-09-11,Modoc,049,8938,872,872,316,1188,11
2022-09-11,Mono,051,14174,3192,3188,246,3434,7
2022-09-11,Monterey,053,433212,93690,93513,20809,114322,762
2022-09-11,Napa,055,140530,32001,31910,1410,33320,158
2022-09-11,Nevada,057,99092,18824,18784,1806,20590,132
2022-09-11,Orange,059,3164182,662598,661329,60663,721992,7371
2022-09-11,Placer,061,380077,75190,74994,9319,84313,657
2022-09-11,Plumas,063,18699,3609,3594,431,4025,13
2022-09-11,Riverside,065,2383286,691689,690018,34930,724948,6596
2022-09-11,Sacramento,067,1510023,343809,343048,33302,376350,3254
2022-09-11,San Benito,069,59416,16058,16000,955,16955,103
2022-09-11,San Bernardino,071,2135413,665735,662248,30420,692668,8057
2022-09-11,San Diego,073,3302833,917628,915648,70637,986285,5474
2022-09-11,San Francisco,075,870044,176651,176512,11958,188470,1022
2022-09-11,San Joaquin,077,732212,196122,195697,14176,209873,2303
2022-09-11,San Luis Obispo,079,281455,62795,62569,7070,69639,519
2022-09-11,San Mateo,081,765935,166612,166165,10502,176667,735
2022-09-11,Santa Barbara,083,443738,104954,104627,6834,111461,717
2022-09-11,Santa Clara,085,1922200,428000,426854,18685,445539,2478
2022-09-11,Santa Cruz,087,273765,62585,62255,3398,65653,274
2022-09-11,Shasta,089,179085,34679,34531,7298,41829,591
2022-09-11,Sierra,091,2930,303,303,60,363,5
2022-09-11,Siskiyou,093,43540,5226,5197,3290,8487,90
2022-09-11,Solano,095,438530,104053,103841,7657,111498,461
2022-09-11,Sonoma,097,501317,106014,105778,5266,111044,521
2022-09-11,Stanislaus,099,539301,137003,136674,20908,157582,1726
2022-09-11,Sutter,101,95872,24103,24037,2463,26500,228
2022-09-11,Tehama,103,63373,13502,13471,3059,16530,210
2022-09-11,Trinity,105,12862,1388,1383,378,1761,20
2022-09-11,Tulare,107,460477,121230,120972,36013,156985,1529
2022-09-11,Tuolumne,109,53932,15427,15362,920,16282,196
2022-09-11,Ventura,111,848112,207113,206442,15365,221807,1558
2022-09-11,Yolo,113,214977,47085,46989,4341,51330,334
2022-09-11,Yuba,115,75493,18769,18709,1682,20391,129
2022-09-10,Alameda,001,1643700,344032,343017,19609,362626,2006
2022-09-10,Alpine,003,1148,134,134,1,135,0
2022-09-10,Amador,005,37829,9915,9890,918,10808,89
2022-09-10,Butte,007,227075,39155,39049,8921,47970,453
2022-09-10,Calaveras,009,45235,8447,8444,523,8967,133
2022-09-10,Colusa,011,21464,3764,3755,1253,5008,22
2022-09-10,Contra Costa,013,1133247,247220,246174,20350,266524,1415
2022-09-10,Del Norte,015,27424,7377,7354,404,7758,56
2022-09-10,El Dorado,017,186661,32089,32027,4221,36248,229
2022-09-10,Fresno,019,978130,272714,272161,30482,302643,2835
2022-09-10,Glenn,021,27897,5481,5473,1859,7332,48
2022-09-10,Humboldt,023,135768,21550,21494,4928,26422,155
2022-09-10,Imperial,025,180216,65121,64926,15529,80455,956
2022-09-10,Inyo,027,18085,4473,4465,932,5397,59
2022-09-10,Kern,029,883053,217950,217203,59356,276559,2404
2022-09-10,Kings,031,150075,59122,58980,4057,63037,455
2022-09-10,Lake,033,64148,12688,12663,1160,13823,144
2022-09-10,Lassen,035,31185,9937,9931,983,10914,64
2022-09-10,Los Angeles,037,10098052,3254979,3246402,177608,3424010,33094
2022-09-10,Madera,039,155013,43789,43599,8185,51784,373
2022-09-10,Marin,041,260295,44680,44584,5254,49838,305
2022-09-10,Mariposa,043,17540,3065,3058,355,3413,31
2022-09-10,Mendocino,045,87422,15875,15853,4439,20292,135
2022-09-10,Merced,047,269075,71735,71563,11563,83126,856
2022-09-10,Modoc,049,8938,872,872,316,1188,11
2022-09-10,Mono,051,14174,3191,3188,246,3434,7
2022-09-10,Monterey,053,433212,93669,93513,20809,114322,762
2022-09-10,Napa,055,140530,31993,31910,1410,33320,158
2022-09-10,Nevada,057,99092,18820,18784,1806,20590,132
2022-09-10,Orange,059,3164182,662434,661329,60663,721992,7371
2022-09-10,Placer,061,380077,75162,74994,9319,84313,657
2022-09-10,Plumas,063,18699,3606,3594,431,4025,13
2022-09-10,Riverside,065,2383286,691523,690018,34930,724948,6596
2022-09-10,Sacramento,067,1510023,343716,343048,33302,376350,3254
2022-09-10,San Benito,069,59416,16052,16000,955,16955,103
2022-09-10,San Bernardino,071,2135413,665583,662248,30420,692668,8057
2022-09-10,San Diego,073,3302833,917415,915648,70631,986279,5474
2022-09-10,San Francisco,075,870044,176630,176512,11958,188470,1022
2022-09-10,San Joaquin,077,732212,196075,195697,14176,209873,2303
2022-09-10,San Luis Obispo,079,281455,62783,62569,7069,69638,519
2022-09-10,San Mateo,081,765935,166543,166165,10502,176667,735
2022-09-10,Santa Barbara,083,443738,104937,104627,6834,111461,717
2022-09-10,Santa Clara,085,1922200,427782,426854,18685,445539,2478
2022-09-10,Santa Cruz,087,273765,62576,62255,3398,65653,274
2022-09-10,Shasta,089,179085,34670,34531,7298,41829,591
2022-09-10,Sierra,091,2930,303,303,60,363,5
2022-09-10,Siskiyou,093,43540,5226,5197,3290,8487,90
2022-09-10,Solano,095,438530,104028,103841,7657,111498,461
2022-09-10,Sonoma,097,501317,105995,105778,5266,111044,521
2022-09-10,Stanislaus,099,539301,136966,136674,20905,157579,1726
2022-09-10,Sutter,101,95872,24088,24037,2463,26500,228
2022-09-10,Tehama,103,63373,13501,13471,3059,16530,210
2022-09-10,Trinity,105,12862,1388,1383,378,1761,20
2022-09-10,Tulare,107,460477,121209,120972,36012,156984,1529
2022-09-10,Tuolumne,109,53932,15421,15362,920,16282,196
2022-09-10,Ventura,111,848112,207049,206442,15365,221807,1558
2022-09-10,Yolo,113,214977,47075,46989,4341,51330,334
2022-09-10,Yuba,115,75493,18761,18709,1682,20391,129
2022-09-09,Alameda,001,1643700,343866,343017,19609,362626,2006
2022-09-09,Alpine,003,1148,134,134,1,135,0
2022-09-09,Amador,005,37829,9912,9890,918,10808,89
2022-09-09,Butte,007,227075,39142,39049,8921,47970,453
2022-09-09,Calaveras,009,45235,8445,8444,523,8967,133
2022-09-09,Colusa,011,21464,3762,3755,1253,5008,22
2022-09-09,Contra Costa,013,1133247,247143,246174,20350,266524,1415
2022-09-09,Del Norte,015,27424,7376,7354,404,7758,56
2022-09-09,El Dorado,017,186661,32082,32027,4221,36248,229
2022-09-09,Fresno,019,978130,272653,272161,30482,302643,2835
2022-09-09,Glenn,021,27897,5479,5473,1858,7331,48
2022-09-09,Humboldt,023,135768,21544,21494,4928,26422,155
2022-09-09,Imperial,025,180216,65099,64926,15529,80455,956
2022-09-09,Inyo,027,18085,4471,4465,932,5397,59
2022-09-09,Kern,029,883053,217892,217203,59347,276550,2404
2022-09-09,Kings,031,150075,59103,58980,4056,63036,455
2022-09-09,Lake,033,64148,12685,12663,1160,13823,144
2022-09-09,Lassen,035,31185,9937,9931,983,10914,64
2022-09-09,Los Angeles,037,10098052,3254114,3246402,177536,3423938,33094
2022-09-09,Madera,039,155013,43772,43599,8185,51784,373
2022-09-09,Marin,041,260295,44668,44584,5252,49836,305
2022-09-09,Mariposa,043,17540,3064,3058,355,3413,31
2022-09-09,Mendocino,045,87422,15871,15853,4439,20292,135
2022-09-09,Merced,047,269075,71715,71563,11563,83126,856
2022-09-09,Modoc,049,8938,872,872,316,1188,11
2022-09-09,Mono,051,14174,3191,3188,246,3434,7
2022-09-09,Monterey,053,433212,93655,93513,20809,114322,762
2022-09-09,Napa,055,140530,31981,31910,1410,33320,158
2022-09-09,Nevada,057,99092,18814,18784,1806,20590,132
2022-09-09,Orange,059,3164182,662248,661329,60663,721992,7371
2022-09-09,Placer,061,380077,75141,74994,9315,84309,657
2022-09-09,Plumas,063,18699,3605,3594,431,4025,13
2022-09-09,Riverside,065,2383286,691343,690018,34930,724948,6596
2022-09-09,Sacramento,067,1510023,343582,343048,33302,376350,3254
2022-09-09,San Benito,069,59416,16042,16000,955,16955,103
2022-09-09,San Bernardino,071,2135413,665410,662248,30420,692668,8057
2022-09-09,San Diego,073,3302833,917153,915648,70610,986258,5474
2022-09-09,San Francisco,075,870044,176600,176512,11958,188470,1022
2022-09-09,San Joaquin,077,732212,196022,195697,14173,209870,2303
2022-09-09,San Luis Obispo,079,281455,62777,62569,7069,69638,519
2022-09-09,San Mateo,081,765935,166489,166165,10502,176667,735
2022-09-09,Santa Barbara,083,443738,104900,104627,6834,111461,717
2022-09-09,Santa Clara,085,1922200,427597,426854,18685,445539,2478
2022-09-09,Santa Cruz,087,273765,62556,62255,3398,65653,274
2022-09-09,Shasta,089,179085,34656,34531,7298,41829,591
2022-09-09,Sierra,091,2930,303,303,60,363,5
2022-09-09,Siskiyou,093,43540,5219,5197,3290,8487,90
2022-09-09,Solano,095,438530,103994,103841,7657,111498,461
2022-09-09,Sonoma,097,501317,105966,105778,5266,111044,521
2022-09-09,Stanislaus,099,539301,136940,136674,20903,157577,1726
2022-09-09,Sutter,101,95872,24081,24037,2463,26500,228
2022-09-09,Tehama,103,63373,13497,13471,3059,16530,210
2022-09-09,Trinity,105,12862,1387,1383,378,1761,20
2022-09-09,Tulare,107,460477,121179,120972,36010,156982,1529
2022-09-09,Tuolumne,109,53932,15420,15362,920,16282,196
2022-09-09,Ventura,111,848112,206982,206442,15365,221807,1558
2022-09-09,Yolo,113,214977,47060,46989,4340,51329,334
2022-09-09,Yuba,115,75493,18751,18709,1682,20391,129
2022-09-08,Alameda,001,1643700,343650,343017,19609,362626,2006
2022-09-08,Alpine,003,1148,134,134,1,135,0
2022-09-08,Amador,005,37829,9905,9890,918,10808,89
2022-09-08,Butte,007,227075,39123,39049,8920,47969,453
2022-09-08,Calaveras,009,45235,8445,8444,523,8967,133
2022-09-08,Colusa,011,21464,3762,3755,1253,5008,22
2022-09-08,Contra Costa,013,1133247,247019,246174,20350,266524,1415
2022-09-08,Del Norte,015,27424,7366,7354,404,7758,56
2022-09-08,El Dorado,017,186661,32068,32027,4221,36248,229
2022-09-08,Fresno,019,978130,272537,272161,30482,302643,2835
2022-09-08,Glenn,021,27897,5478,5473,1858,7331,48
2022-09-08,Humboldt,023,135768,21523,21494,4926,26420,155
2022-09-08,Imperial,025,180216,65067,64926,15529,80455,956
2022-09-08,Inyo,027,18085,4469,4465,932,5397,59
2022-09-08,Kern,029,883053,217804,217203,59332,276535,2404
2022-09-08,Kings,031,150075,59075,58980,4055,63035,455
2022-09-08,Lake,033,64148,12676,12663,1160,13823,144
2022-09-08,Lassen,035,31185,9936,9931,983,10914,64
2022-09-08,Los Angeles,037,10098052,3252843,3246402,177424,3423826,33094
2022-09-08,Madera,039,155013,43744,43599,8185,51784,373
2022-09-08,Marin,041,260295,44643,44584,5251,49835,305
2022-09-08,Mariposa,043,17540,3062,3058,355,3413,31
2022-09-08,Mendocino,045,87422,15865,15853,4439,20292,135
2022-09-08,Merced,047,269075,71690,71563,11563,83126,856
2022-09-08,Modoc,049,8938,872,872,316,1188,11
2022-09-08,Mono,051,14174,3191,3188,246,3434,7
2022-09-08,Monterey,053,433212,93625,93513,20807,114320,762
2022-09-08,Napa,055,140530,31967,31910,1410,33320,158
2022-09-08,Nevada,057,99092,18806,18784,1806,20590,132
2022-09-08,Orange,059,3164182,661985,661329,60663,721992,7371
2022-09-08,Placer,061,380077,75110,74994,9313,84307,657
2022-09-08,Plumas,063,18699,3602,3594,431,4025,13
2022-09-08,Riverside,065,2383286,691082,690018,34930,724948,6596
2022-09-08,Sacramento,067,1510023,343397,343048,33302,376350,3254
2022-09-08,San Benito,069,59416,16031,16000,955,16955,103
2022-09-08,San Bernardino,071,2135413,665122,662248,30420,692668,8057
2022-09-08,San Diego,073,3302833,916789,915648,70564,986212,5474
2022-09-08,San Francisco,075,870044,176553,176512,11958,188470,1022
2022-09-08,San Joaquin,077,732212,195938,195697,14172,209869,2303
2022-09-08,San Luis Obispo,079,281455,62761,62569,7068,69637,519
2022-09-08,San Mateo,081,765935,166413,166165,10502,176667,735
2022-09-08,Santa Barbara,083,443738,104861,104627,6834,111461,717
2022-09-08,Santa Clara,085,1922200,427334,426854,18685,445539,2478
2022-09-08,Santa Cruz,087,273765,62525,62255,3398,65653,274
2022-09-08,Shasta,089,179085,34637,34531,7298,41829,591
2022-09-08,Sierra,091,2930,303,303,60,363,5
2022-09-08,Siskiyou,093,43540,5214,5197,3290,8487,90
2022-09-08,Solano,095,438530,103939,103841,7657,111498,461
2022-09-08,Sonoma,097,501317,105887,105778,5266,111044,521
2022-09-08,Stanislaus,099,539301,136875,136674,20892,157566,1726
2022-09-08,Sutter,101,95872,24071,24037,2463,26500,228
2022-09-08,Tehama,103,63373,13490,13471,3057,16528,210
2022-09-08,Trinity,105,12862,1387,1383,378,1761,20
2022-09-08,Tulare,107,460477,121135,120972,36001,156973,1529
2022-09-08,Tuolumne,109,53932,15413,15362,920,16282,196
2022-09-08,Ventura,111,848112,206872,206442,15365,221807,1558
2022-09-08,Yolo,113,214977,47040,46989,4340,51329,334
2022-09-08,Yuba,115,75493,18741,18709,1682,20391,129
2022-09-07,Alameda,001,1643700,343418,342480,19609,362089,1999
2022-09-07,Alpine,003,1148,134,133,1,134,0
2022-09-07,Amador,005,37829,9903,9877,918,10795,89
2022-09-07,Butte,007,227075,39095,38969,8918,47887,453
2022-09-07,Calaveras,009,45235,8444,8437,523,8960,133
2022-09-07,Colusa,011,21464,3759,3748,1253,5001,22
2022-09-07,Contra Costa,013,1133247,246880,245708,20350,266058,1415
2022-09-07,Del Norte,015,27424,7364,7346,404,7750,56
2022-09-07,El Dorado,017,186661,32055,31979,4221,36200,229
2022-09-07,Fresno,019,978130,272378,271753,30482,302235,2835
2022-09-07,Glenn,021,27897,5476,5468,1857,7325,48
2022-09-07,Humboldt,023,135768,21503,21459,4925,26384,155
2022-09-07,Imperial,025,180216,65032,64755,15528,80283,956
2022-09-07,Inyo,027,18085,4466,4456,932,5388,59
2022-09-07,Kern,029,883053,217707,216932,59316,276248,2404
2022-09-07,Kings,031,150075,59041,58922,4054,62976,455
2022-09-07,Lake,033,64148,12668,12647,1160,13807,143
2022-09-07,Lassen,035,31185,9936,9918,983,10901,64
2022-09-07,Los Angeles,037,10098052,3251357,3242352,177260,3419612,32971
2022-09-07,Madera,039,155013,43701,43533,8185,51718,373
2022-09-07,Marin,041,260295,44620,44489,5249,49738,305
2022-09-07,Mariposa,043,17540,3060,3046,355,3401,31
2022-09-07,Mendocino,045,87422,15861,15813,4439,20252,135
2022-09-07,Merced,047,269075,71658,71448,11562,83010,856
2022-09-07,Modoc,049,8938,872,868,316,1184,11
2022-09-07,Mono,051,14174,3189,3184,246,3430,7
2022-09-07,Monterey,053,433212,93596,93430,20805,114235,762
2022-09-07,Napa,055,140530,31948,31854,1410,33264,156
2022-09-07,Nevada,057,99092,18797,18761,1806,20567,132
2022-09-07,Orange,059,3164182,661687,660580,60662,721242,7362
2022-09-07,Placer,061,380077,75084,74884,9312,84196,658
2022-09-07,Plumas,063,18699,3600,3588,431,4019,13
2022-09-07,Riverside,065,2383286,690763,688794,34929,723723,6591
2022-09-07,Sacramento,067,1510023,343236,342602,33302,375904,3248
2022-09-07,San Benito,069,59416,16018,15933,955,16888,103
2022-09-07,San Bernardino,071,2135413,664872,660303,30420,690723,8023
2022-09-07,San Diego,073,3302833,916311,914552,70527,985079,5468
2022-09-07,San Francisco,075,870044,176514,176386,11958,188344,1018
2022-09-07,San Joaquin,077,732212,195830,195359,14172,209531,2303
2022-09-07,San Luis Obispo,079,281455,62743,62548,7068,69616,517
2022-09-07,San Mateo,081,765935,166311,165893,10502,176395,736
2022-09-07,Santa Barbara,083,443738,104820,104452,6834,111286,717
2022-09-07,Santa Clara,085,1922200,427061,426178,18685,444863,2472
2022-09-07,Santa Cruz,087,273765,62492,62187,3398,65585,274
2022-09-07,Shasta,089,179085,34615,34484,7298,41782,591
2022-09-07,Sierra,091,2930,303,303,60,363,5
2022-09-07,Siskiyou,093,43540,5209,5190,3290,8480,89
2022-09-07,Solano,095,438530,103882,103665,7657,111322,463
2022-09-07,Sonoma,097,501317,105827,105389,5266,110655,517
2022-09-07,Stanislaus,099,539301,136800,136477,20881,157358,1726
2022-09-07,Sutter,101,95872,24057,23984,2463,26447,228
2022-09-07,Tehama,103,63373,13487,13453,3056,16509,210
2022-09-07,Trinity,105,12862,1387,1382,378,1760,20
2022-09-07,Tulare,107,460477,121084,120846,35992,156838,1529
2022-09-07,Tuolumne,109,53932,15406,15327,920,16247,196
2022-09-07,Ventura,111,848112,206759,206121,15365,221486,1557
2022-09-07,Yolo,113,214977,47011,46966,4339,51305,334
2022-09-07,Yuba,115,75493,18728,18665,1682,20347,129
2022-09-06,Alameda,001,1643700,343160,342480,19602,362082,1999
2022-09-06,Alpine,003,1148,133,133,1,134,0
2022-09-06,Amador,005,37829,9900,9877,918,10795,89
2022-09-06,Butte,007,227075,39065,38969,8908,47877,453
2022-09-06,Calaveras,009,45235,8442,8437,523,8960,133
2022-09-06,Colusa,011,21464,3758,3748,1253,5001,22
2022-09-06,Contra Costa,013,1133247,246718,245708,20334,266042,1415
2022-09-06,Del Norte,015,27424,7356,7346,404,7750,56
2022-09-06,El Dorado,017,186661,32037,31979,4216,36195,229
2022-09-06,Fresno,019,978130,272254,271753,30470,302223,2835
2022-09-06,Glenn,021,27897,5474,5468,1855,7323,48
2022-09-06,Humboldt,023,135768,21487,21459,4921,26380,155
2022-09-06,Imperial,025,180216,64981,64755,15510,80265,956
2022-09-06,Inyo,027,18085,4464,4456,925,5381,59
2022-09-06,Kern,029,883053,217617,216932,59299,276231,2404
2022-09-06,Kings,031,150075,59002,58922,4051,62973,455
2022-09-06,Lake,033,64148,12665,12647,1160,13807,143
2022-09-06,Lassen,035,31185,9933,9918,982,10900,64
2022-09-06,Los Angeles,037,10098052,3249682,3242352,177081,3419433,32971
2022-09-06,Madera,039,155013,43659,43533,8180,51713,373
2022-09-06,Marin,041,260295,44589,44489,5248,49737,305
2022-09-06,Mariposa,043,17540,3059,3046,355,3401,31
2022-09-06,Mendocino,045,87422,15856,15813,4430,20243,135
2022-09-06,Merced,047,269075,71623,71448,11558,83006,856
2022-09-06,Modoc,049,8938,871,868,316,1184,11
2022-09-06,Mono,051,14174,3189,3184,246,3430,7
2022-09-06,Monterey,053,433212,93561,93430,20800,114230,762
2022-09-06,Napa,055,140530,31931,31854,1410,33264,156
2022-09-06,Nevada,057,99092,18788,18761,1803,20564,132
2022-09-06,Orange,059,3164182,661340,660580,60617,721197,7362
2022-09-06,Placer,061,380077,75046,74884,9311,84195,658
2022-09-06,Plumas,063,18699,3597,3588,431,4019,13
2022-09-06,Riverside,065,2383286,690305,688794,34914,723708,6591
2022-09-06,Sacramento,067,1510023,343018,342602,33293,375895,3248
2022-09-06,San Benito,069,59416,16002,15933,955,16888,103
2022-09-06,San Bernardino,071,2135413,664605,660303,30410,690713,8023
2022-09-06,San Diego,073,3302833,915811,914552,70473,985025,5468
2022-09-06,San Francisco,075,870044,176456,176386,11955,188341,1018
2022-09-06,San Joaquin,077,732212,195745,195359,14161,209520,2303
2022-09-06,San Luis Obispo,079,281455,62704,62548,7067,69615,517
2022-09-06,San Mateo,081,765935,166209,165893,10498,176391,736
2022-09-06,Santa Barbara,083,443738,104765,104452,6832,111284,717
2022-09-06,Santa Clara,085,1922200,426805,426178,18678,444856,2472
2022-09-06,Santa Cruz,087,273765,62411,62187,3398,65585,274
2022-09-06,Shasta,089,179085,34570,34484,7295,41779,591
2022-09-06,Sierra,091,2930,303,303,60,363,5
2022-09-06,Siskiyou,093,43540,5206,5190,3287,8477,89
2022-09-06,Solano,095,438530,103819,103665,7649,111314,463
2022-09-06,Sonoma,097,501317,105768,105389,5264,110653,517
2022-09-06,Stanislaus,099,539301,136731,136477,20867,157344,1726
2022-09-06,Sutter,101,95872,24030,23984,2463,26447,228
2022-09-06,Tehama,103,63373,13478,13453,3055,16508,210
2022-09-06,Trinity,105,12862,1386,1382,378,1760,20
2022-09-06,Tulare,107,460477,121034,120846,35965,156811,1529
2022-09-06,Tuolumne,109,53932,15395,15327,920,16247,196
2022-09-06,Ventura,111,848112,206620,206121,15355,221476,1557
2022-09-06,Yolo,113,214977,46996,46966,4335,51301,334
2022-09-06,Yuba,115,75493,18706,18665,1681,20346,129
2022-09-05,Alameda,001,1643700,342877,342480,19586,362066,1999
2022-09-05,Alpine,003,1148,133,133,1,134,0
2022-09-05,Amador,005,37829,9896,9877,918,10795,89
2022-09-05,Butte,007,227075,39020,38969,8895,47864,453
2022-09-05,Calaveras,009,45235,8439,8437,522,8959,133
2022-09-05,Colusa,011,21464,3752,3748,1250,4998,22
2022-09-05,Contra Costa,013,1133247,246533,245708,20312,266020,1415
2022-09-05,Del Norte,015,27424,7350,7346,402,7748,56
2022-09-05,El Dorado,017,186661,32016,31979,4211,36190,229
2022-09-05,Fresno,019,978130,272027,271753,30416,302169,2835
2022-09-05,Glenn,021,27897,5472,5468,1851,7319,48
2022-09-05,Humboldt,023,135768,21473,21459,4915,26374,155
2022-09-05,Imperial,025,180216,64927,64755,15457,80212,956
2022-09-05,Inyo,027,18085,4461,4456,923,5379,59
2022-09-05,Kern,029,883053,217489,216932,59214,276146,2404
2022-09-05,Kings,031,150075,58948,58922,4047,62969,455
2022-09-05,Lake,033,64148,12659,12647,1159,13806,143
2022-09-05,Lassen,035,31185,9924,9918,981,10899,64
2022-09-05,Los Angeles,037,10098052,3247348,3242352,176843,3419195,32971
2022-09-05,Madera,039,155013,43604,43533,8159,51692,373
2022-09-05,Marin,041,260295,44563,44489,5247,49736,305
2022-09-05,Mariposa,043,17540,3054,3046,355,3401,31
2022-09-05,Mendocino,045,87422,15837,15813,4417,20230,135
2022-09-05,Merced,047,269075,71562,71448,11529,82977,856
2022-09-05,Modoc,049,8938,870,868,316,1184,11
2022-09-05,Mono,051,14174,3186,3184,246,3430,7
2022-09-05,Monterey,053,433212,93502,93430,20781,114211,762
2022-09-05,Napa,055,140530,31903,31854,1407,33261,156
2022-09-05,Nevada,057,99092,18782,18761,1799,20560,132
2022-09-05,Orange,059,3164182,660875,660580,60523,721103,7362
2022-09-05,Placer,061,380077,74998,74884,9308,84192,658
2022-09-05,Plumas,063,18699,3596,3588,431,4019,13
2022-09-05,Riverside,065,2383286,689811,688794,34869,723663,6591
2022-09-05,Sacramento,067,1510023,342731,342602,33227,375829,3248
2022-09-05,San Benito,069,59416,15978,15933,952,16885,103
2022-09-05,San Bernardino,071,2135413,664174,660303,30385,690688,8023
2022-09-05,San Diego,073,3302833,915199,914552,70371,984923,5468
2022-09-05,San Francisco,075,870044,176400,176386,11949,188335,1018
2022-09-05,San Joaquin,077,732212,195606,195359,14151,209510,2303
2022-09-05,San Luis Obispo,079,281455,62651,62548,7049,69597,517
2022-09-05,San Mateo,081,765935,166095,165893,10490,176383,736
2022-09-05,Santa Barbara,083,443738,104681,104452,6825,111277,717
2022-09-05,Santa Clara,085,1922200,426447,426178,18663,444841,2472
2022-09-05,Santa Cruz,087,273765,62353,62187,3393,65580,274
2022-09-05,Shasta,089,179085,34539,34484,7287,41771,591
2022-09-05,Sierra,091,2930,303,303,60,363,5
2022-09-05,Siskiyou,093,43540,5200,5190,3287,8477,89
2022-09-05,Solano,095,438530,103724,103665,7635,111300,463
2022-09-05,Sonoma,097,501317,105694,105389,5257,110646,517
2022-09-05,Stanislaus,099,539301,136633,136477,20849,157326,1726
2022-09-05,Sutter,101,95872,24004,23984,2461,26445,228
2022-09-05,Tehama,103,63373,13470,13453,3055,16508,210
2022-09-05,Trinity,105,12862,1386,1382,377,1759,20
2022-09-05,Tulare,107,460477,120933,120846,35913,156759,1529
2022-09-05,Tuolumne,109,53932,15376,15327,920,16247,196
2022-09-05,Ventura,111,848112,206448,206121,15318,221439,1557
2022-09-05,Yolo,113,214977,46973,46966,4329,51295,334
2022-09-05,Yuba,115,75493,18685,18665,1681,20346,129
2022-09-04,Alameda,001,1643700,342744,341621,19580,361201,1998
2022-09-04,Alpine,003,1148,133,133,1,134,0
2022-09-04,Amador,005,37829,9892,9855,917,10772,89
2022-09-04,Butte,007,227075,38999,38851,8888,47739,453
2022-09-04,Calaveras,009,45235,8437,8422,522,8944,133
2022-09-04,Colusa,011,21464,3751,3742,1249,4991,22
2022-09-04,Contra Costa,013,1133247,246428,245022,20305,265327,1410
2022-09-04,Del Norte,015,27424,7349,7340,400,7740,56
2022-09-04,El Dorado,017,186661,32000,31929,4207,36136,229
2022-09-04,Fresno,019,978130,271923,271062,30408,301470,2835
2022-09-04,Glenn,021,27897,5471,5462,1851,7313,48
2022-09-04,Humboldt,023,135768,21464,21390,4912,26302,154
2022-09-04,Imperial,025,180216,64900,64678,15451,80129,956
2022-09-04,Inyo,027,18085,4459,4449,921,5370,59
2022-09-04,Kern,029,883053,217407,216471,59190,275661,2404
2022-09-04,Kings,031,150075,58936,58753,4047,62800,455
2022-09-04,Lake,033,64148,12652,12608,1159,13767,143
2022-09-04,Lassen,035,31185,9921,9908,981,10889,64
2022-09-04,Los Angeles,037,10098052,3246525,3235242,176742,3411984,32927
2022-09-04,Madera,039,155013,43590,43403,8152,51555,373
2022-09-04,Marin,041,260295,44539,44394,5244,49638,305
2022-09-04,Mariposa,043,17540,3053,3036,355,3391,31
2022-09-04,Mendocino,045,87422,15833,15781,4416,20197,134
2022-09-04,Merced,047,269075,71538,71280,11526,82806,856
2022-09-04,Modoc,049,8938,870,868,316,1184,11
2022-09-04,Mono,051,14174,3186,3183,246,3429,7
2022-09-04,Monterey,053,433212,93470,93246,20767,114013,761
2022-09-04,Napa,055,140530,31895,31799,1407,33206,156
2022-09-04,Nevada,057,99092,18773,18705,1797,20502,132
2022-09-04,Orange,059,3164182,660702,659290,60472,719762,7347
2022-09-04,Placer,061,380077,74967,74754,9307,84061,657
2022-09-04,Plumas,063,18699,3594,3587,431,4018,13
2022-09-04,Riverside,065,2383286,689621,687184,34855,722039,6581
2022-09-04,Sacramento,067,1510023,342636,341766,33216,374982,3243
2022-09-04,San Benito,069,59416,15973,15900,952,16852,103
2022-09-04,San Bernardino,071,2135413,664034,658354,30372,688726,8006
2022-09-04,San Diego,073,3302833,914967,912824,70352,983176,5464
2022-09-04,San Francisco,075,870044,176370,176131,11946,188077,1015
2022-09-04,San Joaquin,077,732212,195484,194904,14143,209047,2301
2022-09-04,San Luis Obispo,079,281455,62641,62455,7047,69502,517
2022-09-04,San Mateo,081,765935,166042,165520,10485,176005,738
2022-09-04,Santa Barbara,083,443738,104639,104161,6821,110982,716
2022-09-04,Santa Clara,085,1922200,426252,425040,18652,443692,2473
2022-09-04,Santa Cruz,087,273765,62334,61989,3392,65381,273
2022-09-04,Shasta,089,179085,34532,34422,7285,41707,591
2022-09-04,Sierra,091,2930,303,303,60,363,5
2022-09-04,Siskiyou,093,43540,5197,5168,3284,8452,89
2022-09-04,Solano,095,438530,103706,103457,7631,111088,461
2022-09-04,Sonoma,097,501317,105669,105162,5253,110415,517
2022-09-04,Stanislaus,099,539301,136573,136168,20841,157009,1726
2022-09-04,Sutter,101,95872,23989,23927,2461,26388,228
2022-09-04,Tehama,103,63373,13464,13406,3053,16459,210
2022-09-04,Trinity,105,12862,1386,1377,376,1753,20
2022-09-04,Tulare,107,460477,120890,120592,35886,156478,1527
2022-09-04,Tuolumne,109,53932,15362,15294,919,16213,196
2022-09-04,Ventura,111,848112,206366,205627,15312,220939,1558
2022-09-04,Yolo,113,214977,46963,46882,4324,51206,334
2022-09-04,Yuba,115,75493,18681,18615,1681,20296,129
2022-09-03,Alameda,001,1643700,342622,341621,19573,361194,1998
2022-09-03,Alpine,003,1148,133,133,1,134,0
2022-09-03,Amador,005,37829,9887,9855,916,10771,89
2022-09-03,Butte,007,227075,38982,38851,8880,47731,453
2022-09-03,Calaveras,009,45235,8436,8422,522,8944,133
2022-09-03,Colusa,011,21464,3751,3742,1249,4991,22
2022-09-03,Contra Costa,013,1133247,246322,245022,20295,265317,1410
2022-09-03,Del Norte,015,27424,7349,7340,400,7740,56
2022-09-03,El Dorado,017,186661,31992,31929,4206,36135,229
2022-09-03,Fresno,019,978130,271847,271062,30392,301454,2835
2022-09-03,Glenn,021,27897,5470,5462,1851,7313,48
2022-09-03,Humboldt,023,135768,21454,21390,4912,26302,154
2022-09-03,Imperial,025,180216,64881,64678,15441,80119,956
2022-09-03,Inyo,027,18085,4458,4449,919,5368,59
2022-09-03,Kern,029,883053,217339,216471,59170,275641,2404
2022-09-03,Kings,031,150075,58926,58753,4047,62800,455
2022-09-03,Lake,033,64148,12646,12608,1159,13767,143
2022-09-03,Lassen,035,31185,9921,9908,981,10889,64
2022-09-03,Los Angeles,037,10098052,3245663,3235242,176618,3411860,32927
2022-09-03,Madera,039,155013,43571,43403,8151,51554,373
2022-09-03,Marin,041,260295,44526,44394,5241,49635,305
2022-09-03,Mariposa,043,17540,3052,3036,354,3390,31
2022-09-03,Mendocino,045,87422,15821,15781,4413,20194,134
2022-09-03,Merced,047,269075,71511,71280,11524,82804,856
2022-09-03,Modoc,049,8938,870,868,316,1184,11
2022-09-03,Mono,051,14174,3186,3183,245,3428,7
2022-09-03,Monterey,053,433212,93456,93246,20758,114004,761
2022-09-03,Napa,055,140530,31889,31799,1407,33206,156
2022-09-03,Nevada,057,99092,18767,18705,1797,20502,132
2022-09-03,Orange,059,3164182,660511,659290,60421,719711,7347
2022-09-03,Placer,061,380077,74938,74754,9306,84060,657
2022-09-03,Plumas,063,18699,3592,3587,431,4018,13
2022-09-03,Riverside,065,2383286,689425,687184,34829,722013,6581
2022-09-03,Sacramento,067,1510023,342521,341766,33209,374975,3243
2022-09-03,San Benito,069,59416,15967,15900,951,16851,103
2022-09-03,San Bernardino,071,2135413,663859,658354,30348,688702,8006
2022-09-03,San Diego,073,3302833,914726,912824,70335,983159,5464
2022-09-03,San Francisco,075,870044,176347,176131,11941,188072,1015
2022-09-03,San Joaquin,077,732212,195428,194904,14133,209037,2301
2022-09-03,San Luis Obispo,079,281455,62631,62455,7044,69499,517
2022-09-03,San Mateo,081,765935,165980,165520,10476,175996,738
2022-09-03,Santa Barbara,083,443738,104594,104161,6816,110977,716
2022-09-03,Santa Clara,085,1922200,426073,425040,18647,443687,2473
2022-09-03,Santa Cruz,087,273765,62315,61989,3392,65381,273
2022-09-03,Shasta,089,179085,34520,34422,7282,41704,591
2022-09-03,Sierra,091,2930,303,303,60,363,5
2022-09-03,Siskiyou,093,43540,5194,5168,3284,8452,89
2022-09-03,Solano,095,438530,103691,103457,7627,111084,461
2022-09-03,Sonoma,097,501317,105645,105162,5253,110415,517
2022-09-03,Stanislaus,099,539301,136532,136168,20835,157003,1726
2022-09-03,Sutter,101,95872,23978,23927,2460,26387,228
2022-09-03,Tehama,103,63373,13459,13406,3052,16458,210
2022-09-03,Trinity,105,12862,1386,1377,376,1753,20
2022-09-03,Tulare,107,460477,120856,120592,35855,156447,1527
2022-09-03,Tuolumne,109,53932,15358,15294,918,16212,196
2022-09-03,Ventura,111,848112,206288,205627,15299,220926,1558
2022-09-03,Yolo,113,214977,46954,46882,4322,51204,334
2022-09-03,Yuba,115,75493,18672,18615,1680,20295,129
2022-09-02,Alameda,001,1643700,342491,341621,19567,361188,1998
2022-09-02,Alpine,003,1148,133,133,1,134,0
2022-09-02,Amador,005,37829,9886,9855,916,10771,89
2022-09-02,Butte,007,227075,38970,38851,8870,47721,453
2022-09-02,Calaveras,009,45235,8432,8422,521,8943,133
2022-09-02,Colusa,011,21464,3750,3742,1249,4991,22
2022-09-02,Contra Costa,013,1133247,246227,245022,20284,265306,1410
2022-09-02,Del Norte,015,27424,7349,7340,398,7738,56
2022-09-02,El Dorado,017,186661,31981,31929,4204,36133,229
2022-09-02,Fresno,019,978130,271735,271062,30372,301434,2835
2022-09-02,Glenn,021,27897,5466,5462,1851,7313,48
2022-09-02,Humboldt,023,135768,21447,21390,4908,26298,154
2022-09-02,Imperial,025,180216,64860,64678,15435,80113,956
2022-09-02,Inyo,027,18085,4455,4449,918,5367,59
2022-09-02,Kern,029,883053,217258,216471,59145,275616,2404
2022-09-02,Kings,031,150075,58915,58753,4044,62797,455
2022-09-02,Lake,033,64148,12642,12608,1159,13767,143
2022-09-02,Lassen,035,31185,9920,9908,981,10889,64
2022-09-02,Los Angeles,037,10098052,3244672,3235242,176477,3411719,32927
2022-09-02,Madera,039,155013,43558,43403,8145,51548,373
2022-09-02,Marin,041,260295,44509,44394,5231,49625,305
2022-09-02,Mariposa,043,17540,3049,3036,352,3388,31
2022-09-02,Mendocino,045,87422,15819,15781,4412,20193,134
2022-09-02,Merced,047,269075,71485,71280,11521,82801,856
2022-09-02,Modoc,049,8938,870,868,316,1184,11
2022-09-02,Mono,051,14174,3186,3183,244,3427,7
2022-09-02,Monterey,053,433212,93427,93246,20746,113992,761
2022-09-02,Napa,055,140530,31876,31799,1407,33206,156
2022-09-02,Nevada,057,99092,18762,18705,1795,20500,132
2022-09-02,Orange,059,3164182,660324,659290,60364,719654,7347
2022-09-02,Placer,061,380077,74921,74754,9300,84054,657
2022-09-02,Plumas,063,18699,3591,3587,431,4018,13
2022-09-02,Riverside,065,2383286,689177,687184,34815,721999,6581
2022-09-02,Sacramento,067,1510023,342371,341766,33204,374970,3243
2022-09-02,San Benito,069,59416,15960,15900,951,16851,103
2022-09-02,San Bernardino,071,2135413,663685,658354,30332,688686,8006
2022-09-02,San Diego,073,3302833,914457,912824,70310,983134,5464
2022-09-02,San Francisco,075,870044,176313,176131,11924,188055,1015
2022-09-02,San Joaquin,077,732212,195325,194904,14126,209030,2301
2022-09-02,San Luis Obispo,079,281455,62615,62455,7043,69498,517
2022-09-02,San Mateo,081,765935,165897,165520,10473,175993,738
2022-09-02,Santa Barbara,083,443738,104548,104161,6813,110974,716
2022-09-02,Santa Clara,085,1922200,425874,425040,18636,443676,2473
2022-09-02,Santa Cruz,087,273765,62293,61989,3390,65379,273
2022-09-02,Shasta,089,179085,34513,34422,7281,41703,591
2022-09-02,Sierra,091,2930,303,303,60,363,5
2022-09-02,Siskiyou,093,43540,5191,5168,3284,8452,89
2022-09-02,Solano,095,438530,103657,103457,7623,111080,461
2022-09-02,Sonoma,097,501317,105609,105162,5250,110412,517
2022-09-02,Stanislaus,099,539301,136486,136168,20830,156998,1726
2022-09-02,Sutter,101,95872,23967,23927,2459,26386,228
2022-09-02,Tehama,103,63373,13456,13406,3050,16456,210
2022-09-02,Trinity,105,12862,1385,1377,376,1753,20
2022-09-02,Tulare,107,460477,120813,120592,35834,156426,1527
2022-09-02,Tuolumne,109,53932,15356,15294,918,16212,196
2022-09-02,Ventura,111,848112,206200,205627,15288,220915,1558
2022-09-02,Yolo,113,214977,46943,46882,4319,51201,334
2022-09-02,Yuba,115,75493,18664,18615,1677,20292,129
2022-09-01,Alameda,001,1643700,342265,341621,19544,361165,1998
2022-09-01,Alpine,003,1148,133,133,1,134,0
2022-09-01,Amador,005,37829,9882,9855,916,10771,89
2022-09-01,Butte,007,227075,38942,38851,8857,47708,453
2022-09-01,Calaveras,009,45235,8426,8422,520,8942,133
2022-09-01,Colusa,011,21464,3746,3742,1249,4991,22
2022-09-01,Contra Costa,013,1133247,246079,245022,20258,265280,1410
2022-09-01,Del Norte,015,27424,7348,7340,396,7736,56
2022-09-01,El Dorado,017,186661,31971,31929,4203,36132,229
2022-09-01,Fresno,019,978130,271562,271062,30310,301372,2835
2022-09-01,Glenn,021,27897,5464,5462,1851,7313,48
2022-09-01,Humboldt,023,135768,21434,21390,4901,26291,154
2022-09-01,Imperial,025,180216,64813,64678,15413,80091,956
2022-09-01,Inyo,027,18085,4453,4449,917,5366,59
2022-09-01,Kern,029,883053,217185,216471,59086,275557,2404
2022-09-01,Kings,031,150075,58886,58753,4042,62795,455
2022-09-01,Lake,033,64148,12632,12608,1158,13766,143
2022-09-01,Lassen,035,31185,9920,9908,979,10887,64
2022-09-01,Los Angeles,037,10098052,3243155,3235242,176280,3411522,32927
2022-09-01,Madera,039,155013,43520,43403,8141,51544,373
2022-09-01,Marin,041,260295,44476,44394,5222,49616,305
2022-09-01,Mariposa,043,17540,3048,3036,352,3388,31
2022-09-01,Mendocino,045,87422,15815,15781,4411,20192,134
2022-09-01,Merced,047,269075,71453,71280,11505,82785,856
2022-09-01,Modoc,049,8938,870,868,315,1183,11
2022-09-01,Mono,051,14174,3185,3183,244,3427,7
2022-09-01,Monterey,053,433212,93387,93246,20725,113971,761
2022-09-01,Napa,055,140530,31856,31799,1407,33206,156
2022-09-01,Nevada,057,99092,18754,18705,1794,20499,132
2022-09-01,Orange,059,3164182,660018,659290,60289,719579,7347
2022-09-01,Placer,061,380077,74885,74754,9293,84047,657
2022-09-01,Plumas,063,18699,3589,3587,431,4018,13
2022-09-01,Riverside,065,2383286,688844,687184,34778,721962,6581
2022-09-01,Sacramento,067,1510023,342177,341766,33166,374932,3243
2022-09-01,San Benito,069,59416,15952,15900,950,16850,103
2022-09-01,San Bernardino,071,2135413,663369,658354,30302,688656,8006
2022-09-01,San Diego,073,3302833,914047,912824,70267,983091,5464
2022-09-01,San Francisco,075,870044,176259,176131,11915,188046,1015
2022-09-01,San Joaquin,077,732212,195235,194904,14115,209019,2301
2022-09-01,San Luis Obispo,079,281455,62580,62455,7033,69488,517
2022-09-01,San Mateo,081,765935,165806,165520,10466,175986,738
2022-09-01,Santa Barbara,083,443738,104487,104161,6804,110965,716
2022-09-01,Santa Clara,085,1922200,425588,425040,18627,443667,2473
2022-09-01,Santa Cruz,087,273765,62241,61989,3385,65374,273
2022-09-01,Shasta,089,179085,34493,34422,7276,41698,591
2022-09-01,Sierra,091,2930,303,303,60,363,5
2022-09-01,Siskiyou,093,43540,5190,5168,3283,8451,89
2022-09-01,Solano,095,438530,103588,103457,7620,111077,461
2022-09-01,Sonoma,097,501317,105542,105162,5241,110403,517
2022-09-01,Stanislaus,099,539301,136406,136168,20816,156984,1726
2022-09-01,Sutter,101,95872,23949,23927,2456,26383,228
2022-09-01,Tehama,103,63373,13452,13406,3047,16453,210
2022-09-01,Trinity,105,12862,1384,1377,373,1750,20
2022-09-01,Tulare,107,460477,120762,120592,35791,156383,1527
2022-09-01,Tuolumne,109,53932,15348,15294,918,16212,196
2022-09-01,Ventura,111,848112,206059,205627,15269,220896,1558
2022-09-01,Yolo,113,214977,46916,46882,4312,51194,334
2022-09-01,Yuba,115,75493,18650,18615,1677,20292,129
2022-08-31,Alameda,001,1643700,342039,340789,19529,360318,1986
2022-08-31,Alpine,003,1148,133,133,1,134,0
2022-08-31,Amador,005,37829,9878,9829,914,10743,89
2022-08-31,Butte,007,227075,38907,38720,8839,47559,452
2022-08-31,Calaveras,009,45235,8422,8404,519,8923,133
2022-08-31,Colusa,011,21464,3745,3744,1249,4993,22
2022-08-31,Contra Costa,013,1133247,245924,244168,20232,264400,1409
2022-08-31,Del Norte,015,27424,7345,7333,396,7729,56
2022-08-31,El Dorado,017,186661,31964,31864,4197,36061,226
2022-08-31,Fresno,019,978130,271380,270456,30173,300629,2829
2022-08-31,Glenn,021,27897,5463,5448,1850,7298,48
2022-08-31,Humboldt,023,135768,21408,21325,4897,26222,154
2022-08-31,Imperial,025,180216,64784,64562,15393,79955,953
2022-08-31,Inyo,027,18085,4451,4444,916,5360,59
2022-08-31,Kern,029,883053,217074,216037,59023,275060,2404
2022-08-31,Kings,031,150075,58854,58629,4037,62666,455
2022-08-31,Lake,033,64148,12620,12563,1158,13721,142
2022-08-31,Lassen,035,31185,9915,9889,978,10867,64
2022-08-31,Los Angeles,037,10098052,3241419,3228552,176064,3404616,32877
2022-08-31,Madera,039,155013,43485,43269,8127,51396,372
2022-08-31,Marin,041,260295,44446,44330,5216,49546,305
2022-08-31,Mariposa,043,17540,3048,3025,351,3376,31
2022-08-31,Mendocino,045,87422,15808,15733,4406,20139,134
2022-08-31,Merced,047,269075,71425,71089,11480,82569,852
2022-08-31,Modoc,049,8938,868,865,315,1180,11
2022-08-31,Mono,051,14174,3185,3181,243,3424,7
2022-08-31,Monterey,053,433212,93345,93046,20705,113751,762
2022-08-31,Napa,055,140530,31840,31725,1405,33130,156
2022-08-31,Nevada,057,99092,18737,18649,1793,20442,132
2022-08-31,Orange,059,3164182,659615,658076,60203,718279,7340
2022-08-31,Placer,061,380077,74845,74612,9289,83901,657
2022-08-31,Plumas,063,18699,3588,3581,431,4012,13
2022-08-31,Riverside,065,2383286,688449,685704,34738,720442,6581
2022-08-31,Sacramento,067,1510023,341967,340949,33122,374071,3230
2022-08-31,San Benito,069,59416,15940,15860,948,16808,103
2022-08-31,San Bernardino,071,2135413,662948,656343,30262,686605,8014
2022-08-31,San Diego,073,3302833,913586,910878,70211,981089,5459
2022-08-31,San Francisco,075,870044,176186,175752,11904,187656,1001
2022-08-31,San Joaquin,077,732212,195077,194437,14099,208536,2298
2022-08-31,San Luis Obispo,079,281455,62554,62312,7020,69332,515
2022-08-31,San Mateo,081,765935,165702,165161,10459,175620,738
2022-08-31,Santa Barbara,083,443738,104408,103894,6795,110689,717
2022-08-31,Santa Clara,085,1922200,425290,424011,18610,442621,2467
2022-08-31,Santa Cruz,087,273765,62192,61812,3382,65194,272
2022-08-31,Shasta,089,179085,34479,34355,7268,41623,590
2022-08-31,Sierra,091,2930,303,302,60,362,5
2022-08-31,Siskiyou,093,43540,5182,5152,3282,8434,89
2022-08-31,Solano,095,438530,103524,103173,7617,110790,461
2022-08-31,Sonoma,097,501317,105470,104964,5230,110194,527
2022-08-31,Stanislaus,099,539301,136318,135801,20794,156595,1722
2022-08-31,Sutter,101,95872,23932,23856,2456,26312,228
2022-08-31,Tehama,103,63373,13438,13370,3042,16412,210
2022-08-31,Trinity,105,12862,1384,1373,373,1746,20
2022-08-31,Tulare,107,460477,120692,120346,35740,156086,1527
2022-08-31,Tuolumne,109,53932,15339,15250,916,16166,196
2022-08-31,Ventura,111,848112,205929,205157,15250,220407,1557
2022-08-31,Yolo,113,214977,46883,46807,4305,51112,334
2022-08-31,Yuba,115,75493,18629,18558,1673,20231,129
2022-08-30,Alameda,001,1643700,341793,340789,19510,360299,1986
2022-08-30,Alpine,003,1148,133,133,1,134,0
2022-08-30,Amador,005,37829,9867,9829,914,10743,89
2022-08-30,Butte,007,227075,38871,38720,8823,47543,452
2022-08-30,Calaveras,009,45235,8419,8404,517,8921,133
2022-08-30,Colusa,011,21464,3744,3744,1247,4991,22
2022-08-30,Contra Costa,013,1133247,245770,244168,20212,264380,1409
2022-08-30,Del Norte,015,27424,7344,7333,396,7729,56
2022-08-30,El Dorado,017,186661,31948,31864,4193,36057,226
2022-08-30,Fresno,019,978130,271185,270456,30073,300529,2829
2022-08-30,Glenn,021,27897,5463,5448,1849,7297,48
2022-08-30,Humboldt,023,135768,21389,21325,4893,26218,154
2022-08-30,Imperial,025,180216,64738,64562,15357,79919,953
2022-08-30,Inyo,027,18085,4450,4444,913,5357,59
2022-08-30,Kern,029,883053,216945,216037,58936,274973,2404
2022-08-30,Kings,031,150075,58800,58629,4033,62662,455
2022-08-30,Lake,033,64148,12610,12563,1157,13720,142
2022-08-30,Lassen,035,31185,9911,9889,978,10867,64
2022-08-30,Los Angeles,037,10098052,3239381,3228552,175817,3404369,32877
2022-08-30,Madera,039,155013,43435,43269,8111,51380,372
2022-08-30,Marin,041,260295,44414,44330,5211,49541,305
2022-08-30,Mariposa,043,17540,3046,3025,349,3374,31
2022-08-30,Mendocino,045,87422,15797,15733,4396,20129,134
2022-08-30,Merced,047,269075,71375,71089,11458,82547,852
2022-08-30,Modoc,049,8938,868,865,315,1180,11
2022-08-30,Mono,051,14174,3184,3181,243,3424,7
2022-08-30,Monterey,053,433212,93298,93046,20689,113735,762
2022-08-30,Napa,055,140530,31824,31725,1404,33129,156
2022-08-30,Nevada,057,99092,18719,18649,1773,20422,132
2022-08-30,Orange,059,3164182,659175,658076,60105,718181,7340
2022-08-30,Placer,061,380077,74811,74612,9283,83895,657
2022-08-30,Plumas,063,18699,3587,3581,431,4012,13
2022-08-30,Riverside,065,2383286,688007,685704,34701,720405,6581
2022-08-30,Sacramento,067,1510023,341772,340949,33080,374029,3230
2022-08-30,San Benito,069,59416,15926,15860,944,16804,103
2022-08-30,San Bernardino,071,2135413,662500,656343,30232,686575,8014
2022-08-30,San Diego,073,3302833,913057,910878,70118,980996,5459
2022-08-30,San Francisco,075,870044,176073,175752,11895,187647,1001
2022-08-30,San Joaquin,077,732212,194926,194437,14071,208508,2298
2022-08-30,San Luis Obispo,079,281455,62521,62312,7004,69316,515
2022-08-30,San Mateo,081,765935,165598,165161,10449,175610,738
2022-08-30,Santa Barbara,083,443738,104321,103894,6783,110677,717
2022-08-30,Santa Clara,085,1922200,424966,424011,18595,442606,2467
2022-08-30,Santa Cruz,087,273765,62144,61812,3373,65185,272
2022-08-30,Shasta,089,179085,34457,34355,7263,41618,590
2022-08-30,Sierra,091,2930,303,302,60,362,5
2022-08-30,Siskiyou,093,43540,5174,5152,3280,8432,89
2022-08-30,Solano,095,438530,103436,103173,7610,110783,461
2022-08-30,Sonoma,097,501317,105406,104964,5223,110187,527
2022-08-30,Stanislaus,099,539301,136212,135801,20779,156580,1722
2022-08-30,Sutter,101,95872,23914,23856,2456,26312,228
2022-08-30,Tehama,103,63373,13432,13370,3034,16404,210
2022-08-30,Trinity,105,12862,1383,1373,372,1745,20
2022-08-30,Tulare,107,460477,120610,120346,35685,156031,1527
2022-08-30,Tuolumne,109,53932,15324,15250,916,16166,196
2022-08-30,Ventura,111,848112,205780,205157,15209,220366,1557
2022-08-30,Yolo,113,214977,46863,46807,4300,51107,334
2022-08-30,Yuba,115,75493,18616,18558,1671,20229,129
2022-08-29,Alameda,001,1643700,341475,340789,19480,360269,1986
2022-08-29,Alpine,003,1148,133,133,1,134,0
2022-08-29,Amador,005,37829,9853,9829,913,10742,89
2022-08-29,Butte,007,227075,38830,38720,8805,47525,452
2022-08-29,Calaveras,009,45235,8418,8404,515,8919,133
2022-08-29,Colusa,011,21464,3744,3744,1247,4991,22
2022-08-29,Contra Costa,013,1133247,245589,244168,20185,264353,1409
2022-08-29,Del Norte,015,27424,7343,7333,396,7729,56
2022-08-29,El Dorado,017,186661,31932,31864,4187,36051,226
2022-08-29,Fresno,019,978130,270958,270456,30033,300489,2829
2022-08-29,Glenn,021,27897,5461,5448,1846,7294,48
2022-08-29,Humboldt,023,135768,21368,21325,4885,26210,154
2022-08-29,Imperial,025,180216,64696,64562,15317,79879,953
2022-08-29,Inyo,027,18085,4449,4444,909,5353,59
2022-08-29,Kern,029,883053,216779,216037,58848,274885,2404
2022-08-29,Kings,031,150075,58730,58629,4029,62658,455
2022-08-29,Lake,033,64148,12596,12563,1156,13719,142
2022-08-29,Lassen,035,31185,9905,9889,978,10867,64
2022-08-29,Los Angeles,037,10098052,3237184,3228552,175547,3404099,32877
2022-08-29,Madera,039,155013,43396,43269,8090,51359,372
2022-08-29,Marin,041,260295,44380,44330,5205,49535,305
2022-08-29,Mariposa,043,17540,3043,3025,347,3372,31
2022-08-29,Mendocino,045,87422,15784,15733,4383,20116,134
2022-08-29,Merced,047,269075,71318,71089,11425,82514,852
2022-08-29,Modoc,049,8938,867,865,314,1179,11
2022-08-29,Mono,051,14174,3183,3181,243,3424,7
2022-08-29,Monterey,053,433212,93262,93046,20659,113705,762
2022-08-29,Napa,055,140530,31804,31725,1404,33129,156
2022-08-29,Nevada,057,99092,18703,18649,1771,20420,132
2022-08-29,Orange,059,3164182,658737,658076,60022,718098,7340
2022-08-29,Placer,061,380077,74772,74612,9271,83883,657
2022-08-29,Plumas,063,18699,3586,3581,431,4012,13
2022-08-29,Riverside,065,2383286,687438,685704,34641,720345,6581
2022-08-29,Sacramento,067,1510023,341496,340949,33031,373980,3230
2022-08-29,San Benito,069,59416,15912,15860,942,16802,103
2022-08-29,San Bernardino,071,2135413,661931,656343,30197,686540,8014
2022-08-29,San Diego,073,3302833,912433,910878,70052,980930,5459
2022-08-29,San Francisco,075,870044,175973,175752,11886,187638,1001
2022-08-29,San Joaquin,077,732212,194786,194437,14049,208486,2298
2022-08-29,San Luis Obispo,079,281455,62494,62312,6991,69303,515
2022-08-29,San Mateo,081,765935,165490,165161,10441,175602,738
2022-08-29,Santa Barbara,083,443738,104242,103894,6773,110667,717
2022-08-29,Santa Clara,085,1922200,424575,424011,18569,442580,2467
2022-08-29,Santa Cruz,087,273765,62078,61812,3364,65176,272
2022-08-29,Shasta,089,179085,34439,34355,7249,41604,590
2022-08-29,Sierra,091,2930,303,302,60,362,5
2022-08-29,Siskiyou,093,43540,5170,5152,3279,8431,89
2022-08-29,Solano,095,438530,103357,103173,7600,110773,461
2022-08-29,Sonoma,097,501317,105325,104964,5216,110180,527
2022-08-29,Stanislaus,099,539301,136091,135801,20744,156545,1722
2022-08-29,Sutter,101,95872,23886,23856,2453,26309,228
2022-08-29,Tehama,103,63373,13423,13370,3033,16403,210
2022-08-29,Trinity,105,12862,1382,1373,372,1745,20
2022-08-29,Tulare,107,460477,120523,120346,35611,155957,1527
2022-08-29,Tuolumne,109,53932,15309,15250,916,16166,196
2022-08-29,Ventura,111,848112,205641,205157,15183,220340,1557
2022-08-29,Yolo,113,214977,46838,46807,4290,51097,334
2022-08-29,Yuba,115,75493,18599,18558,1666,20224,129
2022-08-28,Alameda,001,1643700,341151,339618,19455,359073,1978
2022-08-28,Alpine,003,1148,133,133,1,134,0
2022-08-28,Amador,005,37829,9846,9802,911,10713,89
2022-08-28,Butte,007,227075,38780,38606,8793,47399,452
2022-08-28,Calaveras,009,45235,8410,8368,514,8882,133
2022-08-28,Colusa,011,21464,3742,3736,1244,4980,22
2022-08-28,Contra Costa,013,1133247,245373,243331,20161,263492,1404
2022-08-28,Del Norte,015,27424,7338,7316,395,7711,55
2022-08-28,El Dorado,017,186661,31902,31760,4179,35939,226
2022-08-28,Fresno,019,978130,270714,269680,29976,299656,2829
2022-08-28,Glenn,021,27897,5458,5434,1844,7278,49
2022-08-28,Humboldt,023,135768,21345,21264,4869,26133,154
2022-08-28,Imperial,025,180216,64645,64391,15266,79657,953
2022-08-28,Inyo,027,18085,4448,4443,906,5349,59
2022-08-28,Kern,029,883053,216640,215612,58734,274346,2399
2022-08-28,Kings,031,150075,58673,58443,4018,62461,455
2022-08-28,Lake,033,64148,12584,12524,1153,13677,142
2022-08-28,Lassen,035,31185,9894,9871,978,10849,64
2022-08-28,Los Angeles,037,10098052,3234577,3219328,175208,3394536,32833
2022-08-28,Madera,039,155013,43347,43105,8057,51162,372
2022-08-28,Marin,041,260295,44348,44192,5196,49388,305
2022-08-28,Mariposa,043,17540,3037,3018,346,3364,31
2022-08-28,Mendocino,045,87422,15770,15698,4379,20077,134
2022-08-28,Merced,047,269075,71248,70906,11371,82277,851
2022-08-28,Modoc,049,8938,867,865,314,1179,11
2022-08-28,Mono,051,14174,3182,3181,243,3424,7
2022-08-28,Monterey,053,433212,93196,92844,20629,113473,760
2022-08-28,Napa,055,140530,31777,31668,1403,33071,156
2022-08-28,Nevada,057,99092,18683,18592,1770,20362,132
2022-08-28,Orange,059,3164182,658282,656440,59920,716360,7326
2022-08-28,Placer,061,380077,74729,74391,9258,83649,657
2022-08-28,Plumas,063,18699,3583,3571,431,4002,13
2022-08-28,Riverside,065,2383286,686808,683511,34573,718084,6580
2022-08-28,Sacramento,067,1510023,341173,339846,32957,372803,3222
2022-08-28,San Benito,069,59416,15899,15805,939,16744,103
2022-08-28,San Bernardino,071,2135413,661337,653843,30139,683982,8017
2022-08-28,San Diego,073,3302833,911687,908809,69958,978767,5456
2022-08-28,San Francisco,075,870044,175825,175204,11876,187080,1000
2022-08-28,San Joaquin,077,732212,194560,193880,14016,207896,2296
2022-08-28,San Luis Obispo,079,281455,62452,62105,6970,69075,515
2022-08-28,San Mateo,081,765935,165340,164675,10428,175103,738
2022-08-28,Santa Barbara,083,443738,104118,103496,6753,110249,717
2022-08-28,Santa Clara,085,1922200,424168,422650,18548,441198,2459
2022-08-28,Santa Cruz,087,273765,61981,61594,3347,64941,273
2022-08-28,Shasta,089,179085,34408,34283,7230,41513,590
2022-08-28,Sierra,091,2930,302,300,60,360,5
2022-08-28,Siskiyou,093,43540,5164,5140,3277,8417,89
2022-08-28,Solano,095,438530,103264,102855,7591,110446,460
2022-08-28,Sonoma,097,501317,105241,104646,5204,109850,557
2022-08-28,Stanislaus,099,539301,135941,135310,20715,156025,1722
2022-08-28,Sutter,101,95872,23859,23759,2450,26209,228
2022-08-28,Tehama,103,63373,13403,13340,3031,16371,210
2022-08-28,Trinity,105,12862,1382,1370,370,1740,20
2022-08-28,Tulare,107,460477,120411,119942,35501,155443,1527
2022-08-28,Tuolumne,109,53932,15303,15193,911,16104,196
2022-08-28,Ventura,111,848112,205449,204567,15109,219676,1553
2022-08-28,Yolo,113,214977,46790,46744,4277,51021,334
2022-08-28,Yuba,115,75493,18580,18482,1660,20142,129
2022-08-27,Alameda,001,1643700,340968,339618,19443,359061,1978
2022-08-27,Alpine,003,1148,133,133,1,134,0
2022-08-27,Amador,005,37829,9840,9802,910,10712,89
2022-08-27,Butte,007,227075,38752,38606,8780,47386,452
2022-08-27,Calaveras,009,45235,8405,8368,514,8882,133
2022-08-27,Colusa,011,21464,3741,3736,1241,4977,22
2022-08-27,Contra Costa,013,1133247,245236,243331,20150,263481,1404
2022-08-27,Del Norte,015,27424,7337,7316,394,7710,55
2022-08-27,El Dorado,017,186661,31891,31760,4175,35935,226
2022-08-27,Fresno,019,978130,270594,269680,29960,299640,2829
2022-08-27,Glenn,021,27897,5456,5434,1844,7278,49
2022-08-27,Humboldt,023,135768,21329,21264,4861,26125,154
2022-08-27,Imperial,025,180216,64622,64391,15256,79647,953
2022-08-27,Inyo,027,18085,4447,4443,906,5349,59
2022-08-27,Kern,029,883053,216559,215612,58683,274295,2399
2022-08-27,Kings,031,150075,58643,58443,4015,62458,455
2022-08-27,Lake,033,64148,12580,12524,1153,13677,142
2022-08-27,Lassen,035,31185,9890,9871,978,10849,64
2022-08-27,Los Angeles,037,10098052,3233318,3219328,175011,3394339,32833
2022-08-27,Madera,039,155013,43312,43105,8053,51158,372
2022-08-27,Marin,041,260295,44328,44192,5186,49378,305
2022-08-27,Mariposa,043,17540,3036,3018,345,3363,31
2022-08-27,Mendocino,045,87422,15764,15698,4377,20075,134
2022-08-27,Merced,047,269075,71206,70906,11363,82269,851
2022-08-27,Modoc,049,8938,867,865,314,1179,11
2022-08-27,Mono,051,14174,3182,3181,243,3424,7
2022-08-27,Monterey,053,433212,93165,92844,20613,113457,760
2022-08-27,Napa,055,140530,31761,31668,1401,33069,156
2022-08-27,Nevada,057,99092,18673,18592,1768,20360,132
2022-08-27,Orange,059,3164182,658024,656440,59821,716261,7326
2022-08-27,Placer,061,380077,74692,74391,9254,83645,657
2022-08-27,Plumas,063,18699,3582,3571,431,4002,13
2022-08-27,Riverside,065,2383286,686478,683511,34546,718057,6580
2022-08-27,Sacramento,067,1510023,341041,339846,32944,372790,3222
2022-08-27,San Benito,069,59416,15884,15805,934,16739,103
2022-08-27,San Bernardino,071,2135413,661035,653843,30108,683951,8017
2022-08-27,San Diego,073,3302833,911357,908809,69931,978740,5456
2022-08-27,San Francisco,075,870044,175752,175204,11869,187073,1000
2022-08-27,San Joaquin,077,732212,194503,193880,13995,207875,2296
2022-08-27,San Luis Obispo,079,281455,62437,62105,6963,69068,515
2022-08-27,San Mateo,081,765935,165248,164675,10422,175097,738
2022-08-27,Santa Barbara,083,443738,104056,103496,6742,110238,717
2022-08-27,Santa Clara,085,1922200,423956,422650,18535,441185,2459
2022-08-27,Santa Cruz,087,273765,61968,61594,3346,64940,273
2022-08-27,Shasta,089,179085,34398,34283,7224,41507,590
2022-08-27,Sierra,091,2930,302,300,60,360,5
2022-08-27,Siskiyou,093,43540,5162,5140,3277,8417,89
2022-08-27,Solano,095,438530,103229,102855,7584,110439,460
2022-08-27,Sonoma,097,501317,105199,104646,5201,109847,557
2022-08-27,Stanislaus,099,539301,135868,135310,20691,156001,1722
2022-08-27,Sutter,101,95872,23844,23759,2450,26209,228
2022-08-27,Tehama,103,63373,13397,13340,3030,16370,210
2022-08-27,Trinity,105,12862,1381,1370,369,1739,20
2022-08-27,Tulare,107,460477,120352,119942,35451,155393,1527
2022-08-27,Tuolumne,109,53932,15297,15193,909,16102,196
2022-08-27,Ventura,111,848112,205365,204567,15098,219665,1553
2022-08-27,Yolo,113,214977,46769,46744,4276,51020,334
2022-08-27,Yuba,115,75493,18568,18482,1659,20141,129
2022-08-26,Alameda,001,1643700,340804,339618,19433,359051,1978
2022-08-26,Alpine,003,1148,133,133,1,134,0
2022-08-26,Amador,005,37829,9837,9802,908,10710,89
2022-08-26,Butte,007,227075,38737,38606,8768,47374,452
2022-08-26,Calaveras,009,45235,8400,8368,514,8882,133
2022-08-26,Colusa,011,21464,3740,3736,1241,4977,22
2022-08-26,Contra Costa,013,1133247,245083,243331,20141,263472,1404
2022-08-26,Del Norte,015,27424,7335,7316,394,7710,55
2022-08-26,El Dorado,017,186661,31870,31760,4174,35934,226
2022-08-26,Fresno,019,978130,270440,269680,29921,299601,2829
2022-08-26,Glenn,021,27897,5453,5434,1842,7276,49
2022-08-26,Humboldt,023,135768,21323,21264,4858,26122,154
2022-08-26,Imperial,025,180216,64599,64391,15241,79632,953
2022-08-26,Inyo,027,18085,4446,4443,899,5342,59
2022-08-26,Kern,029,883053,216472,215612,58625,274237,2399
2022-08-26,Kings,031,150075,58629,58443,4014,62457,455
2022-08-26,Lake,033,64148,12572,12524,1152,13676,142
2022-08-26,Lassen,035,31185,9888,9871,978,10849,64
2022-08-26,Los Angeles,037,10098052,3231923,3219328,174814,3394142,32833
2022-08-26,Madera,039,155013,43282,43105,8046,51151,372
2022-08-26,Marin,041,260295,44296,44192,5182,49374,305
2022-08-26,Mariposa,043,17540,3032,3018,340,3358,31
2022-08-26,Mendocino,045,87422,15758,15698,4375,20073,134
2022-08-26,Merced,047,269075,71169,70906,11354,82260,851
2022-08-26,Modoc,049,8938,866,865,314,1179,11
2022-08-26,Mono,051,14174,3182,3181,243,3424,7
2022-08-26,Monterey,053,433212,93127,92844,20596,113440,760
2022-08-26,Napa,055,140530,31748,31668,1400,33068,156
2022-08-26,Nevada,057,99092,18660,18592,1765,20357,132
2022-08-26,Orange,059,3164182,657765,656440,59762,716202,7326
2022-08-26,Placer,061,380077,74657,74391,9243,83634,657
2022-08-26,Plumas,063,18699,3581,3571,431,4002,13
2022-08-26,Riverside,065,2383286,686128,683511,34508,718019,6580
2022-08-26,Sacramento,067,1510023,340859,339846,32934,372780,3222
2022-08-26,San Benito,069,59416,15873,15805,934,16739,103
2022-08-26,San Bernardino,071,2135413,660729,653843,30084,683927,8017
2022-08-26,San Diego,073,3302833,910931,908809,69911,978720,5456
2022-08-26,San Francisco,075,870044,175668,175204,11863,187067,1000
2022-08-26,San Joaquin,077,732212,194430,193880,13977,207857,2296
2022-08-26,San Luis Obispo,079,281455,62415,62105,6958,69063,515
2022-08-26,San Mateo,081,765935,165159,164675,10415,175090,738
2022-08-26,Santa Barbara,083,443738,104004,103496,6736,110232,717
2022-08-26,Santa Clara,085,1922200,423745,422650,18523,441173,2459
2022-08-26,Santa Cruz,087,273765,61921,61594,3342,64936,273
2022-08-26,Shasta,089,179085,34386,34283,7220,41503,590
2022-08-26,Sierra,091,2930,302,300,60,360,5
2022-08-26,Siskiyou,093,43540,5159,5140,3277,8417,89
2022-08-26,Solano,095,438530,103171,102855,7574,110429,460
2022-08-26,Sonoma,097,501317,105157,104646,5199,109845,557
2022-08-26,Stanislaus,099,539301,135791,135310,20683,155993,1722
2022-08-26,Sutter,101,95872,23825,23759,2449,26208,228
2022-08-26,Tehama,103,63373,13386,13340,3028,16368,210
2022-08-26,Trinity,105,12862,1381,1370,369,1739,20
2022-08-26,Tulare,107,460477,120294,119942,35400,155342,1527
2022-08-26,Tuolumne,109,53932,15285,15193,909,16102,196
2022-08-26,Ventura,111,848112,205286,204567,15081,219648,1553
2022-08-26,Yolo,113,214977,46757,46744,4272,51016,334
2022-08-26,Yuba,115,75493,18555,18482,1659,20141,129
2022-08-25,Alameda,001,1643700,340515,339618,19405,359023,1978
2022-08-25,Alpine,003,1148,133,133,1,134,0
2022-08-25,Amador,005,37829,9830,9802,908,10710,89
2022-08-25,Butte,007,227075,38714,38606,8760,47366,452
2022-08-25,Calaveras,009,45235,8394,8368,514,8882,133
2022-08-25,Colusa,011,21464,3740,3736,1240,4976,22
2022-08-25,Contra Costa,013,1133247,244887,243331,20114,263445,1404
2022-08-25,Del Norte,015,27424,7326,7316,394,7710,55
2022-08-25,El Dorado,017,186661,31850,31760,4168,35928,226
2022-08-25,Fresno,019,978130,270242,269680,29875,299555,2829
2022-08-25,Glenn,021,27897,5448,5434,1841,7275,49
2022-08-25,Humboldt,023,135768,21302,21264,4847,26111,154
2022-08-25,Imperial,025,180216,64558,64391,15211,79602,953
2022-08-25,Inyo,027,18085,4446,4443,892,5335,59
2022-08-25,Kern,029,883053,216334,215612,58552,274164,2399
2022-08-25,Kings,031,150075,58571,58443,4006,62449,455
2022-08-25,Lake,033,64148,12559,12524,1149,13673,142
2022-08-25,Lassen,035,31185,9887,9871,977,10848,64
2022-08-25,Los Angeles,037,10098052,3229799,3219328,174529,3393857,32833
2022-08-25,Madera,039,155013,43235,43105,8031,51136,372
2022-08-25,Marin,041,260295,44268,44192,5174,49366,305
2022-08-25,Mariposa,043,17540,3030,3018,340,3358,31
2022-08-25,Mendocino,045,87422,15749,15698,4374,20072,134
2022-08-25,Merced,047,269075,71126,70906,11320,82226,851
2022-08-25,Modoc,049,8938,866,865,314,1179,11
2022-08-25,Mono,051,14174,3182,3181,243,3424,7
2022-08-25,Monterey,053,433212,93075,92844,20574,113418,760
2022-08-25,Napa,055,140530,31730,31668,1399,33067,156
2022-08-25,Nevada,057,99092,18638,18592,1761,20353,132
2022-08-25,Orange,059,3164182,657362,656440,59682,716122,7326
2022-08-25,Placer,061,380077,74606,74391,9235,83626,657
2022-08-25,Plumas,063,18699,3579,3571,431,4002,13
2022-08-25,Riverside,065,2383286,685607,683511,34457,717968,6580
2022-08-25,Sacramento,067,1510023,340590,339846,32892,372738,3222
2022-08-25,San Benito,069,59416,15861,15805,932,16737,103
2022-08-25,San Bernardino,071,2135413,660209,653843,30052,683895,8017
2022-08-25,San Diego,073,3302833,910396,908809,69840,978649,5456
2022-08-25,San Francisco,075,870044,175557,175204,11858,187062,1000
2022-08-25,San Joaquin,077,732212,194284,193880,13952,207832,2296
2022-08-25,San Luis Obispo,079,281455,62316,62105,6946,69051,515
2022-08-25,San Mateo,081,765935,165030,164675,10407,175082,738
2022-08-25,Santa Barbara,083,443738,103910,103496,6720,110216,717
2022-08-25,Santa Clara,085,1922200,423437,422650,18502,441152,2459
2022-08-25,Santa Cruz,087,273765,61863,61594,3337,64931,273
2022-08-25,Shasta,089,179085,34367,34283,7209,41492,590
2022-08-25,Sierra,091,2930,302,300,60,360,5
2022-08-25,Siskiyou,093,43540,5154,5140,3272,8412,89
2022-08-25,Solano,095,438530,103088,102855,7565,110420,460
2022-08-25,Sonoma,097,501317,105081,104646,5192,109838,557
2022-08-25,Stanislaus,099,539301,135666,135310,20661,155971,1722
2022-08-25,Sutter,101,95872,23802,23759,2447,26206,228
2022-08-25,Tehama,103,63373,13379,13340,3020,16360,210
2022-08-25,Trinity,105,12862,1381,1370,368,1738,20
2022-08-25,Tulare,107,460477,120201,119942,35327,155269,1527
2022-08-25,Tuolumne,109,53932,15267,15193,908,16101,196
2022-08-25,Ventura,111,848112,205134,204567,15031,219598,1553
2022-08-25,Yolo,113,214977,46729,46744,4266,51010,334
2022-08-25,Yuba,115,75493,18536,18482,1656,20138,129
2022-08-24,Alameda,001,1643700,340208,338591,19378,357969,1976
2022-08-24,Alpine,003,1148,133,131,1,132,0
2022-08-24,Amador,005,37829,9823,9786,905,10691,89
2022-08-24,Butte,007,227075,38676,38458,8743,47201,449
2022-08-24,Calaveras,009,45235,8379,8334,513,8847,132
2022-08-24,Colusa,011,21464,3740,3722,1239,4961,22
2022-08-24,Contra Costa,013,1133247,244700,242633,20085,262718,1399
2022-08-24,Del Norte,015,27424,7322,7308,392,7700,55
2022-08-24,El Dorado,017,186661,31836,31682,4162,35844,225
2022-08-24,Fresno,019,978130,270052,269025,29819,298844,2822
2022-08-24,Glenn,021,27897,5446,5423,1841,7264,48
2022-08-24,Humboldt,023,135768,21281,21195,4836,26031,153
2022-08-24,Imperial,025,180216,64522,64271,15193,79464,951
2022-08-24,Inyo,027,18085,4445,4440,891,5331,59
2022-08-24,Kern,029,883053,216187,215225,58469,273694,2399
2022-08-24,Kings,031,150075,58519,58324,4002,62326,454
2022-08-24,Lake,033,64148,12551,12476,1145,13621,142
2022-08-24,Lassen,035,31185,9884,9867,974,10841,64
2022-08-24,Los Angeles,037,10098052,3227461,3211321,174248,3385569,32783
2022-08-24,Madera,039,155013,43196,42984,8003,50987,372
2022-08-24,Marin,041,260295,44234,44082,5163,49245,305
2022-08-24,Mariposa,043,17540,3030,3010,340,3350,31
2022-08-24,Mendocino,045,87422,15738,15623,4364,19987,134
2022-08-24,Merced,047,269075,71078,70665,11288,81953,849
2022-08-24,Modoc,049,8938,866,864,313,1177,11
2022-08-24,Mono,051,14174,3182,3181,241,3422,7
2022-08-24,Monterey,053,433212,93015,92590,20531,113121,760
2022-08-24,Napa,055,140530,31720,31602,1397,32999,156
2022-08-24,Nevada,057,99092,18622,18565,1758,20323,132
2022-08-24,Orange,059,3164182,656918,654893,59593,714486,7312
2022-08-24,Placer,061,380077,74547,74226,9230,83456,657
2022-08-24,Plumas,063,18699,3575,3555,431,3986,13
2022-08-24,Riverside,065,2383286,685075,681805,34399,716204,6573
2022-08-24,Sacramento,067,1510023,340310,339009,32854,371863,3208
2022-08-24,San Benito,069,59416,15839,15745,929,16674,103
2022-08-24,San Bernardino,071,2135413,659711,651496,30009,681505,8018
2022-08-24,San Diego,073,3302833,909838,906885,69777,976662,5453
2022-08-24,San Francisco,075,870044,175419,174731,11853,186584,974
2022-08-24,San Joaquin,077,732212,194135,193370,13924,207294,2288
2022-08-24,San Luis Obispo,079,281455,62277,61962,6933,68895,515
2022-08-24,San Mateo,081,765935,164916,164307,10402,174709,738
2022-08-24,Santa Barbara,083,443738,103835,103237,6702,109939,716
2022-08-24,Santa Clara,085,1922200,423094,421483,18489,439972,2454
2022-08-24,Santa Cruz,087,273765,61836,61387,3331,64718,270
2022-08-24,Shasta,089,179085,34353,34180,7196,41376,589
2022-08-24,Sierra,091,2930,302,301,60,361,5
2022-08-24,Siskiyou,093,43540,5150,5133,3271,8404,88
2022-08-24,Solano,095,438530,103002,102631,7555,110186,459
2022-08-24,Sonoma,097,501317,105002,104444,5191,109635,520
2022-08-24,Stanislaus,099,539301,135537,134894,20637,155531,1720
2022-08-24,Sutter,101,95872,23769,23673,2446,26119,228
2022-08-24,Tehama,103,63373,13374,13312,3016,16328,209
2022-08-24,Trinity,105,12862,1380,1369,368,1737,20
2022-08-24,Tulare,107,460477,120097,119644,35225,154869,1525
2022-08-24,Tuolumne,109,53932,15257,15140,908,16048,196
2022-08-24,Ventura,111,848112,204969,204064,14988,219052,1551
2022-08-24,Yolo,113,214977,46700,46665,4258,50923,333
2022-08-24,Yuba,115,75493,18511,18425,1650,20075,129
2022-08-23,Alameda,001,1643700,339890,338591,19355,357946,1976
2022-08-23,Alpine,003,1148,133,131,1,132,0
2022-08-23,Amador,005,37829,9812,9786,904,10690,89
2022-08-23,Butte,007,227075,38645,38458,8722,47180,449
2022-08-23,Calaveras,009,45235,8370,8334,509,8843,132
2022-08-23,Colusa,011,21464,3737,3722,1239,4961,22
2022-08-23,Contra Costa,013,1133247,244503,242633,20052,262685,1399
2022-08-23,Del Norte,015,27424,7318,7308,392,7700,55
2022-08-23,El Dorado,017,186661,31816,31682,4159,35841,225
2022-08-23,Fresno,019,978130,269802,269025,29759,298784,2822
2022-08-23,Glenn,021,27897,5439,5423,1840,7263,48
2022-08-23,Humboldt,023,135768,21268,21195,4824,26019,153
2022-08-23,Imperial,025,180216,64480,64271,15175,79446,951
2022-08-23,Inyo,027,18085,4445,4440,883,5323,59
2022-08-23,Kern,029,883053,216058,215225,58371,273596,2399
2022-08-23,Kings,031,150075,58468,58324,3997,62321,454
2022-08-23,Lake,033,64148,12531,12476,1144,13620,142
2022-08-23,Lassen,035,31185,9880,9867,974,10841,64
2022-08-23,Los Angeles,037,10098052,3224825,3211321,173936,3385257,32783
2022-08-23,Madera,039,155013,43150,42984,7980,50964,372
2022-08-23,Marin,041,260295,44204,44082,5159,49241,305
2022-08-23,Mariposa,043,17540,3027,3010,335,3345,31
2022-08-23,Mendocino,045,87422,15721,15623,4356,19979,134
2022-08-23,Merced,047,269075,71023,70665,11245,81910,849
2022-08-23,Modoc,049,8938,866,864,313,1177,11
2022-08-23,Mono,051,14174,3182,3181,241,3422,7
2022-08-23,Monterey,053,433212,92946,92590,20485,113075,760
2022-08-23,Napa,055,140530,31703,31602,1397,32999,156
2022-08-23,Nevada,057,99092,18608,18565,1750,20315,132
2022-08-23,Orange,059,3164182,656413,654893,59485,714378,7312
2022-08-23,Placer,061,380077,74483,74226,9216,83442,657
2022-08-23,Plumas,063,18699,3569,3555,431,3986,13
2022-08-23,Riverside,065,2383286,684460,681805,34333,716138,6573
2022-08-23,Sacramento,067,1510023,339989,339009,32800,371809,3208
2022-08-23,San Benito,069,59416,15816,15745,925,16670,103
2022-08-23,San Bernardino,071,2135413,659106,651496,29950,681446,8018
2022-08-23,San Diego,073,3302833,909217,906885,69707,976592,5453
2022-08-23,San Francisco,075,870044,175269,174731,11843,186574,974
2022-08-23,San Joaquin,077,732212,193985,193370,13883,207253,2288
2022-08-23,San Luis Obispo,079,281455,62233,61962,6916,68878,515
2022-08-23,San Mateo,081,765935,164795,164307,10398,174705,738
2022-08-23,Santa Barbara,083,443738,103747,103237,6685,109922,716
2022-08-23,Santa Clara,085,1922200,422724,421483,18474,439957,2454
2022-08-23,Santa Cruz,087,273765,61783,61387,3328,64715,270
2022-08-23,Shasta,089,179085,34331,34180,7188,41368,589
2022-08-23,Sierra,091,2930,302,301,60,361,5
2022-08-23,Siskiyou,093,43540,5150,5133,3270,8403,88
2022-08-23,Solano,095,438530,102910,102631,7549,110180,459
2022-08-23,Sonoma,097,501317,104919,104444,5180,109624,520
2022-08-23,Stanislaus,099,539301,135417,134894,20594,155488,1720
2022-08-23,Sutter,101,95872,23750,23673,2441,26114,228
2022-08-23,Tehama,103,63373,13364,13312,3014,16326,209
2022-08-23,Trinity,105,12862,1378,1369,368,1737,20
2022-08-23,Tulare,107,460477,119986,119644,35121,154765,1525
2022-08-23,Tuolumne,109,53932,15242,15140,907,16047,196
2022-08-23,Ventura,111,848112,204799,204064,14951,219015,1551
2022-08-23,Yolo,113,214977,46674,46665,4256,50921,333
2022-08-23,Yuba,115,75493,18490,18425,1646,20071,129
2022-08-22,Alameda,001,1643700,339525,338591,19329,357920,1976
2022-08-22,Alpine,003,1148,133,131,1,132,0
2022-08-22,Amador,005,37829,9807,9786,903,10689,89
2022-08-22,Butte,007,227075,38596,38458,8704,47162,449
2022-08-22,Calaveras,009,45235,8359,8334,507,8841,132
2022-08-22,Colusa,011,21464,3735,3722,1236,4958,22
2022-08-22,Contra Costa,013,1133247,244262,242633,20008,262641,1399
2022-08-22,Del Norte,015,27424,7317,7308,392,7700,55
2022-08-22,El Dorado,017,186661,31790,31682,4155,35837,225
2022-08-22,Fresno,019,978130,269564,269025,29674,298699,2822
2022-08-22,Glenn,021,27897,5438,5423,1838,7261,48
2022-08-22,Humboldt,023,135768,21247,21195,4809,26004,153
2022-08-22,Imperial,025,180216,64406,64271,15133,79404,951
2022-08-22,Inyo,027,18085,4443,4440,883,5323,59
2022-08-22,Kern,029,883053,215909,215225,58239,273464,2399
2022-08-22,Kings,031,150075,58416,58324,3988,62312,454
2022-08-22,Lake,033,64148,12510,12476,1138,13614,142
2022-08-22,Lassen,035,31185,9878,9867,974,10841,64
2022-08-22,Los Angeles,037,10098052,3221904,3211321,173615,3384936,32783
2022-08-22,Madera,039,155013,43097,42984,7954,50938,372
2022-08-22,Marin,041,260295,44173,44082,5150,49232,305
2022-08-22,Mariposa,043,17540,3020,3010,333,3343,31
2022-08-22,Mendocino,045,87422,15701,15623,4338,19961,134
2022-08-22,Merced,047,269075,70948,70665,11202,81867,849
2022-08-22,Modoc,049,8938,866,864,313,1177,11
2022-08-22,Mono,051,14174,3182,3181,241,3422,7
2022-08-22,Monterey,053,433212,92872,92590,20435,113025,760
2022-08-22,Napa,055,140530,31677,31602,1394,32996,156
2022-08-22,Nevada,057,99092,18590,18565,1745,20310,132
2022-08-22,Orange,059,3164182,655832,654893,59373,714266,7312
2022-08-22,Placer,061,380077,74410,74226,9206,83432,657
2022-08-22,Plumas,063,18699,3568,3555,431,3986,13
2022-08-22,Riverside,065,2383286,683800,681805,34262,716067,6573
2022-08-22,Sacramento,067,1510023,339645,339009,32723,371732,3208
2022-08-22,San Benito,069,59416,15796,15745,923,16668,103
2022-08-22,San Bernardino,071,2135413,658379,651496,29888,681384,8018
2022-08-22,San Diego,073,3302833,908540,906885,69595,976480,5453
2022-08-22,San Francisco,075,870044,175121,174731,11831,186562,974
2022-08-22,San Joaquin,077,732212,193810,193370,13842,207212,2288
2022-08-22,San Luis Obispo,079,281455,62183,61962,6901,68863,515
2022-08-22,San Mateo,081,765935,164655,164307,10386,174693,738
2022-08-22,Santa Barbara,083,443738,103625,103237,6667,109904,716
2022-08-22,Santa Clara,085,1922200,422297,421483,18447,439930,2454
2022-08-22,Santa Cruz,087,273765,61701,61387,3324,64711,270
2022-08-22,Shasta,089,179085,34316,34180,7178,41358,589
2022-08-22,Sierra,091,2930,302,301,60,361,5
2022-08-22,Siskiyou,093,43540,5146,5133,3268,8401,88
2022-08-22,Solano,095,438530,102823,102631,7537,110168,459
2022-08-22,Sonoma,097,501317,104841,104444,5164,109608,520
2022-08-22,Stanislaus,099,539301,135256,134894,20556,155450,1720
2022-08-22,Sutter,101,95872,23716,23673,2440,26113,228
2022-08-22,Tehama,103,63373,13358,13312,3011,16323,209
2022-08-22,Trinity,105,12862,1376,1369,365,1734,20
2022-08-22,Tulare,107,460477,119860,119644,35017,154661,1525
2022-08-22,Tuolumne,109,53932,15219,15140,907,16047,196
2022-08-22,Ventura,111,848112,204640,204064,14878,218942,1551
2022-08-22,Yolo,113,214977,46635,46665,4247,50912,333
2022-08-22,Yuba,115,75493,18463,18425,1642,20067,129
2022-08-21,Alameda,001,1643700,339097,337238,19306,356544,1970
2022-08-21,Alpine,003,1148,132,131,1,132,0
2022-08-21,Amador,005,37829,9800,9761,898,10659,89
2022-08-21,Butte,007,227075,38551,38316,8686,47002,449
2022-08-21,Calaveras,009,45235,8346,8313,505,8818,132
2022-08-21,Colusa,011,21464,3730,3718,1230,4948,22
2022-08-21,Contra Costa,013,1133247,243981,241665,19971,261636,1399
2022-08-21,Del Norte,015,27424,7310,7290,391,7681,55
2022-08-21,El Dorado,017,186661,31759,31600,4149,35749,225
2022-08-21,Fresno,019,978130,269291,268147,29594,297741,2822
2022-08-21,Glenn,021,27897,5434,5413,1837,7250,48
2022-08-21,Humboldt,023,135768,21223,21104,4791,25895,153
2022-08-21,Imperial,025,180216,64347,64092,15091,79183,951
2022-08-21,Inyo,027,18085,4443,4435,879,5314,59
2022-08-21,Kern,029,883053,215720,214656,58092,272748,2389
2022-08-21,Kings,031,150075,58345,58109,3977,62086,454
2022-08-21,Lake,033,64148,12489,12426,1133,13559,142
2022-08-21,Lassen,035,31185,9872,9843,974,10817,64
2022-08-21,Los Angeles,037,10098052,3218704,3200023,173241,3373264,32746
2022-08-21,Madera,039,155013,43046,42822,7916,50738,372
2022-08-21,Marin,041,260295,44125,43966,5128,49094,305
2022-08-21,Mariposa,043,17540,3019,3003,332,3335,31
2022-08-21,Mendocino,045,87422,15670,15578,4315,19893,134
2022-08-21,Merced,047,269075,70855,70449,11132,81581,846
2022-08-21,Modoc,049,8938,865,862,313,1175,11
2022-08-21,Mono,051,14174,3182,3177,239,3416,7
2022-08-21,Monterey,053,433212,92771,92287,20378,112665,760
2022-08-21,Napa,055,140530,31655,31534,1393,32927,156
2022-08-21,Nevada,057,99092,18579,18497,1740,20237,132
2022-08-21,Orange,059,3164182,655185,652703,59242,711945,7280
2022-08-21,Placer,061,380077,74350,74027,9201,83228,657
2022-08-21,Plumas,063,18699,3561,3550,431,3981,13
2022-08-21,Riverside,065,2383286,682971,679298,34177,713475,6574
2022-08-21,Sacramento,067,1510023,339275,337745,32653,370398,3208
2022-08-21,San Benito,069,59416,15774,15698,920,16618,103
2022-08-21,San Bernardino,071,2135413,657554,648583,29830,678413,8014
2022-08-21,San Diego,073,3302833,907684,904015,69523,973538,5448
2022-08-21,San Francisco,075,870044,174921,174151,11812,185963,973
2022-08-21,San Joaquin,077,732212,193565,192738,13808,206546,2288
2022-08-21,San Luis Obispo,079,281455,62134,61764,6873,68637,516
2022-08-21,San Mateo,081,765935,164499,163705,10378,174083,738
2022-08-21,Santa Barbara,083,443738,103498,102795,6640,109435,713
2022-08-21,Santa Clara,085,1922200,421773,419723,18415,438138,2437
2022-08-21,Santa Cruz,087,273765,61586,61098,3319,64417,269
2022-08-21,Shasta,089,179085,34278,34105,7163,41268,588
2022-08-21,Sierra,091,2930,302,298,60,358,4
2022-08-21,Siskiyou,093,43540,5145,5119,3261,8380,88
2022-08-21,Solano,095,438530,102739,102355,7526,109881,457
2022-08-21,Sonoma,097,501317,104735,104090,5150,109240,511
2022-08-21,Stanislaus,099,539301,135091,134407,20486,154893,1719
2022-08-21,Sutter,101,95872,23683,23587,2433,26020,228
2022-08-21,Tehama,103,63373,13347,13289,3007,16296,209
2022-08-21,Trinity,105,12862,1374,1366,364,1730,20
2022-08-21,Tulare,107,460477,119736,119251,34863,154114,1521
2022-08-21,Tuolumne,109,53932,15203,15085,905,15990,196
2022-08-21,Ventura,111,848112,204415,203318,14805,218123,1547
2022-08-21,Yolo,113,214977,46595,46567,4242,50809,333
2022-08-21,Yuba,115,75493,18441,18363,1635,19998,129
2022-08-20,Alameda,001,1643700,338887,337238,19289,356527,1970
2022-08-20,Alpine,003,1148,132,131,1,132,0
2022-08-20,Amador,005,37829,9797,9761,898,10659,89
2022-08-20,Butte,007,227075,38522,38316,8681,46997,449
2022-08-20,Calaveras,009,45235,8343,8313,504,8817,132
2022-08-20,Colusa,011,21464,3726,3718,1224,4942,22
2022-08-20,Contra Costa,013,1133247,243846,241665,19956,261621,1399
2022-08-20,Del Norte,015,27424,7309,7290,391,7681,55
2022-08-20,El Dorado,017,186661,31740,31600,4147,35747,225
2022-08-20,Fresno,019,978130,269146,268147,29570,297717,2822
2022-08-20,Glenn,021,27897,5431,5413,1837,7250,48
2022-08-20,Humboldt,023,135768,21207,21104,4776,25880,153
2022-08-20,Imperial,025,180216,64313,64092,15071,79163,951
2022-08-20,Inyo,027,18085,4443,4435,879,5314,59
2022-08-20,Kern,029,883053,215629,214656,58016,272672,2389
2022-08-20,Kings,031,150075,58318,58109,3972,62081,454
2022-08-20,Lake,033,64148,12480,12426,1129,13555,142
2022-08-20,Lassen,035,31185,9869,9843,973,10816,64
2022-08-20,Los Angeles,037,10098052,3217194,3200023,173029,3373052,32746
2022-08-20,Madera,039,155013,43023,42822,7909,50731,372
2022-08-20,Marin,041,260295,44107,43966,5126,49092,305
2022-08-20,Mariposa,043,17540,3019,3003,332,3335,31
2022-08-20,Mendocino,045,87422,15656,15578,4312,19890,134
2022-08-20,Merced,047,269075,70831,70449,11124,81573,846
2022-08-20,Modoc,049,8938,865,862,313,1175,11
2022-08-20,Mono,051,14174,3182,3177,238,3415,7
2022-08-20,Monterey,053,433212,92726,92287,20350,112637,760
2022-08-20,Napa,055,140530,31647,31534,1393,32927,156
2022-08-20,Nevada,057,99092,18576,18497,1738,20235,132
2022-08-20,Orange,059,3164182,654868,652703,59160,711863,7280
2022-08-20,Placer,061,380077,74303,74027,9195,83222,657
2022-08-20,Plumas,063,18699,3561,3550,431,3981,13
2022-08-20,Riverside,065,2383286,682552,679298,34146,713444,6574
2022-08-20,Sacramento,067,1510023,339111,337745,32635,370380,3208
2022-08-20,San Benito,069,59416,15755,15698,917,16615,103
2022-08-20,San Bernardino,071,2135413,657148,648583,29789,678372,8014
2022-08-20,San Diego,073,3302833,907311,904015,69498,973513,5448
2022-08-20,San Francisco,075,870044,174800,174151,11811,185962,973
2022-08-20,San Joaquin,077,732212,193466,192738,13783,206521,2288
2022-08-20,San Luis Obispo,079,281455,62116,61764,6865,68629,516
2022-08-20,San Mateo,081,765935,164399,163705,10374,174079,738
2022-08-20,Santa Barbara,083,443738,103429,102795,6631,109426,713
2022-08-20,Santa Clara,085,1922200,421506,419723,18399,438122,2437
2022-08-20,Santa Cruz,087,273765,61558,61098,3313,64411,269
2022-08-20,Shasta,089,179085,34253,34105,7161,41266,588
2022-08-20,Sierra,091,2930,302,298,60,358,4
2022-08-20,Siskiyou,093,43540,5140,5119,3260,8379,88
2022-08-20,Solano,095,438530,102693,102355,7519,109874,457
2022-08-20,Sonoma,097,501317,104686,104090,5145,109235,511
2022-08-20,Stanislaus,099,539301,135002,134407,20469,154876,1719
2022-08-20,Sutter,101,95872,23655,23587,2433,26020,228
2022-08-20,Tehama,103,63373,13342,13289,3004,16293,209
2022-08-20,Trinity,105,12862,1374,1366,364,1730,20
2022-08-20,Tulare,107,460477,119656,119251,34810,154061,1521
2022-08-20,Tuolumne,109,53932,15194,15085,903,15988,196
2022-08-20,Ventura,111,848112,204306,203318,14792,218110,1547
2022-08-20,Yolo,113,214977,46567,46567,4234,50801,333
2022-08-20,Yuba,115,75493,18434,18363,1634,19997,129
2022-08-19,Alameda,001,1643700,338679,337238,19266,356504,1970
2022-08-19,Alpine,003,1148,132,131,1,132,0
2022-08-19,Amador,005,37829,9796,9761,898,10659,89
2022-08-19,Butte,007,227075,38501,38316,8670,46986,449
2022-08-19,Calaveras,009,45235,8338,8313,504,8817,132
2022-08-19,Colusa,011,21464,3725,3718,1223,4941,22
2022-08-19,Contra Costa,013,1133247,243705,241665,19942,261607,1399
2022-08-19,Del Norte,015,27424,7304,7290,391,7681,55
2022-08-19,El Dorado,017,186661,31728,31600,4143,35743,225
2022-08-19,Fresno,019,978130,268986,268147,29545,297692,2822
2022-08-19,Glenn,021,27897,5430,5413,1837,7250,48
2022-08-19,Humboldt,023,135768,21197,21104,4765,25869,153
2022-08-19,Imperial,025,180216,64285,64092,15056,79148,951
2022-08-19,Inyo,027,18085,4443,4435,875,5310,59
2022-08-19,Kern,029,883053,215540,214656,57941,272597,2389
2022-08-19,Kings,031,150075,58275,58109,3965,62074,454
2022-08-19,Lake,033,64148,12468,12426,1126,13552,142
2022-08-19,Lassen,035,31185,9866,9843,973,10816,64
2022-08-19,Los Angeles,037,10098052,3215419,3200023,172818,3372841,32746
2022-08-19,Madera,039,155013,43000,42822,7905,50727,372
2022-08-19,Marin,041,260295,44072,43966,5120,49086,305
2022-08-19,Mariposa,043,17540,3017,3003,332,3335,31
2022-08-19,Mendocino,045,87422,15644,15578,4303,19881,134
2022-08-19,Merced,047,269075,70792,70449,11119,81568,846
2022-08-19,Modoc,049,8938,865,862,313,1175,11
2022-08-19,Mono,051,14174,3182,3177,238,3415,7
2022-08-19,Monterey,053,433212,92672,92287,20320,112607,760
2022-08-19,Napa,055,140530,31630,31534,1391,32925,156
2022-08-19,Nevada,057,99092,18572,18497,1737,20234,132
2022-08-19,Orange,059,3164182,654508,652703,59078,711781,7280
2022-08-19,Placer,061,380077,74268,74027,9188,83215,657
2022-08-19,Plumas,063,18699,3560,3550,431,3981,13
2022-08-19,Riverside,065,2383286,682133,679298,34114,713412,6574
2022-08-19,Sacramento,067,1510023,338926,337745,32614,370359,3208
2022-08-19,San Benito,069,59416,15752,15698,916,16614,103
2022-08-19,San Bernardino,071,2135413,656715,648583,29774,678357,8014
2022-08-19,San Diego,073,3302833,906814,904015,69448,973463,5448
2022-08-19,San Francisco,075,870044,174659,174151,11794,185945,973
2022-08-19,San Joaquin,077,732212,193365,192738,13765,206503,2288
2022-08-19,San Luis Obispo,079,281455,62101,61764,6863,68627,516
2022-08-19,San Mateo,081,765935,164285,163705,10369,174074,738
2022-08-19,Santa Barbara,083,443738,103350,102795,6626,109421,713
2022-08-19,Santa Clara,085,1922200,421196,419723,18383,438106,2437
2022-08-19,Santa Cruz,087,273765,61495,61098,3308,64406,269
2022-08-19,Shasta,089,179085,34238,34105,7161,41266,588
2022-08-19,Sierra,091,2930,302,298,60,358,4
2022-08-19,Siskiyou,093,43540,5133,5119,3260,8379,88
2022-08-19,Solano,095,438530,102636,102355,7512,109867,457
2022-08-19,Sonoma,097,501317,104630,104090,5142,109232,511
2022-08-19,Stanislaus,099,539301,134920,134407,20454,154861,1719
2022-08-19,Sutter,101,95872,23638,23587,2432,26019,228
2022-08-19,Tehama,103,63373,13332,13289,2998,16287,209
2022-08-19,Trinity,105,12862,1373,1366,364,1730,20
2022-08-19,Tulare,107,460477,119571,119251,34758,154009,1521
2022-08-19,Tuolumne,109,53932,15188,15085,902,15987,196
2022-08-19,Ventura,111,848112,204180,203318,14772,218090,1547
2022-08-19,Yolo,113,214977,46545,46567,4231,50798,333
2022-08-19,Yuba,115,75493,18419,18363,1634,19997,129
2022-08-18,Alameda,001,1643700,338387,337238,19231,356469,1970
2022-08-18,Alpine,003,1148,131,131,1,132,0
2022-08-18,Amador,005,37829,9791,9761,897,10658,89
2022-08-18,Butte,007,227075,38472,38316,8655,46971,449
2022-08-18,Calaveras,009,45235,8333,8313,504,8817,132
2022-08-18,Colusa,011,21464,3725,3718,1219,4937,22
2022-08-18,Contra Costa,013,1133247,243498,241665,19907,261572,1399
2022-08-18,Del Norte,015,27424,7299,7290,390,7680,55
2022-08-18,El Dorado,017,186661,31713,31600,4140,35740,225
2022-08-18,Fresno,019,978130,268776,268147,29490,297637,2822
2022-08-18,Glenn,021,27897,5425,5413,1836,7249,48
2022-08-18,Humboldt,023,135768,21173,21104,4737,25841,153
2022-08-18,Imperial,025,180216,64261,64092,15014,79106,951
2022-08-18,Inyo,027,18085,4442,4435,870,5305,59
2022-08-18,Kern,029,883053,215391,214656,57843,272499,2389
2022-08-18,Kings,031,150075,58230,58109,3954,62063,454
2022-08-18,Lake,033,64148,12456,12426,1123,13549,142
2022-08-18,Lassen,035,31185,9865,9843,972,10815,64
2022-08-18,Los Angeles,037,10098052,3212964,3200023,172544,3372567,32746
2022-08-18,Madera,039,155013,42959,42822,7886,50708,372
2022-08-18,Marin,041,260295,44041,43966,5109,49075,305
2022-08-18,Mariposa,043,17540,3015,3003,332,3335,31
2022-08-18,Mendocino,045,87422,15630,15578,4302,19880,134
2022-08-18,Merced,047,269075,70715,70449,11086,81535,846
2022-08-18,Modoc,049,8938,865,862,313,1175,11
2022-08-18,Mono,051,14174,3180,3177,238,3415,7
2022-08-18,Monterey,053,433212,92586,92287,20280,112567,760
2022-08-18,Napa,055,140530,31609,31534,1390,32924,156
2022-08-18,Nevada,057,99092,18556,18497,1732,20229,132
2022-08-18,Orange,059,3164182,654044,652703,58976,711679,7280
2022-08-18,Placer,061,380077,74213,74027,9185,83212,657
2022-08-18,Plumas,063,18699,3556,3550,431,3981,13
2022-08-18,Riverside,065,2383286,681559,679298,34065,713363,6574
2022-08-18,Sacramento,067,1510023,338624,337745,32555,370300,3208
2022-08-18,San Benito,069,59416,15740,15698,913,16611,103
2022-08-18,San Bernardino,071,2135413,656055,648583,29722,678305,8014
2022-08-18,San Diego,073,3302833,906164,904015,69376,973391,5448
2022-08-18,San Francisco,075,870044,174515,174151,11771,185922,973
2022-08-18,San Joaquin,077,732212,193196,192738,13739,206477,2288
2022-08-18,San Luis Obispo,079,281455,62059,61764,6848,68612,516
2022-08-18,San Mateo,081,765935,164106,163705,10360,174065,738
2022-08-18,Santa Barbara,083,443738,103245,102795,6614,109409,713
2022-08-18,Santa Clara,085,1922200,420764,419723,18353,438076,2437
2022-08-18,Santa Cruz,087,273765,61424,61098,3303,64401,269
2022-08-18,Shasta,089,179085,34218,34105,7156,41261,588
2022-08-18,Sierra,091,2930,301,298,60,358,4
2022-08-18,Siskiyou,093,43540,5131,5119,3258,8377,88
2022-08-18,Solano,095,438530,102565,102355,7502,109857,457
2022-08-18,Sonoma,097,501317,104543,104090,5133,109223,511
2022-08-18,Stanislaus,099,539301,134792,134407,20421,154828,1719
2022-08-18,Sutter,101,95872,23617,23587,2430,26017,228
2022-08-18,Tehama,103,63373,13325,13289,2994,16283,209
2022-08-18,Trinity,105,12862,1372,1366,361,1727,20
2022-08-18,Tulare,107,460477,119477,119251,34659,153910,1521
2022-08-18,Tuolumne,109,53932,15147,15085,897,15982,196
2022-08-18,Ventura,111,848112,204007,203318,14730,218048,1547
2022-08-18,Yolo,113,214977,46521,46567,4222,50789,333
2022-08-18,Yuba,115,75493,18399,18363,1631,19994,129
2022-08-17,Alameda,001,1643700,338053,336198,19195,355393,1948
2022-08-17,Alpine,003,1148,131,131,1,132,0
2022-08-17,Amador,005,37829,9783,9728,897,10625,89
2022-08-17,Butte,007,227075,38433,38203,8644,46847,447
2022-08-17,Calaveras,009,45235,8326,8295,501,8796,131
2022-08-17,Colusa,011,21464,3724,3716,1217,4933,22
2022-08-17,Contra Costa,013,1133247,243271,240894,19870,260764,1394
2022-08-17,Del Norte,015,27424,7295,7274,390,7664,55
2022-08-17,El Dorado,017,186661,31694,31523,4136,35659,225
2022-08-17,Fresno,019,978130,268551,267367,29426,296793,2818
2022-08-17,Glenn,021,27897,5424,5403,1833,7236,48
2022-08-17,Humboldt,023,135768,21150,21029,4722,25751,153
2022-08-17,Imperial,025,180216,64219,63972,14982,78954,950
2022-08-17,Inyo,027,18085,4440,4421,867,5288,58
2022-08-17,Kern,029,883053,215260,214040,57744,271784,2389
2022-08-17,Kings,031,150075,58166,57948,3951,61899,454
2022-08-17,Lake,033,64148,12446,12383,1122,13505,142
2022-08-17,Lassen,035,31185,9856,9813,972,10785,64
2022-08-17,Los Angeles,037,10098052,3210149,3190808,172233,3363041,32701
2022-08-17,Madera,039,155013,42911,42677,7848,50525,372
2022-08-17,Marin,041,260295,44008,43852,5105,48957,305
2022-08-17,Mariposa,043,17540,3011,2998,331,3329,31
2022-08-17,Mendocino,045,87422,15619,15504,4296,19800,132
2022-08-17,Merced,047,269075,70659,70232,11042,81274,843
2022-08-17,Modoc,049,8938,864,857,313,1170,11
2022-08-17,Mono,051,14174,3179,3175,238,3413,7
2022-08-17,Monterey,053,433212,92522,91984,20226,112210,759
2022-08-17,Napa,055,140530,31594,31454,1388,32842,155
2022-08-17,Nevada,057,99092,18539,18443,1730,20173,132
2022-08-17,Orange,059,3164182,653440,650827,58867,709694,7266
2022-08-17,Placer,061,380077,74165,73852,9177,83029,655
2022-08-17,Plumas,063,18699,3554,3544,430,3974,13
2022-08-17,Riverside,065,2383286,680922,677437,34002,711439,6562
2022-08-17,Sacramento,067,1510023,338298,336667,32511,369178,3194
2022-08-17,San Benito,069,59416,15724,15655,912,16567,103
2022-08-17,San Bernardino,071,2135413,655423,646584,29669,676253,7999
2022-08-17,San Diego,073,3302833,905431,901794,69307,971101,5442
2022-08-17,San Francisco,075,870044,174388,173590,11760,185350,971
2022-08-17,San Joaquin,077,732212,193047,192078,13703,205781,2283
2022-08-17,San Luis Obispo,079,281455,62006,61604,6835,68439,514
2022-08-17,San Mateo,081,765935,164010,163218,10353,173571,738
2022-08-17,Santa Barbara,083,443738,103133,102430,6595,109025,712
2022-08-17,Santa Clara,085,1922200,420305,418231,18344,436575,2424
2022-08-17,Santa Cruz,087,273765,61335,60880,3297,64177,269
2022-08-17,Shasta,089,179085,34200,33984,7147,41131,587
2022-08-17,Sierra,091,2930,301,297,60,357,4
2022-08-17,Siskiyou,093,43540,5129,5102,3254,8356,88
2022-08-17,Solano,095,438530,102483,102115,7496,109611,459
2022-08-17,Sonoma,097,501317,104444,103844,5126,108970,504
2022-08-17,Stanislaus,099,539301,134647,133989,20384,154373,1715
2022-08-17,Sutter,101,95872,23583,23489,2424,25913,228
2022-08-17,Tehama,103,63373,13322,13259,2989,16248,209
2022-08-17,Trinity,105,12862,1372,1362,359,1721,20
2022-08-17,Tulare,107,460477,119369,118997,34552,153549,1521
2022-08-17,Tuolumne,109,53932,15139,15044,895,15939,196
2022-08-17,Ventura,111,848112,203826,202609,14676,217285,1546
2022-08-17,Yolo,113,214977,46489,46414,4217,50631,331
2022-08-17,Yuba,115,75493,18379,18305,1628,19933,129
2022-08-16,Alameda,001,1643700,337683,336198,19175,355373,1948
2022-08-16,Alpine,003,1148,131,131,1,132,0
2022-08-16,Amador,005,37829,9770,9728,892,10620,89
2022-08-16,Butte,007,227075,38402,38203,8628,46831,447
2022-08-16,Calaveras,009,45235,8318,8295,501,8796,131
2022-08-16,Colusa,011,21464,3723,3716,1215,4931,22
2022-08-16,Contra Costa,013,1133247,243034,240894,19828,260722,1394
2022-08-16,Del Norte,015,27424,7290,7274,389,7663,55
2022-08-16,El Dorado,017,186661,31674,31523,4129,35652,225
2022-08-16,Fresno,019,978130,268309,267367,29381,296748,2818
2022-08-16,Glenn,021,27897,5423,5403,1830,7233,48
2022-08-16,Humboldt,023,135768,21123,21029,4695,25724,153
2022-08-16,Imperial,025,180216,64169,63972,14943,78915,950
2022-08-16,Inyo,027,18085,4436,4421,863,5284,58
2022-08-16,Kern,029,883053,215125,214040,57641,271681,2389
2022-08-16,Kings,031,150075,58120,57948,3948,61896,454
2022-08-16,Lake,033,64148,12430,12383,1118,13501,142
2022-08-16,Lassen,035,31185,9843,9813,971,10784,64
2022-08-16,Los Angeles,037,10098052,3207203,3190808,171892,3362700,32701
2022-08-16,Madera,039,155013,42853,42677,7827,50504,372
2022-08-16,Marin,041,260295,43970,43852,5099,48951,305
2022-08-16,Mariposa,043,17540,3010,2998,330,3328,31
2022-08-16,Mendocino,045,87422,15601,15504,4282,19786,132
2022-08-16,Merced,047,269075,70582,70232,11000,81232,843
2022-08-16,Modoc,049,8938,864,857,313,1170,11
2022-08-16,Mono,051,14174,3178,3175,237,3412,7
2022-08-16,Monterey,053,433212,92443,91984,20155,112139,759
2022-08-16,Napa,055,140530,31575,31454,1387,32841,155
2022-08-16,Nevada,057,99092,18524,18443,1726,20169,132
2022-08-16,Orange,059,3164182,652783,650827,58743,709570,7266
2022-08-16,Placer,061,380077,74097,73852,9168,83020,655
2022-08-16,Plumas,063,18699,3552,3544,430,3974,13
2022-08-16,Riverside,065,2383286,680240,677437,33953,711390,6562
2022-08-16,Sacramento,067,1510023,337967,336667,32476,369143,3194
2022-08-16,San Benito,069,59416,15711,15655,908,16563,103
2022-08-16,San Bernardino,071,2135413,654691,646584,29607,676191,7999
2022-08-16,San Diego,073,3302833,904617,901794,69218,971012,5442
2022-08-16,San Francisco,075,870044,174229,173590,11755,185345,971
2022-08-16,San Joaquin,077,732212,192835,192078,13673,205751,2283
2022-08-16,San Luis Obispo,079,281455,61969,61604,6828,68432,514
2022-08-16,San Mateo,081,765935,163851,163218,10339,173557,738
2022-08-16,Santa Barbara,083,443738,103006,102430,6572,109002,712
2022-08-16,Santa Clara,085,1922200,419834,418231,18319,436550,2424
2022-08-16,Santa Cruz,087,273765,61282,60880,3293,64173,269
2022-08-16,Shasta,089,179085,34173,33984,7138,41122,587
2022-08-16,Sierra,091,2930,300,297,60,357,4
2022-08-16,Siskiyou,093,43540,5125,5102,3249,8351,88
2022-08-16,Solano,095,438530,102411,102115,7480,109595,459
2022-08-16,Sonoma,097,501317,104339,103844,5118,108962,504
2022-08-16,Stanislaus,099,539301,134513,133989,20327,154316,1715
2022-08-16,Sutter,101,95872,23559,23489,2418,25907,228
2022-08-16,Tehama,103,63373,13316,13259,2984,16243,209
2022-08-16,Trinity,105,12862,1369,1362,359,1721,20
2022-08-16,Tulare,107,460477,119282,118997,34432,153429,1521
2022-08-16,Tuolumne,109,53932,15125,15044,895,15939,196
2022-08-16,Ventura,111,848112,203597,202609,14620,217229,1546
2022-08-16,Yolo,113,214977,46470,46414,4213,50627,331
2022-08-16,Yuba,115,75493,18360,18305,1622,19927,129
2022-08-15,Alameda,001,1643700,337303,336198,19143,355341,1948
2022-08-15,Alpine,003,1148,131,131,1,132,0
2022-08-15,Amador,005,37829,9758,9728,892,10620,89
2022-08-15,Butte,007,227075,38381,38203,8608,46811,447
2022-08-15,Calaveras,009,45235,8316,8295,500,8795,131
2022-08-15,Colusa,011,21464,3720,3716,1214,4930,22
2022-08-15,Contra Costa,013,1133247,242754,240894,19795,260689,1394
2022-08-15,Del Norte,015,27424,7286,7274,388,7662,55
2022-08-15,El Dorado,017,186661,31644,31523,4122,35645,225
2022-08-15,Fresno,019,978130,268006,267367,29320,296687,2818
2022-08-15,Glenn,021,27897,5415,5403,1829,7232,48
2022-08-15,Humboldt,023,135768,21101,21029,4674,25703,153
2022-08-15,Imperial,025,180216,64122,63972,14906,78878,950
2022-08-15,Inyo,027,18085,4435,4421,861,5282,58
2022-08-15,Kern,029,883053,214942,214040,57542,271582,2389
2022-08-15,Kings,031,150075,58045,57948,3939,61887,454
2022-08-15,Lake,033,64148,12414,12383,1116,13499,142
2022-08-15,Lassen,035,31185,9842,9813,971,10784,64
2022-08-15,Los Angeles,037,10098052,3203885,3190808,171557,3362365,32701
2022-08-15,Madera,039,155013,42800,42677,7785,50462,372
2022-08-15,Marin,041,260295,43926,43852,5093,48945,305
2022-08-15,Mariposa,043,17540,3008,2998,329,3327,31
2022-08-15,Mendocino,045,87422,15584,15504,4276,19780,132
2022-08-15,Merced,047,269075,70518,70232,10948,81180,843
2022-08-15,Modoc,049,8938,860,857,313,1170,11
2022-08-15,Mono,051,14174,3177,3175,237,3412,7
2022-08-15,Monterey,053,433212,92333,91984,20085,112069,759
2022-08-15,Napa,055,140530,31549,31454,1387,32841,155
2022-08-15,Nevada,057,99092,18510,18443,1725,20168,132
2022-08-15,Orange,059,3164182,652078,650827,58628,709455,7266
2022-08-15,Placer,061,380077,74038,73852,9159,83011,655
2022-08-15,Plumas,063,18699,3548,3544,430,3974,13
2022-08-15,Riverside,065,2383286,679448,677437,33893,711330,6562
2022-08-15,Sacramento,067,1510023,337571,336667,32439,369106,3194
2022-08-15,San Benito,069,59416,15695,15655,906,16561,103
2022-08-15,San Bernardino,071,2135413,653870,646584,29538,676122,7999
2022-08-15,San Diego,073,3302833,903771,901794,69106,970900,5442
2022-08-15,San Francisco,075,870044,174055,173590,11751,185341,971
2022-08-15,San Joaquin,077,732212,192632,192078,13633,205711,2283
2022-08-15,San Luis Obispo,079,281455,61932,61604,6810,68414,514
2022-08-15,San Mateo,081,765935,163648,163218,10333,173551,738
2022-08-15,Santa Barbara,083,443738,102909,102430,6549,108979,712
2022-08-15,Santa Clara,085,1922200,419316,418231,18289,436520,2424
2022-08-15,Santa Cruz,087,273765,61202,60880,3288,64168,269
2022-08-15,Shasta,089,179085,34148,33984,7128,41112,587
2022-08-15,Sierra,091,2930,300,297,60,357,4
2022-08-15,Siskiyou,093,43540,5122,5102,3245,8347,88
2022-08-15,Solano,095,438530,102307,102115,7465,109580,459
2022-08-15,Sonoma,097,501317,104248,103844,5110,108954,504
2022-08-15,Stanislaus,099,539301,134373,133989,20295,154284,1715
2022-08-15,Sutter,101,95872,23527,23489,2416,25905,228
2022-08-15,Tehama,103,63373,13308,13259,2977,16236,209
2022-08-15,Trinity,105,12862,1366,1362,357,1719,20
2022-08-15,Tulare,107,460477,119151,118997,34315,153312,1521
2022-08-15,Tuolumne,109,53932,15117,15044,895,15939,196
2022-08-15,Ventura,111,848112,203347,202609,14557,217166,1546
2022-08-15,Yolo,113,214977,46435,46414,4211,50625,331
2022-08-15,Yuba,115,75493,18337,18305,1617,19922,129
2022-08-14,Alameda,001,1643700,336843,334944,19116,354060,1948
2022-08-14,Alpine,003,1148,131,131,1,132,0
2022-08-14,Amador,005,37829,9749,9705,890,10595,89
2022-08-14,Butte,007,227075,38331,38062,8592,46654,447
2022-08-14,Calaveras,009,45235,8307,8271,499,8770,131
2022-08-14,Colusa,011,21464,3720,3704,1211,4915,22
2022-08-14,Contra Costa,013,1133247,242486,239735,19741,259476,1393
2022-08-14,Del Norte,015,27424,7278,7245,386,7631,54
2022-08-14,El Dorado,017,186661,31612,31430,4117,35547,225
2022-08-14,Fresno,019,978130,267705,266211,29265,295476,2816
2022-08-14,Glenn,021,27897,5411,5393,1828,7221,48
2022-08-14,Humboldt,023,135768,21074,20954,4659,25613,153
2022-08-14,Imperial,025,180216,64057,63766,14864,78630,950
2022-08-14,Inyo,027,18085,4428,4418,857,5275,58
2022-08-14,Kern,029,883053,214762,213071,57410,270481,2380
2022-08-14,Kings,031,150075,57990,57748,3934,61682,454
2022-08-14,Lake,033,64148,12396,12324,1113,13437,142
2022-08-14,Lassen,035,31185,9822,9795,970,10765,64
2022-08-14,Los Angeles,037,10098052,3200424,3177769,171171,3348940,32657
2022-08-14,Madera,039,155013,42737,42517,7742,50259,372
2022-08-14,Marin,041,260295,43881,43662,5087,48749,305
2022-08-14,Mariposa,043,17540,3006,2986,328,3314,31
2022-08-14,Mendocino,045,87422,15565,15456,4269,19725,132
2022-08-14,Merced,047,269075,70413,69974,10885,80859,842
2022-08-14,Modoc,049,8938,859,856,313,1169,11
2022-08-14,Mono,051,14174,3177,3170,236,3406,7
2022-08-14,Monterey,053,433212,92209,91612,20013,111625,759
2022-08-14,Napa,055,140530,31510,31312,1384,32696,156
2022-08-14,Nevada,057,99092,18490,18398,1722,20120,132
2022-08-14,Orange,059,3164182,651355,648171,58488,706659,7248
2022-08-14,Placer,061,380077,73978,73588,9142,82730,656
2022-08-14,Plumas,063,18699,3546,3539,430,3969,13
2022-08-14,Riverside,065,2383286,678635,674362,33808,708170,6561
2022-08-14,Sacramento,067,1510023,337086,335292,32386,367678,3190
2022-08-14,San Benito,069,59416,15673,15578,897,16475,103
2022-08-14,San Bernardino,071,2135413,653011,643895,29466,673361,7983
2022-08-14,San Diego,073,3302833,902882,898646,69005,967651,5437
2022-08-14,San Francisco,075,870044,173842,172876,11737,184613,955
2022-08-14,San Joaquin,077,732212,192340,191272,13572,204844,2283
2022-08-14,San Luis Obispo,079,281455,61871,61403,6782,68185,512
2022-08-14,San Mateo,081,765935,163443,162531,10319,172850,738
2022-08-14,Santa Barbara,083,443738,102771,101942,6523,108465,712
2022-08-14,Santa Clara,085,1922200,418748,416369,18254,434623,2422
2022-08-14,Santa Cruz,087,273765,61097,60594,3281,63875,273
2022-08-14,Shasta,089,179085,34104,33895,7116,41011,584
2022-08-14,Sierra,091,2930,300,296,60,356,4
2022-08-14,Siskiyou,093,43540,5115,5086,3243,8329,88
2022-08-14,Solano,095,438530,102169,101761,7456,109217,458
2022-08-14,Sonoma,097,501317,104144,103496,5094,108590,504
2022-08-14,Stanislaus,099,539301,134193,133490,20241,153731,1702
2022-08-14,Sutter,101,95872,23485,23386,2412,25798,228
2022-08-14,Tehama,103,63373,13301,13213,2976,16189,209
2022-08-14,Trinity,105,12862,1365,1356,357,1713,20
2022-08-14,Tulare,107,460477,119004,118563,34194,152757,1520
2022-08-14,Tuolumne,109,53932,15097,14964,894,15858,196
2022-08-14,Ventura,111,848112,203083,201765,14514,216279,1541
2022-08-14,Yolo,113,214977,46389,46225,4206,50431,331
2022-08-14,Yuba,115,75493,18315,18232,1614,19846,129
2022-08-13,Alameda,001,1643700,336593,334944,19101,354045,1948
2022-08-13,Alpine,003,1148,131,131,1,132,0
2022-08-13,Amador,005,37829,9745,9705,890,10595,89
2022-08-13,Butte,007,227075,38307,38062,8581,46643,447
2022-08-13,Calaveras,009,45235,8303,8271,498,8769,131
2022-08-13,Colusa,011,21464,3717,3704,1211,4915,22
2022-08-13,Contra Costa,013,1133247,242321,239735,19714,259449,1393
2022-08-13,Del Norte,015,27424,7276,7245,386,7631,54
2022-08-13,El Dorado,017,186661,31599,31430,4116,35546,225
2022-08-13,Fresno,019,978130,267566,266211,29237,295448,2816
2022-08-13,Glenn,021,27897,5411,5393,1826,7219,48
2022-08-13,Humboldt,023,135768,21058,20954,4649,25603,153
2022-08-13,Imperial,025,180216,64016,63766,14846,78612,950
2022-08-13,Inyo,027,18085,4426,4418,856,5274,58
2022-08-13,Kern,029,883053,214673,213071,57356,270427,2380
2022-08-13,Kings,031,150075,57965,57748,3933,61681,454
2022-08-13,Lake,033,64148,12385,12324,1113,13437,142
2022-08-13,Lassen,035,31185,9816,9795,969,10764,64
2022-08-13,Los Angeles,037,10098052,3198634,3177769,170917,3348686,32657
2022-08-13,Madera,039,155013,42720,42517,7735,50252,372
2022-08-13,Marin,041,260295,43861,43662,5084,48746,305
2022-08-13,Mariposa,043,17540,3006,2986,327,3313,31
2022-08-13,Mendocino,045,87422,15553,15456,4266,19722,132
2022-08-13,Merced,047,269075,70374,69974,10880,80854,842
2022-08-13,Modoc,049,8938,859,856,313,1169,11
2022-08-13,Mono,051,14174,3177,3170,235,3405,7
2022-08-13,Monterey,053,433212,92146,91612,19976,111588,759
2022-08-13,Napa,055,140530,31497,31312,1382,32694,156
2022-08-13,Nevada,057,99092,18479,18398,1720,20118,132
2022-08-13,Orange,059,3164182,650965,648171,58413,706584,7248
2022-08-13,Placer,061,380077,73932,73588,9136,82724,656
2022-08-13,Plumas,063,18699,3544,3539,430,3969,13
2022-08-13,Riverside,065,2383286,678200,674362,33776,708138,6561
2022-08-13,Sacramento,067,1510023,336895,335292,32375,367667,3190
2022-08-13,San Benito,069,59416,15667,15578,891,16469,103
2022-08-13,San Bernardino,071,2135413,652555,643895,29438,673333,7983
2022-08-13,San Diego,073,3302833,902432,898646,68962,967608,5437
2022-08-13,San Francisco,075,870044,173725,172876,11731,184607,955
2022-08-13,San Joaquin,077,732212,192217,191272,13550,204822,2283
2022-08-13,San Luis Obispo,079,281455,61852,61403,6777,68180,512
2022-08-13,San Mateo,081,765935,163331,162531,10307,172838,738
2022-08-13,Santa Barbara,083,443738,102695,101942,6507,108449,712
2022-08-13,Santa Clara,085,1922200,418432,416369,18233,434602,2422
2022-08-13,Santa Cruz,087,273765,61060,60594,3275,63869,273
2022-08-13,Shasta,089,179085,34066,33895,7112,41007,584
2022-08-13,Sierra,091,2930,300,296,60,356,4
2022-08-13,Siskiyou,093,43540,5113,5086,3240,8326,88
2022-08-13,Solano,095,438530,102129,101761,7448,109209,458
2022-08-13,Sonoma,097,501317,104093,103496,5093,108589,504
2022-08-13,Stanislaus,099,539301,134092,133490,20221,153711,1702
2022-08-13,Sutter,101,95872,23471,23386,2412,25798,228
2022-08-13,Tehama,103,63373,13296,13213,2975,16188,209
2022-08-13,Trinity,105,12862,1364,1356,357,1713,20
2022-08-13,Tulare,107,460477,118933,118563,34137,152700,1520
2022-08-13,Tuolumne,109,53932,15083,14964,889,15853,196
2022-08-13,Ventura,111,848112,202920,201765,14500,216265,1541
2022-08-13,Yolo,113,214977,46361,46225,4203,50428,331
2022-08-13,Yuba,115,75493,18306,18232,1612,19844,129
2022-08-12,Alameda,001,1643700,336342,334944,19086,354030,1948
2022-08-12,Alpine,003,1148,131,131,1,132,0
2022-08-12,Amador,005,37829,9735,9705,887,10592,89
2022-08-12,Butte,007,227075,38287,38062,8573,46635,447
2022-08-12,Calaveras,009,45235,8295,8271,495,8766,131
2022-08-12,Colusa,011,21464,3714,3704,1211,4915,22
2022-08-12,Contra Costa,013,1133247,242156,239735,19695,259430,1393
2022-08-12,Del Norte,015,27424,7272,7245,386,7631,54
2022-08-12,El Dorado,017,186661,31581,31430,4112,35542,225
2022-08-12,Fresno,019,978130,267362,266211,29211,295422,2816
2022-08-12,Glenn,021,27897,5411,5393,1826,7219,48
2022-08-12,Humboldt,023,135768,21036,20954,4641,25595,153
2022-08-12,Imperial,025,180216,63989,63766,14831,78597,950
2022-08-12,Inyo,027,18085,4425,4418,854,5272,58
2022-08-12,Kern,029,883053,214574,213071,57296,270367,2380
2022-08-12,Kings,031,150075,57944,57748,3930,61678,454
2022-08-12,Lake,033,64148,12381,12324,1110,13434,142
2022-08-12,Lassen,035,31185,9814,9795,969,10764,64
2022-08-12,Los Angeles,037,10098052,3196583,3177769,170678,3348447,32657
2022-08-12,Madera,039,155013,42687,42517,7729,50246,372
2022-08-12,Marin,041,260295,43831,43662,5076,48738,305
2022-08-12,Mariposa,043,17540,3006,2986,327,3313,31
2022-08-12,Mendocino,045,87422,15542,15456,4258,19714,132
2022-08-12,Merced,047,269075,70341,69974,10874,80848,842
2022-08-12,Modoc,049,8938,859,856,313,1169,11
2022-08-12,Mono,051,14174,3177,3170,235,3405,7
2022-08-12,Monterey,053,433212,92088,91612,19943,111555,759
2022-08-12,Napa,055,140530,31476,31312,1381,32693,156
2022-08-12,Nevada,057,99092,18475,18398,1718,20116,132
2022-08-12,Orange,059,3164182,650554,648171,58323,706494,7248
2022-08-12,Placer,061,380077,73882,73588,9126,82714,656
2022-08-12,Plumas,063,18699,3542,3539,430,3969,13
2022-08-12,Riverside,065,2383286,677778,674362,33743,708105,6561
2022-08-12,Sacramento,067,1510023,336679,335292,32359,367651,3190
2022-08-12,San Benito,069,59416,15650,15578,890,16468,103
2022-08-12,San Bernardino,071,2135413,652154,643895,29420,673315,7983
2022-08-12,San Diego,073,3302833,901904,898646,68884,967530,5437
2022-08-12,San Francisco,075,870044,173601,172876,11722,184598,955
2022-08-12,San Joaquin,077,732212,192097,191272,13532,204804,2283
2022-08-12,San Luis Obispo,079,281455,61830,61403,6770,68173,512
2022-08-12,San Mateo,081,765935,163204,162531,10302,172833,738
2022-08-12,Santa Barbara,083,443738,102613,101942,6502,108444,712
2022-08-12,Santa Clara,085,1922200,418089,416369,18212,434581,2422
2022-08-12,Santa Cruz,087,273765,61006,60594,3273,63867,273
2022-08-12,Shasta,089,179085,34052,33895,7104,40999,584
2022-08-12,Sierra,091,2930,298,296,59,355,4
2022-08-12,Siskiyou,093,43540,5110,5086,3240,8326,88
2022-08-12,Solano,095,438530,102056,101761,7437,109198,458
2022-08-12,Sonoma,097,501317,104034,103496,5092,108588,504
2022-08-12,Stanislaus,099,539301,134006,133490,20209,153699,1702
2022-08-12,Sutter,101,95872,23456,23386,2412,25798,228
2022-08-12,Tehama,103,63373,13288,13213,2974,16187,209
2022-08-12,Trinity,105,12862,1361,1356,356,1712,20
2022-08-12,Tulare,107,460477,118874,118563,34079,152642,1520
2022-08-12,Tuolumne,109,53932,15076,14964,888,15852,196
2022-08-12,Ventura,111,848112,202775,201765,14484,216249,1541
2022-08-12,Yolo,113,214977,46339,46225,4198,50423,331
2022-08-12,Yuba,115,75493,18295,18232,1611,19843,129
2022-08-11,Alameda,001,1643700,336020,334944,19053,353997,1948
2022-08-11,Alpine,003,1148,131,131,1,132,0
2022-08-11,Amador,005,37829,9732,9705,884,10589,89
2022-08-11,Butte,007,227075,38251,38062,8559,46621,447
2022-08-11,Calaveras,009,45235,8289,8271,493,8764,131
2022-08-11,Colusa,011,21464,3711,3704,1210,4914,22
2022-08-11,Contra Costa,013,1133247,241898,239735,19661,259396,1393
2022-08-11,Del Norte,015,27424,7265,7245,384,7629,54
2022-08-11,El Dorado,017,186661,31551,31430,4104,35534,225
2022-08-11,Fresno,019,978130,267116,266211,29163,295374,2816
2022-08-11,Glenn,021,27897,5409,5393,1825,7218,48
2022-08-11,Humboldt,023,135768,21006,20954,4632,25586,153
2022-08-11,Imperial,025,180216,63942,63766,14786,78552,950
2022-08-11,Inyo,027,18085,4424,4418,848,5266,58
2022-08-11,Kern,029,883053,214397,213071,57184,270255,2380
2022-08-11,Kings,031,150075,57886,57748,3923,61671,454
2022-08-11,Lake,033,64148,12371,12324,1109,13433,142
2022-08-11,Lassen,035,31185,9809,9795,969,10764,64
2022-08-11,Los Angeles,037,10098052,3193655,3177769,170320,3348089,32657
2022-08-11,Madera,039,155013,42640,42517,7701,50218,372
2022-08-11,Marin,041,260295,43792,43662,5069,48731,305
2022-08-11,Mariposa,043,17540,3006,2986,324,3310,31
2022-08-11,Mendocino,045,87422,15531,15456,4255,19711,132
2022-08-11,Merced,047,269075,70290,69974,10839,80813,842
2022-08-11,Modoc,049,8938,858,856,313,1169,11
2022-08-11,Mono,051,14174,3177,3170,235,3405,7
2022-08-11,Monterey,053,433212,91989,91612,19888,111500,759
2022-08-11,Napa,055,140530,31439,31312,1379,32691,156
2022-08-11,Nevada,057,99092,18457,18398,1714,20112,132
2022-08-11,Orange,059,3164182,649907,648171,58200,706371,7248
2022-08-11,Placer,061,380077,73819,73588,9116,82704,656
2022-08-11,Plumas,063,18699,3541,3539,429,3968,13
2022-08-11,Riverside,065,2383286,677172,674362,33697,708059,6561
2022-08-11,Sacramento,067,1510023,336370,335292,32327,367619,3190
2022-08-11,San Benito,069,59416,15635,15578,889,16467,103
2022-08-11,San Bernardino,071,2135413,651422,643895,29371,673266,7983
2022-08-11,San Diego,073,3302833,901133,898646,68759,967405,5437
2022-08-11,San Francisco,075,870044,173454,172876,11705,184581,955
2022-08-11,San Joaquin,077,732212,191908,191272,13506,204778,2283
2022-08-11,San Luis Obispo,079,281455,61781,61403,6743,68146,512
2022-08-11,San Mateo,081,765935,163043,162531,10290,172821,738
2022-08-11,Santa Barbara,083,443738,102505,101942,6479,108421,712
2022-08-11,Santa Clara,085,1922200,417657,416369,18190,434559,2422
2022-08-11,Santa Cruz,087,273765,60941,60594,3269,63863,273
2022-08-11,Shasta,089,179085,34033,33895,7090,40985,584
2022-08-11,Sierra,091,2930,297,296,59,355,4
2022-08-11,Siskiyou,093,43540,5107,5086,3236,8322,88
2022-08-11,Solano,095,438530,101989,101761,7425,109186,458
2022-08-11,Sonoma,097,501317,103939,103496,5085,108581,504
2022-08-11,Stanislaus,099,539301,133852,133490,20171,153661,1702
2022-08-11,Sutter,101,95872,23426,23386,2412,25798,228
2022-08-11,Tehama,103,63373,13280,13213,2974,16187,209
2022-08-11,Trinity,105,12862,1361,1356,355,1711,20
2022-08-11,Tulare,107,460477,118777,118563,33990,152553,1520
2022-08-11,Tuolumne,109,53932,15068,14964,886,15850,196
2022-08-11,Ventura,111,848112,202573,201765,14447,216212,1541
2022-08-11,Yolo,113,214977,46305,46225,4194,50419,331
2022-08-11,Yuba,115,75493,18272,18232,1608,19840,129
2022-08-10,Alameda,001,1643700,335623,333587,19029,352616,1944
2022-08-10,Alpine,003,1148,131,131,1,132,0
2022-08-10,Amador,005,37829,9727,9677,881,10558,88
2022-08-10,Butte,007,227075,38216,37892,8549,46441,446
2022-08-10,Calaveras,009,45235,8283,8251,490,8741,130
2022-08-10,Colusa,011,21464,3707,3700,1210,4910,22
2022-08-10,Contra Costa,013,1133247,241647,238658,19620,258278,1382
2022-08-10,Del Norte,015,27424,7260,7220,384,7604,54
2022-08-10,El Dorado,017,186661,31525,31354,4089,35443,225
2022-08-10,Fresno,019,978130,266846,265300,29100,294400,2815
2022-08-10,Glenn,021,27897,5407,5387,1822,7209,48
2022-08-10,Humboldt,023,135768,20992,20843,4614,25457,153
2022-08-10,Imperial,025,180216,63883,63532,14744,78276,949
2022-08-10,Inyo,027,18085,4424,4416,847,5263,57
2022-08-10,Kern,029,883053,214221,212602,57106,269708,2380
2022-08-10,Kings,031,150075,57840,57569,3921,61490,453
2022-08-10,Lake,033,64148,12357,12281,1109,13390,142
2022-08-10,Lassen,035,31185,9802,9682,969,10651,64
2022-08-10,Los Angeles,037,10098052,3190493,3168105,169962,3338067,32609
2022-08-10,Madera,039,155013,42603,42350,7686,50036,372
2022-08-10,Marin,041,260295,43746,43532,5066,48598,302
2022-08-10,Mariposa,043,17540,3005,2980,324,3304,31
2022-08-10,Mendocino,045,87422,15517,15394,4253,19647,132
2022-08-10,Merced,047,269075,70219,69740,10816,80556,839
2022-08-10,Modoc,049,8938,858,855,312,1167,11
2022-08-10,Mono,051,14174,3175,3165,235,3400,7
2022-08-10,Monterey,053,433212,91888,91307,19822,111129,758
2022-08-10,Napa,055,140530,31402,31223,1377,32600,153
2022-08-10,Nevada,057,99092,18443,18354,1712,20066,132
2022-08-10,Orange,059,3164182,649200,646005,58075,704080,7235
2022-08-10,Placer,061,380077,73764,73348,9110,82458,650
2022-08-10,Plumas,063,18699,3539,3525,429,3954,13
2022-08-10,Riverside,065,2383286,676454,672334,33637,705971,6555
2022-08-10,Sacramento,067,1510023,336039,334382,32298,366680,3177
2022-08-10,San Benito,069,59416,15606,15507,882,16389,101
2022-08-10,San Bernardino,071,2135413,650794,641936,29319,671255,7977
2022-08-10,San Diego,073,3302833,900281,895482,68644,964126,5429
2022-08-10,San Francisco,075,870044,173294,172265,11689,183954,945
2022-08-10,San Joaquin,077,732212,191686,190596,13465,204061,2281
2022-08-10,San Luis Obispo,079,281455,61736,61207,6728,67935,510
2022-08-10,San Mateo,081,765935,162849,161882,10281,172163,738
2022-08-10,Santa Barbara,083,443738,102378,101558,6459,108017,711
2022-08-10,Santa Clara,085,1922200,417137,414659,18167,432826,2398
2022-08-10,Santa Cruz,087,273765,60860,60360,3267,63627,269
2022-08-10,Shasta,089,179085,34012,33816,7081,40897,584
2022-08-10,Sierra,091,2930,297,295,59,354,4
2022-08-10,Siskiyou,093,43540,5102,5074,3230,8304,87
2022-08-10,Solano,095,438530,101899,101393,7420,108813,457
2022-08-10,Sonoma,097,501317,103848,103168,5077,108245,501
2022-08-10,Stanislaus,099,539301,133713,133071,20139,153210,1702
2022-08-10,Sutter,101,95872,23398,23279,2410,25689,228
2022-08-10,Tehama,103,63373,13273,13187,2973,16160,209
2022-08-10,Trinity,105,12862,1360,1350,355,1705,20
2022-08-10,Tulare,107,460477,118692,118239,33911,152150,1520
2022-08-10,Tuolumne,109,53932,15033,14922,884,15806,196
2022-08-10,Ventura,111,848112,202348,201179,14410,215589,1539
2022-08-10,Yolo,113,214977,46271,46069,4187,50256,330
2022-08-10,Yuba,115,75493,18252,18179,1604,19783,129
2022-08-09,Alameda,001,1643700,335203,333587,18986,352573,1944
2022-08-09,Alpine,003,1148,131,131,1,132,0
2022-08-09,Amador,005,37829,9717,9677,880,10557,88
2022-08-09,Butte,007,227075,38178,37892,8538,46430,446
2022-08-09,Calaveras,009,45235,8276,8251,490,8741,130
2022-08-09,Colusa,011,21464,3704,3700,1209,4909,22
2022-08-09,Contra Costa,013,1133247,241372,238658,19575,258233,1382
2022-08-09,Del Norte,015,27424,7243,7220,383,7603,54
2022-08-09,El Dorado,017,186661,31496,31354,4083,35437,225
2022-08-09,Fresno,019,978130,266521,265300,29065,294365,2815
2022-08-09,Glenn,021,27897,5405,5387,1822,7209,48
2022-08-09,Humboldt,023,135768,20967,20843,4604,25447,153
2022-08-09,Imperial,025,180216,63820,63532,14686,78218,949
2022-08-09,Inyo,027,18085,4423,4416,843,5259,57
2022-08-09,Kern,029,883053,214029,212602,57010,269612,2380
2022-08-09,Kings,031,150075,57774,57569,3919,61488,453
2022-08-09,Lake,033,64148,12333,12281,1108,13389,142
2022-08-09,Lassen,035,31185,9796,9682,969,10651,64
2022-08-09,Los Angeles,037,10098052,3187030,3168105,169598,3337703,32609
2022-08-09,Madera,039,155013,42549,42350,7675,50025,372
2022-08-09,Marin,041,260295,43690,43532,5062,48594,302
2022-08-09,Mariposa,043,17540,3001,2980,323,3303,31
2022-08-09,Mendocino,045,87422,15499,15394,4243,19637,132
2022-08-09,Merced,047,269075,70155,69740,10789,80529,839
2022-08-09,Modoc,049,8938,858,855,311,1166,11
2022-08-09,Mono,051,14174,3174,3165,234,3399,7
2022-08-09,Monterey,053,433212,91776,91307,19757,111064,758
2022-08-09,Napa,055,140530,31374,31223,1375,32598,153
2022-08-09,Nevada,057,99092,18431,18354,1710,20064,132
2022-08-09,Orange,059,3164182,648389,646005,57935,703940,7235
2022-08-09,Placer,061,380077,73700,73348,9104,82452,650
2022-08-09,Plumas,063,18699,3534,3525,429,3954,13
2022-08-09,Riverside,065,2383286,675701,672334,33582,705916,6555
2022-08-09,Sacramento,067,1510023,335625,334382,32266,366648,3177
2022-08-09,San Benito,069,59416,15589,15507,877,16384,101
2022-08-09,San Bernardino,071,2135413,650123,641936,29261,671197,7977
2022-08-09,San Diego,073,3302833,899389,895482,68507,963989,5429
2022-08-09,San Francisco,075,870044,173049,172265,11670,183935,945
2022-08-09,San Joaquin,077,732212,191475,190596,13426,204022,2281
2022-08-09,San Luis Obispo,079,281455,61679,61207,6704,67911,510
2022-08-09,San Mateo,081,765935,162657,161882,10265,172147,738
2022-08-09,Santa Barbara,083,443738,102221,101558,6429,107987,711
2022-08-09,Santa Clara,085,1922200,416610,414659,18147,432806,2398
2022-08-09,Santa Cruz,087,273765,60786,60360,3258,63618,269
2022-08-09,Shasta,089,179085,33990,33816,7078,40894,584
2022-08-09,Sierra,091,2930,297,295,59,354,4
2022-08-09,Siskiyou,093,43540,5098,5074,3226,8300,87
2022-08-09,Solano,095,438530,101795,101393,7408,108801,457
2022-08-09,Sonoma,097,501317,103746,103168,5069,108237,501
2022-08-09,Stanislaus,099,539301,133571,133071,20108,153179,1702
2022-08-09,Sutter,101,95872,23367,23279,2408,25687,228
2022-08-09,Tehama,103,63373,13260,13187,2963,16150,209
2022-08-09,Trinity,105,12862,1358,1350,354,1704,20
2022-08-09,Tulare,107,460477,118579,118239,33822,152061,1520
2022-08-09,Tuolumne,109,53932,15017,14922,884,15806,196
2022-08-09,Ventura,111,848112,202115,201179,14377,215556,1539
2022-08-09,Yolo,113,214977,46229,46069,4175,50244,330
2022-08-09,Yuba,115,75493,18233,18179,1594,19773,129
2022-08-08,Alameda,001,1643700,334746,333587,18944,352531,1944
2022-08-08,Alpine,003,1148,131,131,1,132,0
2022-08-08,Amador,005,37829,9711,9677,879,10556,88
2022-08-08,Butte,007,227075,38125,37892,8524,46416,446
2022-08-08,Calaveras,009,45235,8271,8251,487,8738,130
2022-08-08,Colusa,011,21464,3704,3700,1208,4908,22
2022-08-08,Contra Costa,013,1133247,240999,238658,19527,258185,1382
2022-08-08,Del Norte,015,27424,7236,7220,382,7602,54
2022-08-08,El Dorado,017,186661,31467,31354,4076,35430,225
2022-08-08,Fresno,019,978130,266159,265300,29017,294317,2815
2022-08-08,Glenn,021,27897,5399,5387,1821,7208,48
2022-08-08,Humboldt,023,135768,20929,20843,4587,25430,153
2022-08-08,Imperial,025,180216,63761,63532,14618,78150,949
2022-08-08,Inyo,027,18085,4422,4416,842,5258,57
2022-08-08,Kern,029,883053,213772,212602,56894,269496,2380
2022-08-08,Kings,031,150075,57713,57569,3910,61479,453
2022-08-08,Lake,033,64148,12312,12281,1104,13385,142
2022-08-08,Lassen,035,31185,9783,9682,966,10648,64
2022-08-08,Los Angeles,037,10098052,3183447,3168105,169178,3337283,32609
2022-08-08,Madera,039,155013,42491,42350,7651,50001,372
2022-08-08,Marin,041,260295,43635,43532,5050,48582,302
2022-08-08,Mariposa,043,17540,2997,2980,319,3299,31
2022-08-08,Mendocino,045,87422,15485,15394,4233,19627,132
2022-08-08,Merced,047,269075,70084,69740,10762,80502,839
2022-08-08,Modoc,049,8938,857,855,311,1166,11
2022-08-08,Mono,051,14174,3174,3165,234,3399,7
2022-08-08,Monterey,053,433212,91677,91307,19677,110984,758
2022-08-08,Napa,055,140530,31339,31223,1374,32597,153
2022-08-08,Nevada,057,99092,18416,18354,1702,20056,132
2022-08-08,Orange,059,3164182,647558,646005,57776,703781,7235
2022-08-08,Placer,061,380077,73641,73348,9095,82443,650
2022-08-08,Plumas,063,18699,3531,3525,428,3953,13
2022-08-08,Riverside,065,2383286,674904,672334,33530,705864,6555
2022-08-08,Sacramento,067,1510023,335223,334382,32228,366610,3177
2022-08-08,San Benito,069,59416,15564,15507,874,16381,101
2022-08-08,San Bernardino,071,2135413,649299,641936,29201,671137,7977
2022-08-08,San Diego,073,3302833,898294,895482,68386,963868,5429
2022-08-08,San Francisco,075,870044,172835,172265,11653,183918,945
2022-08-08,San Joaquin,077,732212,191212,190596,13387,203983,2281
2022-08-08,San Luis Obispo,079,281455,61616,61207,6680,67887,510
2022-08-08,San Mateo,081,765935,162449,161882,10254,172136,738
2022-08-08,Santa Barbara,083,443738,102088,101558,6412,107970,711
2022-08-08,Santa Clara,085,1922200,416002,414659,18124,432783,2398
2022-08-08,Santa Cruz,087,273765,60710,60360,3255,63615,269
2022-08-08,Shasta,089,179085,33961,33816,7069,40885,584
2022-08-08,Sierra,091,2930,297,295,59,354,4
2022-08-08,Siskiyou,093,43540,5095,5074,3223,8297,87
2022-08-08,Solano,095,438530,101653,101393,7393,108786,457
2022-08-08,Sonoma,097,501317,103632,103168,5060,108228,501
2022-08-08,Stanislaus,099,539301,133447,133071,20084,153155,1702
2022-08-08,Sutter,101,95872,23330,23279,2408,25687,228
2022-08-08,Tehama,103,63373,13250,13187,2961,16148,209
2022-08-08,Trinity,105,12862,1358,1350,353,1703,20
2022-08-08,Tulare,107,460477,118439,118239,33737,151976,1520
2022-08-08,Tuolumne,109,53932,15009,14922,883,15805,196
2022-08-08,Ventura,111,848112,201872,201179,14330,215509,1539
2022-08-08,Yolo,113,214977,46175,46069,4169,50238,330
2022-08-08,Yuba,115,75493,18209,18179,1592,19771,129
2022-08-07,Alameda,001,1643700,334191,331755,18903,350658,1945
2022-08-07,Alpine,003,1148,131,130,1,131,0
2022-08-07,Amador,005,37829,9704,9655,877,10532,88
2022-08-07,Butte,007,227075,38055,37717,8509,46226,446
2022-08-07,Calaveras,009,45235,8258,8219,483,8702,129
2022-08-07,Colusa,011,21464,3700,3696,1207,4903,22
2022-08-07,Contra Costa,013,1133247,240609,237436,19480,256916,1383
2022-08-07,Del Norte,015,27424,7224,7191,379,7570,54
2022-08-07,El Dorado,017,186661,31427,31240,4071,35311,225
2022-08-07,Fresno,019,978130,265744,263912,28944,292856,2815
2022-08-07,Glenn,021,27897,5397,5379,1818,7197,48
2022-08-07,Humboldt,023,135768,20892,20746,4566,25312,153
2022-08-07,Imperial,025,180216,63680,63198,14546,77744,949
2022-08-07,Inyo,027,18085,4422,4408,839,5247,57
2022-08-07,Kern,029,883053,213541,211798,56755,268553,2375
2022-08-07,Kings,031,150075,57616,57294,3902,61196,453
2022-08-07,Lake,033,64148,12300,12220,1103,13323,142
2022-08-07,Lassen,035,31185,9727,9654,966,10620,64
2022-08-07,Los Angeles,037,10098052,3179066,3153757,168795,3322552,32563
2022-08-07,Madera,039,155013,42433,42139,7615,49754,372
2022-08-07,Marin,041,260295,43579,43295,5040,48335,302
2022-08-07,Mariposa,043,17540,2994,2965,318,3283,31
2022-08-07,Mendocino,045,87422,15466,15335,4214,19549,132
2022-08-07,Merced,047,269075,69963,69498,10719,80217,838
2022-08-07,Modoc,049,8938,856,853,311,1164,11
2022-08-07,Mono,051,14174,3171,3161,233,3394,7
2022-08-07,Monterey,053,433212,91545,90884,19587,110471,757
2022-08-07,Napa,055,140530,31295,31052,1372,32424,151
2022-08-07,Nevada,057,99092,18392,18309,1696,20005,132
2022-08-07,Orange,059,3164182,646664,643029,57601,700630,7213
2022-08-07,Placer,061,380077,73550,73064,9079,82143,648
2022-08-07,Plumas,063,18699,3530,3516,428,3944,13
2022-08-07,Riverside,065,2383286,673975,669230,33448,702678,6555
2022-08-07,Sacramento,067,1510023,334733,332928,32178,365106,3175
2022-08-07,San Benito,069,59416,15538,15403,871,16274,101
2022-08-07,San Bernardino,071,2135413,648408,639120,29138,668258,7956
2022-08-07,San Diego,073,3302833,897013,891504,68275,959779,5424
2022-08-07,San Francisco,075,870044,172560,171486,11628,183114,946
2022-08-07,San Joaquin,077,732212,190916,189696,13335,203031,2276
2022-08-07,San Luis Obispo,079,281455,61518,60903,6648,67551,510
2022-08-07,San Mateo,081,765935,162203,161011,10238,171249,734
2022-08-07,Santa Barbara,083,443738,101903,100995,6384,107379,711
2022-08-07,Santa Clara,085,1922200,415289,412411,18104,430515,2386
2022-08-07,Santa Cruz,087,273765,60589,59982,3239,63221,269
2022-08-07,Shasta,089,179085,33913,33727,7055,40782,583
2022-08-07,Sierra,091,2930,296,295,59,354,4
2022-08-07,Siskiyou,093,43540,5089,5045,3218,8263,87
2022-08-07,Solano,095,438530,101495,100081,7376,107457,457
2022-08-07,Sonoma,097,501317,103514,102682,5052,107734,502
2022-08-07,Stanislaus,099,539301,133253,132406,20053,152459,1701
2022-08-07,Sutter,101,95872,23293,23178,2407,25585,228
2022-08-07,Tehama,103,63373,13240,13155,2957,16112,209
2022-08-07,Trinity,105,12862,1356,1347,352,1699,20
2022-08-07,Tulare,107,460477,118288,117668,33637,151305,1516
2022-08-07,Tuolumne,109,53932,14992,14844,883,15727,196
2022-08-07,Ventura,111,848112,201613,200270,14284,214554,1537
2022-08-07,Yolo,113,214977,46125,45902,4159,50061,331
2022-08-07,Yuba,115,75493,18190,18099,1588,19687,124
2022-08-06,Alameda,001,1643700,333950,331755,18891,350646,1945
2022-08-06,Alpine,003,1148,131,130,1,131,0
2022-08-06,Amador,005,37829,9697,9655,875,10530,88
2022-08-06,Butte,007,227075,38017,37717,8498,46215,446
2022-08-06,Calaveras,009,45235,8251,8219,482,8701,129
2022-08-06,Colusa,011,21464,3698,3696,1204,4900,22
2022-08-06,Contra Costa,013,1133247,240364,237436,19460,256896,1383
2022-08-06,Del Norte,015,27424,7218,7191,379,7570,54
2022-08-06,El Dorado,017,186661,31410,31240,4068,35308,225
2022-08-06,Fresno,019,978130,265566,263912,28922,292834,2815
2022-08-06,Glenn,021,27897,5397,5379,1817,7196,48
2022-08-06,Humboldt,023,135768,20871,20746,4557,25303,153
2022-08-06,Imperial,025,180216,63634,63198,14518,77716,949
2022-08-06,Inyo,027,18085,4422,4408,838,5246,57
2022-08-06,Kern,029,883053,213446,211798,56685,268483,2375
2022-08-06,Kings,031,150075,57576,57294,3902,61196,453
2022-08-06,Lake,033,64148,12295,12220,1103,13323,142
2022-08-06,Lassen,035,31185,9694,9654,966,10620,64
2022-08-06,Los Angeles,037,10098052,3176892,3153757,168512,3322269,32563
2022-08-06,Madera,039,155013,42389,42139,7609,49748,372
2022-08-06,Marin,041,260295,43550,43295,5035,48330,302
2022-08-06,Mariposa,043,17540,2993,2965,318,3283,31
2022-08-06,Mendocino,045,87422,15457,15335,4213,19548,132
2022-08-06,Merced,047,269075,69934,69498,10713,80211,838
2022-08-06,Modoc,049,8938,856,853,311,1164,11
2022-08-06,Mono,051,14174,3169,3161,233,3394,7
2022-08-06,Monterey,053,433212,91492,90884,19543,110427,757
2022-08-06,Napa,055,140530,31275,31052,1371,32423,151
2022-08-06,Nevada,057,99092,18384,18309,1694,20003,132
2022-08-06,Orange,059,3164182,646224,643029,57488,700517,7213
2022-08-06,Placer,061,380077,73493,73064,9072,82136,648
2022-08-06,Plumas,063,18699,3528,3516,428,3944,13
2022-08-06,Riverside,065,2383286,673459,669230,33409,702639,6555
2022-08-06,Sacramento,067,1510023,334557,332928,32169,365097,3175
2022-08-06,San Benito,069,59416,15521,15403,869,16272,101
2022-08-06,San Bernardino,071,2135413,647959,639120,29103,668223,7956
2022-08-06,San Diego,073,3302833,896454,891504,68234,959738,5424
2022-08-06,San Francisco,075,870044,172405,171486,11618,183104,946
2022-08-06,San Joaquin,077,732212,190786,189696,13315,203011,2276
2022-08-06,San Luis Obispo,079,281455,61490,60903,6643,67546,510
2022-08-06,San Mateo,081,765935,162067,161011,10231,171242,734
2022-08-06,Santa Barbara,083,443738,101831,100995,6370,107365,711
2022-08-06,Santa Clara,085,1922200,414828,412411,18087,430498,2386
2022-08-06,Santa Cruz,087,273765,60532,59982,3232,63214,269
2022-08-06,Shasta,089,179085,33882,33727,7045,40772,583
2022-08-06,Sierra,091,2930,296,295,59,354,4
2022-08-06,Siskiyou,093,43540,5082,5045,3216,8261,87
2022-08-06,Solano,095,438530,101448,100081,7371,107452,457
2022-08-06,Sonoma,097,501317,103449,102682,5043,107725,502
2022-08-06,Stanislaus,099,539301,133149,132406,20044,152450,1701
2022-08-06,Sutter,101,95872,23269,23178,2407,25585,228
2022-08-06,Tehama,103,63373,13235,13155,2953,16108,209
2022-08-06,Trinity,105,12862,1356,1347,352,1699,20
2022-08-06,Tulare,107,460477,118207,117668,33595,151263,1516
2022-08-06,Tuolumne,109,53932,14984,14844,882,15726,196
2022-08-06,Ventura,111,848112,201505,200270,14264,214534,1537
2022-08-06,Yolo,113,214977,46093,45902,4152,50054,331
2022-08-06,Yuba,115,75493,18175,18099,1587,19686,124
2022-08-05,Alameda,001,1643700,333644,331755,18881,350636,1945
2022-08-05,Alpine,003,1148,131,130,1,131,0
2022-08-05,Amador,005,37829,9695,9655,874,10529,88
2022-08-05,Butte,007,227075,37979,37717,8487,46204,446
2022-08-05,Calaveras,009,45235,8247,8219,482,8701,129
2022-08-05,Colusa,011,21464,3697,3696,1204,4900,22
2022-08-05,Contra Costa,013,1133247,240171,237436,19432,256868,1383
2022-08-05,Del Norte,015,27424,7214,7191,378,7569,54
2022-08-05,El Dorado,017,186661,31402,31240,4067,35307,225
2022-08-05,Fresno,019,978130,265388,263912,28898,292810,2815
2022-08-05,Glenn,021,27897,5396,5379,1816,7195,48
2022-08-05,Humboldt,023,135768,20854,20746,4544,25290,153
2022-08-05,Imperial,025,180216,63559,63198,14479,77677,949
2022-08-05,Inyo,027,18085,4422,4408,838,5246,57
2022-08-05,Kern,029,883053,213333,211798,56620,268418,2375
2022-08-05,Kings,031,150075,57551,57294,3900,61194,453
2022-08-05,Lake,033,64148,12285,12220,1103,13323,142
2022-08-05,Lassen,035,31185,9682,9654,965,10619,64
2022-08-05,Los Angeles,037,10098052,3174419,3153757,168234,3321991,32563
2022-08-05,Madera,039,155013,42346,42139,7599,49738,372
2022-08-05,Marin,041,260295,43507,43295,5029,48324,302
2022-08-05,Mariposa,043,17540,2989,2965,316,3281,31
2022-08-05,Mendocino,045,87422,15443,15335,4209,19544,132
2022-08-05,Merced,047,269075,69884,69498,10706,80204,838
2022-08-05,Modoc,049,8938,856,853,311,1164,11
2022-08-05,Mono,051,14174,3168,3161,233,3394,7
2022-08-05,Monterey,053,433212,91425,90884,19507,110391,757
2022-08-05,Napa,055,140530,31245,31052,1370,32422,151
2022-08-05,Nevada,057,99092,18375,18309,1692,20001,132
2022-08-05,Orange,059,3164182,645722,643029,57385,700414,7213
2022-08-05,Placer,061,380077,73443,73064,9062,82126,648
2022-08-05,Plumas,063,18699,3526,3516,428,3944,13
2022-08-05,Riverside,065,2383286,672901,669230,33361,702591,6555
2022-08-05,Sacramento,067,1510023,334315,332928,32151,365079,3175
2022-08-05,San Benito,069,59416,15501,15403,867,16270,101
2022-08-05,San Bernardino,071,2135413,647500,639120,29077,668197,7956
2022-08-05,San Diego,073,3302833,895790,891504,68152,959656,5424
2022-08-05,San Francisco,075,870044,172262,171486,11598,183084,946
2022-08-05,San Joaquin,077,732212,190657,189696,13295,202991,2276
2022-08-05,San Luis Obispo,079,281455,61455,60903,6635,67538,510
2022-08-05,San Mateo,081,765935,161895,161011,10220,171231,734
2022-08-05,Santa Barbara,083,443738,101730,100995,6362,107357,711
2022-08-05,Santa Clara,085,1922200,414326,412411,18059,430470,2386
2022-08-05,Santa Cruz,087,273765,60465,59982,3228,63210,269
2022-08-05,Shasta,089,179085,33872,33727,7042,40769,583
2022-08-05,Sierra,091,2930,296,295,59,354,4
2022-08-05,Siskiyou,093,43540,5077,5045,3214,8259,87
2022-08-05,Solano,095,438530,101371,100081,7363,107444,457
2022-08-05,Sonoma,097,501317,103373,102682,5038,107720,502
2022-08-05,Stanislaus,099,539301,133047,132406,20036,152442,1701
2022-08-05,Sutter,101,95872,23248,23178,2405,25583,228
2022-08-05,Tehama,103,63373,13227,13155,2953,16108,209
2022-08-05,Trinity,105,12862,1355,1347,352,1699,20
2022-08-05,Tulare,107,460477,118120,117668,33542,151210,1516
2022-08-05,Tuolumne,109,53932,14971,14844,881,15725,196
2022-08-05,Ventura,111,848112,201356,200270,14235,214505,1537
2022-08-05,Yolo,113,214977,46075,45902,4137,50039,331
2022-08-05,Yuba,115,75493,18167,18099,1586,19685,124
2022-08-04,Alameda,001,1643700,333182,331755,18833,350588,1945
2022-08-04,Alpine,003,1148,130,130,1,131,0
2022-08-04,Amador,005,37829,9684,9655,870,10525,88
2022-08-04,Butte,007,227075,37935,37717,8471,46188,446
2022-08-04,Calaveras,009,45235,8240,8219,481,8700,129
2022-08-04,Colusa,011,21464,3696,3696,1204,4900,22
2022-08-04,Contra Costa,013,1133247,239894,237436,19393,256829,1383
2022-08-04,Del Norte,015,27424,7206,7191,377,7568,54
2022-08-04,El Dorado,017,186661,31370,31240,4064,35304,225
2022-08-04,Fresno,019,978130,265062,263912,28841,292753,2815
2022-08-04,Glenn,021,27897,5392,5379,1813,7192,48
2022-08-04,Humboldt,023,135768,20830,20746,4531,25277,153
2022-08-04,Imperial,025,180216,63491,63198,14425,77623,949
2022-08-04,Inyo,027,18085,4421,4408,837,5245,57
2022-08-04,Kern,029,883053,213127,211798,56531,268329,2375
2022-08-04,Kings,031,150075,57485,57294,3892,61186,453
2022-08-04,Lake,033,64148,12271,12220,1102,13322,142
2022-08-04,Lassen,035,31185,9676,9654,962,10616,64
2022-08-04,Los Angeles,037,10098052,3170766,3153757,167856,3321613,32563
2022-08-04,Madera,039,155013,42302,42139,7556,49695,372
2022-08-04,Marin,041,260295,43453,43295,5000,48295,302
2022-08-04,Mariposa,043,17540,2984,2965,314,3279,31
2022-08-04,Mendocino,045,87422,15430,15335,4201,19536,132
2022-08-04,Merced,047,269075,69813,69498,10667,80165,838
2022-08-04,Modoc,049,8938,856,853,311,1164,11
2022-08-04,Mono,051,14174,3168,3161,233,3394,7
2022-08-04,Monterey,053,433212,91315,90884,19441,110325,757
2022-08-04,Napa,055,140530,31209,31052,1369,32421,151
2022-08-04,Nevada,057,99092,18363,18309,1685,19994,132
2022-08-04,Orange,059,3164182,644955,643029,57245,700274,7213
2022-08-04,Placer,061,380077,73373,73064,9049,82113,648
2022-08-04,Plumas,063,18699,3521,3516,428,3944,13
2022-08-04,Riverside,065,2383286,672186,669230,33315,702545,6555
2022-08-04,Sacramento,067,1510023,333895,332928,32129,365057,3175
2022-08-04,San Benito,069,59416,15473,15403,859,16262,101
2022-08-04,San Bernardino,071,2135413,646805,639120,29023,668143,7956
2022-08-04,San Diego,073,3302833,894799,891504,68049,959553,5424
2022-08-04,San Francisco,075,870044,172055,171486,11570,183056,946
2022-08-04,San Joaquin,077,732212,190455,189696,13267,202963,2276
2022-08-04,San Luis Obispo,079,281455,61387,60903,6608,67511,510
2022-08-04,San Mateo,081,765935,161674,161011,10213,171224,734
2022-08-04,Santa Barbara,083,443738,101597,100995,6341,107336,711
2022-08-04,Santa Clara,085,1922200,413747,412411,18029,430440,2386
2022-08-04,Santa Cruz,087,273765,60377,59982,3227,63209,269
2022-08-04,Shasta,089,179085,33849,33727,7028,40755,583
2022-08-04,Sierra,091,2930,296,295,59,354,4
2022-08-04,Siskiyou,093,43540,5071,5045,3208,8253,87
2022-08-04,Solano,095,438530,101260,100081,7353,107434,457
2022-08-04,Sonoma,097,501317,103266,102682,5027,107709,502
2022-08-04,Stanislaus,099,539301,132889,132406,20014,152420,1701
2022-08-04,Sutter,101,95872,23222,23178,2403,25581,228
2022-08-04,Tehama,103,63373,13213,13155,2948,16103,209
2022-08-04,Trinity,105,12862,1354,1347,351,1698,20
2022-08-04,Tulare,107,460477,118005,117668,33481,151149,1516
2022-08-04,Tuolumne,109,53932,14947,14844,879,15723,196
2022-08-04,Ventura,111,848112,201127,200270,14197,214467,1537
2022-08-04,Yolo,113,214977,46039,45902,4129,50031,331
2022-08-04,Yuba,115,75493,18148,18099,1585,19684,124
2022-08-03,Alameda,001,1643700,332674,330158,18800,348958,1941
2022-08-03,Alpine,003,1148,130,130,1,131,0
2022-08-03,Amador,005,37829,9678,9627,867,10494,88
2022-08-03,Butte,007,227075,37891,37567,8460,46027,444
2022-08-03,Calaveras,009,45235,8232,8194,480,8674,128
2022-08-03,Colusa,011,21464,3696,3676,1204,4880,22
2022-08-03,Contra Costa,013,1133247,239572,236190,19342,255532,1381
2022-08-03,Del Norte,015,27424,7202,7156,377,7533,54
2022-08-03,El Dorado,017,186661,31334,31165,4054,35219,222
2022-08-03,Fresno,019,978130,264667,262758,28796,291554,2806
2022-08-03,Glenn,021,27897,5390,5363,1809,7172,48
2022-08-03,Humboldt,023,135768,20798,20640,4513,25153,153
2022-08-03,Imperial,025,180216,63412,62884,14374,77258,949
2022-08-03,Inyo,027,18085,4421,4398,831,5229,57
2022-08-03,Kern,029,883053,212943,211047,56422,267469,2375
2022-08-03,Kings,031,150075,57421,57065,3890,60955,453
2022-08-03,Lake,033,64148,12254,12172,1099,13271,142
2022-08-03,Lassen,035,31185,9673,9563,962,10525,64
2022-08-03,Los Angeles,037,10098052,3167079,3140955,167475,3308430,32500
2022-08-03,Madera,039,155013,42254,41918,7537,49455,372
2022-08-03,Marin,041,260295,43392,43127,4985,48112,300
2022-08-03,Mariposa,043,17540,2980,2950,314,3264,30
2022-08-03,Mendocino,045,87422,15413,15260,4193,19453,132
2022-08-03,Merced,047,269075,69747,69198,10639,79837,838
2022-08-03,Modoc,049,8938,855,842,311,1153,11
2022-08-03,Mono,051,14174,3168,3157,231,3388,7
2022-08-03,Monterey,053,433212,91210,90456,19376,109832,754
2022-08-03,Napa,055,140530,31172,30935,1364,32299,151
2022-08-03,Nevada,057,99092,18352,18253,1682,19935,132
2022-08-03,Orange,059,3164182,644136,640110,57079,697189,7202
2022-08-03,Placer,061,380077,73292,72834,9035,81869,646
2022-08-03,Plumas,063,18699,3518,3496,428,3924,13
2022-08-03,Riverside,065,2383286,671333,666773,33250,700023,6547
2022-08-03,Sacramento,067,1510023,333463,331584,32095,363679,3162
2022-08-03,San Benito,069,59416,15443,15338,852,16190,100
2022-08-03,San Bernardino,071,2135413,646082,636510,28967,665477,7951
2022-08-03,San Diego,073,3302833,893584,887729,67921,955650,5417
2022-08-03,San Francisco,075,870044,171850,170637,11551,182188,939
2022-08-03,San Joaquin,077,732212,190213,188962,13242,202204,2276
2022-08-03,San Luis Obispo,079,281455,61303,60648,6592,67240,504
2022-08-03,San Mateo,081,765935,161487,160258,10201,170459,725
2022-08-03,Santa Barbara,083,443738,101475,100558,6319,106877,710
2022-08-03,Santa Clara,085,1922200,413272,410394,18000,428394,2383
2022-08-03,Santa Cruz,087,273765,60286,59661,3224,62885,269
2022-08-03,Shasta,089,179085,33821,33630,7022,40652,582
2022-08-03,Sierra,091,2930,296,295,59,354,4
2022-08-03,Siskiyou,093,43540,5067,5021,3206,8227,86
2022-08-03,Solano,095,438530,101142,99608,7341,106949,459
2022-08-03,Sonoma,097,501317,103143,102306,5014,107320,500
2022-08-03,Stanislaus,099,539301,132746,131869,19989,151858,1701
2022-08-03,Sutter,101,95872,23193,23056,2401,25457,228
2022-08-03,Tehama,103,63373,13201,13135,2944,16079,209
2022-08-03,Trinity,105,12862,1354,1342,350,1692,20
2022-08-03,Tulare,107,460477,117869,117288,33413,150701,1516
2022-08-03,Tuolumne,109,53932,14928,14778,878,15656,196
2022-08-03,Ventura,111,848112,200892,199530,14159,213689,1536
2022-08-03,Yolo,113,214977,45992,45757,4110,49867,330
2022-08-03,Yuba,115,75493,18119,18036,1584,19620,124
2022-08-02,Alameda,001,1643700,332135,330158,18765,348923,1941
2022-08-02,Alpine,003,1148,130,130,1,131,0
2022-08-02,Amador,005,37829,9669,9627,860,10487,88
2022-08-02,Butte,007,227075,37852,37567,8448,46015,444
2022-08-02,Calaveras,009,45235,8217,8194,478,8672,128
2022-08-02,Colusa,011,21464,3693,3676,1204,4880,22
2022-08-02,Contra Costa,013,1133247,239219,236190,19279,255469,1381
2022-08-02,Del Norte,015,27424,7192,7156,377,7533,54
2022-08-02,El Dorado,017,186661,31300,31165,4048,35213,222
2022-08-02,Fresno,019,978130,264243,262758,28713,291471,2806
2022-08-02,Glenn,021,27897,5386,5363,1807,7170,48
2022-08-02,Humboldt,023,135768,20761,20640,4490,25130,153
2022-08-02,Imperial,025,180216,63330,62884,14326,77210,949
2022-08-02,Inyo,027,18085,4418,4398,821,5219,57
2022-08-02,Kern,029,883053,212704,211047,56285,267332,2375
2022-08-02,Kings,031,150075,57340,57065,3887,60952,453
2022-08-02,Lake,033,64148,12243,12172,1096,13268,142
2022-08-02,Lassen,035,31185,9670,9563,961,10524,64
2022-08-02,Los Angeles,037,10098052,3162784,3140955,167002,3307957,32500
2022-08-02,Madera,039,155013,42184,41918,7515,49433,372
2022-08-02,Marin,041,260295,43334,43127,4977,48104,300
2022-08-02,Mariposa,043,17540,2976,2950,314,3264,30
2022-08-02,Mendocino,045,87422,15381,15260,4179,19439,132
2022-08-02,Merced,047,269075,69672,69198,10601,79799,838
2022-08-02,Modoc,049,8938,855,842,311,1153,11
2022-08-02,Mono,051,14174,3166,3157,230,3387,7
2022-08-02,Monterey,053,433212,91087,90456,19304,109760,754
2022-08-02,Napa,055,140530,31135,30935,1361,32296,151
2022-08-02,Nevada,057,99092,18337,18253,1681,19934,132
2022-08-02,Orange,059,3164182,643261,640110,56916,697026,7202
2022-08-02,Placer,061,380077,73207,72834,9026,81860,646
2022-08-02,Plumas,063,18699,3513,3496,428,3924,13
2022-08-02,Riverside,065,2383286,670418,666773,33198,699971,6547
2022-08-02,Sacramento,067,1510023,333052,331584,32051,363635,3162
2022-08-02,San Benito,069,59416,15409,15338,849,16187,100
2022-08-02,San Bernardino,071,2135413,645238,636510,28914,665424,7951
2022-08-02,San Diego,073,3302833,892422,887729,67791,955520,5417
2022-08-02,San Francisco,075,870044,171613,170637,11536,182173,939
2022-08-02,San Joaquin,077,732212,189977,188962,13213,202175,2276
2022-08-02,San Luis Obispo,079,281455,61216,60648,6563,67211,504
2022-08-02,San Mateo,081,765935,161243,160258,10197,170455,725
2022-08-02,Santa Barbara,083,443738,101312,100558,6290,106848,710
2022-08-02,Santa Clara,085,1922200,412647,410394,17964,428358,2383
2022-08-02,Santa Cruz,087,273765,60197,59661,3216,62877,269
2022-08-02,Shasta,089,179085,33799,33630,7008,40638,582
2022-08-02,Sierra,091,2930,296,295,59,354,4
2022-08-02,Siskiyou,093,43540,5053,5021,3202,8223,86
2022-08-02,Solano,095,438530,100961,99608,7319,106927,459
2022-08-02,Sonoma,097,501317,102972,102306,4997,107303,500
2022-08-02,Stanislaus,099,539301,132588,131869,19951,151820,1701
2022-08-02,Sutter,101,95872,23159,23056,2400,25456,228
2022-08-02,Tehama,103,63373,13191,13135,2940,16075,209
2022-08-02,Trinity,105,12862,1354,1342,348,1690,20
2022-08-02,Tulare,107,460477,117732,117288,33329,150617,1516
2022-08-02,Tuolumne,109,53932,14911,14778,876,15654,196
2022-08-02,Ventura,111,848112,200639,199530,14115,213645,1536
2022-08-02,Yolo,113,214977,45945,45757,4105,49862,330
2022-08-02,Yuba,115,75493,18098,18036,1580,19616,124
2022-08-01,Alameda,001,1643700,331479,330158,18731,348889,1941
2022-08-01,Alpine,003,1148,130,130,1,131,0
2022-08-01,Amador,005,37829,9662,9627,858,10485,88
2022-08-01,Butte,007,227075,37795,37567,8433,46000,444
2022-08-01,Calaveras,009,45235,8214,8194,477,8671,128
2022-08-01,Colusa,011,21464,3689,3676,1195,4871,22
2022-08-01,Contra Costa,013,1133247,238825,236190,19222,255412,1381
2022-08-01,Del Norte,015,27424,7187,7156,377,7533,54
2022-08-01,El Dorado,017,186661,31272,31165,4043,35208,222
2022-08-01,Fresno,019,978130,263789,262758,28635,291393,2806
2022-08-01,Glenn,021,27897,5378,5363,1806,7169,48
2022-08-01,Humboldt,023,135768,20730,20640,4472,25112,153
2022-08-01,Imperial,025,180216,63214,62884,14266,77150,949
2022-08-01,Inyo,027,18085,4414,4398,817,5215,57
2022-08-01,Kern,029,883053,212466,211047,56178,267225,2375
2022-08-01,Kings,031,150075,57248,57065,3876,60941,453
2022-08-01,Lake,033,64148,12214,12172,1095,13267,142
2022-08-01,Lassen,035,31185,9650,9563,961,10524,64
2022-08-01,Los Angeles,037,10098052,3158097,3140955,166532,3307487,32500
2022-08-01,Madera,039,155013,42102,41918,7484,49402,372
2022-08-01,Marin,041,260295,43281,43127,4952,48079,300
2022-08-01,Mariposa,043,17540,2972,2950,312,3262,30
2022-08-01,Mendocino,045,87422,15357,15260,4170,19430,132
2022-08-01,Merced,047,269075,69565,69198,10576,79774,838
2022-08-01,Modoc,049,8938,855,842,311,1153,11
2022-08-01,Mono,051,14174,3165,3157,228,3385,7
2022-08-01,Monterey,053,433212,90941,90456,19228,109684,754
2022-08-01,Napa,055,140530,31087,30935,1358,32293,151
2022-08-01,Nevada,057,99092,18325,18253,1676,19929,132
2022-08-01,Orange,059,3164182,642316,640110,56752,696862,7202
2022-08-01,Placer,061,380077,73140,72834,9014,81848,646
2022-08-01,Plumas,063,18699,3509,3496,428,3924,13
2022-08-01,Riverside,065,2383286,669409,666773,33149,699922,6547
2022-08-01,Sacramento,067,1510023,332615,331584,32011,363595,3162
2022-08-01,San Benito,069,59416,15390,15338,849,16187,100
2022-08-01,San Bernardino,071,2135413,644318,636510,28859,665369,7951
2022-08-01,San Diego,073,3302833,890995,887729,67619,955348,5417
2022-08-01,San Francisco,075,870044,171356,170637,11521,182158,939
2022-08-01,San Joaquin,077,732212,189707,188962,13180,202142,2276
2022-08-01,San Luis Obispo,079,281455,61120,60648,6546,67194,504
2022-08-01,San Mateo,081,765935,160951,160258,10184,170442,725
2022-08-01,Santa Barbara,083,443738,101137,100558,6265,106823,710
2022-08-01,Santa Clara,085,1922200,411872,410394,17938,428332,2383
2022-08-01,Santa Cruz,087,273765,60092,59661,3204,62865,269
2022-08-01,Shasta,089,179085,33773,33630,6996,40626,582
2022-08-01,Sierra,091,2930,296,295,59,354,4
2022-08-01,Siskiyou,093,43540,5045,5021,3194,8215,86
2022-08-01,Solano,095,438530,100780,99608,7300,106908,459
2022-08-01,Sonoma,097,501317,102803,102306,4986,107292,500
2022-08-01,Stanislaus,099,539301,132413,131869,19926,151795,1701
2022-08-01,Sutter,101,95872,23104,23056,2399,25455,228
2022-08-01,Tehama,103,63373,13175,13135,2934,16069,209
2022-08-01,Trinity,105,12862,1353,1342,347,1689,20
2022-08-01,Tulare,107,460477,117560,117288,33247,150535,1516
2022-08-01,Tuolumne,109,53932,14892,14778,876,15654,196
2022-08-01,Ventura,111,848112,200388,199530,14068,213598,1536
2022-08-01,Yolo,113,214977,45894,45757,4089,49846,330
2022-08-01,Yuba,115,75493,18074,18036,1576,19612,124
2022-07-31,Alameda,001,1643700,330749,327608,18694,346302,1941
2022-07-31,Alpine,003,1148,130,130,1,131,0
2022-07-31,Amador,005,37829,9649,9609,853,10462,88
2022-07-31,Butte,007,227075,37719,37349,8413,45762,444
2022-07-31,Calaveras,009,45235,8202,8145,474,8619,128
2022-07-31,Colusa,011,21464,3685,3664,1193,4857,22
2022-07-31,Contra Costa,013,1133247,238356,234635,19151,253786,1375
2022-07-31,Del Norte,015,27424,7175,7136,374,7510,54
2022-07-31,El Dorado,017,186661,31245,31007,4035,35042,222
2022-07-31,Fresno,019,978130,263240,260858,28555,289413,2805
2022-07-31,Glenn,021,27897,5375,5350,1804,7154,48
2022-07-31,Humboldt,023,135768,20691,20523,4440,24963,151
2022-07-31,Imperial,025,180216,63109,62471,14185,76656,949
2022-07-31,Inyo,027,18085,4409,4388,812,5200,57
2022-07-31,Kern,029,883053,212157,210190,56008,266198,2375
2022-07-31,Kings,031,150075,57121,56673,3867,60540,454
2022-07-31,Lake,033,64148,12198,12102,1093,13195,142
2022-07-31,Lassen,035,31185,9571,9548,961,10509,64
2022-07-31,Los Angeles,037,10098052,3152959,3122700,165912,3288612,32445
2022-07-31,Madera,039,155013,42012,41641,7450,49091,372
2022-07-31,Marin,041,260295,43208,42840,4939,47779,300
2022-07-31,Mariposa,043,17540,2966,2940,311,3251,30
2022-07-31,Mendocino,045,87422,15338,15172,4161,19333,132
2022-07-31,Merced,047,269075,69437,68853,10533,79386,838
2022-07-31,Modoc,049,8938,851,841,311,1152,11
2022-07-31,Mono,051,14174,3165,3155,225,3380,7
2022-07-31,Monterey,053,433212,90782,89974,19144,109118,754
2022-07-31,Napa,055,140530,31021,30777,1355,32132,150
2022-07-31,Nevada,057,99092,18288,18187,1673,19860,131
2022-07-31,Orange,059,3164182,641329,636403,56552,692955,7194
2022-07-31,Placer,061,380077,73037,72444,8997,81441,647
2022-07-31,Plumas,063,18699,3503,3490,427,3917,13
2022-07-31,Riverside,065,2383286,668360,662929,33063,695992,6543
2022-07-31,Sacramento,067,1510023,332008,329639,31956,361595,3156
2022-07-31,San Benito,069,59416,15362,15256,843,16099,100
2022-07-31,San Bernardino,071,2135413,643219,633131,28763,661894,7941
2022-07-31,San Diego,073,3302833,889402,881822,67469,949291,5409
2022-07-31,San Francisco,075,870044,170960,169564,11480,181044,937
2022-07-31,San Joaquin,077,732212,189353,187937,13109,201046,2276
2022-07-31,San Luis Obispo,079,281455,60974,60370,6511,66881,503
2022-07-31,San Mateo,081,765935,160706,159145,10156,169301,726
2022-07-31,Santa Barbara,083,443738,100910,99946,6218,106164,708
2022-07-31,Santa Clara,085,1922200,411103,407392,17903,425295,2381
2022-07-31,Santa Cruz,087,273765,59925,59227,3188,62415,269
2022-07-31,Shasta,089,179085,33722,33454,6973,40427,581
2022-07-31,Sierra,091,2930,296,293,59,352,4
2022-07-31,Siskiyou,093,43540,5034,4997,3191,8188,86
2022-07-31,Solano,095,438530,100586,99034,7286,106320,457
2022-07-31,Sonoma,097,501317,102651,101747,4957,106704,500
2022-07-31,Stanislaus,099,539301,132179,131081,19885,150966,1696
2022-07-31,Sutter,101,95872,23060,22931,2388,25319,228
2022-07-31,Tehama,103,63373,13167,13079,2925,16004,208
2022-07-31,Trinity,105,12862,1351,1340,346,1686,20
2022-07-31,Tulare,107,460477,117370,116640,33125,149765,1514
2022-07-31,Tuolumne,109,53932,14868,14701,873,15574,196
2022-07-31,Ventura,111,848112,200073,198498,13987,212485,1530
2022-07-31,Yolo,113,214977,45833,45511,4080,49591,327
2022-07-31,Yuba,115,75493,18042,17951,1567,19518,124
2022-07-30,Alameda,001,1643700,330411,327608,18676,346284,1941
2022-07-30,Alpine,003,1148,130,130,1,131,0
2022-07-30,Amador,005,37829,9647,9609,847,10456,88
2022-07-30,Butte,007,227075,37690,37349,8404,45753,444
2022-07-30,Calaveras,009,45235,8192,8145,473,8618,128
2022-07-30,Colusa,011,21464,3680,3664,1193,4857,22
2022-07-30,Contra Costa,013,1133247,238080,234635,19112,253747,1375
2022-07-30,Del Norte,015,27424,7170,7136,372,7508,54
2022-07-30,El Dorado,017,186661,31226,31007,4031,35038,222
2022-07-30,Fresno,019,978130,263036,260858,28515,289373,2805
2022-07-30,Glenn,021,27897,5370,5350,1803,7153,48
2022-07-30,Humboldt,023,135768,20672,20523,4428,24951,151
2022-07-30,Imperial,025,180216,63063,62471,14155,76626,949
2022-07-30,Inyo,027,18085,4408,4388,808,5196,57
2022-07-30,Kern,029,883053,212037,210190,55923,266113,2375
2022-07-30,Kings,031,150075,57088,56673,3867,60540,454
2022-07-30,Lake,033,64148,12188,12102,1092,13194,142
2022-07-30,Lassen,035,31185,9570,9548,959,10507,64
2022-07-30,Los Angeles,037,10098052,3150515,3122700,165536,3288236,32445
2022-07-30,Madera,039,155013,41978,41641,7445,49086,372
2022-07-30,Marin,041,260295,43176,42840,4937,47777,300
2022-07-30,Mariposa,043,17540,2964,2940,310,3250,30
2022-07-30,Mendocino,045,87422,15314,15172,4157,19329,132
2022-07-30,Merced,047,269075,69386,68853,10524,79377,838
2022-07-30,Modoc,049,8938,851,841,311,1152,11
2022-07-30,Mono,051,14174,3165,3155,223,3378,7
2022-07-30,Monterey,053,433212,90691,89974,19099,109073,754
2022-07-30,Napa,055,140530,30993,30777,1352,32129,150
2022-07-30,Nevada,057,99092,18279,18187,1669,19856,131
2022-07-30,Orange,059,3164182,640790,636403,56445,692848,7194
2022-07-30,Placer,061,380077,72998,72444,8984,81428,647
2022-07-30,Plumas,063,18699,3502,3490,427,3917,13
2022-07-30,Riverside,065,2383286,667826,662929,33034,695963,6543
2022-07-30,Sacramento,067,1510023,331766,329639,31948,361587,3156
2022-07-30,San Benito,069,59416,15350,15256,840,16096,100
2022-07-30,San Bernardino,071,2135413,642741,633131,28721,661852,7941
2022-07-30,San Diego,073,3302833,888758,881822,67418,949240,5409
2022-07-30,San Francisco,075,870044,170808,169564,11469,181033,937
2022-07-30,San Joaquin,077,732212,189226,187937,13085,201022,2276
2022-07-30,San Luis Obispo,079,281455,60934,60370,6498,66868,503
2022-07-30,San Mateo,081,765935,160521,159145,10138,169283,726
2022-07-30,Santa Barbara,083,443738,100819,99946,6197,106143,708
2022-07-30,Santa Clara,085,1922200,410613,407392,17884,425276,2381
2022-07-30,Santa Cruz,087,273765,59858,59227,3180,62407,269
2022-07-30,Shasta,089,179085,33702,33454,6972,40426,581
2022-07-30,Sierra,091,2930,296,293,59,352,4
2022-07-30,Siskiyou,093,43540,5031,4997,3189,8186,86
2022-07-30,Solano,095,438530,100528,99034,7273,106307,457
2022-07-30,Sonoma,097,501317,102564,101747,4949,106696,500
2022-07-30,Stanislaus,099,539301,132047,131081,19863,150944,1696
2022-07-30,Sutter,101,95872,23035,22931,2387,25318,228
2022-07-30,Tehama,103,63373,13161,13079,2922,16001,208
2022-07-30,Trinity,105,12862,1351,1340,346,1686,20
2022-07-30,Tulare,107,460477,117279,116640,33061,149701,1514
2022-07-30,Tuolumne,109,53932,14849,14701,873,15574,196
2022-07-30,Ventura,111,848112,199907,198498,13956,212454,1530
2022-07-30,Yolo,113,214977,45806,45511,4076,49587,327
2022-07-30,Yuba,115,75493,18029,17951,1567,19518,124
2022-07-29,Alameda,001,1643700,330045,327608,18648,346256,1941
2022-07-29,Alpine,003,1148,130,130,1,131,0
2022-07-29,Amador,005,37829,9646,9609,846,10455,88
2022-07-29,Butte,007,227075,37659,37349,8387,45736,444
2022-07-29,Calaveras,009,45235,8188,8145,473,8618,128
2022-07-29,Colusa,011,21464,3680,3664,1193,4857,22
2022-07-29,Contra Costa,013,1133247,237854,234635,19088,253723,1375
2022-07-29,Del Norte,015,27424,7165,7136,371,7507,54
2022-07-29,El Dorado,017,186661,31204,31007,4030,35037,222
2022-07-29,Fresno,019,978130,262792,260858,28467,289325,2805
2022-07-29,Glenn,021,27897,5368,5350,1801,7151,48
2022-07-29,Humboldt,023,135768,20646,20523,4418,24941,151
2022-07-29,Imperial,025,180216,63002,62471,14127,76598,949
2022-07-29,Inyo,027,18085,4407,4388,807,5195,57
2022-07-29,Kern,029,883053,211873,210190,55834,266024,2375
2022-07-29,Kings,031,150075,57051,56673,3866,60539,454
2022-07-29,Lake,033,64148,12173,12102,1089,13191,142
2022-07-29,Lassen,035,31185,9568,9548,959,10507,64
2022-07-29,Los Angeles,037,10098052,3147677,3122700,165214,3287914,32445
2022-07-29,Madera,039,155013,41933,41641,7433,49074,372
2022-07-29,Marin,041,260295,43129,42840,4929,47769,300
2022-07-29,Mariposa,043,17540,2963,2940,310,3250,30
2022-07-29,Mendocino,045,87422,15296,15172,4145,19317,132
2022-07-29,Merced,047,269075,69329,68853,10507,79360,838
2022-07-29,Modoc,049,8938,851,841,311,1152,11
2022-07-29,Mono,051,14174,3164,3155,222,3377,7
2022-07-29,Monterey,053,433212,90599,89974,19063,109037,754
2022-07-29,Napa,055,140530,30967,30777,1351,32128,150
2022-07-29,Nevada,057,99092,18268,18187,1667,19854,131
2022-07-29,Orange,059,3164182,640196,636403,56314,692717,7194
2022-07-29,Placer,061,380077,72928,72444,8970,81414,647
2022-07-29,Plumas,063,18699,3501,3490,427,3917,13
2022-07-29,Riverside,065,2383286,667284,662929,32988,695917,6543
2022-07-29,Sacramento,067,1510023,331455,329639,31929,361568,3156
2022-07-29,San Benito,069,59416,15335,15256,839,16095,100
2022-07-29,San Bernardino,071,2135413,642211,633131,28689,661820,7941
2022-07-29,San Diego,073,3302833,887903,881822,67311,949133,5409
2022-07-29,San Francisco,075,870044,170630,169564,11457,181021,937
2022-07-29,San Joaquin,077,732212,189114,187937,13072,201009,2276
2022-07-29,San Luis Obispo,079,281455,60898,60370,6486,66856,503
2022-07-29,San Mateo,081,765935,160345,159145,10129,169274,726
2022-07-29,Santa Barbara,083,443738,100697,99946,6187,106133,708
2022-07-29,Santa Clara,085,1922200,410138,407392,17863,425255,2381
2022-07-29,Santa Cruz,087,273765,59782,59227,3177,62404,269
2022-07-29,Shasta,089,179085,33676,33454,6964,40418,581
2022-07-29,Sierra,091,2930,296,293,58,351,4
2022-07-29,Siskiyou,093,43540,5026,4997,3188,8185,86
2022-07-29,Solano,095,438530,100397,99034,7263,106297,457
2022-07-29,Sonoma,097,501317,102461,101747,4937,106684,500
2022-07-29,Stanislaus,099,539301,131943,131081,19852,150933,1696
2022-07-29,Sutter,101,95872,23015,22931,2387,25318,228
2022-07-29,Tehama,103,63373,13154,13079,2920,15999,208
2022-07-29,Trinity,105,12862,1347,1340,345,1685,20
2022-07-29,Tulare,107,460477,117177,116640,33000,149640,1514
2022-07-29,Tuolumne,109,53932,14836,14701,872,15573,196
2022-07-29,Ventura,111,848112,199757,198498,13917,212415,1530
2022-07-29,Yolo,113,214977,45771,45511,4063,49574,327
2022-07-29,Yuba,115,75493,18008,17951,1565,19516,124
2022-07-28,Alameda,001,1643700,329560,327608,18600,346208,1941
2022-07-28,Alpine,003,1148,130,130,1,131,0
2022-07-28,Amador,005,37829,9639,9609,845,10454,88
2022-07-28,Butte,007,227075,37607,37349,8374,45723,444
2022-07-28,Calaveras,009,45235,8177,8145,472,8617,128
2022-07-28,Colusa,011,21464,3674,3664,1193,4857,22
2022-07-28,Contra Costa,013,1133247,237490,234635,19033,253668,1375
2022-07-28,Del Norte,015,27424,7159,7136,370,7506,54
2022-07-28,El Dorado,017,186661,31169,31007,4025,35032,222
2022-07-28,Fresno,019,978130,262361,260858,28393,289251,2805
2022-07-28,Glenn,021,27897,5366,5350,1797,7147,48
2022-07-28,Humboldt,023,135768,20612,20523,4407,24930,151
2022-07-28,Imperial,025,180216,62903,62471,14063,76534,949
2022-07-28,Inyo,027,18085,4403,4388,805,5193,57
2022-07-28,Kern,029,883053,211625,210190,55727,265917,2375
2022-07-28,Kings,031,150075,56949,56673,3863,60536,454
2022-07-28,Lake,033,64148,12156,12102,1088,13190,142
2022-07-28,Lassen,035,31185,9563,9548,959,10507,64
2022-07-28,Los Angeles,037,10098052,3143426,3122700,164680,3287380,32445
2022-07-28,Madera,039,155013,41872,41641,7423,49064,372
2022-07-28,Marin,041,260295,43081,42840,4924,47764,300
2022-07-28,Mariposa,043,17540,2960,2940,307,3247,30
2022-07-28,Mendocino,045,87422,15275,15172,4134,19306,132
2022-07-28,Merced,047,269075,69251,68853,10468,79321,838
2022-07-28,Modoc,049,8938,848,841,311,1152,11
2022-07-28,Mono,051,14174,3164,3155,221,3376,7
2022-07-28,Monterey,053,433212,90445,89974,18986,108960,754
2022-07-28,Napa,055,140530,30928,30777,1349,32126,150
2022-07-28,Nevada,057,99092,18255,18187,1661,19848,131
2022-07-28,Orange,059,3164182,639248,636403,56164,692567,7194
2022-07-28,Placer,061,380077,72837,72444,8949,81393,647
2022-07-28,Plumas,063,18699,3500,3490,427,3917,13
2022-07-28,Riverside,065,2383286,666479,662929,32934,695863,6543
2022-07-28,Sacramento,067,1510023,331031,329639,31899,361538,3156
2022-07-28,San Benito,069,59416,15307,15256,834,16090,100
2022-07-28,San Bernardino,071,2135413,641379,633131,28647,661778,7941
2022-07-28,San Diego,073,3302833,886551,881822,67180,949002,5409
2022-07-28,San Francisco,075,870044,170404,169564,11427,180991,937
2022-07-28,San Joaquin,077,732212,188860,187937,13034,200971,2276
2022-07-28,San Luis Obispo,079,281455,60812,60370,6464,66834,503
2022-07-28,San Mateo,081,765935,160091,159145,10115,169260,726
2022-07-28,Santa Barbara,083,443738,100560,99946,6154,106100,708
2022-07-28,Santa Clara,085,1922200,409493,407392,17831,425223,2381
2022-07-28,Santa Cruz,087,273765,59662,59227,3165,62392,269
2022-07-28,Shasta,089,179085,33649,33454,6949,40403,581
2022-07-28,Sierra,091,2930,296,293,58,351,4
2022-07-28,Siskiyou,093,43540,5022,4997,3181,8178,86
2022-07-28,Solano,095,438530,100248,99034,7252,106286,457
2022-07-28,Sonoma,097,501317,102337,101747,4911,106658,500
2022-07-28,Stanislaus,099,539301,131794,131081,19820,150901,1696
2022-07-28,Sutter,101,95872,22984,22931,2382,25313,228
2022-07-28,Tehama,103,63373,13136,13079,2911,15990,208
2022-07-28,Trinity,105,12862,1346,1340,344,1684,20
2022-07-28,Tulare,107,460477,117050,116640,32901,149541,1514
2022-07-28,Tuolumne,109,53932,14817,14701,870,15571,196
2022-07-28,Ventura,111,848112,199490,198498,13877,212375,1530
2022-07-28,Yolo,113,214977,45722,45511,4051,49562,327
2022-07-28,Yuba,115,75493,17994,17951,1556,19507,124
2022-07-27,Alameda,001,1643700,329040,325669,18554,344223,1938
2022-07-27,Alpine,003,1148,130,130,1,131,0
2022-07-27,Amador,005,37829,9630,9568,844,10412,87
2022-07-27,Butte,007,227075,37563,37146,8362,45508,441
2022-07-27,Calaveras,009,45235,8167,8105,471,8576,130
2022-07-27,Colusa,011,21464,3665,3649,1193,4842,22
2022-07-27,Contra Costa,013,1133247,237135,233236,18981,252217,1374
2022-07-27,Del Norte,015,27424,7155,7161,370,7531,54
2022-07-27,El Dorado,017,186661,31122,30891,4016,34907,222
2022-07-27,Fresno,019,978130,261949,259483,28320,287803,2801
2022-07-27,Glenn,021,27897,5362,5327,1796,7123,48
2022-07-27,Humboldt,023,135768,20572,20406,4399,24805,150
2022-07-27,Imperial,025,180216,62818,62014,14009,76023,948
2022-07-27,Inyo,027,18085,4399,4381,801,5182,57
2022-07-27,Kern,029,883053,211401,209400,55585,264985,2368
2022-07-27,Kings,031,150075,56874,56417,3855,60272,451
2022-07-27,Lake,033,64148,12140,12025,1086,13111,142
2022-07-27,Lassen,035,31185,9558,9509,958,10467,64
2022-07-27,Los Angeles,037,10098052,3138747,3107063,164195,3271258,32392
2022-07-27,Madera,039,155013,41784,41423,7410,48833,372
2022-07-27,Marin,041,260295,43009,42624,4916,47540,300
2022-07-27,Mariposa,043,17540,2955,2927,307,3234,30
2022-07-27,Mendocino,045,87422,15247,15066,4118,19184,131
2022-07-27,Merced,047,269075,69135,68455,10438,78893,838
2022-07-27,Modoc,049,8938,846,840,311,1151,10
2022-07-27,Mono,051,14174,3162,3148,219,3367,7
2022-07-27,Monterey,053,433212,90314,89520,18913,108433,752
2022-07-27,Napa,055,140530,30884,30647,1347,31994,150
2022-07-27,Nevada,057,99092,18237,18134,1660,19794,132
2022-07-27,Orange,059,3164182,638261,632871,55992,688863,7188
2022-07-27,Placer,061,380077,72756,72194,8928,81122,647
2022-07-27,Plumas,063,18699,3494,3472,427,3899,13
2022-07-27,Riverside,065,2383286,665468,659650,32853,692503,6528
2022-07-27,Sacramento,067,1510023,330572,328249,31844,360093,3146
2022-07-27,San Benito,069,59416,15287,15188,832,16020,100
2022-07-27,San Bernardino,071,2135413,640490,629895,28593,658488,7937
2022-07-27,San Diego,073,3302833,885104,876507,67042,943549,5386
2022-07-27,San Francisco,075,870044,170157,168570,11411,179981,931
2022-07-27,San Joaquin,077,732212,188573,187066,13000,200066,2267
2022-07-27,San Luis Obispo,079,281455,60731,60180,6430,66610,502
2022-07-27,San Mateo,081,765935,159843,158343,10105,168448,724
2022-07-27,Santa Barbara,083,443738,100402,99460,6117,105577,707
2022-07-27,Santa Clara,085,1922200,408803,404896,17811,422707,2380
2022-07-27,Santa Cruz,087,273765,59567,58873,3152,62025,269
2022-07-27,Shasta,089,179085,33616,33314,6939,40253,578
2022-07-27,Sierra,091,2930,295,293,58,351,4
2022-07-27,Siskiyou,093,43540,5009,4975,3177,8152,84
2022-07-27,Solano,095,438530,100082,98579,7242,105821,457
2022-07-27,Sonoma,097,501317,102196,101316,4897,106213,499
2022-07-27,Stanislaus,099,539301,131593,130451,19779,150230,1695
2022-07-27,Sutter,101,95872,22948,22811,2376,25187,228
2022-07-27,Tehama,103,63373,13122,13036,2906,15942,207
2022-07-27,Trinity,105,12862,1345,1337,343,1680,20
2022-07-27,Tulare,107,460477,116889,116167,32829,148996,1514
2022-07-27,Tuolumne,109,53932,14787,14594,867,15461,196
2022-07-27,Ventura,111,848112,199212,197572,13813,211385,1527
2022-07-27,Yolo,113,214977,45676,45359,4034,49393,326
2022-07-27,Yuba,115,75493,17970,17873,1548,19421,124
2022-07-26,Alameda,001,1643700,328404,325669,18506,344175,1938
2022-07-26,Alpine,003,1148,130,130,1,131,0
2022-07-26,Amador,005,37829,9621,9568,840,10408,87
2022-07-26,Butte,007,227075,37503,37146,8345,45491,441
2022-07-26,Calaveras,009,45235,8157,8105,469,8574,130
2022-07-26,Colusa,011,21464,3664,3649,1193,4842,22
2022-07-26,Contra Costa,013,1133247,236703,233236,18925,252161,1374
2022-07-26,Del Norte,015,27424,7142,7161,370,7531,54
2022-07-26,El Dorado,017,186661,31077,30891,4010,34901,222
2022-07-26,Fresno,019,978130,261415,259483,28228,287711,2801
2022-07-26,Glenn,021,27897,5359,5327,1792,7119,48
2022-07-26,Humboldt,023,135768,20540,20406,4384,24790,150
2022-07-26,Imperial,025,180216,62698,62014,13929,75943,948
2022-07-26,Inyo,027,18085,4396,4381,799,5180,57
2022-07-26,Kern,029,883053,211085,209400,55437,264837,2368
2022-07-26,Kings,031,150075,56759,56417,3853,60270,451
2022-07-26,Lake,033,64148,12110,12025,1085,13110,142
2022-07-26,Lassen,035,31185,9555,9509,956,10465,64
2022-07-26,Los Angeles,037,10098052,3133780,3107063,163608,3270671,32392
2022-07-26,Madera,039,155013,41719,41423,7385,48808,372
2022-07-26,Marin,041,260295,42943,42624,4905,47529,300
2022-07-26,Mariposa,043,17540,2953,2927,307,3234,30
2022-07-26,Mendocino,045,87422,15224,15066,4106,19172,131
2022-07-26,Merced,047,269075,69043,68455,10413,78868,838
2022-07-26,Modoc,049,8938,844,840,311,1151,10
2022-07-26,Mono,051,14174,3160,3148,218,3366,7
2022-07-26,Monterey,053,433212,90176,89520,18826,108346,752
2022-07-26,Napa,055,140530,30848,30647,1341,31988,150
2022-07-26,Nevada,057,99092,18214,18134,1657,19791,132
2022-07-26,Orange,059,3164182,637163,632871,55777,688648,7188
2022-07-26,Placer,061,380077,72638,72194,8909,81103,647
2022-07-26,Plumas,063,18699,3491,3472,426,3898,13
2022-07-26,Riverside,065,2383286,664443,659650,32774,692424,6528
2022-07-26,Sacramento,067,1510023,330037,328249,31779,360028,3146
2022-07-26,San Benito,069,59416,15257,15188,831,16019,100
2022-07-26,San Bernardino,071,2135413,639493,629895,28525,658420,7937
2022-07-26,San Diego,073,3302833,883412,876507,66865,943372,5386
2022-07-26,San Francisco,075,870044,169870,168570,11397,179967,931
2022-07-26,San Joaquin,077,732212,188278,187066,12960,200026,2267
2022-07-26,San Luis Obispo,079,281455,60651,60180,6403,66583,502
2022-07-26,San Mateo,081,765935,159561,158343,10094,168437,724
2022-07-26,Santa Barbara,083,443738,100223,99460,6093,105553,707
2022-07-26,Santa Clara,085,1922200,407951,404896,17773,422669,2380
2022-07-26,Santa Cruz,087,273765,59463,58873,3135,62008,269
2022-07-26,Shasta,089,179085,33583,33314,6923,40237,578
2022-07-26,Sierra,091,2930,294,293,58,351,4
2022-07-26,Siskiyou,093,43540,5004,4975,3169,8144,84
2022-07-26,Solano,095,438530,99891,98579,7225,105804,457
2022-07-26,Sonoma,097,501317,102048,101316,4869,106185,499
2022-07-26,Stanislaus,099,539301,131380,130451,19754,150205,1695
2022-07-26,Sutter,101,95872,22918,22811,2375,25186,228
2022-07-26,Tehama,103,63373,13103,13036,2901,15937,207
2022-07-26,Trinity,105,12862,1344,1337,341,1678,20
2022-07-26,Tulare,107,460477,116739,116167,32741,148908,1514
2022-07-26,Tuolumne,109,53932,14768,14594,865,15459,196
2022-07-26,Ventura,111,848112,198902,197572,13756,211328,1527
2022-07-26,Yolo,113,214977,45628,45359,4023,49382,326
2022-07-26,Yuba,115,75493,17952,17873,1547,19420,124
2022-07-25,Alameda,001,1643700,327668,325669,18437,344106,1938
2022-07-25,Alpine,003,1148,130,130,1,131,0
2022-07-25,Amador,005,37829,9608,9568,837,10405,87
2022-07-25,Butte,007,227075,37428,37146,8330,45476,441
2022-07-25,Calaveras,009,45235,8146,8105,468,8573,130
2022-07-25,Colusa,011,21464,3663,3649,1190,4839,22
2022-07-25,Contra Costa,013,1133247,236222,233236,18842,252078,1374
2022-07-25,Del Norte,015,27424,7135,7161,369,7530,54
2022-07-25,El Dorado,017,186661,31038,30891,3996,34887,222
2022-07-25,Fresno,019,978130,260829,259483,28127,287610,2801
2022-07-25,Glenn,021,27897,5351,5327,1789,7116,48
2022-07-25,Humboldt,023,135768,20508,20406,4363,24769,150
2022-07-25,Imperial,025,180216,62578,62014,13843,75857,948
2022-07-25,Inyo,027,18085,4393,4381,793,5174,57
2022-07-25,Kern,029,883053,210794,209400,55275,264675,2368
2022-07-25,Kings,031,150075,56624,56417,3843,60260,451
2022-07-25,Lake,033,64148,12089,12025,1084,13109,142
2022-07-25,Lassen,035,31185,9548,9509,955,10464,64
2022-07-25,Los Angeles,037,10098052,3127992,3107063,163055,3270118,32392
2022-07-25,Madera,039,155013,41631,41423,7360,48783,372
2022-07-25,Marin,041,260295,42869,42624,4898,47522,300
2022-07-25,Mariposa,043,17540,2950,2927,304,3231,30
2022-07-25,Mendocino,045,87422,15187,15066,4094,19160,131
2022-07-25,Merced,047,269075,68929,68455,10382,78837,838
2022-07-25,Modoc,049,8938,839,840,309,1149,10
2022-07-25,Mono,051,14174,3158,3148,217,3365,7
2022-07-25,Monterey,053,433212,90021,89520,18716,108236,752
2022-07-25,Napa,055,140530,30804,30647,1340,31987,150
2022-07-25,Nevada,057,99092,18202,18134,1649,19783,132
2022-07-25,Orange,059,3164182,635914,632871,55574,688445,7188
2022-07-25,Placer,061,380077,72556,72194,8903,81097,647
2022-07-25,Plumas,063,18699,3485,3472,425,3897,13
2022-07-25,Riverside,065,2383286,663353,659650,32695,692345,6528
2022-07-25,Sacramento,067,1510023,329503,328249,31717,359966,3146
2022-07-25,San Benito,069,59416,15225,15188,829,16017,100
2022-07-25,San Bernardino,071,2135413,638319,629895,28470,658365,7937
2022-07-25,San Diego,073,3302833,881625,876507,66680,943187,5386
2022-07-25,San Francisco,075,870044,169559,168570,11382,179952,931
2022-07-25,San Joaquin,077,732212,187989,187066,12894,199960,2267
2022-07-25,San Luis Obispo,079,281455,60545,60180,6371,66551,502
2022-07-25,San Mateo,081,765935,159192,158343,10072,168415,724
2022-07-25,Santa Barbara,083,443738,100030,99460,6068,105528,707
2022-07-25,Santa Clara,085,1922200,407059,404896,17693,422589,2380
2022-07-25,Santa Cruz,087,273765,59342,58873,3122,61995,269
2022-07-25,Shasta,089,179085,33532,33314,6915,40229,578
2022-07-25,Sierra,091,2930,293,293,58,351,4
2022-07-25,Siskiyou,093,43540,4998,4975,3160,8135,84
2022-07-25,Solano,095,438530,99645,98579,7210,105789,457
2022-07-25,Sonoma,097,501317,101889,101316,4851,106167,499
2022-07-25,Stanislaus,099,539301,131184,130451,19728,150179,1695
2022-07-25,Sutter,101,95872,22872,22811,2374,25185,228
2022-07-25,Tehama,103,63373,13086,13036,2893,15929,207
2022-07-25,Trinity,105,12862,1342,1337,341,1678,20
2022-07-25,Tulare,107,460477,116528,116167,32644,148811,1514
2022-07-25,Tuolumne,109,53932,14749,14594,865,15459,196
2022-07-25,Ventura,111,848112,198595,197572,13701,211273,1527
2022-07-25,Yolo,113,214977,45565,45359,4007,49366,326
2022-07-25,Yuba,115,75493,17914,17873,1546,19419,124
2022-07-24,Alameda,001,1643700,326860,323165,18394,341559,1933
2022-07-24,Alpine,003,1148,130,130,1,131,0
2022-07-24,Amador,005,37829,9586,9526,834,10360,87
2022-07-24,Butte,007,227075,37363,36994,8303,45297,440
2022-07-24,Calaveras,009,45235,8129,8064,466,8530,128
2022-07-24,Colusa,011,21464,3657,3639,1190,4829,22
2022-07-24,Contra Costa,013,1133247,235690,231714,18762,250476,1363
2022-07-24,Del Norte,015,27424,7117,7128,365,7493,54
2022-07-24,El Dorado,017,186661,30990,30722,3979,34701,222
2022-07-24,Fresno,019,978130,260177,257571,28028,285599,2792
2022-07-24,Glenn,021,27897,5345,5311,1787,7098,48
2022-07-24,Humboldt,023,135768,20475,20283,4346,24629,150
2022-07-24,Imperial,025,180216,62416,61671,13722,75393,948
2022-07-24,Inyo,027,18085,4389,4366,782,5148,57
2022-07-24,Kern,029,883053,210424,208535,55102,263637,2366
2022-07-24,Kings,031,150075,56499,56103,3830,59933,451
2022-07-24,Lake,033,64148,12063,11957,1081,13038,142
2022-07-24,Lassen,035,31185,9522,9504,952,10456,64
2022-07-24,Los Angeles,037,10098052,3121564,3085376,162383,3247759,32340
2022-07-24,Madera,039,155013,41534,41145,7330,48475,372
2022-07-24,Marin,041,260295,42800,42347,4886,47233,300
2022-07-24,Mariposa,043,17540,2947,2897,303,3200,30
2022-07-24,Mendocino,045,87422,15137,14988,4062,19050,131
2022-07-24,Merced,047,269075,68772,68127,10323,78450,837
2022-07-24,Modoc,049,8938,839,829,308,1137,10
2022-07-24,Mono,051,14174,3157,3141,217,3358,7
2022-07-24,Monterey,053,433212,89845,89067,18616,107683,747
2022-07-24,Napa,055,140530,30751,30495,1339,31834,148
2022-07-24,Nevada,057,99092,18183,18073,1640,19713,131
2022-07-24,Orange,059,3164182,634564,627948,55335,683283,7181
2022-07-24,Placer,061,380077,72433,71870,8890,80760,644
2022-07-24,Plumas,063,18699,3484,3464,425,3889,13
2022-07-24,Riverside,065,2383286,662057,655603,32582,688185,6527
2022-07-24,Sacramento,067,1510023,328819,326216,31648,357864,3136
2022-07-24,San Benito,069,59416,15204,15049,829,15878,100
2022-07-24,San Bernardino,071,2135413,636926,626059,28390,654449,7933
2022-07-24,San Diego,073,3302833,879549,870102,66489,936591,5380
2022-07-24,San Francisco,075,870044,169110,167260,11352,178612,931
2022-07-24,San Joaquin,077,732212,187625,186142,12828,198970,2267
2022-07-24,San Luis Obispo,079,281455,60397,59919,6338,66257,500
2022-07-24,San Mateo,081,765935,158856,157266,10048,167314,724
2022-07-24,Santa Barbara,083,443738,99803,98826,6028,104854,706
2022-07-24,Santa Clara,085,1922200,406103,401495,17653,419148,2381
2022-07-24,Santa Cruz,087,273765,59170,58386,3101,61487,268
2022-07-24,Shasta,089,179085,33468,33185,6900,40085,578
2022-07-24,Sierra,091,2930,293,293,58,351,4
2022-07-24,Siskiyou,093,43540,4994,4938,3144,8082,84
2022-07-24,Solano,095,438530,99431,98016,7196,105212,457
2022-07-24,Sonoma,097,501317,101686,100735,4830,105565,499
2022-07-24,Stanislaus,099,539301,130892,129813,19698,149511,1695
2022-07-24,Sutter,101,95872,22822,22687,2371,25058,228
2022-07-24,Tehama,103,63373,13076,12974,2883,15857,207
2022-07-24,Trinity,105,12862,1341,1330,339,1669,20
2022-07-24,Tulare,107,460477,116341,115548,32540,148088,1513
2022-07-24,Tuolumne,109,53932,14715,14514,864,15378,196
2022-07-24,Ventura,111,848112,198185,196127,13600,209727,1525
2022-07-24,Yolo,113,214977,45489,45141,3995,49136,327
2022-07-24,Yuba,115,75493,17887,17770,1544,19314,124
2022-07-23,Alameda,001,1643700,326443,323165,18374,341539,1933
2022-07-23,Alpine,003,1148,130,130,1,131,0
2022-07-23,Amador,005,37829,9576,9526,834,10360,87
2022-07-23,Butte,007,227075,37315,36994,8296,45290,440
2022-07-23,Calaveras,009,45235,8118,8064,466,8530,128
2022-07-23,Colusa,011,21464,3652,3639,1190,4829,22
2022-07-23,Contra Costa,013,1133247,235390,231714,18732,250446,1363
2022-07-23,Del Norte,015,27424,7114,7128,364,7492,54
2022-07-23,El Dorado,017,186661,30972,30722,3977,34699,222
2022-07-23,Fresno,019,978130,259953,257571,27975,285546,2792
2022-07-23,Glenn,021,27897,5343,5311,1785,7096,48
2022-07-23,Humboldt,023,135768,20448,20283,4333,24616,150
2022-07-23,Imperial,025,180216,62355,61671,13700,75371,948
2022-07-23,Inyo,027,18085,4387,4366,781,5147,57
2022-07-23,Kern,029,883053,210258,208535,55000,263535,2366
2022-07-23,Kings,031,150075,56456,56103,3827,59930,451
2022-07-23,Lake,033,64148,12052,11957,1080,13037,142
2022-07-23,Lassen,035,31185,9520,9504,952,10456,64
2022-07-23,Los Angeles,037,10098052,3118749,3085376,161943,3247319,32340
2022-07-23,Madera,039,155013,41475,41145,7325,48470,372
2022-07-23,Marin,041,260295,42725,42347,4876,47223,300
2022-07-23,Mariposa,043,17540,2944,2897,303,3200,30
2022-07-23,Mendocino,045,87422,15117,14988,4055,19043,131
2022-07-23,Merced,047,269075,68704,68127,10306,78433,837
2022-07-23,Modoc,049,8938,839,829,308,1137,10
2022-07-23,Mono,051,14174,3156,3141,217,3358,7
2022-07-23,Monterey,053,433212,89758,89067,18595,107662,747
2022-07-23,Napa,055,140530,30718,30495,1338,31833,148
2022-07-23,Nevada,057,99092,18171,18073,1638,19711,131
2022-07-23,Orange,059,3164182,633863,627948,55150,683098,7181
2022-07-23,Placer,061,380077,72360,71870,8880,80750,644
2022-07-23,Plumas,063,18699,3483,3464,425,3889,13
2022-07-23,Riverside,065,2383286,661349,655603,32542,688145,6527
2022-07-23,Sacramento,067,1510023,328549,326216,31633,357849,3136
2022-07-23,San Benito,069,59416,15194,15049,820,15869,100
2022-07-23,San Bernardino,071,2135413,636307,626059,28349,654408,7933
2022-07-23,San Diego,073,3302833,878726,870102,66434,936536,5380
2022-07-23,San Francisco,075,870044,168916,167260,11337,178597,931
2022-07-23,San Joaquin,077,732212,187471,186142,12807,198949,2267
2022-07-23,San Luis Obispo,079,281455,60368,59919,6327,66246,500
2022-07-23,San Mateo,081,765935,158680,157266,10034,167300,724
2022-07-23,Santa Barbara,083,443738,99704,98826,5997,104823,706
2022-07-23,Santa Clara,085,1922200,405490,401495,17628,419123,2381
2022-07-23,Santa Cruz,087,273765,59119,58386,3089,61475,268
2022-07-23,Shasta,089,179085,33429,33185,6894,40079,578
2022-07-23,Sierra,091,2930,293,293,58,351,4
2022-07-23,Siskiyou,093,43540,4990,4938,3142,8080,84
2022-07-23,Solano,095,438530,99367,98016,7190,105206,457
2022-07-23,Sonoma,097,501317,101598,100735,4820,105555,499
2022-07-23,Stanislaus,099,539301,130761,129813,19664,149477,1695
2022-07-23,Sutter,101,95872,22801,22687,2371,25058,228
2022-07-23,Tehama,103,63373,13062,12974,2880,15854,207
2022-07-23,Trinity,105,12862,1341,1330,338,1668,20
2022-07-23,Tulare,107,460477,116226,115548,32471,148019,1513
2022-07-23,Tuolumne,109,53932,14692,14514,864,15378,196
2022-07-23,Ventura,111,848112,198001,196127,13567,209694,1525
2022-07-23,Yolo,113,214977,45455,45141,3987,49128,327
2022-07-23,Yuba,115,75493,17874,17770,1540,19310,124
2022-07-22,Alameda,001,1643700,326033,323165,18346,341511,1933
2022-07-22,Alpine,003,1148,130,130,1,131,0
2022-07-22,Amador,005,37829,9570,9526,833,10359,87
2022-07-22,Butte,007,227075,37280,36994,8280,45274,440
2022-07-22,Calaveras,009,45235,8109,8064,466,8530,128
2022-07-22,Colusa,011,21464,3651,3639,1186,4825,22
2022-07-22,Contra Costa,013,1133247,235099,231714,18695,250409,1363
2022-07-22,Del Norte,015,27424,7107,7128,364,7492,54
2022-07-22,El Dorado,017,186661,30943,30722,3972,34694,222
2022-07-22,Fresno,019,978130,259673,257571,27927,285498,2792
2022-07-22,Glenn,021,27897,5338,5311,1784,7095,48
2022-07-22,Humboldt,023,135768,20425,20283,4323,24606,150
2022-07-22,Imperial,025,180216,62264,61671,13668,75339,948
2022-07-22,Inyo,027,18085,4387,4366,774,5140,57
2022-07-22,Kern,029,883053,210058,208535,54907,263442,2366
2022-07-22,Kings,031,150075,56420,56103,3826,59929,451
2022-07-22,Lake,033,64148,12038,11957,1078,13035,142
2022-07-22,Lassen,035,31185,9520,9504,952,10456,64
2022-07-22,Los Angeles,037,10098052,3115258,3085376,161499,3246875,32340
2022-07-22,Madera,039,155013,41432,41145,7314,48459,372
2022-07-22,Marin,041,260295,42672,42347,4868,47215,300
2022-07-22,Mariposa,043,17540,2942,2897,303,3200,30
2022-07-22,Mendocino,045,87422,15093,14988,4047,19035,131
2022-07-22,Merced,047,269075,68632,68127,10294,78421,837
2022-07-22,Modoc,049,8938,839,829,308,1137,10
2022-07-22,Mono,051,14174,3155,3141,216,3357,7
2022-07-22,Monterey,053,433212,89668,89067,18561,107628,747
2022-07-22,Napa,055,140530,30687,30495,1338,31833,148
2022-07-22,Nevada,057,99092,18159,18073,1631,19704,131
2022-07-22,Orange,059,3164182,633089,627948,54996,682944,7181
2022-07-22,Placer,061,380077,72315,71870,8872,80742,644
2022-07-22,Plumas,063,18699,3482,3464,425,3889,13
2022-07-22,Riverside,065,2383286,660606,655603,32479,688082,6527
2022-07-22,Sacramento,067,1510023,328194,326216,31605,357821,3136
2022-07-22,San Benito,069,59416,15185,15049,820,15869,100
2022-07-22,San Bernardino,071,2135413,635681,626059,28305,654364,7933
2022-07-22,San Diego,073,3302833,877644,870102,66307,936409,5380
2022-07-22,San Francisco,075,870044,168720,167260,11308,178568,931
2022-07-22,San Joaquin,077,732212,187316,186142,12779,198921,2267
2022-07-22,San Luis Obispo,079,281455,60313,59919,6315,66234,500
2022-07-22,San Mateo,081,765935,158452,157266,10021,167287,724
2022-07-22,Santa Barbara,083,443738,99602,98826,5991,104817,706
2022-07-22,Santa Clara,085,1922200,404835,401495,17602,419097,2381
2022-07-22,Santa Cruz,087,273765,59013,58386,3081,61467,268
2022-07-22,Shasta,089,179085,33398,33185,6889,40074,578
2022-07-22,Sierra,091,2930,293,293,58,351,4
2022-07-22,Siskiyou,093,43540,4983,4938,3139,8077,84
2022-07-22,Solano,095,438530,99229,98016,7180,105196,457
2022-07-22,Sonoma,097,501317,101491,100735,4802,105537,499
2022-07-22,Stanislaus,099,539301,130632,129813,19642,149455,1695
2022-07-22,Sutter,101,95872,22777,22687,2370,25057,228
2022-07-22,Tehama,103,63373,13053,12974,2878,15852,207
2022-07-22,Trinity,105,12862,1339,1330,337,1667,20
2022-07-22,Tulare,107,460477,116114,115548,32411,147959,1513
2022-07-22,Tuolumne,109,53932,14668,14514,860,15374,196
2022-07-22,Ventura,111,848112,197815,196127,13532,209659,1525
2022-07-22,Yolo,113,214977,45401,45141,3969,49110,327
2022-07-22,Yuba,115,75493,17860,17770,1538,19308,124
2022-07-21,Alameda,001,1643700,325358,323165,18297,341462,1933
2022-07-21,Alpine,003,1148,130,130,1,131,0
2022-07-21,Amador,005,37829,9563,9526,831,10357,87
2022-07-21,Butte,007,227075,37238,36994,8260,45254,440
2022-07-21,Calaveras,009,45235,8094,8064,464,8528,128
2022-07-21,Colusa,011,21464,3647,3639,1184,4823,22
2022-07-21,Contra Costa,013,1133247,234713,231714,18638,250352,1363
2022-07-21,Del Norte,015,27424,7097,7128,364,7492,54
2022-07-21,El Dorado,017,186661,30892,30722,3969,34691,222
2022-07-21,Fresno,019,978130,259199,257571,27846,285417,2792
2022-07-21,Glenn,021,27897,5332,5311,1784,7095,48
2022-07-21,Humboldt,023,135768,20393,20283,4300,24583,150
2022-07-21,Imperial,025,180216,62151,61671,13572,75243,948
2022-07-21,Inyo,027,18085,4383,4366,767,5133,57
2022-07-21,Kern,029,883053,209784,208535,54782,263317,2366
2022-07-21,Kings,031,150075,56346,56103,3813,59916,451
2022-07-21,Lake,033,64148,12025,11957,1075,13032,142
2022-07-21,Lassen,035,31185,9517,9504,952,10456,64
2022-07-21,Los Angeles,037,10098052,3109695,3085376,160891,3246267,32340
2022-07-21,Madera,039,155013,41357,41145,7292,48437,372
2022-07-21,Marin,041,260295,42607,42347,4865,47212,300
2022-07-21,Mariposa,043,17540,2938,2897,302,3199,30
2022-07-21,Mendocino,045,87422,15067,14988,4041,19029,131
2022-07-21,Merced,047,269075,68530,68127,10267,78394,837
2022-07-21,Modoc,049,8938,837,829,308,1137,10
2022-07-21,Mono,051,14174,3151,3141,215,3356,7
2022-07-21,Monterey,053,433212,89544,89067,18486,107553,747
2022-07-21,Napa,055,140530,30643,30495,1338,31833,148
2022-07-21,Nevada,057,99092,18141,18073,1625,19698,131
2022-07-21,Orange,059,3164182,631966,627948,54778,682726,7181
2022-07-21,Placer,061,380077,72208,71870,8850,80720,644
2022-07-21,Plumas,063,18699,3481,3464,425,3889,13
2022-07-21,Riverside,065,2383286,659542,655603,32406,688009,6527
2022-07-21,Sacramento,067,1510023,327683,326216,31565,357781,3136
2022-07-21,San Benito,069,59416,15143,15049,817,15866,100
2022-07-21,San Bernardino,071,2135413,634642,626059,28240,654299,7933
2022-07-21,San Diego,073,3302833,875954,870102,66114,936216,5380
2022-07-21,San Francisco,075,870044,168362,167260,11256,178516,931
2022-07-21,San Joaquin,077,732212,187064,186142,12751,198893,2267
2022-07-21,San Luis Obispo,079,281455,60257,59919,6285,66204,500
2022-07-21,San Mateo,081,765935,158156,157266,10006,167272,724
2022-07-21,Santa Barbara,083,443738,99441,98826,5971,104797,706
2022-07-21,Santa Clara,085,1922200,404034,401495,17564,419059,2381
2022-07-21,Santa Cruz,087,273765,58895,58386,3066,61452,268
2022-07-21,Shasta,089,179085,33348,33185,6875,40060,578
2022-07-21,Sierra,091,2930,293,293,58,351,4
2022-07-21,Siskiyou,093,43540,4972,4938,3133,8071,84
2022-07-21,Solano,095,438530,99087,98016,7172,105188,457
2022-07-21,Sonoma,097,501317,101347,100735,4788,105523,499
2022-07-21,Stanislaus,099,539301,130440,129813,19623,149436,1695
2022-07-21,Sutter,101,95872,22749,22687,2368,25055,228
2022-07-21,Tehama,103,63373,13036,12974,2867,15841,207
2022-07-21,Trinity,105,12862,1335,1330,337,1667,20
2022-07-21,Tulare,107,460477,115962,115548,32329,147877,1513
2022-07-21,Tuolumne,109,53932,14636,14514,857,15371,196
2022-07-21,Ventura,111,848112,197489,196127,13442,209569,1525
2022-07-21,Yolo,113,214977,45340,45141,3956,49097,327
2022-07-21,Yuba,115,75493,17832,17770,1535,19305,124
2022-07-20,Alameda,001,1643700,324684,321347,18256,339603,1915
2022-07-20,Alpine,003,1148,130,130,1,131,0
2022-07-20,Amador,005,37829,9545,9478,829,10307,87
2022-07-20,Butte,007,227075,37189,36820,8240,45060,440
2022-07-20,Calaveras,009,45235,8085,8035,463,8498,126
2022-07-20,Colusa,011,21464,3643,3627,1182,4809,22
2022-07-20,Contra Costa,013,1133247,234308,230356,18589,248945,1362
2022-07-20,Del Norte,015,27424,7088,7081,364,7445,54
2022-07-20,El Dorado,017,186661,30860,30628,3959,34587,221
2022-07-20,Fresno,019,978130,258685,256217,27776,283993,2790
2022-07-20,Glenn,021,27897,5328,5287,1781,7068,48
2022-07-20,Humboldt,023,135768,20354,20149,4281,24430,150
2022-07-20,Imperial,025,180216,62007,61170,13476,74646,944
2022-07-20,Inyo,027,18085,4381,4355,762,5117,56
2022-07-20,Kern,029,883053,209492,207603,54659,262262,2366
2022-07-20,Kings,031,150075,56262,55836,3802,59638,449
2022-07-20,Lake,033,64148,12004,11895,1070,12965,142
2022-07-20,Lassen,035,31185,9508,9455,952,10407,64
2022-07-20,Los Angeles,037,10098052,3104145,3068779,160287,3229066,32292
2022-07-20,Madera,039,155013,41284,40902,7272,48174,372
2022-07-20,Marin,041,260295,42527,42153,4858,47011,300
2022-07-20,Mariposa,043,17540,2923,2884,300,3184,30
2022-07-20,Mendocino,045,87422,15052,14890,4029,18919,131
2022-07-20,Merced,047,269075,68434,67775,10241,78016,833
2022-07-20,Modoc,049,8938,836,799,307,1106,9
2022-07-20,Mono,051,14174,3148,3138,212,3350,7
2022-07-20,Monterey,053,433212,89407,88606,18405,107011,747
2022-07-20,Napa,055,140530,30605,30353,1336,31689,145
2022-07-20,Nevada,057,99092,18115,18020,1620,19640,131
2022-07-20,Orange,059,3164182,630699,624998,54544,679542,7173
2022-07-20,Placer,061,380077,72126,71614,8832,80446,639
2022-07-20,Plumas,063,18699,3475,3433,424,3857,13
2022-07-20,Riverside,065,2383286,658446,652192,32306,684498,6510
2022-07-20,Sacramento,067,1510023,327131,324765,31520,356285,3123
2022-07-20,San Benito,069,59416,15111,14966,814,15780,100
2022-07-20,San Bernardino,071,2135413,633603,622760,28178,650938,7921
2022-07-20,San Diego,073,3302833,874118,864434,65935,930369,5375
2022-07-20,San Francisco,075,870044,168023,166241,11238,177479,929
2022-07-20,San Joaquin,077,732212,186776,185319,12715,198034,2262
2022-07-20,San Luis Obispo,079,281455,60187,59727,6256,65983,499
2022-07-20,San Mateo,081,765935,157871,156191,9981,166172,724
2022-07-20,Santa Barbara,083,443738,99262,98322,5944,104266,703
2022-07-20,Santa Clara,085,1922200,403227,398816,17529,416345,2374
2022-07-20,Santa Cruz,087,273765,58781,58004,3053,61057,267
2022-07-20,Shasta,089,179085,33306,33017,6869,39886,576
2022-07-20,Sierra,091,2930,293,292,58,350,4
2022-07-20,Siskiyou,093,43540,4957,4921,3126,8047,84
2022-07-20,Solano,095,438530,98923,97577,7152,104729,459
2022-07-20,Sonoma,097,501317,101160,100304,4774,105078,499
2022-07-20,Stanislaus,099,539301,130274,129200,19590,148790,1695
2022-07-20,Sutter,101,95872,22714,22592,2365,24957,228
2022-07-20,Tehama,103,63373,13020,12923,2863,15786,205
2022-07-20,Trinity,105,12862,1335,1319,336,1655,20
2022-07-20,Tulare,107,460477,115781,115073,32215,147288,1510
2022-07-20,Tuolumne,109,53932,14610,14389,856,15245,196
2022-07-20,Ventura,111,848112,197170,195189,13370,208559,1522
2022-07-20,Yolo,113,214977,45284,44950,3945,48895,325
2022-07-20,Yuba,115,75493,17808,17661,1534,19195,124
2022-07-19,Alameda,001,1643700,324012,321347,18231,339578,1915
2022-07-19,Alpine,003,1148,130,130,1,131,0
2022-07-19,Amador,005,37829,9533,9478,825,10303,87
2022-07-19,Butte,007,227075,37137,36820,8226,45046,440
2022-07-19,Calaveras,009,45235,8075,8035,463,8498,126
2022-07-19,Colusa,011,21464,3640,3627,1178,4805,22
2022-07-19,Contra Costa,013,1133247,233858,230356,18532,248888,1362
2022-07-19,Del Norte,015,27424,7080,7081,363,7444,54
2022-07-19,El Dorado,017,186661,30815,30628,3950,34578,221
2022-07-19,Fresno,019,978130,258081,256217,27691,283908,2790
2022-07-19,Glenn,021,27897,5321,5287,1780,7067,48
2022-07-19,Humboldt,023,135768,20319,20149,4267,24416,150
2022-07-19,Imperial,025,180216,61872,61170,13386,74556,944
2022-07-19,Inyo,027,18085,4379,4355,760,5115,56
2022-07-19,Kern,029,883053,209215,207603,54508,262111,2366
2022-07-19,Kings,031,150075,56159,55836,3783,59619,449
2022-07-19,Lake,033,64148,11983,11895,1062,12957,142
2022-07-19,Lassen,035,31185,9500,9455,952,10407,64
2022-07-19,Los Angeles,037,10098052,3098050,3068779,159595,3228374,32292
2022-07-19,Madera,039,155013,41205,40902,7249,48151,372
2022-07-19,Marin,041,260295,42463,42153,4845,46998,300
2022-07-19,Mariposa,043,17540,2918,2884,299,3183,30
2022-07-19,Mendocino,045,87422,15020,14890,4018,18908,131
2022-07-19,Merced,047,269075,68328,67775,10209,77984,833
2022-07-19,Modoc,049,8938,835,799,307,1106,9
2022-07-19,Mono,051,14174,3144,3138,212,3350,7
2022-07-19,Monterey,053,433212,89257,88606,18324,106930,747
2022-07-19,Napa,055,140530,30548,30353,1332,31685,145
2022-07-19,Nevada,057,99092,18101,18020,1613,19633,131
2022-07-19,Orange,059,3164182,629413,624998,54296,679294,7173
2022-07-19,Placer,061,380077,72039,71614,8816,80430,639
2022-07-19,Plumas,063,18699,3469,3433,422,3855,13
2022-07-19,Riverside,065,2383286,657136,652192,32212,684404,6510
2022-07-19,Sacramento,067,1510023,326502,324765,31480,356245,3123
2022-07-19,San Benito,069,59416,15067,14966,812,15778,100
2022-07-19,San Bernardino,071,2135413,632478,622760,28107,650867,7921
2022-07-19,San Diego,073,3302833,872013,864434,65709,930143,5375
2022-07-19,San Francisco,075,870044,167662,166241,11219,177460,929
2022-07-19,San Joaquin,077,732212,186499,185319,12660,197979,2262
2022-07-19,San Luis Obispo,079,281455,60103,59727,6218,65945,499
2022-07-19,San Mateo,081,765935,157578,156191,9957,166148,724
2022-07-19,Santa Barbara,083,443738,99051,98322,5922,104244,703
2022-07-19,Santa Clara,085,1922200,402279,398816,17478,416294,2374
2022-07-19,Santa Cruz,087,273765,58659,58004,3038,61042,267
2022-07-19,Shasta,089,179085,33274,33017,6855,39872,576
2022-07-19,Sierra,091,2930,293,292,58,350,4
2022-07-19,Siskiyou,093,43540,4950,4921,3119,8040,84
2022-07-19,Solano,095,438530,98699,97577,7127,104704,459
2022-07-19,Sonoma,097,501317,101003,100304,4746,105050,499
2022-07-19,Stanislaus,099,539301,130031,129200,19562,148762,1695
2022-07-19,Sutter,101,95872,22684,22592,2362,24954,228
2022-07-19,Tehama,103,63373,13006,12923,2856,15779,205
2022-07-19,Trinity,105,12862,1332,1319,335,1654,20
2022-07-19,Tulare,107,460477,115597,115073,32107,147180,1510
2022-07-19,Tuolumne,109,53932,14586,14389,847,15236,196
2022-07-19,Ventura,111,848112,196823,195189,13294,208483,1522
2022-07-19,Yolo,113,214977,45223,44950,3936,48886,325
2022-07-19,Yuba,115,75493,17775,17661,1533,19194,124
2022-07-18,Alameda,001,1643700,323273,321347,18195,339542,1915
2022-07-18,Alpine,003,1148,130,130,1,131,0
2022-07-18,Amador,005,37829,9518,9478,825,10303,87
2022-07-18,Butte,007,227075,37067,36820,8213,45033,440
2022-07-18,Calaveras,009,45235,8064,8035,460,8495,126
2022-07-18,Colusa,011,21464,3637,3627,1172,4799,22
2022-07-18,Contra Costa,013,1133247,233392,230356,18461,248817,1362
2022-07-18,Del Norte,015,27424,7069,7081,361,7442,54
2022-07-18,El Dorado,017,186661,30763,30628,3941,34569,221
2022-07-18,Fresno,019,978130,257493,256217,27610,283827,2790
2022-07-18,Glenn,021,27897,5319,5287,1780,7067,48
2022-07-18,Humboldt,023,135768,20278,20149,4247,24396,150
2022-07-18,Imperial,025,180216,61707,61170,13289,74459,944
2022-07-18,Inyo,027,18085,4375,4355,759,5114,56
2022-07-18,Kern,029,883053,208907,207603,54327,261930,2366
2022-07-18,Kings,031,150075,56052,55836,3775,59611,449
2022-07-18,Lake,033,64148,11961,11895,1056,12951,142
2022-07-18,Lassen,035,31185,9496,9455,951,10406,64
2022-07-18,Los Angeles,037,10098052,3091302,3068779,158944,3227723,32292
2022-07-18,Madera,039,155013,41098,40902,7221,48123,372
2022-07-18,Marin,041,260295,42386,42153,4834,46987,300
2022-07-18,Mariposa,043,17540,2910,2884,298,3182,30
2022-07-18,Mendocino,045,87422,14991,14890,4007,18897,131
2022-07-18,Merced,047,269075,68206,67775,10183,77958,833
2022-07-18,Modoc,049,8938,834,799,307,1106,9
2022-07-18,Mono,051,14174,3143,3138,212,3350,7
2022-07-18,Monterey,053,433212,89093,88606,18244,106850,747
2022-07-18,Napa,055,140530,30508,30353,1329,31682,145
2022-07-18,Nevada,057,99092,18087,18020,1602,19622,131
2022-07-18,Orange,059,3164182,627936,624998,54051,679049,7173
2022-07-18,Placer,061,380077,71953,71614,8800,80414,639
2022-07-18,Plumas,063,18699,3460,3433,421,3854,13
2022-07-18,Riverside,065,2383286,655852,652192,32101,684293,6510
2022-07-18,Sacramento,067,1510023,325878,324765,31417,356182,3123
2022-07-18,San Benito,069,59416,15028,14966,807,15773,100
2022-07-18,San Bernardino,071,2135413,631229,622760,28034,650794,7921
2022-07-18,San Diego,073,3302833,869693,864434,65437,929871,5375
2022-07-18,San Francisco,075,870044,167239,166241,11195,177436,929
2022-07-18,San Joaquin,077,732212,186167,185319,12615,197934,2262
2022-07-18,San Luis Obispo,079,281455,60007,59727,6193,65920,499
2022-07-18,San Mateo,081,765935,157207,156191,9938,166129,724
2022-07-18,Santa Barbara,083,443738,98854,98322,5901,104223,703
2022-07-18,Santa Clara,085,1922200,401297,398816,17428,416244,2374
2022-07-18,Santa Cruz,087,273765,58510,58004,3026,61030,267
2022-07-18,Shasta,089,179085,33226,33017,6839,39856,576
2022-07-18,Sierra,091,2930,293,292,58,350,4
2022-07-18,Siskiyou,093,43540,4946,4921,3112,8033,84
2022-07-18,Solano,095,438530,98466,97577,7111,104688,459
2022-07-18,Sonoma,097,501317,100824,100304,4728,105032,499
2022-07-18,Stanislaus,099,539301,129809,129200,19525,148725,1695
2022-07-18,Sutter,101,95872,22650,22592,2362,24954,228
2022-07-18,Tehama,103,63373,12985,12923,2856,15779,205
2022-07-18,Trinity,105,12862,1330,1319,334,1653,20
2022-07-18,Tulare,107,460477,115407,115073,32018,147091,1510
2022-07-18,Tuolumne,109,53932,14550,14389,845,15234,196
2022-07-18,Ventura,111,848112,196439,195189,13228,208417,1522
2022-07-18,Yolo,113,214977,45153,44950,3925,48875,325
2022-07-18,Yuba,115,75493,17740,17661,1524,19185,124
2022-07-17,Alameda,001,1643700,322376,318442,18138,336580,1911
2022-07-17,Alpine,003,1148,130,130,1,131,0
2022-07-17,Amador,005,37829,9509,9437,821,10258,87
2022-07-17,Butte,007,227075,37006,36644,8191,44835,440
2022-07-17,Calaveras,009,45235,8047,7994,450,8444,126
2022-07-17,Colusa,011,21464,3630,3617,1166,4783,22
2022-07-17,Contra Costa,013,1133247,232827,228634,18386,247020,1356
2022-07-17,Del Norte,015,27424,7042,6860,359,7219,54
2022-07-17,El Dorado,017,186661,30715,30461,3927,34388,219
2022-07-17,Fresno,019,978130,256805,254088,27507,281595,2790
2022-07-17,Glenn,021,27897,5313,5273,1778,7051,48
2022-07-17,Humboldt,023,135768,20223,20016,4230,24246,150
2022-07-17,Imperial,025,180216,61512,60550,13143,73693,944
2022-07-17,Inyo,027,18085,4364,4343,755,5098,56
2022-07-17,Kern,029,883053,208412,206466,54122,260588,2364
2022-07-17,Kings,031,150075,55914,55432,3752,59184,449
2022-07-17,Lake,033,64148,11929,11835,1052,12887,141
2022-07-17,Lassen,035,31185,9470,9425,947,10372,64
2022-07-17,Los Angeles,037,10098052,3084058,3042708,158157,3200865,32248
2022-07-17,Madera,039,155013,40989,40627,7176,47803,372
2022-07-17,Marin,041,260295,42288,41829,4828,46657,300
2022-07-17,Mariposa,043,17540,2903,2866,298,3164,30
2022-07-17,Mendocino,045,87422,14952,14799,3988,18787,131
2022-07-17,Merced,047,269075,68070,67416,10143,77559,833
2022-07-17,Modoc,049,8938,831,799,307,1106,9
2022-07-17,Mono,051,14174,3141,3131,208,3339,7
2022-07-17,Monterey,053,433212,88898,88118,18174,106292,747
2022-07-17,Napa,055,140530,30449,30176,1328,31504,145
2022-07-17,Nevada,057,99092,18060,17941,1594,19535,131
2022-07-17,Orange,059,3164182,626365,620414,53785,674199,7161
2022-07-17,Placer,061,380077,71865,71232,8781,80013,637
2022-07-17,Plumas,063,18699,3445,3406,421,3827,13
2022-07-17,Riverside,065,2383286,654385,647328,31985,679313,6508
2022-07-17,Sacramento,067,1510023,325217,322788,31360,354148,3119
2022-07-17,San Benito,069,59416,15002,14869,801,15670,100
2022-07-17,San Bernardino,071,2135413,629797,618482,27924,646406,7914
2022-07-17,San Diego,073,3302833,867309,857262,65234,922496,5370
2022-07-17,San Francisco,075,870044,166766,164853,11151,176004,928
2022-07-17,San Joaquin,077,732212,185792,184187,12552,196739,2262
2022-07-17,San Luis Obispo,079,281455,59888,59437,6154,65591,499
2022-07-17,San Mateo,081,765935,156842,154961,9916,164877,723
2022-07-17,Santa Barbara,083,443738,98586,97600,5874,103474,702
2022-07-17,Santa Clara,085,1922200,400239,395466,17374,412840,2371
2022-07-17,Santa Cruz,087,273765,58314,57531,3008,60539,267
2022-07-17,Shasta,089,179085,33174,32871,6813,39684,575
2022-07-17,Sierra,091,2930,293,291,58,349,4
2022-07-17,Siskiyou,093,43540,4936,4899,3098,7997,83
2022-07-17,Solano,095,438530,98268,96974,7087,104061,457
2022-07-17,Sonoma,097,501317,100629,99679,4710,104389,499
2022-07-17,Stanislaus,099,539301,129539,128436,19494,147930,1692
2022-07-17,Sutter,101,95872,22596,22452,2359,24811,228
2022-07-17,Tehama,103,63373,12961,12860,2849,15709,205
2022-07-17,Trinity,105,12862,1327,1304,332,1636,20
2022-07-17,Tulare,107,460477,115184,114399,31925,146324,1510
2022-07-17,Tuolumne,109,53932,14517,14280,837,15117,196
2022-07-17,Ventura,111,848112,195987,193965,13118,207083,1519
2022-07-17,Yolo,113,214977,45076,44703,3909,48612,324
2022-07-17,Yuba,115,75493,17700,17567,1514,19081,124
2022-07-16,Alameda,001,1643700,321962,318442,18122,336564,1911
2022-07-16,Alpine,003,1148,130,130,1,131,0
2022-07-16,Amador,005,37829,9501,9437,821,10258,87
2022-07-16,Butte,007,227075,36985,36644,8176,44820,440
2022-07-16,Calaveras,009,45235,8042,7994,444,8438,126
2022-07-16,Colusa,011,21464,3626,3617,1162,4779,22
2022-07-16,Contra Costa,013,1133247,232519,228634,18336,246970,1356
2022-07-16,Del Norte,015,27424,7031,6860,359,7219,54
2022-07-16,El Dorado,017,186661,30694,30461,3925,34386,219
2022-07-16,Fresno,019,978130,256518,254088,27468,281556,2790
2022-07-16,Glenn,021,27897,5308,5273,1775,7048,48
2022-07-16,Humboldt,023,135768,20192,20016,4218,24234,150
2022-07-16,Imperial,025,180216,61427,60550,13099,73649,944
2022-07-16,Inyo,027,18085,4363,4343,754,5097,56
2022-07-16,Kern,029,883053,208241,206466,53985,260451,2364
2022-07-16,Kings,031,150075,55873,55432,3748,59180,449
2022-07-16,Lake,033,64148,11913,11835,1052,12887,141
2022-07-16,Lassen,035,31185,9468,9425,946,10371,64
2022-07-16,Los Angeles,037,10098052,3080638,3042708,157683,3200391,32248
2022-07-16,Madera,039,155013,40946,40627,7162,47789,372
2022-07-16,Marin,041,260295,42252,41829,4821,46650,300
2022-07-16,Mariposa,043,17540,2901,2866,298,3164,30
2022-07-16,Mendocino,045,87422,14944,14799,3985,18784,131
2022-07-16,Merced,047,269075,67982,67416,10132,77548,833
2022-07-16,Modoc,049,8938,831,799,307,1106,9
2022-07-16,Mono,051,14174,3140,3131,207,3338,7
2022-07-16,Monterey,053,433212,88804,88118,18132,106250,747
2022-07-16,Napa,055,140530,30421,30176,1326,31502,145
2022-07-16,Nevada,057,99092,18046,17941,1587,19528,131
2022-07-16,Orange,059,3164182,625638,620414,53641,674055,7161
2022-07-16,Placer,061,380077,71780,71232,8765,79997,637
2022-07-16,Plumas,063,18699,3441,3406,420,3826,13
2022-07-16,Riverside,065,2383286,653597,647328,31933,679261,6508
2022-07-16,Sacramento,067,1510023,324945,322788,31346,354134,3119
2022-07-16,San Benito,069,59416,14985,14869,797,15666,100
2022-07-16,San Bernardino,071,2135413,629061,618482,27862,646344,7914
2022-07-16,San Diego,073,3302833,866399,857262,65158,922420,5370
2022-07-16,San Francisco,075,870044,166581,164853,11135,175988,928
2022-07-16,San Joaquin,077,732212,185634,184187,12529,196716,2262
2022-07-16,San Luis Obispo,079,281455,59860,59437,6134,65571,499
2022-07-16,San Mateo,081,765935,156603,154961,9905,164866,723
2022-07-16,Santa Barbara,083,443738,98470,97600,5854,103454,702
2022-07-16,Santa Clara,085,1922200,399572,395466,17349,412815,2371
2022-07-16,Santa Cruz,087,273765,58242,57531,3003,60534,267
2022-07-16,Shasta,089,179085,33154,32871,6809,39680,575
2022-07-16,Sierra,091,2930,293,291,58,349,4
2022-07-16,Siskiyou,093,43540,4934,4899,3093,7992,83
2022-07-16,Solano,095,438530,98197,96974,7071,104045,457
2022-07-16,Sonoma,097,501317,100542,99679,4699,104378,499
2022-07-16,Stanislaus,099,539301,129408,128436,19463,147899,1692
2022-07-16,Sutter,101,95872,22572,22452,2358,24810,228
2022-07-16,Tehama,103,63373,12952,12860,2844,15704,205
2022-07-16,Trinity,105,12862,1325,1304,332,1636,20
2022-07-16,Tulare,107,460477,115077,114399,31864,146263,1510
2022-07-16,Tuolumne,109,53932,14493,14280,837,15117,196
2022-07-16,Ventura,111,848112,195761,193965,13081,207046,1519
2022-07-16,Yolo,113,214977,45030,44703,3896,48599,324
2022-07-16,Yuba,115,75493,17676,17567,1514,19081,124
2022-07-15,Alameda,001,1643700,321501,318442,18087,336529,1911
2022-07-15,Alpine,003,1148,130,130,1,131,0
2022-07-15,Amador,005,37829,9498,9437,820,10257,87
2022-07-15,Butte,007,227075,36946,36644,8170,44814,440
2022-07-15,Calaveras,009,45235,8036,7994,440,8434,126
2022-07-15,Colusa,011,21464,3624,3617,1160,4777,22
2022-07-15,Contra Costa,013,1133247,232243,228634,18286,246920,1356
2022-07-15,Del Norte,015,27424,7020,6860,356,7216,54
2022-07-15,El Dorado,017,186661,30666,30461,3922,34383,219
2022-07-15,Fresno,019,978130,256126,254088,27405,281493,2790
2022-07-15,Glenn,021,27897,5305,5273,1772,7045,48
2022-07-15,Humboldt,023,135768,20168,20016,4206,24222,150
2022-07-15,Imperial,025,180216,61352,60550,13056,73606,944
2022-07-15,Inyo,027,18085,4359,4343,749,5092,56
2022-07-15,Kern,029,883053,208028,206466,53829,260295,2364
2022-07-15,Kings,031,150075,55809,55432,3741,59173,449
2022-07-15,Lake,033,64148,11901,11835,1049,12884,141
2022-07-15,Lassen,035,31185,9466,9425,944,10369,64
2022-07-15,Los Angeles,037,10098052,3076479,3042708,157180,3199888,32248
2022-07-15,Madera,039,155013,40883,40627,7143,47770,372
2022-07-15,Marin,041,260295,42192,41829,4810,46639,300
2022-07-15,Mariposa,043,17540,2898,2866,297,3163,30
2022-07-15,Mendocino,045,87422,14921,14799,3980,18779,131
2022-07-15,Merced,047,269075,67921,67416,10123,77539,833
2022-07-15,Modoc,049,8938,830,799,307,1106,9
2022-07-15,Mono,051,14174,3138,3131,206,3337,7
2022-07-15,Monterey,053,433212,88691,88118,18105,106223,747
2022-07-15,Napa,055,140530,30388,30176,1325,31501,145
2022-07-15,Nevada,057,99092,18034,17941,1585,19526,131
2022-07-15,Orange,059,3164182,624797,620414,53479,673893,7161
2022-07-15,Placer,061,380077,71707,71232,8738,79970,637
2022-07-15,Plumas,063,18699,3434,3406,418,3824,13
2022-07-15,Riverside,065,2383286,652768,647328,31870,679198,6508
2022-07-15,Sacramento,067,1510023,324578,322788,31327,354115,3119
2022-07-15,San Benito,069,59416,14970,14869,797,15666,100
2022-07-15,San Bernardino,071,2135413,628317,618482,27820,646302,7914
2022-07-15,San Diego,073,3302833,865125,857262,64996,922258,5370
2022-07-15,San Francisco,075,870044,166325,164853,11093,175946,928
2022-07-15,San Joaquin,077,732212,185458,184187,12499,196686,2262
2022-07-15,San Luis Obispo,079,281455,59829,59437,6121,65558,499
2022-07-15,San Mateo,081,765935,156367,154961,9888,164849,723
2022-07-15,Santa Barbara,083,443738,98341,97600,5847,103447,702
2022-07-15,Santa Clara,085,1922200,398885,395466,17323,412789,2371
2022-07-15,Santa Cruz,087,273765,58152,57531,2991,60522,267
2022-07-15,Shasta,089,179085,33131,32871,6802,39673,575
2022-07-15,Sierra,091,2930,293,291,58,349,4
2022-07-15,Siskiyou,093,43540,4931,4899,3091,7990,83
2022-07-15,Solano,095,438530,98047,96974,7060,104034,457
2022-07-15,Sonoma,097,501317,100419,99679,4690,104369,499
2022-07-15,Stanislaus,099,539301,129284,128436,19447,147883,1692
2022-07-15,Sutter,101,95872,22545,22452,2357,24809,228
2022-07-15,Tehama,103,63373,12945,12860,2836,15696,205
2022-07-15,Trinity,105,12862,1321,1304,332,1636,20
2022-07-15,Tulare,107,460477,114926,114399,31779,146178,1510
2022-07-15,Tuolumne,109,53932,14449,14280,834,15114,196
2022-07-15,Ventura,111,848112,195535,193965,13042,207007,1519
2022-07-15,Yolo,113,214977,44984,44703,3885,48588,324
2022-07-15,Yuba,115,75493,17650,17567,1514,19081,124
2022-07-14,Alameda,001,1643700,320743,318442,18024,336466,1911
2022-07-14,Alpine,003,1148,130,130,1,131,0
2022-07-14,Amador,005,37829,9485,9437,814,10251,87
2022-07-14,Butte,007,227075,36906,36644,8164,44808,440
2022-07-14,Calaveras,009,45235,8029,7994,436,8430,126
2022-07-14,Colusa,011,21464,3624,3617,1158,4775,22
2022-07-14,Contra Costa,013,1133247,231798,228634,18199,246833,1356
2022-07-14,Del Norte,015,27424,6999,6860,354,7214,54
2022-07-14,El Dorado,017,186661,30629,30461,3913,34374,219
2022-07-14,Fresno,019,978130,255594,254088,27315,281403,2790
2022-07-14,Glenn,021,27897,5296,5273,1769,7042,48
2022-07-14,Humboldt,023,135768,20128,20016,4191,24207,150
2022-07-14,Imperial,025,180216,61173,60550,12940,73490,944
2022-07-14,Inyo,027,18085,4357,4343,744,5087,56
2022-07-14,Kern,029,883053,207699,206466,53627,260093,2364
2022-07-14,Kings,031,150075,55714,55432,3730,59162,449
2022-07-14,Lake,033,64148,11885,11835,1047,12882,141
2022-07-14,Lassen,035,31185,9461,9425,943,10368,64
2022-07-14,Los Angeles,037,10098052,3070345,3042708,156470,3199178,32248
2022-07-14,Madera,039,155013,40810,40627,7086,47713,372
2022-07-14,Marin,041,260295,42102,41829,4805,46634,300
2022-07-14,Mariposa,043,17540,2892,2866,292,3158,30
2022-07-14,Mendocino,045,87422,14907,14799,3975,18774,131
2022-07-14,Merced,047,269075,67826,67416,10096,77512,833
2022-07-14,Modoc,049,8938,830,799,307,1106,9
2022-07-14,Mono,051,14174,3137,3131,206,3337,7
2022-07-14,Monterey,053,433212,88573,88118,18027,106145,747
2022-07-14,Napa,055,140530,30345,30176,1321,31497,145
2022-07-14,Nevada,057,99092,18009,17941,1576,19517,131
2022-07-14,Orange,059,3164182,623536,620414,53267,673681,7161
2022-07-14,Placer,061,380077,71597,71232,8718,79950,637
2022-07-14,Plumas,063,18699,3425,3406,417,3823,13
2022-07-14,Riverside,065,2383286,651532,647328,31796,679124,6508
2022-07-14,Sacramento,067,1510023,324024,322788,31285,354073,3119
2022-07-14,San Benito,069,59416,14940,14869,793,15662,100
2022-07-14,San Bernardino,071,2135413,627164,618482,27741,646223,7914
2022-07-14,San Diego,073,3302833,863242,857262,64765,922027,5370
2022-07-14,San Francisco,075,870044,165987,164853,11046,175899,928
2022-07-14,San Joaquin,077,732212,185149,184187,12464,196651,2262
2022-07-14,San Luis Obispo,079,281455,59742,59437,6077,65514,499
2022-07-14,San Mateo,081,765935,156080,154961,9866,164827,723
2022-07-14,Santa Barbara,083,443738,98162,97600,5835,103435,702
2022-07-14,Santa Clara,085,1922200,398031,395466,17280,412746,2371
2022-07-14,Santa Cruz,087,273765,58060,57531,2977,60508,267
2022-07-14,Shasta,089,179085,33083,32871,6790,39661,575
2022-07-14,Sierra,091,2930,293,291,58,349,4
2022-07-14,Siskiyou,093,43540,4923,4899,3083,7982,83
2022-07-14,Solano,095,438530,97870,96974,7048,104022,457
2022-07-14,Sonoma,097,501317,100285,99679,4667,104346,499
2022-07-14,Stanislaus,099,539301,129079,128436,19417,147853,1692
2022-07-14,Sutter,101,95872,22519,22452,2356,24808,228
2022-07-14,Tehama,103,63373,12922,12860,2831,15691,205
2022-07-14,Trinity,105,12862,1321,1304,328,1632,20
2022-07-14,Tulare,107,460477,114797,114399,31680,146079,1510
2022-07-14,Tuolumne,109,53932,14409,14280,830,15110,196
2022-07-14,Ventura,111,848112,195186,193965,12969,206934,1519
2022-07-14,Yolo,113,214977,44919,44703,3872,48575,324
2022-07-14,Yuba,115,75493,17618,17567,1505,19072,124
2022-07-13,Alameda,001,1643700,320043,316026,17954,333980,1911
2022-07-13,Alpine,003,1148,130,129,1,130,0
2022-07-13,Amador,005,37829,9474,9388,813,10201,87
2022-07-13,Butte,007,227075,36850,36405,8150,44555,439
2022-07-13,Calaveras,009,45235,8016,7945,435,8380,125
2022-07-13,Colusa,011,21464,3620,3606,1158,4764,22
2022-07-13,Contra Costa,013,1133247,231317,226833,18118,244951,1356
2022-07-13,Del Norte,015,27424,6980,6790,354,7144,54
2022-07-13,El Dorado,017,186661,30580,30273,3907,34180,218
2022-07-13,Fresno,019,978130,255044,252573,27204,279777,2786
2022-07-13,Glenn,021,27897,5291,5256,1768,7024,48
2022-07-13,Humboldt,023,135768,20095,19854,4176,24030,150
2022-07-13,Imperial,025,180216,61016,60011,12859,72870,944
2022-07-13,Inyo,027,18085,4356,4324,739,5063,56
2022-07-13,Kern,029,883053,207297,205428,53405,258833,2359
2022-07-13,Kings,031,150075,55604,55138,3721,58859,449
2022-07-13,Lake,033,64148,11867,11773,1046,12819,140
2022-07-13,Lassen,035,31185,9439,9381,942,10323,64
2022-07-13,Los Angeles,037,10098052,3063736,3024953,155760,3180713,32206
2022-07-13,Madera,039,155013,40743,40378,7061,47439,372
2022-07-13,Marin,041,260295,42035,41616,4797,46413,300
2022-07-13,Mariposa,043,17540,2887,2847,291,3138,30
2022-07-13,Mendocino,045,87422,14887,14713,3960,18673,128
2022-07-13,Merced,047,269075,67694,67028,10065,77093,832
2022-07-13,Modoc,049,8938,829,791,306,1097,9
2022-07-13,Mono,051,14174,3136,3131,202,3333,7
2022-07-13,Monterey,053,433212,88429,87575,17951,105526,745
2022-07-13,Napa,055,140530,30306,30032,1320,31352,145
2022-07-13,Nevada,057,99092,17991,17849,1569,19418,131
2022-07-13,Orange,059,3164182,622157,616278,53030,669308,7147
2022-07-13,Placer,061,380077,71490,70890,8705,79595,637
2022-07-13,Plumas,063,18699,3417,3354,416,3770,13
2022-07-13,Riverside,065,2383286,650322,643472,31699,675171,6504
2022-07-13,Sacramento,067,1510023,323496,321076,31244,352320,3114
2022-07-13,San Benito,069,59416,14913,14774,787,15561,100
2022-07-13,San Bernardino,071,2135413,625987,614957,27644,642601,7907
2022-07-13,San Diego,073,3302833,861331,851596,64547,916143,5363
2022-07-13,San Francisco,075,870044,165583,163635,11018,174653,919
2022-07-13,San Joaquin,077,732212,184821,183283,12430,195713,2260
2022-07-13,San Luis Obispo,079,281455,59636,59134,6031,65165,498
2022-07-13,San Mateo,081,765935,155740,153875,9849,163724,723
2022-07-13,Santa Barbara,083,443738,97983,97053,5823,102876,699
2022-07-13,Santa Clara,085,1922200,397143,392415,17240,409655,2365
2022-07-13,Santa Cruz,087,273765,57924,57124,2970,60094,267
2022-07-13,Shasta,089,179085,33026,32708,6775,39483,574
2022-07-13,Sierra,091,2930,293,289,58,347,4
2022-07-13,Siskiyou,093,43540,4916,4873,3081,7954,82
2022-07-13,Solano,095,438530,97665,96479,7025,103504,455
2022-07-13,Sonoma,097,501317,100127,99173,4650,103823,499
2022-07-13,Stanislaus,099,539301,128879,127845,19370,147215,1689
2022-07-13,Sutter,101,95872,22472,22331,2354,24685,228
2022-07-13,Tehama,103,63373,12909,12793,2828,15621,205
2022-07-13,Trinity,105,12862,1320,1293,326,1619,20
2022-07-13,Tulare,107,460477,114602,113830,31588,145418,1508
2022-07-13,Tuolumne,109,53932,14385,14159,825,14984,194
2022-07-13,Ventura,111,848112,194852,192923,12889,205812,1518
2022-07-13,Yolo,113,214977,44857,44447,3862,48309,326
2022-07-13,Yuba,115,75493,17591,17464,1497,18961,124
2022-07-12,Alameda,001,1643700,319272,316026,17907,333933,1911
2022-07-12,Alpine,003,1148,130,129,1,130,0
2022-07-12,Amador,005,37829,9441,9388,806,10194,87
2022-07-12,Butte,007,227075,36793,36405,8131,44536,439
2022-07-12,Calaveras,009,45235,8001,7945,433,8378,125
2022-07-12,Colusa,011,21464,3618,3606,1155,4761,22
2022-07-12,Contra Costa,013,1133247,230812,226833,18043,244876,1356
2022-07-12,Del Norte,015,27424,6933,6790,351,7141,54
2022-07-12,El Dorado,017,186661,30541,30273,3901,34174,218
2022-07-12,Fresno,019,978130,254504,252573,27120,279693,2786
2022-07-12,Glenn,021,27897,5288,5256,1764,7020,48
2022-07-12,Humboldt,023,135768,20045,19854,4160,24014,150
2022-07-12,Imperial,025,180216,60840,60011,12759,72770,944
2022-07-12,Inyo,027,18085,4348,4324,739,5063,56
2022-07-12,Kern,029,883053,206972,205428,53227,258655,2359
2022-07-12,Kings,031,150075,55492,55138,3711,58849,449
2022-07-12,Lake,033,64148,11855,11773,1041,12814,140
2022-07-12,Lassen,035,31185,9425,9381,936,10317,64
2022-07-12,Los Angeles,037,10098052,3056973,3024953,155066,3180019,32206
2022-07-12,Madera,039,155013,40657,40378,7046,47424,372
2022-07-12,Marin,041,260295,41962,41616,4787,46403,300
2022-07-12,Mariposa,043,17540,2876,2847,291,3138,30
2022-07-12,Mendocino,045,87422,14848,14713,3936,18649,128
2022-07-12,Merced,047,269075,67585,67028,10032,77060,832
2022-07-12,Modoc,049,8938,827,791,303,1094,9
2022-07-12,Mono,051,14174,3132,3131,202,3333,7
2022-07-12,Monterey,053,433212,88274,87575,17863,105438,745
2022-07-12,Napa,055,140530,30252,30032,1317,31349,145
2022-07-12,Nevada,057,99092,17969,17849,1562,19411,131
2022-07-12,Orange,059,3164182,620752,616278,52797,669075,7147
2022-07-12,Placer,061,380077,71380,70890,8690,79580,637
2022-07-12,Plumas,063,18699,3411,3354,415,3769,13
2022-07-12,Riverside,065,2383286,649035,643472,31604,675076,6504
2022-07-12,Sacramento,067,1510023,322908,321076,31206,352282,3114
2022-07-12,San Benito,069,59416,14867,14774,781,15555,100
2022-07-12,San Bernardino,071,2135413,624653,614957,27558,642515,7907
2022-07-12,San Diego,073,3302833,858967,851596,64319,915915,5363
2022-07-12,San Francisco,075,870044,165176,163635,10994,174629,919
2022-07-12,San Joaquin,077,732212,184508,183283,12394,195677,2260
2022-07-12,San Luis Obispo,079,281455,59558,59134,6002,65136,498
2022-07-12,San Mateo,081,765935,155346,153875,9830,163705,723
2022-07-12,Santa Barbara,083,443738,97768,97053,5806,102859,699
2022-07-12,Santa Clara,085,1922200,396187,392415,17197,409612,2365
2022-07-12,Santa Cruz,087,273765,57786,57124,2961,60085,267
2022-07-12,Shasta,089,179085,32963,32708,6756,39464,574
2022-07-12,Sierra,091,2930,292,289,58,347,4
2022-07-12,Siskiyou,093,43540,4907,4873,3079,7952,82
2022-07-12,Solano,095,438530,97452,96479,7000,103479,455
2022-07-12,Sonoma,097,501317,99966,99173,4622,103795,499
2022-07-12,Stanislaus,099,539301,128633,127845,19334,147179,1689
2022-07-12,Sutter,101,95872,22438,22331,2352,24683,228
2022-07-12,Tehama,103,63373,12889,12793,2822,15615,205
2022-07-12,Trinity,105,12862,1312,1293,326,1619,20
2022-07-12,Tulare,107,460477,114409,113830,31488,145318,1508
2022-07-12,Tuolumne,109,53932,14350,14159,821,14980,194
2022-07-12,Ventura,111,848112,194520,192923,12792,205715,1518
2022-07-12,Yolo,113,214977,44787,44447,3854,48301,326
2022-07-12,Yuba,115,75493,17563,17464,1484,18948,124
2022-07-11,Alameda,001,1643700,318366,316026,17848,333874,1911
2022-07-11,Alpine,003,1148,130,129,1,130,0
2022-07-11,Amador,005,37829,9433,9388,800,10188,87
2022-07-11,Butte,007,227075,36734,36405,8112,44517,439
2022-07-11,Calaveras,009,45235,7985,7945,431,8376,125
2022-07-11,Colusa,011,21464,3614,3606,1152,4758,22
2022-07-11,Contra Costa,013,1133247,230331,226833,17983,244816,1356
2022-07-11,Del Norte,015,27424,6902,6790,341,7131,54
2022-07-11,El Dorado,017,186661,30484,30273,3890,34163,218
2022-07-11,Fresno,019,978130,253837,252573,27039,279612,2786
2022-07-11,Glenn,021,27897,5285,5256,1762,7018,48
2022-07-11,Humboldt,023,135768,19986,19854,4141,23995,150
2022-07-11,Imperial,025,180216,60680,60011,12648,72659,944
2022-07-11,Inyo,027,18085,4345,4324,735,5059,56
2022-07-11,Kern,029,883053,206643,205428,53078,258506,2359
2022-07-11,Kings,031,150075,55344,55138,3701,58839,449
2022-07-11,Lake,033,64148,11829,11773,1039,12812,140
2022-07-11,Lassen,035,31185,9419,9381,936,10317,64
2022-07-11,Los Angeles,037,10098052,3049893,3024953,154285,3179238,32206
2022-07-11,Madera,039,155013,40570,40378,7001,47379,372
2022-07-11,Marin,041,260295,41873,41616,4778,46394,300
2022-07-11,Mariposa,043,17540,2868,2847,289,3136,30
2022-07-11,Mendocino,045,87422,14809,14713,3922,18635,128
2022-07-11,Merced,047,269075,67458,67028,9997,77025,832
2022-07-11,Modoc,049,8938,821,791,301,1092,9
2022-07-11,Mono,051,14174,3132,3131,201,3332,7
2022-07-11,Monterey,053,433212,88108,87575,17794,105369,745
2022-07-11,Napa,055,140530,30190,30032,1317,31349,145
2022-07-11,Nevada,057,99092,17952,17849,1560,19409,131
2022-07-11,Orange,059,3164182,619182,616278,52568,668846,7147
2022-07-11,Placer,061,380077,71272,70890,8675,79565,637
2022-07-11,Plumas,063,18699,3399,3354,413,3767,13
2022-07-11,Riverside,065,2383286,647595,643472,31518,674990,6504
2022-07-11,Sacramento,067,1510023,322361,321076,31161,352237,3114
2022-07-11,San Benito,069,59416,14831,14774,777,15551,100
2022-07-11,San Bernardino,071,2135413,623285,614957,27468,642425,7907
2022-07-11,San Diego,073,3302833,856592,851596,64082,915678,5363
2022-07-11,San Francisco,075,870044,164762,163635,10966,174601,919
2022-07-11,San Joaquin,077,732212,184130,183283,12357,195640,2260
2022-07-11,San Luis Obispo,079,281455,59450,59134,5970,65104,498
2022-07-11,San Mateo,081,765935,154948,153875,9795,163670,723
2022-07-11,Santa Barbara,083,443738,97559,97053,5793,102846,699
2022-07-11,Santa Clara,085,1922200,395119,392415,17142,409557,2365
2022-07-11,Santa Cruz,087,273765,57636,57124,2947,60071,267
2022-07-11,Shasta,089,179085,32908,32708,6726,39434,574
2022-07-11,Sierra,091,2930,292,289,58,347,4
2022-07-11,Siskiyou,093,43540,4900,4873,3072,7945,82
2022-07-11,Solano,095,438530,97239,96479,6985,103464,455
2022-07-11,Sonoma,097,501317,99772,99173,4602,103775,499
2022-07-11,Stanislaus,099,539301,128408,127845,19298,147143,1689
2022-07-11,Sutter,101,95872,22396,22331,2345,24676,228
2022-07-11,Tehama,103,63373,12876,12793,2815,15608,205
2022-07-11,Trinity,105,12862,1310,1293,325,1618,20
2022-07-11,Tulare,107,460477,114221,113830,31383,145213,1508
2022-07-11,Tuolumne,109,53932,14310,14159,819,14978,194
2022-07-11,Ventura,111,848112,194123,192923,12710,205633,1518
2022-07-11,Yolo,113,214977,44721,44447,3839,48286,326
2022-07-11,Yuba,115,75493,17527,17464,1481,18945,124
2022-07-10,Alameda,001,1643700,317371,312651,17768,330419,1912
2022-07-10,Alpine,003,1148,130,129,1,130,0
2022-07-10,Amador,005,37829,9423,9335,797,10132,87
2022-07-10,Butte,007,227075,36636,36165,8089,44254,438
2022-07-10,Calaveras,009,45235,7976,7895,430,8325,125
2022-07-10,Colusa,011,21464,3610,3586,1144,4730,22
2022-07-10,Contra Costa,013,1133247,229719,224718,17888,242606,1351
2022-07-10,Del Norte,015,27424,6862,6666,335,7001,54
2022-07-10,El Dorado,017,186661,30401,30070,3882,33952,218
2022-07-10,Fresno,019,978130,253163,250379,26946,277325,2786
2022-07-10,Glenn,021,27897,5280,5231,1758,6989,48
2022-07-10,Humboldt,023,135768,19927,19677,4127,23804,149
2022-07-10,Imperial,025,180216,60456,59558,12507,72065,944
2022-07-10,Inyo,027,18085,4340,4297,729,5026,56
2022-07-10,Kern,029,883053,206134,204128,52882,257010,2359
2022-07-10,Kings,031,150075,55168,54725,3695,58420,449
2022-07-10,Lake,033,64148,11804,11685,1036,12721,140
2022-07-10,Lassen,035,31185,9404,9362,934,10296,64
2022-07-10,Los Angeles,037,10098052,3042659,3002013,153485,3155498,32151
2022-07-10,Madera,039,155013,40461,40081,6967,47048,372
2022-07-10,Marin,041,260295,41776,41271,4769,46040,302
2022-07-10,Mariposa,043,17540,2861,2805,285,3090,30
2022-07-10,Mendocino,045,87422,14779,14610,3905,18515,128
2022-07-10,Merced,047,269075,67301,66616,9940,76556,832
2022-07-10,Modoc,049,8938,820,789,293,1082,9
2022-07-10,Mono,051,14174,3131,3119,199,3318,7
2022-07-10,Monterey,053,433212,87916,87002,17714,104716,745
2022-07-10,Napa,055,140530,30128,29807,1315,31122,145
2022-07-10,Nevada,057,99092,17890,17693,1551,19244,131
2022-07-10,Orange,059,3164182,617488,610975,52261,663236,7132
2022-07-10,Placer,061,380077,71156,70401,8656,79057,632
2022-07-10,Plumas,063,18699,3386,3339,409,3748,13
2022-07-10,Riverside,065,2383286,646000,638193,31388,669581,6506
2022-07-10,Sacramento,067,1510023,321659,318556,31088,349644,3108
2022-07-10,San Benito,069,59416,14795,14628,766,15394,100
2022-07-10,San Bernardino,071,2135413,621831,610086,27388,637474,7893
2022-07-10,San Diego,073,3302833,854105,844085,63810,907895,5357
2022-07-10,San Francisco,075,870044,164223,161931,10891,172822,914
2022-07-10,San Joaquin,077,732212,183756,181958,12297,194255,2257
2022-07-10,San Luis Obispo,079,281455,59329,58636,5931,64567,498
2022-07-10,San Mateo,081,765935,154486,152319,9769,162088,723
2022-07-10,Santa Barbara,083,443738,97326,96266,5767,102033,697
2022-07-10,Santa Clara,085,1922200,393993,388270,17080,405350,2360
2022-07-10,Santa Cruz,087,273765,57445,56455,2930,59385,266
2022-07-10,Shasta,089,179085,32842,32536,6703,39239,576
2022-07-10,Sierra,091,2930,290,291,58,349,4
2022-07-10,Siskiyou,093,43540,4895,4855,3059,7914,82
2022-07-10,Solano,095,438530,96992,95651,6957,102608,455
2022-07-10,Sonoma,097,501317,99569,98430,4570,103000,496
2022-07-10,Stanislaus,099,539301,128169,126897,19255,146152,1686
2022-07-10,Sutter,101,95872,22347,22165,2344,24509,228
2022-07-10,Tehama,103,63373,12851,12716,2802,15518,205
2022-07-10,Trinity,105,12862,1304,1272,323,1595,20
2022-07-10,Tulare,107,460477,113967,113002,31286,144288,1508
2022-07-10,Tuolumne,109,53932,14274,14019,811,14830,194
2022-07-10,Ventura,111,848112,193649,191462,12609,204071,1518
2022-07-10,Yolo,113,214977,44643,44152,3824,47976,323
2022-07-10,Yuba,115,75493,17488,17345,1479,18824,125
2022-07-09,Alameda,001,1643700,316883,312651,17743,330394,1912
2022-07-09,Alpine,003,1148,130,129,1,130,0
2022-07-09,Amador,005,37829,9415,9335,795,10130,87
2022-07-09,Butte,007,227075,36591,36165,8075,44240,438
2022-07-09,Calaveras,009,45235,7961,7895,429,8324,125
2022-07-09,Colusa,011,21464,3609,3586,1143,4729,22
2022-07-09,Contra Costa,013,1133247,229411,224718,17830,242548,1351
2022-07-09,Del Norte,015,27424,6854,6666,335,7001,54
2022-07-09,El Dorado,017,186661,30358,30070,3877,33947,218
2022-07-09,Fresno,019,978130,252903,250379,26909,277288,2786
2022-07-09,Glenn,021,27897,5273,5231,1758,6989,48
2022-07-09,Humboldt,023,135768,19909,19677,4117,23794,149
2022-07-09,Imperial,025,180216,60377,59558,12454,72012,944
2022-07-09,Inyo,027,18085,4334,4297,728,5025,56
2022-07-09,Kern,029,883053,205960,204128,52783,256911,2359
2022-07-09,Kings,031,150075,55129,54725,3693,58418,449
2022-07-09,Lake,033,64148,11796,11685,1035,12720,140
2022-07-09,Lassen,035,31185,9403,9362,934,10296,64
2022-07-09,Los Angeles,037,10098052,3039193,3002013,152997,3155010,32151
2022-07-09,Madera,039,155013,40422,40081,6959,47040,372
2022-07-09,Marin,041,260295,41720,41271,4758,46029,302
2022-07-09,Mariposa,043,17540,2856,2805,285,3090,30
2022-07-09,Mendocino,045,87422,14764,14610,3895,18505,128
2022-07-09,Merced,047,269075,67250,66616,9935,76551,832
2022-07-09,Modoc,049,8938,820,789,289,1078,9
2022-07-09,Mono,051,14174,3131,3119,199,3318,7
2022-07-09,Monterey,053,433212,87819,87002,17664,104666,745
2022-07-09,Napa,055,140530,30097,29807,1312,31119,145
2022-07-09,Nevada,057,99092,17878,17693,1547,19240,131
2022-07-09,Orange,059,3164182,616628,610975,52091,663066,7132
2022-07-09,Placer,061,380077,71067,70401,8648,79049,632
2022-07-09,Plumas,063,18699,3379,3339,407,3746,13
2022-07-09,Riverside,065,2383286,645103,638193,31333,669526,6506
2022-07-09,Sacramento,067,1510023,321355,318556,31070,349626,3108
2022-07-09,San Benito,069,59416,14775,14628,765,15393,100
2022-07-09,San Bernardino,071,2135413,621112,610086,27337,637423,7893
2022-07-09,San Diego,073,3302833,853202,844085,63727,907812,5357
2022-07-09,San Francisco,075,870044,163989,161931,10870,172801,914
2022-07-09,San Joaquin,077,732212,183589,181958,12271,194229,2257
2022-07-09,San Luis Obispo,079,281455,59272,58636,5912,64548,498
2022-07-09,San Mateo,081,765935,154245,152319,9753,162072,723
2022-07-09,Santa Barbara,083,443738,97193,96266,5757,102023,697
2022-07-09,Santa Clara,085,1922200,393256,388270,17051,405321,2360
2022-07-09,Santa Cruz,087,273765,57368,56455,2921,59376,266
2022-07-09,Shasta,089,179085,32820,32536,6693,39229,576
2022-07-09,Sierra,091,2930,290,291,58,349,4
2022-07-09,Siskiyou,093,43540,4891,4855,3057,7912,82
2022-07-09,Solano,095,438530,96907,95651,6947,102598,455
2022-07-09,Sonoma,097,501317,99481,98430,4564,102994,496
2022-07-09,Stanislaus,099,539301,128005,126897,19227,146124,1686
2022-07-09,Sutter,101,95872,22317,22165,2344,24509,228
2022-07-09,Tehama,103,63373,12834,12716,2793,15509,205
2022-07-09,Trinity,105,12862,1304,1272,322,1594,20
2022-07-09,Tulare,107,460477,113857,113002,31227,144229,1508
2022-07-09,Tuolumne,109,53932,14236,14019,809,14828,194
2022-07-09,Ventura,111,848112,193387,191462,12568,204030,1518
2022-07-09,Yolo,113,214977,44593,44152,3810,47962,323
2022-07-09,Yuba,115,75493,17465,17345,1478,18823,125
2022-07-08,Alameda,001,1643700,316365,312651,17700,330351,1912
2022-07-08,Alpine,003,1148,130,129,1,130,0
2022-07-08,Amador,005,37829,9405,9335,793,10128,87
2022-07-08,Butte,007,227075,36560,36165,8061,44226,438
2022-07-08,Calaveras,009,45235,7946,7895,429,8324,125
2022-07-08,Colusa,011,21464,3605,3586,1143,4729,22
2022-07-08,Contra Costa,013,1133247,229058,224718,17780,242498,1351
2022-07-08,Del Norte,015,27424,6843,6666,333,6999,54
2022-07-08,El Dorado,017,186661,30332,30070,3870,33940,218
2022-07-08,Fresno,019,978130,252534,250379,26856,277235,2786
2022-07-08,Glenn,021,27897,5268,5231,1755,6986,48
2022-07-08,Humboldt,023,135768,19896,19677,4106,23783,149
2022-07-08,Imperial,025,180216,60288,59558,12414,71972,944
2022-07-08,Inyo,027,18085,4333,4297,724,5021,56
2022-07-08,Kern,029,883053,205731,204128,52687,256815,2359
2022-07-08,Kings,031,150075,55087,54725,3692,58417,449
2022-07-08,Lake,033,64148,11779,11685,1032,12717,140
2022-07-08,Lassen,035,31185,9397,9362,933,10295,64
2022-07-08,Los Angeles,037,10098052,3034979,3002013,152423,3154436,32151
2022-07-08,Madera,039,155013,40368,40081,6945,47026,372
2022-07-08,Marin,041,260295,41634,41271,4742,46013,302
2022-07-08,Mariposa,043,17540,2853,2805,284,3089,30
2022-07-08,Mendocino,045,87422,14746,14610,3891,18501,128
2022-07-08,Merced,047,269075,67184,66616,9924,76540,832
2022-07-08,Modoc,049,8938,820,789,289,1078,9
2022-07-08,Mono,051,14174,3129,3119,198,3317,7
2022-07-08,Monterey,053,433212,87706,87002,17634,104636,745
2022-07-08,Napa,055,140530,30073,29807,1311,31118,145
2022-07-08,Nevada,057,99092,17870,17693,1545,19238,131
2022-07-08,Orange,059,3164182,615728,610975,51915,662890,7132
2022-07-08,Placer,061,380077,70992,70401,8636,79037,632
2022-07-08,Plumas,063,18699,3374,3339,407,3746,13
2022-07-08,Riverside,065,2383286,644191,638193,31276,669469,6506
2022-07-08,Sacramento,067,1510023,320921,318556,31050,349606,3108
2022-07-08,San Benito,069,59416,14758,14628,762,15390,100
2022-07-08,San Bernardino,071,2135413,620356,610086,27294,637380,7893
2022-07-08,San Diego,073,3302833,851954,844085,63566,907651,5357
2022-07-08,San Francisco,075,870044,163725,161931,10844,172775,914
2022-07-08,San Joaquin,077,732212,183416,181958,12260,194218,2257
2022-07-08,San Luis Obispo,079,281455,59236,58636,5897,64533,498
2022-07-08,San Mateo,081,765935,153954,152319,9739,162058,723
2022-07-08,Santa Barbara,083,443738,97066,96266,5753,102019,697
2022-07-08,Santa Clara,085,1922200,392486,388270,17030,405300,2360
2022-07-08,Santa Cruz,087,273765,57280,56455,2913,59368,266
2022-07-08,Shasta,089,179085,32790,32536,6685,39221,576
2022-07-08,Sierra,091,2930,290,291,58,349,4
2022-07-08,Siskiyou,093,43540,4886,4855,3054,7909,82
2022-07-08,Solano,095,438530,96789,95651,6936,102587,455
2022-07-08,Sonoma,097,501317,99335,98430,4547,102977,496
2022-07-08,Stanislaus,099,539301,127867,126897,19214,146111,1686
2022-07-08,Sutter,101,95872,22292,22165,2343,24508,228
2022-07-08,Tehama,103,63373,12822,12716,2791,15507,205
2022-07-08,Trinity,105,12862,1302,1272,321,1593,20
2022-07-08,Tulare,107,460477,113737,113002,31159,144161,1508
2022-07-08,Tuolumne,109,53932,14205,14019,803,14822,194
2022-07-08,Ventura,111,848112,193147,191462,12529,203991,1518
2022-07-08,Yolo,113,214977,44541,44152,3798,47950,323
2022-07-08,Yuba,115,75493,17449,17345,1477,18822,125
2022-07-07,Alameda,001,1643700,315562,312651,17655,330306,1912
2022-07-07,Alpine,003,1148,129,129,1,130,0
2022-07-07,Amador,005,37829,9389,9335,786,10121,87
2022-07-07,Butte,007,227075,36496,36165,8041,44206,438
2022-07-07,Calaveras,009,45235,7937,7895,424,8319,125
2022-07-07,Colusa,011,21464,3600,3586,1142,4728,22
2022-07-07,Contra Costa,013,1133247,228506,224718,17704,242422,1351
2022-07-07,Del Norte,015,27424,6817,6666,329,6995,54
2022-07-07,El Dorado,017,186661,30281,30070,3859,33929,218
2022-07-07,Fresno,019,978130,251990,250379,26754,277133,2786
2022-07-07,Glenn,021,27897,5262,5231,1753,6984,48
2022-07-07,Humboldt,023,135768,19851,19677,4090,23767,149
2022-07-07,Imperial,025,180216,60113,59558,12304,71862,944
2022-07-07,Inyo,027,18085,4330,4297,716,5013,56
2022-07-07,Kern,029,883053,205437,204128,52540,256668,2359
2022-07-07,Kings,031,150075,55009,54725,3688,58413,449
2022-07-07,Lake,033,64148,11758,11685,1032,12717,140
2022-07-07,Lassen,035,31185,9396,9362,933,10295,64
2022-07-07,Los Angeles,037,10098052,3028710,3002013,151745,3153758,32151
2022-07-07,Madera,039,155013,40289,40081,6929,47010,372
2022-07-07,Marin,041,260295,41555,41271,4731,46002,302
2022-07-07,Mariposa,043,17540,2846,2805,281,3086,30
2022-07-07,Mendocino,045,87422,14729,14610,3886,18496,128
2022-07-07,Merced,047,269075,67072,66616,9891,76507,832
2022-07-07,Modoc,049,8938,815,789,286,1075,9
2022-07-07,Mono,051,14174,3128,3119,196,3315,7
2022-07-07,Monterey,053,433212,87547,87002,17570,104572,745
2022-07-07,Napa,055,140530,30003,29807,1303,31110,145
2022-07-07,Nevada,057,99092,17840,17693,1540,19233,131
2022-07-07,Orange,059,3164182,614344,610975,51711,662686,7132
2022-07-07,Placer,061,380077,70882,70401,8611,79012,632
2022-07-07,Plumas,063,18699,3367,3339,406,3745,13
2022-07-07,Riverside,065,2383286,642873,638193,31213,669406,6506
2022-07-07,Sacramento,067,1510023,320295,318556,31001,349557,3108
2022-07-07,San Benito,069,59416,14728,14628,762,15390,100
2022-07-07,San Bernardino,071,2135413,619038,610086,27230,637316,7893
2022-07-07,San Diego,073,3302833,850040,844085,63342,907427,5357
2022-07-07,San Francisco,075,870044,163342,161931,10790,172721,914
2022-07-07,San Joaquin,077,732212,183083,181958,12236,194194,2257
2022-07-07,San Luis Obispo,079,281455,59157,58636,5865,64501,498
2022-07-07,San Mateo,081,765935,153617,152319,9730,162049,723
2022-07-07,Santa Barbara,083,443738,96872,96266,5738,102004,697
2022-07-07,Santa Clara,085,1922200,391504,388270,16983,405253,2360
2022-07-07,Santa Cruz,087,273765,57124,56455,2899,59354,266
2022-07-07,Shasta,089,179085,32755,32536,6668,39204,576
2022-07-07,Sierra,091,2930,289,291,57,348,4
2022-07-07,Siskiyou,093,43540,4879,4855,3048,7903,82
2022-07-07,Solano,095,438530,96516,95651,6925,102576,455
2022-07-07,Sonoma,097,501317,99198,98430,4528,102958,496
2022-07-07,Stanislaus,099,539301,127667,126897,19179,146076,1686
2022-07-07,Sutter,101,95872,22246,22165,2341,24506,228
2022-07-07,Tehama,103,63373,12805,12716,2782,15498,205
2022-07-07,Trinity,105,12862,1297,1272,320,1592,20
2022-07-07,Tulare,107,460477,113528,113002,31066,144068,1508
2022-07-07,Tuolumne,109,53932,14169,14019,797,14816,194
2022-07-07,Ventura,111,848112,192827,191462,12449,203911,1518
2022-07-07,Yolo,113,214977,44483,44152,3785,47937,323
2022-07-07,Yuba,115,75493,17415,17345,1475,18820,125
2022-07-06,Alameda,001,1643700,314733,310551,17590,328141,1899
2022-07-06,Alpine,003,1148,129,129,1,130,0
2022-07-06,Amador,005,37829,9370,9301,786,10087,87
2022-07-06,Butte,007,227075,36432,36053,8025,44078,436
2022-07-06,Calaveras,009,45235,7928,7873,422,8295,124
2022-07-06,Colusa,011,21464,3597,3579,1141,4720,22
2022-07-06,Contra Costa,013,1133247,227990,223500,17652,241152,1348
2022-07-06,Del Norte,015,27424,6787,6623,327,6950,54
2022-07-06,El Dorado,017,186661,30238,29953,3847,33800,218
2022-07-06,Fresno,019,978130,251436,249480,26678,276158,2786
2022-07-06,Glenn,021,27897,5257,5222,1753,6975,48
2022-07-06,Humboldt,023,135768,19804,19608,4079,23687,149
2022-07-06,Imperial,025,180216,59914,59184,12216,71400,944
2022-07-06,Inyo,027,18085,4324,4282,710,4992,56
2022-07-06,Kern,029,883053,205121,203587,52370,255957,2353
2022-07-06,Kings,031,150075,54892,54560,3683,58243,449
2022-07-06,Lake,033,64148,11739,11659,1032,12691,140
2022-07-06,Lassen,035,31185,9379,9350,933,10283,64
2022-07-06,Los Angeles,037,10098052,3022328,2991161,151036,3142197,32116
2022-07-06,Madera,039,155013,40219,39952,6906,46858,372
2022-07-06,Marin,041,260295,41487,41036,4721,45757,302
2022-07-06,Mariposa,043,17540,2836,2797,281,3078,30
2022-07-06,Mendocino,045,87422,14701,14540,3875,18415,127
2022-07-06,Merced,047,269075,66949,66420,9869,76289,832
2022-07-06,Modoc,049,8938,809,788,284,1072,8
2022-07-06,Mono,051,14174,3127,3109,196,3305,7
2022-07-06,Monterey,053,433212,87387,86639,17504,104143,744
2022-07-06,Napa,055,140530,29942,29690,1301,30991,144
2022-07-06,Nevada,057,99092,17811,17660,1535,19195,131
2022-07-06,Orange,059,3164182,612826,608084,51510,659594,7125
2022-07-06,Placer,061,380077,70768,70113,8590,78703,632
2022-07-06,Plumas,063,18699,3356,3316,405,3721,13
2022-07-06,Riverside,065,2383286,641513,636209,31141,667350,6505
2022-07-06,Sacramento,067,1510023,319612,317315,30957,348272,3104
2022-07-06,San Benito,069,59416,14686,14556,751,15307,100
2022-07-06,San Bernardino,071,2135413,617789,608119,27154,635273,7870
2022-07-06,San Diego,073,3302833,847910,839970,63086,903056,5349
2022-07-06,San Francisco,075,870044,162921,160612,10758,171370,910
2022-07-06,San Joaquin,077,732212,182769,181448,12208,193656,2256
2022-07-06,San Luis Obispo,079,281455,59046,58488,5826,64314,496
2022-07-06,San Mateo,081,765935,153222,151344,9699,161043,723
2022-07-06,Santa Barbara,083,443738,96682,95918,5718,101636,702
2022-07-06,Santa Clara,085,1922200,390410,385553,16917,402470,2358
2022-07-06,Santa Cruz,087,273765,56982,56307,2881,59188,267
2022-07-06,Shasta,089,179085,32702,32444,6645,39089,570
2022-07-06,Sierra,091,2930,289,290,57,347,4
2022-07-06,Siskiyou,093,43540,4872,4841,3042,7883,82
2022-07-06,Solano,095,438530,96265,95181,6901,102082,455
2022-07-06,Sonoma,097,501317,99015,98031,4511,102542,495
2022-07-06,Stanislaus,099,539301,127444,126492,19151,145643,1682
2022-07-06,Sutter,101,95872,22195,22089,2340,24429,228
2022-07-06,Tehama,103,63373,12794,12680,2776,15456,205
2022-07-06,Trinity,105,12862,1289,1263,316,1579,20
2022-07-06,Tulare,107,460477,113310,112684,30973,143657,1500
2022-07-06,Tuolumne,109,53932,14137,13960,784,14744,189
2022-07-06,Ventura,111,848112,192447,190794,12381,203175,1517
2022-07-06,Yolo,113,214977,44400,43171,3766,46937,324
2022-07-06,Yuba,115,75493,17377,17277,1469,18746,124
2022-07-05,Alameda,001,1643700,313752,310551,17525,328076,1899
2022-07-05,Alpine,003,1148,129,129,1,130,0
2022-07-05,Amador,005,37829,9355,9301,782,10083,87
2022-07-05,Butte,007,227075,36349,36053,8003,44056,436
2022-07-05,Calaveras,009,45235,7917,7873,421,8294,124
2022-07-05,Colusa,011,21464,3592,3579,1139,4718,22
2022-07-05,Contra Costa,013,1133247,227357,223500,17578,241078,1348
2022-07-05,Del Norte,015,27424,6761,6623,322,6945,54
2022-07-05,El Dorado,017,186661,30188,29953,3838,33791,218
2022-07-05,Fresno,019,978130,250840,249480,26592,276072,2786
2022-07-05,Glenn,021,27897,5248,5222,1752,6974,48
2022-07-05,Humboldt,023,135768,19765,19608,4069,23677,149
2022-07-05,Imperial,025,180216,59773,59184,12117,71301,944
2022-07-05,Inyo,027,18085,4310,4282,700,4982,56
2022-07-05,Kern,029,883053,204686,203587,52173,255760,2353
2022-07-05,Kings,031,150075,54764,54560,3670,58230,449
2022-07-05,Lake,033,64148,11716,11659,1029,12688,140
2022-07-05,Lassen,035,31185,9368,9350,933,10283,64
2022-07-05,Los Angeles,037,10098052,3015485,2991161,150270,3141431,32116
2022-07-05,Madera,039,155013,40134,39952,6884,46836,372
2022-07-05,Marin,041,260295,41386,41036,4711,45747,302
2022-07-05,Mariposa,043,17540,2826,2797,278,3075,30
2022-07-05,Mendocino,045,87422,14655,14540,3860,18400,127
2022-07-05,Merced,047,269075,66829,66420,9839,76259,832
2022-07-05,Modoc,049,8938,801,788,284,1072,8
2022-07-05,Mono,051,14174,3124,3109,193,3302,7
2022-07-05,Monterey,053,433212,87224,86639,17452,104091,744
2022-07-05,Napa,055,140530,29890,29690,1296,30986,144
2022-07-05,Nevada,057,99092,17772,17660,1525,19185,131
2022-07-05,Orange,059,3164182,611279,608084,51271,659355,7125
2022-07-05,Placer,061,380077,70663,70113,8569,78682,632
2022-07-05,Plumas,063,18699,3346,3316,404,3720,13
2022-07-05,Riverside,065,2383286,640046,636209,31056,667265,6505
2022-07-05,Sacramento,067,1510023,318962,317315,30888,348203,3104
2022-07-05,San Benito,069,59416,14652,14556,744,15300,100
2022-07-05,San Bernardino,071,2135413,616464,608119,27076,635195,7870
2022-07-05,San Diego,073,3302833,845553,839970,62849,902819,5349
2022-07-05,San Francisco,075,870044,162404,160612,10732,171344,910
2022-07-05,San Joaquin,077,732212,182409,181448,12138,193586,2256
2022-07-05,San Luis Obispo,079,281455,58888,58488,5783,64271,496
2022-07-05,San Mateo,081,765935,152745,151344,9676,161020,723
2022-07-05,Santa Barbara,083,443738,96459,95918,5689,101607,702
2022-07-05,Santa Clara,085,1922200,389246,385553,16863,402416,2358
2022-07-05,Santa Cruz,087,273765,56806,56307,2865,59172,267
2022-07-05,Shasta,089,179085,32659,32444,6621,39065,570
2022-07-05,Sierra,091,2930,289,290,57,347,4
2022-07-05,Siskiyou,093,43540,4865,4841,3030,7871,82
2022-07-05,Solano,095,438530,95990,95181,6878,102059,455
2022-07-05,Sonoma,097,501317,98769,98031,4493,102524,495
2022-07-05,Stanislaus,099,539301,127204,126492,19112,145604,1682
2022-07-05,Sutter,101,95872,22153,22089,2338,24427,228
2022-07-05,Tehama,103,63373,12769,12680,2772,15452,205
2022-07-05,Trinity,105,12862,1280,1263,314,1577,20
2022-07-05,Tulare,107,460477,113073,112684,30891,143575,1500
2022-07-05,Tuolumne,109,53932,14103,13960,777,14737,189
2022-07-05,Ventura,111,848112,192050,190794,12318,203112,1517
2022-07-05,Yolo,113,214977,44314,43171,3756,46927,324
2022-07-05,Yuba,115,75493,17348,17277,1468,18745,124
2022-07-04,Alameda,001,1643700,312602,310551,17440,327991,1899
2022-07-04,Alpine,003,1148,129,129,1,130,0
2022-07-04,Amador,005,37829,9342,9301,781,10082,87
2022-07-04,Butte,007,227075,36239,36053,7985,44038,436
2022-07-04,Calaveras,009,45235,7907,7873,421,8294,124
2022-07-04,Colusa,011,21464,3588,3579,1137,4716,22
2022-07-04,Contra Costa,013,1133247,226644,223500,17478,240978,1348
2022-07-04,Del Norte,015,27424,6728,6623,318,6941,54
2022-07-04,El Dorado,017,186661,30103,29953,3820,33773,218
2022-07-04,Fresno,019,978130,250203,249480,26465,275945,2786
2022-07-04,Glenn,021,27897,5240,5222,1746,6968,48
2022-07-04,Humboldt,023,135768,19694,19608,4055,23663,149
2022-07-04,Imperial,025,180216,59565,59184,11996,71180,944
2022-07-04,Inyo,027,18085,4307,4282,690,4972,56
2022-07-04,Kern,029,883053,204241,203587,51917,255504,2353
2022-07-04,Kings,031,150075,54614,54560,3666,58226,449
2022-07-04,Lake,033,64148,11703,11659,1027,12686,140
2022-07-04,Lassen,035,31185,9360,9350,932,10282,64
2022-07-04,Los Angeles,037,10098052,3007082,2991161,149360,3140521,32116
2022-07-04,Madera,039,155013,40040,39952,6858,46810,372
2022-07-04,Marin,041,260295,41269,41036,4700,45736,302
2022-07-04,Mariposa,043,17540,2816,2797,273,3070,30
2022-07-04,Mendocino,045,87422,14619,14540,3814,18354,127
2022-07-04,Merced,047,269075,66700,66420,9791,76211,832
2022-07-04,Modoc,049,8938,793,788,280,1068,8
2022-07-04,Mono,051,14174,3122,3109,191,3300,7
2022-07-04,Monterey,053,433212,87031,86639,17381,104020,744
2022-07-04,Napa,055,140530,29826,29690,1292,30982,144
2022-07-04,Nevada,057,99092,17729,17660,1517,19177,131
2022-07-04,Orange,059,3164182,609487,608084,50979,659063,7125
2022-07-04,Placer,061,380077,70485,70113,8539,78652,632
2022-07-04,Plumas,063,18699,3328,3316,403,3719,13
2022-07-04,Riverside,065,2383286,638402,636209,30961,667170,6505
2022-07-04,Sacramento,067,1510023,318189,317315,30795,348110,3104
2022-07-04,San Benito,069,59416,14596,14556,739,15295,100
2022-07-04,San Bernardino,071,2135413,614861,608119,27000,635119,7870
2022-07-04,San Diego,073,3302833,842911,839970,62521,902491,5349
2022-07-04,San Francisco,075,870044,161794,160612,10671,171283,910
2022-07-04,San Joaquin,077,732212,182011,181448,12074,193522,2256
2022-07-04,San Luis Obispo,079,281455,58699,58488,5712,64200,496
2022-07-04,San Mateo,081,765935,152237,151344,9636,160980,723
2022-07-04,Santa Barbara,083,443738,96236,95918,5666,101584,702
2022-07-04,Santa Clara,085,1922200,387753,385553,16810,402363,2358
2022-07-04,Santa Cruz,087,273765,56608,56307,2843,59150,267
2022-07-04,Shasta,089,179085,32582,32444,6592,39036,570
2022-07-04,Sierra,091,2930,289,290,57,347,4
2022-07-04,Siskiyou,093,43540,4858,4841,3022,7863,82
2022-07-04,Solano,095,438530,95662,95181,6844,102025,455
2022-07-04,Sonoma,097,501317,98474,98031,4466,102497,495
2022-07-04,Stanislaus,099,539301,126914,126492,19062,145554,1682
2022-07-04,Sutter,101,95872,22107,22089,2337,24426,228
2022-07-04,Tehama,103,63373,12743,12680,2758,15438,205
2022-07-04,Trinity,105,12862,1275,1263,312,1575,20
2022-07-04,Tulare,107,460477,112835,112684,30779,143463,1500
2022-07-04,Tuolumne,109,53932,14061,13960,773,14733,189
2022-07-04,Ventura,111,848112,191584,190794,12213,203007,1517
2022-07-04,Yolo,113,214977,44222,43171,3738,46909,324
2022-07-04,Yuba,115,75493,17309,17277,1468,18745,124
2022-07-03,Alameda,001,1643700,312048,307672,17410,325082,1898
2022-07-03,Alpine,003,1148,129,129,1,130,0
2022-07-03,Amador,005,37829,9334,9243,778,10021,87
2022-07-03,Butte,007,227075,36225,35846,7978,43824,436
2022-07-03,Calaveras,009,45235,7891,7836,421,8257,124
2022-07-03,Colusa,011,21464,3586,3566,1135,4701,22
2022-07-03,Contra Costa,013,1133247,226288,221545,17446,238991,1343
2022-07-03,Del Norte,015,27424,6719,6543,317,6860,53
2022-07-03,El Dorado,017,186661,30071,29764,3814,33578,217
2022-07-03,Fresno,019,978130,249951,247952,26429,274381,2783
2022-07-03,Glenn,021,27897,5239,5211,1743,6954,48
2022-07-03,Humboldt,023,135768,19672,19516,4046,23562,149
2022-07-03,Imperial,025,180216,59490,58768,11957,70725,944
2022-07-03,Inyo,027,18085,4303,4261,688,4949,56
2022-07-03,Kern,029,883053,204100,202502,51777,254279,2352
2022-07-03,Kings,031,150075,54589,54262,3664,57926,449
2022-07-03,Lake,033,64148,11692,11595,1027,12622,140
2022-07-03,Lassen,035,31185,9357,9336,931,10267,64
2022-07-03,Los Angeles,037,10098052,3004340,2969395,148997,3118392,32089
2022-07-03,Madera,039,155013,40013,39738,6853,46591,372
2022-07-03,Marin,041,260295,41199,40653,4691,45344,297
2022-07-03,Mariposa,043,17540,2812,2780,272,3052,30
2022-07-03,Mendocino,045,87422,14607,14464,3813,18277,127
2022-07-03,Merced,047,269075,66651,66093,9786,75879,832
2022-07-03,Modoc,049,8938,793,787,280,1067,8
2022-07-03,Mono,051,14174,3121,3099,190,3289,7
2022-07-03,Monterey,053,433212,86919,86212,17327,103539,744
2022-07-03,Napa,055,140530,29806,29486,1289,30775,145
2022-07-03,Nevada,057,99092,17710,17546,1510,19056,131
2022-07-03,Orange,059,3164182,608947,603511,50842,654353,7114
2022-07-03,Placer,061,380077,70398,69606,8525,78131,631
2022-07-03,Plumas,063,18699,3321,3294,403,3697,13
2022-07-03,Riverside,065,2383286,637831,632038,30918,662956,6502
2022-07-03,Sacramento,067,1510023,317916,315165,30774,345939,3100
2022-07-03,San Benito,069,59416,14589,14420,738,15158,100
2022-07-03,San Bernardino,071,2135413,614261,604093,26967,631060,7860
2022-07-03,San Diego,073,3302833,842182,834116,62453,896569,5341
2022-07-03,San Francisco,075,870044,161457,158871,10659,169530,910
2022-07-03,San Joaquin,077,732212,181841,180368,12036,192404,2256
2022-07-03,San Luis Obispo,079,281455,58630,58079,5702,63781,489
2022-07-03,San Mateo,081,765935,151934,149812,9619,159431,723
2022-07-03,Santa Barbara,083,443738,96128,95214,5654,100868,699
2022-07-03,Santa Clara,085,1922200,387028,381630,16780,398410,2355
2022-07-03,Santa Cruz,087,273765,56547,55757,2822,58579,267
2022-07-03,Shasta,089,179085,32547,32280,6582,38862,570
2022-07-03,Sierra,091,2930,288,283,57,340,4
2022-07-03,Siskiyou,093,43540,4854,4808,3020,7828,82
2022-07-03,Solano,095,438530,95587,94437,6839,101276,455
2022-07-03,Sonoma,097,501317,98364,97379,4461,101840,495
2022-07-03,Stanislaus,099,539301,126797,125788,19047,144835,1681
2022-07-03,Sutter,101,95872,22086,21935,2336,24271,228
2022-07-03,Tehama,103,63373,12725,12615,2756,15371,205
2022-07-03,Trinity,105,12862,1274,1256,309,1565,20
2022-07-03,Tulare,107,460477,112737,112118,30741,142859,1500
2022-07-03,Tuolumne,109,53932,14038,13886,770,14656,189
2022-07-03,Ventura,111,848112,191373,189493,12194,201687,1517
2022-07-03,Yolo,113,214977,44179,42760,3728,46488,324
2022-07-03,Yuba,115,75493,17295,17168,1467,18635,124
2022-07-02,Alameda,001,1643700,311671,307672,17382,325054,1898
2022-07-02,Alpine,003,1148,129,129,1,130,0
2022-07-02,Amador,005,37829,9318,9243,777,10020,87
2022-07-02,Butte,007,227075,36200,35846,7965,43811,436
2022-07-02,Calaveras,009,45235,7885,7836,421,8257,124
2022-07-02,Colusa,011,21464,3582,3566,1133,4699,22
2022-07-02,Contra Costa,013,1133247,225941,221545,17394,238939,1343
2022-07-02,Del Norte,015,27424,6709,6543,317,6860,53
2022-07-02,El Dorado,017,186661,30037,29764,3809,33573,217
2022-07-02,Fresno,019,978130,249728,247952,26395,274347,2783
2022-07-02,Glenn,021,27897,5234,5211,1742,6953,48
2022-07-02,Humboldt,023,135768,19646,19516,4042,23558,149
2022-07-02,Imperial,025,180216,59412,58768,11936,70704,944
2022-07-02,Inyo,027,18085,4299,4261,686,4947,56
2022-07-02,Kern,029,883053,203949,202502,51633,254135,2352
2022-07-02,Kings,031,150075,54544,54262,3664,57926,449
2022-07-02,Lake,033,64148,11683,11595,1025,12620,140
2022-07-02,Lassen,035,31185,9356,9336,930,10266,64
2022-07-02,Los Angeles,037,10098052,3001662,2969395,148573,3117968,32089
2022-07-02,Madera,039,155013,39983,39738,6849,46587,372
2022-07-02,Marin,041,260295,41137,40653,4674,45327,297
2022-07-02,Mariposa,043,17540,2808,2780,271,3051,30
2022-07-02,Mendocino,045,87422,14579,14464,3813,18277,127
2022-07-02,Merced,047,269075,66592,66093,9777,75870,832
2022-07-02,Modoc,049,8938,793,787,279,1066,8
2022-07-02,Mono,051,14174,3118,3099,190,3289,7
2022-07-02,Monterey,053,433212,86829,86212,17289,103501,744
2022-07-02,Napa,055,140530,29777,29486,1288,30774,145
2022-07-02,Nevada,057,99092,17695,17546,1504,19050,131
2022-07-02,Orange,059,3164182,608298,603511,50686,654197,7114
2022-07-02,Placer,061,380077,70306,69606,8511,78117,631
2022-07-02,Plumas,063,18699,3312,3294,403,3697,13
2022-07-02,Riverside,065,2383286,637236,632038,30873,662911,6502
2022-07-02,Sacramento,067,1510023,317582,315165,30753,345918,3100
2022-07-02,San Benito,069,59416,14569,14420,729,15149,100
2022-07-02,San Bernardino,071,2135413,613723,604093,26932,631025,7860
2022-07-02,San Diego,073,3302833,841376,834116,62396,896512,5341
2022-07-02,San Francisco,075,870044,161170,158871,10635,169506,910
2022-07-02,San Joaquin,077,732212,181710,180368,12012,192380,2256
2022-07-02,San Luis Obispo,079,281455,58580,58079,5688,63767,489
2022-07-02,San Mateo,081,765935,151679,149812,9599,159411,723
2022-07-02,Santa Barbara,083,443738,96001,95214,5643,100857,699
2022-07-02,Santa Clara,085,1922200,386292,381630,16750,398380,2355
2022-07-02,Santa Cruz,087,273765,56488,55757,2812,58569,267
2022-07-02,Shasta,089,179085,32518,32280,6571,38851,570
2022-07-02,Sierra,091,2930,288,283,57,340,4
2022-07-02,Siskiyou,093,43540,4847,4808,3019,7827,82
2022-07-02,Solano,095,438530,95516,94437,6825,101262,455
2022-07-02,Sonoma,097,501317,98259,97379,4453,101832,495
2022-07-02,Stanislaus,099,539301,126678,125788,19032,144820,1681
2022-07-02,Sutter,101,95872,22067,21935,2336,24271,228
2022-07-02,Tehama,103,63373,12702,12615,2755,15370,205
2022-07-02,Trinity,105,12862,1272,1256,308,1564,20
2022-07-02,Tulare,107,460477,112635,112118,30699,142817,1500
2022-07-02,Tuolumne,109,53932,14025,13886,761,14647,189
2022-07-02,Ventura,111,848112,191200,189493,12169,201662,1517
2022-07-02,Yolo,113,214977,44134,42760,3721,46481,324
2022-07-02,Yuba,115,75493,17283,17168,1467,18635,124
2022-07-01,Alameda,001,1643700,311192,307672,17353,325025,1898
2022-07-01,Alpine,003,1148,129,129,1,130,0
2022-07-01,Amador,005,37829,9313,9243,775,10018,87
2022-07-01,Butte,007,227075,36173,35846,7947,43793,436
2022-07-01,Calaveras,009,45235,7874,7836,421,8257,124
2022-07-01,Colusa,011,21464,3579,3566,1133,4699,22
2022-07-01,Contra Costa,013,1133247,225640,221545,17351,238896,1343
2022-07-01,Del Norte,015,27424,6689,6543,315,6858,53
2022-07-01,El Dorado,017,186661,30012,29764,3801,33565,217
2022-07-01,Fresno,019,978130,249445,247952,26340,274292,2783
2022-07-01,Glenn,021,27897,5234,5211,1742,6953,48
2022-07-01,Humboldt,023,135768,19624,19516,4033,23549,149
2022-07-01,Imperial,025,180216,59336,58768,11909,70677,944
2022-07-01,Inyo,027,18085,4292,4261,680,4941,56
2022-07-01,Kern,029,883053,203745,202502,51513,254015,2352
2022-07-01,Kings,031,150075,54511,54262,3660,57922,449
2022-07-01,Lake,033,64148,11672,11595,1024,12619,140
2022-07-01,Lassen,035,31185,9353,9336,930,10266,64
2022-07-01,Los Angeles,037,10098052,2998213,2969395,148062,3117457,32089
2022-07-01,Madera,039,155013,39940,39738,6835,46573,372
2022-07-01,Marin,041,260295,41064,40653,4661,45314,297
2022-07-01,Mariposa,043,17540,2806,2780,270,3050,30
2022-07-01,Mendocino,045,87422,14559,14464,3809,18273,127
2022-07-01,Merced,047,269075,66508,66093,9773,75866,832
2022-07-01,Modoc,049,8938,793,787,278,1065,8
2022-07-01,Mono,051,14174,3110,3099,189,3288,7
2022-07-01,Monterey,053,433212,86746,86212,17258,103470,744
2022-07-01,Napa,055,140530,29733,29486,1288,30774,145
2022-07-01,Nevada,057,99092,17675,17546,1499,19045,131
2022-07-01,Orange,059,3164182,607589,603511,50529,654040,7114
2022-07-01,Placer,061,380077,70239,69606,8499,78105,631
2022-07-01,Plumas,063,18699,3310,3294,403,3697,13
2022-07-01,Riverside,065,2383286,636521,632038,30820,662858,6502
2022-07-01,Sacramento,067,1510023,317199,315165,30736,345901,3100
2022-07-01,San Benito,069,59416,14551,14420,728,15148,100
2022-07-01,San Bernardino,071,2135413,613075,604093,26898,630991,7860
2022-07-01,San Diego,073,3302833,840339,834116,62256,896372,5341
2022-07-01,San Francisco,075,870044,160890,158871,10595,169466,910
2022-07-01,San Joaquin,077,732212,181568,180368,11983,192351,2256
2022-07-01,San Luis Obispo,079,281455,58550,58079,5679,63758,489
2022-07-01,San Mateo,081,765935,151403,149812,9579,159391,723
2022-07-01,Santa Barbara,083,443738,95885,95214,5634,100848,699
2022-07-01,Santa Clara,085,1922200,385593,381630,16714,398344,2355
2022-07-01,Santa Cruz,087,273765,56422,55757,2799,58556,267
2022-07-01,Shasta,089,179085,32498,32280,6561,38841,570
2022-07-01,Sierra,091,2930,288,283,57,340,4
2022-07-01,Siskiyou,093,43540,4843,4808,3017,7825,82
2022-07-01,Solano,095,438530,95350,94437,6811,101248,455
2022-07-01,Sonoma,097,501317,98137,97379,4434,101813,495
2022-07-01,Stanislaus,099,539301,126549,125788,19006,144794,1681
2022-07-01,Sutter,101,95872,22038,21935,2336,24271,228
2022-07-01,Tehama,103,63373,12693,12615,2753,15368,205
2022-07-01,Trinity,105,12862,1271,1256,308,1564,20
2022-07-01,Tulare,107,460477,112539,112118,30657,142775,1500
2022-07-01,Tuolumne,109,53932,14006,13886,754,14640,189
2022-07-01,Ventura,111,848112,190989,189493,12133,201626,1517
2022-07-01,Yolo,113,214977,44099,42760,3706,46466,324
2022-07-01,Yuba,115,75493,17262,17168,1467,18635,124
2022-06-30,Alameda,001,1643700,310377,307672,17298,324970,1898
2022-06-30,Alpine,003,1148,129,129,1,130,0
2022-06-30,Amador,005,37829,9303,9243,772,10015,87
2022-06-30,Butte,007,227075,36123,35846,7930,43776,436
2022-06-30,Calaveras,009,45235,7863,7836,420,8256,124
2022-06-30,Colusa,011,21464,3575,3566,1131,4697,22
2022-06-30,Contra Costa,013,1133247,225090,221545,17280,238825,1343
2022-06-30,Del Norte,015,27424,6672,6543,312,6855,53
2022-06-30,El Dorado,017,186661,29967,29764,3793,33557,217
2022-06-30,Fresno,019,978130,249048,247952,26295,274247,2783
2022-06-30,Glenn,021,27897,5231,5211,1742,6953,48
2022-06-30,Humboldt,023,135768,19587,19516,4027,23543,149
2022-06-30,Imperial,025,180216,59222,58768,11877,70645,944
2022-06-30,Inyo,027,18085,4286,4261,680,4941,56
2022-06-30,Kern,029,883053,203431,202502,51349,253851,2352
2022-06-30,Kings,031,150075,54435,54262,3657,57919,449
2022-06-30,Lake,033,64148,11653,11595,1021,12616,140
2022-06-30,Lassen,035,31185,9350,9336,929,10265,64
2022-06-30,Los Angeles,037,10098052,2992871,2969395,147470,3116865,32089
2022-06-30,Madera,039,155013,39874,39738,6808,46546,372
2022-06-30,Marin,041,260295,40980,40653,4654,45307,297
2022-06-30,Mariposa,043,17540,2799,2780,268,3048,30
2022-06-30,Mendocino,045,87422,14543,14464,3803,18267,127
2022-06-30,Merced,047,269075,66408,66093,9756,75849,832
2022-06-30,Modoc,049,8938,792,787,277,1064,8
2022-06-30,Mono,051,14174,3108,3099,188,3287,7
2022-06-30,Monterey,053,433212,86597,86212,17195,103407,744
2022-06-30,Napa,055,140530,29674,29486,1282,30768,145
2022-06-30,Nevada,057,99092,17647,17546,1492,19038,131
2022-06-30,Orange,059,3164182,606422,603511,50345,653856,7114
2022-06-30,Placer,061,380077,70091,69606,8482,78088,631
2022-06-30,Plumas,063,18699,3305,3294,402,3696,13
2022-06-30,Riverside,065,2383286,635420,632038,30750,662788,6502
2022-06-30,Sacramento,067,1510023,316617,315165,30695,345860,3100
2022-06-30,San Benito,069,59416,14514,14420,725,15145,100
2022-06-30,San Bernardino,071,2135413,612026,604093,26856,630949,7860
2022-06-30,San Diego,073,3302833,838815,834116,62055,896171,5341
2022-06-30,San Francisco,075,870044,160460,158871,10564,169435,910
2022-06-30,San Joaquin,077,732212,181287,180368,11951,192319,2256
2022-06-30,San Luis Obispo,079,281455,58449,58079,5652,63731,489
2022-06-30,San Mateo,081,765935,150997,149812,9546,159358,723
2022-06-30,Santa Barbara,083,443738,95687,95214,5622,100836,699
2022-06-30,Santa Clara,085,1922200,384495,381630,16670,398300,2355
2022-06-30,Santa Cruz,087,273765,56303,55757,2785,58542,267
2022-06-30,Shasta,089,179085,32459,32280,6542,38822,570
2022-06-30,Sierra,091,2930,288,283,57,340,4
2022-06-30,Siskiyou,093,43540,4835,4808,3010,7818,82
2022-06-30,Solano,095,438530,95150,94437,6782,101219,455
2022-06-30,Sonoma,097,501317,97974,97379,4413,101792,495
2022-06-30,Stanislaus,099,539301,126354,125788,18982,144770,1681
2022-06-30,Sutter,101,95872,22005,21935,2334,24269,228
2022-06-30,Tehama,103,63373,12672,12615,2750,15365,205
2022-06-30,Trinity,105,12862,1265,1256,306,1562,20
2022-06-30,Tulare,107,460477,112390,112118,30581,142699,1500
2022-06-30,Tuolumne,109,53932,13987,13886,748,14634,189
2022-06-30,Ventura,111,848112,190645,189493,12058,201551,1517
2022-06-30,Yolo,113,214977,44028,42760,3688,46448,324
2022-06-30,Yuba,115,75493,17234,17168,1461,18629,124
2022-06-29,Alameda,001,1643700,309576,305288,17257,322545,1895
2022-06-29,Alpine,003,1148,129,129,1,130,0
2022-06-29,Amador,005,37829,9296,9205,772,9977,87
2022-06-29,Butte,007,227075,36076,35651,7914,43565,434
2022-06-29,Calaveras,009,45235,7851,7798,417,8215,124
2022-06-29,Colusa,011,21464,3572,3548,1129,4677,22
2022-06-29,Contra Costa,013,1133247,224608,219921,17226,237147,1339
2022-06-29,Del Norte,015,27424,6646,6484,308,6792,53
2022-06-29,El Dorado,017,186661,29909,29549,3777,33326,216
2022-06-29,Fresno,019,978130,248657,246740,26236,272976,2777
2022-06-29,Glenn,021,27897,5230,5192,1740,6932,48
2022-06-29,Humboldt,023,135768,19561,19411,4017,23428,149
2022-06-29,Imperial,025,180216,59103,58498,11830,70328,944
2022-06-29,Inyo,027,18085,4282,4243,675,4918,56
2022-06-29,Kern,029,883053,203146,201537,51189,252726,2343
2022-06-29,Kings,031,150075,54345,54031,3655,57686,448
2022-06-29,Lake,033,64148,11625,11548,1017,12565,140
2022-06-29,Lassen,035,31185,9345,9310,929,10239,64
2022-06-29,Los Angeles,037,10098052,2987261,2955489,146877,3102366,32062
2022-06-29,Madera,039,155013,39823,39554,6799,46353,372
2022-06-29,Marin,041,260295,40876,40397,4648,45045,297
2022-06-29,Mariposa,043,17540,2797,2753,268,3021,30
2022-06-29,Mendocino,045,87422,14514,14383,3787,18170,127
2022-06-29,Merced,047,269075,66314,65733,9745,75478,830
2022-06-29,Modoc,049,8938,790,780,276,1056,8
2022-06-29,Mono,051,14174,3108,3081,186,3267,7
2022-06-29,Monterey,053,433212,86466,85711,17145,102856,743
2022-06-29,Napa,055,140530,29624,29285,1278,30563,144
2022-06-29,Nevada,057,99092,17613,17439,1488,18927,129
2022-06-29,Orange,059,3164182,605260,599951,50177,650128,7095
2022-06-29,Placer,061,380077,69956,69244,8473,77717,629
2022-06-29,Plumas,063,18699,3302,3267,400,3667,13
2022-06-29,Riverside,065,2383286,634364,629035,30683,659718,6493
2022-06-29,Sacramento,067,1510023,316024,313224,30646,343870,3082
2022-06-29,San Benito,069,59416,14478,14302,717,15019,100
2022-06-29,San Bernardino,071,2135413,611024,600960,26760,627720,7825
2022-06-29,San Diego,073,3302833,837086,828907,61825,890732,5336
2022-06-29,San Francisco,075,870044,159976,157419,10531,167950,902
2022-06-29,San Joaquin,077,732212,180993,179476,11916,191392,2252
2022-06-29,San Luis Obispo,079,281455,58314,57783,5615,63398,486
2022-06-29,San Mateo,081,765935,150620,148533,9525,158058,723
2022-06-29,Santa Barbara,083,443738,95536,94683,5611,100294,699
2022-06-29,Santa Clara,085,1922200,383501,378000,16612,394612,2348
2022-06-29,Santa Cruz,087,273765,56179,55432,2771,58203,266
2022-06-29,Shasta,089,179085,32412,32106,6526,38632,570
2022-06-29,Sierra,091,2930,286,283,57,340,4
2022-06-29,Siskiyou,093,43540,4827,4773,3009,7782,82
2022-06-29,Solano,095,438530,94926,92975,6767,99742,455
2022-06-29,Sonoma,097,501317,97791,96854,4401,101255,493
2022-06-29,Stanislaus,099,539301,126178,125189,18956,144145,1674
2022-06-29,Sutter,101,95872,21952,21836,2329,24165,227
2022-06-29,Tehama,103,63373,12653,12561,2749,15310,205
2022-06-29,Trinity,105,12862,1263,1245,305,1550,20
2022-06-29,Tulare,107,460477,112257,111707,30508,142215,1499
2022-06-29,Tuolumne,109,53932,13963,13779,732,14511,189
2022-06-29,Ventura,111,848112,190338,188519,11997,200516,1514
2022-06-29,Yolo,113,214977,43926,42410,3677,46087,323
2022-06-29,Yuba,115,75493,17205,17082,1459,18541,124
2022-06-28,Alameda,001,1643700,308737,305288,17221,322509,1895
2022-06-28,Alpine,003,1148,129,129,1,130,0
2022-06-28,Amador,005,37829,9291,9205,771,9976,87
2022-06-28,Butte,007,227075,36010,35651,7896,43547,434
2022-06-28,Calaveras,009,45235,7839,7798,417,8215,124
2022-06-28,Colusa,011,21464,3571,3548,1128,4676,22
2022-06-28,Contra Costa,013,1133247,224001,219921,17163,237084,1339
2022-06-28,Del Norte,015,27424,6609,6484,306,6790,53
2022-06-28,El Dorado,017,186661,29861,29549,3766,33315,216
2022-06-28,Fresno,019,978130,248226,246740,26181,272921,2777
2022-06-28,Glenn,021,27897,5222,5192,1735,6927,48
2022-06-28,Humboldt,023,135768,19541,19411,4010,23421,149
2022-06-28,Imperial,025,180216,59007,58498,11753,70251,944
2022-06-28,Inyo,027,18085,4276,4243,669,4912,56
2022-06-28,Kern,029,883053,202853,201537,50984,252521,2343
2022-06-28,Kings,031,150075,54263,54031,3650,57681,448
2022-06-28,Lake,033,64148,11614,11548,1015,12563,140
2022-06-28,Lassen,035,31185,9338,9310,929,10239,64
2022-06-28,Los Angeles,037,10098052,2981347,2955489,146274,3101763,32062
2022-06-28,Madera,039,155013,39764,39554,6782,46336,372
2022-06-28,Marin,041,260295,40768,40397,4641,45038,297
2022-06-28,Mariposa,043,17540,2789,2753,266,3019,30
2022-06-28,Mendocino,045,87422,14486,14383,3775,18158,127
2022-06-28,Merced,047,269075,66212,65733,9727,75460,830
2022-06-28,Modoc,049,8938,788,780,275,1055,8
2022-06-28,Mono,051,14174,3101,3081,184,3265,7
2022-06-28,Monterey,053,433212,86341,85711,17098,102809,743
2022-06-28,Napa,055,140530,29556,29285,1275,30560,144
2022-06-28,Nevada,057,99092,17583,17439,1484,18923,129
2022-06-28,Orange,059,3164182,603917,599951,50002,649953,7095
2022-06-28,Placer,061,380077,69792,69244,8464,77708,629
2022-06-28,Plumas,063,18699,3302,3267,399,3666,13
2022-06-28,Riverside,065,2383286,633167,629035,30636,659671,6493
2022-06-28,Sacramento,067,1510023,315349,313224,30589,343813,3082
2022-06-28,San Benito,069,59416,14438,14302,716,15018,100
2022-06-28,San Bernardino,071,2135413,609899,600960,26714,627674,7825
2022-06-28,San Diego,073,3302833,835223,828907,61586,890493,5336
2022-06-28,San Francisco,075,870044,159454,157419,10506,167925,902
2022-06-28,San Joaquin,077,732212,180684,179476,11881,191357,2252
2022-06-28,San Luis Obispo,079,281455,58195,57783,5578,63361,486
2022-06-28,San Mateo,081,765935,150174,148533,9500,158033,723
2022-06-28,Santa Barbara,083,443738,95366,94683,5594,100277,699
2022-06-28,Santa Clara,085,1922200,382389,378000,16556,394556,2348
2022-06-28,Santa Cruz,087,273765,56047,55432,2763,58195,266
2022-06-28,Shasta,089,179085,32365,32106,6513,38619,570
2022-06-28,Sierra,091,2930,286,283,57,340,4
2022-06-28,Siskiyou,093,43540,4820,4773,3003,7776,82
2022-06-28,Solano,095,438530,94657,92975,6752,99727,455
2022-06-28,Sonoma,097,501317,97581,96854,4385,101239,493
2022-06-28,Stanislaus,099,539301,125976,125189,18939,144128,1674
2022-06-28,Sutter,101,95872,21916,21836,2327,24163,227
2022-06-28,Tehama,103,63373,12633,12561,2745,15306,205
2022-06-28,Trinity,105,12862,1260,1245,303,1548,20
2022-06-28,Tulare,107,460477,112069,111707,30434,142141,1499
2022-06-28,Tuolumne,109,53932,13932,13779,726,14505,189
2022-06-28,Ventura,111,848112,190014,188519,11920,200439,1514
2022-06-28,Yolo,113,214977,43813,42410,3671,46081,323
2022-06-28,Yuba,115,75493,17170,17082,1455,18537,124
2022-06-27,Alameda,001,1643700,307806,305288,17166,322454,1895
2022-06-27,Alpine,003,1148,129,129,1,130,0
2022-06-27,Amador,005,37829,9276,9205,769,9974,87
2022-06-27,Butte,007,227075,35956,35651,7876,43527,434
2022-06-27,Calaveras,009,45235,7825,7798,417,8215,124
2022-06-27,Colusa,011,21464,3567,3548,1126,4674,22
2022-06-27,Contra Costa,013,1133247,223320,219921,17098,237019,1339
2022-06-27,Del Norte,015,27424,6589,6484,300,6784,53
2022-06-27,El Dorado,017,186661,29796,29549,3748,33297,216
2022-06-27,Fresno,019,978130,247760,246740,26116,272856,2777
2022-06-27,Glenn,021,27897,5216,5192,1728,6920,48
2022-06-27,Humboldt,023,135768,19506,19411,3998,23409,149
2022-06-27,Imperial,025,180216,58867,58498,11687,70185,944
2022-06-27,Inyo,027,18085,4266,4243,660,4903,56
2022-06-27,Kern,029,883053,202497,201537,50778,252315,2343
2022-06-27,Kings,031,150075,54176,54031,3647,57678,448
2022-06-27,Lake,033,64148,11595,11548,1010,12558,140
2022-06-27,Lassen,035,31185,9329,9310,929,10239,64
2022-06-27,Los Angeles,037,10098052,2975144,2955489,145713,3101202,32062
2022-06-27,Madera,039,155013,39699,39554,6770,46324,372
2022-06-27,Marin,041,260295,40662,40397,4628,45025,297
2022-06-27,Mariposa,043,17540,2780,2753,264,3017,30
2022-06-27,Mendocino,045,87422,14456,14383,3769,18152,127
2022-06-27,Merced,047,269075,66102,65733,9691,75424,830
2022-06-27,Modoc,049,8938,783,780,274,1054,8
2022-06-27,Mono,051,14174,3100,3081,184,3265,7
2022-06-27,Monterey,053,433212,86191,85711,17037,102748,743
2022-06-27,Napa,055,140530,29486,29285,1272,30557,144
2022-06-27,Nevada,057,99092,17553,17439,1470,18909,129
2022-06-27,Orange,059,3164182,602562,599951,49787,649738,7095
2022-06-27,Placer,061,380077,69679,69244,8440,77684,629
2022-06-27,Plumas,063,18699,3297,3267,398,3665,13
2022-06-27,Riverside,065,2383286,632018,629035,30570,659605,6493
2022-06-27,Sacramento,067,1510023,314622,313224,30540,343764,3082
2022-06-27,San Benito,069,59416,14383,14302,713,15015,100
2022-06-27,San Bernardino,071,2135413,608783,600960,26667,627627,7825
2022-06-27,San Diego,073,3302833,833293,828907,61354,890261,5336
2022-06-27,San Francisco,075,870044,158909,157419,10480,167899,902
2022-06-27,San Joaquin,077,732212,180343,179476,11840,191316,2252
2022-06-27,San Luis Obispo,079,281455,58081,57783,5542,63325,486
2022-06-27,San Mateo,081,765935,149706,148533,9464,157997,723
2022-06-27,Santa Barbara,083,443738,95179,94683,5580,100263,699
2022-06-27,Santa Clara,085,1922200,380963,378000,16501,394501,2348
2022-06-27,Santa Cruz,087,273765,55877,55432,2755,58187,266
2022-06-27,Shasta,089,179085,32304,32106,6495,38601,570
2022-06-27,Sierra,091,2930,286,283,57,340,4
2022-06-27,Siskiyou,093,43540,4810,4773,2996,7769,82
2022-06-27,Solano,095,438530,94347,92975,6720,99695,455
2022-06-27,Sonoma,097,501317,97389,96854,4366,101220,493
2022-06-27,Stanislaus,099,539301,125748,125189,18921,144110,1674
2022-06-27,Sutter,101,95872,21875,21836,2324,24160,227
2022-06-27,Tehama,103,63373,12611,12561,2743,15304,205
2022-06-27,Trinity,105,12862,1258,1245,301,1546,20
2022-06-27,Tulare,107,460477,111888,111707,30348,142055,1499
2022-06-27,Tuolumne,109,53932,13897,13779,717,14496,189
2022-06-27,Ventura,111,848112,189633,188519,11861,200380,1514
2022-06-27,Yolo,113,214977,43687,42410,3663,46073,323
2022-06-27,Yuba,115,75493,17142,17082,1452,18534,124
2022-06-26,Alameda,001,1643700,306729,302071,17093,319164,1891
2022-06-26,Alpine,003,1148,129,129,1,130,0
2022-06-26,Amador,005,37829,9237,9135,767,9902,87
2022-06-26,Butte,007,227075,35884,35406,7851,43257,433
2022-06-26,Calaveras,009,45235,7810,7754,414,8168,124
2022-06-26,Colusa,011,21464,3558,3540,1122,4662,22
2022-06-26,Contra Costa,013,1133247,222697,218053,17018,235071,1335
2022-06-26,Del Norte,015,27424,6567,6398,296,6694,52
2022-06-26,El Dorado,017,186661,29712,29313,3723,33036,216
2022-06-26,Fresno,019,978130,247223,245118,26054,271172,2777
2022-06-26,Glenn,021,27897,5211,5178,1725,6903,48
2022-06-26,Humboldt,023,135768,19471,19234,3987,23221,149
2022-06-26,Imperial,025,180216,58721,58127,11594,69721,944
2022-06-26,Inyo,027,18085,4255,4228,647,4875,56
2022-06-26,Kern,029,883053,202192,200556,50575,251131,2344
2022-06-26,Kings,031,150075,54067,53783,3644,57427,448
2022-06-26,Lake,033,64148,11576,11471,1008,12479,140
2022-06-26,Lassen,035,31185,9320,9287,929,10216,64
2022-06-26,Los Angeles,037,10098052,2968564,2936815,145081,3081896,32036
2022-06-26,Madera,039,155013,39629,39319,6752,46071,372
2022-06-26,Marin,041,260295,40541,39979,4607,44586,297
2022-06-26,Mariposa,043,17540,2772,2713,264,2977,30
2022-06-26,Mendocino,045,87422,14427,14292,3743,18035,127
2022-06-26,Merced,047,269075,65969,65408,9664,75072,828
2022-06-26,Modoc,049,8938,782,777,272,1049,8
2022-06-26,Mono,051,14174,3090,3076,184,3260,7
2022-06-26,Monterey,053,433212,86018,85275,16976,102251,743
2022-06-26,Napa,055,140530,29406,29054,1269,30323,144
2022-06-26,Nevada,057,99092,17509,17339,1466,18805,129
2022-06-26,Orange,059,3164182,601078,595761,49583,645344,7090
2022-06-26,Placer,061,380077,69544,68785,8418,77203,628
2022-06-26,Plumas,063,18699,3285,3241,398,3639,13
2022-06-26,Riverside,065,2383286,630789,625794,30513,656307,6493
2022-06-26,Sacramento,067,1510023,313802,310837,30472,341309,3077
2022-06-26,San Benito,069,59416,14338,14192,710,14902,99
2022-06-26,San Bernardino,071,2135413,607575,598062,26608,624670,7803
2022-06-26,San Diego,073,3302833,831095,822848,61186,884034,5332
2022-06-26,San Francisco,075,870044,158265,155609,10427,166036,899
2022-06-26,San Joaquin,077,732212,179968,178447,11797,190244,2252
2022-06-26,San Luis Obispo,079,281455,57945,57472,5491,62963,485
2022-06-26,San Mateo,081,765935,149199,146955,9434,156389,723
2022-06-26,Santa Barbara,083,443738,94971,94017,5552,99569,699
2022-06-26,Santa Clara,085,1922200,379584,373961,16424,390385,2338
2022-06-26,Santa Cruz,087,273765,55721,54874,2747,57621,265
2022-06-26,Shasta,089,179085,32222,31921,6477,38398,570
2022-06-26,Sierra,091,2930,285,283,57,340,4
2022-06-26,Siskiyou,093,43540,4792,4744,2989,7733,81
2022-06-26,Solano,095,438530,94077,92248,6683,98931,455
2022-06-26,Sonoma,097,501317,97155,95981,4332,100313,493
2022-06-26,Stanislaus,099,539301,125547,124493,18898,143391,1672
2022-06-26,Sutter,101,95872,21835,21733,2323,24056,227
2022-06-26,Tehama,103,63373,12594,12510,2737,15247,205
2022-06-26,Trinity,105,12862,1253,1233,299,1532,20
2022-06-26,Tulare,107,460477,111706,111188,30266,141454,1496
2022-06-26,Tuolumne,109,53932,13869,13688,710,14398,189
2022-06-26,Ventura,111,848112,189239,187389,11785,199174,1514
2022-06-26,Yolo,113,214977,43572,41932,3649,45581,323
2022-06-26,Yuba,115,75493,17105,16994,1443,18437,124
2022-06-25,Alameda,001,1643700,306263,302071,17079,319150,1891
2022-06-25,Alpine,003,1148,129,129,1,130,0
2022-06-25,Amador,005,37829,9227,9135,766,9901,87
2022-06-25,Butte,007,227075,35845,35406,7829,43235,433
2022-06-25,Calaveras,009,45235,7801,7754,414,8168,124
2022-06-25,Colusa,011,21464,3553,3540,1122,4662,22
2022-06-25,Contra Costa,013,1133247,222336,218053,16975,235028,1335
2022-06-25,Del Norte,015,27424,6553,6398,293,6691,52
2022-06-25,El Dorado,017,186661,29672,29313,3717,33030,216
2022-06-25,Fresno,019,978130,246993,245118,26029,271147,2777
2022-06-25,Glenn,021,27897,5206,5178,1723,6901,48
2022-06-25,Humboldt,023,135768,19450,19234,3976,23210,149
2022-06-25,Imperial,025,180216,58640,58127,11569,69696,944
2022-06-25,Inyo,027,18085,4253,4228,643,4871,56
2022-06-25,Kern,029,883053,202034,200556,50470,251026,2344
2022-06-25,Kings,031,150075,54029,53783,3644,57427,448
2022-06-25,Lake,033,64148,11567,11471,1007,12478,140
2022-06-25,Lassen,035,31185,9315,9287,927,10214,64
2022-06-25,Los Angeles,037,10098052,2965555,2936815,144696,3081511,32036
2022-06-25,Madera,039,155013,39596,39319,6749,46068,372
2022-06-25,Marin,041,260295,40488,39979,4600,44579,297
2022-06-25,Mariposa,043,17540,2770,2713,264,2977,30
2022-06-25,Mendocino,045,87422,14415,14292,3738,18030,127
2022-06-25,Merced,047,269075,65892,65408,9661,75069,828
2022-06-25,Modoc,049,8938,782,777,272,1049,8
2022-06-25,Mono,051,14174,3085,3076,184,3260,7
2022-06-25,Monterey,053,433212,85917,85275,16947,102222,743
2022-06-25,Napa,055,140530,29375,29054,1265,30319,144
2022-06-25,Nevada,057,99092,17485,17339,1462,18801,129
2022-06-25,Orange,059,3164182,600382,595761,49445,645206,7090
2022-06-25,Placer,061,380077,69449,68785,8398,77183,628
2022-06-25,Plumas,063,18699,3281,3241,398,3639,13
2022-06-25,Riverside,065,2383286,630146,625794,30471,656265,6493
2022-06-25,Sacramento,067,1510023,313491,310837,30446,341283,3077
2022-06-25,San Benito,069,59416,14313,14192,709,14901,99
2022-06-25,San Bernardino,071,2135413,606986,598062,26580,624642,7803
2022-06-25,San Diego,073,3302833,830191,822848,61124,883972,5332
2022-06-25,San Francisco,075,870044,157968,155609,10404,166013,899
2022-06-25,San Joaquin,077,732212,179819,178447,11783,190230,2252
2022-06-25,San Luis Obispo,079,281455,57874,57472,5481,62953,485
2022-06-25,San Mateo,081,765935,148925,146955,9411,156366,723
2022-06-25,Santa Barbara,083,443738,94828,94017,5539,99556,699
2022-06-25,Santa Clara,085,1922200,378731,373961,16396,390357,2338
2022-06-25,Santa Cruz,087,273765,55651,54874,2744,57618,265
2022-06-25,Shasta,089,179085,32184,31921,6463,38384,570
2022-06-25,Sierra,091,2930,285,283,57,340,4
2022-06-25,Siskiyou,093,43540,4789,4744,2986,7730,81
2022-06-25,Solano,095,438530,93992,92248,6664,98912,455
2022-06-25,Sonoma,097,501317,97044,95981,4321,100302,493
2022-06-25,Stanislaus,099,539301,125417,124493,18880,143373,1672
2022-06-25,Sutter,101,95872,21813,21733,2322,24055,227
2022-06-25,Tehama,103,63373,12583,12510,2732,15242,205
2022-06-25,Trinity,105,12862,1252,1233,297,1530,20
2022-06-25,Tulare,107,460477,111629,111188,30224,141412,1496
2022-06-25,Tuolumne,109,53932,13851,13688,707,14395,189
2022-06-25,Ventura,111,848112,189030,187389,11757,199146,1514
2022-06-25,Yolo,113,214977,43508,41932,3643,45575,323
2022-06-25,Yuba,115,75493,17084,16994,1442,18436,124
2022-06-24,Alameda,001,1643700,305691,302071,17045,319116,1891
2022-06-24,Alpine,003,1148,129,129,1,130,0
2022-06-24,Amador,005,37829,9220,9135,764,9899,87
2022-06-24,Butte,007,227075,35815,35406,7815,43221,433
2022-06-24,Calaveras,009,45235,7796,7754,413,8167,124
2022-06-24,Colusa,011,21464,3552,3540,1119,4659,22
2022-06-24,Contra Costa,013,1133247,221993,218053,16950,235003,1335
2022-06-24,Del Norte,015,27424,6542,6398,291,6689,52
2022-06-24,El Dorado,017,186661,29629,29313,3713,33026,216
2022-06-24,Fresno,019,978130,246705,245118,25994,271112,2777
2022-06-24,Glenn,021,27897,5204,5178,1723,6901,48
2022-06-24,Humboldt,023,135768,19419,19234,3971,23205,149
2022-06-24,Imperial,025,180216,58568,58127,11539,69666,944
2022-06-24,Inyo,027,18085,4251,4228,639,4867,56
2022-06-24,Kern,029,883053,201861,200556,50375,250931,2344
2022-06-24,Kings,031,150075,53985,53783,3640,57423,448
2022-06-24,Lake,033,64148,11556,11471,1007,12478,140
2022-06-24,Lassen,035,31185,9312,9287,926,10213,64
2022-06-24,Los Angeles,037,10098052,2962277,2936815,144366,3081181,32036
2022-06-24,Madera,039,155013,39550,39319,6743,46062,372
2022-06-24,Marin,041,260295,40412,39979,4588,44567,297
2022-06-24,Mariposa,043,17540,2763,2713,264,2977,30
2022-06-24,Mendocino,045,87422,14406,14292,3735,18027,127
2022-06-24,Merced,047,269075,65855,65408,9652,75060,828
2022-06-24,Modoc,049,8938,782,777,272,1049,8
2022-06-24,Mono,051,14174,3081,3076,183,3259,7
2022-06-24,Monterey,053,433212,85836,85275,16920,102195,743
2022-06-24,Napa,055,140530,29347,29054,1264,30318,144
2022-06-24,Nevada,057,99092,17469,17339,1456,18795,129
2022-06-24,Orange,059,3164182,599693,595761,49301,645062,7090
2022-06-24,Placer,061,380077,69373,68785,8386,77171,628
2022-06-24,Plumas,063,18699,3277,3241,398,3639,13
2022-06-24,Riverside,065,2383286,629499,625794,30427,656221,6493
2022-06-24,Sacramento,067,1510023,313095,310837,30424,341261,3077
2022-06-24,San Benito,069,59416,14300,14192,708,14900,99
2022-06-24,San Bernardino,071,2135413,606399,598062,26555,624617,7803
2022-06-24,San Diego,073,3302833,829150,822848,61048,883896,5332
2022-06-24,San Francisco,075,870044,157653,155609,10376,165985,899
2022-06-24,San Joaquin,077,732212,179639,178447,11758,190205,2252
2022-06-24,San Luis Obispo,079,281455,57829,57472,5476,62948,485
2022-06-24,San Mateo,081,765935,148595,146955,9398,156353,723
2022-06-24,Santa Barbara,083,443738,94697,94017,5536,99553,699
2022-06-24,Santa Clara,085,1922200,377906,373961,16347,390308,2338
2022-06-24,Santa Cruz,087,273765,55550,54874,2733,57607,265
2022-06-24,Shasta,089,179085,32154,31921,6454,38375,570
2022-06-24,Sierra,091,2930,285,283,57,340,4
2022-06-24,Siskiyou,093,43540,4781,4744,2985,7729,81
2022-06-24,Solano,095,438530,93841,92248,6650,98898,455
2022-06-24,Sonoma,097,501317,96905,95981,4304,100285,493
2022-06-24,Stanislaus,099,539301,125292,124493,18858,143351,1672
2022-06-24,Sutter,101,95872,21798,21733,2321,24054,227
2022-06-24,Tehama,103,63373,12568,12510,2726,15236,205
2022-06-24,Trinity,105,12862,1249,1233,297,1530,20
2022-06-24,Tulare,107,460477,111531,111188,30167,141355,1496
2022-06-24,Tuolumne,109,53932,13831,13688,701,14389,189
2022-06-24,Ventura,111,848112,188803,187389,11728,199117,1514
2022-06-24,Yolo,113,214977,43414,41932,3634,45566,323
2022-06-24,Yuba,115,75493,17066,16994,1442,18436,124
2022-06-23,Alameda,001,1643700,304875,302071,16985,319056,1891
2022-06-23,Alpine,003,1148,129,129,1,130,0
2022-06-23,Amador,005,37829,9211,9135,763,9898,87
2022-06-23,Butte,007,227075,35755,35406,7796,43202,433
2022-06-23,Calaveras,009,45235,7785,7754,412,8166,124
2022-06-23,Colusa,011,21464,3545,3540,1117,4657,22
2022-06-23,Contra Costa,013,1133247,221480,218053,16856,234909,1335
2022-06-23,Del Norte,015,27424,6510,6398,289,6687,52
2022-06-23,El Dorado,017,186661,29571,29313,3701,33014,216
2022-06-23,Fresno,019,978130,246301,245118,25934,271052,2777
2022-06-23,Glenn,021,27897,5201,5178,1714,6892,48
2022-06-23,Humboldt,023,135768,19397,19234,3967,23201,149
2022-06-23,Imperial,025,180216,58493,58127,11487,69614,944
2022-06-23,Inyo,027,18085,4248,4228,636,4864,56
2022-06-23,Kern,029,883053,201580,200556,50226,250782,2344
2022-06-23,Kings,031,150075,53926,53783,3637,57420,448
2022-06-23,Lake,033,64148,11535,11471,1007,12478,140
2022-06-23,Lassen,035,31185,9302,9287,925,10212,64
2022-06-23,Los Angeles,037,10098052,2957622,2936815,143828,3080643,32036
2022-06-23,Madera,039,155013,39489,39319,6728,46047,372
2022-06-23,Marin,041,260295,40298,39979,4564,44543,297
2022-06-23,Mariposa,043,17540,2751,2713,264,2977,30
2022-06-23,Mendocino,045,87422,14377,14292,3731,18023,127
2022-06-23,Merced,047,269075,65778,65408,9636,75044,828
2022-06-23,Modoc,049,8938,781,777,272,1049,8
2022-06-23,Mono,051,14174,3079,3076,182,3258,7
2022-06-23,Monterey,053,433212,85690,85275,16867,102142,743
2022-06-23,Napa,055,140530,29290,29054,1263,30317,144
2022-06-23,Nevada,057,99092,17436,17339,1456,18795,129
2022-06-23,Orange,059,3164182,598688,595761,49123,644884,7090
2022-06-23,Placer,061,380077,69235,68785,8366,77151,628
2022-06-23,Plumas,063,18699,3272,3241,396,3637,13
2022-06-23,Riverside,065,2383286,628578,625794,30378,656172,6493
2022-06-23,Sacramento,067,1510023,312490,310837,30380,341217,3077
2022-06-23,San Benito,069,59416,14269,14192,706,14898,99
2022-06-23,San Bernardino,071,2135413,605606,598062,26521,624583,7803
2022-06-23,San Diego,073,3302833,827675,822848,60850,883698,5332
2022-06-23,San Francisco,075,870044,157184,155609,10343,165952,899
2022-06-23,San Joaquin,077,732212,179362,178447,11734,190181,2252
2022-06-23,San Luis Obispo,079,281455,57740,57472,5444,62916,485
2022-06-23,San Mateo,081,765935,148247,146955,9363,156318,723
2022-06-23,Santa Barbara,083,443738,94532,94017,5508,99525,699
2022-06-23,Santa Clara,085,1922200,376924,373961,16300,390261,2338
2022-06-23,Santa Cruz,087,273765,55439,54874,2721,57595,265
2022-06-23,Shasta,089,179085,32112,31921,6442,38363,570
2022-06-23,Sierra,091,2930,284,283,57,340,4
2022-06-23,Siskiyou,093,43540,4775,4744,2978,7722,81
2022-06-23,Solano,095,438530,93594,92248,6611,98859,455
2022-06-23,Sonoma,097,501317,96708,95981,4284,100265,493
2022-06-23,Stanislaus,099,539301,125111,124493,18831,143324,1672
2022-06-23,Sutter,101,95872,21764,21733,2321,24054,227
2022-06-23,Tehama,103,63373,12559,12510,2723,15233,205
2022-06-23,Trinity,105,12862,1247,1233,297,1530,20
2022-06-23,Tulare,107,460477,111407,111188,30099,141287,1496
2022-06-23,Tuolumne,109,53932,13804,13688,689,14377,189
2022-06-23,Ventura,111,848112,188506,187389,11691,199080,1514
2022-06-23,Yolo,113,214977,43310,41932,3622,45554,323
2022-06-23,Yuba,115,75493,17045,16994,1436,18430,124
2022-06-22,Alameda,001,1643700,304054,299567,16926,316493,1888
2022-06-22,Alpine,003,1148,129,129,1,130,0
2022-06-22,Amador,005,37829,9205,9049,762,9811,87
2022-06-22,Butte,007,227075,35689,35203,7778,42981,433
2022-06-22,Calaveras,009,45235,7773,7716,412,8128,122
2022-06-22,Colusa,011,21464,3542,3529,1117,4646,21
2022-06-22,Contra Costa,013,1133247,220959,216355,16801,233156,1328
2022-06-22,Del Norte,015,27424,6492,6367,288,6655,52
2022-06-22,El Dorado,017,186661,29508,29139,3688,32827,215
2022-06-22,Fresno,019,978130,245882,244129,25879,270008,2772
2022-06-22,Glenn,021,27897,5199,5161,1709,6870,48
2022-06-22,Humboldt,023,135768,19345,19111,3947,23058,148
2022-06-22,Imperial,025,180216,58392,57866,11454,69320,944
2022-06-22,Inyo,027,18085,4243,4222,635,4857,56
2022-06-22,Kern,029,883053,201308,199721,50091,249812,2341
2022-06-22,Kings,031,150075,53862,53568,3633,57201,448
2022-06-22,Lake,033,64148,11518,11426,1001,12427,140
2022-06-22,Lassen,035,31185,9294,9259,923,10182,64
2022-06-22,Los Angeles,037,10098052,2952657,2925667,143373,3069040,32015
2022-06-22,Madera,039,155013,39432,39139,6709,45848,372
2022-06-22,Marin,041,260295,40195,39687,4558,44245,297
2022-06-22,Mariposa,043,17540,2745,2695,261,2956,30
2022-06-22,Mendocino,045,87422,14361,14201,3710,17911,127
2022-06-22,Merced,047,269075,65682,65120,9612,74732,827
2022-06-22,Modoc,049,8938,780,773,268,1041,8
2022-06-22,Mono,051,14174,3078,3073,180,3253,7
2022-06-22,Monterey,053,433212,85563,84752,16824,101576,742
2022-06-22,Napa,055,140530,29219,28894,1259,30153,144
2022-06-22,Nevada,057,99092,17416,17280,1446,18726,129
2022-06-22,Orange,059,3164182,597499,592215,48939,641154,7084
2022-06-22,Placer,061,380077,69119,68447,8356,76803,628
2022-06-22,Plumas,063,18699,3262,3220,396,3616,13
2022-06-22,Riverside,065,2383286,627729,623584,30322,653906,6491
2022-06-22,Sacramento,067,1510023,311865,309105,30344,339449,3071
2022-06-22,San Benito,069,59416,14244,14128,703,14831,99
2022-06-22,San Bernardino,071,2135413,604799,595517,26491,622008,7774
2022-06-22,San Diego,073,3302833,826064,815124,60673,875797,5318
2022-06-22,San Francisco,075,870044,156699,154213,10314,164527,897
2022-06-22,San Joaquin,077,732212,179104,177637,11709,189346,2251
2022-06-22,San Luis Obispo,079,281455,57651,57177,5408,62585,485
2022-06-22,San Mateo,081,765935,147841,145781,9340,155121,723
2022-06-22,Santa Barbara,083,443738,94385,93576,5494,99070,700
2022-06-22,Santa Clara,085,1922200,375835,370678,16190,386868,2340
2022-06-22,Santa Cruz,087,273765,55320,54525,2708,57233,265
2022-06-22,Shasta,089,179085,32067,31786,6427,38213,570
2022-06-22,Sierra,091,2930,284,283,57,340,4
2022-06-22,Siskiyou,093,43540,4768,4711,2975,7686,81
2022-06-22,Solano,095,438530,93346,91528,6546,98074,454
2022-06-22,Sonoma,097,501317,96495,95363,4263,99626,493
2022-06-22,Stanislaus,099,539301,124915,124023,18778,142801,1670
2022-06-22,Sutter,101,95872,21732,21649,2320,23969,227
2022-06-22,Tehama,103,63373,12549,12465,2721,15186,205
2022-06-22,Trinity,105,12862,1245,1223,297,1520,20
2022-06-22,Tulare,107,460477,111272,110768,30019,140787,1496
2022-06-22,Tuolumne,109,53932,13785,13596,683,14279,189
2022-06-22,Ventura,111,848112,188201,186601,11640,198241,1514
2022-06-22,Yolo,113,214977,43188,41689,3611,45300,323
2022-06-22,Yuba,115,75493,17025,16912,1432,18344,124
2022-06-21,Alameda,001,1643700,303260,299567,16892,316459,1888
2022-06-21,Alpine,003,1148,129,129,1,130,0
2022-06-21,Amador,005,37829,9198,9049,759,9808,87
2022-06-21,Butte,007,227075,35617,35203,7767,42970,433
2022-06-21,Calaveras,009,45235,7764,7716,411,8127,122
2022-06-21,Colusa,011,21464,3539,3529,1115,4644,21
2022-06-21,Contra Costa,013,1133247,220396,216355,16752,233107,1328
2022-06-21,Del Norte,015,27424,6461,6367,286,6653,52
2022-06-21,El Dorado,017,186661,29434,29139,3681,32820,215
2022-06-21,Fresno,019,978130,245447,244129,25814,269943,2772
2022-06-21,Glenn,021,27897,5192,5161,1707,6868,48
2022-06-21,Humboldt,023,135768,19293,19111,3934,23045,148
2022-06-21,Imperial,025,180216,58298,57866,11418,69284,944
2022-06-21,Inyo,027,18085,4238,4222,629,4851,56
2022-06-21,Kern,029,883053,200987,199721,49911,249632,2341
2022-06-21,Kings,031,150075,53788,53568,3632,57200,448
2022-06-21,Lake,033,64148,11495,11426,998,12424,140
2022-06-21,Lassen,035,31185,9284,9259,920,10179,64
2022-06-21,Los Angeles,037,10098052,2947851,2925667,142869,3068536,32015
2022-06-21,Madera,039,155013,39348,39139,6699,45838,372
2022-06-21,Marin,041,260295,40105,39687,4546,44233,297
2022-06-21,Mariposa,043,17540,2739,2695,260,2955,30
2022-06-21,Mendocino,045,87422,14332,14201,3701,17902,127
2022-06-21,Merced,047,269075,65582,65120,9581,74701,827
2022-06-21,Modoc,049,8938,777,773,267,1040,8
2022-06-21,Mono,051,14174,3076,3073,179,3252,7
2022-06-21,Monterey,053,433212,85407,84752,16782,101534,742
2022-06-21,Napa,055,140530,29166,28894,1258,30152,144
2022-06-21,Nevada,057,99092,17388,17280,1443,18723,129
2022-06-21,Orange,059,3164182,596305,592215,48800,641015,7084
2022-06-21,Placer,061,380077,68992,68447,8345,76792,628
2022-06-21,Plumas,063,18699,3253,3220,395,3615,13
2022-06-21,Riverside,065,2383286,626768,623584,30263,653847,6491
2022-06-21,Sacramento,067,1510023,311169,309105,30298,339403,3071
2022-06-21,San Benito,069,59416,14208,14128,699,14827,99
2022-06-21,San Bernardino,071,2135413,603972,595517,26444,621961,7774
2022-06-21,San Diego,073,3302833,824377,815124,60474,875598,5318
2022-06-21,San Francisco,075,870044,156214,154213,10282,164495,897
2022-06-21,San Joaquin,077,732212,178785,177637,11681,189318,2251
2022-06-21,San Luis Obispo,079,281455,57540,57177,5363,62540,485
2022-06-21,San Mateo,081,765935,147355,145781,9321,155102,723
2022-06-21,Santa Barbara,083,443738,94218,93576,5480,99056,700
2022-06-21,Santa Clara,085,1922200,374676,370678,16142,386820,2340
2022-06-21,Santa Cruz,087,273765,55190,54525,2700,57225,265
2022-06-21,Shasta,089,179085,32020,31786,6409,38195,570
2022-06-21,Sierra,091,2930,284,283,57,340,4
2022-06-21,Siskiyou,093,43540,4760,4711,2967,7678,81
2022-06-21,Solano,095,438530,93086,91528,6529,98057,454
2022-06-21,Sonoma,097,501317,96259,95363,4239,99602,493
2022-06-21,Stanislaus,099,539301,124722,124023,18754,142777,1670
2022-06-21,Sutter,101,95872,21708,21649,2318,23967,227
2022-06-21,Tehama,103,63373,12535,12465,2721,15186,205
2022-06-21,Trinity,105,12862,1239,1223,297,1520,20
2022-06-21,Tulare,107,460477,111131,110768,29959,140727,1496
2022-06-21,Tuolumne,109,53932,13761,13596,677,14273,189
2022-06-21,Ventura,111,848112,187877,186601,11585,198186,1514
2022-06-21,Yolo,113,214977,43056,41689,3600,45289,323
2022-06-21,Yuba,115,75493,16996,16912,1431,18343,124
2022-06-20,Alameda,001,1643700,302361,299567,16834,316401,1888
2022-06-20,Alpine,003,1148,129,129,1,130,0
2022-06-20,Amador,005,37829,9188,9049,756,9805,87
2022-06-20,Butte,007,227075,35548,35203,7751,42954,433
2022-06-20,Calaveras,009,45235,7757,7716,411,8127,122
2022-06-20,Colusa,011,21464,3538,3529,1114,4643,21
2022-06-20,Contra Costa,013,1133247,219794,216355,16685,233040,1328
2022-06-20,Del Norte,015,27424,6449,6367,282,6649,52
2022-06-20,El Dorado,017,186661,29363,29139,3663,32802,215
2022-06-20,Fresno,019,978130,244960,244129,25751,269880,2772
2022-06-20,Glenn,021,27897,5187,5161,1704,6865,48
2022-06-20,Humboldt,023,135768,19245,19111,3917,23028,148
2022-06-20,Imperial,025,180216,58165,57866,11385,69251,944
2022-06-20,Inyo,027,18085,4234,4222,624,4846,56
2022-06-20,Kern,029,883053,200696,199721,49763,249484,2341
2022-06-20,Kings,031,150075,53707,53568,3630,57198,448
2022-06-20,Lake,033,64148,11474,11426,996,12422,140
2022-06-20,Lassen,035,31185,9279,9259,919,10178,64
2022-06-20,Los Angeles,037,10098052,2942447,2925667,142395,3068062,32015
2022-06-20,Madera,039,155013,39286,39139,6681,45820,372
2022-06-20,Marin,041,260295,40003,39687,4523,44210,297
2022-06-20,Mariposa,043,17540,2725,2695,260,2955,30
2022-06-20,Mendocino,045,87422,14303,14201,3696,17897,127
2022-06-20,Merced,047,269075,65488,65120,9555,74675,827
2022-06-20,Modoc,049,8938,776,773,266,1039,8
2022-06-20,Mono,051,14174,3076,3073,176,3249,7
2022-06-20,Monterey,053,433212,85257,84752,16717,101469,742
2022-06-20,Napa,055,140530,29093,28894,1255,30149,144
2022-06-20,Nevada,057,99092,17363,17280,1434,18714,129
2022-06-20,Orange,059,3164182,595042,592215,48647,640862,7084
2022-06-20,Placer,061,380077,68875,68447,8333,76780,628
2022-06-20,Plumas,063,18699,3247,3220,395,3615,13
2022-06-20,Riverside,065,2383286,625829,623584,30195,653779,6491
2022-06-20,Sacramento,067,1510023,310466,309105,30226,339331,3071
2022-06-20,San Benito,069,59416,14162,14128,693,14821,99
2022-06-20,San Bernardino,071,2135413,603067,595517,26406,621923,7774
2022-06-20,San Diego,073,3302833,822385,815124,60228,875352,5318
2022-06-20,San Francisco,075,870044,155598,154213,10243,164456,897
2022-06-20,San Joaquin,077,732212,178458,177637,11637,189274,2251
2022-06-20,San Luis Obispo,079,281455,57436,57177,5315,62492,485
2022-06-20,San Mateo,081,765935,146849,145781,9296,155077,723
2022-06-20,Santa Barbara,083,443738,94034,93576,5455,99031,700
2022-06-20,Santa Clara,085,1922200,373466,370678,16080,386758,2340
2022-06-20,Santa Cruz,087,273765,55016,54525,2693,57218,265
2022-06-20,Shasta,089,179085,31963,31786,6397,38183,570
2022-06-20,Sierra,091,2930,284,283,56,339,4
2022-06-20,Siskiyou,093,43540,4747,4711,2955,7666,81
2022-06-20,Solano,095,438530,92758,91528,6509,98037,454
2022-06-20,Sonoma,097,501317,96020,95363,4213,99576,493
2022-06-20,Stanislaus,099,539301,124537,124023,18727,142750,1670
2022-06-20,Sutter,101,95872,21677,21649,2299,23948,227
2022-06-20,Tehama,103,63373,12520,12465,2718,15183,205
2022-06-20,Trinity,105,12862,1234,1223,297,1520,20
2022-06-20,Tulare,107,460477,110987,110768,29894,140662,1496
2022-06-20,Tuolumne,109,53932,13723,13596,677,14273,189
2022-06-20,Ventura,111,848112,187539,186601,11548,198149,1514
2022-06-20,Yolo,113,214977,42895,41689,3582,45271,323
2022-06-20,Yuba,115,75493,16971,16912,1425,18337,124
2022-06-19,Alameda,001,1643700,301433,296062,16802,312864,1883
2022-06-19,Alpine,003,1148,129,129,1,130,0
2022-06-19,Amador,005,37829,9138,8985,743,9728,87
2022-06-19,Butte,007,227075,35487,34920,7728,42648,432
2022-06-19,Calaveras,009,45235,7739,7664,410,8074,122
2022-06-19,Colusa,011,21464,3533,3519,1110,4629,21
2022-06-19,Contra Costa,013,1133247,219109,213994,16617,230611,1323
2022-06-19,Del Norte,015,27424,6432,6307,279,6586,52
2022-06-19,El Dorado,017,186661,29281,28904,3647,32551,215
2022-06-19,Fresno,019,978130,244513,242214,25683,267897,2768
2022-06-19,Glenn,021,27897,5178,5131,1702,6833,48
2022-06-19,Humboldt,023,135768,19200,18885,3892,22777,148
2022-06-19,Imperial,025,180216,58041,57450,11351,68801,944
2022-06-19,Inyo,027,18085,4233,4209,623,4832,56
2022-06-19,Kern,029,883053,200335,198567,49593,248160,2340
2022-06-19,Kings,031,150075,53612,53242,3627,56869,448
2022-06-19,Lake,033,64148,11460,11318,995,12313,140
2022-06-19,Lassen,035,31185,9266,9225,919,10144,64
2022-06-19,Los Angeles,037,10098052,2937559,2909197,141840,3051037,31999
2022-06-19,Madera,039,155013,39194,38859,6661,45520,372
2022-06-19,Marin,041,260295,39875,39214,4513,43727,294
2022-06-19,Mariposa,043,17540,2718,2662,259,2921,30
2022-06-19,Mendocino,045,87422,14276,14090,3683,17773,127
2022-06-19,Merced,047,269075,65388,64734,9526,74260,827
2022-06-19,Modoc,049,8938,773,771,265,1036,8
2022-06-19,Mono,051,14174,3074,3066,175,3241,6
2022-06-19,Monterey,053,433212,85109,84032,16671,100703,744
2022-06-19,Napa,055,140530,29033,28619,1251,29870,144
2022-06-19,Nevada,057,99092,17333,17134,1426,18560,129
2022-06-19,Orange,059,3164182,593789,587176,48456,635632,7074
2022-06-19,Placer,061,380077,68756,67961,8312,76273,628
2022-06-19,Plumas,063,18699,3239,3201,395,3596,13
2022-06-19,Riverside,065,2383286,624956,619760,30146,649906,6488
2022-06-19,Sacramento,067,1510023,309738,306215,30169,336384,3072
2022-06-19,San Benito,069,59416,14143,13985,691,14676,99
2022-06-19,San Bernardino,071,2135413,602241,591926,26369,618295,7765
2022-06-19,San Diego,073,3302833,820849,815124,60110,875234,5318
2022-06-19,San Francisco,075,870044,155073,151898,10203,162101,897
2022-06-19,San Joaquin,077,732212,178136,176323,11600,187923,2251
2022-06-19,San Luis Obispo,079,281455,57298,56767,5258,62025,485
2022-06-19,San Mateo,081,765935,146398,143879,9263,153142,723
2022-06-19,Santa Barbara,083,443738,93864,92906,5439,98345,699
2022-06-19,Santa Clara,085,1922200,372294,365638,16019,381657,2328
2022-06-19,Santa Cruz,087,273765,54853,53866,2674,56540,264
2022-06-19,Shasta,089,179085,31904,31647,6386,38033,568
2022-06-19,Sierra,091,2930,284,281,56,337,4
2022-06-19,Siskiyou,093,43540,4735,4672,2949,7621,81
2022-06-19,Solano,095,438530,92504,90548,6497,97045,454
2022-06-19,Sonoma,097,501317,95776,94318,4192,98510,493
2022-06-19,Stanislaus,099,539301,124351,123264,18683,141947,1668
2022-06-19,Sutter,101,95872,21642,21501,2291,23792,227
2022-06-19,Tehama,103,63373,12511,12410,2712,15122,205
2022-06-19,Trinity,105,12862,1231,1220,297,1517,20
2022-06-19,Tulare,107,460477,110803,110041,29838,139879,1496
2022-06-19,Tuolumne,109,53932,13696,13487,677,14164,189
2022-06-19,Ventura,111,848112,187186,185219,11505,196724,1513
2022-06-19,Yolo,113,214977,42806,41135,3569,44704,323
2022-06-19,Yuba,115,75493,16940,16786,1422,18208,124
2022-06-18,Alameda,001,1643700,300968,296062,16782,312844,1883
2022-06-18,Alpine,003,1148,129,129,1,130,0
2022-06-18,Amador,005,37829,9131,8985,739,9724,87
2022-06-18,Butte,007,227075,35436,34920,7717,42637,432
2022-06-18,Calaveras,009,45235,7727,7664,410,8074,122
2022-06-18,Colusa,011,21464,3530,3519,1110,4629,21
2022-06-18,Contra Costa,013,1133247,218797,213994,16588,230582,1323
2022-06-18,Del Norte,015,27424,6426,6307,278,6585,52
2022-06-18,El Dorado,017,186661,29252,28904,3644,32548,215
2022-06-18,Fresno,019,978130,244311,242214,25668,267882,2768
2022-06-18,Glenn,021,27897,5175,5131,1701,6832,48
2022-06-18,Humboldt,023,135768,19171,18885,3885,22770,148
2022-06-18,Imperial,025,180216,57970,57450,11338,68788,944
2022-06-18,Inyo,027,18085,4232,4209,622,4831,56
2022-06-18,Kern,029,883053,200212,198567,49507,248074,2340
2022-06-18,Kings,031,150075,53576,53242,3626,56868,448
2022-06-18,Lake,033,64148,11449,11318,993,12311,140
2022-06-18,Lassen,035,31185,9262,9225,919,10144,64
2022-06-18,Los Angeles,037,10098052,2935128,2909197,141549,3050746,31999
2022-06-18,Madera,039,155013,39171,38859,6655,45514,372
2022-06-18,Marin,041,260295,39811,39214,4503,43717,294
2022-06-18,Mariposa,043,17540,2713,2662,259,2921,30
2022-06-18,Mendocino,045,87422,14254,14090,3680,17770,127
2022-06-18,Merced,047,269075,65325,64734,9517,74251,827
2022-06-18,Modoc,049,8938,773,771,265,1036,8
2022-06-18,Mono,051,14174,3073,3066,175,3241,6
2022-06-18,Monterey,053,433212,85017,84032,16643,100675,744
2022-06-18,Napa,055,140530,29008,28619,1250,29869,144
2022-06-18,Nevada,057,99092,17321,17134,1425,18559,129
2022-06-18,Orange,059,3164182,593171,587176,48345,635521,7074
2022-06-18,Placer,061,380077,68691,67961,8299,76260,628
2022-06-18,Plumas,063,18699,3231,3201,395,3596,13
2022-06-18,Riverside,065,2383286,624422,619760,30131,649891,6488
2022-06-18,Sacramento,067,1510023,309423,306215,30147,336362,3072
2022-06-18,San Benito,069,59416,14128,13985,684,14669,99
2022-06-18,San Bernardino,071,2135413,601810,591926,26347,618273,7765
2022-06-18,San Diego,073,3302833,820130,815124,60067,875191,5318
2022-06-18,San Francisco,075,870044,154738,151898,10183,162081,897
2022-06-18,San Joaquin,077,732212,177973,176323,11592,187915,2251
2022-06-18,San Luis Obispo,079,281455,57253,56767,5250,62017,485
2022-06-18,San Mateo,081,765935,146130,143879,9241,153120,723
2022-06-18,Santa Barbara,083,443738,93753,92906,5429,98335,699
2022-06-18,Santa Clara,085,1922200,371536,365638,15975,381613,2328
2022-06-18,Santa Cruz,087,273765,54777,53866,2664,56530,264
2022-06-18,Shasta,089,179085,31883,31647,6383,38030,568
2022-06-18,Sierra,091,2930,284,281,56,337,4
2022-06-18,Siskiyou,093,43540,4727,4672,2945,7617,81
2022-06-18,Solano,095,438530,92421,90548,6488,97036,454
2022-06-18,Sonoma,097,501317,95639,94318,4174,98492,493
2022-06-18,Stanislaus,099,539301,124243,123264,18665,141929,1668
2022-06-18,Sutter,101,95872,21621,21501,2288,23789,227
2022-06-18,Tehama,103,63373,12502,12410,2708,15118,205
2022-06-18,Trinity,105,12862,1230,1220,297,1517,20
2022-06-18,Tulare,107,460477,110721,110041,29797,139838,1496
2022-06-18,Tuolumne,109,53932,13674,13487,674,14161,189
2022-06-18,Ventura,111,848112,187011,185219,11483,196702,1513
2022-06-18,Yolo,113,214977,42737,41135,3564,44699,323
2022-06-18,Yuba,115,75493,16927,16786,1422,18208,124
2022-06-17,Alameda,001,1643700,300498,296062,16768,312830,1883
2022-06-17,Alpine,003,1148,129,129,1,130,0
2022-06-17,Amador,005,37829,9122,8985,739,9724,87
2022-06-17,Butte,007,227075,35405,34920,7707,42627,432
2022-06-17,Calaveras,009,45235,7719,7664,410,8074,122
2022-06-17,Colusa,011,21464,3529,3519,1105,4624,21
2022-06-17,Contra Costa,013,1133247,218501,213994,16562,230556,1323
2022-06-17,Del Norte,015,27424,6412,6307,278,6585,52
2022-06-17,El Dorado,017,186661,29221,28904,3640,32544,215
2022-06-17,Fresno,019,978130,244069,242214,25642,267856,2768
2022-06-17,Glenn,021,27897,5174,5131,1695,6826,48
2022-06-17,Humboldt,023,135768,19144,18885,3881,22766,148
2022-06-17,Imperial,025,180216,57918,57450,11326,68776,944
2022-06-17,Inyo,027,18085,4228,4209,616,4825,56
2022-06-17,Kern,029,883053,200059,198567,49466,248033,2340
2022-06-17,Kings,031,150075,53549,53242,3625,56867,448
2022-06-17,Lake,033,64148,11441,11318,992,12310,140
2022-06-17,Lassen,035,31185,9261,9225,918,10143,64
2022-06-17,Los Angeles,037,10098052,2932284,2909197,141250,3050447,31999
2022-06-17,Madera,039,155013,39146,38859,6649,45508,372
2022-06-17,Marin,041,260295,39716,39214,4491,43705,294
2022-06-17,Mariposa,043,17540,2709,2662,259,2921,30
2022-06-17,Mendocino,045,87422,14238,14090,3676,17766,127
2022-06-17,Merced,047,269075,65268,64734,9512,74246,827
2022-06-17,Modoc,049,8938,773,771,265,1036,8
2022-06-17,Mono,051,14174,3073,3066,175,3241,6
2022-06-17,Monterey,053,433212,84927,84032,16613,100645,744
2022-06-17,Napa,055,140530,28969,28619,1247,29866,144
2022-06-17,Nevada,057,99092,17302,17134,1420,18554,129
2022-06-17,Orange,059,3164182,592494,587176,48212,635388,7074
2022-06-17,Placer,061,380077,68631,67961,8289,76250,628
2022-06-17,Plumas,063,18699,3230,3201,394,3595,13
2022-06-17,Riverside,065,2383286,623869,619760,30095,649855,6488
2022-06-17,Sacramento,067,1510023,309033,306215,30127,336342,3072
2022-06-17,San Benito,069,59416,14116,13985,684,14669,99
2022-06-17,San Bernardino,071,2135413,601372,591926,26316,618242,7765
2022-06-17,San Diego,073,3302833,819165,815124,59962,875086,5318
2022-06-17,San Francisco,075,870044,154418,151898,10148,162046,897
2022-06-17,San Joaquin,077,732212,177824,176323,11582,187905,2251
2022-06-17,San Luis Obispo,079,281455,57216,56767,5244,62011,485
2022-06-17,San Mateo,081,765935,145829,143879,9222,153101,723
2022-06-17,Santa Barbara,083,443738,93648,92906,5417,98323,699
2022-06-17,Santa Clara,085,1922200,370709,365638,15942,381580,2328
2022-06-17,Santa Cruz,087,273765,54711,53866,2659,56525,264
2022-06-17,Shasta,089,179085,31857,31647,6375,38022,568
2022-06-17,Sierra,091,2930,284,281,56,337,4
2022-06-17,Siskiyou,093,43540,4720,4672,2945,7617,81
2022-06-17,Solano,095,438530,92276,90548,6477,97025,454
2022-06-17,Sonoma,097,501317,95473,94318,4157,98475,493
2022-06-17,Stanislaus,099,539301,124145,123264,18656,141920,1668
2022-06-17,Sutter,101,95872,21599,21501,2282,23783,227
2022-06-17,Tehama,103,63373,12487,12410,2705,15115,205
2022-06-17,Trinity,105,12862,1230,1220,297,1517,20
2022-06-17,Tulare,107,460477,110639,110041,29760,139801,1496
2022-06-17,Tuolumne,109,53932,13661,13487,673,14160,189
2022-06-17,Ventura,111,848112,186831,185219,11463,196682,1513
2022-06-17,Yolo,113,214977,42654,41135,3551,44686,323
2022-06-17,Yuba,115,75493,16920,16786,1419,18205,124
2022-06-16,Alameda,001,1643700,299718,296062,16717,312779,1883
2022-06-16,Alpine,003,1148,129,129,1,130,0
2022-06-16,Amador,005,37829,9115,8985,734,9719,87
2022-06-16,Butte,007,227075,35330,34920,7691,42611,432
2022-06-16,Calaveras,009,45235,7707,7664,409,8073,122
2022-06-16,Colusa,011,21464,3527,3519,1104,4623,21
2022-06-16,Contra Costa,013,1133247,218035,213994,16511,230505,1323
2022-06-16,Del Norte,015,27424,6398,6307,277,6584,52
2022-06-16,El Dorado,017,186661,29169,28904,3628,32532,215
2022-06-16,Fresno,019,978130,243700,242214,25583,267797,2768
2022-06-16,Glenn,021,27897,5166,5131,1691,6822,48
2022-06-16,Humboldt,023,135768,19114,18885,3867,22752,148
2022-06-16,Imperial,025,180216,57819,57450,11297,68747,944
2022-06-16,Inyo,027,18085,4227,4209,613,4822,56
2022-06-16,Kern,029,883053,199848,198567,49351,247918,2340
2022-06-16,Kings,031,150075,53482,53242,3621,56863,448
2022-06-16,Lake,033,64148,11425,11318,992,12310,140
2022-06-16,Lassen,035,31185,9254,9225,918,10143,64
2022-06-16,Los Angeles,037,10098052,2928299,2909197,140895,3050092,31999
2022-06-16,Madera,039,155013,39116,38859,6639,45498,372
2022-06-16,Marin,041,260295,39617,39214,4478,43692,294
2022-06-16,Mariposa,043,17540,2701,2662,257,2919,30
2022-06-16,Mendocino,045,87422,14209,14090,3666,17756,127
2022-06-16,Merced,047,269075,65190,64734,9493,74227,827
2022-06-16,Modoc,049,8938,773,771,265,1036,8
2022-06-16,Mono,051,14174,3072,3066,174,3240,6
2022-06-16,Monterey,053,433212,84778,84032,16558,100590,744
2022-06-16,Napa,055,140530,28925,28619,1244,29863,144
2022-06-16,Nevada,057,99092,17278,17134,1415,18549,129
2022-06-16,Orange,059,3164182,591471,587176,48077,635253,7074
2022-06-16,Placer,061,380077,68546,67961,8267,76228,628
2022-06-16,Plumas,063,18699,3223,3201,393,3594,13
2022-06-16,Riverside,065,2383286,623121,619760,30051,649811,6488
2022-06-16,Sacramento,067,1510023,308451,306215,30094,336309,3072
2022-06-16,San Benito,069,59416,14092,13985,681,14666,99
2022-06-16,San Bernardino,071,2135413,600712,591926,26278,618204,7765
2022-06-16,San Diego,073,3302833,817640,815124,59800,874924,5318
2022-06-16,San Francisco,075,870044,153967,151898,10108,162006,897
2022-06-16,San Joaquin,077,732212,177572,176323,11566,187889,2251
2022-06-16,San Luis Obispo,079,281455,57138,56767,5224,61991,485
2022-06-16,San Mateo,081,765935,145466,143879,9206,153085,723
2022-06-16,Santa Barbara,083,443738,93499,92906,5403,98309,699
2022-06-16,Santa Clara,085,1922200,369764,365638,15893,381531,2328
2022-06-16,Santa Cruz,087,273765,54578,53866,2647,56513,264
2022-06-16,Shasta,089,179085,31827,31647,6364,38011,568
2022-06-16,Sierra,091,2930,283,281,56,337,4
2022-06-16,Siskiyou,093,43540,4711,4672,2936,7608,81
2022-06-16,Solano,095,438530,92083,90548,6465,97013,454
2022-06-16,Sonoma,097,501317,95287,94318,4140,98458,493
2022-06-16,Stanislaus,099,539301,123985,123264,18640,141904,1668
2022-06-16,Sutter,101,95872,21574,21501,2280,23781,227
2022-06-16,Tehama,103,63373,12468,12410,2703,15113,205
2022-06-16,Trinity,105,12862,1228,1220,294,1514,20
2022-06-16,Tulare,107,460477,110508,110041,29717,139758,1496
2022-06-16,Tuolumne,109,53932,13637,13487,669,14156,189
2022-06-16,Ventura,111,848112,186560,185219,11418,196637,1513
2022-06-16,Yolo,113,214977,42563,41135,3540,44675,323
2022-06-16,Yuba,115,75493,16896,16786,1415,18201,124
2022-06-15,Alameda,001,1643700,298941,295002,16688,311690,1880
2022-06-15,Alpine,003,1148,129,129,1,130,0
2022-06-15,Amador,005,37829,9107,8972,734,9706,87
2022-06-15,Butte,007,227075,35267,34841,7672,42513,430
2022-06-15,Calaveras,009,45235,7704,7648,407,8055,122
2022-06-15,Colusa,011,21464,3523,3515,1102,4617,21
2022-06-15,Contra Costa,013,1133247,217575,213219,16466,229685,1321
2022-06-15,Del Norte,015,27424,6387,6298,276,6574,52
2022-06-15,El Dorado,017,186661,29115,28829,3616,32445,215
2022-06-15,Fresno,019,978130,243337,241768,25538,267306,2767
2022-06-15,Glenn,021,27897,5161,5128,1683,6811,48
2022-06-15,Humboldt,023,135768,19076,18836,3842,22678,148
2022-06-15,Imperial,025,180216,57736,57373,11274,68647,941
2022-06-15,Inyo,027,18085,4225,4205,612,4817,56
2022-06-15,Kern,029,883053,199584,198216,49244,247460,2338
2022-06-15,Kings,031,150075,53428,53170,3619,56789,448
2022-06-15,Lake,033,64148,11405,11303,987,12290,140
2022-06-15,Lassen,035,31185,9250,9209,917,10126,64
2022-06-15,Los Angeles,037,10098052,2924000,2897298,140539,3037837,31971
2022-06-15,Madera,039,155013,39072,38776,6622,45398,372
2022-06-15,Marin,041,260295,39528,39027,4471,43498,294
2022-06-15,Mariposa,043,17540,2697,2651,255,2906,30
2022-06-15,Mendocino,045,87422,14177,14052,3655,17707,127
2022-06-15,Merced,047,269075,65109,64595,9481,74076,825
2022-06-15,Modoc,049,8938,772,772,265,1037,8
2022-06-15,Mono,051,14174,3072,3060,173,3233,6
2022-06-15,Monterey,053,433212,84638,83837,16518,100355,741
2022-06-15,Napa,055,140530,28865,28518,1235,29753,144
2022-06-15,Nevada,057,99092,17253,17107,1411,18518,127
2022-06-15,Orange,059,3164182,590443,585496,47908,633404,7067
2022-06-15,Placer,061,380077,68423,67805,8250,76055,628
2022-06-15,Plumas,063,18699,3218,3185,391,3576,13
2022-06-15,Riverside,065,2383286,622397,618584,29999,648583,6482
2022-06-15,Sacramento,067,1510023,307857,305361,30046,335407,3059
2022-06-15,San Benito,069,59416,14052,13953,674,14627,99
2022-06-15,San Bernardino,071,2135413,600059,590328,26238,616566,7735
2022-06-15,San Diego,073,3302833,816089,811093,59634,870727,5316
2022-06-15,San Francisco,075,870044,153529,151170,10083,161253,890
2022-06-15,San Joaquin,077,732212,177328,175966,11535,187501,2244
2022-06-15,San Luis Obispo,079,281455,57052,56535,5187,61722,486
2022-06-15,San Mateo,081,765935,145070,143277,9190,152467,722
2022-06-15,Santa Barbara,083,443738,93366,92710,5396,98106,698
2022-06-15,Santa Clara,085,1922200,368762,364014,15857,379871,2323
2022-06-15,Santa Cruz,087,273765,54463,53718,2642,56360,265
2022-06-15,Shasta,089,179085,31787,31598,6357,37955,568
2022-06-15,Sierra,091,2930,281,280,56,336,4
2022-06-15,Siskiyou,093,43540,4700,4656,2926,7582,81
2022-06-15,Solano,095,438530,91854,90265,6457,96722,453
2022-06-15,Sonoma,097,501317,95094,94041,4128,98169,492
2022-06-15,Stanislaus,099,539301,123841,122944,18616,141560,1668
2022-06-15,Sutter,101,95872,21547,21448,2275,23723,227
2022-06-15,Tehama,103,63373,12460,12392,2697,15089,205
2022-06-15,Trinity,105,12862,1227,1217,292,1509,20
2022-06-15,Tulare,107,460477,110402,109930,29680,139610,1495
2022-06-15,Tuolumne,109,53932,13626,13459,669,14128,189
2022-06-15,Ventura,111,848112,186285,184750,11371,196121,1509
2022-06-15,Yolo,113,214977,42456,40756,3525,44281,322
2022-06-15,Yuba,115,75493,16871,16754,1410,18164,124
2022-06-14,Alameda,001,1643700,298238,295002,16640,311642,1880
2022-06-14,Alpine,003,1148,129,129,1,130,0
2022-06-14,Amador,005,37829,9091,8972,729,9701,87
2022-06-14,Butte,007,227075,35213,34841,7657,42498,430
2022-06-14,Calaveras,009,45235,7694,7648,406,8054,122
2022-06-14,Colusa,011,21464,3521,3515,1101,4616,21
2022-06-14,Contra Costa,013,1133247,217045,213219,16407,229626,1321
2022-06-14,Del Norte,015,27424,6379,6298,273,6571,52
2022-06-14,El Dorado,017,186661,29063,28829,3608,32437,215
2022-06-14,Fresno,019,978130,242947,241768,25476,267244,2767
2022-06-14,Glenn,021,27897,5153,5128,1680,6808,48
2022-06-14,Humboldt,023,135768,19026,18836,3825,22661,148
2022-06-14,Imperial,025,180216,57662,57373,11244,68617,941
2022-06-14,Inyo,027,18085,4220,4205,611,4816,56
2022-06-14,Kern,029,883053,199325,198216,49128,247344,2338
2022-06-14,Kings,031,150075,53358,53170,3617,56787,448
2022-06-14,Lake,033,64148,11379,11303,986,12289,140
2022-06-14,Lassen,035,31185,9244,9209,914,10123,64
2022-06-14,Los Angeles,037,10098052,2919479,2897298,140123,3037421,31971
2022-06-14,Madera,039,155013,39018,38776,6614,45390,372
2022-06-14,Marin,041,260295,39419,39027,4460,43487,294
2022-06-14,Mariposa,043,17540,2686,2651,253,2904,30
2022-06-14,Mendocino,045,87422,14149,14052,3643,17695,127
2022-06-14,Merced,047,269075,65027,64595,9456,74051,825
2022-06-14,Modoc,049,8938,772,772,264,1036,8
2022-06-14,Mono,051,14174,3072,3060,172,3232,6
2022-06-14,Monterey,053,433212,84498,83837,16472,100309,741
2022-06-14,Napa,055,140530,28803,28518,1234,29752,144
2022-06-14,Nevada,057,99092,17221,17107,1406,18513,127
2022-06-14,Orange,059,3164182,589318,585496,47748,633244,7067
2022-06-14,Placer,061,380077,68300,67805,8235,76040,628
2022-06-14,Plumas,063,18699,3213,3185,391,3576,13
2022-06-14,Riverside,065,2383286,621615,618584,29964,648548,6482
2022-06-14,Sacramento,067,1510023,307230,305361,29965,335326,3059
2022-06-14,San Benito,069,59416,14017,13953,672,14625,99
2022-06-14,San Bernardino,071,2135413,599342,590328,26194,616522,7735
2022-06-14,San Diego,073,3302833,814376,811093,59482,870575,5316
2022-06-14,San Francisco,075,870044,153040,151170,10056,161226,890
2022-06-14,San Joaquin,077,732212,177059,175966,11500,187466,2244
2022-06-14,San Luis Obispo,079,281455,56943,56535,5139,61674,486
2022-06-14,San Mateo,081,765935,144692,143277,9176,152453,722
2022-06-14,Santa Barbara,083,443738,93230,92710,5381,98091,698
2022-06-14,Santa Clara,085,1922200,367696,364014,15810,379824,2323
2022-06-14,Santa Cruz,087,273765,54338,53718,2631,56349,265
2022-06-14,Shasta,089,179085,31757,31598,6349,37947,568
2022-06-14,Sierra,091,2930,281,280,56,336,4
2022-06-14,Siskiyou,093,43540,4690,4656,2920,7576,81
2022-06-14,Solano,095,438530,91595,90265,6437,96702,453
2022-06-14,Sonoma,097,501317,94879,94041,4115,98156,492
2022-06-14,Stanislaus,099,539301,123664,122944,18587,141531,1668
2022-06-14,Sutter,101,95872,21509,21448,2271,23719,227
2022-06-14,Tehama,103,63373,12442,12392,2696,15088,205
2022-06-14,Trinity,105,12862,1226,1217,292,1509,20
2022-06-14,Tulare,107,460477,110260,109930,29634,139564,1495
2022-06-14,Tuolumne,109,53932,13605,13459,665,14124,189
2022-06-14,Ventura,111,848112,185992,184750,11334,196084,1509
2022-06-14,Yolo,113,214977,42349,40756,3514,44270,322
2022-06-14,Yuba,115,75493,16841,16754,1407,18161,124
2022-06-13,Alameda,001,1643700,297416,295002,16591,311593,1880
2022-06-13,Alpine,003,1148,129,129,1,130,0
2022-06-13,Amador,005,37829,9084,8972,727,9699,87
2022-06-13,Butte,007,227075,35135,34841,7632,42473,430
2022-06-13,Calaveras,009,45235,7675,7648,406,8054,122
2022-06-13,Colusa,011,21464,3521,3515,1098,4613,21
2022-06-13,Contra Costa,013,1133247,216468,213219,16340,229559,1321
2022-06-13,Del Norte,015,27424,6367,6298,269,6567,52
2022-06-13,El Dorado,017,186661,29013,28829,3596,32425,215
2022-06-13,Fresno,019,978130,242528,241768,25422,267190,2767
2022-06-13,Glenn,021,27897,5149,5128,1676,6804,48
2022-06-13,Humboldt,023,135768,18973,18836,3801,22637,148
2022-06-13,Imperial,025,180216,57562,57373,11200,68573,941
2022-06-13,Inyo,027,18085,4216,4205,606,4811,56
2022-06-13,Kern,029,883053,199057,198216,48993,247209,2338
2022-06-13,Kings,031,150075,53293,53170,3613,56783,448
2022-06-13,Lake,033,64148,11354,11303,985,12288,140
2022-06-13,Lassen,035,31185,9236,9209,911,10120,64
2022-06-13,Los Angeles,037,10098052,2914919,2897298,139732,3037030,31971
2022-06-13,Madera,039,155013,38951,38776,6596,45372,372
2022-06-13,Marin,041,260295,39312,39027,4432,43459,294
2022-06-13,Mariposa,043,17540,2672,2651,252,2903,30
2022-06-13,Mendocino,045,87422,14125,14052,3627,17679,127
2022-06-13,Merced,047,269075,64950,64595,9429,74024,825
2022-06-13,Modoc,049,8938,771,772,264,1036,8
2022-06-13,Mono,051,14174,3070,3060,172,3232,6
2022-06-13,Monterey,053,433212,84365,83837,16421,100258,741
2022-06-13,Napa,055,140530,28733,28518,1230,29748,144
2022-06-13,Nevada,057,99092,17190,17107,1403,18510,127
2022-06-13,Orange,059,3164182,588079,585496,47571,633067,7067
2022-06-13,Placer,061,380077,68204,67805,8213,76018,628
2022-06-13,Plumas,063,18699,3208,3185,390,3575,13
2022-06-13,Riverside,065,2383286,620873,618584,29929,648513,6482
2022-06-13,Sacramento,067,1510023,306555,305361,29901,335262,3059
2022-06-13,San Benito,069,59416,13990,13953,666,14619,99
2022-06-13,San Bernardino,071,2135413,598548,590328,26163,616491,7735
2022-06-13,San Diego,073,3302833,812665,811093,59379,870472,5316
2022-06-13,San Francisco,075,870044,152489,151170,10038,161208,890
2022-06-13,San Joaquin,077,732212,176795,175966,11463,187429,2244
2022-06-13,San Luis Obispo,079,281455,56842,56535,5088,61623,486
2022-06-13,San Mateo,081,765935,144262,143277,9154,152431,722
2022-06-13,Santa Barbara,083,443738,93101,92710,5368,98078,698
2022-06-13,Santa Clara,085,1922200,366684,364014,15758,379772,2323
2022-06-13,Santa Cruz,087,273765,54200,53718,2624,56342,265
2022-06-13,Shasta,089,179085,31723,31598,6342,37940,568
2022-06-13,Sierra,091,2930,281,280,56,336,4
2022-06-13,Siskiyou,093,43540,4686,4656,2912,7568,81
2022-06-13,Solano,095,438530,91358,90265,6412,96677,453
2022-06-13,Sonoma,097,501317,94623,94041,4096,98137,492
2022-06-13,Stanislaus,099,539301,123495,122944,18568,141512,1668
2022-06-13,Sutter,101,95872,21481,21448,2267,23715,227
2022-06-13,Tehama,103,63373,12422,12392,2693,15085,205
2022-06-13,Trinity,105,12862,1224,1217,292,1509,20
2022-06-13,Tulare,107,460477,110110,109930,29585,139515,1495
2022-06-13,Tuolumne,109,53932,13582,13459,662,14121,189
2022-06-13,Ventura,111,848112,185700,184750,11284,196034,1509
2022-06-13,Yolo,113,214977,42211,40756,3502,44258,322
2022-06-13,Yuba,115,75493,16823,16754,1403,18157,124
2022-06-12,Alameda,001,1643700,296601,292112,16533,308645,1877
2022-06-12,Alpine,003,1148,129,129,1,130,0
2022-06-12,Amador,005,37829,9061,8869,726,9595,87
2022-06-12,Butte,007,227075,35078,34596,7611,42207,427
2022-06-12,Calaveras,009,45235,7661,7604,403,8007,122
2022-06-12,Colusa,011,21464,3520,3505,1097,4602,21
2022-06-12,Contra Costa,013,1133247,215880,211229,16268,227497,1315
2022-06-12,Del Norte,015,27424,6353,6253,269,6522,52
2022-06-12,El Dorado,017,186661,28952,28641,3579,32220,215
2022-06-12,Fresno,019,978130,242068,240345,25369,265714,2766
2022-06-12,Glenn,021,27897,5145,5104,1674,6778,48
2022-06-12,Humboldt,023,135768,18908,18696,3765,22461,148
2022-06-12,Imperial,025,180216,57485,57129,11156,68285,941
2022-06-12,Inyo,027,18085,4214,4194,605,4799,56
2022-06-12,Kern,029,883053,198775,197353,48874,246227,2338
2022-06-12,Kings,031,150075,53215,52978,3608,56586,447
2022-06-12,Lake,033,64148,11330,11202,984,12186,139
2022-06-12,Lassen,035,31185,9218,9172,909,10081,64
2022-06-12,Los Angeles,037,10098052,2909978,2878981,139252,3018233,31947
2022-06-12,Madera,039,155013,38858,38567,6570,45137,372
2022-06-12,Marin,041,260295,39204,38593,4408,43001,294
2022-06-12,Mariposa,043,17540,2666,2625,251,2876,30
2022-06-12,Mendocino,045,87422,14102,13945,3621,17566,127
2022-06-12,Merced,047,269075,64833,64286,9400,73686,825
2022-06-12,Modoc,049,8938,771,767,264,1031,8
2022-06-12,Mono,051,14174,3066,3052,171,3223,6
2022-06-12,Monterey,053,433212,84209,83391,16343,99734,739
2022-06-12,Napa,055,140530,28670,28202,1221,29423,143
2022-06-12,Nevada,057,99092,17147,16989,1397,18386,127
2022-06-12,Orange,059,3164182,586808,581624,47388,629012,7057
2022-06-12,Placer,061,380077,68091,67306,8189,75495,628
2022-06-12,Plumas,063,18699,3202,3172,389,3561,13
2022-06-12,Riverside,065,2383286,619926,615556,29861,645417,6481
2022-06-12,Sacramento,067,1510023,305818,302721,29800,332521,3058
2022-06-12,San Benito,069,59416,13956,13832,660,14492,99
2022-06-12,San Bernardino,071,2135413,597633,587385,26114,613499,7708
2022-06-12,San Diego,073,3302833,810930,805360,59245,864605,5315
2022-06-12,San Francisco,075,870044,151927,149278,9993,159271,890
2022-06-12,San Joaquin,077,732212,176441,174822,11437,186259,2244
2022-06-12,San Luis Obispo,079,281455,56705,56160,5027,61187,485
2022-06-12,San Mateo,081,765935,143801,141719,9112,150831,715
2022-06-12,Santa Barbara,083,443738,92928,92177,5354,97531,694
2022-06-12,Santa Clara,085,1922200,365509,359925,15711,375636,2322
2022-06-12,Santa Cruz,087,273765,54040,53171,2619,55790,264
2022-06-12,Shasta,089,179085,31676,31483,6328,37811,566
2022-06-12,Sierra,091,2930,281,278,56,334,4
2022-06-12,Siskiyou,093,43540,4678,4633,2907,7540,81
2022-06-12,Solano,095,438530,91066,89424,6393,95817,453
2022-06-12,Sonoma,097,501317,94367,93218,4072,97290,492
2022-06-12,Stanislaus,099,539301,123296,122267,18531,140798,1665
2022-06-12,Sutter,101,95872,21440,21333,2251,23584,227
2022-06-12,Tehama,103,63373,12404,12343,2688,15031,205
2022-06-12,Trinity,105,12862,1221,1213,292,1505,20
2022-06-12,Tulare,107,460477,109911,109467,29519,138986,1495
2022-06-12,Tuolumne,109,53932,13554,13382,660,14042,189
2022-06-12,Ventura,111,848112,185342,183680,11239,194919,1508
2022-06-12,Yolo,113,214977,42090,40202,3497,43699,323
2022-06-12,Yuba,115,75493,16795,16653,1395,18048,123
2022-06-11,Alameda,001,1643700,296187,292112,16513,308625,1877
2022-06-11,Alpine,003,1148,129,129,1,130,0
2022-06-11,Amador,005,37829,9047,8869,726,9595,87
2022-06-11,Butte,007,227075,35043,34596,7595,42191,427
2022-06-11,Calaveras,009,45235,7654,7604,402,8006,122
2022-06-11,Colusa,011,21464,3518,3505,1096,4601,21
2022-06-11,Contra Costa,013,1133247,215568,211229,16233,227462,1315
2022-06-11,Del Norte,015,27424,6345,6253,269,6522,52
2022-06-11,El Dorado,017,186661,28933,28641,3577,32218,215
2022-06-11,Fresno,019,978130,241873,240345,25349,265694,2766
2022-06-11,Glenn,021,27897,5143,5104,1674,6778,48
2022-06-11,Humboldt,023,135768,18888,18696,3757,22453,148
2022-06-11,Imperial,025,180216,57429,57129,11142,68271,941
2022-06-11,Inyo,027,18085,4214,4194,603,4797,56
2022-06-11,Kern,029,883053,198653,197353,48801,246154,2338
2022-06-11,Kings,031,150075,53183,52978,3607,56585,447
2022-06-11,Lake,033,64148,11322,11202,981,12183,139
2022-06-11,Lassen,035,31185,9213,9172,908,10080,64
2022-06-11,Los Angeles,037,10098052,2907640,2878981,138961,3017942,31947
2022-06-11,Madera,039,155013,38837,38567,6568,45135,372
2022-06-11,Marin,041,260295,39127,38593,4374,42967,294
2022-06-11,Mariposa,043,17540,2662,2625,250,2875,30
2022-06-11,Mendocino,045,87422,14091,13945,3617,17562,127
2022-06-11,Merced,047,269075,64785,64286,9396,73682,825
2022-06-11,Modoc,049,8938,771,767,264,1031,8
2022-06-11,Mono,051,14174,3066,3052,171,3223,6
2022-06-11,Monterey,053,433212,84126,83391,16311,99702,739
2022-06-11,Napa,055,140530,28631,28202,1217,29419,143
2022-06-11,Nevada,057,99092,17134,16989,1395,18384,127
2022-06-11,Orange,059,3164182,586165,581624,47252,628876,7057
2022-06-11,Placer,061,380077,68003,67306,8180,75486,628
2022-06-11,Plumas,063,18699,3199,3172,389,3561,13
2022-06-11,Riverside,065,2383286,619400,615556,29832,645388,6481
2022-06-11,Sacramento,067,1510023,305512,302721,29765,332486,3058
2022-06-11,San Benito,069,59416,13946,13832,657,14489,99
2022-06-11,San Bernardino,071,2135413,597213,587385,26091,613476,7708
2022-06-11,San Diego,073,3302833,810227,805360,59201,864561,5315
2022-06-11,San Francisco,075,870044,151603,149278,9973,159251,890
2022-06-11,San Joaquin,077,732212,176286,174822,11419,186241,2244
2022-06-11,San Luis Obispo,079,281455,56671,56160,5018,61178,485
2022-06-11,San Mateo,081,765935,143578,141719,9090,150809,715
2022-06-11,Santa Barbara,083,443738,92862,92177,5340,97517,694
2022-06-11,Santa Clara,085,1922200,364747,359925,15673,375598,2322
2022-06-11,Santa Cruz,087,273765,53985,53171,2605,55776,264
2022-06-11,Shasta,089,179085,31660,31483,6322,37805,566
2022-06-11,Sierra,091,2930,281,278,56,334,4
2022-06-11,Siskiyou,093,43540,4672,4633,2899,7532,81
2022-06-11,Solano,095,438530,90977,89424,6384,95808,453
2022-06-11,Sonoma,097,501317,94260,93218,4047,97265,492
2022-06-11,Stanislaus,099,539301,123194,122267,18511,140778,1665
2022-06-11,Sutter,101,95872,21422,21333,2250,23583,227
2022-06-11,Tehama,103,63373,12397,12343,2688,15031,205
2022-06-11,Trinity,105,12862,1220,1213,292,1505,20
2022-06-11,Tulare,107,460477,109828,109467,29490,138957,1495
2022-06-11,Tuolumne,109,53932,13528,13382,659,14041,189
2022-06-11,Ventura,111,848112,185164,183680,11208,194888,1508
2022-06-11,Yolo,113,214977,42026,40202,3491,43693,323
2022-06-11,Yuba,115,75493,16776,16653,1391,18044,123
2022-06-10,Alameda,001,1643700,295717,292112,16490,308602,1877
2022-06-10,Alpine,003,1148,129,129,1,130,0
2022-06-10,Amador,005,37829,9034,8869,725,9594,87
2022-06-10,Butte,007,227075,35011,34596,7581,42177,427
2022-06-10,Calaveras,009,45235,7649,7604,401,8005,122
2022-06-10,Colusa,011,21464,3513,3505,1095,4600,21
2022-06-10,Contra Costa,013,1133247,215301,211229,16202,227431,1315
2022-06-10,Del Norte,015,27424,6339,6253,268,6521,52
2022-06-10,El Dorado,017,186661,28903,28641,3574,32215,215
2022-06-10,Fresno,019,978130,241644,240345,25326,265671,2766
2022-06-10,Glenn,021,27897,5141,5104,1671,6775,48
2022-06-10,Humboldt,023,135768,18866,18696,3750,22446,148
2022-06-10,Imperial,025,180216,57383,57129,11139,68268,941
2022-06-10,Inyo,027,18085,4213,4194,600,4794,56
2022-06-10,Kern,029,883053,198507,197353,48710,246063,2338
2022-06-10,Kings,031,150075,53162,52978,3606,56584,447
2022-06-10,Lake,033,64148,11307,11202,980,12182,139
2022-06-10,Lassen,035,31185,9210,9172,906,10078,64
2022-06-10,Los Angeles,037,10098052,2904916,2878981,138692,3017673,31947
2022-06-10,Madera,039,155013,38809,38567,6560,45127,372
2022-06-10,Marin,041,260295,39032,38593,4347,42940,294
2022-06-10,Mariposa,043,17540,2658,2625,249,2874,30
2022-06-10,Mendocino,045,87422,14073,13945,3609,17554,127
2022-06-10,Merced,047,269075,64742,64286,9391,73677,825
2022-06-10,Modoc,049,8938,771,767,264,1031,8
2022-06-10,Mono,051,14174,3066,3052,170,3222,6
2022-06-10,Monterey,053,433212,84035,83391,16271,99662,739
2022-06-10,Napa,055,140530,28600,28202,1216,29418,143
2022-06-10,Nevada,057,99092,17121,16989,1394,18383,127
2022-06-10,Orange,059,3164182,585506,581624,47138,628762,7057
2022-06-10,Placer,061,380077,67932,67306,8162,75468,628
2022-06-10,Plumas,063,18699,3195,3172,389,3561,13
2022-06-10,Riverside,065,2383286,618879,615556,29803,645359,6481
2022-06-10,Sacramento,067,1510023,305116,302721,29742,332463,3058
2022-06-10,San Benito,069,59416,13932,13832,656,14488,99
2022-06-10,San Bernardino,071,2135413,596806,587385,26060,613445,7708
2022-06-10,San Diego,073,3302833,809310,805360,59169,864529,5315
2022-06-10,San Francisco,075,870044,151282,149278,9934,159212,890
2022-06-10,San Joaquin,077,732212,176171,174822,11404,186226,2244
2022-06-10,San Luis Obispo,079,281455,56636,56160,5011,61171,485
2022-06-10,San Mateo,081,765935,143325,141719,9077,150796,715
2022-06-10,Santa Barbara,083,443738,92763,92177,5336,97513,694
2022-06-10,Santa Clara,085,1922200,364002,359925,15639,375564,2322
2022-06-10,Santa Cruz,087,273765,53886,53171,2595,55766,264
2022-06-10,Shasta,089,179085,31640,31483,6313,37796,566
2022-06-10,Sierra,091,2930,280,278,56,334,4
2022-06-10,Siskiyou,093,43540,4665,4633,2893,7526,81
2022-06-10,Solano,095,438530,90817,89424,6372,95796,453
2022-06-10,Sonoma,097,501317,94099,93218,4024,97242,492
2022-06-10,Stanislaus,099,539301,123075,122267,18499,140766,1665
2022-06-10,Sutter,101,95872,21407,21333,2248,23581,227
2022-06-10,Tehama,103,63373,12389,12343,2687,15030,205
2022-06-10,Trinity,105,12862,1218,1213,292,1505,20
2022-06-10,Tulare,107,460477,109761,109467,29469,138936,1495
2022-06-10,Tuolumne,109,53932,13514,13382,657,14039,189
2022-06-10,Ventura,111,848112,184978,183680,11174,194854,1508
2022-06-10,Yolo,113,214977,41936,40202,3483,43685,323
2022-06-10,Yuba,115,75493,16755,16653,1388,18041,123
2022-06-09,Alameda,001,1643700,294807,292112,16439,308551,1877
2022-06-09,Alpine,003,1148,129,129,1,130,0
2022-06-09,Amador,005,37829,9023,8869,722,9591,87
2022-06-09,Butte,007,227075,34951,34596,7570,42166,427
2022-06-09,Calaveras,009,45235,7639,7604,401,8005,122
2022-06-09,Colusa,011,21464,3512,3505,1093,4598,21
2022-06-09,Contra Costa,013,1133247,214788,211229,16156,227385,1315
2022-06-09,Del Norte,015,27424,6326,6253,265,6518,52
2022-06-09,El Dorado,017,186661,28846,28641,3565,32206,215
2022-06-09,Fresno,019,978130,241290,240345,25280,265625,2766
2022-06-09,Glenn,021,27897,5135,5104,1669,6773,48
2022-06-09,Humboldt,023,135768,18817,18696,3739,22435,148
2022-06-09,Imperial,025,180216,57325,57129,11122,68251,941
2022-06-09,Inyo,027,18085,4210,4194,595,4789,56
2022-06-09,Kern,029,883053,198306,197353,48612,245965,2338
2022-06-09,Kings,031,150075,53121,52978,3603,56581,447
2022-06-09,Lake,033,64148,11282,11202,978,12180,139
2022-06-09,Lassen,035,31185,9191,9172,904,10076,64
2022-06-09,Los Angeles,037,10098052,2900523,2878981,138311,3017292,31947
2022-06-09,Madera,039,155013,38755,38567,6546,45113,372
2022-06-09,Marin,041,260295,38930,38593,4322,42915,294
2022-06-09,Mariposa,043,17540,2654,2625,248,2873,30
2022-06-09,Mendocino,045,87422,14045,13945,3607,17552,127
2022-06-09,Merced,047,269075,64664,64286,9382,73668,825
2022-06-09,Modoc,049,8938,770,767,264,1031,8
2022-06-09,Mono,051,14174,3060,3052,168,3220,6
2022-06-09,Monterey,053,433212,83915,83391,16202,99593,739
2022-06-09,Napa,055,140530,28540,28202,1214,29416,143
2022-06-09,Nevada,057,99092,17088,16989,1393,18382,127
2022-06-09,Orange,059,3164182,584441,581624,46991,628615,7057
2022-06-09,Placer,061,380077,67811,67306,8149,75455,628
2022-06-09,Plumas,063,18699,3189,3172,389,3561,13
2022-06-09,Riverside,065,2383286,618186,615556,29763,645319,6481
2022-06-09,Sacramento,067,1510023,304539,302721,29660,332381,3058
2022-06-09,San Benito,069,59416,13914,13832,654,14486,99
2022-06-09,San Bernardino,071,2135413,596134,587385,26027,613412,7708
2022-06-09,San Diego,073,3302833,807900,805360,59035,864395,5315
2022-06-09,San Francisco,075,870044,150881,149278,9904,159182,890
2022-06-09,San Joaquin,077,732212,175878,174822,11386,186208,2244
2022-06-09,San Luis Obispo,079,281455,56549,56160,4983,61143,485
2022-06-09,San Mateo,081,765935,142944,141719,9050,150769,715
2022-06-09,Santa Barbara,083,443738,92632,92177,5331,97508,694
2022-06-09,Santa Clara,085,1922200,363037,359925,15570,375495,2322
2022-06-09,Santa Cruz,087,273765,53754,53171,2585,55756,264
2022-06-09,Shasta,089,179085,31609,31483,6303,37786,566
2022-06-09,Sierra,091,2930,280,278,56,334,4
2022-06-09,Siskiyou,093,43540,4658,4633,2879,7512,81
2022-06-09,Solano,095,438530,90573,89424,6358,95782,453
2022-06-09,Sonoma,097,501317,93942,93218,4005,97223,492
2022-06-09,Stanislaus,099,539301,122907,122267,18484,140751,1665
2022-06-09,Sutter,101,95872,21370,21333,2248,23581,227
2022-06-09,Tehama,103,63373,12371,12343,2686,15029,205
2022-06-09,Trinity,105,12862,1217,1213,292,1505,20
2022-06-09,Tulare,107,460477,109640,109467,29433,138900,1495
2022-06-09,Tuolumne,109,53932,13483,13382,654,14036,189
2022-06-09,Ventura,111,848112,184709,183680,11140,194820,1508
2022-06-09,Yolo,113,214977,41824,40202,3468,43670,323
2022-06-09,Yuba,115,75493,16732,16653,1385,18038,123
2022-06-08,Alameda,001,1643700,294046,289661,16391,306052,1873
2022-06-08,Alpine,003,1148,129,128,1,129,0
2022-06-08,Amador,005,37829,9015,8818,720,9538,87
2022-06-08,Butte,007,227075,34884,34380,7552,41932,427
2022-06-08,Calaveras,009,45235,7625,7564,401,7965,122
2022-06-08,Colusa,011,21464,3510,3495,1090,4585,21
2022-06-08,Contra Costa,013,1133247,214278,209384,16091,225475,1310
2022-06-08,Del Norte,015,27424,6304,6229,265,6494,52
2022-06-08,El Dorado,017,186661,28794,28478,3556,32034,215
2022-06-08,Fresno,019,978130,240953,239376,25208,264584,2766
2022-06-08,Glenn,021,27897,5131,5095,1666,6761,48
2022-06-08,Humboldt,023,135768,18787,18598,3713,22311,147
2022-06-08,Imperial,025,180216,57251,56912,11102,68014,941
2022-06-08,Inyo,027,18085,4208,4189,595,4784,56
2022-06-08,Kern,029,883053,198037,196763,48502,245265,2338
2022-06-08,Kings,031,150075,53051,52821,3599,56420,447
2022-06-08,Lake,033,64148,11261,11158,975,12133,137
2022-06-08,Lassen,035,31185,9178,9148,904,10052,64
2022-06-08,Los Angeles,037,10098052,2895900,2865901,137926,3003827,31920
2022-06-08,Madera,039,155013,38710,38408,6533,44941,372
2022-06-08,Marin,041,260295,38837,38338,4305,42643,294
2022-06-08,Mariposa,043,17540,2644,2614,247,2861,30
2022-06-08,Mendocino,045,87422,14025,13859,3595,17454,127
2022-06-08,Merced,047,269075,64599,64080,9360,73440,825
2022-06-08,Modoc,049,8938,766,761,264,1025,8
2022-06-08,Mono,051,14174,3056,3044,168,3212,6
2022-06-08,Monterey,053,433212,83804,83063,16152,99215,740
2022-06-08,Napa,055,140530,28451,27996,1209,29205,143
2022-06-08,Nevada,057,99092,17062,16907,1389,18296,127
2022-06-08,Orange,059,3164182,583335,578530,46805,625335,7044
2022-06-08,Placer,061,380077,67682,66951,8138,75089,627
2022-06-08,Plumas,063,18699,3186,3150,388,3538,13
2022-06-08,Riverside,065,2383286,617500,613469,29728,643197,6480
2022-06-08,Sacramento,067,1510023,303902,300875,29577,330452,3054
2022-06-08,San Benito,069,59416,13880,13734,652,14386,99
2022-06-08,San Bernardino,071,2135413,595437,585029,25983,611012,7685
2022-06-08,San Diego,073,3302833,806399,800840,58859,859699,5308
2022-06-08,San Francisco,075,870044,150458,147960,9876,157836,885
2022-06-08,San Joaquin,077,732212,175602,173887,11360,185247,2241
2022-06-08,San Luis Obispo,079,281455,56393,55822,4922,60744,484
2022-06-08,San Mateo,081,765935,142544,140569,9003,149572,710
2022-06-08,Santa Barbara,083,443738,92493,91747,5320,97067,693
2022-06-08,Santa Clara,085,1922200,362071,356452,15519,371971,2321
2022-06-08,Santa Cruz,087,273765,53614,52753,2574,55327,264
2022-06-08,Shasta,089,179085,31576,31394,6292,37686,565
2022-06-08,Sierra,091,2930,280,278,56,334,4
2022-06-08,Siskiyou,093,43540,4653,4609,2877,7486,81
2022-06-08,Solano,095,438530,90306,88522,6338,94860,453
2022-06-08,Sonoma,097,501317,93757,92644,3971,96615,491
2022-06-08,Stanislaus,099,539301,122724,121787,18453,140240,1662
2022-06-08,Sutter,101,95872,21346,21256,2242,23498,227
2022-06-08,Tehama,103,63373,12364,12306,2685,14991,205
2022-06-08,Trinity,105,12862,1216,1211,291,1502,20
2022-06-08,Tulare,107,460477,109554,109091,29378,138469,1494
2022-06-08,Tuolumne,109,53932,13467,13335,653,13988,189
2022-06-08,Ventura,111,848112,184433,182847,11091,193938,1506
2022-06-08,Yolo,113,214977,41718,39962,3454,43416,321
2022-06-08,Yuba,115,75493,16707,16558,1377,17935,122
2022-06-07,Alameda,001,1643700,293238,289661,16345,306006,1873
2022-06-07,Alpine,003,1148,129,128,1,129,0
2022-06-07,Amador,005,37829,9005,8818,717,9535,87
2022-06-07,Butte,007,227075,34806,34380,7527,41907,427
2022-06-07,Calaveras,009,45235,7617,7564,399,7963,122
2022-06-07,Colusa,011,21464,3510,3495,1087,4582,21
2022-06-07,Contra Costa,013,1133247,213721,209384,16038,225422,1310
2022-06-07,Del Norte,015,27424,6296,6229,262,6491,52
2022-06-07,El Dorado,017,186661,28730,28478,3546,32024,215
2022-06-07,Fresno,019,978130,240570,239376,25141,264517,2766
2022-06-07,Glenn,021,27897,5124,5095,1666,6761,48
2022-06-07,Humboldt,023,135768,18749,18598,3697,22295,147
2022-06-07,Imperial,025,180216,57192,56912,11069,67981,941
2022-06-07,Inyo,027,18085,4207,4189,587,4776,56
2022-06-07,Kern,029,883053,197782,196763,48394,245157,2338
2022-06-07,Kings,031,150075,52993,52821,3595,56416,447
2022-06-07,Lake,033,64148,11236,11158,969,12127,137
2022-06-07,Lassen,035,31185,9169,9148,903,10051,64
2022-06-07,Los Angeles,037,10098052,2890571,2865901,137489,3003390,31920
2022-06-07,Madera,039,155013,38638,38408,6517,44925,372
2022-06-07,Marin,041,260295,38753,38338,4278,42616,294
2022-06-07,Mariposa,043,17540,2637,2614,245,2859,30
2022-06-07,Mendocino,045,87422,13993,13859,3564,17423,127
2022-06-07,Merced,047,269075,64508,64080,9344,73424,825
2022-06-07,Modoc,049,8938,766,761,262,1023,8
2022-06-07,Mono,051,14174,3054,3044,166,3210,6
2022-06-07,Monterey,053,433212,83676,83063,16098,99161,740
2022-06-07,Napa,055,140530,28377,27996,1201,29197,143
2022-06-07,Nevada,057,99092,17035,16907,1383,18290,127
2022-06-07,Orange,059,3164182,582220,578530,46644,625174,7044
2022-06-07,Placer,061,380077,67530,66951,8119,75070,627
2022-06-07,Plumas,063,18699,3181,3150,387,3537,13
2022-06-07,Riverside,065,2383286,616618,613469,29677,643146,6480
2022-06-07,Sacramento,067,1510023,303184,300875,29474,330349,3054
2022-06-07,San Benito,069,59416,13838,13734,648,14382,99
2022-06-07,San Bernardino,071,2135413,594655,585029,25956,610985,7685
2022-06-07,San Diego,073,3302833,804822,800840,58653,859493,5308
2022-06-07,San Francisco,075,870044,149936,147960,9855,157815,885
2022-06-07,San Joaquin,077,732212,175269,173887,11322,185209,2241
2022-06-07,San Luis Obispo,079,281455,56290,55822,4878,60700,484
2022-06-07,San Mateo,081,765935,142125,140569,8947,149516,710
2022-06-07,Santa Barbara,083,443738,92347,91747,5307,97054,693
2022-06-07,Santa Clara,085,1922200,360938,356452,15438,371890,2321
2022-06-07,Santa Cruz,087,273765,53513,52753,2567,55320,264
2022-06-07,Shasta,089,179085,31539,31394,6285,37679,565
2022-06-07,Sierra,091,2930,279,278,56,334,4
2022-06-07,Siskiyou,093,43540,4646,4609,2873,7482,81
2022-06-07,Solano,095,438530,89981,88522,6321,94843,453
2022-06-07,Sonoma,097,501317,93526,92644,3939,96583,491
2022-06-07,Stanislaus,099,539301,122551,121787,18434,140221,1662
2022-06-07,Sutter,101,95872,21317,21256,2240,23496,227
2022-06-07,Tehama,103,63373,12348,12306,2681,14987,205
2022-06-07,Trinity,105,12862,1215,1211,291,1502,20
2022-06-07,Tulare,107,460477,109428,109091,29327,138418,1494
2022-06-07,Tuolumne,109,53932,13454,13335,651,13986,189
2022-06-07,Ventura,111,848112,184068,182847,11047,193894,1506
2022-06-07,Yolo,113,214977,41601,39962,3445,43407,321
2022-06-07,Yuba,115,75493,16678,16558,1376,17934,122
2022-06-06,Alameda,001,1643700,292354,289661,16292,305953,1873
2022-06-06,Alpine,003,1148,129,128,1,129,0
2022-06-06,Amador,005,37829,8954,8818,715,9533,87
2022-06-06,Butte,007,227075,34743,34380,7513,41893,427
2022-06-06,Calaveras,009,45235,7606,7564,399,7963,122
2022-06-06,Colusa,011,21464,3509,3495,1083,4578,21
2022-06-06,Contra Costa,013,1133247,213072,209384,15956,225340,1310
2022-06-06,Del Norte,015,27424,6288,6229,261,6490,52
2022-06-06,El Dorado,017,186661,28681,28478,3534,32012,215
2022-06-06,Fresno,019,978130,240152,239376,25074,264450,2766
2022-06-06,Glenn,021,27897,5117,5095,1663,6758,48
2022-06-06,Humboldt,023,135768,18711,18598,3684,22282,147
2022-06-06,Imperial,025,180216,57118,56912,11036,67948,941
2022-06-06,Inyo,027,18085,4203,4189,584,4773,56
2022-06-06,Kern,029,883053,197500,196763,48263,245026,2338
2022-06-06,Kings,031,150075,52934,52821,3592,56413,447
2022-06-06,Lake,033,64148,11216,11158,963,12121,137
2022-06-06,Lassen,035,31185,9159,9148,902,10050,64
2022-06-06,Los Angeles,037,10098052,2884936,2865901,137073,3002974,31920
2022-06-06,Madera,039,155013,38570,38408,6490,44898,372
2022-06-06,Marin,041,260295,38628,38338,4241,42579,294
2022-06-06,Mariposa,043,17540,2627,2614,243,2857,30
2022-06-06,Mendocino,045,87422,13964,13859,3553,17412,127
2022-06-06,Merced,047,269075,64386,64080,9319,73399,825
2022-06-06,Modoc,049,8938,764,761,260,1021,8
2022-06-06,Mono,051,14174,3051,3044,165,3209,6
2022-06-06,Monterey,053,433212,83533,83063,16033,99096,740
2022-06-06,Napa,055,140530,28299,27996,1192,29188,143
2022-06-06,Nevada,057,99092,17007,16907,1379,18286,127
2022-06-06,Orange,059,3164182,581096,578530,46485,625015,7044
2022-06-06,Placer,061,380077,67414,66951,8095,75046,627
2022-06-06,Plumas,063,18699,3174,3150,386,3536,13
2022-06-06,Riverside,065,2383286,615824,613469,29627,643096,6480
2022-06-06,Sacramento,067,1510023,302408,300875,29371,330246,3054
2022-06-06,San Benito,069,59416,13790,13734,644,14378,99
2022-06-06,San Bernardino,071,2135413,593884,585029,25914,610943,7685
2022-06-06,San Diego,073,3302833,803033,800840,58417,859257,5308
2022-06-06,San Francisco,075,870044,149408,147960,9832,157792,885
2022-06-06,San Joaquin,077,732212,174887,173887,11292,185179,2241
2022-06-06,San Luis Obispo,079,281455,56181,55822,4845,60667,484
2022-06-06,San Mateo,081,765935,141647,140569,8909,149478,710
2022-06-06,Santa Barbara,083,443738,92170,91747,5289,97036,693
2022-06-06,Santa Clara,085,1922200,359677,356452,15355,371807,2321
2022-06-06,Santa Cruz,087,273765,53359,52753,2555,55308,264
2022-06-06,Shasta,089,179085,31504,31394,6273,37667,565
2022-06-06,Sierra,091,2930,279,278,56,334,4
2022-06-06,Siskiyou,093,43540,4636,4609,2863,7472,81
2022-06-06,Solano,095,438530,89692,88522,6302,94824,453
2022-06-06,Sonoma,097,501317,93286,92644,3911,96555,491
2022-06-06,Stanislaus,099,539301,122364,121787,18414,140201,1662
2022-06-06,Sutter,101,95872,21287,21256,2234,23490,227
2022-06-06,Tehama,103,63373,12336,12306,2679,14985,205
2022-06-06,Trinity,105,12862,1213,1211,291,1502,20
2022-06-06,Tulare,107,460477,109290,109091,29272,138363,1494
2022-06-06,Tuolumne,109,53932,13435,13335,650,13985,189
2022-06-06,Ventura,111,848112,183761,182847,11004,193851,1506
2022-06-06,Yolo,113,214977,41443,39962,3434,43396,321
2022-06-06,Yuba,115,75493,16635,16558,1369,17927,122
2022-06-05,Alameda,001,1643700,291305,285785,16231,302016,1873
2022-06-05,Alpine,003,1148,128,128,1,129,0
2022-06-05,Amador,005,37829,8915,8775,712,9487,87
2022-06-05,Butte,007,227075,34664,34129,7496,41625,427
2022-06-05,Calaveras,009,45235,7590,7525,393,7918,121
2022-06-05,Colusa,011,21464,3502,3484,1083,4567,21
2022-06-05,Contra Costa,013,1133247,212363,206711,15843,222554,1310
2022-06-05,Del Norte,015,27424,6277,6206,257,6463,52
2022-06-05,El Dorado,017,186661,28605,28241,3526,31767,214
2022-06-05,Fresno,019,978130,239691,237945,24987,262932,2766
2022-06-05,Glenn,021,27897,5110,5063,1663,6726,48
2022-06-05,Humboldt,023,135768,18661,18433,3661,22094,147
2022-06-05,Imperial,025,180216,57022,56690,10988,67678,941
2022-06-05,Inyo,027,18085,4199,4176,579,4755,56
2022-06-05,Kern,029,883053,197190,195863,48149,244012,2338
2022-06-05,Kings,031,150075,52860,52597,3586,56183,447
2022-06-05,Lake,033,64148,11197,11064,959,12023,137
2022-06-05,Lassen,035,31185,9151,9106,898,10004,64
2022-06-05,Los Angeles,037,10098052,2878871,2846989,136549,2983538,31899
2022-06-05,Madera,039,155013,38508,38188,6475,44663,372
2022-06-05,Marin,041,260295,38515,37879,4208,42087,294
2022-06-05,Mariposa,043,17540,2625,2557,242,2799,30
2022-06-05,Mendocino,045,87422,13928,13738,3506,17244,125
2022-06-05,Merced,047,269075,64295,63756,9286,73042,825
2022-06-05,Modoc,049,8938,763,759,260,1019,8
2022-06-05,Mono,051,14174,3048,3037,163,3200,6
2022-06-05,Monterey,053,433212,83372,82451,15950,98401,738
2022-06-05,Napa,055,140530,28169,27686,1183,28869,143
2022-06-05,Nevada,057,99092,16964,16728,1363,18091,127
2022-06-05,Orange,059,3164182,579838,574146,46301,620447,7038
2022-06-05,Placer,061,380077,67273,66428,8081,74509,627
2022-06-05,Plumas,063,18699,3166,3138,386,3524,13
2022-06-05,Riverside,065,2383286,614890,610369,29563,639932,6481
2022-06-05,Sacramento,067,1510023,301496,297787,29227,327014,3052
2022-06-05,San Benito,069,59416,13745,13572,638,14210,99
2022-06-05,San Bernardino,071,2135413,592904,582305,25870,608175,7664
2022-06-05,San Diego,073,3302833,801131,794822,58226,853048,5303
2022-06-05,San Francisco,075,870044,148819,145876,9777,155653,881
2022-06-05,San Joaquin,077,732212,174454,172621,11246,183867,2242
2022-06-05,San Luis Obispo,079,281455,56019,55333,4772,60105,484
2022-06-05,San Mateo,081,765935,141134,138536,8863,147399,710
2022-06-05,Santa Barbara,083,443738,91978,90911,5270,96181,693
2022-06-05,Santa Clara,085,1922200,358269,351492,15265,366757,2317
2022-06-05,Santa Cruz,087,273765,53167,52333,2542,54875,263
2022-06-05,Shasta,089,179085,31463,31272,6262,37534,565
2022-06-05,Sierra,091,2930,279,278,56,334,4
2022-06-05,Siskiyou,093,43540,4631,4591,2851,7442,81
2022-06-05,Solano,095,438530,89353,87571,6286,93857,452
2022-06-05,Sonoma,097,501317,93006,91518,3882,95400,491
2022-06-05,Stanislaus,099,539301,122167,121001,18387,139388,1661
2022-06-05,Sutter,101,95872,21255,21125,2227,23352,227
2022-06-05,Tehama,103,63373,12317,12262,2676,14938,204
2022-06-05,Trinity,105,12862,1213,1204,291,1495,20
2022-06-05,Tulare,107,460477,109102,108598,29196,137794,1490
2022-06-05,Tuolumne,109,53932,13406,13251,637,13888,189
2022-06-05,Ventura,111,848112,183408,181709,10952,192661,1505
2022-06-05,Yolo,113,214977,41311,39561,3422,42983,321
2022-06-05,Yuba,115,75493,16595,16467,1361,17828,122
2022-06-04,Alameda,001,1643700,290805,285785,16211,301996,1873
2022-06-04,Alpine,003,1148,128,128,1,129,0
2022-06-04,Amador,005,37829,8906,8775,710,9485,87
2022-06-04,Butte,007,227075,34625,34129,7491,41620,427
2022-06-04,Calaveras,009,45235,7576,7525,393,7918,121
2022-06-04,Colusa,011,21464,3499,3484,1078,4562,21
2022-06-04,Contra Costa,013,1133247,211976,206711,15803,222514,1310
2022-06-04,Del Norte,015,27424,6275,6206,257,6463,52
2022-06-04,El Dorado,017,186661,28566,28241,3522,31763,214
2022-06-04,Fresno,019,978130,239520,237945,24970,262915,2766
2022-06-04,Glenn,021,27897,5106,5063,1662,6725,48
2022-06-04,Humboldt,023,135768,18639,18433,3655,22088,147
2022-06-04,Imperial,025,180216,56971,56690,10976,67666,941
2022-06-04,Inyo,027,18085,4199,4176,578,4754,56
2022-06-04,Kern,029,883053,197068,195863,48081,243944,2338
2022-06-04,Kings,031,150075,52817,52597,3586,56183,447
2022-06-04,Lake,033,64148,11182,11064,953,12017,137
2022-06-04,Lassen,035,31185,9146,9106,897,10003,64
2022-06-04,Los Angeles,037,10098052,2876423,2846989,136273,2983262,31899
2022-06-04,Madera,039,155013,38473,38188,6471,44659,372
2022-06-04,Marin,041,260295,38438,37879,4167,42046,294
2022-06-04,Mariposa,043,17540,2622,2557,242,2799,30
2022-06-04,Mendocino,045,87422,13915,13738,3505,17243,125
2022-06-04,Merced,047,269075,64245,63756,9278,73034,825
2022-06-04,Modoc,049,8938,762,759,259,1018,8
2022-06-04,Mono,051,14174,3048,3037,163,3200,6
2022-06-04,Monterey,053,433212,83287,82451,15915,98366,738
2022-06-04,Napa,055,140530,28127,27686,1181,28867,143
2022-06-04,Nevada,057,99092,16951,16728,1362,18090,127
2022-06-04,Orange,059,3164182,579197,574146,46178,620324,7038
2022-06-04,Placer,061,380077,67191,66428,8073,74501,627
2022-06-04,Plumas,063,18699,3162,3138,385,3523,13
2022-06-04,Riverside,065,2383286,614355,610369,29538,639907,6481
2022-06-04,Sacramento,067,1510023,301140,297787,29200,326987,3052
2022-06-04,San Benito,069,59416,13719,13572,635,14207,99
2022-06-04,San Bernardino,071,2135413,592453,582305,25841,608146,7664
2022-06-04,San Diego,073,3302833,800403,794822,58182,853004,5303
2022-06-04,San Francisco,075,870044,148486,145876,9756,155632,881
2022-06-04,San Joaquin,077,732212,174309,172621,11212,183833,2242
2022-06-04,San Luis Obispo,079,281455,55981,55333,4765,60098,484
2022-06-04,San Mateo,081,765935,140830,138536,8835,147371,710
2022-06-04,Santa Barbara,083,443738,91880,90911,5249,96160,693
2022-06-04,Santa Clara,085,1922200,357390,351492,15224,366716,2317
2022-06-04,Santa Cruz,087,273765,53082,52333,2529,54862,263
2022-06-04,Shasta,089,179085,31440,31272,6259,37531,565
2022-06-04,Sierra,091,2930,279,278,56,334,4
2022-06-04,Siskiyou,093,43540,4627,4591,2845,7436,81
2022-06-04,Solano,095,438530,89270,87571,6273,93844,452
2022-06-04,Sonoma,097,501317,92854,91518,3868,95386,491
2022-06-04,Stanislaus,099,539301,122028,121001,18374,139375,1661
2022-06-04,Sutter,101,95872,21228,21125,2224,23349,227
2022-06-04,Tehama,103,63373,12303,12262,2675,14937,204
2022-06-04,Trinity,105,12862,1213,1204,291,1495,20
2022-06-04,Tulare,107,460477,109036,108598,29154,137752,1490
2022-06-04,Tuolumne,109,53932,13396,13251,634,13885,189
2022-06-04,Ventura,111,848112,183223,181709,10937,192646,1505
2022-06-04,Yolo,113,214977,41233,39561,3417,42978,321
2022-06-04,Yuba,115,75493,16579,16467,1357,17824,122
2022-06-03,Alameda,001,1643700,290274,285785,16185,301970,1873
2022-06-03,Alpine,003,1148,128,128,1,129,0
2022-06-03,Amador,005,37829,8900,8775,708,9483,87
2022-06-03,Butte,007,227075,34574,34129,7482,41611,427
2022-06-03,Calaveras,009,45235,7571,7525,393,7918,121
2022-06-03,Colusa,011,21464,3499,3484,1076,4560,21
2022-06-03,Contra Costa,013,1133247,211665,206711,15774,222485,1310
2022-06-03,Del Norte,015,27424,6271,6206,254,6460,52
2022-06-03,El Dorado,017,186661,28537,28241,3519,31760,214
2022-06-03,Fresno,019,978130,239290,237945,24942,262887,2766
2022-06-03,Glenn,021,27897,5100,5063,1659,6722,48
2022-06-03,Humboldt,023,135768,18619,18433,3649,22082,147
2022-06-03,Imperial,025,180216,56925,56690,10966,67656,941
2022-06-03,Inyo,027,18085,4198,4176,578,4754,56
2022-06-03,Kern,029,883053,196927,195863,48014,243877,2338
2022-06-03,Kings,031,150075,52793,52597,3586,56183,447
2022-06-03,Lake,033,64148,11171,11064,950,12014,137
2022-06-03,Lassen,035,31185,9141,9106,897,10003,64
2022-06-03,Los Angeles,037,10098052,2873522,2846989,135989,2982978,31899
2022-06-03,Madera,039,155013,38429,38188,6462,44650,372
2022-06-03,Marin,041,260295,38369,37879,4132,42011,294
2022-06-03,Mariposa,043,17540,2618,2557,242,2799,30
2022-06-03,Mendocino,045,87422,13893,13738,3504,17242,125
2022-06-03,Merced,047,269075,64195,63756,9275,73031,825
2022-06-03,Modoc,049,8938,762,759,259,1018,8
2022-06-03,Mono,051,14174,3045,3037,163,3200,6
2022-06-03,Monterey,053,433212,83188,82451,15868,98319,738
2022-06-03,Napa,055,140530,28077,27686,1173,28859,143
2022-06-03,Nevada,057,99092,16930,16728,1361,18089,127
2022-06-03,Orange,059,3164182,578508,574146,46074,620220,7038
2022-06-03,Placer,061,380077,67110,66428,8060,74488,627
2022-06-03,Plumas,063,18699,3160,3138,384,3522,13
2022-06-03,Riverside,065,2383286,613830,610369,29508,639877,6481
2022-06-03,Sacramento,067,1510023,300668,297787,29167,326954,3052
2022-06-03,San Benito,069,59416,13706,13572,631,14203,99
2022-06-03,San Bernardino,071,2135413,591992,582305,25805,608110,7664
2022-06-03,San Diego,073,3302833,799453,794822,58063,852885,5303
2022-06-03,San Francisco,075,870044,148113,145876,9724,155600,881
2022-06-03,San Joaquin,077,732212,174146,172621,11194,183815,2242
2022-06-03,San Luis Obispo,079,281455,55936,55333,4757,60090,484
2022-06-03,San Mateo,081,765935,140547,138536,8822,147358,710
2022-06-03,Santa Barbara,083,443738,91761,90911,5247,96158,693
2022-06-03,Santa Clara,085,1922200,356497,351492,15178,366670,2317
2022-06-03,Santa Cruz,087,273765,52950,52333,2516,54849,263
2022-06-03,Shasta,089,179085,31428,31272,6258,37530,565
2022-06-03,Sierra,091,2930,279,278,56,334,4
2022-06-03,Siskiyou,093,43540,4622,4591,2844,7435,81
2022-06-03,Solano,095,438530,89155,87571,6264,93835,452
2022-06-03,Sonoma,097,501317,92709,91518,3859,95377,491
2022-06-03,Stanislaus,099,539301,121922,121001,18357,139358,1661
2022-06-03,Sutter,101,95872,21205,21125,2223,23348,227
2022-06-03,Tehama,103,63373,12297,12262,2674,14936,204
2022-06-03,Trinity,105,12862,1211,1204,291,1495,20
2022-06-03,Tulare,107,460477,108968,108598,29119,137717,1490
2022-06-03,Tuolumne,109,53932,13385,13251,631,13882,189
2022-06-03,Ventura,111,848112,183034,181709,10912,192621,1505
2022-06-03,Yolo,113,214977,41170,39561,3403,42964,321
2022-06-03,Yuba,115,75493,16554,16467,1355,17822,122
2022-06-02,Alameda,001,1643700,289379,285785,16122,301907,1873
2022-06-02,Alpine,003,1148,128,128,1,129,0
2022-06-02,Amador,005,37829,8877,8775,706,9481,87
2022-06-02,Butte,007,227075,34499,34129,7466,41595,427
2022-06-02,Calaveras,009,45235,7558,7525,392,7917,121
2022-06-02,Colusa,011,21464,3496,3484,1076,4560,21
2022-06-02,Contra Costa,013,1133247,211079,206711,15682,222393,1310
2022-06-02,Del Norte,015,27424,6261,6206,253,6459,52
2022-06-02,El Dorado,017,186661,28470,28241,3507,31748,214
2022-06-02,Fresno,019,978130,238949,237945,24885,262830,2766
2022-06-02,Glenn,021,27897,5094,5063,1654,6717,48
2022-06-02,Humboldt,023,135768,18578,18433,3628,22061,147
2022-06-02,Imperial,025,180216,56866,56690,10955,67645,941
2022-06-02,Inyo,027,18085,4198,4176,575,4751,56
2022-06-02,Kern,029,883053,196643,195863,47910,243773,2338
2022-06-02,Kings,031,150075,52740,52597,3581,56178,447
2022-06-02,Lake,033,64148,11149,11064,948,12012,137
2022-06-02,Lassen,035,31185,9130,9106,897,10003,64
2022-06-02,Los Angeles,037,10098052,2868607,2846989,135568,2982557,31899
2022-06-02,Madera,039,155013,38375,38188,6449,44637,372
2022-06-02,Marin,041,260295,38271,37879,4105,41984,294
2022-06-02,Mariposa,043,17540,2613,2557,241,2798,30
2022-06-02,Mendocino,045,87422,13864,13738,3496,17234,125
2022-06-02,Merced,047,269075,64117,63756,9266,73022,825
2022-06-02,Modoc,049,8938,761,759,259,1018,8
2022-06-02,Mono,051,14174,3045,3037,163,3200,6
2022-06-02,Monterey,053,433212,83038,82451,15804,98255,738
2022-06-02,Napa,055,140530,28001,27686,1170,28856,143
2022-06-02,Nevada,057,99092,16893,16728,1356,18084,127
2022-06-02,Orange,059,3164182,577478,574146,45929,620075,7038
2022-06-02,Placer,061,380077,66989,66428,8046,74474,627
2022-06-02,Plumas,063,18699,3151,3138,384,3522,13
2022-06-02,Riverside,065,2383286,613144,610369,29449,639818,6481
2022-06-02,Sacramento,067,1510023,300028,297787,29061,326848,3052
2022-06-02,San Benito,069,59416,13673,13572,628,14200,99
2022-06-02,San Bernardino,071,2135413,591308,582305,25760,608065,7664
2022-06-02,San Diego,073,3302833,798080,794822,57900,852722,5303
2022-06-02,San Francisco,075,870044,147690,145876,9674,155550,881
2022-06-02,San Joaquin,077,732212,173836,172621,11165,183786,2242
2022-06-02,San Luis Obispo,079,281455,55806,55333,4722,60055,484
2022-06-02,San Mateo,081,765935,140169,138536,8769,147305,710
2022-06-02,Santa Barbara,083,443738,91587,90911,5232,96143,693
2022-06-02,Santa Clara,085,1922200,355402,351492,15058,366550,2317
2022-06-02,Santa Cruz,087,273765,52834,52333,2505,54838,263
2022-06-02,Shasta,089,179085,31397,31272,6251,37523,565
2022-06-02,Sierra,091,2930,279,278,56,334,4
2022-06-02,Siskiyou,093,43540,4615,4591,2835,7426,81
2022-06-02,Solano,095,438530,88883,87571,6254,93825,452
2022-06-02,Sonoma,097,501317,92483,91518,3833,95351,491
2022-06-02,Stanislaus,099,539301,121764,121001,18334,139335,1661
2022-06-02,Sutter,101,95872,21178,21125,2217,23342,227
2022-06-02,Tehama,103,63373,12286,12262,2667,14929,204
2022-06-02,Trinity,105,12862,1209,1204,291,1495,20
2022-06-02,Tulare,107,460477,108837,108598,29053,137651,1490
2022-06-02,Tuolumne,109,53932,13366,13251,629,13880,189
2022-06-02,Ventura,111,848112,182761,181709,10878,192587,1505
2022-06-02,Yolo,113,214977,41061,39561,3393,42954,321
2022-06-02,Yuba,115,75493,16533,16467,1348,17815,122
2022-06-01,Alameda,001,1643700,288375,284051,16066,300117,1868
2022-06-01,Alpine,003,1148,128,128,1,129,0
2022-06-01,Amador,005,37829,8871,8741,704,9445,87
2022-06-01,Butte,007,227075,34430,34059,7452,41511,427
2022-06-01,Calaveras,009,45235,7553,7502,389,7891,120
2022-06-01,Colusa,011,21464,3493,3476,1076,4552,21
2022-06-01,Contra Costa,013,1133247,210437,205699,15605,221304,1310
2022-06-01,Del Norte,015,27424,6251,6188,252,6440,51
2022-06-01,El Dorado,017,186661,28408,28133,3489,31622,214
2022-06-01,Fresno,019,978130,238593,237367,24831,262198,2765
2022-06-01,Glenn,021,27897,5089,5059,1654,6713,48
2022-06-01,Humboldt,023,135768,18535,18371,3605,21976,147
2022-06-01,Imperial,025,180216,56799,56445,10928,67373,938
2022-06-01,Inyo,027,18085,4194,4171,569,4740,56
2022-06-01,Kern,029,883053,196418,195438,47831,243269,2336
2022-06-01,Kings,031,150075,52683,52491,3577,56068,447
2022-06-01,Lake,033,64148,11128,11024,943,11967,137
2022-06-01,Lassen,035,31185,9117,9083,896,9979,64
2022-06-01,Los Angeles,037,10098052,2863212,2836856,135139,2971995,31882
2022-06-01,Madera,039,155013,38337,38115,6435,44550,372
2022-06-01,Marin,041,260295,38156,37654,4064,41718,293
2022-06-01,Mariposa,043,17540,2598,2549,240,2789,30
2022-06-01,Mendocino,045,87422,13837,13692,3480,17172,125
2022-06-01,Merced,047,269075,64035,63637,9248,72885,824
2022-06-01,Modoc,049,8938,758,755,258,1013,8
2022-06-01,Mono,051,14174,3043,3035,162,3197,6
2022-06-01,Monterey,053,433212,82884,82215,15741,97956,737
2022-06-01,Napa,055,140530,27924,27580,1160,28740,143
2022-06-01,Nevada,057,99092,16854,16693,1347,18040,127
2022-06-01,Orange,059,3164182,576230,571973,45774,617747,7032
2022-06-01,Placer,061,380077,66847,66199,8015,74214,627
2022-06-01,Plumas,063,18699,3144,3117,383,3500,13
2022-06-01,Riverside,065,2383286,612411,608913,29403,638316,6480
2022-06-01,Sacramento,067,1510023,299277,296457,28956,325413,3045
2022-06-01,San Benito,069,59416,13635,13510,617,14127,98
2022-06-01,San Bernardino,071,2135413,590592,580767,25722,606489,7641
2022-06-01,San Diego,073,3302833,796386,791557,57701,849258,5292
2022-06-01,San Francisco,075,870044,147165,144476,9633,154109,879
2022-06-01,San Joaquin,077,732212,173538,172170,11136,183306,2241
2022-06-01,San Luis Obispo,079,281455,55640,55099,4689,59788,482
2022-06-01,San Mateo,081,765935,139688,137566,8697,146263,710
2022-06-01,Santa Barbara,083,443738,91404,90531,5217,95748,693
2022-06-01,Santa Clara,085,1922200,354236,348742,14975,363717,2317
2022-06-01,Santa Cruz,087,273765,52721,52141,2495,54636,263
2022-06-01,Shasta,089,179085,31366,31247,6248,37495,564
2022-06-01,Sierra,091,2930,279,280,56,336,4
2022-06-01,Siskiyou,093,43540,4610,4574,2830,7404,81
2022-06-01,Solano,095,438530,88650,87206,6227,93433,452
2022-06-01,Sonoma,097,501317,92230,91174,3809,94983,491
2022-06-01,Stanislaus,099,539301,121573,120778,18317,139095,1656
2022-06-01,Sutter,101,95872,21148,21065,2213,23278,227
2022-06-01,Tehama,103,63373,12279,12245,2663,14908,204
2022-06-01,Trinity,105,12862,1208,1200,290,1490,20
2022-06-01,Tulare,107,460477,108725,108401,28996,137397,1490
2022-06-01,Tuolumne,109,53932,13352,13221,628,13849,189
2022-06-01,Ventura,111,848112,182477,181163,10848,192011,1503
2022-06-01,Yolo,113,214977,40977,39371,3382,42753,320
2022-06-01,Yuba,115,75493,16509,16406,1340,17746,122
2022-05-31,Alameda,001,1643700,287272,284051,16012,300063,1868
2022-05-31,Alpine,003,1148,128,128,1,129,0
2022-05-31,Amador,005,37829,8853,8741,698,9439,87
2022-05-31,Butte,007,227075,34369,34059,7434,41493,427
2022-05-31,Calaveras,009,45235,7542,7502,389,7891,120
2022-05-31,Colusa,011,21464,3488,3476,1075,4551,21
2022-05-31,Contra Costa,013,1133247,209691,205699,15510,221209,1310
2022-05-31,Del Norte,015,27424,6241,6188,250,6438,51
2022-05-31,El Dorado,017,186661,28346,28133,3469,31602,214
2022-05-31,Fresno,019,978130,238196,237367,24764,262131,2765
2022-05-31,Glenn,021,27897,5081,5059,1652,6711,48
2022-05-31,Humboldt,023,135768,18504,18371,3585,21956,147
2022-05-31,Imperial,025,180216,56735,56445,10904,67349,938
2022-05-31,Inyo,027,18085,4188,4171,567,4738,56
2022-05-31,Kern,029,883053,196175,195438,47736,243174,2336
2022-05-31,Kings,031,150075,52632,52491,3570,56061,447
2022-05-31,Lake,033,64148,11109,11024,939,11963,137
2022-05-31,Lassen,035,31185,9105,9083,895,9978,64
2022-05-31,Los Angeles,037,10098052,2857139,2836856,134677,2971533,31882
2022-05-31,Madera,039,155013,38273,38115,6416,44531,372
2022-05-31,Marin,041,260295,38018,37654,4028,41682,293
2022-05-31,Mariposa,043,17540,2592,2549,235,2784,30
2022-05-31,Mendocino,045,87422,13802,13692,3463,17155,125
2022-05-31,Merced,047,269075,63948,63637,9225,72862,824
2022-05-31,Modoc,049,8938,756,755,258,1013,8
2022-05-31,Mono,051,14174,3039,3035,162,3197,6
2022-05-31,Monterey,053,433212,82726,82215,15675,97890,737
2022-05-31,Napa,055,140530,27830,27580,1157,28737,143
2022-05-31,Nevada,057,99092,16808,16693,1345,18038,127
2022-05-31,Orange,059,3164182,575002,571973,45592,617565,7032
2022-05-31,Placer,061,380077,66687,66199,7985,74184,627
2022-05-31,Plumas,063,18699,3140,3117,382,3499,13
2022-05-31,Riverside,065,2383286,611498,608913,29341,638254,6480
2022-05-31,Sacramento,067,1510023,298416,296457,28816,325273,3045
2022-05-31,San Benito,069,59416,13579,13510,612,14122,98
2022-05-31,San Bernardino,071,2135413,589700,580767,25687,606454,7641
2022-05-31,San Diego,073,3302833,794507,791557,57498,849055,5292
2022-05-31,San Francisco,075,870044,146521,144476,9591,154067,879
2022-05-31,San Joaquin,077,732212,173160,172170,11097,183267,2241
2022-05-31,San Luis Obispo,079,281455,55490,55099,4625,59724,482
2022-05-31,San Mateo,081,765935,139130,137566,8655,146221,710
2022-05-31,Santa Barbara,083,443738,91180,90531,5194,95725,693
2022-05-31,Santa Clara,085,1922200,352723,348742,14898,363640,2317
2022-05-31,Santa Cruz,087,273765,52600,52141,2475,54616,263
2022-05-31,Shasta,089,179085,31332,31247,6237,37484,564
2022-05-31,Sierra,091,2930,278,280,55,335,4
2022-05-31,Siskiyou,093,43540,4605,4574,2824,7398,81
2022-05-31,Solano,095,438530,88321,87206,6205,93411,452
2022-05-31,Sonoma,097,501317,91941,91174,3769,94943,491
2022-05-31,Stanislaus,099,539301,121369,120778,18295,139073,1656
2022-05-31,Sutter,101,95872,21119,21065,2207,23272,227
2022-05-31,Tehama,103,63373,12270,12245,2658,14903,204
2022-05-31,Trinity,105,12862,1207,1200,290,1490,20
2022-05-31,Tulare,107,460477,108587,108401,28937,137338,1490
2022-05-31,Tuolumne,109,53932,13337,13221,625,13846,189
2022-05-31,Ventura,111,848112,182157,181163,10800,191963,1503
2022-05-31,Yolo,113,214977,40803,39371,3371,42742,320
2022-05-31,Yuba,115,75493,16477,16406,1334,17740,122
2022-05-30,Alameda,001,1643700,285896,284051,15923,299974,1868
2022-05-30,Alpine,003,1148,128,128,1,129,0
2022-05-30,Amador,005,37829,8838,8741,697,9438,87
2022-05-30,Butte,007,227075,34294,34059,7411,41470,427
2022-05-30,Calaveras,009,45235,7533,7502,389,7891,120
2022-05-30,Colusa,011,21464,3486,3476,1074,4550,21
2022-05-30,Contra Costa,013,1133247,208849,205699,15374,221073,1310
2022-05-30,Del Norte,015,27424,6224,6188,249,6437,51
2022-05-30,El Dorado,017,186661,28270,28133,3449,31582,214
2022-05-30,Fresno,019,978130,237723,237367,24693,262060,2765
2022-05-30,Glenn,021,27897,5076,5059,1649,6708,48
2022-05-30,Humboldt,023,135768,18450,18371,3557,21928,147
2022-05-30,Imperial,025,180216,56654,56445,10877,67322,938
2022-05-30,Inyo,027,18085,4183,4171,566,4737,56
2022-05-30,Kern,029,883053,195895,195438,47622,243060,2336
2022-05-30,Kings,031,150075,52536,52491,3570,56061,447
2022-05-30,Lake,033,64148,11080,11024,930,11954,137
2022-05-30,Lassen,035,31185,9090,9083,892,9975,64
2022-05-30,Los Angeles,037,10098052,2849811,2836856,134175,2971031,31882
2022-05-30,Madera,039,155013,38217,38115,6376,44491,372
2022-05-30,Marin,041,260295,37893,37654,3986,41640,293
2022-05-30,Mariposa,043,17540,2569,2549,231,2780,30
2022-05-30,Mendocino,045,87422,13755,13692,3445,17137,125
2022-05-30,Merced,047,269075,63852,63637,9186,72823,824
2022-05-30,Modoc,049,8938,753,755,256,1011,8
2022-05-30,Mono,051,14174,3036,3035,162,3197,6
2022-05-30,Monterey,053,433212,82539,82215,15587,97802,737
2022-05-30,Napa,055,140530,27753,27580,1149,28729,143
2022-05-30,Nevada,057,99092,16761,16693,1340,18033,127
2022-05-30,Orange,059,3164182,573536,571973,45379,617352,7032
2022-05-30,Placer,061,380077,66546,66199,7955,74154,627
2022-05-30,Plumas,063,18699,3134,3117,379,3496,13
2022-05-30,Riverside,065,2383286,610492,608913,29263,638176,6480
2022-05-30,Sacramento,067,1510023,297459,296457,28657,325114,3045
2022-05-30,San Benito,069,59416,13517,13510,604,14114,98
2022-05-30,San Bernardino,071,2135413,588700,580767,25651,606418,7641
2022-05-30,San Diego,073,3302833,792235,791557,57205,848762,5292
2022-05-30,San Francisco,075,870044,145859,144476,9537,154013,879
2022-05-30,San Joaquin,077,732212,172763,172170,11058,183228,2241
2022-05-30,San Luis Obispo,079,281455,55285,55099,4556,59655,482
2022-05-30,San Mateo,081,765935,138453,137566,8603,146169,710
2022-05-30,Santa Barbara,083,443738,90924,90531,5160,95691,693
2022-05-30,Santa Clara,085,1922200,351166,348742,14807,363549,2317
2022-05-30,Santa Cruz,087,273765,52462,52141,2465,54606,263
2022-05-30,Shasta,089,179085,31294,31247,6230,37477,564
2022-05-30,Sierra,091,2930,278,280,55,335,4
2022-05-30,Siskiyou,093,43540,4596,4574,2812,7386,81
2022-05-30,Solano,095,438530,87977,87206,6152,93358,452
2022-05-30,Sonoma,097,501317,91653,91174,3725,94899,491
2022-05-30,Stanislaus,099,539301,121177,120778,18267,139045,1656
2022-05-30,Sutter,101,95872,21080,21065,2201,23266,227
2022-05-30,Tehama,103,63373,12254,12245,2654,14899,204
2022-05-30,Trinity,105,12862,1206,1200,290,1490,20
2022-05-30,Tulare,107,460477,108428,108401,28848,137249,1490
2022-05-30,Tuolumne,109,53932,13313,13221,621,13842,189
2022-05-30,Ventura,111,848112,181784,181163,10750,191913,1503
2022-05-30,Yolo,113,214977,40612,39371,3361,42732,320
2022-05-30,Yuba,115,75493,16449,16406,1330,17736,122
2022-05-29,Alameda,001,1643700,285418,280775,15899,296674,1863
2022-05-29,Alpine,003,1148,128,126,1,127,0
2022-05-29,Amador,005,37829,8833,8696,694,9390,86
2022-05-29,Butte,007,227075,34278,33876,7404,41280,426
2022-05-29,Calaveras,009,45235,7522,7469,389,7858,120
2022-05-29,Colusa,011,21464,3485,3474,1073,4547,21
2022-05-29,Contra Costa,013,1133247,208504,203528,15350,218878,1306
2022-05-29,Del Norte,015,27424,6222,6166,248,6414,51
2022-05-29,El Dorado,017,186661,28243,27898,3446,31344,214
2022-05-29,Fresno,019,978130,237597,236250,24674,260924,2764
2022-05-29,Glenn,021,27897,5071,5048,1649,6697,48
2022-05-29,Humboldt,023,135768,18429,18257,3546,21803,147
2022-05-29,Imperial,025,180216,56617,56323,10863,67186,939
2022-05-29,Inyo,027,18085,4182,4161,566,4727,56
2022-05-29,Kern,029,883053,195797,194687,47558,242245,2334
2022-05-29,Kings,031,150075,52511,52292,3570,55862,447
2022-05-29,Lake,033,64148,11071,10958,928,11886,137
2022-05-29,Lassen,035,31185,9086,9049,892,9941,64
2022-05-29,Los Angeles,037,10098052,2847614,2819145,133908,2953053,31862
2022-05-29,Madera,039,155013,38194,37955,6371,44326,371
2022-05-29,Marin,041,260295,37825,37215,3954,41169,293
2022-05-29,Mariposa,043,17540,2564,2526,231,2757,31
2022-05-29,Mendocino,045,87422,13734,13612,3444,17056,124
2022-05-29,Merced,047,269075,63831,63389,9183,72572,824
2022-05-29,Modoc,049,8938,753,751,256,1007,8
2022-05-29,Mono,051,14174,3035,3030,162,3192,6
2022-05-29,Monterey,053,433212,82475,81875,15543,97418,737
2022-05-29,Napa,055,140530,27725,27376,1148,28524,144
2022-05-29,Nevada,057,99092,16746,16568,1338,17906,127
2022-05-29,Orange,059,3164182,572960,568369,45206,613575,7028
2022-05-29,Placer,061,380077,66476,65672,7946,73618,626
2022-05-29,Plumas,063,18699,3127,3096,379,3475,13
2022-05-29,Riverside,065,2383286,610149,606444,29228,635672,6480
2022-05-29,Sacramento,067,1510023,297008,294000,28635,322635,3032
2022-05-29,San Benito,069,59416,13511,13402,602,14004,98
2022-05-29,San Bernardino,071,2135413,588409,578656,25635,604291,7610
2022-05-29,San Diego,073,3302833,791498,786243,57127,843370,5288
2022-05-29,San Francisco,075,870044,145429,142456,9528,151984,879
2022-05-29,San Joaquin,077,732212,172600,171282,11040,182322,2241
2022-05-29,San Luis Obispo,079,281455,55233,54701,4544,59245,481
2022-05-29,San Mateo,081,765935,138202,135746,8590,144336,710
2022-05-29,Santa Barbara,083,443738,90795,89940,5159,95099,693
2022-05-29,Santa Clara,085,1922200,350369,344223,14768,358991,2304
2022-05-29,Santa Cruz,087,273765,52386,51819,2458,54277,263
2022-05-29,Shasta,089,179085,31282,31165,6226,37391,564
2022-05-29,Sierra,091,2930,278,278,55,333,4
2022-05-29,Siskiyou,093,43540,4591,4537,2810,7347,81
2022-05-29,Solano,095,438530,87924,86565,6141,92706,452
2022-05-29,Sonoma,097,501317,91561,90364,3710,94074,490
2022-05-29,Stanislaus,099,539301,121078,120241,18251,138492,1657
2022-05-29,Sutter,101,95872,21060,20976,2201,23177,227
2022-05-29,Tehama,103,63373,12244,12210,2653,14863,204
2022-05-29,Trinity,105,12862,1205,1196,290,1486,20
2022-05-29,Tulare,107,460477,108344,108029,28803,136832,1484
2022-05-29,Tuolumne,109,53932,13298,13141,621,13762,189
2022-05-29,Ventura,111,848112,181639,179953,10741,190694,1503
2022-05-29,Yolo,113,214977,40560,39016,3358,42374,319
2022-05-29,Yuba,115,75493,16433,16314,1326,17640,122
2022-05-28,Alameda,001,1643700,285042,280775,15874,296649,1863
2022-05-28,Alpine,003,1148,128,126,1,127,0
2022-05-28,Amador,005,37829,8824,8696,694,9390,86
2022-05-28,Butte,007,227075,34254,33876,7388,41264,426
2022-05-28,Calaveras,009,45235,7518,7469,389,7858,120
2022-05-28,Colusa,011,21464,3480,3474,1072,4546,21
2022-05-28,Contra Costa,013,1133247,208238,203528,15325,218853,1306
2022-05-28,Del Norte,015,27424,6218,6166,246,6412,51
2022-05-28,El Dorado,017,186661,28213,27898,3445,31343,214
2022-05-28,Fresno,019,978130,237439,236250,24643,260893,2764
2022-05-28,Glenn,021,27897,5068,5048,1649,6697,48
2022-05-28,Humboldt,023,135768,18405,18257,3536,21793,147
2022-05-28,Imperial,025,180216,56591,56323,10853,67176,939
2022-05-28,Inyo,027,18085,4182,4161,564,4725,56
2022-05-28,Kern,029,883053,195699,194687,47507,242194,2334
2022-05-28,Kings,031,150075,52487,52292,3569,55861,447
2022-05-28,Lake,033,64148,11061,10958,928,11886,137
2022-05-28,Lassen,035,31185,9081,9049,892,9941,64
2022-05-28,Los Angeles,037,10098052,2845633,2819145,133642,2952787,31862
2022-05-28,Madera,039,155013,38177,37955,6368,44323,371
2022-05-28,Marin,041,260295,37758,37215,3924,41139,293
2022-05-28,Mariposa,043,17540,2560,2526,231,2757,31
2022-05-28,Mendocino,045,87422,13722,13612,3444,17056,124
2022-05-28,Merced,047,269075,63797,63389,9179,72568,824
2022-05-28,Modoc,049,8938,753,751,256,1007,8
2022-05-28,Mono,051,14174,3035,3030,161,3191,6
2022-05-28,Monterey,053,433212,82408,81875,15511,97386,737
2022-05-28,Napa,055,140530,27680,27376,1147,28523,144
2022-05-28,Nevada,057,99092,16734,16568,1336,17904,127
2022-05-28,Orange,059,3164182,572448,568369,45088,613457,7028
2022-05-28,Placer,061,380077,66401,65672,7932,73604,626
2022-05-28,Plumas,063,18699,3121,3096,378,3474,13
2022-05-28,Riverside,065,2383286,609771,606444,29200,635644,6480
2022-05-28,Sacramento,067,1510023,296736,294000,28617,322617,3032
2022-05-28,San Benito,069,59416,13496,13402,602,14004,98
2022-05-28,San Bernardino,071,2135413,588043,578656,25608,604264,7610
2022-05-28,San Diego,073,3302833,790839,786243,57080,843323,5288
2022-05-28,San Francisco,075,870044,145124,142456,9507,151963,879
2022-05-28,San Joaquin,077,732212,172495,171282,11024,182306,2241
2022-05-28,San Luis Obispo,079,281455,55198,54701,4541,59242,481
2022-05-28,San Mateo,081,765935,137929,135746,8563,144309,710
2022-05-28,Santa Barbara,083,443738,90695,89940,5149,95089,693
2022-05-28,Santa Clara,085,1922200,349581,344223,14741,358964,2304
2022-05-28,Santa Cruz,087,273765,52344,51819,2450,54269,263
2022-05-28,Shasta,089,179085,31271,31165,6221,37386,564
2022-05-28,Sierra,091,2930,278,278,54,332,4
2022-05-28,Siskiyou,093,43540,4583,4537,2806,7343,81
2022-05-28,Solano,095,438530,87851,86565,6131,92696,452
2022-05-28,Sonoma,097,501317,91421,90364,3699,94063,490
2022-05-28,Stanislaus,099,539301,120979,120241,18245,138486,1657
2022-05-28,Sutter,101,95872,21045,20976,2199,23175,227
2022-05-28,Tehama,103,63373,12232,12210,2650,14860,204
2022-05-28,Trinity,105,12862,1204,1196,290,1486,20
2022-05-28,Tulare,107,460477,108285,108029,28770,136799,1484
2022-05-28,Tuolumne,109,53932,13283,13141,620,13761,189
2022-05-28,Ventura,111,848112,181472,179953,10721,190674,1503
2022-05-28,Yolo,113,214977,40506,39016,3351,42367,319
2022-05-28,Yuba,115,75493,16419,16314,1324,17638,122
2022-05-27,Alameda,001,1643700,284569,280775,15837,296612,1863
2022-05-27,Alpine,003,1148,127,126,1,127,0
2022-05-27,Amador,005,37829,8819,8696,694,9390,86
2022-05-27,Butte,007,227075,34227,33876,7372,41248,426
2022-05-27,Calaveras,009,45235,7511,7469,389,7858,120
2022-05-27,Colusa,011,21464,3480,3474,1072,4546,21
2022-05-27,Contra Costa,013,1133247,207957,203528,15293,218821,1306
2022-05-27,Del Norte,015,27424,6212,6166,246,6412,51
2022-05-27,El Dorado,017,186661,28189,27898,3437,31335,214
2022-05-27,Fresno,019,978130,237267,236250,24611,260861,2764
2022-05-27,Glenn,021,27897,5066,5048,1648,6696,48
2022-05-27,Humboldt,023,135768,18395,18257,3530,21787,147
2022-05-27,Imperial,025,180216,56508,56323,10848,67171,939
2022-05-27,Inyo,027,18085,4180,4161,563,4724,56
2022-05-27,Kern,029,883053,195590,194687,47440,242127,2334
2022-05-27,Kings,031,150075,52459,52292,3566,55858,447
2022-05-27,Lake,033,64148,11055,10958,926,11884,137
2022-05-27,Lassen,035,31185,9077,9049,892,9941,64
2022-05-27,Los Angeles,037,10098052,2843283,2819145,133395,2952540,31862
2022-05-27,Madera,039,155013,38143,37955,6359,44314,371
2022-05-27,Marin,041,260295,37692,37215,3890,41105,293
2022-05-27,Mariposa,043,17540,2554,2526,231,2757,31
2022-05-27,Mendocino,045,87422,13705,13612,3440,17052,124
2022-05-27,Merced,047,269075,63752,63389,9177,72566,824
2022-05-27,Modoc,049,8938,753,751,256,1007,8
2022-05-27,Mono,051,14174,3034,3030,161,3191,6
2022-05-27,Monterey,053,433212,82349,81875,15465,97340,737
2022-05-27,Napa,055,140530,27647,27376,1144,28520,144
2022-05-27,Nevada,057,99092,16723,16568,1332,17900,127
2022-05-27,Orange,059,3164182,571891,568369,44978,613347,7028
2022-05-27,Placer,061,380077,66332,65672,7922,73594,626
2022-05-27,Plumas,063,18699,3118,3096,378,3474,13
2022-05-27,Riverside,065,2383286,609359,606444,29168,635612,6480
2022-05-27,Sacramento,067,1510023,296358,294000,28579,322579,3032
2022-05-27,San Benito,069,59416,13484,13402,602,14004,98
2022-05-27,San Bernardino,071,2135413,587705,578656,25583,604239,7610
2022-05-27,San Diego,073,3302833,789960,786243,56989,843232,5288
2022-05-27,San Francisco,075,870044,144794,142456,9467,151923,879
2022-05-27,San Joaquin,077,732212,172365,171282,11005,182287,2241
2022-05-27,San Luis Obispo,079,281455,55137,54701,4528,59229,481
2022-05-27,San Mateo,081,765935,137679,135746,8538,144284,710
2022-05-27,Santa Barbara,083,443738,90606,89940,5148,95088,693
2022-05-27,Santa Clara,085,1922200,348829,344223,14723,358946,2304
2022-05-27,Santa Cruz,087,273765,52289,51819,2438,54257,263
2022-05-27,Shasta,089,179085,31261,31165,6215,37380,564
2022-05-27,Sierra,091,2930,278,278,54,332,4
2022-05-27,Siskiyou,093,43540,4580,4537,2804,7341,81
2022-05-27,Solano,095,438530,87725,86565,6120,92685,452
2022-05-27,Sonoma,097,501317,91276,90364,3687,94051,490
2022-05-27,Stanislaus,099,539301,120896,120241,18231,138472,1657
2022-05-27,Sutter,101,95872,21028,20976,2198,23174,227
2022-05-27,Tehama,103,63373,12229,12210,2649,14859,204
2022-05-27,Trinity,105,12862,1204,1196,290,1486,20
2022-05-27,Tulare,107,460477,108218,108029,28733,136762,1484
2022-05-27,Tuolumne,109,53932,13273,13141,619,13760,189
2022-05-27,Ventura,111,848112,181295,179953,10698,190651,1503
2022-05-27,Yolo,113,214977,40435,39016,3343,42359,319
2022-05-27,Yuba,115,75493,16405,16314,1323,17637,122
2022-05-26,Alameda,001,1643700,283719,280775,15758,296533,1863
2022-05-26,Alpine,003,1148,127,126,1,127,0
2022-05-26,Amador,005,37829,8806,8696,694,9390,86
2022-05-26,Butte,007,227075,34172,33876,7350,41226,426
2022-05-26,Calaveras,009,45235,7501,7469,389,7858,120
2022-05-26,Colusa,011,21464,3477,3474,1069,4543,21
2022-05-26,Contra Costa,013,1133247,207479,203528,15220,218748,1306
2022-05-26,Del Norte,015,27424,6204,6166,242,6408,51
2022-05-26,El Dorado,017,186661,28140,27898,3426,31324,214
2022-05-26,Fresno,019,978130,237013,236250,24557,260807,2764
2022-05-26,Glenn,021,27897,5061,5048,1648,6696,48
2022-05-26,Humboldt,023,135768,18354,18257,3517,21774,147
2022-05-26,Imperial,025,180216,56475,56323,10833,67156,939
2022-05-26,Inyo,027,18085,4179,4161,560,4721,56
2022-05-26,Kern,029,883053,195426,194687,47366,242053,2334
2022-05-26,Kings,031,150075,52413,52292,3563,55855,447
2022-05-26,Lake,033,64148,11040,10958,926,11884,137
2022-05-26,Lassen,035,31185,9068,9049,892,9941,64
2022-05-26,Los Angeles,037,10098052,2839115,2819145,133062,2952207,31862
2022-05-26,Madera,039,155013,38099,37955,6348,44303,371
2022-05-26,Marin,041,260295,37597,37215,3849,41064,293
2022-05-26,Mariposa,043,17540,2549,2526,229,2755,31
2022-05-26,Mendocino,045,87422,13679,13612,3431,17043,124
2022-05-26,Merced,047,269075,63686,63389,9168,72557,824
2022-05-26,Modoc,049,8938,752,751,256,1007,8
2022-05-26,Mono,051,14174,3033,3030,160,3190,6
2022-05-26,Monterey,053,433212,82271,81875,15412,97287,737
2022-05-26,Napa,055,140530,27595,27376,1142,28518,144
2022-05-26,Nevada,057,99092,16692,16568,1323,17891,127
2022-05-26,Orange,059,3164182,570985,568369,44859,613228,7028
2022-05-26,Placer,061,380077,66196,65672,7902,73574,626
2022-05-26,Plumas,063,18699,3114,3096,377,3473,13
2022-05-26,Riverside,065,2383286,608747,606444,29116,635560,6480
2022-05-26,Sacramento,067,1510023,295702,294000,28491,322491,3032
2022-05-26,San Benito,069,59416,13468,13402,600,14002,98
2022-05-26,San Bernardino,071,2135413,587158,578656,25567,604223,7610
2022-05-26,San Diego,073,3302833,788655,786243,56847,843090,5288
2022-05-26,San Francisco,075,870044,144340,142456,9420,151876,879
2022-05-26,San Joaquin,077,732212,172144,171282,10980,182262,2241
2022-05-26,San Luis Obispo,079,281455,55041,54701,4495,59196,481
2022-05-26,San Mateo,081,765935,137292,135746,8500,144246,710
2022-05-26,Santa Barbara,083,443738,90460,89940,5128,95068,693
2022-05-26,Santa Clara,085,1922200,347858,344223,14636,358859,2304
2022-05-26,Santa Cruz,087,273765,52198,51819,2430,54249,263
2022-05-26,Shasta,089,179085,31235,31165,6212,37377,564
2022-05-26,Sierra,091,2930,278,278,54,332,4
2022-05-26,Siskiyou,093,43540,4576,4537,2802,7339,81
2022-05-26,Solano,095,438530,87525,86565,6113,92678,452
2022-05-26,Sonoma,097,501317,91084,90364,3660,94024,490
2022-05-26,Stanislaus,099,539301,120792,120241,18215,138456,1657
2022-05-26,Sutter,101,95872,21008,20976,2194,23170,227
2022-05-26,Tehama,103,63373,12219,12210,2648,14858,204
2022-05-26,Trinity,105,12862,1202,1196,290,1486,20
2022-05-26,Tulare,107,460477,108151,108029,28677,136706,1484
2022-05-26,Tuolumne,109,53932,13252,13141,615,13756,189
2022-05-26,Ventura,111,848112,181032,179953,10663,190616,1503
2022-05-26,Yolo,113,214977,40330,39016,3334,42350,319
2022-05-26,Yuba,115,75493,16389,16314,1321,17635,122
2022-05-25,Alameda,001,1643700,282820,278228,15696,293924,1860
2022-05-25,Alpine,003,1148,126,126,1,127,0
2022-05-25,Amador,005,37829,8789,8654,692,9346,86
2022-05-25,Butte,007,227075,34110,33755,7327,41082,426
2022-05-25,Calaveras,009,45235,7493,7450,387,7837,120
2022-05-25,Colusa,011,21464,3476,3471,1067,4538,21
2022-05-25,Contra Costa,013,1133247,206928,201866,15147,217013,1306
2022-05-25,Del Norte,015,27424,6198,6145,236,6381,50
2022-05-25,El Dorado,017,186661,28087,27715,3417,31132,213
2022-05-25,Fresno,019,978130,236728,235569,24505,260074,2763
2022-05-25,Glenn,021,27897,5056,5030,1646,6676,48
2022-05-25,Humboldt,023,135768,18327,18133,3498,21631,147
2022-05-25,Imperial,025,180216,56417,56203,10822,67025,923
2022-05-25,Inyo,027,18085,4176,4152,560,4712,56
2022-05-25,Kern,029,883053,195234,194251,47278,241529,2336
2022-05-25,Kings,031,150075,52359,52178,3559,55737,447
2022-05-25,Lake,033,64148,11027,10908,925,11833,137
2022-05-25,Lassen,035,31185,9061,9028,892,9920,64
2022-05-25,Los Angeles,037,10098052,2834491,2806770,132697,2939467,31845
2022-05-25,Madera,039,155013,38060,37867,6335,44202,370
2022-05-25,Marin,041,260295,37497,36890,3821,40711,293
2022-05-25,Mariposa,043,17540,2539,2514,227,2741,30
2022-05-25,Mendocino,045,87422,13664,13545,3425,16970,124
2022-05-25,Merced,047,269075,63620,63220,9138,72358,823
2022-05-25,Modoc,049,8938,751,750,255,1005,8
2022-05-25,Mono,051,14174,3033,3024,159,3183,6
2022-05-25,Monterey,053,433212,82205,81592,15369,96961,737
2022-05-25,Napa,055,140530,27545,27240,1136,28376,143
2022-05-25,Nevada,057,99092,16657,16517,1317,17834,127
2022-05-25,Orange,059,3164182,569975,565564,44706,610270,7026
2022-05-25,Placer,061,380077,66045,65309,7881,73190,626
2022-05-25,Plumas,063,18699,3108,3065,376,3441,13
2022-05-25,Riverside,065,2383286,608072,604465,29064,633529,6480
2022-05-25,Sacramento,067,1510023,295061,292211,28382,320593,3028
2022-05-25,San Benito,069,59416,13433,13338,593,13931,98
2022-05-25,San Bernardino,071,2135413,586617,576982,25541,602523,7568
2022-05-25,San Diego,073,3302833,787188,782420,56665,839085,5284
2022-05-25,San Francisco,075,870044,143840,141015,9393,150408,872
2022-05-25,San Joaquin,077,732212,171907,170626,10960,181586,2238
2022-05-25,San Luis Obispo,079,281455,54935,54342,4442,58784,481
2022-05-25,San Mateo,081,765935,136834,134441,8435,142876,710
2022-05-25,Santa Barbara,083,443738,90293,89426,5113,94539,693
2022-05-25,Santa Clara,085,1922200,346789,340868,14529,355397,2304
2022-05-25,Santa Cruz,087,273765,52114,51644,2415,54059,263
2022-05-25,Shasta,089,179085,31210,31072,6203,37275,564
2022-05-25,Sierra,091,2930,278,277,54,331,4
2022-05-25,Siskiyou,093,43540,4565,4516,2799,7315,81
2022-05-25,Solano,095,438530,87316,86024,6096,92120,451
2022-05-25,Sonoma,097,501317,90891,89810,3621,93431,490
2022-05-25,Stanislaus,099,539301,120656,119894,18193,138087,1654
2022-05-25,Sutter,101,95872,20984,20904,2190,23094,226
2022-05-25,Tehama,103,63373,12213,12189,2644,14833,201
2022-05-25,Trinity,105,12862,1202,1194,290,1484,20
2022-05-25,Tulare,107,460477,108070,107790,28634,136424,1482
2022-05-25,Tuolumne,109,53932,13230,13086,612,13698,182
2022-05-25,Ventura,111,848112,180741,179116,10626,189742,1499
2022-05-25,Yolo,113,214977,40235,38782,3324,42106,319
2022-05-25,Yuba,115,75493,16362,16260,1315,17575,122
2022-05-24,Alameda,001,1643700,281943,278228,15637,293865,1860
2022-05-24,Alpine,003,1148,126,126,1,127,0
2022-05-24,Amador,005,37829,8782,8654,688,9342,86
2022-05-24,Butte,007,227075,34065,33755,7305,41060,426
2022-05-24,Calaveras,009,45235,7486,7450,385,7835,120
2022-05-24,Colusa,011,21464,3474,3471,1065,4536,21
2022-05-24,Contra Costa,013,1133247,206278,201866,15047,216913,1306
2022-05-24,Del Norte,015,27424,6193,6145,234,6379,50
2022-05-24,El Dorado,017,186661,28019,27715,3410,31125,213
2022-05-24,Fresno,019,978130,236411,235569,24469,260038,2763
2022-05-24,Glenn,021,27897,5054,5030,1646,6676,48
2022-05-24,Humboldt,023,135768,18295,18133,3480,21613,147
2022-05-24,Imperial,025,180216,56364,56203,10809,67012,923
2022-05-24,Inyo,027,18085,4168,4152,557,4709,56
2022-05-24,Kern,029,883053,195039,194251,47171,241422,2336
2022-05-24,Kings,031,150075,52292,52178,3554,55732,447
2022-05-24,Lake,033,64148,11010,10908,923,11831,137
2022-05-24,Lassen,035,31185,9048,9028,888,9916,64
2022-05-24,Los Angeles,037,10098052,2829201,2806770,132312,2939082,31845
2022-05-24,Madera,039,155013,38012,37867,6320,44187,370
2022-05-24,Marin,041,260295,37391,36890,3770,40660,293
2022-05-24,Mariposa,043,17540,2532,2514,225,2739,30
2022-05-24,Mendocino,045,87422,13640,13545,3415,16960,124
2022-05-24,Merced,047,269075,63559,63220,9107,72327,823
2022-05-24,Modoc,049,8938,750,750,254,1004,8
2022-05-24,Mono,051,14174,3030,3024,159,3183,6
2022-05-24,Monterey,053,433212,82114,81592,15308,96900,737
2022-05-24,Napa,055,140530,27497,27240,1124,28364,143
2022-05-24,Nevada,057,99092,16615,16517,1310,17827,127
2022-05-24,Orange,059,3164182,568944,565564,44538,610102,7026
2022-05-24,Placer,061,380077,65945,65309,7865,73174,626
2022-05-24,Plumas,063,18699,3102,3065,376,3441,13
2022-05-24,Riverside,065,2383286,607378,604465,29015,633480,6480
2022-05-24,Sacramento,067,1510023,294376,292211,28261,320472,3028
2022-05-24,San Benito,069,59416,13398,13338,591,13929,98
2022-05-24,San Bernardino,071,2135413,585994,576982,25512,602494,7568
2022-05-24,San Diego,073,3302833,785535,782420,56460,838880,5284
2022-05-24,San Francisco,075,870044,143298,141015,9365,150380,872
2022-05-24,San Joaquin,077,732212,171644,170626,10930,181556,2238
2022-05-24,San Luis Obispo,079,281455,54785,54342,4388,58730,481
2022-05-24,San Mateo,081,765935,136304,134441,8380,142821,710
2022-05-24,Santa Barbara,083,443738,90131,89426,5086,94512,693
2022-05-24,Santa Clara,085,1922200,345505,340868,14436,355304,2304
2022-05-24,Santa Cruz,087,273765,52037,51644,2405,54049,263
2022-05-24,Shasta,089,179085,31185,31072,6191,37263,564
2022-05-24,Sierra,091,2930,278,277,54,331,4
2022-05-24,Siskiyou,093,43540,4555,4516,2791,7307,81
2022-05-24,Solano,095,438530,87085,86024,6066,92090,451
2022-05-24,Sonoma,097,501317,90685,89810,3583,93393,490
2022-05-24,Stanislaus,099,539301,120519,119894,18158,138052,1654
2022-05-24,Sutter,101,95872,20963,20904,2186,23090,226
2022-05-24,Tehama,103,63373,12204,12189,2642,14831,201
2022-05-24,Trinity,105,12862,1199,1194,290,1484,20
2022-05-24,Tulare,107,460477,107952,107790,28580,136370,1482
2022-05-24,Tuolumne,109,53932,13215,13086,612,13698,182
2022-05-24,Ventura,111,848112,180426,179116,10576,189692,1499
2022-05-24,Yolo,113,214977,40131,38782,3319,42101,319
2022-05-24,Yuba,115,75493,16334,16260,1307,17567,122
2022-05-23,Alameda,001,1643700,281002,278228,15551,293779,1860
2022-05-23,Alpine,003,1148,126,126,1,127,0
2022-05-23,Amador,005,37829,8750,8654,685,9339,86
2022-05-23,Butte,007,227075,34018,33755,7278,41033,426
2022-05-23,Calaveras,009,45235,7479,7450,383,7833,120
2022-05-23,Colusa,011,21464,3473,3471,1063,4534,21
2022-05-23,Contra Costa,013,1133247,205544,201866,14964,216830,1306
2022-05-23,Del Norte,015,27424,6188,6145,230,6375,50
2022-05-23,El Dorado,017,186661,27937,27715,3401,31116,213
2022-05-23,Fresno,019,978130,236063,235569,24402,259971,2763
2022-05-23,Glenn,021,27897,5050,5030,1642,6672,48
2022-05-23,Humboldt,023,135768,18268,18133,3458,21591,147
2022-05-23,Imperial,025,180216,56319,56203,10789,66992,923
2022-05-23,Inyo,027,18085,4165,4152,556,4708,56
2022-05-23,Kern,029,883053,194821,194251,47085,241336,2336
2022-05-23,Kings,031,150075,52245,52178,3549,55727,447
2022-05-23,Lake,033,64148,10991,10908,921,11829,137
2022-05-23,Lassen,035,31185,9040,9028,885,9913,64
2022-05-23,Los Angeles,037,10098052,2823771,2806770,131943,2938713,31845
2022-05-23,Madera,039,155013,37981,37867,6297,44164,370
2022-05-23,Marin,041,260295,37250,36890,3725,40615,293
2022-05-23,Mariposa,043,17540,2530,2514,223,2737,30
2022-05-23,Mendocino,045,87422,13618,13545,3401,16946,124
2022-05-23,Merced,047,269075,63480,63220,9079,72299,823
2022-05-23,Modoc,049,8938,749,750,254,1004,8
2022-05-23,Mono,051,14174,3030,3024,159,3183,6
2022-05-23,Monterey,053,433212,82015,81592,15243,96835,737
2022-05-23,Napa,055,140530,27440,27240,1117,28357,143
2022-05-23,Nevada,057,99092,16580,16517,1307,17824,127
2022-05-23,Orange,059,3164182,567933,565564,44394,609958,7026
2022-05-23,Placer,061,380077,65800,65309,7833,73142,626
2022-05-23,Plumas,063,18699,3099,3065,375,3440,13
2022-05-23,Riverside,065,2383286,606656,604465,28962,633427,6480
2022-05-23,Sacramento,067,1510023,293627,292211,28138,320349,3028
2022-05-23,San Benito,069,59416,13363,13338,588,13926,98
2022-05-23,San Bernardino,071,2135413,585346,576982,25479,602461,7568
2022-05-23,San Diego,073,3302833,783816,782420,56247,838667,5284
2022-05-23,San Francisco,075,870044,142726,141015,9331,150346,872
2022-05-23,San Joaquin,077,732212,171374,170626,10899,181525,2238
2022-05-23,San Luis Obispo,079,281455,54639,54342,4341,58683,481
2022-05-23,San Mateo,081,765935,135733,134441,8329,142770,710
2022-05-23,Santa Barbara,083,443738,89896,89426,5062,94488,693
2022-05-23,Santa Clara,085,1922200,344132,340868,14348,355216,2304
2022-05-23,Santa Cruz,087,273765,51933,51644,2390,54034,263
2022-05-23,Shasta,089,179085,31162,31072,6185,37257,564
2022-05-23,Sierra,091,2930,278,277,54,331,4
2022-05-23,Siskiyou,093,43540,4541,4516,2787,7303,81
2022-05-23,Solano,095,438530,86813,86024,6046,92070,451
2022-05-23,Sonoma,097,501317,90457,89810,3534,93344,490
2022-05-23,Stanislaus,099,539301,120379,119894,18118,138012,1654
2022-05-23,Sutter,101,95872,20923,20904,2181,23085,226
2022-05-23,Tehama,103,63373,12192,12189,2641,14830,201
2022-05-23,Trinity,105,12862,1198,1194,290,1484,20
2022-05-23,Tulare,107,460477,107829,107790,28511,136301,1482
2022-05-23,Tuolumne,109,53932,13191,13086,608,13694,182
2022-05-23,Ventura,111,848112,180095,179116,10546,189662,1499
2022-05-23,Yolo,113,214977,39998,38782,3303,42085,319
2022-05-23,Yuba,115,75493,16305,16260,1303,17563,122
2022-05-22,Alameda,001,1643700,279907,274996,15443,290439,1858
2022-05-22,Alpine,003,1148,126,126,1,127,0
2022-05-22,Amador,005,37829,8733,8628,679,9307,86
2022-05-22,Butte,007,227075,33966,33606,7252,40858,426
2022-05-22,Calaveras,009,45235,7468,7424,379,7803,120
2022-05-22,Colusa,011,21464,3469,3468,1060,4528,21
2022-05-22,Contra Costa,013,1133247,204818,199703,14831,214534,1305
2022-05-22,Del Norte,015,27424,6172,6045,219,6264,50
2022-05-22,El Dorado,017,186661,27860,27517,3385,30902,213
2022-05-22,Fresno,019,978130,235724,234657,24351,259008,2760
2022-05-22,Glenn,021,27897,5040,5020,1641,6661,48
2022-05-22,Humboldt,023,135768,18214,17984,3430,21414,146
2022-05-22,Imperial,025,180216,56251,56014,10774,66788,923
2022-05-22,Inyo,027,18085,4157,4135,554,4689,56
2022-05-22,Kern,029,883053,194585,193705,46985,240690,2334
2022-05-22,Kings,031,150075,52182,52038,3543,55581,447
2022-05-22,Lake,033,64148,10959,10867,919,11786,137
2022-05-22,Lassen,035,31185,9024,9011,882,9893,64
2022-05-22,Los Angeles,037,10098052,2817887,2791671,131514,2923185,31815
2022-05-22,Madera,039,155013,37934,37744,6262,44006,370
2022-05-22,Marin,041,260295,37104,36394,3681,40075,293
2022-05-22,Mariposa,043,17540,2526,2490,222,2712,30
2022-05-22,Mendocino,045,87422,13590,13461,3372,16833,124
2022-05-22,Merced,047,269075,63402,62969,9048,72017,823
2022-05-22,Modoc,049,8938,748,750,254,1004,8
2022-05-22,Mono,051,14174,3029,3012,159,3171,6
2022-05-22,Monterey,053,433212,81857,81224,15143,96367,735
2022-05-22,Napa,055,140530,27369,27034,1109,28143,143
2022-05-22,Nevada,057,99092,16546,16410,1295,17705,127
2022-05-22,Orange,059,3164182,566840,562531,44218,606749,7025
2022-05-22,Placer,061,380077,65641,64802,7801,72603,626
2022-05-22,Plumas,063,18699,3092,3052,373,3425,13
2022-05-22,Riverside,065,2383286,605824,601808,28896,630704,6476
2022-05-22,Sacramento,067,1510023,292829,289972,27977,317949,3027
2022-05-22,San Benito,069,59416,13331,13234,582,13816,98
2022-05-22,San Bernardino,071,2135413,584626,575194,25440,600634,7523
2022-05-22,San Diego,073,3302833,782197,777404,56052,833456,5282
2022-05-22,San Francisco,075,870044,142037,138922,9314,148236,871
2022-05-22,San Joaquin,077,732212,171073,169745,10860,180605,2237
2022-05-22,San Luis Obispo,079,281455,54484,54012,4280,58292,481
2022-05-22,San Mateo,081,765935,135167,132636,8276,140912,711
2022-05-22,Santa Barbara,083,443738,89664,88783,5027,93810,692
2022-05-22,Santa Clara,085,1922200,342693,336488,14269,350757,2301
2022-05-22,Santa Cruz,087,273765,51840,51333,2376,53709,263
2022-05-22,Shasta,089,179085,31114,30966,6173,37139,564
2022-05-22,Sierra,091,2930,278,276,54,330,4
2022-05-22,Siskiyou,093,43540,4532,4501,2786,7287,81
2022-05-22,Solano,095,438530,86532,85038,6013,91051,451
2022-05-22,Sonoma,097,501317,90169,88889,3479,92368,489
2022-05-22,Stanislaus,099,539301,120206,119396,18095,137491,1653
2022-05-22,Sutter,101,95872,20894,20809,2173,22982,226
2022-05-22,Tehama,103,63373,12184,12162,2636,14798,201
2022-05-22,Trinity,105,12862,1198,1191,289,1480,20
2022-05-22,Tulare,107,460477,107723,107485,28428,135913,1477
2022-05-22,Tuolumne,109,53932,13171,12977,606,13583,182
2022-05-22,Ventura,111,848112,179750,178024,10497,188521,1499
2022-05-22,Yolo,113,214977,39871,38377,3279,41656,319
2022-05-22,Yuba,115,75493,16278,16180,1294,17474,122
2022-05-21,Alameda,001,1643700,279445,274996,15422,290418,1858
2022-05-21,Alpine,003,1148,126,126,1,127,0
2022-05-21,Amador,005,37829,8722,8628,679,9307,86
2022-05-21,Butte,007,227075,33945,33606,7238,40844,426
2022-05-21,Calaveras,009,45235,7462,7424,379,7803,120
2022-05-21,Colusa,011,21464,3469,3468,1059,4527,21
2022-05-21,Contra Costa,013,1133247,204460,199703,14798,214501,1305
2022-05-21,Del Norte,015,27424,6168,6045,217,6262,50
2022-05-21,El Dorado,017,186661,27824,27517,3383,30900,213
2022-05-21,Fresno,019,978130,235592,234657,24330,258987,2760
2022-05-21,Glenn,021,27897,5036,5020,1640,6660,48
2022-05-21,Humboldt,023,135768,18189,17984,3422,21406,146
2022-05-21,Imperial,025,180216,56217,56014,10772,66786,923
2022-05-21,Inyo,027,18085,4155,4135,552,4687,56
2022-05-21,Kern,029,883053,194489,193705,46924,240629,2334
2022-05-21,Kings,031,150075,52159,52038,3542,55580,447
2022-05-21,Lake,033,64148,10951,10867,919,11786,137
2022-05-21,Lassen,035,31185,9021,9011,882,9893,64
2022-05-21,Los Angeles,037,10098052,2815586,2791671,131272,2922943,31815
2022-05-21,Madera,039,155013,37916,37744,6256,44000,370
2022-05-21,Marin,041,260295,37010,36394,3637,40031,293
2022-05-21,Mariposa,043,17540,2524,2490,222,2712,30
2022-05-21,Mendocino,045,87422,13579,13461,3367,16828,124
2022-05-21,Merced,047,269075,63367,62969,9042,72011,823
2022-05-21,Modoc,049,8938,747,750,254,1004,8
2022-05-21,Mono,051,14174,3029,3012,159,3171,6
2022-05-21,Monterey,053,433212,81790,81224,15088,96312,735
2022-05-21,Napa,055,140530,27336,27034,1106,28140,143
2022-05-21,Nevada,057,99092,16540,16410,1295,17705,127
2022-05-21,Orange,059,3164182,566328,562531,44114,606645,7025
2022-05-21,Placer,061,380077,65533,64802,7788,72590,626
2022-05-21,Plumas,063,18699,3085,3052,373,3425,13
2022-05-21,Riverside,065,2383286,605352,601808,28871,630679,6476
2022-05-21,Sacramento,067,1510023,292503,289972,27948,317920,3027
2022-05-21,San Benito,069,59416,13319,13234,574,13808,98
2022-05-21,San Bernardino,071,2135413,584288,575194,25415,600609,7523
2022-05-21,San Diego,073,3302833,781499,777404,55991,833395,5282
2022-05-21,San Francisco,075,870044,141728,138922,9301,148223,871
2022-05-21,San Joaquin,077,732212,170955,169745,10842,180587,2237
2022-05-21,San Luis Obispo,079,281455,54405,54012,4266,58278,481
2022-05-21,San Mateo,081,765935,134856,132636,8248,140884,711
2022-05-21,Santa Barbara,083,443738,89572,88783,5014,93797,692
2022-05-21,Santa Clara,085,1922200,341845,336488,14226,350714,2301
2022-05-21,Santa Cruz,087,273765,51795,51333,2357,53690,263
2022-05-21,Shasta,089,179085,31103,30966,6171,37137,564
2022-05-21,Sierra,091,2930,277,276,54,330,4
2022-05-21,Siskiyou,093,43540,4528,4501,2784,7285,81
2022-05-21,Solano,095,438530,86448,85038,6007,91045,451
2022-05-21,Sonoma,097,501317,90043,88889,3470,92359,489
2022-05-21,Stanislaus,099,539301,120127,119396,18073,137469,1653
2022-05-21,Sutter,101,95872,20884,20809,2168,22977,226
2022-05-21,Tehama,103,63373,12182,12162,2635,14797,201
2022-05-21,Trinity,105,12862,1198,1191,289,1480,20
2022-05-21,Tulare,107,460477,107661,107485,28392,135877,1477
2022-05-21,Tuolumne,109,53932,13164,12977,606,13583,182
2022-05-21,Ventura,111,848112,179575,178024,10478,188502,1499
2022-05-21,Yolo,113,214977,39806,38377,3268,41645,319
2022-05-21,Yuba,115,75493,16265,16180,1292,17472,122
2022-05-20,Alameda,001,1643700,278902,274996,15395,290391,1858
2022-05-20,Alpine,003,1148,126,126,1,127,0
2022-05-20,Amador,005,37829,8715,8628,679,9307,86
2022-05-20,Butte,007,227075,33923,33606,7226,40832,426
2022-05-20,Calaveras,009,45235,7454,7424,379,7803,120
2022-05-20,Colusa,011,21464,3469,3468,1059,4527,21
2022-05-20,Contra Costa,013,1133247,204104,199703,14781,214484,1305
2022-05-20,Del Norte,015,27424,6163,6045,216,6261,50
2022-05-20,El Dorado,017,186661,27792,27517,3380,30897,213
2022-05-20,Fresno,019,978130,235435,234657,24300,258957,2760
2022-05-20,Glenn,021,27897,5033,5020,1640,6660,48
2022-05-20,Humboldt,023,135768,18167,17984,3414,21398,146
2022-05-20,Imperial,025,180216,56193,56014,10769,66783,923
2022-05-20,Inyo,027,18085,4152,4135,548,4683,56
2022-05-20,Kern,029,883053,194386,193705,46875,240580,2334
2022-05-20,Kings,031,150075,52144,52038,3541,55579,447
2022-05-20,Lake,033,64148,10934,10867,919,11786,137
2022-05-20,Lassen,035,31185,9019,9011,882,9893,64
2022-05-20,Los Angeles,037,10098052,2813235,2791671,131048,2922719,31815
2022-05-20,Madera,039,155013,37897,37744,6248,43992,370
2022-05-20,Marin,041,260295,36937,36394,3598,39992,293
2022-05-20,Mariposa,043,17540,2519,2490,222,2712,30
2022-05-20,Mendocino,045,87422,13564,13461,3363,16824,124
2022-05-20,Merced,047,269075,63333,62969,9039,72008,823
2022-05-20,Modoc,049,8938,747,750,254,1004,8
2022-05-20,Mono,051,14174,3025,3012,159,3171,6
2022-05-20,Monterey,053,433212,81732,81224,15048,96272,735
2022-05-20,Napa,055,140530,27306,27034,1102,28136,143
2022-05-20,Nevada,057,99092,16532,16410,1293,17703,127
2022-05-20,Orange,059,3164182,565756,562531,44018,606549,7025
2022-05-20,Placer,061,380077,65458,64802,7772,72574,626
2022-05-20,Plumas,063,18699,3083,3052,373,3425,13
2022-05-20,Riverside,065,2383286,604903,601808,28848,630656,6476
2022-05-20,Sacramento,067,1510023,292124,289972,27927,317899,3027
2022-05-20,San Benito,069,59416,13303,13234,573,13807,98
2022-05-20,San Bernardino,071,2135413,583967,575194,25396,600590,7523
2022-05-20,San Diego,073,3302833,780702,777404,55902,833306,5282
2022-05-20,San Francisco,075,870044,141395,138922,9270,148192,871
2022-05-20,San Joaquin,077,732212,170834,169745,10835,180580,2237
2022-05-20,San Luis Obispo,079,281455,54369,54012,4261,58273,481
2022-05-20,San Mateo,081,765935,134541,132636,8225,140861,711
2022-05-20,Santa Barbara,083,443738,89488,88783,5009,93792,692
2022-05-20,Santa Clara,085,1922200,341052,336488,14172,350660,2301
2022-05-20,Santa Cruz,087,273765,51750,51333,2339,53672,263
2022-05-20,Shasta,089,179085,31089,30966,6168,37134,564
2022-05-20,Sierra,091,2930,277,276,54,330,4
2022-05-20,Siskiyou,093,43540,4525,4501,2782,7283,81
2022-05-20,Solano,095,438530,86307,85038,6000,91038,451
2022-05-20,Sonoma,097,501317,89916,88889,3457,92346,489
2022-05-20,Stanislaus,099,539301,120045,119396,18060,137456,1653
2022-05-20,Sutter,101,95872,20875,20809,2167,22976,226
2022-05-20,Tehama,103,63373,12179,12162,2634,14796,201
2022-05-20,Trinity,105,12862,1198,1191,289,1480,20
2022-05-20,Tulare,107,460477,107605,107485,28353,135838,1477
2022-05-20,Tuolumne,109,53932,13145,12977,604,13581,182
2022-05-20,Ventura,111,848112,179377,178024,10460,188484,1499
2022-05-20,Yolo,113,214977,39737,38377,3262,41639,319
2022-05-20,Yuba,115,75493,16250,16180,1288,17468,122
2022-05-19,Alameda,001,1643700,278062,274996,15323,290319,1858
2022-05-19,Alpine,003,1148,126,126,1,127,0
2022-05-19,Amador,005,37829,8707,8628,679,9307,86
2022-05-19,Butte,007,227075,33885,33606,7217,40823,426
2022-05-19,Calaveras,009,45235,7448,7424,376,7800,120
2022-05-19,Colusa,011,21464,3468,3468,1058,4526,21
2022-05-19,Contra Costa,013,1133247,203563,199703,14707,214410,1305
2022-05-19,Del Norte,015,27424,6158,6045,211,6256,50
2022-05-19,El Dorado,017,186661,27740,27517,3365,30882,213
2022-05-19,Fresno,019,978130,235211,234657,24261,258918,2760
2022-05-19,Glenn,021,27897,5032,5020,1636,6656,48
2022-05-19,Humboldt,023,135768,18133,17984,3399,21383,146
2022-05-19,Imperial,025,180216,56147,56014,10768,66782,923
2022-05-19,Inyo,027,18085,4148,4135,547,4682,56
2022-05-19,Kern,029,883053,194245,193705,46800,240505,2334
2022-05-19,Kings,031,150075,52117,52038,3540,55578,447
2022-05-19,Lake,033,64148,10926,10867,917,11784,137
2022-05-19,Lassen,035,31185,9015,9011,882,9893,64
2022-05-19,Los Angeles,037,10098052,2809276,2791671,130719,2922390,31815
2022-05-19,Madera,039,155013,37861,37744,6232,43976,370
2022-05-19,Marin,041,260295,36841,36394,3565,39959,293
2022-05-19,Mariposa,043,17540,2511,2490,222,2712,30
2022-05-19,Mendocino,045,87422,13541,13461,3356,16817,124
2022-05-19,Merced,047,269075,63271,62969,9023,71992,823
2022-05-19,Modoc,049,8938,747,750,254,1004,8
2022-05-19,Mono,051,14174,3024,3012,155,3167,6
2022-05-19,Monterey,053,433212,81653,81224,14983,96207,735
2022-05-19,Napa,055,140530,27249,27034,1099,28133,143
2022-05-19,Nevada,057,99092,16498,16410,1286,17696,127
2022-05-19,Orange,059,3164182,564925,562531,43893,606424,7025
2022-05-19,Placer,061,380077,65340,64802,7756,72558,626
2022-05-19,Plumas,063,18699,3077,3052,373,3425,13
2022-05-19,Riverside,065,2383286,604272,601808,28806,630614,6476
2022-05-19,Sacramento,067,1510023,291566,289972,27844,317816,3027
2022-05-19,San Benito,069,59416,13275,13234,570,13804,98
2022-05-19,San Bernardino,071,2135413,583449,575194,25375,600569,7523
2022-05-19,San Diego,073,3302833,779466,777404,55744,833148,5282
2022-05-19,San Francisco,075,870044,140924,138922,9235,148157,871
2022-05-19,San Joaquin,077,732212,170592,169745,10818,180563,2237
2022-05-19,San Luis Obispo,079,281455,54266,54012,4229,58241,481
2022-05-19,San Mateo,081,765935,134076,132636,8166,140802,711
2022-05-19,Santa Barbara,083,443738,89334,88783,4982,93765,692
2022-05-19,Santa Clara,085,1922200,339963,336488,14079,350567,2301
2022-05-19,Santa Cruz,087,273765,51671,51333,2325,53658,263
2022-05-19,Shasta,089,179085,31060,30966,6162,37128,564
2022-05-19,Sierra,091,2930,277,276,54,330,4
2022-05-19,Siskiyou,093,43540,4522,4501,2780,7281,81
2022-05-19,Solano,095,438530,86124,85038,5976,91014,451
2022-05-19,Sonoma,097,501317,89712,88889,3423,92312,489
2022-05-19,Stanislaus,099,539301,119916,119396,18038,137434,1653
2022-05-19,Sutter,101,95872,20839,20809,2164,22973,226
2022-05-19,Tehama,103,63373,12169,12162,2631,14793,201
2022-05-19,Trinity,105,12862,1197,1191,289,1480,20
2022-05-19,Tulare,107,460477,107511,107485,28307,135792,1477
2022-05-19,Tuolumne,109,53932,13121,12977,601,13578,182
2022-05-19,Ventura,111,848112,179102,178024,10421,188445,1499
2022-05-19,Yolo,113,214977,39646,38377,3254,41631,319
2022-05-19,Yuba,115,75493,16230,16180,1280,17460,122
2022-05-18,Alameda,001,1643700,277210,272530,15254,287784,1859
2022-05-18,Alpine,003,1148,126,126,1,127,0
2022-05-18,Amador,005,37829,8689,8592,679,9271,86
2022-05-18,Butte,007,227075,33844,33486,7202,40688,426
2022-05-18,Calaveras,009,45235,7440,7400,376,7776,120
2022-05-18,Colusa,011,21464,3468,3467,1058,4525,21
2022-05-18,Contra Costa,013,1133247,203009,198207,14620,212827,1303
2022-05-18,Del Norte,015,27424,6150,6001,207,6208,50
2022-05-18,El Dorado,017,186661,27689,27388,3357,30745,212
2022-05-18,Fresno,019,978130,234951,234055,24220,258275,2759
2022-05-18,Glenn,021,27897,5031,5012,1636,6648,48
2022-05-18,Humboldt,023,135768,18108,17868,3378,21246,146
2022-05-18,Imperial,025,180216,56085,55915,10763,66678,918
2022-05-18,Inyo,027,18085,4144,4120,541,4661,56
2022-05-18,Kern,029,883053,194127,193338,46740,240078,2327
2022-05-18,Kings,031,150075,52088,51903,3537,55440,447
2022-05-18,Lake,033,64148,10917,10831,916,11747,137
2022-05-18,Lassen,035,31185,9009,8994,882,9876,65
2022-05-18,Los Angeles,037,10098052,2804934,2780354,130439,2910793,31789
2022-05-18,Madera,039,155013,37822,37644,6223,43867,365
2022-05-18,Marin,041,260295,36750,36024,3524,39548,293
2022-05-18,Mariposa,043,17540,2504,2481,222,2703,30
2022-05-18,Mendocino,045,87422,13520,13403,3341,16744,124
2022-05-18,Merced,047,269075,63206,62802,8996,71798,818
2022-05-18,Modoc,049,8938,747,748,254,1002,8
2022-05-18,Mono,051,14174,3022,3010,153,3163,6
2022-05-18,Monterey,053,433212,81544,80955,14927,95882,735
2022-05-18,Napa,055,140530,27207,26912,1092,28004,143
2022-05-18,Nevada,057,99092,16478,16361,1281,17642,127
2022-05-18,Orange,059,3164182,564122,560094,43788,603882,7021
2022-05-18,Placer,061,380077,65195,64432,7741,72173,626
2022-05-18,Plumas,063,18699,3069,3022,370,3392,13
2022-05-18,Riverside,065,2383286,603630,599947,28753,628700,6471
2022-05-18,Sacramento,067,1510023,291044,288335,27761,316096,3022
2022-05-18,San Benito,069,59416,13252,13186,566,13752,98
2022-05-18,San Bernardino,071,2135413,582973,573790,25348,599138,7455
2022-05-18,San Diego,073,3302833,778031,773934,55580,829514,5277
2022-05-18,San Francisco,075,870044,140393,137341,9208,146549,869
2022-05-18,San Joaquin,077,732212,170359,169045,10732,179777,2236
2022-05-18,San Luis Obispo,079,281455,54167,53756,4194,57950,478
2022-05-18,San Mateo,081,765935,133653,131330,8097,139427,709
2022-05-18,Santa Barbara,083,443738,89174,88317,4961,93278,693
2022-05-18,Santa Clara,085,1922200,338813,333230,13983,347213,2300
2022-05-18,Santa Cruz,087,273765,51580,51020,2312,53332,263
2022-05-18,Shasta,089,179085,31037,30899,6157,37056,558
2022-05-18,Sierra,091,2930,277,275,54,329,4
2022-05-18,Siskiyou,093,43540,4517,4495,2778,7273,81
2022-05-18,Solano,095,438530,85865,84476,5959,90435,451
2022-05-18,Sonoma,097,501317,89513,88195,3384,91579,489
2022-05-18,Stanislaus,099,539301,119806,119025,18006,137031,1645
2022-05-18,Sutter,101,95872,20817,20763,2155,22918,226
2022-05-18,Tehama,103,63373,12163,12133,2628,14761,201
2022-05-18,Trinity,105,12862,1197,1189,289,1478,20
2022-05-18,Tulare,107,460477,107440,107292,28249,135541,1477
2022-05-18,Tuolumne,109,53932,13102,12917,599,13516,182
2022-05-18,Ventura,111,848112,178830,177233,10382,187615,1497
2022-05-18,Yolo,113,214977,39534,38139,3242,41381,316
2022-05-18,Yuba,115,75493,16206,16109,1271,17380,122
2022-05-17,Alameda,001,1643700,276378,272530,15187,287717,1859
2022-05-17,Alpine,003,1148,126,126,1,127,0
2022-05-17,Amador,005,37829,8680,8592,677,9269,86
2022-05-17,Butte,007,227075,33792,33486,7181,40667,426
2022-05-17,Calaveras,009,45235,7433,7400,376,7776,120
2022-05-17,Colusa,011,21464,3467,3467,1057,4524,21
2022-05-17,Contra Costa,013,1133247,202371,198207,14535,212742,1303
2022-05-17,Del Norte,015,27424,6136,6001,207,6208,50
2022-05-17,El Dorado,017,186661,27634,27388,3351,30739,212
2022-05-17,Fresno,019,978130,234700,234055,24189,258244,2759
2022-05-17,Glenn,021,27897,5028,5012,1635,6647,48
2022-05-17,Humboldt,023,135768,18068,17868,3361,21229,146
2022-05-17,Imperial,025,180216,56042,55915,10753,66668,918
2022-05-17,Inyo,027,18085,4142,4120,532,4652,56
2022-05-17,Kern,029,883053,193970,193338,46684,240022,2327
2022-05-17,Kings,031,150075,52045,51903,3533,55436,447
2022-05-17,Lake,033,64148,10902,10831,914,11745,137
2022-05-17,Lassen,035,31185,9004,8994,881,9875,65
2022-05-17,Los Angeles,037,10098052,2800383,2780354,130136,2910490,31789
2022-05-17,Madera,039,155013,37796,37644,6208,43852,365
2022-05-17,Marin,041,260295,36616,36024,3463,39487,293
2022-05-17,Mariposa,043,17540,2499,2481,221,2702,30
2022-05-17,Mendocino,045,87422,13494,13403,3331,16734,124
2022-05-17,Merced,047,269075,63141,62802,8977,71779,818
2022-05-17,Modoc,049,8938,747,748,254,1002,8
2022-05-17,Mono,051,14174,3018,3010,153,3163,6
2022-05-17,Monterey,053,433212,81427,80955,14860,95815,735
2022-05-17,Napa,055,140530,27159,26912,1084,27996,143
2022-05-17,Nevada,057,99092,16449,16361,1273,17634,127
2022-05-17,Orange,059,3164182,563224,560094,43655,603749,7021
2022-05-17,Placer,061,380077,65030,64432,7703,72135,626
2022-05-17,Plumas,063,18699,3063,3022,369,3391,13
2022-05-17,Riverside,065,2383286,602947,599947,28709,628656,6471
2022-05-17,Sacramento,067,1510023,290414,288335,27659,315994,3022
2022-05-17,San Benito,069,59416,13215,13186,565,13751,98
2022-05-17,San Bernardino,071,2135413,582478,573790,25334,599124,7455
2022-05-17,San Diego,073,3302833,776518,773934,55413,829347,5277
2022-05-17,San Francisco,075,870044,139814,137341,9177,146518,869
2022-05-17,San Joaquin,077,732212,170119,169045,10693,179738,2236
2022-05-17,San Luis Obispo,079,281455,54074,53756,4150,57906,478
2022-05-17,San Mateo,081,765935,133160,131330,8057,139387,709
2022-05-17,Santa Barbara,083,443738,88975,88317,4943,93260,693
2022-05-17,Santa Clara,085,1922200,337630,333230,13909,347139,2300
2022-05-17,Santa Cruz,087,273765,51503,51020,2304,53324,263
2022-05-17,Shasta,089,179085,30999,30899,6154,37053,558
2022-05-17,Sierra,091,2930,277,275,54,329,4
2022-05-17,Siskiyou,093,43540,4515,4495,2776,7271,81
2022-05-17,Solano,095,438530,85587,84476,5930,90406,451
2022-05-17,Sonoma,097,501317,89272,88195,3338,91533,489
2022-05-17,Stanislaus,099,539301,119658,119025,17978,137003,1645
2022-05-17,Sutter,101,95872,20797,20763,2151,22914,226
2022-05-17,Tehama,103,63373,12151,12133,2625,14758,201
2022-05-17,Trinity,105,12862,1196,1189,289,1478,20
2022-05-17,Tulare,107,460477,107346,107292,28208,135500,1477
2022-05-17,Tuolumne,109,53932,13087,12917,599,13516,182
2022-05-17,Ventura,111,848112,178507,177233,10328,187561,1497
2022-05-17,Yolo,113,214977,39396,38139,3235,41374,316
2022-05-17,Yuba,115,75493,16182,16109,1268,17377,122
2022-05-16,Alameda,001,1643700,275368,272530,15106,287636,1859
2022-05-16,Alpine,003,1148,126,126,1,127,0
2022-05-16,Amador,005,37829,8670,8592,676,9268,86
2022-05-16,Butte,007,227075,33733,33486,7165,40651,426
2022-05-16,Calaveras,009,45235,7425,7400,374,7774,120
2022-05-16,Colusa,011,21464,3466,3467,1057,4524,21
2022-05-16,Contra Costa,013,1133247,201731,198207,14454,212661,1303
2022-05-16,Del Norte,015,27424,6123,6001,204,6205,50
2022-05-16,El Dorado,017,186661,27578,27388,3343,30731,212
2022-05-16,Fresno,019,978130,234439,234055,24147,258202,2759
2022-05-16,Glenn,021,27897,5024,5012,1630,6642,48
2022-05-16,Humboldt,023,135768,18023,17868,3347,21215,146
2022-05-16,Imperial,025,180216,55978,55915,10740,66655,918
2022-05-16,Inyo,027,18085,4138,4120,529,4649,56
2022-05-16,Kern,029,883053,193818,193338,46618,239956,2327
2022-05-16,Kings,031,150075,51995,51903,3532,55435,447
2022-05-16,Lake,033,64148,10895,10831,913,11744,137
2022-05-16,Lassen,035,31185,8999,8994,879,9873,65
2022-05-16,Los Angeles,037,10098052,2795936,2780354,129852,2910206,31789
2022-05-16,Madera,039,155013,37765,37644,6186,43830,365
2022-05-16,Marin,041,260295,36452,36024,3415,39439,293
2022-05-16,Mariposa,043,17540,2498,2481,220,2701,30
2022-05-16,Mendocino,045,87422,13468,13403,3319,16722,124
2022-05-16,Merced,047,269075,63071,62802,8941,71743,818
2022-05-16,Modoc,049,8938,747,748,254,1002,8
2022-05-16,Mono,051,14174,3016,3010,153,3163,6
2022-05-16,Monterey,053,433212,81317,80955,14773,95728,735
2022-05-16,Napa,055,140530,27108,26912,1079,27991,143
2022-05-16,Nevada,057,99092,16430,16361,1267,17628,127
2022-05-16,Orange,059,3164182,562370,560094,43531,603625,7021
2022-05-16,Placer,061,380077,64923,64432,7672,72104,626
2022-05-16,Plumas,063,18699,3053,3022,368,3390,13
2022-05-16,Riverside,065,2383286,602237,599947,28654,628601,6471
2022-05-16,Sacramento,067,1510023,289752,288335,27568,315903,3022
2022-05-16,San Benito,069,59416,13197,13186,560,13746,98
2022-05-16,San Bernardino,071,2135413,582011,573790,25304,599094,7455
2022-05-16,San Diego,073,3302833,774976,773934,55244,829178,5277
2022-05-16,San Francisco,075,870044,139109,137341,9145,146486,869
2022-05-16,San Joaquin,077,732212,169839,169045,10508,179553,2236
2022-05-16,San Luis Obispo,079,281455,53971,53756,4121,57877,478
2022-05-16,San Mateo,081,765935,132617,131330,8001,139331,709
2022-05-16,Santa Barbara,083,443738,88831,88317,4932,93249,693
2022-05-16,Santa Clara,085,1922200,336303,333230,13822,347052,2300
2022-05-16,Santa Cruz,087,273765,51424,51020,2289,53309,263
2022-05-16,Shasta,089,179085,30966,30899,6146,37045,558
2022-05-16,Sierra,091,2930,277,275,53,328,4
2022-05-16,Siskiyou,093,43540,4512,4495,2769,7264,81
2022-05-16,Solano,095,438530,85326,84476,5904,90380,451
2022-05-16,Sonoma,097,501317,88972,88195,3300,91495,489
2022-05-16,Stanislaus,099,539301,119513,119025,17946,136971,1645
2022-05-16,Sutter,101,95872,20783,20763,2144,22907,226
2022-05-16,Tehama,103,63373,12143,12133,2622,14755,201
2022-05-16,Trinity,105,12862,1195,1189,289,1478,20
2022-05-16,Tulare,107,460477,107269,107292,28157,135449,1477
2022-05-16,Tuolumne,109,53932,13055,12917,596,13513,182
2022-05-16,Ventura,111,848112,178175,177233,10272,187505,1497
2022-05-16,Yolo,113,214977,39261,38139,3226,41365,316
2022-05-16,Yuba,115,75493,16155,16109,1265,17374,122
2022-05-15,Alameda,001,1643700,274297,268944,15037,283981,1857
2022-05-15,Alpine,003,1148,126,125,1,126,0
2022-05-15,Amador,005,37829,8654,8574,671,9245,86
2022-05-15,Butte,007,227075,33675,33377,7144,40521,424
2022-05-15,Calaveras,009,45235,7406,7378,372,7750,120
2022-05-15,Colusa,011,21464,3463,3463,1055,4518,21
2022-05-15,Contra Costa,013,1133247,200972,195925,14372,210297,1301
2022-05-15,Del Norte,015,27424,6050,5919,202,6121,50
2022-05-15,El Dorado,017,186661,27517,27216,3328,30544,212
2022-05-15,Fresno,019,978130,234173,233305,24112,257417,2757
2022-05-15,Glenn,021,27897,5021,5004,1629,6633,48
2022-05-15,Humboldt,023,135768,17973,17633,3307,20940,146
2022-05-15,Imperial,025,180216,55942,55756,10719,66475,917
2022-05-15,Inyo,027,18085,4134,4114,525,4639,56
2022-05-15,Kern,029,883053,193643,192939,46538,239477,2314
2022-05-15,Kings,031,150075,51935,51779,3528,55307,447
2022-05-15,Lake,033,64148,10878,10790,910,11700,137
2022-05-15,Lassen,035,31185,8991,8987,878,9865,65
2022-05-15,Los Angeles,037,10098052,2791321,2768726,129481,2898207,31768
2022-05-15,Madera,039,155013,37723,37520,6169,43689,365
2022-05-15,Marin,041,260295,36281,35486,3376,38862,293
2022-05-15,Mariposa,043,17540,2493,2463,219,2682,30
2022-05-15,Mendocino,045,87422,13449,13349,3292,16641,124
2022-05-15,Merced,047,269075,62985,62627,8895,71522,818
2022-05-15,Modoc,049,8938,746,747,254,1001,8
2022-05-15,Mono,051,14174,3013,3002,151,3153,6
2022-05-15,Monterey,053,433212,81208,80620,14685,95305,735
2022-05-15,Napa,055,140530,27053,26698,1075,27773,143
2022-05-15,Nevada,057,99092,16400,16240,1264,17504,127
2022-05-15,Orange,059,3164182,561423,557134,43398,600532,7017
2022-05-15,Placer,061,380077,64741,63963,7641,71604,626
2022-05-15,Plumas,063,18699,3047,3006,368,3374,13
2022-05-15,Riverside,065,2383286,601522,597914,28586,626500,6471
2022-05-15,Sacramento,067,1510023,289039,286403,27436,313839,3022
2022-05-15,San Benito,069,59416,13171,13106,558,13664,98
2022-05-15,San Bernardino,071,2135413,581461,572057,25278,597335,7423
2022-05-15,San Diego,073,3302833,773470,770323,55044,825367,5271
2022-05-15,San Francisco,075,870044,138393,134916,9111,144027,866
2022-05-15,San Joaquin,077,732212,169596,168174,10432,178606,2236
2022-05-15,San Luis Obispo,079,281455,53844,53502,4079,57581,478
2022-05-15,San Mateo,081,765935,132085,129480,7927,137407,709
2022-05-15,Santa Barbara,083,443738,88601,87773,4897,92670,693
2022-05-15,Santa Clara,085,1922200,334888,328609,13733,342342,2297
2022-05-15,Santa Cruz,087,273765,51319,50268,2273,52541,263
2022-05-15,Shasta,089,179085,30925,30799,6140,36939,557
2022-05-15,Sierra,091,2930,277,275,53,328,4
2022-05-15,Siskiyou,093,43540,4510,4482,2766,7248,81
2022-05-15,Solano,095,438530,85007,83669,5870,89539,451
2022-05-15,Sonoma,097,501317,88647,87070,3275,90345,488
2022-05-15,Stanislaus,099,539301,119344,118586,17914,136500,1645
2022-05-15,Sutter,101,95872,20756,20690,2134,22824,226
2022-05-15,Tehama,103,63373,12126,12115,2616,14731,201
2022-05-15,Trinity,105,12862,1194,1188,289,1477,20
2022-05-15,Tulare,107,460477,107169,107077,28108,135185,1469
2022-05-15,Tuolumne,109,53932,13001,12851,595,13446,182
2022-05-15,Ventura,111,848112,177829,176317,10210,186527,1497
2022-05-15,Yolo,113,214977,39146,37737,3214,40951,316
2022-05-15,Yuba,115,75493,16121,16028,1256,17284,122
2022-05-14,Alameda,001,1643700,273874,268944,15018,283962,1857
2022-05-14,Alpine,003,1148,125,125,1,126,0
2022-05-14,Amador,005,37829,8648,8574,671,9245,86
2022-05-14,Butte,007,227075,33655,33377,7136,40513,424
2022-05-14,Calaveras,009,45235,7404,7378,372,7750,120
2022-05-14,Colusa,011,21464,3463,3463,1055,4518,21
2022-05-14,Contra Costa,013,1133247,200595,195925,14342,210267,1301
2022-05-14,Del Norte,015,27424,6042,5919,200,6119,50
2022-05-14,El Dorado,017,186661,27487,27216,3323,30539,212
2022-05-14,Fresno,019,978130,234050,233305,24105,257410,2757
2022-05-14,Glenn,021,27897,5020,5004,1625,6629,48
2022-05-14,Humboldt,023,135768,17947,17633,3300,20933,146
2022-05-14,Imperial,025,180216,55911,55756,10716,66472,917
2022-05-14,Inyo,027,18085,4129,4114,525,4639,56
2022-05-14,Kern,029,883053,193573,192939,46493,239432,2314
2022-05-14,Kings,031,150075,51908,51779,3528,55307,447
2022-05-14,Lake,033,64148,10868,10790,905,11695,137
2022-05-14,Lassen,035,31185,8989,8987,878,9865,65
2022-05-14,Los Angeles,037,10098052,2789410,2768726,129260,2897986,31768
2022-05-14,Madera,039,155013,37708,37520,6169,43689,365
2022-05-14,Marin,041,260295,36176,35486,3327,38813,293
2022-05-14,Mariposa,043,17540,2492,2463,219,2682,30
2022-05-14,Mendocino,045,87422,13439,13349,3288,16637,124
2022-05-14,Merced,047,269075,62950,62627,8892,71519,818
2022-05-14,Modoc,049,8938,745,747,254,1001,8
2022-05-14,Mono,051,14174,3013,3002,150,3152,6
2022-05-14,Monterey,053,433212,81142,80620,14631,95251,735
2022-05-14,Napa,055,140530,27029,26698,1068,27766,143
2022-05-14,Nevada,057,99092,16385,16240,1263,17503,127
2022-05-14,Orange,059,3164182,560978,557134,43314,600448,7017
2022-05-14,Placer,061,380077,64635,63963,7619,71582,626
2022-05-14,Plumas,063,18699,3043,3006,368,3374,13
2022-05-14,Riverside,065,2383286,601115,597914,28551,626465,6471
2022-05-14,Sacramento,067,1510023,288769,286403,27415,313818,3022
2022-05-14,San Benito,069,59416,13160,13106,555,13661,98
2022-05-14,San Bernardino,071,2135413,581184,572057,25266,597323,7423
2022-05-14,San Diego,073,3302833,772871,770323,54998,825321,5271
2022-05-14,San Francisco,075,870044,138032,134916,9087,144003,866
2022-05-14,San Joaquin,077,732212,169455,168174,10416,178590,2236
2022-05-14,San Luis Obispo,079,281455,53817,53502,4076,57578,478
2022-05-14,San Mateo,081,765935,131762,129480,7898,137378,709
2022-05-14,Santa Barbara,083,443738,88494,87773,4892,92665,693
2022-05-14,Santa Clara,085,1922200,334055,328609,13694,342303,2297
2022-05-14,Santa Cruz,087,273765,51272,50268,2259,52527,263
2022-05-14,Shasta,089,179085,30920,30799,6139,36938,557
2022-05-14,Sierra,091,2930,277,275,53,328,4
2022-05-14,Siskiyou,093,43540,4507,4482,2764,7246,81
2022-05-14,Solano,095,438530,84946,83669,5860,89529,451
2022-05-14,Sonoma,097,501317,88504,87070,3263,90333,488
2022-05-14,Stanislaus,099,539301,119260,118586,17903,136489,1645
2022-05-14,Sutter,101,95872,20748,20690,2133,22823,226
2022-05-14,Tehama,103,63373,12120,12115,2615,14730,201
2022-05-14,Trinity,105,12862,1194,1188,289,1477,20
2022-05-14,Tulare,107,460477,107124,107077,28080,135157,1469
2022-05-14,Tuolumne,109,53932,12990,12851,595,13446,182
2022-05-14,Ventura,111,848112,177667,176317,10186,186503,1497
2022-05-14,Yolo,113,214977,39076,37737,3207,40944,316
2022-05-14,Yuba,115,75493,16114,16028,1255,17283,122
2022-05-13,Alameda,001,1643700,273397,268944,14987,283931,1857
2022-05-13,Alpine,003,1148,125,125,1,126,0
2022-05-13,Amador,005,37829,8643,8574,670,9244,86
2022-05-13,Butte,007,227075,33638,33377,7133,40510,424
2022-05-13,Calaveras,009,45235,7401,7378,372,7750,120
2022-05-13,Colusa,011,21464,3462,3463,1055,4518,21
2022-05-13,Contra Costa,013,1133247,200251,195925,14313,210238,1301
2022-05-13,Del Norte,015,27424,6039,5919,200,6119,50
2022-05-13,El Dorado,017,186661,27459,27216,3323,30539,212
2022-05-13,Fresno,019,978130,233941,233305,24086,257391,2757
2022-05-13,Glenn,021,27897,5018,5004,1624,6628,48
2022-05-13,Humboldt,023,135768,17923,17633,3292,20925,146
2022-05-13,Imperial,025,180216,55892,55756,10715,66471,917
2022-05-13,Inyo,027,18085,4129,4114,524,4638,56
2022-05-13,Kern,029,883053,193500,192939,46464,239403,2314
2022-05-13,Kings,031,150075,51884,51779,3528,55307,447
2022-05-13,Lake,033,64148,10865,10790,905,11695,137
2022-05-13,Lassen,035,31185,8988,8987,878,9865,65
2022-05-13,Los Angeles,037,10098052,2787468,2768726,129070,2897796,31768
2022-05-13,Madera,039,155013,37688,37520,6160,43680,365
2022-05-13,Marin,041,260295,36074,35486,3284,38770,293
2022-05-13,Mariposa,043,17540,2490,2463,219,2682,30
2022-05-13,Mendocino,045,87422,13425,13349,3281,16630,124
2022-05-13,Merced,047,269075,62915,62627,8884,71511,818
2022-05-13,Modoc,049,8938,745,747,254,1001,8
2022-05-13,Mono,051,14174,3011,3002,149,3151,6
2022-05-13,Monterey,053,433212,81086,80620,14591,95211,735
2022-05-13,Napa,055,140530,26992,26698,1066,27764,143
2022-05-13,Nevada,057,99092,16370,16240,1262,17502,127
2022-05-13,Orange,059,3164182,560512,557134,43244,600378,7017
2022-05-13,Placer,061,380077,64556,63963,7610,71573,626
2022-05-13,Plumas,063,18699,3036,3006,368,3374,13
2022-05-13,Riverside,065,2383286,600729,597914,28522,626436,6471
2022-05-13,Sacramento,067,1510023,288434,286403,27397,313800,3022
2022-05-13,San Benito,069,59416,13156,13106,555,13661,98
2022-05-13,San Bernardino,071,2135413,580944,572057,25258,597315,7423
2022-05-13,San Diego,073,3302833,772232,770323,54919,825242,5271
2022-05-13,San Francisco,075,870044,137678,134916,9067,143983,866
2022-05-13,San Joaquin,077,732212,169336,168174,10404,178578,2236
2022-05-13,San Luis Obispo,079,281455,53781,53502,4072,57574,478
2022-05-13,San Mateo,081,765935,131473,129480,7877,137357,709
2022-05-13,Santa Barbara,083,443738,88401,87773,4889,92662,693
2022-05-13,Santa Clara,085,1922200,333251,328609,13661,342270,2297
2022-05-13,Santa Cruz,087,273765,51185,50268,2251,52519,263
2022-05-13,Shasta,089,179085,30916,30799,6139,36938,557
2022-05-13,Sierra,091,2930,276,275,50,325,4
2022-05-13,Siskiyou,093,43540,4506,4482,2764,7246,81
2022-05-13,Solano,095,438530,84824,83669,5853,89522,451
2022-05-13,Sonoma,097,501317,88327,87070,3249,90319,488
2022-05-13,Stanislaus,099,539301,119166,118586,17894,136480,1645
2022-05-13,Sutter,101,95872,20736,20690,2132,22822,226
2022-05-13,Tehama,103,63373,12118,12115,2613,14728,201
2022-05-13,Trinity,105,12862,1193,1188,289,1477,20
2022-05-13,Tulare,107,460477,107078,107077,28044,135121,1469
2022-05-13,Tuolumne,109,53932,12974,12851,595,13446,182
2022-05-13,Ventura,111,848112,177487,176317,10172,186489,1497
2022-05-13,Yolo,113,214977,39013,37737,3203,40940,316
2022-05-13,Yuba,115,75493,16101,16028,1252,17280,122
2022-05-12,Alameda,001,1643700,272653,268944,14931,283875,1857
2022-05-12,Alpine,003,1148,125,125,1,126,0
2022-05-12,Amador,005,37829,8634,8574,670,9244,86
2022-05-12,Butte,007,227075,33611,33377,7119,40496,424
2022-05-12,Calaveras,009,45235,7397,7378,371,7749,120
2022-05-12,Colusa,011,21464,3462,3463,1054,4517,21
2022-05-12,Contra Costa,013,1133247,199731,195925,14250,210175,1301
2022-05-12,Del Norte,015,27424,6022,5919,199,6118,50
2022-05-12,El Dorado,017,186661,27419,27216,3314,30530,212
2022-05-12,Fresno,019,978130,233791,233305,24066,257371,2757
2022-05-12,Glenn,021,27897,5014,5004,1622,6626,48
2022-05-12,Humboldt,023,135768,17881,17633,3279,20912,146
2022-05-12,Imperial,025,180216,55865,55756,10702,66458,917
2022-05-12,Inyo,027,18085,4125,4114,519,4633,56
2022-05-12,Kern,029,883053,193435,192939,46417,239356,2314
2022-05-12,Kings,031,150075,51863,51779,3526,55305,447
2022-05-12,Lake,033,64148,10847,10790,899,11689,137
2022-05-12,Lassen,035,31185,8987,8987,878,9865,65
2022-05-12,Los Angeles,037,10098052,2784256,2768726,128800,2897526,31768
2022-05-12,Madera,039,155013,37663,37520,6148,43668,365
2022-05-12,Marin,041,260295,35974,35486,3261,38747,293
2022-05-12,Mariposa,043,17540,2485,2463,218,2681,30
2022-05-12,Mendocino,045,87422,13408,13349,3269,16618,124
2022-05-12,Merced,047,269075,62882,62627,8873,71500,818
2022-05-12,Modoc,049,8938,744,747,254,1001,8
2022-05-12,Mono,051,14174,3011,3002,148,3150,6
2022-05-12,Monterey,053,433212,81028,80620,14548,95168,735
2022-05-12,Napa,055,140530,26946,26698,1064,27762,143
2022-05-12,Nevada,057,99092,16348,16240,1261,17501,127
2022-05-12,Orange,059,3164182,559873,557134,43136,600270,7017
2022-05-12,Placer,061,380077,64458,63963,7587,71550,626
2022-05-12,Plumas,063,18699,3030,3006,368,3374,13
2022-05-12,Riverside,065,2383286,600274,597914,28489,626403,6471
2022-05-12,Sacramento,067,1510023,287975,286403,27333,313736,3022
2022-05-12,San Benito,069,59416,13141,13106,554,13660,98
2022-05-12,San Bernardino,071,2135413,580592,572057,25241,597298,7423
2022-05-12,San Diego,073,3302833,771278,770323,54830,825153,5271
2022-05-12,San Francisco,075,870044,137297,134916,9028,143944,866
2022-05-12,San Joaquin,077,732212,169155,168174,10361,178535,2236
2022-05-12,San Luis Obispo,079,281455,53722,53502,4043,57545,478
2022-05-12,San Mateo,081,765935,131065,129480,7826,137306,709
2022-05-12,Santa Barbara,083,443738,88295,87773,4878,92651,693
2022-05-12,Santa Clara,085,1922200,332271,328609,13573,342182,2297
2022-05-12,Santa Cruz,087,273765,51041,50268,2244,52512,263
2022-05-12,Shasta,089,179085,30903,30799,6136,36935,557
2022-05-12,Sierra,091,2930,275,275,50,325,4
2022-05-12,Siskiyou,093,43540,4501,4482,2762,7244,81
2022-05-12,Solano,095,438530,84608,83669,5840,89509,451
2022-05-12,Sonoma,097,501317,88110,87070,3222,90292,488
2022-05-12,Stanislaus,099,539301,119065,118586,17868,136454,1645
2022-05-12,Sutter,101,95872,20720,20690,2131,22821,226
2022-05-12,Tehama,103,63373,12111,12115,2611,14726,201
2022-05-12,Trinity,105,12862,1192,1188,288,1476,20
2022-05-12,Tulare,107,460477,107024,107077,27995,135072,1469
2022-05-12,Tuolumne,109,53932,12953,12851,593,13444,182
2022-05-12,Ventura,111,848112,177257,176317,10130,186447,1497
2022-05-12,Yolo,113,214977,38900,37737,3193,40930,316
2022-05-12,Yuba,115,75493,16085,16028,1249,17277,122
2022-05-11,Alameda,001,1643700,271941,267982,14876,282858,1853
2022-05-11,Alpine,003,1148,125,125,1,126,0
2022-05-11,Amador,005,37829,8627,8564,670,9234,86
2022-05-11,Butte,007,227075,33579,33339,7113,40452,423
2022-05-11,Calaveras,009,45235,7392,7368,367,7735,120
2022-05-11,Colusa,011,21464,3461,3462,1054,4516,21
2022-05-11,Contra Costa,013,1133247,199216,195153,14195,209348,1302
2022-05-11,Del Norte,015,27424,6012,5911,199,6110,50
2022-05-11,El Dorado,017,186661,27383,27172,3307,30479,212
2022-05-11,Fresno,019,978130,233628,233021,24033,257054,2754
2022-05-11,Glenn,021,27897,5014,5001,1620,6621,48
2022-05-11,Humboldt,023,135768,17838,17585,3263,20848,146
2022-05-11,Imperial,025,180216,55839,55751,10692,66443,917
2022-05-11,Inyo,027,18085,4124,4093,518,4611,56
2022-05-11,Kern,029,883053,193338,192795,46372,239167,2292
2022-05-11,Kings,031,150075,51835,51752,3524,55276,447
2022-05-11,Lake,033,64148,10834,10786,898,11684,137
2022-05-11,Lassen,035,31185,8986,8984,877,9861,65
2022-05-11,Los Angeles,037,10098052,2781117,2761410,128572,2889982,31747
2022-05-11,Madera,039,155013,37630,37496,6137,43633,365
2022-05-11,Marin,041,260295,35873,35336,3219,38555,292
2022-05-11,Mariposa,043,17540,2480,2461,218,2679,30
2022-05-11,Mendocino,045,87422,13393,13320,3252,16572,124
2022-05-11,Merced,047,269075,62841,62567,8852,71419,818
2022-05-11,Modoc,049,8938,743,747,254,1001,8
2022-05-11,Mono,051,14174,3011,2999,147,3146,6
2022-05-11,Monterey,053,433212,80965,80534,14497,95031,733
2022-05-11,Napa,055,140530,26893,26660,1062,27722,143
2022-05-11,Nevada,057,99092,16332,16230,1256,17486,127
2022-05-11,Orange,059,3164182,559198,556265,43058,599323,7009
2022-05-11,Placer,061,380077,64360,63823,7572,71395,625
2022-05-11,Plumas,063,18699,3022,2998,368,3366,13
2022-05-11,Riverside,065,2383286,599824,597302,28453,625755,6468
2022-05-11,Sacramento,067,1510023,287560,285799,27286,313085,3020
2022-05-11,San Benito,069,59416,13121,13088,550,13638,98
2022-05-11,San Bernardino,071,2135413,580226,571372,25232,596604,7354
2022-05-11,San Diego,073,3302833,770296,768135,54700,822835,5257
2022-05-11,San Francisco,075,870044,136797,134027,9003,143030,864
2022-05-11,San Joaquin,077,732212,168979,167949,10339,178288,2233
2022-05-11,San Luis Obispo,079,281455,53675,53420,4026,57446,478
2022-05-11,San Mateo,081,765935,130668,128821,7782,136603,711
2022-05-11,Santa Barbara,083,443738,88166,87593,4866,92459,693
2022-05-11,Santa Clara,085,1922200,331263,327177,13525,340702,2294
2022-05-11,Santa Cruz,087,273765,50883,50031,2230,52261,263
2022-05-11,Shasta,089,179085,30871,30768,6133,36901,564
2022-05-11,Sierra,091,2930,275,275,50,325,4
2022-05-11,Siskiyou,093,43540,4499,4478,2762,7240,81
2022-05-11,Solano,095,438530,84411,83464,5827,89291,450
2022-05-11,Sonoma,097,501317,87906,86798,3209,90007,488
2022-05-11,Stanislaus,099,539301,118964,118445,17850,136295,1644
2022-05-11,Sutter,101,95872,20705,20668,2130,22798,225
2022-05-11,Tehama,103,63373,12111,12106,2611,14717,201
2022-05-11,Trinity,105,12862,1190,1188,288,1476,20
2022-05-11,Tulare,107,460477,106968,107068,27962,135030,1468
2022-05-11,Tuolumne,109,53932,12934,12829,593,13422,181
2022-05-11,Ventura,111,848112,177058,175955,10089,186044,1491
2022-05-11,Yolo,113,214977,38785,37654,3188,40842,316
2022-05-11,Yuba,115,75493,16066,15997,1240,17237,122
2022-05-10,Alameda,001,1643700,271159,267982,14823,282805,1853
2022-05-10,Alpine,003,1148,125,125,1,126,0
2022-05-10,Amador,005,37829,8623,8564,669,9233,86
2022-05-10,Butte,007,227075,33552,33339,7109,40448,423
2022-05-10,Calaveras,009,45235,7388,7368,366,7734,120
2022-05-10,Colusa,011,21464,3461,3462,1053,4515,21
2022-05-10,Contra Costa,013,1133247,198734,195153,14153,209306,1302
2022-05-10,Del Norte,015,27424,5959,5911,199,6110,50
2022-05-10,El Dorado,017,186661,27346,27172,3301,30473,212
2022-05-10,Fresno,019,978130,233468,233021,24005,257026,2754
2022-05-10,Glenn,021,27897,5011,5001,1620,6621,48
2022-05-10,Humboldt,023,135768,17800,17585,3246,20831,146
2022-05-10,Imperial,025,180216,55804,55751,10674,66425,917
2022-05-10,Inyo,027,18085,4122,4093,512,4605,56
2022-05-10,Kern,029,883053,193236,192795,46333,239128,2292
2022-05-10,Kings,031,150075,51804,51752,3524,55276,447
2022-05-10,Lake,033,64148,10829,10786,898,11684,137
2022-05-10,Lassen,035,31185,8981,8984,877,9861,65
2022-05-10,Los Angeles,037,10098052,2777820,2761410,128337,2889747,31747
2022-05-10,Madera,039,155013,37598,37496,6124,43620,365
2022-05-10,Marin,041,260295,35760,35336,3176,38512,292
2022-05-10,Mariposa,043,17540,2480,2461,218,2679,30
2022-05-10,Mendocino,045,87422,13381,13320,3239,16559,124
2022-05-10,Merced,047,269075,62795,62567,8833,71400,818
2022-05-10,Modoc,049,8938,743,747,254,1001,8
2022-05-10,Mono,051,14174,3007,2999,143,3142,6
2022-05-10,Monterey,053,433212,80899,80534,14449,94983,733
2022-05-10,Napa,055,140530,26855,26660,1060,27720,143
2022-05-10,Nevada,057,99092,16312,16230,1253,17483,127
2022-05-10,Orange,059,3164182,558493,556265,42967,599232,7009
2022-05-10,Placer,061,380077,64246,63823,7557,71380,625
2022-05-10,Plumas,063,18699,3014,2998,367,3365,13
2022-05-10,Riverside,065,2383286,599398,597302,28424,625726,6468
2022-05-10,Sacramento,067,1510023,287059,285799,27219,313018,3020
2022-05-10,San Benito,069,59416,13104,13088,545,13633,98
2022-05-10,San Bernardino,071,2135413,579867,571372,25206,596578,7354
2022-05-10,San Diego,073,3302833,769277,768135,54581,822716,5257
2022-05-10,San Francisco,075,870044,136247,134027,8977,143004,864
2022-05-10,San Joaquin,077,732212,168821,167949,10278,178227,2233
2022-05-10,San Luis Obispo,079,281455,53599,53420,4001,57421,478
2022-05-10,San Mateo,081,765935,130293,128821,7742,136563,711
2022-05-10,Santa Barbara,083,443738,88050,87593,4851,92444,693
2022-05-10,Santa Clara,085,1922200,330238,327177,13443,340620,2294
2022-05-10,Santa Cruz,087,273765,50757,50031,2219,52250,263
2022-05-10,Shasta,089,179085,30851,30768,6132,36900,564
2022-05-10,Sierra,091,2930,275,275,49,324,4
2022-05-10,Siskiyou,093,43540,4495,4478,2762,7240,81
2022-05-10,Solano,095,438530,84227,83464,5808,89272,450
2022-05-10,Sonoma,097,501317,87666,86798,3171,89969,488
2022-05-10,Stanislaus,099,539301,118870,118445,17832,136277,1644
2022-05-10,Sutter,101,95872,20686,20668,2127,22795,225
2022-05-10,Tehama,103,63373,12108,12106,2604,14710,201
2022-05-10,Trinity,105,12862,1190,1188,288,1476,20
2022-05-10,Tulare,107,460477,106925,107068,27934,135002,1468
2022-05-10,Tuolumne,109,53932,12922,12829,593,13422,181
2022-05-10,Ventura,111,848112,176840,175955,10053,186008,1491
2022-05-10,Yolo,113,214977,38681,37654,3177,40831,316
2022-05-10,Yuba,115,75493,16045,15997,1237,17234,122
2022-05-09,Alameda,001,1643700,270387,267982,14778,282760,1853
2022-05-09,Alpine,003,1148,125,125,1,126,0
2022-05-09,Amador,005,37829,8616,8564,669,9233,86
2022-05-09,Butte,007,227075,33526,33339,7100,40439,423
2022-05-09,Calaveras,009,45235,7382,7368,366,7734,120
2022-05-09,Colusa,011,21464,3459,3462,1051,4513,21
2022-05-09,Contra Costa,013,1133247,198268,195153,14095,209248,1302
2022-05-09,Del Norte,015,27424,5950,5911,198,6109,50
2022-05-09,El Dorado,017,186661,27310,27172,3293,30465,212
2022-05-09,Fresno,019,978130,233309,233021,23983,257004,2754
2022-05-09,Glenn,021,27897,5009,5001,1618,6619,48
2022-05-09,Humboldt,023,135768,17749,17585,3224,20809,146
2022-05-09,Imperial,025,180216,55771,55751,10661,66412,917
2022-05-09,Inyo,027,18085,4119,4093,509,4602,56
2022-05-09,Kern,029,883053,193138,192795,46277,239072,2292
2022-05-09,Kings,031,150075,51773,51752,3523,55275,447
2022-05-09,Lake,033,64148,10821,10786,897,11683,137
2022-05-09,Lassen,035,31185,8979,8984,877,9861,65
2022-05-09,Los Angeles,037,10098052,2774463,2761410,128094,2889504,31747
2022-05-09,Madera,039,155013,37567,37496,6115,43611,365
2022-05-09,Marin,041,260295,35643,35336,3141,38477,292
2022-05-09,Mariposa,043,17540,2475,2461,218,2679,30
2022-05-09,Mendocino,045,87422,13370,13320,3228,16548,124
2022-05-09,Merced,047,269075,62754,62567,8814,71381,818
2022-05-09,Modoc,049,8938,743,747,254,1001,8
2022-05-09,Mono,051,14174,3005,2999,141,3140,6
2022-05-09,Monterey,053,433212,80807,80534,14395,94929,733
2022-05-09,Napa,055,140530,26805,26660,1058,27718,143
2022-05-09,Nevada,057,99092,16284,16230,1247,17477,127
2022-05-09,Orange,059,3164182,557824,556265,42887,599152,7009
2022-05-09,Placer,061,380077,64185,63823,7541,71364,625
2022-05-09,Plumas,063,18699,3005,2998,367,3365,13
2022-05-09,Riverside,065,2383286,598909,597302,28388,625690,6468
2022-05-09,Sacramento,067,1510023,286632,285799,27147,312946,3020
2022-05-09,San Benito,069,59416,13085,13088,543,13631,98
2022-05-09,San Bernardino,071,2135413,579535,571372,25195,596567,7354
2022-05-09,San Diego,073,3302833,768299,768135,54440,822575,5257
2022-05-09,San Francisco,075,870044,135691,134027,8953,142980,864
2022-05-09,San Joaquin,077,732212,168638,167949,10256,178205,2233
2022-05-09,San Luis Obispo,079,281455,53545,53420,3980,57400,478
2022-05-09,San Mateo,081,765935,129867,128821,7704,136525,711
2022-05-09,Santa Barbara,083,443738,87920,87593,4840,92433,693
2022-05-09,Santa Clara,085,1922200,329100,327177,13379,340556,2294
2022-05-09,Santa Cruz,087,273765,50616,50031,2211,52242,263
2022-05-09,Shasta,089,179085,30837,30768,6130,36898,564
2022-05-09,Sierra,091,2930,275,275,49,324,4
2022-05-09,Siskiyou,093,43540,4493,4478,2762,7240,81
2022-05-09,Solano,095,438530,84071,83464,5795,89259,450
2022-05-09,Sonoma,097,501317,87406,86798,3145,89943,488
2022-05-09,Stanislaus,099,539301,118774,118445,17815,136260,1644
2022-05-09,Sutter,101,95872,20673,20668,2126,22794,225
2022-05-09,Tehama,103,63373,12106,12106,2602,14708,201
2022-05-09,Trinity,105,12862,1190,1188,288,1476,20
2022-05-09,Tulare,107,460477,106877,107068,27897,134965,1468
2022-05-09,Tuolumne,109,53932,12914,12829,593,13422,181
2022-05-09,Ventura,111,848112,176623,175955,10005,185960,1491
2022-05-09,Yolo,113,214977,38572,37654,3168,40822,316
2022-05-09,Yuba,115,75493,16036,15997,1236,17233,122
2022-05-08,Alameda,001,1643700,269493,265198,14710,279908,1855
2022-05-08,Alpine,003,1148,125,125,1,126,0
2022-05-08,Amador,005,37829,8605,8556,667,9223,86
2022-05-08,Butte,007,227075,33503,33269,7089,40358,421
2022-05-08,Calaveras,009,45235,7375,7353,365,7718,120
2022-05-08,Colusa,011,21464,3458,3459,1051,4510,21
2022-05-08,Contra Costa,013,1133247,197755,193961,14014,207975,1302
2022-05-08,Del Norte,015,27424,5934,5884,198,6082,50
2022-05-08,El Dorado,017,186661,27272,27081,3287,30368,210
2022-05-08,Fresno,019,978130,233143,232655,23960,256615,2754
2022-05-08,Glenn,021,27897,5007,4996,1618,6614,48
2022-05-08,Humboldt,023,135768,17696,17410,3185,20595,146
2022-05-08,Imperial,025,180216,55737,55683,10652,66335,917
2022-05-08,Inyo,027,18085,4112,4087,509,4596,56
2022-05-08,Kern,029,883053,193044,192590,46232,238822,2287
2022-05-08,Kings,031,150075,51756,51702,3523,55225,447
2022-05-08,Lake,033,64148,10814,10766,897,11663,137
2022-05-08,Lassen,035,31185,8975,8978,877,9855,65
2022-05-08,Los Angeles,037,10098052,2770877,2751478,127805,2879283,31738
2022-05-08,Madera,039,155013,37545,37420,6096,43516,365
2022-05-08,Marin,041,260295,35519,34934,3094,38028,292
2022-05-08,Mariposa,043,17540,2468,2438,217,2655,30
2022-05-08,Mendocino,045,87422,13351,13270,3202,16472,124
2022-05-08,Merced,047,269075,62704,62471,8787,71258,818
2022-05-08,Modoc,049,8938,743,745,254,999,8
2022-05-08,Mono,051,14174,3004,2997,139,3136,6
2022-05-08,Monterey,053,433212,80714,80246,14312,94558,733
2022-05-08,Napa,055,140530,26764,26524,1055,27579,143
2022-05-08,Nevada,057,99092,16260,16171,1245,17416,127
2022-05-08,Orange,059,3164182,557146,554411,42785,597196,7007
2022-05-08,Placer,061,380077,64068,63577,7514,71091,625
2022-05-08,Plumas,063,18699,3001,2996,367,3363,13
2022-05-08,Riverside,065,2383286,598422,596022,28352,624374,6467
2022-05-08,Sacramento,067,1510023,286128,284564,27075,311639,3016
2022-05-08,San Benito,069,59416,13070,13047,540,13587,98
2022-05-08,San Bernardino,071,2135413,579103,570381,25162,595543,7306
2022-05-08,San Diego,073,3302833,767270,765377,54336,819713,5244
2022-05-08,San Francisco,075,870044,135036,132659,8923,141582,861
2022-05-08,San Joaquin,077,732212,168450,167568,10223,177791,2229
2022-05-08,San Luis Obispo,079,281455,53474,53273,3960,57233,477
2022-05-08,San Mateo,081,765935,129405,127615,7651,135266,709
2022-05-08,Santa Barbara,083,443738,87786,87305,4831,92136,692
2022-05-08,Santa Clara,085,1922200,328031,324946,13304,338250,2287
2022-05-08,Santa Cruz,087,273765,50436,49605,2207,51812,262
2022-05-08,Shasta,089,179085,30809,30721,6126,36847,563
2022-05-08,Sierra,091,2930,275,275,49,324,4
2022-05-08,Siskiyou,093,43540,4490,4470,2757,7227,81
2022-05-08,Solano,095,438530,83900,83038,5770,88808,450
2022-05-08,Sonoma,097,501317,87187,86150,3110,89260,488
2022-05-08,Stanislaus,099,539301,118666,118235,17793,136028,1643
2022-05-08,Sutter,101,95872,20652,20694,2122,22816,225
2022-05-08,Tehama,103,63373,12100,12098,2599,14697,201
2022-05-08,Trinity,105,12862,1189,1180,288,1468,20
2022-05-08,Tulare,107,460477,106837,106987,27862,134849,1468
2022-05-08,Tuolumne,109,53932,12901,12793,589,13382,181
2022-05-08,Ventura,111,848112,176386,175454,9959,185413,1491
2022-05-08,Yolo,113,214977,38466,37456,3154,40610,315
2022-05-08,Yuba,115,75493,16014,15964,1232,17196,122
2022-05-07,Alameda,001,1643700,269115,265198,14692,279890,1855
2022-05-07,Alpine,003,1148,125,125,1,126,0
2022-05-07,Amador,005,37829,8603,8556,667,9223,86
2022-05-07,Butte,007,227075,33495,33269,7083,40352,421
2022-05-07,Calaveras,009,45235,7368,7353,365,7718,120
2022-05-07,Colusa,011,21464,3458,3459,1051,4510,21
2022-05-07,Contra Costa,013,1133247,197514,193961,13997,207958,1302
2022-05-07,Del Norte,015,27424,5932,5884,198,6082,50
2022-05-07,El Dorado,017,186661,27254,27081,3286,30367,210
2022-05-07,Fresno,019,978130,233087,232655,23953,256608,2754
2022-05-07,Glenn,021,27897,5006,4996,1618,6614,48
2022-05-07,Humboldt,023,135768,17668,17410,3177,20587,146
2022-05-07,Imperial,025,180216,55714,55683,10646,66329,917
2022-05-07,Inyo,027,18085,4109,4087,509,4596,56
2022-05-07,Kern,029,883053,193009,192590,46211,238801,2287
2022-05-07,Kings,031,150075,51745,51702,3523,55225,447
2022-05-07,Lake,033,64148,10810,10766,897,11663,137
2022-05-07,Lassen,035,31185,8975,8978,877,9855,65
2022-05-07,Los Angeles,037,10098052,2769284,2751478,127636,2879114,31738
2022-05-07,Madera,039,155013,37538,37420,6096,43516,365
2022-05-07,Marin,041,260295,35445,34934,3062,37996,292
2022-05-07,Mariposa,043,17540,2465,2438,217,2655,30
2022-05-07,Mendocino,045,87422,13342,13270,3199,16469,124
2022-05-07,Merced,047,269075,62691,62471,8787,71258,818
2022-05-07,Modoc,049,8938,743,745,254,999,8
2022-05-07,Mono,051,14174,3003,2997,139,3136,6
2022-05-07,Monterey,053,433212,80654,80246,14286,94532,733
2022-05-07,Napa,055,140530,26734,26524,1054,27578,143
2022-05-07,Nevada,057,99092,16250,16171,1240,17411,127
2022-05-07,Orange,059,3164182,556818,554411,42736,597147,7007
2022-05-07,Placer,061,380077,64005,63577,7507,71084,625
2022-05-07,Plumas,063,18699,3001,2996,366,3362,13
2022-05-07,Riverside,065,2383286,598168,596022,28325,624347,6467
2022-05-07,Sacramento,067,1510023,285934,284564,27062,311626,3016
2022-05-07,San Benito,069,59416,13061,13047,535,13582,98
2022-05-07,San Bernardino,071,2135413,578889,570381,25157,595538,7306
2022-05-07,San Diego,073,3302833,766784,765377,54306,819683,5244
2022-05-07,San Francisco,075,870044,134707,132659,8903,141562,861
2022-05-07,San Joaquin,077,732212,168345,167568,10215,177783,2229
2022-05-07,San Luis Obispo,079,281455,53462,53273,3949,57222,477
2022-05-07,San Mateo,081,765935,129120,127615,7629,135244,709
2022-05-07,Santa Barbara,083,443738,87706,87305,4828,92133,692
2022-05-07,Santa Clara,085,1922200,327410,324946,13274,338220,2287
2022-05-07,Santa Cruz,087,273765,50383,49605,2197,51802,262
2022-05-07,Shasta,089,179085,30801,30721,6126,36847,563
2022-05-07,Sierra,091,2930,275,275,49,324,4
2022-05-07,Siskiyou,093,43540,4488,4470,2757,7227,81
2022-05-07,Solano,095,438530,83844,83038,5766,88804,450
2022-05-07,Sonoma,097,501317,87062,86150,3101,89251,488
2022-05-07,Stanislaus,099,539301,118619,118235,17786,136021,1643
2022-05-07,Sutter,101,95872,20643,20694,2122,22816,225
2022-05-07,Tehama,103,63373,12098,12098,2598,14696,201
2022-05-07,Trinity,105,12862,1189,1180,288,1468,20
2022-05-07,Tulare,107,460477,106813,106987,27850,134837,1468
2022-05-07,Tuolumne,109,53932,12894,12793,589,13382,181
2022-05-07,Ventura,111,848112,176275,175454,9935,185389,1491
2022-05-07,Yolo,113,214977,38421,37456,3152,40608,315
2022-05-07,Yuba,115,75493,16005,15964,1232,17196,122
2022-05-06,Alameda,001,1643700,268733,265198,14671,279869,1855
2022-05-06,Alpine,003,1148,125,125,1,126,0
2022-05-06,Amador,005,37829,8602,8556,666,9222,86
2022-05-06,Butte,007,227075,33486,33269,7080,40349,421
2022-05-06,Calaveras,009,45235,7366,7353,365,7718,120
2022-05-06,Colusa,011,21464,3458,3459,1051,4510,21
2022-05-06,Contra Costa,013,1133247,197281,193961,13985,207946,1302
2022-05-06,Del Norte,015,27424,5922,5884,198,6082,50
2022-05-06,El Dorado,017,186661,27229,27081,3284,30365,210
2022-05-06,Fresno,019,978130,233011,232655,23944,256599,2754
2022-05-06,Glenn,021,27897,5006,4996,1618,6614,48
2022-05-06,Humboldt,023,135768,17641,17410,3170,20580,146
2022-05-06,Imperial,025,180216,55705,55683,10643,66326,917
2022-05-06,Inyo,027,18085,4100,4087,506,4593,56
2022-05-06,Kern,029,883053,192957,192590,46184,238774,2287
2022-05-06,Kings,031,150075,51737,51702,3523,55225,447
2022-05-06,Lake,033,64148,10808,10766,897,11663,137
2022-05-06,Lassen,035,31185,8975,8978,877,9855,65
2022-05-06,Los Angeles,037,10098052,2767458,2751478,127491,2878969,31738
2022-05-06,Madera,039,155013,37524,37420,6093,43513,365
2022-05-06,Marin,041,260295,35367,34934,3016,37950,292
2022-05-06,Mariposa,043,17540,2464,2438,210,2648,30
2022-05-06,Mendocino,045,87422,13330,13270,3197,16467,124
2022-05-06,Merced,047,269075,62674,62471,8786,71257,818
2022-05-06,Modoc,049,8938,743,745,254,999,8
2022-05-06,Mono,051,14174,3002,2997,139,3136,6
2022-05-06,Monterey,053,433212,80615,80246,14249,94495,733
2022-05-06,Napa,055,140530,26717,26524,1054,27578,143
2022-05-06,Nevada,057,99092,16238,16171,1238,17409,127
2022-05-06,Orange,059,3164182,556473,554411,42670,597081,7007
2022-05-06,Placer,061,380077,63944,63577,7495,71072,625
2022-05-06,Plumas,063,18699,2999,2996,366,3362,13
2022-05-06,Riverside,065,2383286,597940,596022,28305,624327,6467
2022-05-06,Sacramento,067,1510023,285677,284564,27042,311606,3016
2022-05-06,San Benito,069,59416,13057,13047,535,13582,98
2022-05-06,San Bernardino,071,2135413,578712,570381,25151,595532,7306
2022-05-06,San Diego,073,3302833,766274,765377,54270,819647,5244
2022-05-06,San Francisco,075,870044,134379,132659,8882,141541,861
2022-05-06,San Joaquin,077,732212,168255,167568,10203,177771,2229
2022-05-06,San Luis Obispo,079,281455,53436,53273,3944,57217,477
2022-05-06,San Mateo,081,765935,128894,127615,7620,135235,709
2022-05-06,Santa Barbara,083,443738,87652,87305,4826,92131,692
2022-05-06,Santa Clara,085,1922200,326820,324946,13259,338205,2287
2022-05-06,Santa Cruz,087,273765,50318,49605,2193,51798,262
2022-05-06,Shasta,089,179085,30795,30721,6125,36846,563
2022-05-06,Sierra,091,2930,275,275,49,324,4
2022-05-06,Siskiyou,093,43540,4486,4470,2755,7225,81
2022-05-06,Solano,095,438530,83755,83038,5758,88796,450
2022-05-06,Sonoma,097,501317,86940,86150,3086,89236,488
2022-05-06,Stanislaus,099,539301,118562,118235,17779,136014,1643
2022-05-06,Sutter,101,95872,20637,20694,2122,22816,225
2022-05-06,Tehama,103,63373,12093,12098,2598,14696,201
2022-05-06,Trinity,105,12862,1188,1180,288,1468,20
2022-05-06,Tulare,107,460477,106794,106987,27839,134826,1468
2022-05-06,Tuolumne,109,53932,12887,12793,588,13381,181
2022-05-06,Ventura,111,848112,176159,175454,9905,185359,1491
2022-05-06,Yolo,113,214977,38374,37456,3148,40604,315
2022-05-06,Yuba,115,75493,15994,15964,1231,17195,122
2022-05-05,Alameda,001,1643700,268145,265198,14626,279824,1855
2022-05-05,Alpine,003,1148,125,125,1,126,0
2022-05-05,Amador,005,37829,8600,8556,665,9221,86
2022-05-05,Butte,007,227075,33467,33269,7073,40342,421
2022-05-05,Calaveras,009,45235,7363,7353,363,7716,120
2022-05-05,Colusa,011,21464,3458,3459,1048,4507,21
2022-05-05,Contra Costa,013,1133247,196887,193961,13941,207902,1302
2022-05-05,Del Norte,015,27424,5921,5884,198,6082,50
2022-05-05,El Dorado,017,186661,27204,27081,3277,30358,210
2022-05-05,Fresno,019,978130,232910,232655,23921,256576,2754
2022-05-05,Glenn,021,27897,5006,4996,1618,6614,48
2022-05-05,Humboldt,023,135768,17603,17410,3156,20566,146
2022-05-05,Imperial,025,180216,55698,55683,10632,66315,917
2022-05-05,Inyo,027,18085,4096,4087,505,4592,56
2022-05-05,Kern,029,883053,192900,192590,46146,238736,2287
2022-05-05,Kings,031,150075,51729,51702,3523,55225,447
2022-05-05,Lake,033,64148,10804,10766,897,11663,137
2022-05-05,Lassen,035,31185,8975,8978,877,9855,65
2022-05-05,Los Angeles,037,10098052,2764872,2751478,127267,2878745,31738
2022-05-05,Madera,039,155013,37507,37420,6088,43508,365
2022-05-05,Marin,041,260295,35257,34934,2994,37928,292
2022-05-05,Mariposa,043,17540,2462,2438,209,2647,30
2022-05-05,Mendocino,045,87422,13319,13270,3189,16459,124
2022-05-05,Merced,047,269075,62641,62471,8782,71253,818
2022-05-05,Modoc,049,8938,743,745,252,997,8
2022-05-05,Mono,051,14174,3001,2997,138,3135,6
2022-05-05,Monterey,053,433212,80560,80246,14220,94466,733
2022-05-05,Napa,055,140530,26684,26524,1053,27577,143
2022-05-05,Nevada,057,99092,16228,16171,1235,17406,127
2022-05-05,Orange,059,3164182,555965,554411,42614,597025,7007
2022-05-05,Placer,061,380077,63883,63577,7486,71063,625
2022-05-05,Plumas,063,18699,2998,2996,366,3362,13
2022-05-05,Riverside,065,2383286,597602,596022,28278,624300,6467
2022-05-05,Sacramento,067,1510023,285343,284564,26988,311552,3016
2022-05-05,San Benito,069,59416,13046,13047,533,13580,98
2022-05-05,San Bernardino,071,2135413,578420,570381,25135,595516,7306
2022-05-05,San Diego,073,3302833,765533,765377,54200,819577,5244
2022-05-05,San Francisco,075,870044,133963,132659,8848,141507,861
2022-05-05,San Joaquin,077,732212,168163,167568,10175,177743,2229
2022-05-05,San Luis Obispo,079,281455,53400,53273,3929,57202,477
2022-05-05,San Mateo,081,765935,128557,127615,7595,135210,709
2022-05-05,Santa Barbara,083,443738,87577,87305,4821,92126,692
2022-05-05,Santa Clara,085,1922200,326026,324946,13197,338143,2287
2022-05-05,Santa Cruz,087,273765,50220,49605,2189,51794,262
2022-05-05,Shasta,089,179085,30785,30721,6123,36844,563
2022-05-05,Sierra,091,2930,275,275,49,324,4
2022-05-05,Siskiyou,093,43540,4484,4470,2755,7225,81
2022-05-05,Solano,095,438530,83635,83038,5740,88778,450
2022-05-05,Sonoma,097,501317,86767,86150,3068,89218,488
2022-05-05,Stanislaus,099,539301,118504,118235,17765,136000,1643
2022-05-05,Sutter,101,95872,20635,20694,2120,22814,225
2022-05-05,Tehama,103,63373,12089,12098,2596,14694,201
2022-05-05,Trinity,105,12862,1188,1180,288,1468,20
2022-05-05,Tulare,107,460477,106764,106987,27821,134808,1468
2022-05-05,Tuolumne,109,53932,12869,12793,585,13378,181
2022-05-05,Ventura,111,848112,175971,175454,9862,185316,1491
2022-05-05,Yolo,113,214977,38303,37456,3137,40593,315
2022-05-05,Yuba,115,75493,15984,15964,1228,17192,122
2022-05-04,Alameda,001,1643700,267483,263736,14584,278320,1850
2022-05-04,Alpine,003,1148,125,124,1,125,0
2022-05-04,Amador,005,37829,8597,8546,664,9210,86
2022-05-04,Butte,007,227075,33450,33220,7068,40288,417
2022-05-04,Calaveras,009,45235,7358,7344,363,7707,120
2022-05-04,Colusa,011,21464,3457,3460,1048,4508,21
2022-05-04,Contra Costa,013,1133247,196522,193175,13886,207061,1302
2022-05-04,Del Norte,015,27424,5913,5866,198,6064,50
2022-05-04,El Dorado,017,186661,27179,27021,3270,30291,210
2022-05-04,Fresno,019,978130,232793,232332,23910,256242,2751
2022-05-04,Glenn,021,27897,5004,4995,1618,6613,48
2022-05-04,Humboldt,023,135768,17563,17316,3146,20462,146
2022-05-04,Imperial,025,180216,55676,55548,10624,66172,910
2022-05-04,Inyo,027,18085,4096,4085,502,4587,56
2022-05-04,Kern,029,883053,192835,192432,46110,238542,2281
2022-05-04,Kings,031,150075,51711,51663,3522,55185,447
2022-05-04,Lake,033,64148,10799,10758,897,11655,137
2022-05-04,Lassen,035,31185,8974,8972,875,9847,65
2022-05-04,Los Angeles,037,10098052,2762093,2744894,127076,2871970,31722
2022-05-04,Madera,039,155013,37483,37395,6083,43478,365
2022-05-04,Marin,041,260295,35170,34727,2972,37699,291
2022-05-04,Mariposa,043,17540,2456,2435,204,2639,30
2022-05-04,Mendocino,045,87422,13311,13247,3181,16428,123
2022-05-04,Merced,047,269075,62615,62419,8771,71190,818
2022-05-04,Modoc,049,8938,743,746,252,998,8
2022-05-04,Mono,051,14174,3000,2993,135,3128,6
2022-05-04,Monterey,053,433212,80498,80038,14196,94234,732
2022-05-04,Napa,055,140530,26647,26434,1050,27484,143
2022-05-04,Nevada,057,99092,16212,16136,1231,17367,127
2022-05-04,Orange,059,3164182,555383,553177,42542,595719,7006
2022-05-04,Placer,061,380077,63800,63410,7480,70890,625
2022-05-04,Plumas,063,18699,2996,2947,366,3313,13
2022-05-04,Riverside,065,2383286,597267,594981,28252,623233,6457
2022-05-04,Sacramento,067,1510023,285014,283939,26953,310892,3013
2022-05-04,San Benito,069,59416,13036,13019,527,13546,98
2022-05-04,San Bernardino,071,2135413,578158,569570,25122,594692,7240
2022-05-04,San Diego,073,3302833,764785,763453,54107,817560,5239
2022-05-04,San Francisco,075,870044,133552,131599,8826,140425,860
2022-05-04,San Joaquin,077,732212,168059,167280,10147,177427,2225
2022-05-04,San Luis Obispo,079,281455,53356,53156,3918,57074,477
2022-05-04,San Mateo,081,765935,128234,126800,7560,134360,710
2022-05-04,Santa Barbara,083,443738,87472,87058,4806,91864,688
2022-05-04,Santa Clara,085,1922200,325223,322805,13143,335948,2285
2022-05-04,Santa Cruz,087,273765,50105,49230,2186,51416,262
2022-05-04,Shasta,089,179085,30769,30681,6121,36802,556
2022-05-04,Sierra,091,2930,275,275,49,324,4
2022-05-04,Siskiyou,093,43540,4480,4463,2753,7216,81
2022-05-04,Solano,095,438530,83490,82796,5730,88526,449
2022-05-04,Sonoma,097,501317,86591,85694,3043,88737,488
2022-05-04,Stanislaus,099,539301,118442,118123,17754,135877,1643
2022-05-04,Sutter,101,95872,20624,20672,2118,22790,224
2022-05-04,Tehama,103,63373,12087,12090,2591,14681,201
2022-05-04,Trinity,105,12862,1188,1180,288,1468,20
2022-05-04,Tulare,107,460477,106745,106935,27806,134741,1464
2022-05-04,Tuolumne,109,53932,12862,12757,583,13340,181
2022-05-04,Ventura,111,848112,175804,175066,9820,184886,1486
2022-05-04,Yolo,113,214977,38227,37344,3131,40475,315
2022-05-04,Yuba,115,75493,15975,15940,1225,17165,122
2022-05-03,Alameda,001,1643700,266867,263736,14541,278277,1850
2022-05-03,Alpine,003,1148,125,124,1,125,0
2022-05-03,Amador,005,37829,8594,8546,663,9209,86
2022-05-03,Butte,007,227075,33434,33220,7063,40283,417
2022-05-03,Calaveras,009,45235,7351,7344,363,7707,120
2022-05-03,Colusa,011,21464,3456,3460,1048,4508,21
2022-05-03,Contra Costa,013,1133247,196131,193175,13843,207018,1302
2022-05-03,Del Norte,015,27424,5906,5866,196,6062,50
2022-05-03,El Dorado,017,186661,27157,27021,3266,30287,210
2022-05-03,Fresno,019,978130,232682,232332,23891,256223,2751
2022-05-03,Glenn,021,27897,5003,4995,1616,6611,48
2022-05-03,Humboldt,023,135768,17527,17316,3127,20443,146
2022-05-03,Imperial,025,180216,55655,55548,10618,66166,910
2022-05-03,Inyo,027,18085,4094,4085,502,4587,56
2022-05-03,Kern,029,883053,192757,192432,46078,238510,2281
2022-05-03,Kings,031,150075,51699,51663,3522,55185,447
2022-05-03,Lake,033,64148,10794,10758,896,11654,137
2022-05-03,Lassen,035,31185,8974,8972,875,9847,65
2022-05-03,Los Angeles,037,10098052,2759033,2744894,126844,2871738,31722
2022-05-03,Madera,039,155013,37453,37395,6078,43473,365
2022-05-03,Marin,041,260295,35059,34727,2949,37676,291
2022-05-03,Mariposa,043,17540,2448,2435,204,2639,30
2022-05-03,Mendocino,045,87422,13296,13247,3163,16410,123
2022-05-03,Merced,047,269075,62587,62419,8748,71167,818
2022-05-03,Modoc,049,8938,742,746,252,998,8
2022-05-03,Mono,051,14174,2998,2993,134,3127,6
2022-05-03,Monterey,053,433212,80446,80038,14162,94200,732
2022-05-03,Napa,055,140530,26612,26434,1043,27477,143
2022-05-03,Nevada,057,99092,16201,16136,1231,17367,127
2022-05-03,Orange,059,3164182,554861,553177,42464,595641,7006
2022-05-03,Placer,061,380077,63706,63410,7466,70876,625
2022-05-03,Plumas,063,18699,2992,2947,366,3313,13
2022-05-03,Riverside,065,2383286,596899,594981,28228,623209,6457
2022-05-03,Sacramento,067,1510023,284702,283939,26902,310841,3013
2022-05-03,San Benito,069,59416,13023,13019,524,13543,98
2022-05-03,San Bernardino,071,2135413,577889,569570,25110,594680,7240
2022-05-03,San Diego,073,3302833,763940,763453,54007,817460,5239
2022-05-03,San Francisco,075,870044,133075,131599,8796,140395,860
2022-05-03,San Joaquin,077,732212,167976,167280,10121,177401,2225
2022-05-03,San Luis Obispo,079,281455,53309,53156,3909,57065,477
2022-05-03,San Mateo,081,765935,127890,126800,7522,134322,710
2022-05-03,Santa Barbara,083,443738,87383,87058,4804,91862,688
2022-05-03,Santa Clara,085,1922200,324408,322805,13092,335897,2285
2022-05-03,Santa Cruz,087,273765,50013,49230,2181,51411,262
2022-05-03,Shasta,089,179085,30750,30681,6120,36801,556
2022-05-03,Sierra,091,2930,275,275,49,324,4
2022-05-03,Siskiyou,093,43540,4479,4463,2753,7216,81
2022-05-03,Solano,095,438530,83303,82796,5720,88516,449
2022-05-03,Sonoma,097,501317,86411,85694,3019,88713,488
2022-05-03,Stanislaus,099,539301,118388,118123,17742,135865,1643
2022-05-03,Sutter,101,95872,20619,20672,2116,22788,224
2022-05-03,Tehama,103,63373,12083,12090,2590,14680,201
2022-05-03,Trinity,105,12862,1187,1180,288,1468,20
2022-05-03,Tulare,107,460477,106716,106935,27792,134727,1464
2022-05-03,Tuolumne,109,53932,12849,12757,583,13340,181
2022-05-03,Ventura,111,848112,175635,175066,9779,184845,1486
2022-05-03,Yolo,113,214977,38157,37344,3130,40474,315
2022-05-03,Yuba,115,75493,15964,15940,1217,17157,122
2022-05-02,Alameda,001,1643700,266237,263736,14496,278232,1850
2022-05-02,Alpine,003,1148,125,124,1,125,0
2022-05-02,Amador,005,37829,8591,8546,660,9206,86
2022-05-02,Butte,007,227075,33411,33220,7060,40280,417
2022-05-02,Calaveras,009,45235,7350,7344,362,7706,120
2022-05-02,Colusa,011,21464,3456,3460,1048,4508,21
2022-05-02,Contra Costa,013,1133247,195759,193175,13805,206980,1302
2022-05-02,Del Norte,015,27424,5901,5866,191,6057,50
2022-05-02,El Dorado,017,186661,27134,27021,3260,30281,210
2022-05-02,Fresno,019,978130,232572,232332,23862,256194,2751
2022-05-02,Glenn,021,27897,5001,4995,1616,6611,48
2022-05-02,Humboldt,023,135768,17476,17316,3113,20429,146
2022-05-02,Imperial,025,180216,55642,55548,10611,66159,910
2022-05-02,Inyo,027,18085,4093,4085,500,4585,56
2022-05-02,Kern,029,883053,192673,192432,46049,238481,2281
2022-05-02,Kings,031,150075,51682,51663,3522,55185,447
2022-05-02,Lake,033,64148,10790,10758,896,11654,137
2022-05-02,Lassen,035,31185,8973,8972,875,9847,65
2022-05-02,Los Angeles,037,10098052,2755990,2744894,126630,2871524,31722
2022-05-02,Madera,039,155013,37436,37395,6071,43466,365
2022-05-02,Marin,041,260295,34934,34727,2926,37653,291
2022-05-02,Mariposa,043,17540,2443,2435,204,2639,30
2022-05-02,Mendocino,045,87422,13278,13247,3150,16397,123
2022-05-02,Merced,047,269075,62556,62419,8742,71161,818
2022-05-02,Modoc,049,8938,741,746,252,998,8
2022-05-02,Mono,051,14174,2996,2993,133,3126,6
2022-05-02,Monterey,053,433212,80367,80038,14121,94159,732
2022-05-02,Napa,055,140530,26573,26434,1041,27475,143
2022-05-02,Nevada,057,99092,16183,16136,1229,17365,127
2022-05-02,Orange,059,3164182,554321,553177,42371,595548,7006
2022-05-02,Placer,061,380077,63649,63410,7459,70869,625
2022-05-02,Plumas,063,18699,2992,2947,366,3313,13
2022-05-02,Riverside,065,2383286,596509,594981,28201,623182,6457
2022-05-02,Sacramento,067,1510023,284396,283939,26862,310801,3013
2022-05-02,San Benito,069,59416,13011,13019,524,13543,98
2022-05-02,San Bernardino,071,2135413,577601,569570,25091,594661,7240
2022-05-02,San Diego,073,3302833,763075,763453,53912,817365,5239
2022-05-02,San Francisco,075,870044,132641,131599,8769,140368,860
2022-05-02,San Joaquin,077,732212,167859,167280,10111,177391,2225
2022-05-02,San Luis Obispo,079,281455,53256,53156,3900,57056,477
2022-05-02,San Mateo,081,765935,127567,126800,7507,134307,710
2022-05-02,Santa Barbara,083,443738,87282,87058,4800,91858,688
2022-05-02,Santa Clara,085,1922200,323495,322805,13045,335850,2285
2022-05-02,Santa Cruz,087,273765,49885,49230,2177,51407,262
2022-05-02,Shasta,089,179085,30731,30681,6119,36800,556
2022-05-02,Sierra,091,2930,275,275,49,324,4
2022-05-02,Siskiyou,093,43540,4476,4463,2751,7214,81
2022-05-02,Solano,095,438530,83163,82796,5711,88507,449
2022-05-02,Sonoma,097,501317,86228,85694,2998,88692,488
2022-05-02,Stanislaus,099,539301,118315,118123,17729,135852,1643
2022-05-02,Sutter,101,95872,20612,20672,2113,22785,224
2022-05-02,Tehama,103,63373,12078,12090,2587,14677,201
2022-05-02,Trinity,105,12862,1186,1180,288,1468,20
2022-05-02,Tulare,107,460477,106694,106935,27776,134711,1464
2022-05-02,Tuolumne,109,53932,12843,12757,583,13340,181
2022-05-02,Ventura,111,848112,175471,175066,9747,184813,1486
2022-05-02,Yolo,113,214977,38078,37344,3124,40468,315
2022-05-02,Yuba,115,75493,15959,15940,1215,17155,122
2022-05-01,Alameda,001,1643700,265534,262027,14446,276473,1851
2022-05-01,Alpine,003,1148,125,124,1,125,0
2022-05-01,Amador,005,37829,8591,8533,660,9193,86
2022-05-01,Butte,007,227075,33384,33172,7055,40227,418
2022-05-01,Calaveras,009,45235,7346,7328,356,7684,120
2022-05-01,Colusa,011,21464,3456,3457,1048,4505,21
2022-05-01,Contra Costa,013,1133247,195373,192136,13733,205869,1301
2022-05-01,Del Norte,015,27424,5893,5841,191,6032,50
2022-05-01,El Dorado,017,186661,27102,26946,3256,30202,210
2022-05-01,Fresno,019,978130,232468,232067,23841,255908,2748
2022-05-01,Glenn,021,27897,5001,4995,1616,6611,48
2022-05-01,Humboldt,023,135768,17412,17194,3088,20282,145
2022-05-01,Imperial,025,180216,55618,55503,10608,66111,910
2022-05-01,Inyo,027,18085,4092,4084,499,4583,56
2022-05-01,Kern,029,883053,192610,192250,46004,238254,2265
2022-05-01,Kings,031,150075,51661,51640,3518,55158,447
2022-05-01,Lake,033,64148,10783,10742,894,11636,137
2022-05-01,Lassen,035,31185,8973,8966,875,9841,65
2022-05-01,Los Angeles,037,10098052,2752975,2736900,126394,2863294,31712
2022-05-01,Madera,039,155013,37418,37360,6060,43420,365
2022-05-01,Marin,041,260295,34847,34519,2893,37412,291
2022-05-01,Mariposa,043,17540,2442,2430,204,2634,30
2022-05-01,Mendocino,045,87422,13259,13219,3134,16353,123
2022-05-01,Merced,047,269075,62526,62357,8726,71083,818
2022-05-01,Modoc,049,8938,741,745,252,997,8
2022-05-01,Mono,051,14174,2993,2989,131,3120,6
2022-05-01,Monterey,053,433212,80288,79881,14079,93960,731
2022-05-01,Napa,055,140530,26528,26319,1037,27356,143
2022-05-01,Nevada,057,99092,16164,16100,1228,17328,127
2022-05-01,Orange,059,3164182,553769,551822,42274,594096,6998
2022-05-01,Placer,061,380077,63576,63273,7445,70718,625
2022-05-01,Plumas,063,18699,2991,2946,366,3312,13
2022-05-01,Riverside,065,2383286,596050,593965,28166,622131,6457
2022-05-01,Sacramento,067,1510023,284064,283048,26801,309849,3007
2022-05-01,San Benito,069,59416,13003,12988,524,13512,98
2022-05-01,San Bernardino,071,2135413,577282,568758,25074,593832,7191
2022-05-01,San Diego,073,3302833,762193,761253,53821,815074,5238
2022-05-01,San Francisco,075,870044,132149,130241,8740,138981,860
2022-05-01,San Joaquin,077,732212,167717,167028,10081,177109,2225
2022-05-01,San Luis Obispo,079,281455,53184,53040,3884,56924,477
2022-05-01,San Mateo,081,765935,127200,125807,7468,133275,705
2022-05-01,Santa Barbara,083,443738,87178,86768,4790,91558,688
2022-05-01,Santa Clara,085,1922200,322553,320709,12992,333701,2281
2022-05-01,Santa Cruz,087,273765,49733,48798,2169,50967,262
2022-05-01,Shasta,089,179085,30715,30649,6117,36766,554
2022-05-01,Sierra,091,2930,275,274,49,323,4
2022-05-01,Siskiyou,093,43540,4475,4458,2745,7203,81
2022-05-01,Solano,095,438530,83031,82459,5697,88156,449
2022-05-01,Sonoma,097,501317,86008,85290,2970,88260,488
2022-05-01,Stanislaus,099,539301,118260,117943,17714,135657,1643
2022-05-01,Sutter,101,95872,20604,20644,2106,22750,224
2022-05-01,Tehama,103,63373,12077,12078,2586,14664,202
2022-05-01,Trinity,105,12862,1186,1179,288,1467,20
2022-05-01,Tulare,107,460477,106661,106856,27756,134612,1458
2022-05-01,Tuolumne,109,53932,12823,12713,577,13290,181
2022-05-01,Ventura,111,848112,175298,174679,9695,184374,1486
2022-05-01,Yolo,113,214977,38013,37173,3113,40286,314
2022-05-01,Yuba,115,75493,15949,15917,1213,17130,121
2022-04-30,Alameda,001,1643700,265133,262027,14431,276458,1851
2022-04-30,Alpine,003,1148,125,124,1,125,0
2022-04-30,Amador,005,37829,8589,8533,660,9193,86
2022-04-30,Butte,007,227075,33378,33172,7051,40223,418
2022-04-30,Calaveras,009,45235,7343,7328,355,7683,120
2022-04-30,Colusa,011,21464,3455,3457,1048,4505,21
2022-04-30,Contra Costa,013,1133247,195128,192136,13723,205859,1301
2022-04-30,Del Norte,015,27424,5888,5841,191,6032,50
2022-04-30,El Dorado,017,186661,27084,26946,3252,30198,210
2022-04-30,Fresno,019,978130,232422,232067,23833,255900,2748
2022-04-30,Glenn,021,27897,5000,4995,1615,6610,48
2022-04-30,Humboldt,023,135768,17370,17194,3079,20273,145
2022-04-30,Imperial,025,180216,55605,55503,10606,66109,910
2022-04-30,Inyo,027,18085,4092,4084,499,4583,56
2022-04-30,Kern,029,883053,192574,192250,45986,238236,2265
2022-04-30,Kings,031,150075,51655,51640,3517,55157,447
2022-04-30,Lake,033,64148,10780,10742,894,11636,137
2022-04-30,Lassen,035,31185,8973,8966,875,9841,65
2022-04-30,Los Angeles,037,10098052,2751600,2736900,126220,2863120,31712
2022-04-30,Madera,039,155013,37407,37360,6059,43419,365
2022-04-30,Marin,041,260295,34801,34519,2863,37382,291
2022-04-30,Mariposa,043,17540,2440,2430,203,2633,30
2022-04-30,Mendocino,045,87422,13255,13219,3134,16353,123
2022-04-30,Merced,047,269075,62512,62357,8724,71081,818
2022-04-30,Modoc,049,8938,741,745,252,997,8
2022-04-30,Mono,051,14174,2992,2989,129,3118,6
2022-04-30,Monterey,053,433212,80221,79881,14056,93937,731
2022-04-30,Napa,055,140530,26504,26319,1036,27355,143
2022-04-30,Nevada,057,99092,16149,16100,1227,17327,127
2022-04-30,Orange,059,3164182,553503,551822,42236,594058,6998
2022-04-30,Placer,061,380077,63531,63273,7439,70712,625
2022-04-30,Plumas,063,18699,2988,2946,366,3312,13
2022-04-30,Riverside,065,2383286,595806,593965,28148,622113,6457
2022-04-30,Sacramento,067,1510023,283942,283048,26788,309836,3007
2022-04-30,San Benito,069,59416,13000,12988,524,13512,98
2022-04-30,San Bernardino,071,2135413,577107,568758,25065,593823,7191
2022-04-30,San Diego,073,3302833,761820,761253,53793,815046,5238
2022-04-30,San Francisco,075,870044,131864,130241,8718,138959,860
2022-04-30,San Joaquin,077,732212,167662,167028,10076,177104,2225
2022-04-30,San Luis Obispo,079,281455,53173,53040,3881,56921,477
2022-04-30,San Mateo,081,765935,126982,125807,7449,133256,705
2022-04-30,Santa Barbara,083,443738,87122,86768,4787,91555,688
2022-04-30,Santa Clara,085,1922200,321981,320709,12968,333677,2281
2022-04-30,Santa Cruz,087,273765,49686,48798,2169,50967,262
2022-04-30,Shasta,089,179085,30709,30649,6115,36764,554
2022-04-30,Sierra,091,2930,275,274,49,323,4
2022-04-30,Siskiyou,093,43540,4473,4458,2744,7202,81
2022-04-30,Solano,095,438530,83014,82459,5695,88154,449
2022-04-30,Sonoma,097,501317,85891,85290,2958,88248,488
2022-04-30,Stanislaus,099,539301,118229,117943,17708,135651,1643
2022-04-30,Sutter,101,95872,20599,20644,2106,22750,224
2022-04-30,Tehama,103,63373,12073,12078,2584,14662,202
2022-04-30,Trinity,105,12862,1186,1179,288,1467,20
2022-04-30,Tulare,107,460477,106642,106856,27744,134600,1458
2022-04-30,Tuolumne,109,53932,12814,12713,577,13290,181
2022-04-30,Ventura,111,848112,175214,174679,9663,184342,1486
2022-04-30,Yolo,113,214977,37966,37173,3112,40285,314
2022-04-30,Yuba,115,75493,15942,15917,1212,17129,121
2022-04-29,Alameda,001,1643700,264821,262027,14418,276445,1851
2022-04-29,Alpine,003,1148,124,124,1,125,0
2022-04-29,Amador,005,37829,8582,8533,658,9191,86
2022-04-29,Butte,007,227075,33373,33172,7045,40217,418
2022-04-29,Calaveras,009,45235,7341,7328,355,7683,120
2022-04-29,Colusa,011,21464,3454,3457,1048,4505,21
2022-04-29,Contra Costa,013,1133247,194933,192136,13704,205840,1301
2022-04-29,Del Norte,015,27424,5884,5841,191,6032,50
2022-04-29,El Dorado,017,186661,27072,26946,3250,30196,210
2022-04-29,Fresno,019,978130,232372,232067,23825,255892,2748
2022-04-29,Glenn,021,27897,5000,4995,1614,6609,48
2022-04-29,Humboldt,023,135768,17345,17194,3071,20265,145
2022-04-29,Imperial,025,180216,55589,55503,10605,66108,910
2022-04-29,Inyo,027,18085,4092,4084,497,4581,56
2022-04-29,Kern,029,883053,192547,192250,45974,238224,2265
2022-04-29,Kings,031,150075,51650,51640,3517,55157,447
2022-04-29,Lake,033,64148,10779,10742,894,11636,137
2022-04-29,Lassen,035,31185,8972,8966,875,9841,65
2022-04-29,Los Angeles,037,10098052,2750295,2736900,126070,2862970,31712
2022-04-29,Madera,039,155013,37397,37360,6058,43418,365
2022-04-29,Marin,041,260295,34735,34519,2843,37362,291
2022-04-29,Mariposa,043,17540,2438,2430,203,2633,30
2022-04-29,Mendocino,045,87422,13250,13219,3133,16352,123
2022-04-29,Merced,047,269075,62500,62357,8723,71080,818
2022-04-29,Modoc,049,8938,741,745,252,997,8
2022-04-29,Mono,051,14174,2992,2989,129,3118,6
2022-04-29,Monterey,053,433212,80187,79881,14042,93923,731
2022-04-29,Napa,055,140530,26476,26319,1034,27353,143
2022-04-29,Nevada,057,99092,16142,16100,1226,17326,127
2022-04-29,Orange,059,3164182,553238,551822,42191,594013,6998
2022-04-29,Placer,061,380077,63502,63273,7432,70705,625
2022-04-29,Plumas,063,18699,2987,2946,366,3312,13
2022-04-29,Riverside,065,2383286,595587,593965,28127,622092,6457
2022-04-29,Sacramento,067,1510023,283795,283048,26780,309828,3007
2022-04-29,San Benito,069,59416,12995,12988,524,13512,98
2022-04-29,San Bernardino,071,2135413,576949,568758,25055,593813,7191
2022-04-29,San Diego,073,3302833,761402,761253,53768,815021,5238
2022-04-29,San Francisco,075,870044,131642,130241,8698,138939,860
2022-04-29,San Joaquin,077,732212,167607,167028,10072,177100,2225
2022-04-29,San Luis Obispo,079,281455,53158,53040,3876,56916,477
2022-04-29,San Mateo,081,765935,126784,125807,7435,133242,705
2022-04-29,Santa Barbara,083,443738,87082,86768,4785,91553,688
2022-04-29,Santa Clara,085,1922200,321472,320709,12938,333647,2281
2022-04-29,Santa Cruz,087,273765,49630,48798,2165,50963,262
2022-04-29,Shasta,089,179085,30707,30649,6114,36763,554
2022-04-29,Sierra,091,2930,275,274,49,323,4
2022-04-29,Siskiyou,093,43540,4472,4458,2744,7202,81
2022-04-29,Solano,095,438530,82957,82459,5690,88149,449
2022-04-29,Sonoma,097,501317,85783,85290,2944,88234,488
2022-04-29,Stanislaus,099,539301,118206,117943,17703,135646,1643
2022-04-29,Sutter,101,95872,20592,20644,2105,22749,224
2022-04-29,Tehama,103,63373,12071,12078,2584,14662,202
2022-04-29,Trinity,105,12862,1186,1179,288,1467,20
2022-04-29,Tulare,107,460477,106624,106856,27728,134584,1458
2022-04-29,Tuolumne,109,53932,12807,12713,574,13287,181
2022-04-29,Ventura,111,848112,175138,174679,9641,184320,1486
2022-04-29,Yolo,113,214977,37933,37173,3109,40282,314
2022-04-29,Yuba,115,75493,15937,15917,1212,17129,121
2022-04-28,Alameda,001,1643700,264381,262027,14382,276409,1851
2022-04-28,Alpine,003,1148,124,124,1,125,0
2022-04-28,Amador,005,37829,8579,8533,658,9191,86
2022-04-28,Butte,007,227075,33364,33172,7039,40211,418
2022-04-28,Calaveras,009,45235,7337,7328,355,7683,120
2022-04-28,Colusa,011,21464,3453,3457,1048,4505,21
2022-04-28,Contra Costa,013,1133247,194677,192136,13663,205799,1301
2022-04-28,Del Norte,015,27424,5880,5841,191,6032,50
2022-04-28,El Dorado,017,186661,27050,26946,3246,30192,210
2022-04-28,Fresno,019,978130,232313,232067,23816,255883,2748
2022-04-28,Glenn,021,27897,4997,4995,1614,6609,48
2022-04-28,Humboldt,023,135768,17311,17194,3055,20249,145
2022-04-28,Imperial,025,180216,55577,55503,10600,66103,910
2022-04-28,Inyo,027,18085,4092,4084,497,4581,56
2022-04-28,Kern,029,883053,192508,192250,45960,238210,2265
2022-04-28,Kings,031,150075,51644,51640,3517,55157,447
2022-04-28,Lake,033,64148,10775,10742,894,11636,137
2022-04-28,Lassen,035,31185,8972,8966,875,9841,65
2022-04-28,Los Angeles,037,10098052,2748230,2736900,125889,2862789,31712
2022-04-28,Madera,039,155013,37391,37360,6055,43415,365
2022-04-28,Marin,041,260295,34685,34519,2828,37347,291
2022-04-28,Mariposa,043,17540,2438,2430,203,2633,30
2022-04-28,Mendocino,045,87422,13239,13219,3116,16335,123
2022-04-28,Merced,047,269075,62482,62357,8715,71072,818
2022-04-28,Modoc,049,8938,741,745,252,997,8
2022-04-28,Mono,051,14174,2990,2989,129,3118,6
2022-04-28,Monterey,053,433212,80148,79881,14018,93899,731
2022-04-28,Napa,055,140530,26446,26319,1031,27350,143
2022-04-28,Nevada,057,99092,16134,16100,1223,17323,127
2022-04-28,Orange,059,3164182,552877,551822,42130,593952,6998
2022-04-28,Placer,061,380077,63455,63273,7424,70697,625
2022-04-28,Plumas,063,18699,2986,2946,366,3312,13
2022-04-28,Riverside,065,2383286,595304,593965,28105,622070,6457
2022-04-28,Sacramento,067,1510023,283613,283048,26741,309789,3007
2022-04-28,San Benito,069,59416,12985,12988,522,13510,98
2022-04-28,San Bernardino,071,2135413,576749,568758,25047,593805,7191
2022-04-28,San Diego,073,3302833,760860,761253,53705,814958,5238
2022-04-28,San Francisco,075,870044,131340,130241,8664,138905,860
2022-04-28,San Joaquin,077,732212,167536,167028,10058,177086,2225
2022-04-28,San Luis Obispo,079,281455,53130,53040,3858,56898,477
2022-04-28,San Mateo,081,765935,126540,125807,7408,133215,705
2022-04-28,Santa Barbara,083,443738,87029,86768,4782,91550,688
2022-04-28,Santa Clara,085,1922200,320931,320709,12904,333613,2281
2022-04-28,Santa Cruz,087,273765,49532,48798,2159,50957,262
2022-04-28,Shasta,089,179085,30699,30649,6114,36763,554
2022-04-28,Sierra,091,2930,275,274,49,323,4
2022-04-28,Siskiyou,093,43540,4469,4458,2744,7202,81
2022-04-28,Solano,095,438530,82873,82459,5685,88144,449
2022-04-28,Sonoma,097,501317,85668,85290,2930,88220,488
2022-04-28,Stanislaus,099,539301,118168,117943,17696,135639,1643
2022-04-28,Sutter,101,95872,20582,20644,2102,22746,224
2022-04-28,Tehama,103,63373,12070,12078,2583,14661,202
2022-04-28,Trinity,105,12862,1186,1179,288,1467,20
2022-04-28,Tulare,107,460477,106602,106856,27718,134574,1458
2022-04-28,Tuolumne,109,53932,12795,12713,573,13286,181
2022-04-28,Ventura,111,848112,175049,174679,9605,184284,1486
2022-04-28,Yolo,113,214977,37895,37173,3106,40279,314
2022-04-28,Yuba,115,75493,15928,15917,1210,17127,121
2022-04-27,Alameda,001,1643700,263899,260871,14339,275210,1843
2022-04-27,Alpine,003,1148,124,124,1,125,0
2022-04-27,Amador,005,37829,8578,8518,658,9176,86
2022-04-27,Butte,007,227075,33353,33118,7034,40152,411
2022-04-27,Calaveras,009,45235,7334,7307,355,7662,119
2022-04-27,Colusa,011,21464,3453,3457,1048,4505,21
2022-04-27,Contra Costa,013,1133247,194413,191412,13633,205045,1300
2022-04-27,Del Norte,015,27424,5875,5833,191,6024,50
2022-04-27,El Dorado,017,186661,27039,26898,3241,30139,209
2022-04-27,Fresno,019,978130,232247,231951,23802,255753,2744
2022-04-27,Glenn,021,27897,4997,4993,1614,6607,48
2022-04-27,Humboldt,023,135768,17281,17138,3044,20182,145
2022-04-27,Imperial,025,180216,55559,55480,10596,66076,910
2022-04-27,Inyo,027,18085,4091,4080,496,4576,56
2022-04-27,Kern,029,883053,192472,192157,45941,238098,2271
2022-04-27,Kings,031,150075,51639,51617,3516,55133,444
2022-04-27,Lake,033,64148,10771,10732,894,11626,135
2022-04-27,Lassen,035,31185,8971,8965,875,9840,65
2022-04-27,Los Angeles,037,10098052,2745898,2731988,125705,2857693,31691
2022-04-27,Madera,039,155013,37382,37339,6054,43393,354
2022-04-27,Marin,041,260295,34624,34354,2814,37168,288
2022-04-27,Mariposa,043,17540,2436,2427,203,2630,30
2022-04-27,Mendocino,045,87422,13232,13188,3108,16296,123
2022-04-27,Merced,047,269075,62468,62315,8711,71026,815
2022-04-27,Modoc,049,8938,741,745,252,997,8
2022-04-27,Mono,051,14174,2990,2989,129,3118,6
2022-04-27,Monterey,053,433212,80106,79695,13978,93673,729
2022-04-27,Napa,055,140530,26417,26210,1026,27236,143
2022-04-27,Nevada,057,99092,16118,16080,1220,17300,127
2022-04-27,Orange,059,3164182,552504,550859,42072,592931,6991
2022-04-27,Placer,061,380077,63413,63154,7408,70562,623
2022-04-27,Plumas,063,18699,2985,2934,366,3300,13
2022-04-27,Riverside,065,2383286,595039,593397,28089,621486,6453
2022-04-27,Sacramento,067,1510023,283413,281802,26709,308511,3001
2022-04-27,San Benito,069,59416,12972,12989,520,13509,98
2022-04-27,San Bernardino,071,2135413,576551,568018,25040,593058,7105
2022-04-27,San Diego,073,3302833,760287,759873,53643,813516,5236
2022-04-27,San Francisco,075,870044,130988,129284,8640,137924,857
2022-04-27,San Joaquin,077,732212,167461,166848,10043,176891,2225
2022-04-27,San Luis Obispo,079,281455,53085,52911,3847,56758,476
2022-04-27,San Mateo,081,765935,126310,125018,7355,132373,702
2022-04-27,Santa Barbara,083,443738,86965,86557,4775,91332,685
2022-04-27,Santa Clara,085,1922200,320366,319077,12857,331934,2282
2022-04-27,Santa Cruz,087,273765,49447,48500,2151,50651,262
2022-04-27,Shasta,089,179085,30687,30633,6111,36744,554
2022-04-27,Sierra,091,2930,274,276,49,325,4
2022-04-27,Siskiyou,093,43540,4469,4455,2740,7195,81
2022-04-27,Solano,095,438530,82761,82220,5677,87897,448
2022-04-27,Sonoma,097,501317,85559,84983,2910,87893,487
2022-04-27,Stanislaus,099,539301,118126,117841,17686,135527,1643
2022-04-27,Sutter,101,95872,20578,20627,2098,22725,224
2022-04-27,Tehama,103,63373,12070,12073,2583,14656,201
2022-04-27,Trinity,105,12862,1186,1179,288,1467,20
2022-04-27,Tulare,107,460477,106584,106580,27709,134289,1453
2022-04-27,Tuolumne,109,53932,12778,12684,572,13256,181
2022-04-27,Ventura,111,848112,174946,174425,9590,184015,1480
2022-04-27,Yolo,113,214977,37846,37096,3100,40196,314
2022-04-27,Yuba,115,75493,15924,15902,1205,17107,121
2022-04-26,Alameda,001,1643700,263382,260871,14297,275168,1843
2022-04-26,Alpine,003,1148,124,124,1,125,0
2022-04-26,Amador,005,37829,8575,8518,657,9175,86
2022-04-26,Butte,007,227075,33337,33118,7027,40145,411
2022-04-26,Calaveras,009,45235,7330,7307,354,7661,119
2022-04-26,Colusa,011,21464,3453,3457,1048,4505,21
2022-04-26,Contra Costa,013,1133247,194152,191412,13596,205008,1300
2022-04-26,Del Norte,015,27424,5867,5833,191,6024,50
2022-04-26,El Dorado,017,186661,27018,26898,3237,30135,209
2022-04-26,Fresno,019,978130,232167,231951,23792,255743,2744
2022-04-26,Glenn,021,27897,4997,4993,1613,6606,48
2022-04-26,Humboldt,023,135768,17250,17138,3038,20176,145
2022-04-26,Imperial,025,180216,55539,55480,10591,66071,910
2022-04-26,Inyo,027,18085,4091,4080,496,4576,56
2022-04-26,Kern,029,883053,192425,192157,45917,238074,2271
2022-04-26,Kings,031,150075,51633,51617,3516,55133,444
2022-04-26,Lake,033,64148,10764,10732,894,11626,135
2022-04-26,Lassen,035,31185,8966,8965,875,9840,65
2022-04-26,Los Angeles,037,10098052,2743507,2731988,125521,2857509,31691
2022-04-26,Madera,039,155013,37374,37339,6047,43386,354
2022-04-26,Marin,041,260295,34571,34354,2795,37149,288
2022-04-26,Mariposa,043,17540,2436,2427,203,2630,30
2022-04-26,Mendocino,045,87422,13228,13188,3102,16290,123
2022-04-26,Merced,047,269075,62445,62315,8694,71009,815
2022-04-26,Modoc,049,8938,741,745,252,997,8
2022-04-26,Mono,051,14174,2990,2989,128,3117,6
2022-04-26,Monterey,053,433212,80052,79695,13939,93634,729
2022-04-26,Napa,055,140530,26386,26210,1022,27232,143
2022-04-26,Nevada,057,99092,16109,16080,1220,17300,127
2022-04-26,Orange,059,3164182,552097,550859,42015,592874,6991
2022-04-26,Placer,061,380077,63382,63154,7406,70560,623
2022-04-26,Plumas,063,18699,2985,2934,366,3300,13
2022-04-26,Riverside,065,2383286,594732,593397,28063,621460,6453
2022-04-26,Sacramento,067,1510023,283176,281802,26687,308489,3001
2022-04-26,San Benito,069,59416,12968,12989,519,13508,98
2022-04-26,San Bernardino,071,2135413,576338,568018,25026,593044,7105
2022-04-26,San Diego,073,3302833,759627,759873,53540,813413,5236
2022-04-26,San Francisco,075,870044,130590,129284,8615,137899,857
2022-04-26,San Joaquin,077,732212,167400,166848,10033,176881,2225
2022-04-26,San Luis Obispo,079,281455,53056,52911,3836,56747,476
2022-04-26,San Mateo,081,765935,126040,125018,7321,132339,702
2022-04-26,Santa Barbara,083,443738,86904,86557,4770,91327,685
2022-04-26,Santa Clara,085,1922200,319809,319077,12811,331888,2282
2022-04-26,Santa Cruz,087,273765,49347,48500,2148,50648,262
2022-04-26,Shasta,089,179085,30675,30633,6111,36744,554
2022-04-26,Sierra,091,2930,274,276,49,325,4
2022-04-26,Siskiyou,093,43540,4467,4455,2738,7193,81
2022-04-26,Solano,095,438530,82662,82220,5666,87886,448
2022-04-26,Sonoma,097,501317,85453,84983,2894,87877,487
2022-04-26,Stanislaus,099,539301,118091,117841,17676,135517,1643
2022-04-26,Sutter,101,95872,20568,20627,2098,22725,224
2022-04-26,Tehama,103,63373,12061,12073,2583,14656,201
2022-04-26,Trinity,105,12862,1186,1179,288,1467,20
2022-04-26,Tulare,107,460477,106556,106580,27695,134275,1453
2022-04-26,Tuolumne,109,53932,12759,12684,570,13254,181
2022-04-26,Ventura,111,848112,174837,174425,9565,183990,1480
2022-04-26,Yolo,113,214977,37787,37096,3095,40191,314
2022-04-26,Yuba,115,75493,15922,15902,1205,17107,121
2022-04-25,Alameda,001,1643700,262874,260871,14256,275127,1843
2022-04-25,Alpine,003,1148,124,124,1,125,0
2022-04-25,Amador,005,37829,8572,8518,657,9175,86
2022-04-25,Butte,007,227075,33322,33118,7018,40136,411
2022-04-25,Calaveras,009,45235,7327,7307,354,7661,119
2022-04-25,Colusa,011,21464,3453,3457,1048,4505,21
2022-04-25,Contra Costa,013,1133247,193885,191412,13559,204971,1300
2022-04-25,Del Norte,015,27424,5861,5833,189,6022,50
2022-04-25,El Dorado,017,186661,26997,26898,3235,30133,209
2022-04-25,Fresno,019,978130,232076,231951,23779,255730,2744
2022-04-25,Glenn,021,27897,4996,4993,1613,6606,48
2022-04-25,Humboldt,023,135768,17208,17138,3030,20168,145
2022-04-25,Imperial,025,180216,55520,55480,10586,66066,910
2022-04-25,Inyo,027,18085,4091,4080,496,4576,56
2022-04-25,Kern,029,883053,192381,192157,45899,238056,2271
2022-04-25,Kings,031,150075,51624,51617,3515,55132,444
2022-04-25,Lake,033,64148,10761,10732,893,11625,135
2022-04-25,Lassen,035,31185,8965,8965,875,9840,65
2022-04-25,Los Angeles,037,10098052,2741122,2731988,125355,2857343,31691
2022-04-25,Madera,039,155013,37361,37339,6043,43382,354
2022-04-25,Marin,041,260295,34507,34354,2771,37125,288
2022-04-25,Mariposa,043,17540,2436,2427,202,2629,30
2022-04-25,Mendocino,045,87422,13218,13188,3085,16273,123
2022-04-25,Merced,047,269075,62432,62315,8692,71007,815
2022-04-25,Modoc,049,8938,741,745,252,997,8
2022-04-25,Mono,051,14174,2990,2989,128,3117,6
2022-04-25,Monterey,053,433212,80014,79695,13914,93609,729
2022-04-25,Napa,055,140530,26345,26210,1020,27230,143
2022-04-25,Nevada,057,99092,16103,16080,1218,17298,127
2022-04-25,Orange,059,3164182,551692,550859,41954,592813,6991
2022-04-25,Placer,061,380077,63346,63154,7401,70555,623
2022-04-25,Plumas,063,18699,2983,2934,366,3300,13
2022-04-25,Riverside,065,2383286,594470,593397,28046,621443,6453
2022-04-25,Sacramento,067,1510023,283011,281802,26654,308456,3001
2022-04-25,San Benito,069,59416,12961,12989,519,13508,98
2022-04-25,San Bernardino,071,2135413,576110,568018,25009,593027,7105
2022-04-25,San Diego,073,3302833,758944,759873,53466,813339,5236
2022-04-25,San Francisco,075,870044,130229,129284,8599,137883,857
2022-04-25,San Joaquin,077,732212,167316,166848,10019,176867,2225
2022-04-25,San Luis Obispo,079,281455,53007,52911,3828,56739,476
2022-04-25,San Mateo,081,765935,125768,125018,7301,132319,702
2022-04-25,Santa Barbara,083,443738,86843,86557,4764,91321,685
2022-04-25,Santa Clara,085,1922200,319163,319077,12766,331843,2282
2022-04-25,Santa Cruz,087,273765,49205,48500,2139,50639,262
2022-04-25,Shasta,089,179085,30663,30633,6108,36741,554
2022-04-25,Sierra,091,2930,274,276,49,325,4
2022-04-25,Siskiyou,093,43540,4467,4455,2737,7192,81
2022-04-25,Solano,095,438530,82544,82220,5655,87875,448
2022-04-25,Sonoma,097,501317,85330,84983,2874,87857,487
2022-04-25,Stanislaus,099,539301,118046,117841,17669,135510,1643
2022-04-25,Sutter,101,95872,20565,20627,2098,22725,224
2022-04-25,Tehama,103,63373,12061,12073,2583,14656,201
2022-04-25,Trinity,105,12862,1185,1179,288,1467,20
2022-04-25,Tulare,107,460477,106531,106580,27685,134265,1453
2022-04-25,Tuolumne,109,53932,12750,12684,570,13254,181
2022-04-25,Ventura,111,848112,174727,174425,9542,183967,1480
2022-04-25,Yolo,113,214977,37724,37096,3091,40187,314
2022-04-25,Yuba,115,75493,15912,15902,1204,17106,121
2022-04-24,Alameda,001,1643700,262291,259619,14211,273830,1837
2022-04-24,Alpine,003,1148,124,124,1,125,0
2022-04-24,Amador,005,37829,8563,8509,656,9165,86
2022-04-24,Butte,007,227075,33299,33105,7011,40116,411
2022-04-24,Calaveras,009,45235,7318,7296,352,7648,119
2022-04-24,Colusa,011,21464,3452,3453,1048,4501,21
2022-04-24,Contra Costa,013,1133247,193578,190611,13526,204137,1298
2022-04-24,Del Norte,015,27424,5852,5827,187,6014,50
2022-04-24,El Dorado,017,186661,26979,26837,3233,30070,209
2022-04-24,Fresno,019,978130,231996,231751,23764,255515,2744
2022-04-24,Glenn,021,27897,4996,4989,1611,6600,48
2022-04-24,Humboldt,023,135768,17183,17033,3016,20049,145
2022-04-24,Imperial,025,180216,55508,55434,10578,66012,910
2022-04-24,Inyo,027,18085,4087,4079,495,4574,56
2022-04-24,Kern,029,883053,192329,192012,45885,237897,2267
2022-04-24,Kings,031,150075,51615,51588,3515,55103,444
2022-04-24,Lake,033,64148,10753,10720,890,11610,134
2022-04-24,Lassen,035,31185,8964,8966,875,9841,65
2022-04-24,Los Angeles,037,10098052,2738773,2725630,125208,2850838,31667
2022-04-24,Madera,039,155013,37346,37333,6037,43370,354
2022-04-24,Marin,041,260295,34453,34150,2737,36887,288
2022-04-24,Mariposa,043,17540,2433,2422,202,2624,30
2022-04-24,Mendocino,045,87422,13213,13158,3073,16231,122
2022-04-24,Merced,047,269075,62409,62286,8684,70970,815
2022-04-24,Modoc,049,8938,741,745,252,997,8
2022-04-24,Mono,051,14174,2988,2986,128,3114,6
2022-04-24,Monterey,053,433212,79961,79560,13881,93441,729
2022-04-24,Napa,055,140530,26308,26093,1019,27112,143
2022-04-24,Nevada,057,99092,16087,16052,1216,17268,127
2022-04-24,Orange,059,3164182,551269,549765,41894,591659,6989
2022-04-24,Placer,061,380077,63291,63037,7393,70430,622
2022-04-24,Plumas,063,18699,2981,2934,366,3300,13
2022-04-24,Riverside,065,2383286,594191,592683,28011,620694,6450
2022-04-24,Sacramento,067,1510023,282804,280551,26620,307171,2993
2022-04-24,San Benito,069,59416,12956,12966,519,13485,98
2022-04-24,San Bernardino,071,2135413,575878,566806,24987,591793,7047
2022-04-24,San Diego,073,3302833,758312,758311,53404,811715,5233
2022-04-24,San Francisco,075,870044,129783,128323,8574,136897,857
2022-04-24,San Joaquin,077,732212,167229,166626,9983,176609,2224
2022-04-24,San Luis Obispo,079,281455,52931,52826,3817,56643,476
2022-04-24,San Mateo,081,765935,125460,124106,7267,131373,703
2022-04-24,Santa Barbara,083,443738,86774,86376,4762,91138,685
2022-04-24,Santa Clara,085,1922200,318481,317487,12712,330199,2277
2022-04-24,Santa Cruz,087,273765,49092,48255,2133,50388,261
2022-04-24,Shasta,089,179085,30651,30607,6106,36713,557
2022-04-24,Sierra,091,2930,274,276,49,325,4
2022-04-24,Siskiyou,093,43540,4465,4453,2735,7188,81
2022-04-24,Solano,095,438530,82437,81982,5646,87628,448
2022-04-24,Sonoma,097,501317,85194,84581,2852,87433,486
2022-04-24,Stanislaus,099,539301,117995,117737,17664,135401,1632
2022-04-24,Sutter,101,95872,20556,20605,2095,22700,224
2022-04-24,Tehama,103,63373,12057,12064,2583,14647,201
2022-04-24,Trinity,105,12862,1185,1177,288,1465,20
2022-04-24,Tulare,107,460477,106504,106354,27674,134028,1446
2022-04-24,Tuolumne,109,53932,12737,12664,569,13233,181
2022-04-24,Ventura,111,848112,174615,174091,9521,183612,1479
2022-04-24,Yolo,113,214977,37684,36990,3088,40078,314
2022-04-24,Yuba,115,75493,15908,15888,1204,17092,121
2022-04-23,Alameda,001,1643700,262047,259619,14198,273817,1837
2022-04-23,Alpine,003,1148,124,124,1,125,0
2022-04-23,Amador,005,37829,8557,8509,656,9165,86
2022-04-23,Butte,007,227075,33290,33105,7008,40113,411
2022-04-23,Calaveras,009,45235,7310,7296,352,7648,119
2022-04-23,Colusa,011,21464,3452,3453,1048,4501,21
2022-04-23,Contra Costa,013,1133247,193422,190611,13508,204119,1298
2022-04-23,Del Norte,015,27424,5850,5827,186,6013,50
2022-04-23,El Dorado,017,186661,26969,26837,3232,30069,209
2022-04-23,Fresno,019,978130,231963,231751,23758,255509,2744
2022-04-23,Glenn,021,27897,4996,4989,1611,6600,48
2022-04-23,Humboldt,023,135768,17167,17033,3013,20046,145
2022-04-23,Imperial,025,180216,55497,55434,10577,66011,910
2022-04-23,Inyo,027,18085,4087,4079,494,4573,56
2022-04-23,Kern,029,883053,192301,192012,45871,237883,2267
2022-04-23,Kings,031,150075,51610,51588,3514,55102,444
2022-04-23,Lake,033,64148,10752,10720,890,11610,134
2022-04-23,Lassen,035,31185,8964,8966,875,9841,65
2022-04-23,Los Angeles,037,10098052,2737837,2725630,125113,2850743,31667
2022-04-23,Madera,039,155013,37339,37333,6036,43369,354
2022-04-23,Marin,041,260295,34418,34150,2691,36841,288
2022-04-23,Mariposa,043,17540,2433,2422,202,2624,30
2022-04-23,Mendocino,045,87422,13206,13158,3073,16231,122
2022-04-23,Merced,047,269075,62399,62286,8684,70970,815
2022-04-23,Modoc,049,8938,741,745,252,997,8
2022-04-23,Mono,051,14174,2988,2986,128,3114,6
2022-04-23,Monterey,053,433212,79892,79560,13866,93426,729
2022-04-23,Napa,055,140530,26287,26093,1017,27110,143
2022-04-23,Nevada,057,99092,16081,16052,1214,17266,127
2022-04-23,Orange,059,3164182,551053,549765,41846,591611,6989
2022-04-23,Placer,061,380077,63261,63037,7393,70430,622
2022-04-23,Plumas,063,18699,2981,2934,366,3300,13
2022-04-23,Riverside,065,2383286,594055,592683,28001,620684,6450
2022-04-23,Sacramento,067,1510023,282704,280551,26617,307168,2993
2022-04-23,San Benito,069,59416,12955,12966,519,13485,98
2022-04-23,San Bernardino,071,2135413,575759,566806,24984,591790,7047
2022-04-23,San Diego,073,3302833,758050,758311,53386,811697,5233
2022-04-23,San Francisco,075,870044,129579,128323,8549,136872,857
2022-04-23,San Joaquin,077,732212,167188,166626,9975,176601,2224
2022-04-23,San Luis Obispo,079,281455,52916,52826,3813,56639,476
2022-04-23,San Mateo,081,765935,125303,124106,7257,131363,703
2022-04-23,Santa Barbara,083,443738,86738,86376,4761,91137,685
2022-04-23,Santa Clara,085,1922200,318102,317487,12685,330172,2277
2022-04-23,Santa Cruz,087,273765,49042,48255,2131,50386,261
2022-04-23,Shasta,089,179085,30648,30607,6106,36713,557
2022-04-23,Sierra,091,2930,274,276,49,325,4
2022-04-23,Siskiyou,093,43540,4463,4453,2735,7188,81
2022-04-23,Solano,095,438530,82410,81982,5643,87625,448
2022-04-23,Sonoma,097,501317,85126,84581,2843,87424,486
2022-04-23,Stanislaus,099,539301,117959,117737,17662,135399,1632
2022-04-23,Sutter,101,95872,20550,20605,2095,22700,224
2022-04-23,Tehama,103,63373,12056,12064,2583,14647,201
2022-04-23,Trinity,105,12862,1185,1177,288,1465,20
2022-04-23,Tulare,107,460477,106496,106354,27665,134019,1446
2022-04-23,Tuolumne,109,53932,12732,12664,569,13233,181
2022-04-23,Ventura,111,848112,174552,174091,9515,183606,1479
2022-04-23,Yolo,113,214977,37656,36990,3084,40074,314
2022-04-23,Yuba,115,75493,15906,15888,1204,17092,121
2022-04-22,Alameda,001,1643700,261812,259619,14179,273798,1837
2022-04-22,Alpine,003,1148,124,124,1,125,0
2022-04-22,Amador,005,37829,8556,8509,654,9163,86
2022-04-22,Butte,007,227075,33283,33105,7003,40108,411
2022-04-22,Calaveras,009,45235,7309,7296,352,7648,119
2022-04-22,Colusa,011,21464,3452,3453,1048,4501,21
2022-04-22,Contra Costa,013,1133247,193286,190611,13492,204103,1298
2022-04-22,Del Norte,015,27424,5850,5827,186,6013,50
2022-04-22,El Dorado,017,186661,26956,26837,3228,30065,209
2022-04-22,Fresno,019,978130,231933,231751,23754,255505,2744
2022-04-22,Glenn,021,27897,4995,4989,1611,6600,48
2022-04-22,Humboldt,023,135768,17151,17033,3007,20040,145
2022-04-22,Imperial,025,180216,55491,55434,10577,66011,910
2022-04-22,Inyo,027,18085,4087,4079,493,4572,56
2022-04-22,Kern,029,883053,192281,192012,45868,237880,2267
2022-04-22,Kings,031,150075,51606,51588,3513,55101,444
2022-04-22,Lake,033,64148,10751,10720,890,11610,134
2022-04-22,Lassen,035,31185,8964,8966,875,9841,65
2022-04-22,Los Angeles,037,10098052,2736740,2725630,125054,2850684,31667
2022-04-22,Madera,039,155013,37334,37333,6035,43368,354
2022-04-22,Marin,041,260295,34381,34150,2680,36830,288
2022-04-22,Mariposa,043,17540,2432,2422,202,2624,30
2022-04-22,Mendocino,045,87422,13201,13158,3068,16226,122
2022-04-22,Merced,047,269075,62392,62286,8673,70959,815
2022-04-22,Modoc,049,8938,741,745,252,997,8
2022-04-22,Mono,051,14174,2988,2986,127,3113,6
2022-04-22,Monterey,053,433212,79857,79560,13852,93412,729
2022-04-22,Napa,055,140530,26269,26093,1015,27108,143
2022-04-22,Nevada,057,99092,16081,16052,1214,17266,127
2022-04-22,Orange,059,3164182,550868,549765,41795,591560,6989
2022-04-22,Placer,061,380077,63238,63037,7390,70427,622
2022-04-22,Plumas,063,18699,2981,2934,366,3300,13
2022-04-22,Riverside,065,2383286,593911,592683,27986,620669,6450
2022-04-22,Sacramento,067,1510023,282616,280551,26605,307156,2993
2022-04-22,San Benito,069,59416,12950,12966,519,13485,98
2022-04-22,San Bernardino,071,2135413,575646,566806,24976,591782,7047
2022-04-22,San Diego,073,3302833,757729,758311,53357,811668,5233
2022-04-22,San Francisco,075,870044,129414,128323,8523,136846,857
2022-04-22,San Joaquin,077,732212,167158,166626,9974,176600,2224
2022-04-22,San Luis Obispo,079,281455,52910,52826,3812,56638,476
2022-04-22,San Mateo,081,765935,125142,124106,7244,131350,703
2022-04-22,Santa Barbara,083,443738,86691,86376,4760,91136,685
2022-04-22,Santa Clara,085,1922200,317755,317487,12671,330158,2277
2022-04-22,Santa Cruz,087,273765,49002,48255,2130,50385,261
2022-04-22,Shasta,089,179085,30643,30607,6105,36712,557
2022-04-22,Sierra,091,2930,274,276,48,324,4
2022-04-22,Siskiyou,093,43540,4463,4453,2735,7188,81
2022-04-22,Solano,095,438530,82353,81982,5641,87623,448
2022-04-22,Sonoma,097,501317,85062,84581,2839,87420,486
2022-04-22,Stanislaus,099,539301,117937,117737,17657,135394,1632
2022-04-22,Sutter,101,95872,20544,20605,2095,22700,224
2022-04-22,Tehama,103,63373,12051,12064,2582,14646,201
2022-04-22,Trinity,105,12862,1185,1177,287,1464,20
2022-04-22,Tulare,107,460477,106486,106354,27657,134011,1446
2022-04-22,Tuolumne,109,53932,12726,12664,567,13231,181
2022-04-22,Ventura,111,848112,174476,174091,9504,183595,1479
2022-04-22,Yolo,113,214977,37635,36990,3082,40072,314
2022-04-22,Yuba,115,75493,15903,15888,1203,17091,121
2022-04-21,Alameda,001,1643700,261454,259619,14139,273758,1837
2022-04-21,Alpine,003,1148,124,124,1,125,0
2022-04-21,Amador,005,37829,8553,8509,654,9163,86
2022-04-21,Butte,007,227075,33275,33105,6995,40100,411
2022-04-21,Calaveras,009,45235,7306,7296,352,7648,119
2022-04-21,Colusa,011,21464,3451,3453,1048,4501,21
2022-04-21,Contra Costa,013,1133247,193091,190611,13471,204082,1298
2022-04-21,Del Norte,015,27424,5849,5827,186,6013,50
2022-04-21,El Dorado,017,186661,26940,26837,3227,30064,209
2022-04-21,Fresno,019,978130,231891,231751,23746,255497,2744
2022-04-21,Glenn,021,27897,4995,4989,1610,6599,48
2022-04-21,Humboldt,023,135768,17128,17033,2999,20032,145
2022-04-21,Imperial,025,180216,55482,55434,10577,66011,910
2022-04-21,Inyo,027,18085,4087,4079,493,4572,56
2022-04-21,Kern,029,883053,192248,192012,45853,237865,2267
2022-04-21,Kings,031,150075,51598,51588,3513,55101,444
2022-04-21,Lake,033,64148,10748,10720,890,11610,134
2022-04-21,Lassen,035,31185,8964,8966,875,9841,65
2022-04-21,Los Angeles,037,10098052,2735091,2725630,124940,2850570,31667
2022-04-21,Madera,039,155013,37331,37333,6034,43367,354
2022-04-21,Marin,041,260295,34333,34150,2670,36820,288
2022-04-21,Mariposa,043,17540,2431,2422,202,2624,30
2022-04-21,Mendocino,045,87422,13194,13158,3065,16223,122
2022-04-21,Merced,047,269075,62374,62286,8671,70957,815
2022-04-21,Modoc,049,8938,741,745,252,997,8
2022-04-21,Mono,051,14174,2987,2986,126,3112,6
2022-04-21,Monterey,053,433212,79830,79560,13838,93398,729
2022-04-21,Napa,055,140530,26238,26093,1014,27107,143
2022-04-21,Nevada,057,99092,16077,16052,1214,17266,127
2022-04-21,Orange,059,3164182,550615,549765,41759,591524,6989
2022-04-21,Placer,061,380077,63200,63037,7386,70423,622
2022-04-21,Plumas,063,18699,2981,2934,366,3300,13
2022-04-21,Riverside,065,2383286,593751,592683,27968,620651,6450
2022-04-21,Sacramento,067,1510023,282468,280551,26585,307136,2993
2022-04-21,San Benito,069,59416,12944,12966,519,13485,98
2022-04-21,San Bernardino,071,2135413,575456,566806,24964,591770,7047
2022-04-21,San Diego,073,3302833,757304,758311,53313,811624,5233
2022-04-21,San Francisco,075,870044,129191,128323,8495,136818,857
2022-04-21,San Joaquin,077,732212,167104,166626,9969,176595,2224
2022-04-21,San Luis Obispo,079,281455,52890,52826,3805,56631,476
2022-04-21,San Mateo,081,765935,124941,124106,7224,131330,703
2022-04-21,Santa Barbara,083,443738,86632,86376,4757,91133,685
2022-04-21,Santa Clara,085,1922200,317304,317487,12649,330136,2277
2022-04-21,Santa Cruz,087,273765,48956,48255,2128,50383,261
2022-04-21,Shasta,089,179085,30635,30607,6105,36712,557
2022-04-21,Sierra,091,2930,274,276,48,324,4
2022-04-21,Siskiyou,093,43540,4463,4453,2735,7188,81
2022-04-21,Solano,095,438530,82291,81982,5635,87617,448
2022-04-21,Sonoma,097,501317,84948,84581,2818,87399,486
2022-04-21,Stanislaus,099,539301,117898,117737,17649,135386,1632
2022-04-21,Sutter,101,95872,20535,20605,2093,22698,224
2022-04-21,Tehama,103,63373,12051,12064,2582,14646,201
2022-04-21,Trinity,105,12862,1185,1177,287,1464,20
2022-04-21,Tulare,107,460477,106479,106354,27653,134007,1446
2022-04-21,Tuolumne,109,53932,12721,12664,567,13231,181
2022-04-21,Ventura,111,848112,174393,174091,9498,183589,1479
2022-04-21,Yolo,113,214977,37605,36990,3082,40072,314
2022-04-21,Yuba,115,75493,15901,15888,1203,17091,121
2022-04-20,Alameda,001,1643700,261091,258734,14109,272843,1832
2022-04-20,Alpine,003,1148,124,124,1,125,0
2022-04-20,Amador,005,37829,8551,8494,654,9148,86
2022-04-20,Butte,007,227075,33266,33083,6988,40071,408
2022-04-20,Calaveras,009,45235,7300,7288,351,7639,119
2022-04-20,Colusa,011,21464,3451,3453,1048,4501,21
2022-04-20,Contra Costa,013,1133247,192856,190042,13446,203488,1299
2022-04-20,Del Norte,015,27424,5843,5814,186,6000,50
2022-04-20,El Dorado,017,186661,26925,26821,3222,30043,209
2022-04-20,Fresno,019,978130,231841,231568,23745,255313,2740
2022-04-20,Glenn,021,27897,4994,4988,1607,6595,48
2022-04-20,Humboldt,023,135768,17106,16976,2995,19971,145
2022-04-20,Imperial,025,180216,55474,55405,10574,65979,910
2022-04-20,Inyo,027,18085,4087,4075,492,4567,56
2022-04-20,Kern,029,883053,192213,191915,45837,237752,2262
2022-04-20,Kings,031,150075,51589,51571,3511,55082,445
2022-04-20,Lake,033,64148,10748,10711,890,11601,134
2022-04-20,Lassen,035,31185,8964,8951,875,9826,65
2022-04-20,Los Angeles,037,10098052,2733352,2721699,124821,2846520,31630
2022-04-20,Madera,039,155013,37328,37333,6031,43364,354
2022-04-20,Marin,041,260295,34292,33985,2647,36632,288
2022-04-20,Mariposa,043,17540,2429,2412,202,2614,30
2022-04-20,Mendocino,045,87422,13188,13128,3057,16185,122
2022-04-20,Merced,047,269075,62364,62322,8658,70980,813
2022-04-20,Modoc,049,8938,741,744,252,996,8
2022-04-20,Mono,051,14174,2987,2984,126,3110,6
2022-04-20,Monterey,053,433212,79784,79419,13819,93238,727
2022-04-20,Napa,055,140530,26204,26016,1010,27026,143
2022-04-20,Nevada,057,99092,16067,16034,1211,17245,127
2022-04-20,Orange,059,3164182,550287,549136,41712,590848,6963
2022-04-20,Placer,061,380077,63174,62928,7381,70309,619
2022-04-20,Plumas,063,18699,2981,2932,366,3298,13
2022-04-20,Riverside,065,2383286,593559,592224,27946,620170,6447
2022-04-20,Sacramento,067,1510023,282325,279326,26568,305894,2987
2022-04-20,San Benito,069,59416,12938,12971,516,13487,98
2022-04-20,San Bernardino,071,2135413,575249,565405,24947,590352,6977
2022-04-20,San Diego,073,3302833,756861,757138,53253,810391,5231
2022-04-20,San Francisco,075,870044,128884,127594,8477,136071,854
2022-04-20,San Joaquin,077,732212,167033,166531,9962,176493,2222
2022-04-20,San Luis Obispo,079,281455,52863,52740,3798,56538,476
2022-04-20,San Mateo,081,765935,124723,123279,7192,130471,701
2022-04-20,Santa Barbara,083,443738,86596,86214,4751,90965,685
2022-04-20,Santa Clara,085,1922200,316893,316355,12611,328966,2274
2022-04-20,Santa Cruz,087,273765,48892,47997,2124,50121,261
2022-04-20,Shasta,089,179085,30632,30590,6104,36694,554
2022-04-20,Sierra,091,2930,274,276,48,324,4
2022-04-20,Siskiyou,093,43540,4462,4446,2734,7180,80
2022-04-20,Solano,095,438530,82219,81841,5632,87473,447
2022-04-20,Sonoma,097,501317,84860,84429,2794,87223,485
2022-04-20,Stanislaus,099,539301,117862,117540,17638,135178,1630
2022-04-20,Sutter,101,95872,20528,20632,2093,22725,224
2022-04-20,Tehama,103,63373,12049,12061,2582,14643,199
2022-04-20,Trinity,105,12862,1185,1178,287,1465,20
2022-04-20,Tulare,107,460477,106471,105974,27642,133616,1439
2022-04-20,Tuolumne,109,53932,12716,12648,566,13214,180
2022-04-20,Ventura,111,848112,174305,173904,9489,183393,1475
2022-04-20,Yolo,113,214977,37555,36785,3079,39864,311
2022-04-20,Yuba,115,75493,15897,15868,1201,17069,121
2022-04-19,Alameda,001,1643700,260731,258734,14077,272811,1832
2022-04-19,Alpine,003,1148,124,124,1,125,0
2022-04-19,Amador,005,37829,8547,8494,651,9145,86
2022-04-19,Butte,007,227075,33259,33083,6984,40067,408
2022-04-19,Calaveras,009,45235,7297,7288,351,7639,119
2022-04-19,Colusa,011,21464,3451,3453,1048,4501,21
2022-04-19,Contra Costa,013,1133247,192610,190042,13428,203470,1299
2022-04-19,Del Norte,015,27424,5841,5814,184,5998,50
2022-04-19,El Dorado,017,186661,26910,26821,3219,30040,209
2022-04-19,Fresno,019,978130,231787,231568,23734,255302,2740
2022-04-19,Glenn,021,27897,4993,4988,1607,6595,48
2022-04-19,Humboldt,023,135768,17069,16976,2984,19960,145
2022-04-19,Imperial,025,180216,55467,55405,10571,65976,910
2022-04-19,Inyo,027,18085,4084,4075,492,4567,56
2022-04-19,Kern,029,883053,192177,191915,45827,237742,2262
2022-04-19,Kings,031,150075,51575,51571,3510,55081,445
2022-04-19,Lake,033,64148,10744,10711,889,11600,134
2022-04-19,Lassen,035,31185,8964,8951,875,9826,65
2022-04-19,Los Angeles,037,10098052,2731552,2721699,124695,2846394,31630
2022-04-19,Madera,039,155013,37325,37333,6030,43363,354
2022-04-19,Marin,041,260295,34242,33985,2631,36616,288
2022-04-19,Mariposa,043,17540,2429,2412,201,2613,30
2022-04-19,Mendocino,045,87422,13180,13128,3046,16174,122
2022-04-19,Merced,047,269075,62345,62322,8654,70976,813
2022-04-19,Modoc,049,8938,741,744,252,996,8
2022-04-19,Mono,051,14174,2987,2984,126,3110,6
2022-04-19,Monterey,053,433212,79763,79419,13806,93225,727
2022-04-19,Napa,055,140530,26181,26016,1001,27017,143
2022-04-19,Nevada,057,99092,16061,16034,1209,17243,127
2022-04-19,Orange,059,3164182,550008,549136,41668,590804,6963
2022-04-19,Placer,061,380077,63142,62928,7376,70304,619
2022-04-19,Plumas,063,18699,2981,2932,366,3298,13
2022-04-19,Riverside,065,2383286,593377,592224,27934,620158,6447
2022-04-19,Sacramento,067,1510023,282152,279326,26544,305870,2987
2022-04-19,San Benito,069,59416,12932,12971,515,13486,98
2022-04-19,San Bernardino,071,2135413,575033,565405,24925,590330,6977
2022-04-19,San Diego,073,3302833,756395,757138,53190,810328,5231
2022-04-19,San Francisco,075,870044,128550,127594,8459,136053,854
2022-04-19,San Joaquin,077,732212,166982,166531,9958,176489,2222
2022-04-19,San Luis Obispo,079,281455,52827,52740,3792,56532,476
2022-04-19,San Mateo,081,765935,124492,123279,7171,130450,701
2022-04-19,Santa Barbara,083,443738,86542,86214,4743,90957,685
2022-04-19,Santa Clara,085,1922200,316473,316355,12582,328937,2274
2022-04-19,Santa Cruz,087,273765,48837,47997,2122,50119,261
2022-04-19,Shasta,089,179085,30620,30590,6103,36693,554
2022-04-19,Sierra,091,2930,274,276,48,324,4
2022-04-19,Siskiyou,093,43540,4461,4446,2732,7178,80
2022-04-19,Solano,095,438530,82135,81841,5625,87466,447
2022-04-19,Sonoma,097,501317,84758,84429,2765,87194,485
2022-04-19,Stanislaus,099,539301,117836,117540,17633,135173,1630
2022-04-19,Sutter,101,95872,20528,20632,2093,22725,224
2022-04-19,Tehama,103,63373,12048,12061,2582,14643,199
2022-04-19,Trinity,105,12862,1184,1178,287,1465,20
2022-04-19,Tulare,107,460477,106455,105974,27636,133610,1439
2022-04-19,Tuolumne,109,53932,12714,12648,566,13214,180
2022-04-19,Ventura,111,848112,174211,173904,9476,183380,1475
2022-04-19,Yolo,113,214977,37510,36785,3077,39862,311
2022-04-19,Yuba,115,75493,15890,15868,1201,17069,121
2022-04-18,Alameda,001,1643700,260348,258734,14055,272789,1832
2022-04-18,Alpine,003,1148,124,124,1,125,0
2022-04-18,Amador,005,37829,8546,8494,650,9144,86
2022-04-18,Butte,007,227075,33255,33083,6979,40062,408
2022-04-18,Calaveras,009,45235,7293,7288,350,7638,119
2022-04-18,Colusa,011,21464,3450,3453,1048,4501,21
2022-04-18,Contra Costa,013,1133247,192375,190042,13403,203445,1299
2022-04-18,Del Norte,015,27424,5836,5814,184,5998,50
2022-04-18,El Dorado,017,186661,26893,26821,3216,30037,209
2022-04-18,Fresno,019,978130,231743,231568,23723,255291,2740
2022-04-18,Glenn,021,27897,4992,4988,1606,6594,48
2022-04-18,Humboldt,023,135768,17039,16976,2981,19957,145
2022-04-18,Imperial,025,180216,55455,55405,10569,65974,910
2022-04-18,Inyo,027,18085,4084,4075,492,4567,56
2022-04-18,Kern,029,883053,192132,191915,45815,237730,2262
2022-04-18,Kings,031,150075,51570,51571,3510,55081,445
2022-04-18,Lake,033,64148,10740,10711,888,11599,134
2022-04-18,Lassen,035,31185,8964,8951,875,9826,65
2022-04-18,Los Angeles,037,10098052,2729718,2721699,124581,2846280,31630
2022-04-18,Madera,039,155013,37317,37333,6029,43362,354
2022-04-18,Marin,041,260295,34178,33985,2608,36593,288
2022-04-18,Mariposa,043,17540,2427,2412,201,2613,30
2022-04-18,Mendocino,045,87422,13163,13128,3041,16169,122
2022-04-18,Merced,047,269075,62333,62322,8648,70970,813
2022-04-18,Modoc,049,8938,740,744,252,996,8
2022-04-18,Mono,051,14174,2986,2984,126,3110,6
2022-04-18,Monterey,053,433212,79690,79419,13790,93209,727
2022-04-18,Napa,055,140530,26145,26016,1000,27016,143
2022-04-18,Nevada,057,99092,16051,16034,1207,17241,127
2022-04-18,Orange,059,3164182,549719,549136,41635,590771,6963
2022-04-18,Placer,061,380077,63109,62928,7374,70302,619
2022-04-18,Plumas,063,18699,2981,2932,366,3298,13
2022-04-18,Riverside,065,2383286,593168,592224,27914,620138,6447
2022-04-18,Sacramento,067,1510023,281995,279326,26532,305858,2987
2022-04-18,San Benito,069,59416,12926,12971,515,13486,98
2022-04-18,San Bernardino,071,2135413,574820,565405,24907,590312,6977
2022-04-18,San Diego,073,3302833,755925,757138,53131,810269,5231
2022-04-18,San Francisco,075,870044,128233,127594,8447,136041,854
2022-04-18,San Joaquin,077,732212,166922,166531,9951,176482,2222
2022-04-18,San Luis Obispo,079,281455,52798,52740,3787,56527,476
2022-04-18,San Mateo,081,765935,124260,123279,7151,130430,701
2022-04-18,Santa Barbara,083,443738,86471,86214,4738,90952,685
2022-04-18,Santa Clara,085,1922200,316027,316355,12557,328912,2274
2022-04-18,Santa Cruz,087,273765,48731,47997,2120,50117,261
2022-04-18,Shasta,089,179085,30614,30590,6100,36690,554
2022-04-18,Sierra,091,2930,274,276,48,324,4
2022-04-18,Siskiyou,093,43540,4460,4446,2731,7177,80
2022-04-18,Solano,095,438530,82070,81841,5619,87460,447
2022-04-18,Sonoma,097,501317,84658,84429,2750,87179,485
2022-04-18,Stanislaus,099,539301,117806,117540,17630,135170,1630
2022-04-18,Sutter,101,95872,20526,20632,2091,22723,224
2022-04-18,Tehama,103,63373,12044,12061,2582,14643,199
2022-04-18,Trinity,105,12862,1184,1178,287,1465,20
2022-04-18,Tulare,107,460477,106440,105974,27628,133602,1439
2022-04-18,Tuolumne,109,53932,12707,12648,565,13213,180
2022-04-18,Ventura,111,848112,174120,173904,9466,183370,1475
2022-04-18,Yolo,113,214977,37453,36785,3077,39862,311
2022-04-18,Yuba,115,75493,15881,15868,1200,17068,121
2022-04-17,Alameda,001,1643700,259957,257897,14029,271926,1829
2022-04-17,Alpine,003,1148,124,124,1,125,0
2022-04-17,Amador,005,37829,8541,8491,648,9139,86
2022-04-17,Butte,007,227075,33253,33053,6976,40029,405
2022-04-17,Calaveras,009,45235,7290,7275,349,7624,119
2022-04-17,Colusa,011,21464,3449,3450,1048,4498,21
2022-04-17,Contra Costa,013,1133247,192147,189742,13367,203109,1298
2022-04-17,Del Norte,015,27424,5831,5809,184,5993,50
2022-04-17,El Dorado,017,186661,26881,26796,3214,30010,209
2022-04-17,Fresno,019,978130,231666,231455,23717,255172,2739
2022-04-17,Glenn,021,27897,4992,4991,1606,6597,48
2022-04-17,Humboldt,023,135768,17004,16929,2975,19904,143
2022-04-17,Imperial,025,180216,55446,55371,10567,65938,910
2022-04-17,Inyo,027,18085,4082,4075,492,4567,56
2022-04-17,Kern,029,883053,192097,191866,45800,237666,2258
2022-04-17,Kings,031,150075,51559,51544,3508,55052,445
2022-04-17,Lake,033,64148,10739,10702,888,11590,134
2022-04-17,Lassen,035,31185,8964,8950,875,9825,65
2022-04-17,Los Angeles,037,10098052,2727722,2717479,124463,2841942,31598
2022-04-17,Madera,039,155013,37311,37362,6029,43391,354
2022-04-17,Marin,041,260295,34111,33829,2578,36407,288
2022-04-17,Mariposa,043,17540,2419,2406,201,2607,30
2022-04-17,Mendocino,045,87422,13148,13107,3037,16144,122
2022-04-17,Merced,047,269075,62313,62295,8642,70937,813
2022-04-17,Modoc,049,8938,740,743,252,995,8
2022-04-17,Mono,051,14174,2985,2977,126,3103,6
2022-04-17,Monterey,053,433212,79657,79311,13770,93081,727
2022-04-17,Napa,055,140530,26101,25929,994,26923,143
2022-04-17,Nevada,057,99092,16035,16014,1202,17216,123
2022-04-17,Orange,059,3164182,549356,548311,41587,589898,6945
2022-04-17,Placer,061,380077,63069,62882,7367,70249,618
2022-04-17,Plumas,063,18699,2981,2929,366,3295,13
2022-04-17,Riverside,065,2383286,592948,591772,27894,619666,6443
2022-04-17,Sacramento,067,1510023,281834,278523,26507,305030,2978
2022-04-17,San Benito,069,59416,12923,12926,514,13440,98
2022-04-17,San Bernardino,071,2135413,574580,564397,24893,589290,6948
2022-04-17,San Diego,073,3302833,755434,756165,53063,809228,5229
2022-04-17,San Francisco,075,870044,127915,126976,8431,135407,854
2022-04-17,San Joaquin,077,732212,166871,166645,9945,176590,2220
2022-04-17,San Luis Obispo,079,281455,52729,52698,3782,56480,476
2022-04-17,San Mateo,081,765935,124024,122652,7135,129787,699
2022-04-17,Santa Barbara,083,443738,86413,86030,4732,90762,684
2022-04-17,Santa Clara,085,1922200,315531,315296,12530,327826,2268
2022-04-17,Santa Cruz,087,273765,48609,47895,2118,50013,261
2022-04-17,Shasta,089,179085,30603,30578,6096,36674,554
2022-04-17,Sierra,091,2930,274,276,48,324,4
2022-04-17,Siskiyou,093,43540,4455,4444,2730,7174,80
2022-04-17,Solano,095,438530,82003,81781,5613,87394,447
2022-04-17,Sonoma,097,501317,84546,84172,2743,86915,485
2022-04-17,Stanislaus,099,539301,117776,117567,17623,135190,1619
2022-04-17,Sutter,101,95872,20521,20621,2090,22711,224
2022-04-17,Tehama,103,63373,12043,12061,2582,14643,199
2022-04-17,Trinity,105,12862,1183,1178,287,1465,20
2022-04-17,Tulare,107,460477,106426,105757,27619,133376,1428
2022-04-17,Tuolumne,109,53932,12701,12640,565,13205,180
2022-04-17,Ventura,111,848112,174022,173665,9448,183113,1474
2022-04-17,Yolo,113,214977,37404,36752,3075,39827,311
2022-04-17,Yuba,115,75493,15875,15857,1200,17057,121
2022-04-16,Alameda,001,1643700,259805,257897,14019,271916,1829
2022-04-16,Alpine,003,1148,124,124,1,125,0
2022-04-16,Amador,005,37829,8539,8491,648,9139,86
2022-04-16,Butte,007,227075,33249,33053,6974,40027,405
2022-04-16,Calaveras,009,45235,7288,7275,349,7624,119
2022-04-16,Colusa,011,21464,3449,3450,1048,4498,21
2022-04-16,Contra Costa,013,1133247,192056,189742,13361,203103,1298
2022-04-16,Del Norte,015,27424,5831,5809,184,5993,50
2022-04-16,El Dorado,017,186661,26870,26796,3214,30010,209
2022-04-16,Fresno,019,978130,231638,231455,23716,255171,2739
2022-04-16,Glenn,021,27897,4992,4991,1606,6597,48
2022-04-16,Humboldt,023,135768,16996,16929,2970,19899,143
2022-04-16,Imperial,025,180216,55440,55371,10566,65937,910
2022-04-16,Inyo,027,18085,4082,4075,492,4567,56
2022-04-16,Kern,029,883053,192086,191866,45788,237654,2258
2022-04-16,Kings,031,150075,51556,51544,3508,55052,445
2022-04-16,Lake,033,64148,10737,10702,888,11590,134
2022-04-16,Lassen,035,31185,8964,8950,875,9825,65
2022-04-16,Los Angeles,037,10098052,2727014,2717479,124413,2841892,31598
2022-04-16,Madera,039,155013,37309,37362,6029,43391,354
2022-04-16,Marin,041,260295,34073,33829,2552,36381,288
2022-04-16,Mariposa,043,17540,2418,2406,201,2607,30
2022-04-16,Mendocino,045,87422,13142,13107,3037,16144,122
2022-04-16,Merced,047,269075,62310,62295,8642,70937,813
2022-04-16,Modoc,049,8938,740,743,252,995,8
2022-04-16,Mono,051,14174,2985,2977,126,3103,6
2022-04-16,Monterey,053,433212,79642,79311,13761,93072,727
2022-04-16,Napa,055,140530,26078,25929,992,26921,143
2022-04-16,Nevada,057,99092,16032,16014,1201,17215,123
2022-04-16,Orange,059,3164182,549240,548311,41558,589869,6945
2022-04-16,Placer,061,380077,63053,62882,7365,70247,618
2022-04-16,Plumas,063,18699,2979,2929,366,3295,13
2022-04-16,Riverside,065,2383286,592868,591772,27888,619660,6443
2022-04-16,Sacramento,067,1510023,281784,278523,26502,305025,2978
2022-04-16,San Benito,069,59416,12922,12926,514,13440,98
2022-04-16,San Bernardino,071,2135413,574481,564397,24889,589286,6948
2022-04-16,San Diego,073,3302833,755287,756165,53051,809216,5229
2022-04-16,San Francisco,075,870044,127759,126976,8422,135398,854
2022-04-16,San Joaquin,077,732212,166831,166645,9941,176586,2220
2022-04-16,San Luis Obispo,079,281455,52723,52698,3781,56479,476
2022-04-16,San Mateo,081,765935,123928,122652,7128,129780,699
2022-04-16,Santa Barbara,083,443738,86383,86030,4732,90762,684
2022-04-16,Santa Clara,085,1922200,315289,315296,12522,327818,2268
2022-04-16,Santa Cruz,087,273765,48581,47895,2118,50013,261
2022-04-16,Shasta,089,179085,30599,30578,6096,36674,554
2022-04-16,Sierra,091,2930,274,276,48,324,4
2022-04-16,Siskiyou,093,43540,4455,4444,2730,7174,80
2022-04-16,Solano,095,438530,81988,81781,5611,87392,447
2022-04-16,Sonoma,097,501317,84497,84172,2734,86906,485
2022-04-16,Stanislaus,099,539301,117756,117567,17618,135185,1619
2022-04-16,Sutter,101,95872,20517,20621,2090,22711,224
2022-04-16,Tehama,103,63373,12042,12061,2582,14643,199
2022-04-16,Trinity,105,12862,1183,1178,287,1465,20
2022-04-16,Tulare,107,460477,106416,105757,27617,133374,1428
2022-04-16,Tuolumne,109,53932,12700,12640,565,13205,180
2022-04-16,Ventura,111,848112,173994,173665,9444,183109,1474
2022-04-16,Yolo,113,214977,37395,36752,3074,39826,311
2022-04-16,Yuba,115,75493,15871,15857,1200,17057,121
2022-04-15,Alameda,001,1643700,259623,257897,14011,271908,1829
2022-04-15,Alpine,003,1148,124,124,1,125,0
2022-04-15,Amador,005,37829,8538,8491,646,9137,86
2022-04-15,Butte,007,227075,33247,33053,6972,40025,405
2022-04-15,Calaveras,009,45235,7286,7275,349,7624,119
2022-04-15,Colusa,011,21464,3449,3450,1048,4498,21
2022-04-15,Contra Costa,013,1133247,191939,189742,13354,203096,1298
2022-04-15,Del Norte,015,27424,5830,5809,184,5993,50
2022-04-15,El Dorado,017,186661,26856,26796,3213,30009,209
2022-04-15,Fresno,019,978130,231609,231455,23716,255171,2739
2022-04-15,Glenn,021,27897,4992,4991,1606,6597,48
2022-04-15,Humboldt,023,135768,16984,16929,2969,19898,143
2022-04-15,Imperial,025,180216,55438,55371,10566,65937,910
2022-04-15,Inyo,027,18085,4082,4075,491,4566,56
2022-04-15,Kern,029,883053,192071,191866,45777,237643,2258
2022-04-15,Kings,031,150075,51552,51544,3508,55052,445
2022-04-15,Lake,033,64148,10732,10702,888,11590,134
2022-04-15,Lassen,035,31185,8964,8950,875,9825,65
2022-04-15,Los Angeles,037,10098052,2726240,2717479,124347,2841826,31598
2022-04-15,Madera,039,155013,37307,37362,6029,43391,354
2022-04-15,Marin,041,260295,34039,33829,2531,36360,288
2022-04-15,Mariposa,043,17540,2417,2406,201,2607,30
2022-04-15,Mendocino,045,87422,13136,13107,3035,16142,122
2022-04-15,Merced,047,269075,62306,62295,8642,70937,813
2022-04-15,Modoc,049,8938,740,743,252,995,8
2022-04-15,Mono,051,14174,2980,2977,125,3102,6
2022-04-15,Monterey,053,433212,79615,79311,13755,93066,727
2022-04-15,Napa,055,140530,26061,25929,991,26920,143
2022-04-15,Nevada,057,99092,16030,16014,1200,17214,123
2022-04-15,Orange,059,3164182,549119,548311,41528,589839,6945
2022-04-15,Placer,061,380077,63038,62882,7364,70246,618
2022-04-15,Plumas,063,18699,2979,2929,366,3295,13
2022-04-15,Riverside,065,2383286,592767,591772,27882,619654,6443
2022-04-15,Sacramento,067,1510023,281705,278523,26498,305021,2978
2022-04-15,San Benito,069,59416,12920,12926,513,13439,98
2022-04-15,San Bernardino,071,2135413,574397,564397,24886,589283,6948
2022-04-15,San Diego,073,3302833,755094,756165,53032,809197,5229
2022-04-15,San Francisco,075,870044,127609,126976,8407,135383,854
2022-04-15,San Joaquin,077,732212,166807,166645,9939,176584,2220
2022-04-15,San Luis Obispo,079,281455,52715,52698,3781,56479,476
2022-04-15,San Mateo,081,765935,123797,122652,7117,129769,699
2022-04-15,Santa Barbara,083,443738,86350,86030,4731,90761,684
2022-04-15,Santa Clara,085,1922200,314999,315296,12514,327810,2268
2022-04-15,Santa Cruz,087,273765,48553,47895,2117,50012,261
2022-04-15,Shasta,089,179085,30590,30578,6096,36674,554
2022-04-15,Sierra,091,2930,274,276,48,324,4
2022-04-15,Siskiyou,093,43540,4453,4444,2730,7174,80
2022-04-15,Solano,095,438530,81963,81781,5611,87392,447
2022-04-15,Sonoma,097,501317,84444,84172,2718,86890,485
2022-04-15,Stanislaus,099,539301,117736,117567,17616,135183,1619
2022-04-15,Sutter,101,95872,20514,20621,2090,22711,224
2022-04-15,Tehama,103,63373,12042,12061,2582,14643,199
2022-04-15,Trinity,105,12862,1183,1178,287,1465,20
2022-04-15,Tulare,107,460477,106410,105757,27611,133368,1428
2022-04-15,Tuolumne,109,53932,12697,12640,562,13202,180
2022-04-15,Ventura,111,848112,173965,173665,9438,183103,1474
2022-04-15,Yolo,113,214977,37378,36752,3074,39826,311
2022-04-15,Yuba,115,75493,15868,15857,1200,17057,121
2022-04-14,Alameda,001,1643700,259357,257897,14001,271898,1829
2022-04-14,Alpine,003,1148,124,124,1,125,0
2022-04-14,Amador,005,37829,8538,8491,646,9137,86
2022-04-14,Butte,007,227075,33242,33053,6969,40022,405
2022-04-14,Calaveras,009,45235,7285,7275,349,7624,119
2022-04-14,Colusa,011,21464,3449,3450,1048,4498,21
2022-04-14,Contra Costa,013,1133247,191784,189742,13342,203084,1298
2022-04-14,Del Norte,015,27424,5828,5809,184,5993,50
2022-04-14,El Dorado,017,186661,26853,26796,3211,30007,209
2022-04-14,Fresno,019,978130,231583,231455,23715,255170,2739
2022-04-14,Glenn,021,27897,4991,4991,1604,6595,48
2022-04-14,Humboldt,023,135768,16970,16929,2968,19897,143
2022-04-14,Imperial,025,180216,55428,55371,10566,65937,910
2022-04-14,Inyo,027,18085,4082,4075,490,4565,56
2022-04-14,Kern,029,883053,192052,191866,45769,237635,2258
2022-04-14,Kings,031,150075,51544,51544,3508,55052,445
2022-04-14,Lake,033,64148,10731,10702,888,11590,134
2022-04-14,Lassen,035,31185,8964,8950,874,9824,65
2022-04-14,Los Angeles,037,10098052,2725153,2717479,124259,2841738,31598
2022-04-14,Madera,039,155013,37305,37362,6029,43391,354
2022-04-14,Marin,041,260295,34006,33829,2503,36332,288
2022-04-14,Mariposa,043,17540,2416,2406,201,2607,30
2022-04-14,Mendocino,045,87422,13131,13107,3035,16142,122
2022-04-14,Merced,047,269075,62301,62295,8641,70936,813
2022-04-14,Modoc,049,8938,739,743,252,995,8
2022-04-14,Mono,051,14174,2980,2977,124,3101,6
2022-04-14,Monterey,053,433212,79590,79311,13750,93061,727
2022-04-14,Napa,055,140530,26039,25929,990,26919,143
2022-04-14,Nevada,057,99092,16023,16014,1199,17213,123
2022-04-14,Orange,059,3164182,548930,548311,41502,589813,6945
2022-04-14,Placer,061,380077,63020,62882,7359,70241,618
2022-04-14,Plumas,063,18699,2979,2929,366,3295,13
2022-04-14,Riverside,065,2383286,592648,591772,27872,619644,6443
2022-04-14,Sacramento,067,1510023,281586,278523,26484,305007,2978
2022-04-14,San Benito,069,59416,12914,12926,513,13439,98
2022-04-14,San Bernardino,071,2135413,574226,564397,24881,589278,6948
2022-04-14,San Diego,073,3302833,754816,756165,52994,809159,5229
2022-04-14,San Francisco,075,870044,127408,126976,8395,135371,854
2022-04-14,San Joaquin,077,732212,166775,166645,9938,176583,2220
2022-04-14,San Luis Obispo,079,281455,52699,52698,3777,56475,476
2022-04-14,San Mateo,081,765935,123642,122652,7099,129751,699
2022-04-14,Santa Barbara,083,443738,86305,86030,4729,90759,684
2022-04-14,Santa Clara,085,1922200,314699,315296,12505,327801,2268
2022-04-14,Santa Cruz,087,273765,48523,47895,2116,50011,261
2022-04-14,Shasta,089,179085,30588,30578,6095,36673,554
2022-04-14,Sierra,091,2930,274,276,48,324,4
2022-04-14,Siskiyou,093,43540,4453,4444,2729,7173,80
2022-04-14,Solano,095,438530,81923,81781,5605,87386,447
2022-04-14,Sonoma,097,501317,84353,84172,2713,86885,485
2022-04-14,Stanislaus,099,539301,117716,117567,17613,135180,1619
2022-04-14,Sutter,101,95872,20512,20621,2081,22702,224
2022-04-14,Tehama,103,63373,12041,12061,2581,14642,199
2022-04-14,Trinity,105,12862,1183,1178,287,1465,20
2022-04-14,Tulare,107,460477,106396,105757,27607,133364,1428
2022-04-14,Tuolumne,109,53932,12693,12640,561,13201,180
2022-04-14,Ventura,111,848112,173916,173665,9432,183097,1474
2022-04-14,Yolo,113,214977,37351,36752,3071,39823,311
2022-04-14,Yuba,115,75493,15865,15857,1200,17057,121
2022-04-13,Alameda,001,1643700,259105,257440,13981,271421,1833
2022-04-13,Alpine,003,1148,124,124,1,125,0
2022-04-13,Amador,005,37829,8536,8490,646,9136,86
2022-04-13,Butte,007,227075,33234,33044,6969,40013,402
2022-04-13,Calaveras,009,45235,7284,7270,349,7619,119
2022-04-13,Colusa,011,21464,3449,3451,1048,4499,21
2022-04-13,Contra Costa,013,1133247,191651,189471,13328,202799,1298
2022-04-13,Del Norte,015,27424,5826,5812,184,5996,50
2022-04-13,El Dorado,017,186661,26849,26794,3211,30005,208
2022-04-13,Fresno,019,978130,231551,231325,23703,255028,2738
2022-04-13,Glenn,021,27897,4990,4989,1604,6593,48
2022-04-13,Humboldt,023,135768,16956,16922,2967,19889,143
2022-04-13,Imperial,025,180216,55415,55353,10564,65917,910
2022-04-13,Inyo,027,18085,4082,4074,487,4561,56
2022-04-13,Kern,029,883053,192028,191859,45763,237622,2249
2022-04-13,Kings,031,150075,51538,51535,3508,55043,443
2022-04-13,Lake,033,64148,10729,10695,888,11583,134
2022-04-13,Lassen,035,31185,8963,8949,874,9823,65
2022-04-13,Los Angeles,037,10098052,2723892,2715722,124184,2839906,31578
2022-04-13,Madera,039,155013,37302,37361,6029,43390,354
2022-04-13,Marin,041,260295,33967,33747,2474,36221,288
2022-04-13,Mariposa,043,17540,2410,2402,201,2603,29
2022-04-13,Mendocino,045,87422,13122,13101,3033,16134,120
2022-04-13,Merced,047,269075,62291,62276,8640,70916,811
2022-04-13,Modoc,049,8938,739,743,252,995,8
2022-04-13,Mono,051,14174,2978,2971,124,3095,6
2022-04-13,Monterey,053,433212,79577,79179,13743,92922,727
2022-04-13,Napa,055,140530,26022,25892,987,26879,143
2022-04-13,Nevada,057,99092,16017,16002,1199,17201,123
2022-04-13,Orange,059,3164182,548735,547783,41479,589262,6935
2022-04-13,Placer,061,380077,62993,62851,7355,70206,615
2022-04-13,Plumas,063,18699,2978,2923,366,3289,13
2022-04-13,Riverside,065,2383286,592509,591659,27865,619524,6437
2022-04-13,Sacramento,067,1510023,281500,277866,26481,304347,2974
2022-04-13,San Benito,069,59416,12908,12927,513,13440,98
2022-04-13,San Bernardino,071,2135413,574080,563709,24876,588585,6905
2022-04-13,San Diego,073,3302833,754530,755584,52961,808545,5223
2022-04-13,San Francisco,075,870044,127239,126608,8375,134983,850
2022-04-13,San Joaquin,077,732212,166740,166654,9936,176590,2219
2022-04-13,San Luis Obispo,079,281455,52675,52660,3777,56437,476
2022-04-13,San Mateo,081,765935,123491,122167,7075,129242,699
2022-04-13,Santa Barbara,083,443738,86267,85938,4724,90662,684
2022-04-13,Santa Clara,085,1922200,314430,314863,12488,327351,2267
2022-04-13,Santa Cruz,087,273765,48468,47765,2115,49880,260
2022-04-13,Shasta,089,179085,30586,30569,6095,36664,551
2022-04-13,Sierra,091,2930,274,276,48,324,4
2022-04-13,Siskiyou,093,43540,4452,4444,2728,7172,80
2022-04-13,Solano,095,438530,81885,81843,5602,87445,448
2022-04-13,Sonoma,097,501317,84283,84033,2699,86732,485
2022-04-13,Stanislaus,099,539301,117698,117573,17608,135181,1577
2022-04-13,Sutter,101,95872,20508,20610,2081,22691,223
2022-04-13,Tehama,103,63373,12040,12062,2580,14642,200
2022-04-13,Trinity,105,12862,1183,1177,287,1464,20
2022-04-13,Tulare,107,460477,106388,105519,27602,133121,1426
2022-04-13,Tuolumne,109,53932,12687,12639,561,13200,180
2022-04-13,Ventura,111,848112,173859,173558,9426,182984,1474
2022-04-13,Yolo,113,214977,37312,36684,3069,39753,311
2022-04-13,Yuba,115,75493,15861,15851,1200,17051,121
2022-04-12,Alameda,001,1643700,258863,257440,13972,271412,1833
2022-04-12,Alpine,003,1148,124,124,1,125,0
2022-04-12,Amador,005,37829,8535,8490,646,9136,86
2022-04-12,Butte,007,227075,33222,33044,6962,40006,402
2022-04-12,Calaveras,009,45235,7280,7270,348,7618,119
2022-04-12,Colusa,011,21464,3449,3451,1048,4499,21
2022-04-12,Contra Costa,013,1133247,191496,189471,13314,202785,1298
2022-04-12,Del Norte,015,27424,5823,5812,184,5996,50
2022-04-12,El Dorado,017,186661,26837,26794,3211,30005,208
2022-04-12,Fresno,019,978130,231521,231325,23696,255021,2738
2022-04-12,Glenn,021,27897,4990,4989,1604,6593,48
2022-04-12,Humboldt,023,135768,16948,16922,2965,19887,143
2022-04-12,Imperial,025,180216,55411,55353,10555,65908,910
2022-04-12,Inyo,027,18085,4082,4074,487,4561,56
2022-04-12,Kern,029,883053,192008,191859,45754,237613,2249
2022-04-12,Kings,031,150075,51530,51535,3506,55041,443
2022-04-12,Lake,033,64148,10725,10695,887,11582,134
2022-04-12,Lassen,035,31185,8963,8949,874,9823,65
2022-04-12,Los Angeles,037,10098052,2722644,2715722,124084,2839806,31578
2022-04-12,Madera,039,155013,37301,37361,6029,43390,354
2022-04-12,Marin,041,260295,33922,33747,2447,36194,288
2022-04-12,Mariposa,043,17540,2410,2402,201,2603,29
2022-04-12,Mendocino,045,87422,13114,13101,3027,16128,120
2022-04-12,Merced,047,269075,62277,62276,8638,70914,811
2022-04-12,Modoc,049,8938,739,743,251,994,8
2022-04-12,Mono,051,14174,2978,2971,124,3095,6
2022-04-12,Monterey,053,433212,79553,79179,13736,92915,727
2022-04-12,Napa,055,140530,25998,25892,977,26869,143
2022-04-12,Nevada,057,99092,16014,16002,1198,17200,123
2022-04-12,Orange,059,3164182,548484,547783,41446,589229,6935
2022-04-12,Placer,061,380077,62970,62851,7350,70201,615
2022-04-12,Plumas,063,18699,2977,2923,366,3289,13
2022-04-12,Riverside,065,2383286,592364,591659,27845,619504,6437
2022-04-12,Sacramento,067,1510023,281385,277866,26479,304345,2974
2022-04-12,San Benito,069,59416,12903,12927,512,13439,98
2022-04-12,San Bernardino,071,2135413,573905,563709,24873,588582,6905
2022-04-12,San Diego,073,3302833,754197,755584,52919,808503,5223
2022-04-12,San Francisco,075,870044,127027,126608,8360,134968,850
2022-04-12,San Joaquin,077,732212,166710,166654,9934,176588,2219
2022-04-12,San Luis Obispo,079,281455,52641,52660,3771,56431,476
2022-04-12,San Mateo,081,765935,123335,122167,7054,129221,699
2022-04-12,Santa Barbara,083,443738,86221,85938,4720,90658,684
2022-04-12,Santa Clara,085,1922200,314139,314863,12477,327340,2267
2022-04-12,Santa Cruz,087,273765,48387,47765,2112,49877,260
2022-04-12,Shasta,089,179085,30586,30569,6094,36663,551
2022-04-12,Sierra,091,2930,274,276,48,324,4
2022-04-12,Siskiyou,093,43540,4452,4444,2726,7170,80
2022-04-12,Solano,095,438530,81845,81843,5600,87443,448
2022-04-12,Sonoma,097,501317,84224,84033,2693,86726,485
2022-04-12,Stanislaus,099,539301,117678,117573,17604,135177,1577
2022-04-12,Sutter,101,95872,20505,20610,2081,22691,223
2022-04-12,Tehama,103,63373,12038,12062,2580,14642,200
2022-04-12,Trinity,105,12862,1183,1177,287,1464,20
2022-04-12,Tulare,107,460477,106373,105519,27597,133116,1426
2022-04-12,Tuolumne,109,53932,12685,12639,559,13198,180
2022-04-12,Ventura,111,848112,173811,173558,9420,182978,1474
2022-04-12,Yolo,113,214977,37272,36684,3063,39747,311
2022-04-12,Yuba,115,75493,15856,15851,1200,17051,121
2022-04-11,Alameda,001,1643700,258572,256649,13955,270604,1826
2022-04-11,Alpine,003,1148,124,124,1,125,0
2022-04-11,Amador,005,37829,8534,8489,646,9135,86
2022-04-11,Butte,007,227075,33209,33031,6958,39989,399
2022-04-11,Calaveras,009,45235,7277,7260,348,7608,119
2022-04-11,Colusa,011,21464,3447,3449,1048,4497,21
2022-04-11,Contra Costa,013,1133247,191329,189154,13297,202451,1296
2022-04-11,Del Norte,015,27424,5822,5811,184,5995,50
2022-04-11,El Dorado,017,186661,26824,26757,3210,29967,207
2022-04-11,Fresno,019,978130,231500,231090,23695,254785,2731
2022-04-11,Glenn,021,27897,4989,4988,1603,6591,47
2022-04-11,Humboldt,023,135768,16933,16913,2963,19876,141
2022-04-11,Imperial,025,180216,55406,55267,10553,65820,910
2022-04-11,Inyo,027,18085,4082,4071,487,4558,56
2022-04-11,Kern,029,883053,191983,191542,45752,237294,2244
2022-04-11,Kings,031,150075,51526,51519,3506,55025,443
2022-04-11,Lake,033,64148,10724,10690,886,11576,134
2022-04-11,Lassen,035,31185,8963,8948,874,9822,65
2022-04-11,Los Angeles,037,10098052,2721384,2709735,124012,2833747,31509
2022-04-11,Madera,039,155013,37294,37356,6029,43385,354
2022-04-11,Marin,041,260295,33866,33648,2428,36076,288
2022-04-11,Mariposa,043,17540,2409,2394,201,2595,29
2022-04-11,Mendocino,045,87422,13110,13087,3025,16112,120
2022-04-11,Merced,047,269075,62268,62231,8636,70867,811
2022-04-11,Modoc,049,8938,739,743,251,994,8
2022-04-11,Mono,051,14174,2977,2967,123,3090,6
2022-04-11,Monterey,053,433212,79533,79103,13727,92830,727
2022-04-11,Napa,055,140530,25981,25824,975,26799,144
2022-04-11,Nevada,057,99092,16010,15976,1198,17174,123
2022-04-11,Orange,059,3164182,548279,546983,41412,588395,6912
2022-04-11,Placer,061,380077,62948,62831,7349,70180,616
2022-04-11,Plumas,063,18699,2975,2887,366,3253,13
2022-04-11,Riverside,065,2383286,592237,591268,27828,619096,6429
2022-04-11,Sacramento,067,1510023,281285,277125,26477,303602,2972
2022-04-11,San Benito,069,59416,12902,12917,512,13429,98
2022-04-11,San Bernardino,071,2135413,573754,562571,24865,587436,6892
2022-04-11,San Diego,073,3302833,753870,754281,52880,807161,5210
2022-04-11,San Francisco,075,870044,126795,125963,8348,134311,844
2022-04-11,San Joaquin,077,732212,166672,166547,9928,176475,2212
2022-04-11,San Luis Obispo,079,281455,52618,52609,3770,56379,476
2022-04-11,San Mateo,081,765935,123149,121514,7040,128554,698
2022-04-11,Santa Barbara,083,443738,86172,85754,4715,90469,680
2022-04-11,Santa Clara,085,1922200,313795,313965,12462,326427,2266
2022-04-11,Santa Cruz,087,273765,48292,47624,2109,49733,259
2022-04-11,Shasta,089,179085,30581,30586,6093,36679,549
2022-04-11,Sierra,091,2930,274,272,48,320,4
2022-04-11,Siskiyou,093,43540,4452,4444,2724,7168,80
2022-04-11,Solano,095,438530,81817,81886,5599,87485,448
2022-04-11,Sonoma,097,501317,84156,83600,2681,86281,485
2022-04-11,Stanislaus,099,539301,117644,117528,17596,135124,1578
2022-04-11,Sutter,101,95872,20502,20591,2081,22672,223
2022-04-11,Tehama,103,63373,12037,12059,2579,14638,201
2022-04-11,Trinity,105,12862,1183,1177,287,1464,20
2022-04-11,Tulare,107,460477,106362,105278,27589,132867,1415
2022-04-11,Tuolumne,109,53932,12682,12632,559,13191,180
2022-04-11,Ventura,111,848112,173752,173343,9419,182762,1467
2022-04-11,Yolo,113,214977,37235,36587,3061,39648,312
2022-04-11,Yuba,115,75493,15853,15848,1199,17047,121
2022-04-10,Alameda,001,1643700,258238,256649,13944,270593,1826
2022-04-10,Alpine,003,1148,124,124,1,125,0
2022-04-10,Amador,005,37829,8532,8489,646,9135,86
2022-04-10,Butte,007,227075,33205,33031,6954,39985,399
2022-04-10,Calaveras,009,45235,7274,7260,348,7608,119
2022-04-10,Colusa,011,21464,3446,3449,1048,4497,21
2022-04-10,Contra Costa,013,1133247,191169,189154,13278,202432,1296
2022-04-10,Del Norte,015,27424,5819,5811,184,5995,50
2022-04-10,El Dorado,017,186661,26817,26757,3208,29965,207
2022-04-10,Fresno,019,978130,231462,231090,23693,254783,2731
2022-04-10,Glenn,021,27897,4989,4988,1603,6591,47
2022-04-10,Humboldt,023,135768,16923,16913,2961,19874,141
2022-04-10,Imperial,025,180216,55402,55267,10551,65818,910
2022-04-10,Inyo,027,18085,4082,4071,485,4556,56
2022-04-10,Kern,029,883053,191964,191542,45747,237289,2244
2022-04-10,Kings,031,150075,51524,51519,3506,55025,443
2022-04-10,Lake,033,64148,10720,10690,884,11574,134
2022-04-10,Lassen,035,31185,8962,8948,874,9822,65
2022-04-10,Los Angeles,037,10098052,2720056,2709735,123921,2833656,31509
2022-04-10,Madera,039,155013,37289,37356,6028,43384,354
2022-04-10,Marin,041,260295,33826,33648,2399,36047,288
2022-04-10,Mariposa,043,17540,2407,2394,201,2595,29
2022-04-10,Mendocino,045,87422,13102,13087,3024,16111,120
2022-04-10,Merced,047,269075,62256,62231,8634,70865,811
2022-04-10,Modoc,049,8938,739,743,251,994,8
2022-04-10,Mono,051,14174,2974,2967,123,3090,6
2022-04-10,Monterey,053,433212,79517,79103,13717,92820,727
2022-04-10,Napa,055,140530,25959,25824,973,26797,144
2022-04-10,Nevada,057,99092,15993,15976,1198,17174,123
2022-04-10,Orange,059,3164182,548029,546983,41374,588357,6912
2022-04-10,Placer,061,380077,62914,62831,7348,70179,616
2022-04-10,Plumas,063,18699,2973,2887,366,3253,13
2022-04-10,Riverside,065,2383286,592085,591268,27815,619083,6429
2022-04-10,Sacramento,067,1510023,281187,277125,26467,303592,2972
2022-04-10,San Benito,069,59416,12899,12917,512,13429,98
2022-04-10,San Bernardino,071,2135413,573522,562571,24856,587427,6892
2022-04-10,San Diego,073,3302833,753544,754281,52835,807116,5210
2022-04-10,San Francisco,075,870044,126556,125963,8332,134295,844
2022-04-10,San Joaquin,077,732212,166625,166547,9921,176468,2212
2022-04-10,San Luis Obispo,079,281455,52584,52609,3767,56376,476
2022-04-10,San Mateo,081,765935,122982,121514,7024,128538,698
2022-04-10,Santa Barbara,083,443738,86088,85754,4705,90459,680
2022-04-10,Santa Clara,085,1922200,313466,313965,12448,326413,2266
2022-04-10,Santa Cruz,087,273765,48203,47624,2108,49732,259
2022-04-10,Shasta,089,179085,30574,30586,6093,36679,549
2022-04-10,Sierra,091,2930,274,272,48,320,4
2022-04-10,Siskiyou,093,43540,4452,4444,2723,7167,80
2022-04-10,Solano,095,438530,81770,81886,5594,87480,448
2022-04-10,Sonoma,097,501317,84055,83600,2674,86274,485
2022-04-10,Stanislaus,099,539301,117621,117528,17589,135117,1578
2022-04-10,Sutter,101,95872,20498,20591,2077,22668,223
2022-04-10,Tehama,103,63373,12035,12059,2579,14638,201
2022-04-10,Trinity,105,12862,1183,1177,287,1464,20
2022-04-10,Tulare,107,460477,106348,105278,27582,132860,1415
2022-04-10,Tuolumne,109,53932,12675,12632,559,13191,180
2022-04-10,Ventura,111,848112,173673,173343,9414,182757,1467
2022-04-10,Yolo,113,214977,37204,36587,3056,39643,312
2022-04-10,Yuba,115,75493,15852,15848,1199,17047,121
2022-04-09,Alameda,001,1643700,258062,256649,13939,270588,1826
2022-04-09,Alpine,003,1148,124,124,1,125,0
2022-04-09,Amador,005,37829,8532,8489,645,9134,86
2022-04-09,Butte,007,227075,33202,33031,6954,39985,399
2022-04-09,Calaveras,009,45235,7273,7260,348,7608,119
2022-04-09,Colusa,011,21464,3445,3449,1048,4497,21
2022-04-09,Contra Costa,013,1133247,191073,189154,13271,202425,1296
2022-04-09,Del Norte,015,27424,5818,5811,184,5995,50
2022-04-09,El Dorado,017,186661,26810,26757,3208,29965,207
2022-04-09,Fresno,019,978130,231441,231090,23693,254783,2731
2022-04-09,Glenn,021,27897,4989,4988,1603,6591,47
2022-04-09,Humboldt,023,135768,16916,16913,2961,19874,141
2022-04-09,Imperial,025,180216,55397,55267,10551,65818,910
2022-04-09,Inyo,027,18085,4082,4071,485,4556,56
2022-04-09,Kern,029,883053,191955,191542,45742,237284,2244
2022-04-09,Kings,031,150075,51518,51519,3506,55025,443
2022-04-09,Lake,033,64148,10718,10690,884,11574,134
2022-04-09,Lassen,035,31185,8962,8948,874,9822,65
2022-04-09,Los Angeles,037,10098052,2719378,2709735,123848,2833583,31509
2022-04-09,Madera,039,155013,37286,37356,6028,43384,354
2022-04-09,Marin,041,260295,33793,33648,2356,36004,288
2022-04-09,Mariposa,043,17540,2407,2394,201,2595,29
2022-04-09,Mendocino,045,87422,13100,13087,3024,16111,120
2022-04-09,Merced,047,269075,62241,62231,8632,70863,811
2022-04-09,Modoc,049,8938,739,743,251,994,8
2022-04-09,Mono,051,14174,2973,2967,122,3089,6
2022-04-09,Monterey,053,433212,79508,79103,13713,92816,727
2022-04-09,Napa,055,140530,25934,25824,973,26797,144
2022-04-09,Nevada,057,99092,15990,15976,1198,17174,123
2022-04-09,Orange,059,3164182,547907,546983,41353,588336,6912
2022-04-09,Placer,061,380077,62899,62831,7346,70177,616
2022-04-09,Plumas,063,18699,2973,2887,366,3253,13
2022-04-09,Riverside,065,2383286,591994,591268,27805,619073,6429
2022-04-09,Sacramento,067,1510023,281140,277125,26465,303590,2972
2022-04-09,San Benito,069,59416,12898,12917,511,13428,98
2022-04-09,San Bernardino,071,2135413,573456,562571,24853,587424,6892
2022-04-09,San Diego,073,3302833,753396,754281,52821,807102,5210
2022-04-09,San Francisco,075,870044,126432,125963,8325,134288,844
2022-04-09,San Joaquin,077,732212,166609,166547,9918,176465,2212
2022-04-09,San Luis Obispo,079,281455,52584,52609,3764,56373,476
2022-04-09,San Mateo,081,765935,122892,121514,7017,128531,698
2022-04-09,Santa Barbara,083,443738,86055,85754,4705,90459,680
2022-04-09,Santa Clara,085,1922200,313270,313965,12445,326410,2266
2022-04-09,Santa Cruz,087,273765,48170,47624,2106,49730,259
2022-04-09,Shasta,089,179085,30572,30586,6093,36679,549
2022-04-09,Sierra,091,2930,274,272,48,320,4
2022-04-09,Siskiyou,093,43540,4451,4444,2722,7166,80
2022-04-09,Solano,095,438530,81752,81886,5592,87478,448
2022-04-09,Sonoma,097,501317,84016,83600,2670,86270,485
2022-04-09,Stanislaus,099,539301,117608,117528,17587,135115,1578
2022-04-09,Sutter,101,95872,20498,20591,2077,22668,223
2022-04-09,Tehama,103,63373,12035,12059,2579,14638,201
2022-04-09,Trinity,105,12862,1183,1177,287,1464,20
2022-04-09,Tulare,107,460477,106345,105278,27580,132858,1415
2022-04-09,Tuolumne,109,53932,12673,12632,559,13191,180
2022-04-09,Ventura,111,848112,173636,173343,9411,182754,1467
2022-04-09,Yolo,113,214977,37185,36587,3056,39643,312
2022-04-09,Yuba,115,75493,15851,15848,1199,17047,121
2022-04-08,Alameda,001,1643700,257905,256649,13933,270582,1826
2022-04-08,Alpine,003,1148,124,124,1,125,0
2022-04-08,Amador,005,37829,8530,8489,644,9133,86
2022-04-08,Butte,007,227075,33196,33031,6951,39982,399
2022-04-08,Calaveras,009,45235,7271,7260,348,7608,119
2022-04-08,Colusa,011,21464,3445,3449,1048,4497,21
2022-04-08,Contra Costa,013,1133247,190995,189154,13258,202412,1296
2022-04-08,Del Norte,015,27424,5816,5811,184,5995,50
2022-04-08,El Dorado,017,186661,26808,26757,3208,29965,207
2022-04-08,Fresno,019,978130,231421,231090,23691,254781,2731
2022-04-08,Glenn,021,27897,4989,4988,1603,6591,47
2022-04-08,Humboldt,023,135768,16912,16913,2959,19872,141
2022-04-08,Imperial,025,180216,55393,55267,10551,65818,910
2022-04-08,Inyo,027,18085,4080,4071,484,4555,56
2022-04-08,Kern,029,883053,191936,191542,45741,237283,2244
2022-04-08,Kings,031,150075,51513,51519,3506,55025,443
2022-04-08,Lake,033,64148,10718,10690,884,11574,134
2022-04-08,Lassen,035,31185,8962,8948,874,9822,65
2022-04-08,Los Angeles,037,10098052,2718749,2709735,123793,2833528,31509
2022-04-08,Madera,039,155013,37284,37356,6027,43383,354
2022-04-08,Marin,041,260295,33773,33648,2340,35988,288
2022-04-08,Mariposa,043,17540,2407,2394,200,2594,29
2022-04-08,Mendocino,045,87422,13098,13087,3024,16111,120
2022-04-08,Merced,047,269075,62234,62231,8630,70861,811
2022-04-08,Modoc,049,8938,739,743,251,994,8
2022-04-08,Mono,051,14174,2971,2967,122,3089,6
2022-04-08,Monterey,053,433212,79498,79103,13712,92815,727
2022-04-08,Napa,055,140530,25922,25824,965,26789,144
2022-04-08,Nevada,057,99092,15987,15976,1198,17174,123
2022-04-08,Orange,059,3164182,547788,546983,41339,588322,6912
2022-04-08,Placer,061,380077,62881,62831,7344,70175,616
2022-04-08,Plumas,063,18699,2970,2887,366,3253,13
2022-04-08,Riverside,065,2383286,591918,591268,27802,619070,6429
2022-04-08,Sacramento,067,1510023,281094,277125,26464,303589,2972
2022-04-08,San Benito,069,59416,12898,12917,511,13428,98
2022-04-08,San Bernardino,071,2135413,573403,562571,24850,587421,6892
2022-04-08,San Diego,073,3302833,753226,754281,52811,807092,5210
2022-04-08,San Francisco,075,870044,126336,125963,8320,134283,844
2022-04-08,San Joaquin,077,732212,166591,166547,9916,176463,2212
2022-04-08,San Luis Obispo,079,281455,52579,52609,3764,56373,476
2022-04-08,San Mateo,081,765935,122786,121514,7012,128526,698
2022-04-08,Santa Barbara,083,443738,86034,85754,4705,90459,680
2022-04-08,Santa Clara,085,1922200,313084,313965,12438,326403,2266
2022-04-08,Santa Cruz,087,273765,48153,47624,2103,49727,259
2022-04-08,Shasta,089,179085,30569,30586,6093,36679,549
2022-04-08,Sierra,091,2930,274,272,48,320,4
2022-04-08,Siskiyou,093,43540,4451,4444,2722,7166,80
2022-04-08,Solano,095,438530,81732,81886,5591,87477,448
2022-04-08,Sonoma,097,501317,83965,83600,2666,86266,485
2022-04-08,Stanislaus,099,539301,117593,117528,17586,135114,1578
2022-04-08,Sutter,101,95872,20498,20591,2077,22668,223
2022-04-08,Tehama,103,63373,12035,12059,2579,14638,201
2022-04-08,Trinity,105,12862,1183,1177,287,1464,20
2022-04-08,Tulare,107,460477,106340,105278,27576,132854,1415
2022-04-08,Tuolumne,109,53932,12672,12632,558,13190,180
2022-04-08,Ventura,111,848112,173607,173343,9409,182752,1467
2022-04-08,Yolo,113,214977,37176,36587,3055,39642,312
2022-04-08,Yuba,115,75493,15850,15848,1199,17047,121
2022-04-07,Alameda,001,1643700,257712,256649,13926,270575,1826
2022-04-07,Alpine,003,1148,124,124,1,125,0
2022-04-07,Amador,005,37829,8529,8489,641,9130,86
2022-04-07,Butte,007,227075,33192,33031,6950,39981,399
2022-04-07,Calaveras,009,45235,7269,7260,348,7608,119
2022-04-07,Colusa,011,21464,3444,3449,1048,4497,21
2022-04-07,Contra Costa,013,1133247,190875,189154,13246,202400,1296
2022-04-07,Del Norte,015,27424,5815,5811,184,5995,50
2022-04-07,El Dorado,017,186661,26796,26757,3206,29963,207
2022-04-07,Fresno,019,978130,231395,231090,23690,254780,2731
2022-04-07,Glenn,021,27897,4987,4988,1602,6590,47
2022-04-07,Humboldt,023,135768,16905,16913,2957,19870,141
2022-04-07,Imperial,025,180216,55391,55267,10549,65816,910
2022-04-07,Inyo,027,18085,4080,4071,484,4555,56
2022-04-07,Kern,029,883053,191912,191542,45738,237280,2244
2022-04-07,Kings,031,150075,51505,51519,3506,55025,443
2022-04-07,Lake,033,64148,10714,10690,884,11574,134
2022-04-07,Lassen,035,31185,8962,8948,874,9822,65
2022-04-07,Los Angeles,037,10098052,2717831,2709735,123719,2833454,31509
2022-04-07,Madera,039,155013,37279,37356,6027,43383,354
2022-04-07,Marin,041,260295,33754,33648,2321,35969,288
2022-04-07,Mariposa,043,17540,2404,2394,199,2593,29
2022-04-07,Mendocino,045,87422,13094,13087,3023,16110,120
2022-04-07,Merced,047,269075,62225,62231,8626,70857,811
2022-04-07,Modoc,049,8938,739,743,251,994,8
2022-04-07,Mono,051,14174,2970,2967,122,3089,6
2022-04-07,Monterey,053,433212,79476,79103,13708,92811,727
2022-04-07,Napa,055,140530,25906,25824,961,26785,144
2022-04-07,Nevada,057,99092,15979,15976,1197,17173,123
2022-04-07,Orange,059,3164182,547632,546983,41310,588293,6912
2022-04-07,Placer,061,380077,62864,62831,7341,70172,616
2022-04-07,Plumas,063,18699,2970,2887,366,3253,13
2022-04-07,Riverside,065,2383286,591816,591268,27788,619056,6429
2022-04-07,Sacramento,067,1510023,281028,277125,26457,303582,2972
2022-04-07,San Benito,069,59416,12897,12917,511,13428,98
2022-04-07,San Bernardino,071,2135413,573243,562571,24837,587408,6892
2022-04-07,San Diego,073,3302833,752958,754281,52779,807060,5210
2022-04-07,San Francisco,075,870044,126179,125963,8305,134268,844
2022-04-07,San Joaquin,077,732212,166551,166547,9913,176460,2212
2022-04-07,San Luis Obispo,079,281455,52561,52609,3762,56371,476
2022-04-07,San Mateo,081,765935,122664,121514,6995,128509,698
2022-04-07,Santa Barbara,083,443738,85990,85754,4703,90457,680
2022-04-07,Santa Clara,085,1922200,312861,313965,12426,326391,2266
2022-04-07,Santa Cruz,087,273765,48134,47624,2099,49723,259
2022-04-07,Shasta,089,179085,30567,30586,6093,36679,549
2022-04-07,Sierra,091,2930,274,272,48,320,4
2022-04-07,Siskiyou,093,43540,4451,4444,2721,7165,80
2022-04-07,Solano,095,438530,81702,81886,5591,87477,448
2022-04-07,Sonoma,097,501317,83922,83600,2660,86260,485
2022-04-07,Stanislaus,099,539301,117571,117528,17583,135111,1578
2022-04-07,Sutter,101,95872,20494,20591,2076,22667,223
2022-04-07,Tehama,103,63373,12033,12059,2579,14638,201
2022-04-07,Trinity,105,12862,1183,1177,287,1464,20
2022-04-07,Tulare,107,460477,106334,105278,27575,132853,1415
2022-04-07,Tuolumne,109,53932,12670,12632,557,13189,180
2022-04-07,Ventura,111,848112,173578,173343,9407,182750,1467
2022-04-07,Yolo,113,214977,37157,36587,3055,39642,312
2022-04-07,Yuba,115,75493,15848,15848,1199,17047,121
2022-04-06,Alameda,001,1643700,257526,256143,13919,270062,1814
2022-04-06,Alpine,003,1148,124,124,1,125,0
2022-04-06,Amador,005,37829,8528,8488,641,9129,86
2022-04-06,Butte,007,227075,33187,32997,6948,39945,396
2022-04-06,Calaveras,009,45235,7267,7258,348,7606,120
2022-04-06,Colusa,011,21464,3444,3447,1048,4495,21
2022-04-06,Contra Costa,013,1133247,190808,188850,13231,202081,1296
2022-04-06,Del Norte,015,27424,5815,5809,184,5993,50
2022-04-06,El Dorado,017,186661,26793,26744,3206,29950,205
2022-04-06,Fresno,019,978130,231360,230942,23686,254628,2725
2022-04-06,Glenn,021,27897,4987,4986,1601,6587,47
2022-04-06,Humboldt,023,135768,16901,16904,2956,19860,140
2022-04-06,Imperial,025,180216,55385,55294,10549,65843,908
2022-04-06,Inyo,027,18085,4079,4068,482,4550,56
2022-04-06,Kern,029,883053,191890,191449,45736,237185,2234
2022-04-06,Kings,031,150075,51504,51491,3505,54996,443
2022-04-06,Lake,033,64148,10710,10679,884,11563,136
2022-04-06,Lassen,035,31185,8962,8945,874,9819,65
2022-04-06,Los Angeles,037,10098052,2716781,2707306,123652,2830958,31465
2022-04-06,Madera,039,155013,37275,37349,6027,43376,354
2022-04-06,Marin,041,260295,33734,33566,2313,35879,288
2022-04-06,Mariposa,043,17540,2403,2392,199,2591,29
2022-04-06,Mendocino,045,87422,13090,13074,3022,16096,119
2022-04-06,Merced,047,269075,62216,62195,8623,70818,810
2022-04-06,Modoc,049,8938,739,741,251,992,8
2022-04-06,Mono,051,14174,2969,2967,122,3089,6
2022-04-06,Monterey,053,433212,79463,79019,13700,92719,727
2022-04-06,Napa,055,140530,25887,25790,957,26747,143
2022-04-06,Nevada,057,99092,15977,15974,1197,17171,123
2022-04-06,Orange,059,3164182,547464,546491,41287,587778,6887
2022-04-06,Placer,061,380077,62858,62787,7340,70127,615
2022-04-06,Plumas,063,18699,2970,2850,366,3216,13
2022-04-06,Riverside,065,2383286,591720,590826,27783,618609,6424
2022-04-06,Sacramento,067,1510023,280950,276567,26453,303020,2953
2022-04-06,San Benito,069,59416,12896,12908,511,13419,98
2022-04-06,San Bernardino,071,2135413,573109,561648,24835,586483,6883
2022-04-06,San Diego,073,3302833,752663,753402,52740,806142,5192
2022-04-06,San Francisco,075,870044,126020,125536,8299,133835,843
2022-04-06,San Joaquin,077,732212,166519,166415,9910,176325,2207
2022-04-06,San Luis Obispo,079,281455,52538,52557,3760,56317,475
2022-04-06,San Mateo,081,765935,122556,121041,6983,128024,693
2022-04-06,Santa Barbara,083,443738,85950,85630,4699,90329,679
2022-04-06,Santa Clara,085,1922200,312664,313278,12406,325684,2265
2022-04-06,Santa Cruz,087,273765,48080,47446,2094,49540,259
2022-04-06,Shasta,089,179085,30566,30565,6093,36658,529
2022-04-06,Sierra,091,2930,274,272,48,320,4
2022-04-06,Siskiyou,093,43540,4451,4442,2721,7163,80
2022-04-06,Solano,095,438530,81668,81789,5586,87375,447
2022-04-06,Sonoma,097,501317,83858,83361,2655,86016,485
2022-04-06,Stanislaus,099,539301,117555,117534,17577,135111,1578
2022-04-06,Sutter,101,95872,20489,20581,2076,22657,222
2022-04-06,Tehama,103,63373,12032,12049,2579,14628,198
2022-04-06,Trinity,105,12862,1183,1173,287,1460,20
2022-04-06,Tulare,107,460477,106328,104826,27570,132396,1414
2022-04-06,Tuolumne,109,53932,12668,12621,557,13178,180
2022-04-06,Ventura,111,848112,173525,173179,9402,182581,1460
2022-04-06,Yolo,113,214977,37132,36393,3054,39447,314
2022-04-06,Yuba,115,75493,15843,15839,1199,17038,121
2022-04-05,Alameda,001,1643700,257314,256143,13910,270053,1814
2022-04-05,Alpine,003,1148,124,124,1,125,0
2022-04-05,Amador,005,37829,8526,8488,641,9129,86
2022-04-05,Butte,007,227075,33182,32997,6945,39942,396
2022-04-05,Calaveras,009,45235,7263,7258,348,7606,120
2022-04-05,Colusa,011,21464,3442,3447,1047,4494,21
2022-04-05,Contra Costa,013,1133247,190712,188850,13224,202074,1296
2022-04-05,Del Norte,015,27424,5813,5809,184,5993,50
2022-04-05,El Dorado,017,186661,26781,26744,3206,29950,205
2022-04-05,Fresno,019,978130,231324,230942,23678,254620,2725
2022-04-05,Glenn,021,27897,4987,4986,1600,6586,47
2022-04-05,Humboldt,023,135768,16895,16904,2956,19860,140
2022-04-05,Imperial,025,180216,55383,55294,10549,65843,908
2022-04-05,Inyo,027,18085,4078,4068,481,4549,56
2022-04-05,Kern,029,883053,191870,191449,45733,237182,2234
2022-04-05,Kings,031,150075,51501,51491,3505,54996,443
2022-04-05,Lake,033,64148,10707,10679,884,11563,136
2022-04-05,Lassen,035,31185,8962,8945,874,9819,65
2022-04-05,Los Angeles,037,10098052,2715721,2707306,123578,2830884,31465
2022-04-05,Madera,039,155013,37268,37349,6025,43374,354
2022-04-05,Marin,041,260295,33679,33566,2298,35864,288
2022-04-05,Mariposa,043,17540,2403,2392,199,2591,29
2022-04-05,Mendocino,045,87422,13084,13074,3021,16095,119
2022-04-05,Merced,047,269075,62205,62195,8618,70813,810
2022-04-05,Modoc,049,8938,739,741,251,992,8
2022-04-05,Mono,051,14174,2968,2967,122,3089,6
2022-04-05,Monterey,053,433212,79440,79019,13689,92708,727
2022-04-05,Napa,055,140530,25878,25790,952,26742,143
2022-04-05,Nevada,057,99092,15969,15974,1197,17171,123
2022-04-05,Orange,059,3164182,547283,546491,41258,587749,6887
2022-04-05,Placer,061,380077,62832,62787,7340,70127,615
2022-04-05,Plumas,063,18699,2970,2850,366,3216,13
2022-04-05,Riverside,065,2383286,591600,590826,27771,618597,6424
2022-04-05,Sacramento,067,1510023,280871,276567,26448,303015,2953
2022-04-05,San Benito,069,59416,12889,12908,511,13419,98
2022-04-05,San Bernardino,071,2135413,572979,561648,24825,586473,6883
2022-04-05,San Diego,073,3302833,752355,753402,52696,806098,5192
2022-04-05,San Francisco,075,870044,125817,125536,8291,133827,843
2022-04-05,San Joaquin,077,732212,166477,166415,9907,176322,2207
2022-04-05,San Luis Obispo,079,281455,52521,52557,3755,56312,475
2022-04-05,San Mateo,081,765935,122440,121041,6972,128013,693
2022-04-05,Santa Barbara,083,443738,85913,85630,4698,90328,679
2022-04-05,Santa Clara,085,1922200,312404,313278,12393,325671,2265
2022-04-05,Santa Cruz,087,273765,48013,47446,2091,49537,259
2022-04-05,Shasta,089,179085,30566,30565,6091,36656,529
2022-04-05,Sierra,091,2930,274,272,48,320,4
2022-04-05,Siskiyou,093,43540,4451,4442,2721,7163,80
2022-04-05,Solano,095,438530,81617,81789,5583,87372,447
2022-04-05,Sonoma,097,501317,83794,83361,2646,86007,485
2022-04-05,Stanislaus,099,539301,117541,117534,17568,135102,1578
2022-04-05,Sutter,101,95872,20485,20581,2075,22656,222
2022-04-05,Tehama,103,63373,12030,12049,2578,14627,198
2022-04-05,Trinity,105,12862,1183,1173,287,1460,20
2022-04-05,Tulare,107,460477,106318,104826,27567,132393,1414
2022-04-05,Tuolumne,109,53932,12667,12621,557,13178,180
2022-04-05,Ventura,111,848112,173469,173179,9395,182574,1460
2022-04-05,Yolo,113,214977,37117,36393,3051,39444,314
2022-04-05,Yuba,115,75493,15841,15839,1199,17038,121
2022-04-04,Alameda,001,1643700,257084,256143,13896,270039,1814
2022-04-04,Alpine,003,1148,124,124,1,125,0
2022-04-04,Amador,005,37829,8525,8488,640,9128,86
2022-04-04,Butte,007,227075,33176,32997,6942,39939,396
2022-04-04,Calaveras,009,45235,7263,7258,348,7606,120
2022-04-04,Colusa,011,21464,3441,3447,1047,4494,21
2022-04-04,Contra Costa,013,1133247,190612,188850,13216,202066,1296
2022-04-04,Del Norte,015,27424,5813,5809,184,5993,50
2022-04-04,El Dorado,017,186661,26776,26744,3206,29950,205
2022-04-04,Fresno,019,978130,231306,230942,23673,254615,2725
2022-04-04,Glenn,021,27897,4986,4986,1600,6586,47
2022-04-04,Humboldt,023,135768,16887,16904,2951,19855,140
2022-04-04,Imperial,025,180216,55378,55294,10549,65843,908
2022-04-04,Inyo,027,18085,4078,4068,479,4547,56
2022-04-04,Kern,029,883053,191848,191449,45728,237177,2234
2022-04-04,Kings,031,150075,51495,51491,3505,54996,443
2022-04-04,Lake,033,64148,10702,10679,884,11563,136
2022-04-04,Lassen,035,31185,8962,8945,874,9819,65
2022-04-04,Los Angeles,037,10098052,2714617,2707306,123531,2830837,31465
2022-04-04,Madera,039,155013,37264,37349,6025,43374,354
2022-04-04,Marin,041,260295,33662,33566,2289,35855,288
2022-04-04,Mariposa,043,17540,2402,2392,199,2591,29
2022-04-04,Mendocino,045,87422,13078,13074,3019,16093,119
2022-04-04,Merced,047,269075,62195,62195,8613,70808,810
2022-04-04,Modoc,049,8938,739,741,251,992,8
2022-04-04,Mono,051,14174,2968,2967,122,3089,6
2022-04-04,Monterey,053,433212,79424,79019,13683,92702,727
2022-04-04,Napa,055,140530,25861,25790,951,26741,143
2022-04-04,Nevada,057,99092,15965,15974,1196,17170,123
2022-04-04,Orange,059,3164182,547117,546491,41232,587723,6887
2022-04-04,Placer,061,380077,62822,62787,7339,70126,615
2022-04-04,Plumas,063,18699,2969,2850,366,3216,13
2022-04-04,Riverside,065,2383286,591509,590826,27759,618585,6424
2022-04-04,Sacramento,067,1510023,280780,276567,26440,303007,2953
2022-04-04,San Benito,069,59416,12886,12908,511,13419,98
2022-04-04,San Bernardino,071,2135413,572842,561648,24818,586466,6883
2022-04-04,San Diego,073,3302833,752036,753402,52659,806061,5192
2022-04-04,San Francisco,075,870044,125619,125536,8282,133818,843
2022-04-04,San Joaquin,077,732212,166451,166415,9904,176319,2207
2022-04-04,San Luis Obispo,079,281455,52498,52557,3753,56310,475
2022-04-04,San Mateo,081,765935,122304,121041,6958,127999,693
2022-04-04,Santa Barbara,083,443738,85868,85630,4697,90327,679
2022-04-04,Santa Clara,085,1922200,312135,313278,12381,325659,2265
2022-04-04,Santa Cruz,087,273765,47966,47446,2091,49537,259
2022-04-04,Shasta,089,179085,30563,30565,6090,36655,529
2022-04-04,Sierra,091,2930,274,272,48,320,4
2022-04-04,Siskiyou,093,43540,4451,4442,2721,7163,80
2022-04-04,Solano,095,438530,81571,81789,5580,87369,447
2022-04-04,Sonoma,097,501317,83740,83361,2639,86000,485
2022-04-04,Stanislaus,099,539301,117520,117534,17561,135095,1578
2022-04-04,Sutter,101,95872,20482,20581,2075,22656,222
2022-04-04,Tehama,103,63373,12028,12049,2578,14627,198
2022-04-04,Trinity,105,12862,1183,1173,287,1460,20
2022-04-04,Tulare,107,460477,106308,104826,27564,132390,1414
2022-04-04,Tuolumne,109,53932,12660,12621,557,13178,180
2022-04-04,Ventura,111,848112,173429,173179,9393,182572,1460
2022-04-04,Yolo,113,214977,37103,36393,3049,39442,314
2022-04-04,Yuba,115,75493,15838,15839,1199,17038,121
2022-04-03,Alameda,001,1643700,256829,255650,13894,269544,1813
2022-04-03,Alpine,003,1148,124,124,1,125,0
2022-04-03,Amador,005,37829,8524,8485,640,9125,86
2022-04-03,Butte,007,227075,33169,32981,6940,39921,396
2022-04-03,Calaveras,009,45235,7263,7254,348,7602,119
2022-04-03,Colusa,011,21464,3441,3445,1047,4492,21
2022-04-03,Contra Costa,013,1133247,190506,188658,13206,201864,1291
2022-04-03,Del Norte,015,27424,5813,5812,184,5996,50
2022-04-03,El Dorado,017,186661,26762,26732,3204,29936,200
2022-04-03,Fresno,019,978130,231274,230559,23670,254229,2722
2022-04-03,Glenn,021,27897,4986,4982,1600,6582,47
2022-04-03,Humboldt,023,135768,16882,16898,2951,19849,140
2022-04-03,Imperial,025,180216,55376,55266,10546,65812,908
2022-04-03,Inyo,027,18085,4076,4063,479,4542,56
2022-04-03,Kern,029,883053,191823,191384,45723,237107,2224
2022-04-03,Kings,031,150075,51489,51470,3503,54973,443
2022-04-03,Lake,033,64148,10700,10674,884,11558,136
2022-04-03,Lassen,035,31185,8961,8943,874,9817,65
2022-04-03,Los Angeles,037,10098052,2713424,2703576,123446,2827022,31410
2022-04-03,Madera,039,155013,37262,37333,6024,43357,354
2022-04-03,Marin,041,260295,33627,33493,2281,35774,287
2022-04-03,Mariposa,043,17540,2401,2391,199,2590,29
2022-04-03,Mendocino,045,87422,13072,13058,3018,16076,119
2022-04-03,Merced,047,269075,62180,62149,8609,70758,808
2022-04-03,Modoc,049,8938,738,741,251,992,8
2022-04-03,Mono,051,14174,2968,2967,122,3089,6
2022-04-03,Monterey,053,433212,79407,78964,13658,92622,726
2022-04-03,Napa,055,140530,25841,25757,950,26707,143
2022-04-03,Nevada,057,99092,15959,15962,1195,17157,123
2022-04-03,Orange,059,3164182,546919,546047,41207,587254,6880
2022-04-03,Placer,061,380077,62796,62740,7334,70074,614
2022-04-03,Plumas,063,18699,2968,2803,366,3169,14
2022-04-03,Riverside,065,2383286,591353,590563,27744,618307,6418
2022-04-03,Sacramento,067,1510023,280704,276218,26427,302645,2950
2022-04-03,San Benito,069,59416,12882,12901,511,13412,98
2022-04-03,San Bernardino,071,2135413,572695,561362,24815,586177,6865
2022-04-03,San Diego,073,3302833,751706,752281,52622,804903,5178
2022-04-03,San Francisco,075,870044,125388,125075,8276,133351,843
2022-04-03,San Joaquin,077,732212,166394,166336,9899,176235,2202
2022-04-03,San Luis Obispo,079,281455,52479,52512,3753,56265,475
2022-04-03,San Mateo,081,765935,122164,120717,6951,127668,693
2022-04-03,Santa Barbara,083,443738,85823,85611,4695,90306,678
2022-04-03,Santa Clara,085,1922200,311836,312517,12372,324889,2258
2022-04-03,Santa Cruz,087,273765,47911,47371,2089,49460,259
2022-04-03,Shasta,089,179085,30553,30556,6089,36645,530
2022-04-03,Sierra,091,2930,274,273,48,321,4
2022-04-03,Siskiyou,093,43540,4451,4439,2721,7160,80
2022-04-03,Solano,095,438530,81530,81848,5574,87422,446
2022-04-03,Sonoma,097,501317,83662,83235,2631,85866,485
2022-04-03,Stanislaus,099,539301,117489,117536,17555,135091,1581
2022-04-03,Sutter,101,95872,20479,20570,2075,22645,222
2022-04-03,Tehama,103,63373,12025,12046,2578,14624,198
2022-04-03,Trinity,105,12862,1183,1173,287,1460,20
2022-04-03,Tulare,107,460477,106301,104736,27555,132291,1410
2022-04-03,Tuolumne,109,53932,12659,12618,557,13175,180
2022-04-03,Ventura,111,848112,173376,173044,9390,182434,1460
2022-04-03,Yolo,113,214977,37082,36347,3047,39394,313
2022-04-03,Yuba,115,75493,15836,15835,1199,17034,120
2022-04-02,Alameda,001,1643700,256726,255650,13893,269543,1813
2022-04-02,Alpine,003,1148,124,124,1,125,0
2022-04-02,Amador,005,37829,8524,8485,640,9125,86
2022-04-02,Butte,007,227075,33165,32981,6939,39920,396
2022-04-02,Calaveras,009,45235,7263,7254,348,7602,119
2022-04-02,Colusa,011,21464,3441,3445,1047,4492,21
2022-04-02,Contra Costa,013,1133247,190447,188658,13203,201861,1291
2022-04-02,Del Norte,015,27424,5812,5812,184,5996,50
2022-04-02,El Dorado,017,186661,26759,26732,3204,29936,200
2022-04-02,Fresno,019,978130,231245,230559,23670,254229,2722
2022-04-02,Glenn,021,27897,4986,4982,1600,6582,47
2022-04-02,Humboldt,023,135768,16878,16898,2951,19849,140
2022-04-02,Imperial,025,180216,55373,55266,10546,65812,908
2022-04-02,Inyo,027,18085,4076,4063,479,4542,56
2022-04-02,Kern,029,883053,191809,191384,45719,237103,2224
2022-04-02,Kings,031,150075,51486,51470,3503,54973,443
2022-04-02,Lake,033,64148,10699,10674,884,11558,136
2022-04-02,Lassen,035,31185,8961,8943,874,9817,65
2022-04-02,Los Angeles,037,10098052,2712913,2703576,123405,2826981,31410
2022-04-02,Madera,039,155013,37259,37333,6024,43357,354
2022-04-02,Marin,041,260295,33604,33493,2273,35766,287
2022-04-02,Mariposa,043,17540,2400,2391,199,2590,29
2022-04-02,Mendocino,045,87422,13070,13058,3018,16076,119
2022-04-02,Merced,047,269075,62177,62149,8609,70758,808
2022-04-02,Modoc,049,8938,738,741,251,992,8
2022-04-02,Mono,051,14174,2968,2967,121,3088,6
2022-04-02,Monterey,053,433212,79394,78964,13652,92616,726
2022-04-02,Napa,055,140530,25827,25757,949,26706,143
2022-04-02,Nevada,057,99092,15955,15962,1194,17156,123
2022-04-02,Orange,059,3164182,546813,546047,41195,587242,6880
2022-04-02,Placer,061,380077,62785,62740,7332,70072,614
2022-04-02,Plumas,063,18699,2968,2803,366,3169,14
2022-04-02,Riverside,065,2383286,591279,590563,27739,618302,6418
2022-04-02,Sacramento,067,1510023,280665,276218,26426,302644,2950
2022-04-02,San Benito,069,59416,12881,12901,511,13412,98
2022-04-02,San Bernardino,071,2135413,572644,561362,24812,586174,6865
2022-04-02,San Diego,073,3302833,751582,752281,52613,804894,5178
2022-04-02,San Francisco,075,870044,125284,125075,8268,133343,843
2022-04-02,San Joaquin,077,732212,166373,166336,9897,176233,2202
2022-04-02,San Luis Obispo,079,281455,52474,52512,3753,56265,475
2022-04-02,San Mateo,081,765935,122069,120717,6942,127659,693
2022-04-02,Santa Barbara,083,443738,85804,85611,4694,90305,678
2022-04-02,Santa Clara,085,1922200,311670,312517,12368,324885,2258
2022-04-02,Santa Cruz,087,273765,47899,47371,2088,49459,259
2022-04-02,Shasta,089,179085,30552,30556,6089,36645,530
2022-04-02,Sierra,091,2930,274,273,48,321,4
2022-04-02,Siskiyou,093,43540,4450,4439,2720,7159,80
2022-04-02,Solano,095,438530,81515,81848,5573,87421,446
2022-04-02,Sonoma,097,501317,83614,83235,2625,85860,485
2022-04-02,Stanislaus,099,539301,117480,117536,17553,135089,1581
2022-04-02,Sutter,101,95872,20474,20570,2075,22645,222
2022-04-02,Tehama,103,63373,12025,12046,2578,14624,198
2022-04-02,Trinity,105,12862,1183,1173,287,1460,20
2022-04-02,Tulare,107,460477,106297,104736,27555,132291,1410
2022-04-02,Tuolumne,109,53932,12657,12618,557,13175,180
2022-04-02,Ventura,111,848112,173335,173044,9390,182434,1460
2022-04-02,Yolo,113,214977,37070,36347,3044,39391,313
2022-04-02,Yuba,115,75493,15835,15835,1199,17034,120
2022-04-01,Alameda,001,1643700,256611,255650,13889,269539,1813
2022-04-01,Alpine,003,1148,124,124,1,125,0
2022-04-01,Amador,005,37829,8524,8485,640,9125,86
2022-04-01,Butte,007,227075,33161,32981,6936,39917,396
2022-04-01,Calaveras,009,45235,7261,7254,348,7602,119
2022-04-01,Colusa,011,21464,3440,3445,1047,4492,21
2022-04-01,Contra Costa,013,1133247,190394,188658,13202,201860,1291
2022-04-01,Del Norte,015,27424,5810,5812,184,5996,50
2022-04-01,El Dorado,017,186661,26756,26732,3203,29935,200
2022-04-01,Fresno,019,978130,231220,230559,23668,254227,2722
2022-04-01,Glenn,021,27897,4986,4982,1600,6582,47
2022-04-01,Humboldt,023,135768,16876,16898,2951,19849,140
2022-04-01,Imperial,025,180216,55371,55266,10546,65812,908
2022-04-01,Inyo,027,18085,4074,4063,478,4541,56
2022-04-01,Kern,029,883053,191798,191384,45716,237100,2224
2022-04-01,Kings,031,150075,51483,51470,3503,54973,443
2022-04-01,Lake,033,64148,10696,10674,884,11558,136
2022-04-01,Lassen,035,31185,8960,8943,874,9817,65
2022-04-01,Los Angeles,037,10098052,2712416,2703576,123362,2826938,31410
2022-04-01,Madera,039,155013,37258,37333,6024,43357,354
2022-04-01,Marin,041,260295,33586,33493,2266,35759,287
2022-04-01,Mariposa,043,17540,2397,2391,199,2590,29
2022-04-01,Mendocino,045,87422,13067,13058,3017,16075,119
2022-04-01,Merced,047,269075,62170,62149,8608,70757,808
2022-04-01,Modoc,049,8938,738,741,251,992,8
2022-04-01,Mono,051,14174,2968,2967,121,3088,6
2022-04-01,Monterey,053,433212,79376,78964,13649,92613,726
2022-04-01,Napa,055,140530,25818,25757,949,26706,143
2022-04-01,Nevada,057,99092,15955,15962,1193,17155,123
2022-04-01,Orange,059,3164182,546706,546047,41187,587234,6880
2022-04-01,Placer,061,380077,62771,62740,7332,70072,614
2022-04-01,Plumas,063,18699,2968,2803,365,3168,14
2022-04-01,Riverside,065,2383286,591213,590563,27726,618289,6418
2022-04-01,Sacramento,067,1510023,280626,276218,26422,302640,2950
2022-04-01,San Benito,069,59416,12880,12901,511,13412,98
2022-04-01,San Bernardino,071,2135413,572588,561362,24808,586170,6865
2022-04-01,San Diego,073,3302833,751435,752281,52598,804879,5178
2022-04-01,San Francisco,075,870044,125173,125075,8262,133337,843
2022-04-01,San Joaquin,077,732212,166353,166336,9895,176231,2202
2022-04-01,San Luis Obispo,079,281455,52468,52512,3752,56264,475
2022-04-01,San Mateo,081,765935,122007,120717,6936,127653,693
2022-04-01,Santa Barbara,083,443738,85784,85611,4694,90305,678
2022-04-01,Santa Clara,085,1922200,311520,312517,12367,324884,2258
2022-04-01,Santa Cruz,087,273765,47884,47371,2086,49457,259
2022-04-01,Shasta,089,179085,30551,30556,6089,36645,530
2022-04-01,Sierra,091,2930,274,273,48,321,4
2022-04-01,Siskiyou,093,43540,4450,4439,2719,7158,80
2022-04-01,Solano,095,438530,81500,81848,5573,87421,446
2022-04-01,Sonoma,097,501317,83570,83235,2624,85859,485
2022-04-01,Stanislaus,099,539301,117468,117536,17550,135086,1581
2022-04-01,Sutter,101,95872,20474,20570,2075,22645,222
2022-04-01,Tehama,103,63373,12025,12046,2578,14624,198
2022-04-01,Trinity,105,12862,1183,1173,287,1460,20
2022-04-01,Tulare,107,460477,106292,104736,27551,132287,1410
2022-04-01,Tuolumne,109,53932,12656,12618,557,13175,180
2022-04-01,Ventura,111,848112,173304,173044,9386,182430,1460
2022-04-01,Yolo,113,214977,37056,36347,3043,39390,313
2022-04-01,Yuba,115,75493,15834,15835,1199,17034,120
2022-03-31,Alameda,001,1643700,256434,255650,13876,269526,1813
2022-03-31,Alpine,003,1148,124,124,1,125,0
2022-03-31,Amador,005,37829,8524,8485,640,9125,86
2022-03-31,Butte,007,227075,33157,32981,6933,39914,396
2022-03-31,Calaveras,009,45235,7258,7254,348,7602,119
2022-03-31,Colusa,011,21464,3439,3445,1047,4492,21
2022-03-31,Contra Costa,013,1133247,190298,188658,13196,201854,1291
2022-03-31,Del Norte,015,27424,5809,5812,184,5996,50
2022-03-31,El Dorado,017,186661,26748,26732,3203,29935,200
2022-03-31,Fresno,019,978130,231185,230559,23647,254206,2722
2022-03-31,Glenn,021,27897,4984,4982,1600,6582,47
2022-03-31,Humboldt,023,135768,16872,16898,2951,19849,140
2022-03-31,Imperial,025,180216,55368,55266,10545,65811,908
2022-03-31,Inyo,027,18085,4073,4063,475,4538,56
2022-03-31,Kern,029,883053,191783,191384,45707,237091,2224
2022-03-31,Kings,031,150075,51474,51470,3503,54973,443
2022-03-31,Lake,033,64148,10695,10674,883,11557,136
2022-03-31,Lassen,035,31185,8958,8943,874,9817,65
2022-03-31,Los Angeles,037,10098052,2711673,2703576,123308,2826884,31410
2022-03-31,Madera,039,155013,37255,37333,6024,43357,354
2022-03-31,Marin,041,260295,33560,33493,2254,35747,287
2022-03-31,Mariposa,043,17540,2396,2391,198,2589,29
2022-03-31,Mendocino,045,87422,13063,13058,3017,16075,119
2022-03-31,Merced,047,269075,62165,62149,8605,70754,808
2022-03-31,Modoc,049,8938,738,741,251,992,8
2022-03-31,Mono,051,14174,2968,2967,121,3088,6
2022-03-31,Monterey,053,433212,79359,78964,13638,92602,726
2022-03-31,Napa,055,140530,25809,25757,947,26704,143
2022-03-31,Nevada,057,99092,15948,15962,1192,17154,123
2022-03-31,Orange,059,3164182,546559,546047,41173,587220,6880
2022-03-31,Placer,061,380077,62746,62740,7329,70069,614
2022-03-31,Plumas,063,18699,2968,2803,364,3167,14
2022-03-31,Riverside,065,2383286,591103,590563,27723,618286,6418
2022-03-31,Sacramento,067,1510023,280553,276218,26414,302632,2950
2022-03-31,San Benito,069,59416,12879,12901,511,13412,98
2022-03-31,San Bernardino,071,2135413,572491,561362,24797,586159,6865
2022-03-31,San Diego,073,3302833,751199,752281,52571,804852,5178
2022-03-31,San Francisco,075,870044,125016,125075,8250,133325,843
2022-03-31,San Joaquin,077,732212,166319,166336,9881,176217,2202
2022-03-31,San Luis Obispo,079,281455,52454,52512,3751,56263,475
2022-03-31,San Mateo,081,765935,121897,120717,6934,127651,693
2022-03-31,Santa Barbara,083,443738,85754,85611,4694,90305,678
2022-03-31,Santa Clara,085,1922200,311292,312517,12355,324872,2258
2022-03-31,Santa Cruz,087,273765,47865,47371,2084,49455,259
2022-03-31,Shasta,089,179085,30545,30556,6089,36645,530
2022-03-31,Sierra,091,2930,271,273,48,321,4
2022-03-31,Siskiyou,093,43540,4448,4439,2719,7158,80
2022-03-31,Solano,095,438530,81471,81848,5570,87418,446
2022-03-31,Sonoma,097,501317,83527,83235,2618,85853,485
2022-03-31,Stanislaus,099,539301,117451,117536,17545,135081,1581
2022-03-31,Sutter,101,95872,20471,20570,2074,22644,222
2022-03-31,Tehama,103,63373,12025,12046,2577,14623,198
2022-03-31,Trinity,105,12862,1183,1173,287,1460,20
2022-03-31,Tulare,107,460477,106282,104736,27543,132279,1410
2022-03-31,Tuolumne,109,53932,12655,12618,557,13175,180
2022-03-31,Ventura,111,848112,173264,173044,9383,182427,1460
2022-03-31,Yolo,113,214977,37040,36347,3043,39390,313
2022-03-31,Yuba,115,75493,15834,15835,1196,17031,120
2022-03-30,Alameda,001,1643700,256301,255467,13868,269335,1812
2022-03-30,Alpine,003,1148,124,124,1,125,0
2022-03-30,Amador,005,37829,8524,8485,640,9125,86
2022-03-30,Butte,007,227075,33152,32968,6927,39895,396
2022-03-30,Calaveras,009,45235,7256,7253,347,7600,119
2022-03-30,Colusa,011,21464,3439,3445,1047,4492,21
2022-03-30,Contra Costa,013,1133247,190236,188496,13185,201681,1291
2022-03-30,Del Norte,015,27424,5807,5808,184,5992,50
2022-03-30,El Dorado,017,186661,26740,26722,3203,29925,200
2022-03-30,Fresno,019,978130,231174,230448,23641,254089,2720
2022-03-30,Glenn,021,27897,4983,4982,1600,6582,47
2022-03-30,Humboldt,023,135768,16869,16894,2951,19845,140
2022-03-30,Imperial,025,180216,55364,55252,10542,65794,908
2022-03-30,Inyo,027,18085,4072,4062,473,4535,56
2022-03-30,Kern,029,883053,191755,191363,45702,237065,2219
2022-03-30,Kings,031,150075,51468,51446,3501,54947,443
2022-03-30,Lake,033,64148,10694,10674,883,11557,136
2022-03-30,Lassen,035,31185,8958,8943,874,9817,65
2022-03-30,Los Angeles,037,10098052,2710848,2702536,123253,2825789,31384
2022-03-30,Madera,039,155013,37249,37330,6023,43353,354
2022-03-30,Marin,041,260295,33540,33453,2235,35688,287
2022-03-30,Mariposa,043,17540,2396,2390,198,2588,27
2022-03-30,Mendocino,045,87422,13059,13055,3014,16069,118
2022-03-30,Merced,047,269075,62159,62136,8600,70736,808
2022-03-30,Modoc,049,8938,738,739,251,990,8
2022-03-30,Mono,051,14174,2967,2967,121,3088,6
2022-03-30,Monterey,053,433212,79342,78911,13631,92542,726
2022-03-30,Napa,055,140530,25797,25745,946,26691,141
2022-03-30,Nevada,057,99092,15945,15960,1190,17150,123
2022-03-30,Orange,059,3164182,546408,545895,41151,587046,6876
2022-03-30,Placer,061,380077,62731,62705,7325,70030,614
2022-03-30,Plumas,063,18699,2968,2762,362,3124,13
2022-03-30,Riverside,065,2383286,591020,590437,27710,618147,6411
2022-03-30,Sacramento,067,1510023,280485,276081,26407,302488,2949
2022-03-30,San Benito,069,59416,12875,12898,511,13409,98
2022-03-30,San Bernardino,071,2135413,572407,561153,24793,585946,6863
2022-03-30,San Diego,073,3302833,750967,751684,52545,804229,5169
2022-03-30,San Francisco,075,870044,124911,124930,8241,133171,841
2022-03-30,San Joaquin,077,732212,166291,166299,9875,176174,2201
2022-03-30,San Luis Obispo,079,281455,52441,52484,3747,56231,475
2022-03-30,San Mateo,081,765935,121796,120548,6934,127482,693
2022-03-30,Santa Barbara,083,443738,85732,85488,4691,90179,677
2022-03-30,Santa Clara,085,1922200,311110,312253,12335,324588,2258
2022-03-30,Santa Cruz,087,273765,47809,47340,2083,49423,259
2022-03-30,Shasta,089,179085,30542,30555,6089,36644,530
2022-03-30,Sierra,091,2930,271,273,48,321,4
2022-03-30,Siskiyou,093,43540,4448,4439,2719,7158,80
2022-03-30,Solano,095,438530,81452,81816,5566,87382,443
2022-03-30,Sonoma,097,501317,83490,83163,2617,85780,485
2022-03-30,Stanislaus,099,539301,117438,117593,17542,135135,1559
2022-03-30,Sutter,101,95872,20466,20565,2074,22639,222
2022-03-30,Tehama,103,63373,12024,12045,2576,14621,198
2022-03-30,Trinity,105,12862,1182,1173,287,1460,20
2022-03-30,Tulare,107,460477,106276,104667,27537,132204,1410
2022-03-30,Tuolumne,109,53932,12653,12616,557,13173,180
2022-03-30,Ventura,111,848112,173223,172984,9375,182359,1460
2022-03-30,Yolo,113,214977,37030,36325,3040,39365,313
2022-03-30,Yuba,115,75493,15832,15830,1196,17026,120
2022-03-29,Alameda,001,1643700,256175,255261,13858,269119,1810
2022-03-29,Alpine,003,1148,124,124,1,125,0
2022-03-29,Amador,005,37829,8524,8483,640,9123,86
2022-03-29,Butte,007,227075,33149,32954,6927,39881,396
2022-03-29,Calaveras,009,45235,7255,7250,346,7596,119
2022-03-29,Colusa,011,21464,3439,3445,1047,4492,21
2022-03-29,Contra Costa,013,1133247,190147,188359,13177,201536,1290
2022-03-29,Del Norte,015,27424,5807,5806,183,5989,50
2022-03-29,El Dorado,017,186661,26735,26706,3203,29909,200
2022-03-29,Fresno,019,978130,231146,230256,23637,253893,2718
2022-03-29,Glenn,021,27897,4982,4983,1600,6583,47
2022-03-29,Humboldt,023,135768,16866,16892,2948,19840,140
2022-03-29,Imperial,025,180216,55350,55233,10541,65774,908
2022-03-29,Inyo,027,18085,4070,4062,472,4534,56
2022-03-29,Kern,029,883053,191723,191338,45695,237033,2220
2022-03-29,Kings,031,150075,51460,51416,3500,54916,443
2022-03-29,Lake,033,64148,10690,10674,883,11557,136
2022-03-29,Lassen,035,31185,8957,8943,874,9817,65
2022-03-29,Los Angeles,037,10098052,2710020,2702005,123207,2825212,31378
2022-03-29,Madera,039,155013,37241,37325,6020,43345,354
2022-03-29,Marin,041,260295,33520,33431,2230,35661,287
2022-03-29,Mariposa,043,17540,2396,2388,198,2586,23
2022-03-29,Mendocino,045,87422,13055,13053,3013,16066,119
2022-03-29,Merced,047,269075,62147,62123,8599,70722,806
2022-03-29,Modoc,049,8938,736,737,251,988,8
2022-03-29,Mono,051,14174,2967,2966,121,3087,5
2022-03-29,Monterey,053,433212,79329,78774,13623,92397,725
2022-03-29,Napa,055,140530,25790,25732,946,26678,141
2022-03-29,Nevada,057,99092,15937,15956,1190,17146,123
2022-03-29,Orange,059,3164182,546260,545832,41135,586967,6871
2022-03-29,Placer,061,380077,62713,62687,7320,70007,614
2022-03-29,Plumas,063,18699,2966,2761,362,3123,13
2022-03-29,Riverside,065,2383286,590920,590359,27702,618061,6403
2022-03-29,Sacramento,067,1510023,280419,276040,26396,302436,2946
2022-03-29,San Benito,069,59416,12873,12892,511,13403,97
2022-03-29,San Bernardino,071,2135413,572310,561026,24785,585811,6860
2022-03-29,San Diego,073,3302833,750723,751240,52523,803763,5159
2022-03-29,San Francisco,075,870044,124760,124789,8235,133024,840
2022-03-29,San Joaquin,077,732212,166254,166241,9867,176108,2198
2022-03-29,San Luis Obispo,079,281455,52425,52455,3743,56198,472
2022-03-29,San Mateo,081,765935,121702,120435,6931,127366,686
2022-03-29,Santa Barbara,083,443738,85709,85464,4691,90155,676
2022-03-29,Santa Clara,085,1922200,310870,312067,12318,324385,2259
2022-03-29,Santa Cruz,087,273765,47789,47323,2082,49405,259
2022-03-29,Shasta,089,179085,30535,30552,6087,36639,529
2022-03-29,Sierra,091,2930,271,273,48,321,4
2022-03-29,Siskiyou,093,43540,4448,4439,2718,7157,80
2022-03-29,Solano,095,438530,81430,81713,5563,87276,441
2022-03-29,Sonoma,097,501317,83457,83130,2611,85741,485
2022-03-29,Stanislaus,099,539301,117419,117683,17536,135219,1559
2022-03-29,Sutter,101,95872,20464,20556,2073,22629,221
2022-03-29,Tehama,103,63373,12022,12045,2576,14621,198
2022-03-29,Trinity,105,12862,1182,1173,287,1460,20
2022-03-29,Tulare,107,460477,106271,104622,27532,132154,1406
2022-03-29,Tuolumne,109,53932,12651,12615,557,13172,180
2022-03-29,Ventura,111,848112,173168,172946,9374,182320,1460
2022-03-29,Yolo,113,214977,37017,36296,3039,39335,313
2022-03-29,Yuba,115,75493,15828,15824,1195,17019,117
2022-03-28,Alameda,001,1643700,256023,255192,13848,269040,1808
2022-03-28,Alpine,003,1148,124,124,1,125,0
2022-03-28,Amador,005,37829,8523,8480,640,9120,86
2022-03-28,Butte,007,227075,33132,32947,6927,39874,392
2022-03-28,Calaveras,009,45235,7255,7247,346,7593,119
2022-03-28,Colusa,011,21464,3439,3445,1047,4492,21
2022-03-28,Contra Costa,013,1133247,190066,188305,13172,201477,1290
2022-03-28,Del Norte,015,27424,5805,5834,183,6017,50
2022-03-28,El Dorado,017,186661,26728,26703,3201,29904,200
2022-03-28,Fresno,019,978130,231118,230144,23620,253764,2717
2022-03-28,Glenn,021,27897,4982,4983,1600,6583,47
2022-03-28,Humboldt,023,135768,16865,16916,2948,19864,140
2022-03-28,Imperial,025,180216,55340,55245,10541,65786,909
2022-03-28,Inyo,027,18085,4069,4062,472,4534,56
2022-03-28,Kern,029,883053,191699,191333,45686,237019,2212
2022-03-28,Kings,031,150075,51447,51405,3500,54905,443
2022-03-28,Lake,033,64148,10688,10673,883,11556,136
2022-03-28,Lassen,035,31185,8957,8946,874,9820,63
2022-03-28,Los Angeles,037,10098052,2709140,2700997,123168,2824165,31349
2022-03-28,Madera,039,155013,37237,37324,6020,43344,354
2022-03-28,Marin,041,260295,33495,33391,2225,35616,287
2022-03-28,Mariposa,043,17540,2395,2388,198,2586,23
2022-03-28,Mendocino,045,87422,13053,13046,3012,16058,118
2022-03-28,Merced,047,269075,62137,62116,8594,70710,805
2022-03-28,Modoc,049,8938,735,736,251,987,7
2022-03-28,Mono,051,14174,2967,2966,121,3087,5
2022-03-28,Monterey,053,433212,79296,78784,13619,92403,724
2022-03-28,Napa,055,140530,25784,25723,945,26668,140
2022-03-28,Nevada,057,99092,15935,15969,1190,17159,123
2022-03-28,Orange,059,3164182,546131,545700,41108,586808,6860
2022-03-28,Placer,061,380077,62693,62687,7319,70006,613
2022-03-28,Plumas,063,18699,2965,2760,362,3122,13
2022-03-28,Riverside,065,2383286,590821,590298,27694,617992,6397
2022-03-28,Sacramento,067,1510023,280350,275889,26384,302273,2946
2022-03-28,San Benito,069,59416,12873,12889,511,13400,97
2022-03-28,San Bernardino,071,2135413,572226,560836,24774,585610,6858
2022-03-28,San Diego,073,3302833,750484,750659,52489,803148,5155
2022-03-28,San Francisco,075,870044,124620,124678,8225,132903,839
2022-03-28,San Joaquin,077,732212,166222,166247,9865,176112,2196
2022-03-28,San Luis Obispo,079,281455,52400,52434,3740,56174,470
2022-03-28,San Mateo,081,765935,121588,120337,6924,127261,686
2022-03-28,Santa Barbara,083,443738,85681,85442,4689,90131,675
2022-03-28,Santa Clara,085,1922200,310641,311953,12309,324262,2257
2022-03-28,Santa Cruz,087,273765,47756,47324,2082,49406,259
2022-03-28,Shasta,089,179085,30534,30550,6086,36636,527
2022-03-28,Sierra,091,2930,271,273,48,321,4
2022-03-28,Siskiyou,093,43540,4447,4438,2718,7156,80
2022-03-28,Solano,095,438530,81402,81704,5558,87262,441
2022-03-28,Sonoma,097,501317,83411,83105,2606,85711,485
2022-03-28,Stanislaus,099,539301,117407,117783,17531,135314,1562
2022-03-28,Sutter,101,95872,20459,20549,2073,22622,221
2022-03-28,Tehama,103,63373,12022,12041,2576,14617,200
2022-03-28,Trinity,105,12862,1182,1173,287,1460,20
2022-03-28,Tulare,107,460477,106259,104576,27526,132102,1404
2022-03-28,Tuolumne,109,53932,12651,12627,557,13184,180
2022-03-28,Ventura,111,848112,173129,172867,9373,182240,1455
2022-03-28,Yolo,113,214977,36999,36282,3037,39319,312
2022-03-28,Yuba,115,75493,15827,15821,1193,17014,117
2022-03-27,Alameda,001,1643700,255837,255132,13839,268971,1809
2022-03-27,Alpine,003,1148,124,124,1,125,0
2022-03-27,Amador,005,37829,8520,8480,640,9120,86
2022-03-27,Butte,007,227075,33119,32943,6921,39864,392
2022-03-27,Calaveras,009,45235,7253,7245,346,7591,119
2022-03-27,Colusa,011,21464,3439,3445,1047,4492,21
2022-03-27,Contra Costa,013,1133247,189951,188251,13156,201407,1290
2022-03-27,Del Norte,015,27424,5804,5836,183,6019,50
2022-03-27,El Dorado,017,186661,26714,26699,3198,29897,200
2022-03-27,Fresno,019,978130,231071,230049,23602,253651,2717
2022-03-27,Glenn,021,27897,4981,4983,1600,6583,47
2022-03-27,Humboldt,023,135768,16861,16920,2948,19868,140
2022-03-27,Imperial,025,180216,55327,55240,10540,65780,909
2022-03-27,Inyo,027,18085,4068,4062,470,4532,56
2022-03-27,Kern,029,883053,191661,191332,45680,237012,2213
2022-03-27,Kings,031,150075,51438,51400,3500,54900,443
2022-03-27,Lake,033,64148,10687,10672,882,11554,136
2022-03-27,Lassen,035,31185,8957,8946,874,9820,63
2022-03-27,Los Angeles,037,10098052,2708331,2700983,123121,2824104,31348
2022-03-27,Madera,039,155013,37233,37323,6018,43341,354
2022-03-27,Marin,041,260295,33458,33391,2215,35606,287
2022-03-27,Mariposa,043,17540,2395,2390,198,2588,23
2022-03-27,Mendocino,045,87422,13049,13046,3010,16056,118
2022-03-27,Merced,047,269075,62127,62110,8593,70703,805
2022-03-27,Modoc,049,8938,734,736,249,985,7
2022-03-27,Mono,051,14174,2967,2966,121,3087,5
2022-03-27,Monterey,053,433212,79275,78778,13607,92385,724
2022-03-27,Napa,055,140530,25769,25723,945,26668,140
2022-03-27,Nevada,057,99092,15931,15967,1188,17155,123
2022-03-27,Orange,059,3164182,545997,545644,41074,586718,6860
2022-03-27,Placer,061,380077,62675,62680,7318,69998,613
2022-03-27,Plumas,063,18699,2964,2760,360,3120,13
2022-03-27,Riverside,065,2383286,590735,590251,27683,617934,6395
2022-03-27,Sacramento,067,1510023,280269,275854,26377,302231,2941
2022-03-27,San Benito,069,59416,12868,12889,510,13399,97
2022-03-27,San Bernardino,071,2135413,572110,560853,24772,585625,6862
2022-03-27,San Diego,073,3302833,750228,750659,52466,803125,5155
2022-03-27,San Francisco,075,870044,124435,124619,8214,132833,839
2022-03-27,San Joaquin,077,732212,166186,166238,9861,176099,2196
2022-03-27,San Luis Obispo,079,281455,52379,52430,3738,56168,470
2022-03-27,San Mateo,081,765935,121484,120324,6918,127242,686
2022-03-27,Santa Barbara,083,443738,85645,85434,4687,90121,675
2022-03-27,Santa Clara,085,1922200,310430,311822,12302,324124,2257
2022-03-27,Santa Cruz,087,273765,47722,47321,2080,49401,259
2022-03-27,Shasta,089,179085,30530,30550,6084,36634,527
2022-03-27,Sierra,091,2930,271,273,48,321,4
2022-03-27,Siskiyou,093,43540,4447,4436,2717,7153,80
2022-03-27,Solano,095,438530,81360,81691,5555,87246,441
2022-03-27,Sonoma,097,501317,83358,83088,2602,85690,485
2022-03-27,Stanislaus,099,539301,117387,117778,17528,135306,1562
2022-03-27,Sutter,101,95872,20453,20545,2073,22618,221
2022-03-27,Tehama,103,63373,12022,12040,2576,14616,200
2022-03-27,Trinity,105,12862,1182,1173,287,1460,20
2022-03-27,Tulare,107,460477,106250,104582,27517,132099,1404
2022-03-27,Tuolumne,109,53932,12650,12628,557,13185,180
2022-03-27,Ventura,111,848112,173084,172831,9371,182202,1455
2022-03-27,Yolo,113,214977,36978,36232,3034,39266,312
2022-03-27,Yuba,115,75493,15824,15821,1186,17007,117
2022-03-26,Alameda,001,1643700,255757,254691,13838,268529,1803
2022-03-26,Alpine,003,1148,124,124,1,125,0
2022-03-26,Amador,005,37829,8520,8476,640,9116,86
2022-03-26,Butte,007,227075,33115,32929,6919,39848,391
2022-03-26,Calaveras,009,45235,7251,7240,346,7586,120
2022-03-26,Colusa,011,21464,3437,3445,1047,4492,21
2022-03-26,Contra Costa,013,1133247,189897,187990,13153,201143,1285
2022-03-26,Del Norte,015,27424,5802,5831,183,6014,50
2022-03-26,El Dorado,017,186661,26706,26674,3196,29870,200
2022-03-26,Fresno,019,978130,231048,229799,23601,253400,2710
2022-03-26,Glenn,021,27897,4981,4978,1600,6578,47
2022-03-26,Humboldt,023,135768,16857,16911,2948,19859,139
2022-03-26,Imperial,025,180216,55321,55230,10539,65769,913
2022-03-26,Inyo,027,18085,4068,4060,469,4529,56
2022-03-26,Kern,029,883053,191647,191288,45676,236964,2201
2022-03-26,Kings,031,150075,51437,51397,3500,54897,444
2022-03-26,Lake,033,64148,10687,10659,882,11541,136
2022-03-26,Lassen,035,31185,8957,8944,874,9818,63
2022-03-26,Los Angeles,037,10098052,2707875,2698028,123079,2821107,31291
2022-03-26,Madera,039,155013,37230,37321,6016,43337,354
2022-03-26,Marin,041,260295,33448,33317,2211,35528,287
2022-03-26,Mariposa,043,17540,2395,2386,198,2584,23
2022-03-26,Mendocino,045,87422,13045,13038,3010,16048,118
2022-03-26,Merced,047,269075,62121,62083,8591,70674,805
2022-03-26,Modoc,049,8938,734,736,249,985,7
2022-03-26,Mono,051,14174,2967,2966,121,3087,5
2022-03-26,Monterey,053,433212,79268,78688,13605,92293,724
2022-03-26,Napa,055,140530,25766,25701,945,26646,139
2022-03-26,Nevada,057,99092,15927,15960,1188,17148,123
2022-03-26,Orange,059,3164182,545920,545294,41063,586357,6853
2022-03-26,Placer,061,380077,62663,62634,7314,69948,613
2022-03-26,Plumas,063,18699,2964,2758,359,3117,13
2022-03-26,Riverside,065,2383286,590665,590060,27682,617742,6397
2022-03-26,Sacramento,067,1510023,280236,275529,26375,301904,2935
2022-03-26,San Benito,069,59416,12868,12885,510,13395,97
2022-03-26,San Bernardino,071,2135413,572051,560742,24768,585510,6840
2022-03-26,San Diego,073,3302833,750104,750170,52459,802629,5146
2022-03-26,San Francisco,075,870044,124329,124265,8208,132473,839
2022-03-26,San Joaquin,077,732212,166165,166079,9860,175939,2195
2022-03-26,San Luis Obispo,079,281455,52373,52369,3738,56107,469
2022-03-26,San Mateo,081,765935,121425,120165,6910,127075,684
2022-03-26,Santa Barbara,083,443738,85625,85477,4685,90162,674
2022-03-26,Santa Clara,085,1922200,310272,311189,12295,323484,2250
2022-03-26,Santa Cruz,087,273765,47711,47329,2080,49409,259
2022-03-26,Shasta,089,179085,30529,30542,6083,36625,527
2022-03-26,Sierra,091,2930,271,273,48,321,4
2022-03-26,Siskiyou,093,43540,4446,4433,2717,7150,80
2022-03-26,Solano,095,438530,81351,81659,5555,87214,441
2022-03-26,Sonoma,097,501317,83328,83113,2597,85710,485
2022-03-26,Stanislaus,099,539301,117380,117962,17527,135489,1565
2022-03-26,Sutter,101,95872,20451,20536,2073,22609,221
2022-03-26,Tehama,103,63373,12022,12036,2575,14611,195
2022-03-26,Trinity,105,12862,1182,1174,287,1461,20
2022-03-26,Tulare,107,460477,106243,104538,27516,132054,1400
2022-03-26,Tuolumne,109,53932,12648,12628,557,13185,180
2022-03-26,Ventura,111,848112,173043,172690,9367,182057,1455
2022-03-26,Yolo,113,214977,36969,36234,3034,39268,311
2022-03-26,Yuba,115,75493,15823,15807,1186,16993,117
2022-03-25,Alameda,001,1643700,255693,254691,13836,268527,1803
2022-03-25,Alpine,003,1148,124,124,1,125,0
2022-03-25,Amador,005,37829,8519,8476,640,9116,86
2022-03-25,Butte,007,227075,33110,32929,6919,39848,391
2022-03-25,Calaveras,009,45235,7250,7240,346,7586,120
2022-03-25,Colusa,011,21464,3437,3445,1047,4492,21
2022-03-25,Contra Costa,013,1133247,189849,187990,13149,201139,1285
2022-03-25,Del Norte,015,27424,5802,5831,183,6014,50
2022-03-25,El Dorado,017,186661,26702,26674,3196,29870,200
2022-03-25,Fresno,019,978130,231020,229799,23593,253392,2710
2022-03-25,Glenn,021,27897,4981,4978,1600,6578,47
2022-03-25,Humboldt,023,135768,16857,16911,2948,19859,139
2022-03-25,Imperial,025,180216,55316,55230,10538,65768,913
2022-03-25,Inyo,027,18085,4067,4060,469,4529,56
2022-03-25,Kern,029,883053,191637,191288,45675,236963,2201
2022-03-25,Kings,031,150075,51436,51397,3500,54897,444
2022-03-25,Lake,033,64148,10687,10659,882,11541,136
2022-03-25,Lassen,035,31185,8956,8944,874,9818,63
2022-03-25,Los Angeles,037,10098052,2707455,2698028,123048,2821076,31291
2022-03-25,Madera,039,155013,37229,37321,6015,43336,354
2022-03-25,Marin,041,260295,33433,33317,2202,35519,287
2022-03-25,Mariposa,043,17540,2395,2386,198,2584,23
2022-03-25,Mendocino,045,87422,13045,13038,3010,16048,118
2022-03-25,Merced,047,269075,62114,62083,8590,70673,805
2022-03-25,Modoc,049,8938,734,736,249,985,7
2022-03-25,Mono,051,14174,2966,2966,121,3087,5
2022-03-25,Monterey,053,433212,79257,78688,13602,92290,724
2022-03-25,Napa,055,140530,25759,25701,945,26646,139
2022-03-25,Nevada,057,99092,15926,15960,1188,17148,123
2022-03-25,Orange,059,3164182,545846,545294,41047,586341,6853
2022-03-25,Placer,061,380077,62657,62634,7311,69945,613
2022-03-25,Plumas,063,18699,2963,2758,359,3117,13
2022-03-25,Riverside,065,2383286,590605,590060,27671,617731,6397
2022-03-25,Sacramento,067,1510023,280194,275529,26373,301902,2935
2022-03-25,San Benito,069,59416,12868,12885,510,13395,97
2022-03-25,San Bernardino,071,2135413,572011,560742,24765,585507,6840
2022-03-25,San Diego,073,3302833,749981,750170,52449,802619,5146
2022-03-25,San Francisco,075,870044,124248,124265,8195,132460,839
2022-03-25,San Joaquin,077,732212,166151,166079,9857,175936,2195
2022-03-25,San Luis Obispo,079,281455,52370,52369,3737,56106,469
2022-03-25,San Mateo,081,765935,121373,120165,6910,127075,684
2022-03-25,Santa Barbara,083,443738,85610,85477,4683,90160,674
2022-03-25,Santa Clara,085,1922200,310121,311189,12290,323479,2250
2022-03-25,Santa Cruz,087,273765,47703,47329,2080,49409,259
2022-03-25,Shasta,089,179085,30525,30542,6082,36624,527
2022-03-25,Sierra,091,2930,271,273,48,321,4
2022-03-25,Siskiyou,093,43540,4444,4433,2715,7148,80
2022-03-25,Solano,095,438530,81337,81659,5553,87212,441
2022-03-25,Sonoma,097,501317,83291,83113,2597,85710,485
2022-03-25,Stanislaus,099,539301,117366,117962,17526,135488,1565
2022-03-25,Sutter,101,95872,20446,20536,2073,22609,221
2022-03-25,Tehama,103,63373,12020,12036,2575,14611,195
2022-03-25,Trinity,105,12862,1182,1174,287,1461,20
2022-03-25,Tulare,107,460477,106239,104538,27516,132054,1400
2022-03-25,Tuolumne,109,53932,12647,12628,557,13185,180
2022-03-25,Ventura,111,848112,173005,172690,9367,182057,1455
2022-03-25,Yolo,113,214977,36957,36234,3034,39268,311
2022-03-25,Yuba,115,75493,15818,15807,1185,16992,117
2022-03-24,Alameda,001,1643700,255576,254691,13820,268511,1803
2022-03-24,Alpine,003,1148,124,124,1,125,0
2022-03-24,Amador,005,37829,8519,8476,640,9116,86
2022-03-24,Butte,007,227075,33104,32929,6919,39848,391
2022-03-24,Calaveras,009,45235,7248,7240,346,7586,120
2022-03-24,Colusa,011,21464,3437,3445,1047,4492,21
2022-03-24,Contra Costa,013,1133247,189770,187990,13146,201136,1285
2022-03-24,Del Norte,015,27424,5798,5831,183,6014,50
2022-03-24,El Dorado,017,186661,26691,26674,3196,29870,200
2022-03-24,Fresno,019,978130,230978,229799,23584,253383,2710
2022-03-24,Glenn,021,27897,4980,4978,1600,6578,47
2022-03-24,Humboldt,023,135768,16852,16911,2946,19857,139
2022-03-24,Imperial,025,180216,55309,55230,10538,65768,913
2022-03-24,Inyo,027,18085,4066,4060,469,4529,56
2022-03-24,Kern,029,883053,191627,191288,45673,236961,2201
2022-03-24,Kings,031,150075,51427,51397,3498,54895,444
2022-03-24,Lake,033,64148,10686,10659,882,11541,136
2022-03-24,Lassen,035,31185,8955,8944,874,9818,63
2022-03-24,Los Angeles,037,10098052,2706887,2698028,123003,2821031,31291
2022-03-24,Madera,039,155013,37227,37321,6013,43334,354
2022-03-24,Marin,041,260295,33412,33317,2193,35510,287
2022-03-24,Mariposa,043,17540,2395,2386,198,2584,23
2022-03-24,Mendocino,045,87422,13039,13038,3007,16045,118
2022-03-24,Merced,047,269075,62107,62083,8589,70672,805
2022-03-24,Modoc,049,8938,734,736,249,985,7
2022-03-24,Mono,051,14174,2966,2966,121,3087,5
2022-03-24,Monterey,053,433212,79231,78688,13588,92276,724
2022-03-24,Napa,055,140530,25750,25701,945,26646,139
2022-03-24,Nevada,057,99092,15922,15960,1187,17147,123
2022-03-24,Orange,059,3164182,545744,545294,41032,586326,6853
2022-03-24,Placer,061,380077,62637,62634,7310,69944,613
2022-03-24,Plumas,063,18699,2963,2758,359,3117,13
2022-03-24,Riverside,065,2383286,590528,590060,27663,617723,6397
2022-03-24,Sacramento,067,1510023,280125,275529,26368,301897,2935
2022-03-24,San Benito,069,59416,12867,12885,509,13394,97
2022-03-24,San Bernardino,071,2135413,571929,560742,24761,585503,6840
2022-03-24,San Diego,073,3302833,749773,750170,52436,802606,5146
2022-03-24,San Francisco,075,870044,124166,124265,8189,132454,839
2022-03-24,San Joaquin,077,732212,166123,166079,9857,175936,2195
2022-03-24,San Luis Obispo,079,281455,52354,52369,3736,56105,469
2022-03-24,San Mateo,081,765935,121325,120165,6906,127071,684
2022-03-24,Santa Barbara,083,443738,85595,85477,4680,90157,674
2022-03-24,Santa Clara,085,1922200,309975,311189,12273,323462,2250
2022-03-24,Santa Cruz,087,273765,47685,47329,2079,49408,259
2022-03-24,Shasta,089,179085,30517,30542,6082,36624,527
2022-03-24,Sierra,091,2930,271,273,48,321,4
2022-03-24,Siskiyou,093,43540,4441,4433,2715,7148,80
2022-03-24,Solano,095,438530,81318,81659,5552,87211,441
2022-03-24,Sonoma,097,501317,83256,83113,2595,85708,485
2022-03-24,Stanislaus,099,539301,117358,117962,17523,135485,1565
2022-03-24,Sutter,101,95872,20441,20536,2073,22609,221
2022-03-24,Tehama,103,63373,12018,12036,2574,14610,195
2022-03-24,Trinity,105,12862,1182,1174,287,1461,20
2022-03-24,Tulare,107,460477,106228,104538,27511,132049,1400
2022-03-24,Tuolumne,109,53932,12645,12628,557,13185,180
2022-03-24,Ventura,111,848112,172962,172690,9366,182056,1455
2022-03-24,Yolo,113,214977,36951,36234,3030,39264,311
2022-03-24,Yuba,115,75493,15814,15807,1183,16990,117
2022-03-23,Alameda,001,1643700,255441,254559,13809,268368,1802
2022-03-23,Alpine,003,1148,124,124,1,125,0
2022-03-23,Amador,005,37829,8519,8475,640,9115,86
2022-03-23,Butte,007,227075,33089,32920,6918,39838,387
2022-03-23,Calaveras,009,45235,7243,7237,346,7583,120
2022-03-23,Colusa,011,21464,3436,3444,1047,4491,21
2022-03-23,Contra Costa,013,1133247,189671,187898,13135,201033,1279
2022-03-23,Del Norte,015,27424,5796,5830,183,6013,50
2022-03-23,El Dorado,017,186661,26685,26670,3196,29866,200
2022-03-23,Fresno,019,978130,230942,229656,23571,253227,2710
2022-03-23,Glenn,021,27897,4980,4975,1600,6575,47
2022-03-23,Humboldt,023,135768,16851,16908,2945,19853,139
2022-03-23,Imperial,025,180216,55303,55211,10537,65748,909
2022-03-23,Inyo,027,18085,4066,4060,469,4529,56
2022-03-23,Kern,029,883053,191610,191241,45668,236909,2196
2022-03-23,Kings,031,150075,51416,51384,3498,54882,442
2022-03-23,Lake,033,64148,10682,10658,881,11539,135
2022-03-23,Lassen,035,31185,8954,8944,873,9817,63
2022-03-23,Los Angeles,037,10098052,2706207,2697227,122973,2820200,31267
2022-03-23,Madera,039,155013,37222,37317,6010,43327,354
2022-03-23,Marin,041,260295,33386,33274,2188,35462,287
2022-03-23,Mariposa,043,17540,2393,2382,197,2579,11
2022-03-23,Mendocino,045,87422,13035,13033,3006,16039,118
2022-03-23,Merced,047,269075,62097,62056,8586,70642,805
2022-03-23,Modoc,049,8938,734,736,249,985,7
2022-03-23,Mono,051,14174,2966,2966,121,3087,5
2022-03-23,Monterey,053,433212,79214,78655,13564,92219,724
2022-03-23,Napa,055,140530,25737,25691,943,26634,139
2022-03-23,Nevada,057,99092,15920,15958,1187,17145,123
2022-03-23,Orange,059,3164182,545614,545158,41020,586178,6852
2022-03-23,Placer,061,380077,62618,62622,7308,69930,613
2022-03-23,Plumas,063,18699,2963,2747,359,3106,13
2022-03-23,Riverside,065,2383286,590455,589947,27658,617605,6388
2022-03-23,Sacramento,067,1510023,280062,275398,26361,301759,2934
2022-03-23,San Benito,069,59416,12866,12884,509,13393,97
2022-03-23,San Bernardino,071,2135413,571855,560550,24757,585307,6828
2022-03-23,San Diego,073,3302833,749579,749871,52413,802284,5143
2022-03-23,San Francisco,075,870044,124053,124110,8182,132292,838
2022-03-23,San Joaquin,077,732212,166086,166041,9850,175891,2187
2022-03-23,San Luis Obispo,079,281455,52337,52344,3731,56075,469
2022-03-23,San Mateo,081,765935,121241,120080,6896,126976,685
2022-03-23,Santa Barbara,083,443738,85578,85464,4679,90143,673
2022-03-23,Santa Clara,085,1922200,309811,310956,12261,323217,2250
2022-03-23,Santa Cruz,087,273765,47666,47314,2075,49389,259
2022-03-23,Shasta,089,179085,30513,30524,6081,36605,526
2022-03-23,Sierra,091,2930,271,273,48,321,4
2022-03-23,Siskiyou,093,43540,4440,4433,2715,7148,80
2022-03-23,Solano,095,438530,81284,81615,5551,87166,441
2022-03-23,Sonoma,097,501317,83223,83074,2592,85666,482
2022-03-23,Stanislaus,099,539301,117341,118041,17520,135561,1568
2022-03-23,Sutter,101,95872,20438,20532,2073,22605,218
2022-03-23,Tehama,103,63373,12015,12035,2574,14609,195
2022-03-23,Trinity,105,12862,1182,1174,287,1461,20
2022-03-23,Tulare,107,460477,106211,104489,27506,131995,1394
2022-03-23,Tuolumne,109,53932,12644,12629,557,13186,180
2022-03-23,Ventura,111,848112,172914,172647,9364,182011,1455
2022-03-23,Yolo,113,214977,36931,36197,3028,39225,308
2022-03-23,Yuba,115,75493,15807,15801,1182,16983,117
2022-03-22,Alameda,001,1643700,255319,254467,13503,267970,1802
2022-03-22,Alpine,003,1148,124,122,1,123,0
2022-03-22,Amador,005,37829,8518,8462,639,9101,86
2022-03-22,Butte,007,227075,33079,32907,6914,39821,387
2022-03-22,Calaveras,009,45235,7241,7237,346,7583,120
2022-03-22,Colusa,011,21464,3435,3445,1047,4492,21
2022-03-22,Contra Costa,013,1133247,189595,187813,13114,200927,1279
2022-03-22,Del Norte,015,27424,5790,5824,183,6007,50
2022-03-22,El Dorado,017,186661,26678,26661,3196,29857,200
2022-03-22,Fresno,019,978130,230893,229551,23562,253113,2708
2022-03-22,Glenn,021,27897,4977,4971,1600,6571,47
2022-03-22,Humboldt,023,135768,16848,16911,2945,19856,139
2022-03-22,Imperial,025,180216,55291,55170,10534,65704,908
2022-03-22,Inyo,027,18085,4066,4060,469,4529,56
2022-03-22,Kern,029,883053,191587,191213,45660,236873,2195
2022-03-22,Kings,031,150075,51404,51369,3497,54866,442
2022-03-22,Lake,033,64148,10680,10657,880,11537,135
2022-03-22,Lassen,035,31185,8954,8940,873,9813,63
2022-03-22,Los Angeles,037,10098052,2705545,2696746,122926,2819672,31250
2022-03-22,Madera,039,155013,37219,37304,6007,43311,354
2022-03-22,Marin,041,260295,33361,33253,2184,35437,287
2022-03-22,Mariposa,043,17540,2391,2382,197,2579,6
2022-03-22,Mendocino,045,87422,13030,13030,3004,16034,118
2022-03-22,Merced,047,269075,62087,62056,8582,70638,805
2022-03-22,Modoc,049,8938,734,735,249,984,7
2022-03-22,Mono,051,14174,2966,2963,121,3084,5
2022-03-22,Monterey,053,433212,79197,78614,13554,92168,724
2022-03-22,Napa,055,140530,25727,25688,942,26630,139
2022-03-22,Nevada,057,99092,15912,15950,1187,17137,123
2022-03-22,Orange,059,3164182,545472,545075,41001,586076,6843
2022-03-22,Placer,061,380077,62605,62604,7306,69910,610
2022-03-22,Plumas,063,18699,2962,2744,359,3103,13
2022-03-22,Riverside,065,2383286,590379,589816,27655,617471,6383
2022-03-22,Sacramento,067,1510023,279986,275374,26350,301724,2927
2022-03-22,San Benito,069,59416,12865,12884,508,13392,97
2022-03-22,San Bernardino,071,2135413,571773,560371,24737,585108,6811
2022-03-22,San Diego,073,3302833,749379,749647,52393,802040,5141
2022-03-22,San Francisco,075,870044,123946,123998,8176,132174,838
2022-03-22,San Joaquin,077,732212,166058,165992,9847,175839,2187
2022-03-22,San Luis Obispo,079,281455,52329,52257,3731,55988,465
2022-03-22,San Mateo,081,765935,121167,119975,6893,126868,686
2022-03-22,Santa Barbara,083,443738,85561,85457,4678,90135,672
2022-03-22,Santa Clara,085,1922200,309642,310787,12249,323036,2249
2022-03-22,Santa Cruz,087,273765,47646,47287,2074,49361,259
2022-03-22,Shasta,089,179085,30507,30528,6081,36609,525
2022-03-22,Sierra,091,2930,271,273,48,321,4
2022-03-22,Siskiyou,093,43540,4440,4429,2714,7143,80
2022-03-22,Solano,095,438530,81261,81587,5548,87135,440
2022-03-22,Sonoma,097,501317,83194,83042,2589,85631,482
2022-03-22,Stanislaus,099,539301,117324,118025,17517,135542,1568
2022-03-22,Sutter,101,95872,20437,20525,2070,22595,218
2022-03-22,Tehama,103,63373,12013,12034,2574,14608,162
2022-03-22,Trinity,105,12862,1182,1174,287,1461,20
2022-03-22,Tulare,107,460477,106200,104431,27498,131929,1391
2022-03-22,Tuolumne,109,53932,12644,12628,557,13185,180
2022-03-22,Ventura,111,848112,172865,172590,9362,181952,1455
2022-03-22,Yolo,113,214977,36911,36184,3027,39211,308
2022-03-22,Yuba,115,75493,15804,15795,1181,16976,117
2022-03-21,Alameda,001,1643700,255098,254354,13495,267849,1799
2022-03-21,Alpine,003,1148,124,122,1,123,0
2022-03-21,Amador,005,37829,8515,8461,638,9099,85
2022-03-21,Butte,007,227075,33068,32895,6911,39806,385
2022-03-21,Calaveras,009,45235,7240,7237,346,7583,119
2022-03-21,Colusa,011,21464,3435,3445,1047,4492,21
2022-03-21,Contra Costa,013,1133247,189531,187509,13099,200608,1276
2022-03-21,Del Norte,015,27424,5789,5824,183,6007,50
2022-03-21,El Dorado,017,186661,26667,26610,3196,29806,199
2022-03-21,Fresno,019,978130,230845,229374,23554,252928,2707
2022-03-21,Glenn,021,27897,4975,4972,1595,6567,46
2022-03-21,Humboldt,023,135768,16838,16912,2932,19844,139
2022-03-21,Imperial,025,180216,55278,55133,10533,65666,908
2022-03-21,Inyo,027,18085,4065,4060,469,4529,56
2022-03-21,Kern,029,883053,191554,191184,45654,236838,2187
2022-03-21,Kings,031,150075,51390,51366,3495,54861,441
2022-03-21,Lake,033,64148,10678,10655,880,11535,135
2022-03-21,Lassen,035,31185,8953,8939,873,9812,63
2022-03-21,Los Angeles,037,10098052,2704677,2694711,122877,2817588,31218
2022-03-21,Madera,039,155013,37213,37288,6004,43292,354
2022-03-21,Marin,041,260295,33317,33242,2179,35421,287
2022-03-21,Mariposa,043,17540,2390,2383,196,2579,6
2022-03-21,Mendocino,045,87422,13022,13028,3002,16030,118
2022-03-21,Merced,047,269075,62073,62048,8577,70625,803
2022-03-21,Modoc,049,8938,732,734,249,983,7
2022-03-21,Mono,051,14174,2966,2962,121,3083,5
2022-03-21,Monterey,053,433212,79148,78572,13541,92113,724
2022-03-21,Napa,055,140530,25719,25684,940,26624,138
2022-03-21,Nevada,057,99092,15908,15963,1186,17149,123
2022-03-21,Orange,059,3164182,545319,544943,40984,585927,6841
2022-03-21,Placer,061,380077,62586,62550,7305,69855,610
2022-03-21,Plumas,063,18699,2962,2744,359,3103,13
2022-03-21,Riverside,065,2383286,590299,589707,27651,617358,6376
2022-03-21,Sacramento,067,1510023,279896,275334,26336,301670,2925
2022-03-21,San Benito,069,59416,12859,12872,508,13380,97
2022-03-21,San Bernardino,071,2135413,571684,560210,24724,584934,6807
2022-03-21,San Diego,073,3302833,749154,748833,52373,801206,5138
2022-03-21,San Francisco,075,870044,123779,123912,8167,132079,835
2022-03-21,San Joaquin,077,732212,166032,165939,9844,175783,2185
2022-03-21,San Luis Obispo,079,281455,52304,52219,3726,55945,463
2022-03-21,San Mateo,081,765935,121008,119899,6891,126790,684
2022-03-21,Santa Barbara,083,443738,85546,85416,4676,90092,672
2022-03-21,Santa Clara,085,1922200,309382,310509,12246,322755,2245
2022-03-21,Santa Cruz,087,273765,47610,47267,2073,49340,259
2022-03-21,Shasta,089,179085,30501,30523,6079,36602,525
2022-03-21,Sierra,091,2930,271,273,48,321,4
2022-03-21,Siskiyou,093,43540,4440,4426,2714,7140,80
2022-03-21,Solano,095,438530,81233,81399,5547,86946,441
2022-03-21,Sonoma,097,501317,83155,82979,2584,85563,482
2022-03-21,Stanislaus,099,539301,117291,118144,17515,135659,1571
2022-03-21,Sutter,101,95872,20434,20523,2058,22581,218
2022-03-21,Tehama,103,63373,12009,12030,2574,14604,160
2022-03-21,Trinity,105,12862,1182,1174,287,1461,20
2022-03-21,Tulare,107,460477,106180,104350,27493,131843,1389
2022-03-21,Tuolumne,109,53932,12644,12620,557,13177,180
2022-03-21,Ventura,111,848112,172795,172537,9358,181895,1452
2022-03-21,Yolo,113,214977,36895,36141,3025,39166,307
2022-03-21,Yuba,115,75493,15801,15790,1180,16970,117
2022-03-20,Alameda,001,1643700,254961,254293,13485,267778,1801
2022-03-20,Alpine,003,1148,122,122,1,123,0
2022-03-20,Amador,005,37829,8512,8460,638,9098,85
2022-03-20,Butte,007,227075,33053,32892,6907,39799,385
2022-03-20,Calaveras,009,45235,7240,7233,343,7576,119
2022-03-20,Colusa,011,21464,3435,3446,1047,4493,21
2022-03-20,Contra Costa,013,1133247,189428,187467,13089,200556,1276
2022-03-20,Del Norte,015,27424,5787,5821,183,6004,50
2022-03-20,El Dorado,017,186661,26659,26608,3196,29804,199
2022-03-20,Fresno,019,978130,230767,229297,23543,252840,2707
2022-03-20,Glenn,021,27897,4974,4972,1595,6567,46
2022-03-20,Humboldt,023,135768,16836,16913,2930,19843,139
2022-03-20,Imperial,025,180216,55267,55133,10532,65665,908
2022-03-20,Inyo,027,18085,4065,4060,469,4529,56
2022-03-20,Kern,029,883053,191510,191170,45649,236819,2187
2022-03-20,Kings,031,150075,51379,51360,3495,54855,441
2022-03-20,Lake,033,64148,10674,10652,880,11532,135
2022-03-20,Lassen,035,31185,8951,8938,873,9811,63
2022-03-20,Los Angeles,037,10098052,2703882,2694698,122833,2817531,31219
2022-03-20,Madera,039,155013,37208,37284,6001,43285,354
2022-03-20,Marin,041,260295,33300,33232,2178,35410,275
2022-03-20,Mariposa,043,17540,2390,2383,196,2579,6
2022-03-20,Mendocino,045,87422,13015,13027,2997,16024,118
2022-03-20,Merced,047,269075,62062,62041,8574,70615,803
2022-03-20,Modoc,049,8938,732,734,249,983,7
2022-03-20,Mono,051,14174,2964,2962,121,3083,5
2022-03-20,Monterey,053,433212,79115,78566,13530,92096,723
2022-03-20,Napa,055,140530,25707,25682,939,26621,138
2022-03-20,Nevada,057,99092,15904,15964,1186,17150,123
2022-03-20,Orange,059,3164182,545197,544862,40966,585828,6841
2022-03-20,Placer,061,380077,62566,62525,7305,69830,610
2022-03-20,Plumas,063,18699,2962,2744,359,3103,13
2022-03-20,Riverside,065,2383286,590202,589657,27647,617304,6376
2022-03-20,Sacramento,067,1510023,279819,275317,26321,301638,2927
2022-03-20,San Benito,069,59416,12859,12869,507,13376,97
2022-03-20,San Bernardino,071,2135413,571603,560220,24715,584935,6805
2022-03-20,San Diego,073,3302833,748918,748833,52340,801173,5138
2022-03-20,San Francisco,075,870044,123629,123858,8155,132013,835
2022-03-20,San Joaquin,077,732212,165999,165927,9840,175767,2185
2022-03-20,San Luis Obispo,079,281455,52280,52217,3723,55940,463
2022-03-20,San Mateo,081,765935,120948,119901,6885,126786,684
2022-03-20,Santa Barbara,083,443738,85521,85412,4675,90087,672
2022-03-20,Santa Clara,085,1922200,309173,310412,12238,322650,2243
2022-03-20,Santa Cruz,087,273765,47583,47265,2072,49337,259
2022-03-20,Shasta,089,179085,30491,30522,6078,36600,525
2022-03-20,Sierra,091,2930,271,273,48,321,4
2022-03-20,Siskiyou,093,43540,4439,4426,2714,7140,80
2022-03-20,Solano,095,438530,81203,81393,5545,86938,441
2022-03-20,Sonoma,097,501317,83112,82965,2583,85548,481
2022-03-20,Stanislaus,099,539301,117265,118146,17512,135658,1572
2022-03-20,Sutter,101,95872,20427,20519,2050,22569,218
2022-03-20,Tehama,103,63373,12007,12030,2574,14604,160
2022-03-20,Trinity,105,12862,1182,1174,287,1461,20
2022-03-20,Tulare,107,460477,106159,104353,27480,131833,1389
2022-03-20,Tuolumne,109,53932,12639,12617,557,13174,180
2022-03-20,Ventura,111,848112,172745,172514,9353,181867,1451
2022-03-20,Yolo,113,214977,36875,36135,3024,39159,307
2022-03-20,Yuba,115,75493,15792,15787,1178,16965,117
2022-03-19,Alameda,001,1643700,254885,253936,13483,267419,1797
2022-03-19,Alpine,003,1148,122,122,1,123,0
2022-03-19,Amador,005,37829,8509,8456,638,9094,85
2022-03-19,Butte,007,227075,33045,32856,6907,39763,385
2022-03-19,Calaveras,009,45235,7240,7229,343,7572,119
2022-03-19,Colusa,011,21464,3433,3445,1047,4492,21
2022-03-19,Contra Costa,013,1133247,189392,187225,13088,200313,1276
2022-03-19,Del Norte,015,27424,5784,5815,183,5998,48
2022-03-19,El Dorado,017,186661,26655,26618,3196,29814,199
2022-03-19,Fresno,019,978130,230744,228965,23542,252507,2694
2022-03-19,Glenn,021,27897,4974,4971,1595,6566,44
2022-03-19,Humboldt,023,135768,16830,16901,2930,19831,138
2022-03-19,Imperial,025,180216,55266,55038,10531,65569,898
2022-03-19,Inyo,027,18085,4065,4061,469,4530,56
2022-03-19,Kern,029,883053,191495,190943,45641,236584,2184
2022-03-19,Kings,031,150075,51374,51334,3495,54829,441
2022-03-19,Lake,033,64148,10674,10641,880,11521,135
2022-03-19,Lassen,035,31185,8951,8925,873,9798,63
2022-03-19,Los Angeles,037,10098052,2703510,2686759,122799,2809558,31133
2022-03-19,Madera,039,155013,37208,37273,6001,43274,354
2022-03-19,Marin,041,260295,33282,33163,2174,35337,272
2022-03-19,Mariposa,043,17540,2389,2378,196,2574,6
2022-03-19,Mendocino,045,87422,13015,13012,2997,16009,117
2022-03-19,Merced,047,269075,62056,61985,8572,70557,800
2022-03-19,Modoc,049,8938,732,734,249,983,7
2022-03-19,Mono,051,14174,2964,2961,121,3082,5
2022-03-19,Monterey,053,433212,79104,78483,13523,92006,720
2022-03-19,Napa,055,140530,25704,25654,939,26593,138
2022-03-19,Nevada,057,99092,15902,15960,1186,17146,123
2022-03-19,Orange,059,3164182,545125,543907,40950,584857,6817
2022-03-19,Placer,061,380077,62552,62483,7305,69788,605
2022-03-19,Plumas,063,18699,2962,2724,359,3083,13
2022-03-19,Riverside,065,2383286,590151,589017,27640,616657,6359
2022-03-19,Sacramento,067,1510023,279778,274855,26317,301172,2913
2022-03-19,San Benito,069,59416,12858,12859,507,13366,97
2022-03-19,San Bernardino,071,2135413,571557,559935,24713,584648,6778
2022-03-19,San Diego,073,3302833,748818,747344,52328,799672,5133
2022-03-19,San Francisco,075,870044,123559,123587,8153,131740,833
2022-03-19,San Joaquin,077,732212,165974,165765,9837,175602,2181
2022-03-19,San Luis Obispo,079,281455,52274,52174,3723,55897,463
2022-03-19,San Mateo,081,765935,120911,119782,6884,126666,667
2022-03-19,Santa Barbara,083,443738,85507,85336,4674,90010,671
2022-03-19,Santa Clara,085,1922200,309051,309918,12229,322147,2225
2022-03-19,Santa Cruz,087,273765,47575,47203,2068,49271,256
2022-03-19,Shasta,089,179085,30487,30495,6078,36573,525
2022-03-19,Sierra,091,2930,271,273,48,321,4
2022-03-19,Siskiyou,093,43540,4438,4422,2714,7136,76
2022-03-19,Solano,095,438530,81194,81340,5542,86882,441
2022-03-19,Sonoma,097,501317,83095,82838,2580,85418,472
2022-03-19,Stanislaus,099,539301,117255,118138,17510,135648,1568
2022-03-19,Sutter,101,95872,20424,20503,2050,22553,218
2022-03-19,Tehama,103,63373,12007,12007,2574,14581,160
2022-03-19,Trinity,105,12862,1182,1173,287,1460,20
2022-03-19,Tulare,107,460477,106150,104290,27475,131765,1384
2022-03-19,Tuolumne,109,53932,12638,12617,557,13174,180
2022-03-19,Ventura,111,848112,172714,172380,9352,181732,1451
2022-03-19,Yolo,113,214977,36866,36086,3024,39110,306
2022-03-19,Yuba,115,75493,15788,15768,1177,16945,117
2022-03-18,Alameda,001,1643700,254825,253936,13480,267416,1797
2022-03-18,Alpine,003,1148,122,122,1,123,0
2022-03-18,Amador,005,37829,8509,8456,638,9094,85
2022-03-18,Butte,007,227075,33040,32856,6904,39760,385
2022-03-18,Calaveras,009,45235,7240,7229,343,7572,119
2022-03-18,Colusa,011,21464,3433,3445,1047,4492,21
2022-03-18,Contra Costa,013,1133247,189360,187225,13086,200311,1276
2022-03-18,Del Norte,015,27424,5782,5815,183,5998,48
2022-03-18,El Dorado,017,186661,26650,26618,3194,29812,199
2022-03-18,Fresno,019,978130,230712,228965,23542,252507,2694
2022-03-18,Glenn,021,27897,4974,4971,1595,6566,44
2022-03-18,Humboldt,023,135768,16827,16901,2929,19830,138
2022-03-18,Imperial,025,180216,55264,55038,10531,65569,898
2022-03-18,Inyo,027,18085,4065,4061,469,4530,56
2022-03-18,Kern,029,883053,191484,190943,45638,236581,2184
2022-03-18,Kings,031,150075,51366,51334,3495,54829,441
2022-03-18,Lake,033,64148,10672,10641,879,11520,135
2022-03-18,Lassen,035,31185,8950,8925,873,9798,63
2022-03-18,Los Angeles,037,10098052,2703161,2686759,122773,2809532,31133
2022-03-18,Madera,039,155013,37203,37273,6001,43274,354
2022-03-18,Marin,041,260295,33268,33163,2174,35337,272
2022-03-18,Mariposa,043,17540,2388,2378,196,2574,6
2022-03-18,Mendocino,045,87422,13011,13012,2997,16009,117
2022-03-18,Merced,047,269075,62045,61985,8572,70557,800
2022-03-18,Modoc,049,8938,732,734,249,983,7
2022-03-18,Mono,051,14174,2963,2961,121,3082,5
2022-03-18,Monterey,053,433212,79086,78483,13521,92004,720
2022-03-18,Napa,055,140530,25701,25654,939,26593,138
2022-03-18,Nevada,057,99092,15899,15960,1185,17145,123
2022-03-18,Orange,059,3164182,545058,543907,40941,584848,6817
2022-03-18,Placer,061,380077,62543,62483,7305,69788,605
2022-03-18,Plumas,063,18699,2962,2724,359,3083,13
2022-03-18,Riverside,065,2383286,590091,589017,27636,616653,6359
2022-03-18,Sacramento,067,1510023,279742,274855,26313,301168,2913
2022-03-18,San Benito,069,59416,12856,12859,507,13366,97
2022-03-18,San Bernardino,071,2135413,571519,559935,24711,584646,6778
2022-03-18,San Diego,073,3302833,748710,747344,52313,799657,5133
2022-03-18,San Francisco,075,870044,123480,123587,8148,131735,833
2022-03-18,San Joaquin,077,732212,165959,165765,9832,175597,2181
2022-03-18,San Luis Obispo,079,281455,52267,52174,3723,55897,463
2022-03-18,San Mateo,081,765935,120876,119782,6881,126663,667
2022-03-18,Santa Barbara,083,443738,85497,85336,4673,90009,671
2022-03-18,Santa Clara,085,1922200,308948,309918,12226,322144,2225
2022-03-18,Santa Cruz,087,273765,47563,47203,2067,49270,256
2022-03-18,Shasta,089,179085,30486,30495,6078,36573,525
2022-03-18,Sierra,091,2930,271,273,48,321,4
2022-03-18,Siskiyou,093,43540,4438,4422,2714,7136,76
2022-03-18,Solano,095,438530,81183,81340,5536,86876,441
2022-03-18,Sonoma,097,501317,83074,82838,2579,85417,472
2022-03-18,Stanislaus,099,539301,117242,118138,17510,135648,1568
2022-03-18,Sutter,101,95872,20421,20503,2050,22553,218
2022-03-18,Tehama,103,63373,12006,12007,2574,14581,160
2022-03-18,Trinity,105,12862,1182,1173,287,1460,20
2022-03-18,Tulare,107,460477,106144,104290,27470,131760,1384
2022-03-18,Tuolumne,109,53932,12637,12617,557,13174,180
2022-03-18,Ventura,111,848112,172694,172380,9347,181727,1451
2022-03-18,Yolo,113,214977,36855,36086,3024,39110,306
2022-03-18,Yuba,115,75493,15786,15768,1177,16945,117
2022-03-17,Alameda,001,1643700,254726,253936,13474,267410,1797
2022-03-17,Alpine,003,1148,122,122,1,123,0
2022-03-17,Amador,005,37829,8502,8456,638,9094,85
2022-03-17,Butte,007,227075,33027,32856,6902,39758,385
2022-03-17,Calaveras,009,45235,7237,7229,343,7572,119
2022-03-17,Colusa,011,21464,3433,3445,1047,4492,21
2022-03-17,Contra Costa,013,1133247,189296,187225,13075,200300,1276
2022-03-17,Del Norte,015,27424,5780,5815,183,5998,48
2022-03-17,El Dorado,017,186661,26644,26618,3194,29812,199
2022-03-17,Fresno,019,978130,230663,228965,23539,252504,2694
2022-03-17,Glenn,021,27897,4974,4971,1595,6566,44
2022-03-17,Humboldt,023,135768,16823,16901,2927,19828,138
2022-03-17,Imperial,025,180216,55253,55038,10531,65569,898
2022-03-17,Inyo,027,18085,4065,4061,469,4530,56
2022-03-17,Kern,029,883053,191455,190943,45635,236578,2184
2022-03-17,Kings,031,150075,51363,51334,3494,54828,441
2022-03-17,Lake,033,64148,10669,10641,879,11520,135
2022-03-17,Lassen,035,31185,8948,8925,873,9798,63
2022-03-17,Los Angeles,037,10098052,2702499,2686759,122738,2809497,31133
2022-03-17,Madera,039,155013,37199,37273,6001,43274,354
2022-03-17,Marin,041,260295,33256,33163,2173,35336,272
2022-03-17,Mariposa,043,17540,2388,2378,196,2574,6
2022-03-17,Mendocino,045,87422,13007,13012,2994,16006,117
2022-03-17,Merced,047,269075,62039,61985,8570,70555,800
2022-03-17,Modoc,049,8938,732,734,249,983,7
2022-03-17,Mono,051,14174,2963,2961,120,3081,5
2022-03-17,Monterey,053,433212,79063,78483,13515,91998,720
2022-03-17,Napa,055,140530,25696,25654,939,26593,138
2022-03-17,Nevada,057,99092,15896,15960,1185,17145,123
2022-03-17,Orange,059,3164182,544964,543907,40931,584838,6817
2022-03-17,Placer,061,380077,62527,62483,7303,69786,605
2022-03-17,Plumas,063,18699,2961,2724,359,3083,13
2022-03-17,Riverside,065,2383286,590011,589017,27629,616646,6359
2022-03-17,Sacramento,067,1510023,279676,274855,26307,301162,2913
2022-03-17,San Benito,069,59416,12855,12859,507,13366,97
2022-03-17,San Bernardino,071,2135413,571455,559935,24708,584643,6778
2022-03-17,San Diego,073,3302833,748534,747344,52299,799643,5133
2022-03-17,San Francisco,075,870044,123399,123587,8143,131730,833
2022-03-17,San Joaquin,077,732212,165939,165765,9830,175595,2181
2022-03-17,San Luis Obispo,079,281455,52253,52174,3721,55895,463
2022-03-17,San Mateo,081,765935,120828,119782,6877,126659,667
2022-03-17,Santa Barbara,083,443738,85481,85336,4673,90009,671
2022-03-17,Santa Clara,085,1922200,308828,309918,12221,322139,2225
2022-03-17,Santa Cruz,087,273765,47547,47203,2065,49268,256
2022-03-17,Shasta,089,179085,30482,30495,6076,36571,525
2022-03-17,Sierra,091,2930,271,273,48,321,4
2022-03-17,Siskiyou,093,43540,4437,4422,2714,7136,76
2022-03-17,Solano,095,438530,81154,81340,5532,86872,441
2022-03-17,Sonoma,097,501317,83046,82838,2577,85415,472
2022-03-17,Stanislaus,099,539301,117228,118138,17505,135643,1568
2022-03-17,Sutter,101,95872,20411,20503,2039,22542,218
2022-03-17,Tehama,103,63373,12006,12007,2574,14581,160
2022-03-17,Trinity,105,12862,1182,1173,287,1460,20
2022-03-17,Tulare,107,460477,106128,104290,27460,131750,1384
2022-03-17,Tuolumne,109,53932,12634,12617,556,13173,180
2022-03-17,Ventura,111,848112,172645,172380,9345,181725,1451
2022-03-17,Yolo,113,214977,36841,36086,3024,39110,306
2022-03-17,Yuba,115,75493,15784,15768,1176,16944,117
2022-03-16,Alameda,001,1643700,254627,253792,13471,267263,1794
2022-03-16,Alpine,003,1148,122,122,1,123,0
2022-03-16,Amador,005,37829,8494,8449,638,9087,85
2022-03-16,Butte,007,227075,33016,32837,6897,39734,385
2022-03-16,Calaveras,009,45235,7235,7229,343,7572,120
2022-03-16,Colusa,011,21464,3433,3445,1047,4492,22
2022-03-16,Contra Costa,013,1133247,189238,187100,13064,200164,1266
2022-03-16,Del Norte,015,27424,5779,5811,181,5992,48
2022-03-16,El Dorado,017,186661,26631,26602,3193,29795,199
2022-03-16,Fresno,019,978130,230616,228786,23528,252314,2689
2022-03-16,Glenn,021,27897,4974,4969,1595,6564,44
2022-03-16,Humboldt,023,135768,16820,16893,2927,19820,138
2022-03-16,Imperial,025,180216,55241,55002,10530,65532,897
2022-03-16,Inyo,027,18085,4064,4061,469,4530,56
2022-03-16,Kern,029,883053,191413,190835,45628,236463,2170
2022-03-16,Kings,031,150075,51348,51321,3494,54815,437
2022-03-16,Lake,033,64148,10667,10633,878,11511,133
2022-03-16,Lassen,035,31185,8945,8924,873,9797,62
2022-03-16,Los Angeles,037,10098052,2701870,2685789,122696,2808485,31102
2022-03-16,Madera,039,155013,37189,37262,6000,43262,354
2022-03-16,Marin,041,260295,33235,33136,2171,35307,272
2022-03-16,Mariposa,043,17540,2386,2376,196,2572,6
2022-03-16,Mendocino,045,87422,13004,13011,2993,16004,117
2022-03-16,Merced,047,269075,62024,61959,8566,70525,798
2022-03-16,Modoc,049,8938,731,734,249,983,7
2022-03-16,Mono,051,14174,2963,2960,120,3080,5
2022-03-16,Monterey,053,433212,79041,78416,13510,91926,720
2022-03-16,Napa,055,140530,25687,25638,939,26577,138
2022-03-16,Nevada,057,99092,15894,15960,1185,17145,123
2022-03-16,Orange,059,3164182,544841,543326,40908,584234,6791
2022-03-16,Placer,061,380077,62511,62435,7301,69736,605
2022-03-16,Plumas,063,18699,2961,2723,359,3082,13
2022-03-16,Riverside,065,2383286,589915,588761,27626,616387,6351
2022-03-16,Sacramento,067,1510023,279611,274709,26300,301009,2910
2022-03-16,San Benito,069,59416,12850,12854,507,13361,97
2022-03-16,San Bernardino,071,2135413,571374,559746,24701,584447,6775
2022-03-16,San Diego,073,3302833,748329,746970,52275,799245,5126
2022-03-16,San Francisco,075,870044,123299,123446,8136,131582,831
2022-03-16,San Joaquin,077,732212,165892,165703,9827,175530,2169
2022-03-16,San Luis Obispo,079,281455,52235,52132,3717,55849,462
2022-03-16,San Mateo,081,765935,120765,119680,6869,126549,660
2022-03-16,Santa Barbara,083,443738,85448,85322,4669,89991,670
2022-03-16,Santa Clara,085,1922200,308642,309689,12206,321895,2224
2022-03-16,Santa Cruz,087,273765,47518,47161,2065,49226,255
2022-03-16,Shasta,089,179085,30473,30489,6072,36561,527
2022-03-16,Sierra,091,2930,271,273,48,321,4
2022-03-16,Siskiyou,093,43540,4434,4419,2712,7131,76
2022-03-16,Solano,095,438530,81131,81277,5530,86807,440
2022-03-16,Sonoma,097,501317,83003,82791,2567,85358,472
2022-03-16,Stanislaus,099,539301,117202,118072,17503,135575,1567
2022-03-16,Sutter,101,95872,20409,20494,2038,22532,218
2022-03-16,Tehama,103,63373,12004,11999,2574,14573,160
2022-03-16,Trinity,105,12862,1182,1173,287,1460,20
2022-03-16,Tulare,107,460477,106115,104217,27454,131671,1377
2022-03-16,Tuolumne,109,53932,12629,12610,556,13166,180
2022-03-16,Ventura,111,848112,172604,172212,9341,181553,1451
2022-03-16,Yolo,113,214977,36818,36079,3023,39102,307
2022-03-16,Yuba,115,75493,15779,15758,1176,16934,117
2022-03-15,Alameda,001,1643700,254495,253694,13462,267156,1793
2022-03-15,Alpine,003,1148,122,122,1,123,0
2022-03-15,Amador,005,37829,8491,8448,638,9086,85
2022-03-15,Butte,007,227075,33003,32822,6896,39718,385
2022-03-15,Calaveras,009,45235,7233,7236,343,7579,118
2022-03-15,Colusa,011,21464,3433,3445,1047,4492,21
2022-03-15,Contra Costa,013,1133247,189157,187021,13057,200078,1265
2022-03-15,Del Norte,015,27424,5776,5806,178,5984,48
2022-03-15,El Dorado,017,186661,26628,26596,3193,29789,199
2022-03-15,Fresno,019,978130,230573,228631,23519,252150,2689
2022-03-15,Glenn,021,27897,4972,4966,1595,6561,44
2022-03-15,Humboldt,023,135768,16814,16889,2926,19815,138
2022-03-15,Imperial,025,180216,55231,54981,10526,65507,896
2022-03-15,Inyo,027,18085,4064,4062,468,4530,56
2022-03-15,Kern,029,883053,191384,190645,45618,236263,2168
2022-03-15,Kings,031,150075,51329,51317,3490,54807,437
2022-03-15,Lake,033,64148,10663,10631,878,11509,131
2022-03-15,Lassen,035,31185,8943,8926,873,9799,62
2022-03-15,Los Angeles,037,10098052,2701185,2685071,122640,2807711,31077
2022-03-15,Madera,039,155013,37180,37258,5999,43257,354
2022-03-15,Marin,041,260295,33212,33111,2170,35281,272
2022-03-15,Mariposa,043,17540,2384,2377,196,2573,6
2022-03-15,Mendocino,045,87422,12999,13005,2992,15997,117
2022-03-15,Merced,047,269075,62006,61916,8557,70473,798
2022-03-15,Modoc,049,8938,731,733,249,982,7
2022-03-15,Mono,051,14174,2963,2961,120,3081,5
2022-03-15,Monterey,053,433212,79011,78400,13502,91902,718
2022-03-15,Napa,055,140530,25679,25657,937,26594,138
2022-03-15,Nevada,057,99092,15892,15960,1183,17143,123
2022-03-15,Orange,059,3164182,544702,543197,40901,584098,6780
2022-03-15,Placer,061,380077,62494,62398,7297,69695,604
2022-03-15,Plumas,063,18699,2960,2722,359,3081,13
2022-03-15,Riverside,065,2383286,589816,588622,27618,616240,6333
2022-03-15,Sacramento,067,1510023,279526,274633,26294,300927,2907
2022-03-15,San Benito,069,59416,12846,12849,507,13356,95
2022-03-15,San Bernardino,071,2135413,571298,559605,24698,584303,6770
2022-03-15,San Diego,073,3302833,748086,746474,52253,798727,5116
2022-03-15,San Francisco,075,870044,123183,123526,8127,131653,831
2022-03-15,San Joaquin,077,732212,165849,165664,9821,175485,2161
2022-03-15,San Luis Obispo,079,281455,52225,52060,3713,55773,458
2022-03-15,San Mateo,081,765935,120714,119586,6863,126449,649
2022-03-15,Santa Barbara,083,443738,85423,85353,4665,90018,668
2022-03-15,Santa Clara,085,1922200,308481,309535,12194,321729,2224
2022-03-15,Santa Cruz,087,273765,47465,47117,2065,49182,255
2022-03-15,Shasta,089,179085,30464,30476,6069,36545,524
2022-03-15,Sierra,091,2930,271,273,48,321,4
2022-03-15,Siskiyou,093,43540,4434,4420,2712,7132,76
2022-03-15,Solano,095,438530,81096,81260,5529,86789,440
2022-03-15,Sonoma,097,501317,82963,82737,2567,85304,472
2022-03-15,Stanislaus,099,539301,117184,118085,17500,135585,1567
2022-03-15,Sutter,101,95872,20406,20480,2029,22509,217
2022-03-15,Tehama,103,63373,12001,11997,2574,14571,160
2022-03-15,Trinity,105,12862,1182,1173,287,1460,20
2022-03-15,Tulare,107,460477,106096,104153,27442,131595,1375
2022-03-15,Tuolumne,109,53932,12625,12602,556,13158,180
2022-03-15,Ventura,111,848112,172559,172150,9338,181488,1451
2022-03-15,Yolo,113,214977,36802,36079,3019,39098,308
2022-03-15,Yuba,115,75493,15771,15756,1176,16932,116
2022-03-14,Alameda,001,1643700,254385,253629,13458,267087,1791
2022-03-14,Alpine,003,1148,122,122,1,123,0
2022-03-14,Amador,005,37829,8486,8448,638,9086,85
2022-03-14,Butte,007,227075,32985,32812,6896,39708,385
2022-03-14,Calaveras,009,45235,7232,7245,343,7588,118
2022-03-14,Colusa,011,21464,3432,3445,1047,4492,21
2022-03-14,Contra Costa,013,1133247,189064,186969,13049,200018,1265
2022-03-14,Del Norte,015,27424,5770,5807,178,5985,48
2022-03-14,El Dorado,017,186661,26623,26570,3193,29763,199
2022-03-14,Fresno,019,978130,230499,228470,23509,251979,2682
2022-03-14,Glenn,021,27897,4970,4966,1595,6561,44
2022-03-14,Humboldt,023,135768,16807,16890,2924,19814,137
2022-03-14,Imperial,025,180216,55220,54933,10525,65458,897
2022-03-14,Inyo,027,18085,4064,4062,468,4530,56
2022-03-14,Kern,029,883053,191349,190526,45607,236133,2166
2022-03-14,Kings,031,150075,51311,51293,3489,54782,437
2022-03-14,Lake,033,64148,10660,10631,878,11509,131
2022-03-14,Lassen,035,31185,8943,8927,872,9799,62
2022-03-14,Los Angeles,037,10098052,2700553,2683369,122573,2805942,31034
2022-03-14,Madera,039,155013,37173,37255,5998,43253,354
2022-03-14,Marin,041,260295,33183,33099,2170,35269,272
2022-03-14,Mariposa,043,17540,2383,2376,196,2572,6
2022-03-14,Mendocino,045,87422,12994,12992,2985,15977,117
2022-03-14,Merced,047,269075,61987,61905,8555,70460,795
2022-03-14,Modoc,049,8938,730,731,249,980,7
2022-03-14,Mono,051,14174,2962,2961,120,3081,5
2022-03-14,Monterey,053,433212,78996,78376,13466,91842,718
2022-03-14,Napa,055,140530,25665,25649,937,26586,138
2022-03-14,Nevada,057,99092,15890,15954,1183,17137,123
2022-03-14,Orange,059,3164182,544565,543099,40893,583992,6775
2022-03-14,Placer,061,380077,62476,62389,7295,69684,601
2022-03-14,Plumas,063,18699,2960,2711,359,3070,13
2022-03-14,Riverside,065,2383286,589682,588531,27608,616139,6332
2022-03-14,Sacramento,067,1510023,279445,274682,26289,300971,2899
2022-03-14,San Benito,069,59416,12841,12846,507,13353,95
2022-03-14,San Bernardino,071,2135413,571209,559505,24693,584198,6767
2022-03-14,San Diego,073,3302833,747783,745515,52225,797740,5108
2022-03-14,San Francisco,075,870044,123093,123575,8121,131696,824
2022-03-14,San Joaquin,077,732212,165810,165662,9820,175482,2142
2022-03-14,San Luis Obispo,079,281455,52197,52046,3710,55756,458
2022-03-14,San Mateo,081,765935,120641,119564,6861,126425,649
2022-03-14,Santa Barbara,083,443738,85386,85396,4664,90060,667
2022-03-14,Santa Clara,085,1922200,308297,309600,12190,321790,2223
2022-03-14,Santa Cruz,087,273765,47427,47107,2063,49170,255
2022-03-14,Shasta,089,179085,30459,30462,6066,36528,520
2022-03-14,Sierra,091,2930,271,273,48,321,4
2022-03-14,Siskiyou,093,43540,4429,4419,2711,7130,76
2022-03-14,Solano,095,438530,81048,81233,5524,86757,440
2022-03-14,Sonoma,097,501317,82928,82731,2563,85294,473
2022-03-14,Stanislaus,099,539301,117148,118088,17496,135584,1567
2022-03-14,Sutter,101,95872,20399,20478,2029,22507,217
2022-03-14,Tehama,103,63373,11999,11996,2574,14570,160
2022-03-14,Trinity,105,12862,1182,1172,287,1459,20
2022-03-14,Tulare,107,460477,106068,104121,27435,131556,1365
2022-03-14,Tuolumne,109,53932,12624,12567,555,13122,180
2022-03-14,Ventura,111,848112,172506,172107,9336,181443,1442
2022-03-14,Yolo,113,214977,36786,36059,3017,39076,308
2022-03-14,Yuba,115,75493,15759,15748,1176,16924,116
2022-03-13,Alameda,001,1643700,254262,253547,13450,266997,1792
2022-03-13,Alpine,003,1148,122,122,1,123,0
2022-03-13,Amador,005,37829,8484,8444,638,9082,85
2022-03-13,Butte,007,227075,32965,32806,6893,39699,384
2022-03-13,Calaveras,009,45235,7227,7253,343,7596,118
2022-03-13,Colusa,011,21464,3432,3444,1045,4489,21
2022-03-13,Contra Costa,013,1133247,188967,186911,13036,199947,1265
2022-03-13,Del Norte,015,27424,5766,5808,178,5986,48
2022-03-13,El Dorado,017,186661,26618,26563,3192,29755,199
2022-03-13,Fresno,019,978130,230418,228421,23495,251916,2683
2022-03-13,Glenn,021,27897,4966,4966,1594,6560,44
2022-03-13,Humboldt,023,135768,16799,16883,2924,19807,137
2022-03-13,Imperial,025,180216,55209,54934,10523,65457,897
2022-03-13,Inyo,027,18085,4064,4062,467,4529,56
2022-03-13,Kern,029,883053,191295,190495,45595,236090,2166
2022-03-13,Kings,031,150075,51303,51273,3489,54762,437
2022-03-13,Lake,033,64148,10657,10626,878,11504,131
2022-03-13,Lassen,035,31185,8942,8929,871,9800,62
2022-03-13,Los Angeles,037,10098052,2699829,2683351,122530,2805881,31034
2022-03-13,Madera,039,155013,37165,37248,5998,43246,354
2022-03-13,Marin,041,260295,33159,33083,2168,35251,272
2022-03-13,Mariposa,043,17540,2381,2376,196,2572,6
2022-03-13,Mendocino,045,87422,12988,12987,2980,15967,117
2022-03-13,Merced,047,269075,61964,61895,8546,70441,795
2022-03-13,Modoc,049,8938,730,731,249,980,7
2022-03-13,Mono,051,14174,2962,2961,120,3081,5
2022-03-13,Monterey,053,433212,78960,78366,13418,91784,718
2022-03-13,Napa,055,140530,25651,25639,936,26575,138
2022-03-13,Nevada,057,99092,15883,15959,1183,17142,123
2022-03-13,Orange,059,3164182,544445,543036,40869,583905,6774
2022-03-13,Placer,061,380077,62449,62372,7292,69664,601
2022-03-13,Plumas,063,18699,2960,2711,359,3070,13
2022-03-13,Riverside,065,2383286,589549,588487,27602,616089,6332
2022-03-13,Sacramento,067,1510023,279347,274715,26277,300992,2899
2022-03-13,San Benito,069,59416,12835,12844,505,13349,95
2022-03-13,San Bernardino,071,2135413,571117,559450,24683,584133,6767
2022-03-13,San Diego,073,3302833,747442,745515,52191,797706,5108
2022-03-13,San Francisco,075,870044,122973,123622,8115,131737,824
2022-03-13,San Joaquin,077,732212,165761,165641,9818,175459,2142
2022-03-13,San Luis Obispo,079,281455,52168,52040,3707,55747,458
2022-03-13,San Mateo,081,765935,120563,119521,6852,126373,649
2022-03-13,Santa Barbara,083,443738,85346,85453,4662,90115,667
2022-03-13,Santa Clara,085,1922200,308128,309493,12182,321675,2225
2022-03-13,Santa Cruz,087,273765,47375,47087,2063,49150,255
2022-03-13,Shasta,089,179085,30442,30457,6064,36521,520
2022-03-13,Sierra,091,2930,271,273,48,321,4
2022-03-13,Siskiyou,093,43540,4429,4418,2711,7129,76
2022-03-13,Solano,095,438530,81013,81217,5519,86736,440
2022-03-13,Sonoma,097,501317,82893,82711,2559,85270,473
2022-03-13,Stanislaus,099,539301,117115,118075,17493,135568,1567
2022-03-13,Sutter,101,95872,20395,20474,2029,22503,217
2022-03-13,Tehama,103,63373,11998,11997,2573,14570,160
2022-03-13,Trinity,105,12862,1182,1172,287,1459,20
2022-03-13,Tulare,107,460477,106035,104119,27427,131546,1365
2022-03-13,Tuolumne,109,53932,12621,12565,555,13120,180
2022-03-13,Ventura,111,848112,172448,172080,9329,181409,1442
2022-03-13,Yolo,113,214977,36767,36019,3015,39034,308
2022-03-13,Yuba,115,75493,15754,15741,1176,16917,116
2022-03-12,Alameda,001,1643700,254194,253079,13445,266524,1783
2022-03-12,Alpine,003,1148,122,122,1,123,0
2022-03-12,Amador,005,37829,8480,8427,638,9065,84
2022-03-12,Butte,007,227075,32961,32774,6891,39665,380
2022-03-12,Calaveras,009,45235,7226,7253,343,7596,118
2022-03-12,Colusa,011,21464,3432,3440,1045,4485,21
2022-03-12,Contra Costa,013,1133247,188925,186618,13035,199653,1256
2022-03-12,Del Norte,015,27424,5765,5791,178,5969,48
2022-03-12,El Dorado,017,186661,26614,26538,3192,29730,199
2022-03-12,Fresno,019,978130,230396,228041,23495,251536,2653
2022-03-12,Glenn,021,27897,4966,4955,1594,6549,44
2022-03-12,Humboldt,023,135768,16795,16862,2923,19785,137
2022-03-12,Imperial,025,180216,55204,54837,10520,65357,896
2022-03-12,Inyo,027,18085,4064,4056,467,4523,56
2022-03-12,Kern,029,883053,191278,190330,45590,235920,2162
2022-03-12,Kings,031,150075,51297,51145,3489,54634,436
2022-03-12,Lake,033,64148,10655,10594,877,11471,131
2022-03-12,Lassen,035,31185,8941,8915,871,9786,62
2022-03-12,Los Angeles,037,10098052,2699500,2678858,122510,2801368,30901
2022-03-12,Madera,039,155013,37160,37223,5998,43221,354
2022-03-12,Marin,041,260295,33135,33015,2167,35182,272
2022-03-12,Mariposa,043,17540,2381,2372,196,2568,6
2022-03-12,Mendocino,045,87422,12984,12965,2980,15945,117
2022-03-12,Merced,047,269075,61957,61840,8545,70385,795
2022-03-12,Modoc,049,8938,730,730,249,979,7
2022-03-12,Mono,051,14174,2962,2960,119,3079,5
2022-03-12,Monterey,053,433212,78953,78285,13416,91701,716
2022-03-12,Napa,055,140530,25641,25584,935,26519,138
2022-03-12,Nevada,057,99092,15877,15947,1183,17130,123
2022-03-12,Orange,059,3164182,544381,542354,40860,583214,6718
2022-03-12,Placer,061,380077,62440,62282,7292,69574,598
2022-03-12,Plumas,063,18699,2960,2707,359,3066,13
2022-03-12,Riverside,065,2383286,589484,588022,27597,615619,6317
2022-03-12,Sacramento,067,1510023,279307,274519,26273,300792,2886
2022-03-12,San Benito,069,59416,12832,12868,505,13373,95
2022-03-12,San Bernardino,071,2135413,571073,559013,24682,583695,6734
2022-03-12,San Diego,073,3302833,747320,744386,52169,796555,5090
2022-03-12,San Francisco,075,870044,122908,123610,8109,131719,823
2022-03-12,San Joaquin,077,732212,165744,165516,9815,175331,2117
2022-03-12,San Luis Obispo,079,281455,52159,51947,3704,55651,457
2022-03-12,San Mateo,081,765935,120527,119288,6851,126139,641
2022-03-12,Santa Barbara,083,443738,85327,85421,4662,90083,664
2022-03-12,Santa Clara,085,1922200,308030,308989,12177,321166,2208
2022-03-12,Santa Cruz,087,273765,47362,46982,2062,49044,254
2022-03-12,Shasta,089,179085,30430,30419,6062,36481,517
2022-03-12,Sierra,091,2930,271,273,48,321,4
2022-03-12,Siskiyou,093,43540,4429,4405,2711,7116,75
2022-03-12,Solano,095,438530,80999,81058,5519,86577,436
2022-03-12,Sonoma,097,501317,82876,82622,2557,85179,473
2022-03-12,Stanislaus,099,539301,117101,117884,17492,135376,1564
2022-03-12,Sutter,101,95872,20394,20429,2029,22458,217
2022-03-12,Tehama,103,63373,11998,11983,2573,14556,159
2022-03-12,Trinity,105,12862,1181,1172,287,1459,20
2022-03-12,Tulare,107,460477,106030,103994,27423,131417,1358
2022-03-12,Tuolumne,109,53932,12620,12476,555,13031,180
2022-03-12,Ventura,111,848112,172423,171932,9328,181260,1442
2022-03-12,Yolo,113,214977,36760,35982,3013,38995,308
2022-03-12,Yuba,115,75493,15754,15722,1176,16898,116
2022-03-11,Alameda,001,1643700,254129,253079,13445,266524,1783
2022-03-11,Alpine,003,1148,122,122,1,123,0
2022-03-11,Amador,005,37829,8478,8427,638,9065,84
2022-03-11,Butte,007,227075,32957,32774,6890,39664,380
2022-03-11,Calaveras,009,45235,7226,7253,343,7596,118
2022-03-11,Colusa,011,21464,3432,3440,1045,4485,21
2022-03-11,Contra Costa,013,1133247,188877,186618,13033,199651,1256
2022-03-11,Del Norte,015,27424,5761,5791,178,5969,48
2022-03-11,El Dorado,017,186661,26610,26538,3192,29730,199
2022-03-11,Fresno,019,978130,230341,228041,23491,251532,2653
2022-03-11,Glenn,021,27897,4966,4955,1594,6549,44
2022-03-11,Humboldt,023,135768,16790,16862,2922,19784,137
2022-03-11,Imperial,025,180216,55198,54837,10519,65356,896
2022-03-11,Inyo,027,18085,4064,4056,467,4523,56
2022-03-11,Kern,029,883053,191257,190330,45585,235915,2162
2022-03-11,Kings,031,150075,51277,51145,3489,54634,436
2022-03-11,Lake,033,64148,10651,10594,877,11471,131
2022-03-11,Lassen,035,31185,8940,8915,871,9786,62
2022-03-11,Los Angeles,037,10098052,2699177,2678858,122485,2801343,30901
2022-03-11,Madera,039,155013,37155,37223,5998,43221,354
2022-03-11,Marin,041,260295,33119,33015,2166,35181,272
2022-03-11,Mariposa,043,17540,2380,2372,196,2568,6
2022-03-11,Mendocino,045,87422,12978,12965,2980,15945,117
2022-03-11,Merced,047,269075,61947,61840,8543,70383,795
2022-03-11,Modoc,049,8938,730,730,249,979,7
2022-03-11,Mono,051,14174,2961,2960,119,3079,5
2022-03-11,Monterey,053,433212,78940,78285,13409,91694,716
2022-03-11,Napa,055,140530,25630,25584,935,26519,138
2022-03-11,Nevada,057,99092,15874,15947,1183,17130,123
2022-03-11,Orange,059,3164182,544312,542354,40846,583200,6718
2022-03-11,Placer,061,380077,62429,62282,7291,69573,598
2022-03-11,Plumas,063,18699,2958,2707,359,3066,13
2022-03-11,Riverside,065,2383286,589407,588022,27593,615615,6317
2022-03-11,Sacramento,067,1510023,279239,274519,26270,300789,2886
2022-03-11,San Benito,069,59416,12831,12868,505,13373,95
2022-03-11,San Bernardino,071,2135413,571016,559013,24677,583690,6734
2022-03-11,San Diego,073,3302833,747154,744386,52155,796541,5090
2022-03-11,San Francisco,075,870044,122857,123610,8105,131715,823
2022-03-11,San Joaquin,077,732212,165710,165516,9812,175328,2117
2022-03-11,San Luis Obispo,079,281455,52151,51947,3703,55650,457
2022-03-11,San Mateo,081,765935,120478,119288,6848,126136,641
2022-03-11,Santa Barbara,083,443738,85307,85421,4661,90082,664
2022-03-11,Santa Clara,085,1922200,307930,308989,12174,321163,2208
2022-03-11,Santa Cruz,087,273765,47347,46982,2062,49044,254
2022-03-11,Shasta,089,179085,30425,30419,6059,36478,517
2022-03-11,Sierra,091,2930,271,273,48,321,4
2022-03-11,Siskiyou,093,43540,4427,4405,2709,7114,75
2022-03-11,Solano,095,438530,80985,81058,5518,86576,436
2022-03-11,Sonoma,097,501317,82851,82622,2555,85177,473
2022-03-11,Stanislaus,099,539301,117087,117884,17491,135375,1564
2022-03-11,Sutter,101,95872,20392,20429,2029,22458,217
2022-03-11,Tehama,103,63373,11996,11983,2573,14556,159
2022-03-11,Trinity,105,12862,1181,1172,287,1459,20
2022-03-11,Tulare,107,460477,106015,103994,27417,131411,1358
2022-03-11,Tuolumne,109,53932,12618,12476,555,13031,180
2022-03-11,Ventura,111,848112,172387,171932,9323,181255,1442
2022-03-11,Yolo,113,214977,36749,35982,3013,38995,308
2022-03-11,Yuba,115,75493,15751,15722,1176,16898,116
2022-03-10,Alameda,001,1643700,254018,253079,13439,266518,1783
2022-03-10,Alpine,003,1148,122,122,1,123,0
2022-03-10,Amador,005,37829,8477,8427,638,9065,84
2022-03-10,Butte,007,227075,32943,32774,6888,39662,380
2022-03-10,Calaveras,009,45235,7225,7253,342,7595,118
2022-03-10,Colusa,011,21464,3432,3440,1045,4485,21
2022-03-10,Contra Costa,013,1133247,188793,186618,13023,199641,1256
2022-03-10,Del Norte,015,27424,5752,5791,178,5969,48
2022-03-10,El Dorado,017,186661,26598,26538,3191,29729,199
2022-03-10,Fresno,019,978130,230267,228041,23481,251522,2653
2022-03-10,Glenn,021,27897,4964,4955,1594,6549,44
2022-03-10,Humboldt,023,135768,16780,16862,2921,19783,137
2022-03-10,Imperial,025,180216,55188,54837,10518,65355,896
2022-03-10,Inyo,027,18085,4063,4056,467,4523,56
2022-03-10,Kern,029,883053,191224,190330,45571,235901,2162
2022-03-10,Kings,031,150075,51248,51145,3488,54633,436
2022-03-10,Lake,033,64148,10641,10594,876,11470,131
2022-03-10,Lassen,035,31185,8940,8915,871,9786,62
2022-03-10,Los Angeles,037,10098052,2698622,2678858,122446,2801304,30901
2022-03-10,Madera,039,155013,37149,37223,5991,43214,354
2022-03-10,Marin,041,260295,33106,33015,2162,35177,272
2022-03-10,Mariposa,043,17540,2380,2372,196,2568,6
2022-03-10,Mendocino,045,87422,12975,12965,2980,15945,117
2022-03-10,Merced,047,269075,61931,61840,8538,70378,795
2022-03-10,Modoc,049,8938,729,730,249,979,7
2022-03-10,Mono,051,14174,2961,2960,119,3079,5
2022-03-10,Monterey,053,433212,78917,78285,13384,91669,716
2022-03-10,Napa,055,140530,25621,25584,934,26518,138
2022-03-10,Nevada,057,99092,15867,15947,1183,17130,123
2022-03-10,Orange,059,3164182,544190,542354,40829,583183,6718
2022-03-10,Placer,061,380077,62407,62282,7286,69568,598
2022-03-10,Plumas,063,18699,2957,2707,359,3066,13
2022-03-10,Riverside,065,2383286,589292,588022,27588,615610,6317
2022-03-10,Sacramento,067,1510023,279162,274519,26264,300783,2886
2022-03-10,San Benito,069,59416,12830,12868,504,13372,95
2022-03-10,San Bernardino,071,2135413,570943,559013,24673,583686,6734
2022-03-10,San Diego,073,3302833,746896,744386,52124,796510,5090
2022-03-10,San Francisco,075,870044,122789,123610,8099,131709,823
2022-03-10,San Joaquin,077,732212,165679,165516,9810,175326,2117
2022-03-10,San Luis Obispo,079,281455,52128,51947,3700,55647,457
2022-03-10,San Mateo,081,765935,120415,119288,6846,126134,641
2022-03-10,Santa Barbara,083,443738,85273,85421,4660,90081,664
2022-03-10,Santa Clara,085,1922200,307804,308989,12166,321155,2208
2022-03-10,Santa Cruz,087,273765,47315,46982,2062,49044,254
2022-03-10,Shasta,089,179085,30416,30419,6057,36476,517
2022-03-10,Sierra,091,2930,271,273,48,321,4
2022-03-10,Siskiyou,093,43540,4427,4405,2709,7114,75
2022-03-10,Solano,095,438530,80949,81058,5513,86571,436
2022-03-10,Sonoma,097,501317,82824,82622,2555,85177,473
2022-03-10,Stanislaus,099,539301,117052,117884,17489,135373,1564
2022-03-10,Sutter,101,95872,20388,20429,2029,22458,217
2022-03-10,Tehama,103,63373,11995,11983,2573,14556,159
2022-03-10,Trinity,105,12862,1181,1172,287,1459,20
2022-03-10,Tulare,107,460477,105997,103994,27411,131405,1358
2022-03-10,Tuolumne,109,53932,12615,12476,555,13031,180
2022-03-10,Ventura,111,848112,172346,171932,9320,181252,1442
2022-03-10,Yolo,113,214977,36736,35982,3012,38994,308
2022-03-10,Yuba,115,75493,15741,15722,1175,16897,116
2022-03-09,Alameda,001,1643700,253895,252893,13434,266327,1781
2022-03-09,Alpine,003,1148,122,125,1,126,0
2022-03-09,Amador,005,37829,8471,8409,638,9047,84
2022-03-09,Butte,007,227075,32934,32767,6884,39651,380
2022-03-09,Calaveras,009,45235,7223,7249,342,7591,117
2022-03-09,Colusa,011,21464,3431,3439,1045,4484,21
2022-03-09,Contra Costa,013,1133247,188699,186483,13008,199491,1256
2022-03-09,Del Norte,015,27424,5748,5765,178,5943,48
2022-03-09,El Dorado,017,186661,26593,26515,3191,29706,198
2022-03-09,Fresno,019,978130,230169,227885,23474,251359,2653
2022-03-09,Glenn,021,27897,4962,4953,1593,6546,44
2022-03-09,Humboldt,023,135768,16775,16854,2918,19772,137
2022-03-09,Imperial,025,180216,55183,54764,10516,65280,894
2022-03-09,Inyo,027,18085,4063,4056,467,4523,56
2022-03-09,Kern,029,883053,191176,190254,45559,235813,2159
2022-03-09,Kings,031,150075,51227,51122,3488,54610,435
2022-03-09,Lake,033,64148,10634,10586,876,11462,130
2022-03-09,Lassen,035,31185,8940,8901,871,9772,62
2022-03-09,Los Angeles,037,10098052,2697974,2677901,122407,2800308,30842
2022-03-09,Madera,039,155013,37142,37207,5990,43197,354
2022-03-09,Marin,041,260295,33088,32967,2162,35129,272
2022-03-09,Mariposa,043,17540,2377,2372,196,2568,6
2022-03-09,Mendocino,045,87422,12971,12957,2975,15932,117
2022-03-09,Merced,047,269075,61916,61792,8532,70324,792
2022-03-09,Modoc,049,8938,728,730,248,978,7
2022-03-09,Mono,051,14174,2961,2962,119,3081,5
2022-03-09,Monterey,053,433212,78895,78258,13341,91599,716
2022-03-09,Napa,055,140530,25600,25561,933,26494,138
2022-03-09,Nevada,057,99092,15858,15938,1182,17120,123
2022-03-09,Orange,059,3164182,544060,542278,40817,583095,6700
2022-03-09,Placer,061,380077,62386,62242,7282,69524,598
2022-03-09,Plumas,063,18699,2956,2708,359,3067,13
2022-03-09,Riverside,065,2383286,589196,587833,27578,615411,6305
2022-03-09,Sacramento,067,1510023,279078,274373,26248,300621,2877
2022-03-09,San Benito,069,59416,12827,12864,504,13368,95
2022-03-09,San Bernardino,071,2135413,570850,558795,24662,583457,6723
2022-03-09,San Diego,073,3302833,746625,743956,52097,796053,5083
2022-03-09,San Francisco,075,870044,122699,123676,8095,131771,812
2022-03-09,San Joaquin,077,732212,165639,165444,9804,175248,2113
2022-03-09,San Luis Obispo,079,281455,52109,51923,3698,55621,457
2022-03-09,San Mateo,081,765935,120357,119194,6834,126028,639
2022-03-09,Santa Barbara,083,443738,85257,85382,4658,90040,661
2022-03-09,Santa Clara,085,1922200,307667,308765,12156,320921,2206
2022-03-09,Santa Cruz,087,273765,47275,46917,2061,48978,254
2022-03-09,Shasta,089,179085,30394,30407,6056,36463,493
2022-03-09,Sierra,091,2930,271,273,48,321,4
2022-03-09,Siskiyou,093,43540,4425,4403,2708,7111,75
2022-03-09,Solano,095,438530,80913,80984,5512,86496,436
2022-03-09,Sonoma,097,501317,82791,82574,2553,85127,473
2022-03-09,Stanislaus,099,539301,117015,117827,17484,135311,1541
2022-03-09,Sutter,101,95872,20377,20409,2025,22434,217
2022-03-09,Tehama,103,63373,11991,11980,2573,14553,159
2022-03-09,Trinity,105,12862,1181,1174,287,1461,20
2022-03-09,Tulare,107,460477,105969,103932,27398,131330,1350
2022-03-09,Tuolumne,109,53932,12613,12444,555,12999,180
2022-03-09,Ventura,111,848112,172296,171852,9317,181169,1448
2022-03-09,Yolo,113,214977,36717,35973,3000,38973,308
2022-03-09,Yuba,115,75493,15736,15714,1174,16888,115
2022-03-08,Alameda,001,1643700,253741,252744,13422,266166,1769
2022-03-08,Alpine,003,1148,122,125,1,126,0
2022-03-08,Amador,005,37829,8457,8407,638,9045,84
2022-03-08,Butte,007,227075,32921,32759,6880,39639,380
2022-03-08,Calaveras,009,45235,7219,7245,342,7587,117
2022-03-08,Colusa,011,21464,3428,3439,1044,4483,21
2022-03-08,Contra Costa,013,1133247,188612,186396,12995,199391,1256
2022-03-08,Del Norte,015,27424,5743,5763,178,5941,48
2022-03-08,El Dorado,017,186661,26583,26503,3185,29688,197
2022-03-08,Fresno,019,978130,230071,227808,23465,251273,2653
2022-03-08,Glenn,021,27897,4961,4944,1592,6536,43
2022-03-08,Humboldt,023,135768,16763,16837,2905,19742,137
2022-03-08,Imperial,025,180216,55168,54721,10514,65235,890
2022-03-08,Inyo,027,18085,4060,4056,467,4523,56
2022-03-08,Kern,029,883053,191112,190208,45545,235753,2154
2022-03-08,Kings,031,150075,51185,51089,3486,54575,434
2022-03-08,Lake,033,64148,10624,10571,876,11447,130
2022-03-08,Lassen,035,31185,8939,8897,871,9768,62
2022-03-08,Los Angeles,037,10098052,2697281,2677166,122369,2799535,30803
2022-03-08,Madera,039,155013,37132,37185,5989,43174,354
2022-03-08,Marin,041,260295,33051,32943,2161,35104,272
2022-03-08,Mariposa,043,17540,2375,2371,196,2567,6
2022-03-08,Mendocino,045,87422,12967,12950,2974,15924,117
2022-03-08,Merced,047,269075,61897,61767,8522,70289,791
2022-03-08,Modoc,049,8938,727,729,248,977,7
2022-03-08,Mono,051,14174,2960,2961,119,3080,5
2022-03-08,Monterey,053,433212,78875,78247,13304,91551,711
2022-03-08,Napa,055,140530,25574,25528,932,26460,137
2022-03-08,Nevada,057,99092,15847,15939,1181,17120,122
2022-03-08,Orange,059,3164182,543915,542164,40797,582961,6692
2022-03-08,Placer,061,380077,62359,62221,7281,69502,594
2022-03-08,Plumas,063,18699,2956,2703,359,3062,13
2022-03-08,Riverside,065,2383286,589088,587686,27571,615257,6294
2022-03-08,Sacramento,067,1510023,278984,274276,26229,300505,2872
2022-03-08,San Benito,069,59416,12825,12855,504,13359,94
2022-03-08,San Bernardino,071,2135413,570757,558512,24653,583165,6715
2022-03-08,San Diego,073,3302833,746281,743604,52080,795684,5077
2022-03-08,San Francisco,075,870044,122610,123675,8090,131765,807
2022-03-08,San Joaquin,077,732212,165604,165381,9800,175181,2104
2022-03-08,San Luis Obispo,079,281455,52081,51900,3695,55595,451
2022-03-08,San Mateo,081,765935,120276,119103,6824,125927,638
2022-03-08,Santa Barbara,083,443738,85225,85363,4658,90021,659
2022-03-08,Santa Clara,085,1922200,307458,308528,12148,320676,2206
2022-03-08,Santa Cruz,087,273765,47238,46875,2060,48935,254
2022-03-08,Shasta,089,179085,30375,30372,6053,36425,493
2022-03-08,Sierra,091,2930,271,273,48,321,4
2022-03-08,Siskiyou,093,43540,4421,4404,2708,7112,74
2022-03-08,Solano,095,438530,80885,80924,5509,86433,434
2022-03-08,Sonoma,097,501317,82743,82571,2552,85123,473
2022-03-08,Stanislaus,099,539301,116971,117782,17475,135257,1541
2022-03-08,Sutter,101,95872,20369,20403,2025,22428,217
2022-03-08,Tehama,103,63373,11987,11972,2572,14544,158
2022-03-08,Trinity,105,12862,1181,1174,287,1461,20
2022-03-08,Tulare,107,460477,105930,103893,27387,131280,1334
2022-03-08,Tuolumne,109,53932,12608,12427,553,12980,180
2022-03-08,Ventura,111,848112,172232,171806,9310,181116,1447
2022-03-08,Yolo,113,214977,36691,35946,2999,38945,306
2022-03-08,Yuba,115,75493,15731,15705,1173,16878,115
2022-03-07,Alameda,001,1643700,253538,252578,13407,265985,1766
2022-03-07,Alpine,003,1148,122,125,1,126,0
2022-03-07,Amador,005,37829,8454,8368,638,9006,84
2022-03-07,Butte,007,227075,32906,32734,6876,39610,378
2022-03-07,Calaveras,009,45235,7215,7242,342,7584,116
2022-03-07,Colusa,011,21464,3426,3437,1044,4481,21
2022-03-07,Contra Costa,013,1133247,188513,186087,12974,199061,1256
2022-03-07,Del Norte,015,27424,5739,5758,178,5936,48
2022-03-07,El Dorado,017,186661,26577,26487,3184,29671,196
2022-03-07,Fresno,019,978130,229981,227670,23442,251112,2653
2022-03-07,Glenn,021,27897,4955,4939,1592,6531,43
2022-03-07,Humboldt,023,135768,16749,16829,2900,19729,137
2022-03-07,Imperial,025,180216,55146,54712,10509,65221,890
2022-03-07,Inyo,027,18085,4058,4054,467,4521,56
2022-03-07,Kern,029,883053,191055,190163,45522,235685,2152
2022-03-07,Kings,031,150075,51155,51065,3481,54546,433
2022-03-07,Lake,033,64148,10612,10562,875,11437,130
2022-03-07,Lassen,035,31185,8938,8896,871,9767,62
2022-03-07,Los Angeles,037,10098052,2696471,2675497,122330,2797827,30759
2022-03-07,Madera,039,155013,37122,37164,5987,43151,354
2022-03-07,Marin,041,260295,33013,32919,2158,35077,272
2022-03-07,Mariposa,043,17540,2374,2369,196,2565,6
2022-03-07,Mendocino,045,87422,12960,12940,2973,15913,117
2022-03-07,Merced,047,269075,61857,61751,8515,70266,791
2022-03-07,Modoc,049,8938,727,729,248,977,7
2022-03-07,Mono,051,14174,2960,2960,119,3079,5
2022-03-07,Monterey,053,433212,78841,78161,13256,91417,706
2022-03-07,Napa,055,140530,25544,25500,932,26432,136
2022-03-07,Nevada,057,99092,15840,15935,1175,17110,122
2022-03-07,Orange,059,3164182,543744,542028,40771,582799,6687
2022-03-07,Placer,061,380077,62330,62215,7280,69495,591
2022-03-07,Plumas,063,18699,2956,2702,359,3061,13
2022-03-07,Riverside,065,2383286,588959,587537,27563,615100,6279
2022-03-07,Sacramento,067,1510023,278883,274079,26216,300295,2866
2022-03-07,San Benito,069,59416,12819,12843,504,13347,94
2022-03-07,San Bernardino,071,2135413,570651,558265,24643,582908,6703
2022-03-07,San Diego,073,3302833,745939,742287,52037,794324,5068
2022-03-07,San Francisco,075,870044,122497,123655,8084,131739,807
2022-03-07,San Joaquin,077,732212,165554,165343,9793,175136,2091
2022-03-07,San Luis Obispo,079,281455,52037,51874,3692,55566,448
2022-03-07,San Mateo,081,765935,120201,119035,6817,125852,630
2022-03-07,Santa Barbara,083,443738,85187,85345,4657,90002,659
2022-03-07,Santa Clara,085,1922200,307271,308517,12142,320659,2202
2022-03-07,Santa Cruz,087,273765,47188,46823,2059,48882,254
2022-03-07,Shasta,089,179085,30362,30352,6050,36402,493
2022-03-07,Sierra,091,2930,271,273,48,321,4
2022-03-07,Siskiyou,093,43540,4417,4398,2707,7105,74
2022-03-07,Solano,095,438530,80828,80886,5507,86393,435
2022-03-07,Sonoma,097,501317,82700,82530,2551,85081,473
2022-03-07,Stanislaus,099,539301,116932,117713,17468,135181,1537
2022-03-07,Sutter,101,95872,20358,20400,2024,22424,217
2022-03-07,Tehama,103,63373,11981,11966,2571,14537,158
2022-03-07,Trinity,105,12862,1179,1173,287,1460,20
2022-03-07,Tulare,107,460477,105893,103834,27377,131211,1316
2022-03-07,Tuolumne,109,53932,12602,12408,552,12960,179
2022-03-07,Ventura,111,848112,172181,171886,9308,181194,1436
2022-03-07,Yolo,113,214977,36668,35934,2993,38927,306
2022-03-07,Yuba,115,75493,15724,15701,1172,16873,115
2022-03-06,Alameda,001,1643700,253351,252460,13398,265858,1766
2022-03-06,Alpine,003,1148,122,125,1,126,0
2022-03-06,Amador,005,37829,8451,8367,636,9003,84
2022-03-06,Butte,007,227075,32894,32714,6871,39585,376
2022-03-06,Calaveras,009,45235,7213,7236,341,7577,116
2022-03-06,Colusa,011,21464,3426,3435,1043,4478,21
2022-03-06,Contra Costa,013,1133247,188399,185974,12949,198923,1256
2022-03-06,Del Norte,015,27424,5723,5744,177,5921,48
2022-03-06,El Dorado,017,186661,26568,26478,3182,29660,196
2022-03-06,Fresno,019,978130,229838,227514,23432,250946,2653
2022-03-06,Glenn,021,27897,4951,4939,1592,6531,43
2022-03-06,Humboldt,023,135768,16739,16813,2897,19710,137
2022-03-06,Imperial,025,180216,55128,54719,10499,65218,890
2022-03-06,Inyo,027,18085,4056,4053,467,4520,56
2022-03-06,Kern,029,883053,191000,190088,45502,235590,2152
2022-03-06,Kings,031,150075,51085,51050,3479,54529,432
2022-03-06,Lake,033,64148,10598,10539,874,11413,130
2022-03-06,Lassen,035,31185,8925,8887,870,9757,62
2022-03-06,Los Angeles,037,10098052,2695539,2675456,122273,2797729,30759
2022-03-06,Madera,039,155013,37092,37135,5980,43115,354
2022-03-06,Marin,041,260295,32987,32879,2157,35036,272
2022-03-06,Mariposa,043,17540,2373,2365,195,2560,6
2022-03-06,Mendocino,045,87422,12948,12923,2969,15892,116
2022-03-06,Merced,047,269075,61825,61722,8498,70220,791
2022-03-06,Modoc,049,8938,727,729,248,977,7
2022-03-06,Mono,051,14174,2960,2959,119,3078,5
2022-03-06,Monterey,053,433212,78795,78154,13225,91379,706
2022-03-06,Napa,055,140530,25509,25457,930,26387,136
2022-03-06,Nevada,057,99092,15829,15924,1174,17098,122
2022-03-06,Orange,059,3164182,543587,541903,40725,582628,6688
2022-03-06,Placer,061,380077,62297,62185,7276,69461,591
2022-03-06,Plumas,063,18699,2951,2704,359,3063,13
2022-03-06,Riverside,065,2383286,588797,587388,27543,614931,6279
2022-03-06,Sacramento,067,1510023,278748,273935,26193,300128,2869
2022-03-06,San Benito,069,59416,12808,12835,503,13338,94
2022-03-06,San Bernardino,071,2135413,570529,558139,24631,582770,6701
2022-03-06,San Diego,073,3302833,745544,742287,51988,794275,5068
2022-03-06,San Francisco,075,870044,122364,123742,8081,131823,806
2022-03-06,San Joaquin,077,732212,165472,165252,9787,175039,2091
2022-03-06,San Luis Obispo,079,281455,51999,51828,3690,55518,448
2022-03-06,San Mateo,081,765935,120118,118916,6808,125724,630
2022-03-06,Santa Barbara,083,443738,85146,85317,4652,89969,659
2022-03-06,Santa Clara,085,1922200,307012,308250,12140,320390,2201
2022-03-06,Santa Cruz,087,273765,47137,46755,2058,48813,254
2022-03-06,Shasta,089,179085,30339,30332,6034,36366,493
2022-03-06,Sierra,091,2930,271,273,48,321,4
2022-03-06,Siskiyou,093,43540,4413,4398,2705,7103,74
2022-03-06,Solano,095,438530,80772,80833,5501,86334,435
2022-03-06,Sonoma,097,501317,82665,82458,2547,85005,473
2022-03-06,Stanislaus,099,539301,116886,117680,17458,135138,1536
2022-03-06,Sutter,101,95872,20347,20390,2020,22410,217
2022-03-06,Tehama,103,63373,11973,11963,2571,14534,158
2022-03-06,Trinity,105,12862,1179,1172,286,1458,20
2022-03-06,Tulare,107,460477,105836,103794,27365,131159,1316
2022-03-06,Tuolumne,109,53932,12596,12379,550,12929,179
2022-03-06,Ventura,111,848112,172112,171819,9306,181125,1436
2022-03-06,Yolo,113,214977,36642,35882,2990,38872,306
2022-03-06,Yuba,115,75493,15720,15694,1171,16865,115
2022-03-05,Alameda,001,1643700,253235,251988,13393,265381,1760
2022-03-05,Alpine,003,1148,122,125,1,126,0
2022-03-05,Amador,005,37829,8448,8344,636,8980,83
2022-03-05,Butte,007,227075,32886,32663,6867,39530,372
2022-03-05,Calaveras,009,45235,7210,7236,341,7577,116
2022-03-05,Colusa,011,21464,3426,3433,1043,4476,21
2022-03-05,Contra Costa,013,1133247,188336,185734,12944,198678,1235
2022-03-05,Del Norte,015,27424,5720,5725,177,5902,48
2022-03-05,El Dorado,017,186661,26562,26446,3179,29625,193
2022-03-05,Fresno,019,978130,229786,227154,23431,250585,2640
2022-03-05,Glenn,021,27897,4949,4927,1592,6519,43
2022-03-05,Humboldt,023,135768,16733,16781,2895,19676,136
2022-03-05,Imperial,025,180216,55118,54650,10497,65147,880
2022-03-05,Inyo,027,18085,4055,4043,466,4509,56
2022-03-05,Kern,029,883053,190968,189817,45484,235301,2141
2022-03-05,Kings,031,150075,51078,50926,3478,54404,431
2022-03-05,Lake,033,64148,10590,10512,873,11385,130
2022-03-05,Lassen,035,31185,8917,8818,870,9688,62
2022-03-05,Los Angeles,037,10098052,2695180,2671564,122236,2793800,30608
2022-03-05,Madera,039,155013,37077,37100,5980,43080,354
2022-03-05,Marin,041,260295,32975,32829,2157,34986,272
2022-03-05,Mariposa,043,17540,2373,2363,195,2558,6
2022-03-05,Mendocino,045,87422,12945,12845,2969,15814,113
2022-03-05,Merced,047,269075,61815,61653,8498,70151,789
2022-03-05,Modoc,049,8938,727,729,248,977,7
2022-03-05,Mono,051,14174,2960,2961,119,3080,5
2022-03-05,Monterey,053,433212,78776,78028,13218,91246,704
2022-03-05,Napa,055,140530,25491,25405,930,26335,134
2022-03-05,Nevada,057,99092,15825,15907,1174,17081,122
2022-03-05,Orange,059,3164182,543462,541463,40714,582177,6638
2022-03-05,Placer,061,380077,62283,62117,7269,69386,591
2022-03-05,Plumas,063,18699,2950,2701,359,3060,13
2022-03-05,Riverside,065,2383286,588706,586785,27539,614324,6239
2022-03-05,Sacramento,067,1510023,278684,273487,26188,299675,2847
2022-03-05,San Benito,069,59416,12806,12820,503,13323,94
2022-03-05,San Bernardino,071,2135413,570471,557421,24625,582046,6641
2022-03-05,San Diego,073,3302833,745354,740747,51977,792724,5045
2022-03-05,San Francisco,075,870044,122295,123537,8078,131615,798
2022-03-05,San Joaquin,077,732212,165431,165085,9779,174864,2069
2022-03-05,San Luis Obispo,079,281455,51991,51739,3689,55428,446
2022-03-05,San Mateo,081,765935,120063,118646,6804,125450,621
2022-03-05,Santa Barbara,083,443738,85131,85249,4652,89901,655
2022-03-05,Santa Clara,085,1922200,306895,307689,12137,319826,2195
2022-03-05,Santa Cruz,087,273765,47117,46622,2058,48680,253
2022-03-05,Shasta,089,179085,30327,30282,6034,36316,492
2022-03-05,Sierra,091,2930,271,273,47,320,4
2022-03-05,Siskiyou,093,43540,4412,4389,2704,7093,74
2022-03-05,Solano,095,438530,80755,80690,5501,86191,435
2022-03-05,Sonoma,097,501317,82643,82313,2547,84860,473
2022-03-05,Stanislaus,099,539301,116860,117501,17456,134957,1531
2022-03-05,Sutter,101,95872,20339,20346,2020,22366,217
2022-03-05,Tehama,103,63373,11971,11939,2571,14510,158
2022-03-05,Trinity,105,12862,1179,1170,284,1454,20
2022-03-05,Tulare,107,460477,105823,103534,27356,130890,1305
2022-03-05,Tuolumne,109,53932,12592,12325,549,12874,178
2022-03-05,Ventura,111,848112,172071,171666,9304,180970,1436
2022-03-05,Yolo,113,214977,36628,35856,2990,38846,306
2022-03-05,Yuba,115,75493,15712,15666,1171,16837,115
2022-03-04,Alameda,001,1643700,253139,251988,13385,265373,1760
2022-03-04,Alpine,003,1148,122,125,1,126,0
2022-03-04,Amador,005,37829,8447,8344,636,8980,83
2022-03-04,Butte,007,227075,32880,32663,6862,39525,372
2022-03-04,Calaveras,009,45235,7209,7236,341,7577,116
2022-03-04,Colusa,011,21464,3424,3433,1043,4476,21
2022-03-04,Contra Costa,013,1133247,188268,185734,12941,198675,1235
2022-03-04,Del Norte,015,27424,5710,5725,177,5902,48
2022-03-04,El Dorado,017,186661,26558,26446,3179,29625,193
2022-03-04,Fresno,019,978130,229723,227154,23424,250578,2640
2022-03-04,Glenn,021,27897,4948,4927,1592,6519,43
2022-03-04,Humboldt,023,135768,16729,16781,2895,19676,136
2022-03-04,Imperial,025,180216,55111,54650,10493,65143,880
2022-03-04,Inyo,027,18085,4055,4043,466,4509,56
2022-03-04,Kern,029,883053,190926,189817,45474,235291,2141
2022-03-04,Kings,031,150075,51065,50926,3478,54404,431
2022-03-04,Lake,033,64148,10589,10512,873,11385,130
2022-03-04,Lassen,035,31185,8915,8818,870,9688,62
2022-03-04,Los Angeles,037,10098052,2694652,2671564,122207,2793771,30608
2022-03-04,Madera,039,155013,37068,37100,5980,43080,354
2022-03-04,Marin,041,260295,32953,32829,2155,34984,272
2022-03-04,Mariposa,043,17540,2368,2363,195,2558,6
2022-03-04,Mendocino,045,87422,12939,12845,2969,15814,113
2022-03-04,Merced,047,269075,61803,61653,8496,70149,789
2022-03-04,Modoc,049,8938,727,729,248,977,7
2022-03-04,Mono,051,14174,2960,2961,119,3080,5
2022-03-04,Monterey,053,433212,78756,78028,13212,91240,704
2022-03-04,Napa,055,140530,25476,25405,929,26334,134
2022-03-04,Nevada,057,99092,15820,15907,1174,17081,122
2022-03-04,Orange,059,3164182,543343,541463,40696,582159,6638
2022-03-04,Placer,061,380077,62271,62117,7266,69383,591
2022-03-04,Plumas,063,18699,2950,2701,358,3059,13
2022-03-04,Riverside,065,2383286,588619,586785,27538,614323,6239
2022-03-04,Sacramento,067,1510023,278611,273487,26185,299672,2847
2022-03-04,San Benito,069,59416,12802,12820,503,13323,94
2022-03-04,San Bernardino,071,2135413,570389,557421,24624,582045,6641
2022-03-04,San Diego,073,3302833,745116,740747,51960,792707,5045
2022-03-04,San Francisco,075,870044,122230,123537,8071,131608,798
2022-03-04,San Joaquin,077,732212,165399,165085,9778,174863,2069
2022-03-04,San Luis Obispo,079,281455,51982,51739,3688,55427,446
2022-03-04,San Mateo,081,765935,120005,118646,6802,125448,621
2022-03-04,Santa Barbara,083,443738,85108,85249,4652,89901,655
2022-03-04,Santa Clara,085,1922200,306745,307689,12134,319823,2195
2022-03-04,Santa Cruz,087,273765,47095,46622,2058,48680,253
2022-03-04,Shasta,089,179085,30319,30282,6031,36313,492
2022-03-04,Sierra,091,2930,271,273,47,320,4
2022-03-04,Siskiyou,093,43540,4410,4389,2700,7089,74
2022-03-04,Solano,095,438530,80722,80690,5498,86188,435
2022-03-04,Sonoma,097,501317,82612,82313,2546,84859,473
2022-03-04,Stanislaus,099,539301,116841,117501,17454,134955,1531
2022-03-04,Sutter,101,95872,20335,20346,2020,22366,217
2022-03-04,Tehama,103,63373,11968,11939,2571,14510,158
2022-03-04,Trinity,105,12862,1179,1170,284,1454,20
2022-03-04,Tulare,107,460477,105804,103534,27351,130885,1305
2022-03-04,Tuolumne,109,53932,12587,12325,549,12874,178
2022-03-04,Ventura,111,848112,172024,171666,9301,180967,1436
2022-03-04,Yolo,113,214977,36611,35856,2990,38846,306
2022-03-04,Yuba,115,75493,15707,15666,1170,16836,115
2022-03-03,Alameda,001,1643700,253020,251988,13373,265361,1760
2022-03-03,Alpine,003,1148,122,125,1,126,0
2022-03-03,Amador,005,37829,8446,8344,636,8980,83
2022-03-03,Butte,007,227075,32863,32663,6855,39518,372
2022-03-03,Calaveras,009,45235,7197,7236,341,7577,116
2022-03-03,Colusa,011,21464,3424,3433,1043,4476,21
2022-03-03,Contra Costa,013,1133247,188193,185734,12926,198660,1235
2022-03-03,Del Norte,015,27424,5703,5725,177,5902,48
2022-03-03,El Dorado,017,186661,26540,26446,3178,29624,193
2022-03-03,Fresno,019,978130,229596,227154,23416,250570,2640
2022-03-03,Glenn,021,27897,4946,4927,1591,6518,43
2022-03-03,Humboldt,023,135768,16714,16781,2894,19675,136
2022-03-03,Imperial,025,180216,55094,54650,10491,65141,880
2022-03-03,Inyo,027,18085,4054,4043,466,4509,56
2022-03-03,Kern,029,883053,190858,189817,45456,235273,2141
2022-03-03,Kings,031,150075,51042,50926,3476,54402,431
2022-03-03,Lake,033,64148,10584,10512,871,11383,130
2022-03-03,Lassen,035,31185,8907,8818,870,9688,62
2022-03-03,Los Angeles,037,10098052,2693925,2671564,122166,2793730,30608
2022-03-03,Madera,039,155013,37052,37100,5975,43075,354
2022-03-03,Marin,041,260295,32927,32829,2154,34983,272
2022-03-03,Mariposa,043,17540,2367,2363,195,2558,6
2022-03-03,Mendocino,045,87422,12928,12845,2967,15812,113
2022-03-03,Merced,047,269075,61784,61653,8490,70143,789
2022-03-03,Modoc,049,8938,727,729,248,977,7
2022-03-03,Mono,051,14174,2959,2961,119,3080,5
2022-03-03,Monterey,053,433212,78726,78028,13195,91223,704
2022-03-03,Napa,055,140530,25452,25405,928,26333,134
2022-03-03,Nevada,057,99092,15815,15907,1169,17076,122
2022-03-03,Orange,059,3164182,543167,541463,40670,582133,6638
2022-03-03,Placer,061,380077,62249,62117,7263,69380,591
2022-03-03,Plumas,063,18699,2949,2701,358,3059,13
2022-03-03,Riverside,065,2383286,588486,586785,27533,614318,6239
2022-03-03,Sacramento,067,1510023,278502,273487,26168,299655,2847
2022-03-03,San Benito,069,59416,12799,12820,503,13323,94
2022-03-03,San Bernardino,071,2135413,570287,557421,24618,582039,6641
2022-03-03,San Diego,073,3302833,744773,740747,51942,792689,5045
2022-03-03,San Francisco,075,870044,122156,123537,8060,131597,798
2022-03-03,San Joaquin,077,732212,165325,165085,9775,174860,2069
2022-03-03,San Luis Obispo,079,281455,51927,51739,3680,55419,446
2022-03-03,San Mateo,081,765935,119930,118646,6792,125438,621
2022-03-03,Santa Barbara,083,443738,85089,85249,4643,89892,655
2022-03-03,Santa Clara,085,1922200,306564,307689,12119,319808,2195
2022-03-03,Santa Cruz,087,273765,47044,46622,2056,48678,253
2022-03-03,Shasta,089,179085,30301,30282,6029,36311,492
2022-03-03,Sierra,091,2930,271,273,47,320,4
2022-03-03,Siskiyou,093,43540,4407,4389,2700,7089,74
2022-03-03,Solano,095,438530,80673,80690,5496,86186,435
2022-03-03,Sonoma,097,501317,82564,82313,2541,84854,473
2022-03-03,Stanislaus,099,539301,116808,117501,17446,134947,1531
2022-03-03,Sutter,101,95872,20327,20346,2020,22366,217
2022-03-03,Tehama,103,63373,11965,11939,2571,14510,158
2022-03-03,Trinity,105,12862,1178,1170,284,1454,20
2022-03-03,Tulare,107,460477,105761,103534,27343,130877,1305
2022-03-03,Tuolumne,109,53932,12576,12325,549,12874,178
2022-03-03,Ventura,111,848112,171972,171666,9299,180965,1436
2022-03-03,Yolo,113,214977,36587,35856,2985,38841,306
2022-03-03,Yuba,115,75493,15701,15666,1165,16831,115
2022-03-02,Alameda,001,1643700,252842,251886,13356,265242,1759
2022-03-02,Alpine,003,1148,122,125,1,126,0
2022-03-02,Amador,005,37829,8433,8341,636,8977,83
2022-03-02,Butte,007,227075,32851,32636,6851,39487,372
2022-03-02,Calaveras,009,45235,7196,7225,341,7566,116
2022-03-02,Colusa,011,21464,3421,3428,1043,4471,21
2022-03-02,Contra Costa,013,1133247,188100,185589,12908,198497,1236
2022-03-02,Del Norte,015,27424,5696,5708,175,5883,47
2022-03-02,El Dorado,017,186661,26529,26433,3175,29608,192
2022-03-02,Fresno,019,978130,229463,226932,23406,250338,2629
2022-03-02,Glenn,021,27897,4946,4922,1590,6512,43
2022-03-02,Humboldt,023,135768,16704,16747,2887,19634,135
2022-03-02,Imperial,025,180216,55068,54629,10486,65115,878
2022-03-02,Inyo,027,18085,4052,4041,465,4506,56
2022-03-02,Kern,029,883053,190792,189656,45437,235093,2136
2022-03-02,Kings,031,150075,51016,50819,3473,54292,431
2022-03-02,Lake,033,64148,10571,10495,869,11364,130
2022-03-02,Lassen,035,31185,8904,8811,869,9680,62
2022-03-02,Los Angeles,037,10098052,2693044,2670287,122120,2792407,30535
2022-03-02,Madera,039,155013,37035,37077,5973,43050,354
2022-03-02,Marin,041,260295,32909,32794,2153,34947,272
2022-03-02,Mariposa,043,17540,2367,2359,195,2554,6
2022-03-02,Mendocino,045,87422,12915,12832,2962,15794,112
2022-03-02,Merced,047,269075,61758,61606,8480,70086,785
2022-03-02,Modoc,049,8938,727,729,248,977,7
2022-03-02,Mono,051,14174,2959,2961,119,3080,5
2022-03-02,Monterey,053,433212,78689,77963,13172,91135,703
2022-03-02,Napa,055,140530,25403,25382,927,26309,134
2022-03-02,Nevada,057,99092,15804,15920,1168,17088,122
2022-03-02,Orange,059,3164182,542963,541230,40644,581874,6623
2022-03-02,Placer,061,380077,62227,62066,7260,69326,589
2022-03-02,Plumas,063,18699,2949,2700,358,3058,13
2022-03-02,Riverside,065,2383286,588336,586513,27523,614036,6229
2022-03-02,Sacramento,067,1510023,278385,273291,26157,299448,2837
2022-03-02,San Benito,069,59416,12788,12814,503,13317,94
2022-03-02,San Bernardino,071,2135413,570178,557082,24612,581694,6619
2022-03-02,San Diego,073,3302833,744412,739803,51894,791697,5034
2022-03-02,San Francisco,075,870044,122061,123442,8058,131500,792
2022-03-02,San Joaquin,077,732212,165266,164968,9770,174738,2063
2022-03-02,San Luis Obispo,079,281455,51889,51686,3675,55361,446
2022-03-02,San Mateo,081,765935,119843,118518,6776,125294,617
2022-03-02,Santa Barbara,083,443738,85064,85183,4642,89825,655
2022-03-02,Santa Clara,085,1922200,306352,307354,12105,319459,2184
2022-03-02,Santa Cruz,087,273765,46973,46534,2055,48589,253
2022-03-02,Shasta,089,179085,30276,30253,6019,36272,490
2022-03-02,Sierra,091,2930,271,273,47,320,4
2022-03-02,Siskiyou,093,43540,4405,4384,2697,7081,74
2022-03-02,Solano,095,438530,80607,80626,5493,86119,433
2022-03-02,Sonoma,097,501317,82518,82208,2537,84745,473
2022-03-02,Stanislaus,099,539301,116772,117411,17421,134832,1519
2022-03-02,Sutter,101,95872,20305,20317,2003,22320,216
2022-03-02,Tehama,103,63373,11960,11930,2570,14500,158
2022-03-02,Trinity,105,12862,1176,1160,284,1444,20
2022-03-02,Tulare,107,460477,105721,103451,27328,130779,1302
2022-03-02,Tuolumne,109,53932,12571,12297,549,12846,179
2022-03-02,Ventura,111,848112,171919,171770,9295,181065,1427
2022-03-02,Yolo,113,214977,36569,35799,2980,38779,305
2022-03-02,Yuba,115,75493,15688,15653,1160,16813,115
2022-03-01,Alameda,001,1643700,252677,251830,13345,265175,1749
2022-03-01,Alpine,003,1148,122,125,1,126,0
2022-03-01,Amador,005,37829,8385,8334,634,8968,83
2022-03-01,Butte,007,227075,32827,32575,6846,39421,372
2022-03-01,Calaveras,009,45235,7193,7223,340,7563,116
2022-03-01,Colusa,011,21464,3420,3423,1043,4466,21
2022-03-01,Contra Costa,013,1133247,187990,185378,12893,198271,1231
2022-03-01,Del Norte,015,27424,5693,5701,174,5875,45
2022-03-01,El Dorado,017,186661,26510,26413,3173,29586,192
2022-03-01,Fresno,019,978130,229323,226594,23391,249985,2628
2022-03-01,Glenn,021,27897,4945,4919,1588,6507,40
2022-03-01,Humboldt,023,135768,16683,16727,2880,19607,135
2022-03-01,Imperial,025,180216,55051,54570,10480,65050,875
2022-03-01,Inyo,027,18085,4048,4041,464,4505,56
2022-03-01,Kern,029,883053,190718,189365,45413,234778,2120
2022-03-01,Kings,031,150075,50994,50763,3469,54232,427
2022-03-01,Lake,033,64148,10560,10471,867,11338,128
2022-03-01,Lassen,035,31185,8900,8801,869,9670,61
2022-03-01,Los Angeles,037,10098052,2692092,2669489,122062,2791551,30486
2022-03-01,Madera,039,155013,37015,37046,5967,43013,354
2022-03-01,Marin,041,260295,32883,32764,2152,34916,272
2022-03-01,Mariposa,043,17540,2366,2357,194,2551,6
2022-03-01,Mendocino,045,87422,12904,12818,2960,15778,112
2022-03-01,Merced,047,269075,61729,61549,8467,70016,781
2022-03-01,Modoc,049,8938,727,729,248,977,7
2022-03-01,Mono,051,14174,2958,2960,119,3079,6
2022-03-01,Monterey,053,433212,78663,77911,13162,91073,696
2022-03-01,Napa,055,140530,25372,25344,927,26271,134
2022-03-01,Nevada,057,99092,15796,15916,1165,17081,121
2022-03-01,Orange,059,3164182,542747,541054,40609,581663,6612
2022-03-01,Placer,061,380077,62199,62021,7255,69276,583
2022-03-01,Plumas,063,18699,2949,2694,358,3052,13
2022-03-01,Riverside,065,2383286,588172,586184,27522,613706,6198
2022-03-01,Sacramento,067,1510023,278254,273089,26144,299233,2831
2022-03-01,San Benito,069,59416,12784,12806,503,13309,94
2022-03-01,San Bernardino,071,2135413,570048,556743,24609,581352,6588
2022-03-01,San Diego,073,3302833,743986,739136,51852,790988,5029
2022-03-01,San Francisco,075,870044,121958,123481,8052,131533,792
2022-03-01,San Joaquin,077,732212,165199,164894,9766,174660,2062
2022-03-01,San Luis Obispo,079,281455,51853,51592,3671,55263,445
2022-03-01,San Mateo,081,765935,119771,118358,6769,125127,613
2022-03-01,Santa Barbara,083,443738,85028,85134,4638,89772,654
2022-03-01,Santa Clara,085,1922200,306102,306978,12093,319071,2190
2022-03-01,Santa Cruz,087,273765,46922,46471,2052,48523,253
2022-03-01,Shasta,089,179085,30247,30227,6016,36243,489
2022-03-01,Sierra,091,2930,271,274,47,321,5
2022-03-01,Siskiyou,093,43540,4401,4384,2692,7076,74
2022-03-01,Solano,095,438530,80545,80556,5490,86046,434
2022-03-01,Sonoma,097,501317,82449,82103,2531,84634,477
2022-03-01,Stanislaus,099,539301,116720,117308,17397,134705,1521
2022-03-01,Sutter,101,95872,20291,20288,1999,22287,217
2022-03-01,Tehama,103,63373,11954,11923,2567,14490,158
2022-03-01,Trinity,105,12862,1175,1159,284,1443,20
2022-03-01,Tulare,107,460477,105639,103371,27308,130679,1302
2022-03-01,Tuolumne,109,53932,12564,12276,547,12823,175
2022-03-01,Ventura,111,848112,171849,171672,9288,180960,1427
2022-03-01,Yolo,113,214977,36544,35801,2974,38775,299
2022-03-01,Yuba,115,75493,15680,15637,1160,16797,116
2022-02-28,Alameda,001,1643700,252458,251714,13330,265044,1742
2022-02-28,Alpine,003,1148,122,125,1,126,0
2022-02-28,Amador,005,37829,8379,8308,633,8941,83
2022-02-28,Butte,007,227075,32805,32550,6840,39390,368
2022-02-28,Calaveras,009,45235,7190,7220,339,7559,110
2022-02-28,Colusa,011,21464,3417,3422,1041,4463,21
2022-02-28,Contra Costa,013,1133247,187882,185272,12874,198146,1231
2022-02-28,Del Norte,015,27424,5688,5699,173,5872,45
2022-02-28,El Dorado,017,186661,26500,26409,3168,29577,191
2022-02-28,Fresno,019,978130,229122,226519,23370,249889,2622
2022-02-28,Glenn,021,27897,4941,4918,1588,6506,40
2022-02-28,Humboldt,023,135768,16668,16717,2876,19593,135
2022-02-28,Imperial,025,180216,55025,54517,10476,64993,875
2022-02-28,Inyo,027,18085,4048,4041,463,4504,56
2022-02-28,Kern,029,883053,190627,189245,45384,234629,2115
2022-02-28,Kings,031,150075,50954,50741,3468,54209,427
2022-02-28,Lake,033,64148,10548,10468,863,11331,128
2022-02-28,Lassen,035,31185,8843,8794,869,9663,55
2022-02-28,Los Angeles,037,10098052,2690918,2666804,121966,2788770,30410
2022-02-28,Madera,039,155013,36989,37023,5951,42974,354
2022-02-28,Marin,041,260295,32858,32775,2152,34927,272
2022-02-28,Mariposa,043,17540,2363,2354,192,2546,6
2022-02-28,Mendocino,045,87422,12895,12800,2952,15752,112
2022-02-28,Merced,047,269075,61685,61519,8450,69969,781
2022-02-28,Modoc,049,8938,727,727,248,975,7
2022-02-28,Mono,051,14174,2958,2961,119,3080,5
2022-02-28,Monterey,053,433212,78596,77865,13141,91006,693
2022-02-28,Napa,055,140530,25345,25317,927,26244,129
2022-02-28,Nevada,057,99092,15790,15908,1159,17067,121
2022-02-28,Orange,059,3164182,542494,540839,40595,581434,6605
2022-02-28,Placer,061,380077,62168,61976,7250,69226,577
2022-02-28,Plumas,063,18699,2949,2691,357,3048,13
2022-02-28,Riverside,065,2383286,587976,585891,27490,613381,6179
2022-02-28,Sacramento,067,1510023,278115,273038,26120,299158,2825
2022-02-28,San Benito,069,59416,12779,12798,503,13301,94
2022-02-28,San Bernardino,071,2135413,569862,556540,24595,581135,6576
2022-02-28,San Diego,073,3302833,743597,737760,51822,789582,5018
2022-02-28,San Francisco,075,870044,121798,123402,8045,131447,792
2022-02-28,San Joaquin,077,732212,165115,164833,9756,174589,2060
2022-02-28,San Luis Obispo,079,281455,51792,51565,3664,55229,440
2022-02-28,San Mateo,081,765935,119672,118301,6763,125064,611
2022-02-28,Santa Barbara,083,443738,84985,85076,4633,89709,653
2022-02-28,Santa Clara,085,1922200,305830,306930,12071,319001,2180
2022-02-28,Santa Cruz,087,273765,46852,46447,2051,48498,253
2022-02-28,Shasta,089,179085,30222,30213,6012,36225,488
2022-02-28,Sierra,091,2930,271,273,47,320,4
2022-02-28,Siskiyou,093,43540,4398,4382,2687,7069,74
2022-02-28,Solano,095,438530,80479,80544,5478,86022,430
2022-02-28,Sonoma,097,501317,82381,82058,2528,84586,477
2022-02-28,Stanislaus,099,539301,116656,117231,17381,134612,1521
2022-02-28,Sutter,101,95872,20278,20285,1996,22281,214
2022-02-28,Tehama,103,63373,11941,11917,2567,14484,158
2022-02-28,Trinity,105,12862,1175,1160,284,1444,20
2022-02-28,Tulare,107,460477,105591,103304,27292,130596,1300
2022-02-28,Tuolumne,109,53932,12554,12247,547,12794,175
2022-02-28,Ventura,111,848112,171765,171614,9287,180901,1423
2022-02-28,Yolo,113,214977,36508,35754,2967,38721,299
2022-02-28,Yuba,115,75493,15665,15625,1159,16784,115
2022-02-27,Alameda,001,1643700,252184,251624,13321,264945,1744
2022-02-27,Alpine,003,1148,122,125,1,126,0
2022-02-27,Amador,005,37829,8375,8305,630,8935,83
2022-02-27,Butte,007,227075,32768,32551,6827,39378,368
2022-02-27,Calaveras,009,45235,7183,7214,339,7553,110
2022-02-27,Colusa,011,21464,3416,3422,1041,4463,21
2022-02-27,Contra Costa,013,1133247,187756,185185,12854,198039,1230
2022-02-27,Del Norte,015,27424,5671,5691,171,5862,45
2022-02-27,El Dorado,017,186661,26482,26410,3166,29576,191
2022-02-27,Fresno,019,978130,228923,226397,23343,249740,2621
2022-02-27,Glenn,021,27897,4939,4915,1588,6503,40
2022-02-27,Humboldt,023,135768,16646,16713,2869,19582,135
2022-02-27,Imperial,025,180216,54977,54509,10459,64968,875
2022-02-27,Inyo,027,18085,4047,4041,459,4500,56
2022-02-27,Kern,029,883053,190509,189219,45346,234565,2115
2022-02-27,Kings,031,150075,50926,50733,3467,54200,428
2022-02-27,Lake,033,64148,10529,10463,863,11326,128
2022-02-27,Lassen,035,31185,8835,8786,869,9655,55
2022-02-27,Los Angeles,037,10098052,2689609,2666789,121883,2788672,30410
2022-02-27,Madera,039,155013,36963,37009,5943,42952,354
2022-02-27,Marin,041,260295,32820,32756,2150,34906,272
2022-02-27,Mariposa,043,17540,2360,2352,192,2544,6
2022-02-27,Mendocino,045,87422,12879,12798,2939,15737,112
2022-02-27,Merced,047,269075,61633,61491,8433,69924,779
2022-02-27,Modoc,049,8938,726,727,248,975,7
2022-02-27,Mono,051,14174,2957,2960,119,3079,5
2022-02-27,Monterey,053,433212,78539,77851,13117,90968,693
2022-02-27,Napa,055,140530,25307,25316,927,26243,129
2022-02-27,Nevada,057,99092,15782,15900,1155,17055,121
2022-02-27,Orange,059,3164182,542248,540659,40566,581225,6605
2022-02-27,Placer,061,380077,62128,61965,7246,69211,577
2022-02-27,Plumas,063,18699,2946,2691,357,3048,13
2022-02-27,Riverside,065,2383286,587735,585833,27466,613299,6179
2022-02-27,Sacramento,067,1510023,277929,272927,26091,299018,2822
2022-02-27,San Benito,069,59416,12772,12798,503,13301,94
2022-02-27,San Bernardino,071,2135413,569677,556457,24585,581042,6572
2022-02-27,San Diego,073,3302833,743124,737760,51777,789537,5018
2022-02-27,San Francisco,075,870044,121675,123327,8034,131361,791
2022-02-27,San Joaquin,077,732212,165011,164814,9752,174566,2060
2022-02-27,San Luis Obispo,079,281455,51700,51564,3657,55221,439
2022-02-27,San Mateo,081,765935,119562,118244,6758,125002,611
2022-02-27,Santa Barbara,083,443738,84947,85050,4629,89679,653
2022-02-27,Santa Clara,085,1922200,305543,306756,12043,318799,2180
2022-02-27,Santa Cruz,087,273765,46791,46411,2051,48462,253
2022-02-27,Shasta,089,179085,30190,30206,6007,36213,488
2022-02-27,Sierra,091,2930,271,273,47,320,4
2022-02-27,Siskiyou,093,43540,4393,4378,2675,7053,74
2022-02-27,Solano,095,438530,80403,80515,5465,85980,430
2022-02-27,Sonoma,097,501317,82299,82041,2521,84562,476
2022-02-27,Stanislaus,099,539301,116590,117200,17362,134562,1522
2022-02-27,Sutter,101,95872,20261,20280,1990,22270,214
2022-02-27,Tehama,103,63373,11928,11915,2566,14481,158
2022-02-27,Trinity,105,12862,1174,1158,284,1442,20
2022-02-27,Tulare,107,460477,105522,103270,27243,130513,1300
2022-02-27,Tuolumne,109,53932,12541,12243,546,12789,175
2022-02-27,Ventura,111,848112,171690,171660,9283,180943,1423
2022-02-27,Yolo,113,214977,36480,35744,2962,38706,299
2022-02-27,Yuba,115,75493,15655,15619,1157,16776,113
2022-02-26,Alameda,001,1643700,252075,250867,13316,264183,1716
2022-02-26,Alpine,003,1148,122,125,1,126,0
2022-02-26,Amador,005,37829,8373,8282,629,8911,83
2022-02-26,Butte,007,227075,32754,32466,6824,39290,368
2022-02-26,Calaveras,009,45235,7182,7192,339,7531,110
2022-02-26,Colusa,011,21464,3416,3414,1041,4455,21
2022-02-26,Contra Costa,013,1133247,187687,184686,12836,197522,1209
2022-02-26,Del Norte,015,27424,5666,5639,171,5810,45
2022-02-26,El Dorado,017,186661,26471,26355,3163,29518,191
2022-02-26,Fresno,019,978130,228833,225679,23343,249022,2597
2022-02-26,Glenn,021,27897,4937,4909,1587,6496,40
2022-02-26,Humboldt,023,135768,16621,16619,2868,19487,133
2022-02-26,Imperial,025,180216,54950,54367,10457,64824,871
2022-02-26,Inyo,027,18085,4046,4034,454,4488,56
2022-02-26,Kern,029,883053,190456,188584,45327,233911,2106
2022-02-26,Kings,031,150075,50913,50579,3467,54046,423
2022-02-26,Lake,033,64148,10524,10383,863,11246,128
2022-02-26,Lassen,035,31185,8834,8761,869,9630,55
2022-02-26,Los Angeles,037,10098052,2689035,2660973,121843,2782816,30202
2022-02-26,Madera,039,155013,36948,36933,5941,42874,330
2022-02-26,Marin,041,260295,32804,32651,2148,34799,267
2022-02-26,Mariposa,043,17540,2359,2332,192,2524,6
2022-02-26,Mendocino,045,87422,12872,12762,2939,15701,111
2022-02-26,Merced,047,269075,61612,61348,8432,69780,775
2022-02-26,Modoc,049,8938,726,726,248,974,7
2022-02-26,Mono,051,14174,2957,2959,118,3077,5
2022-02-26,Monterey,053,433212,78507,77610,13111,90721,692
2022-02-26,Napa,055,140530,25292,25221,926,26147,130
2022-02-26,Nevada,057,99092,15778,15850,1153,17003,121
2022-02-26,Orange,059,3164182,542137,539992,40549,580541,6540
2022-02-26,Placer,061,380077,62109,61803,7243,69046,573
2022-02-26,Plumas,063,18699,2946,2673,357,3030,13
2022-02-26,Riverside,065,2383286,587615,584835,27457,612292,6143
2022-02-26,Sacramento,067,1510023,277833,272339,26081,298420,2793
2022-02-26,San Benito,069,59416,12768,12770,503,13273,92
2022-02-26,San Bernardino,071,2135413,569586,555668,24578,580246,6505
2022-02-26,San Diego,073,3302833,742901,736049,51755,787804,5002
2022-02-26,San Francisco,075,870044,121605,123079,8026,131105,769
2022-02-26,San Joaquin,077,732212,164977,164418,9751,174169,2048
2022-02-26,San Luis Obispo,079,281455,51688,51358,3655,55013,438
2022-02-26,San Mateo,081,765935,119508,117860,6757,124617,603
2022-02-26,Santa Barbara,083,443738,84916,84830,4629,89459,652
2022-02-26,Santa Clara,085,1922200,305394,305895,12039,317934,2166
2022-02-26,Santa Cruz,087,273765,46768,46186,2051,48237,251
2022-02-26,Shasta,089,179085,30181,30108,6001,36109,485
2022-02-26,Sierra,091,2930,271,270,47,317,1
2022-02-26,Siskiyou,093,43540,4393,4359,2673,7032,72
2022-02-26,Solano,095,438530,80368,80225,5461,85686,428
2022-02-26,Sonoma,097,501317,82265,81702,2519,84221,432
2022-02-26,Stanislaus,099,539301,116552,116896,17357,134253,1503
2022-02-26,Sutter,101,95872,20252,20230,1990,22220,214
2022-02-26,Tehama,103,63373,11922,11878,2564,14442,158
2022-02-26,Trinity,105,12862,1173,1156,284,1440,20
2022-02-26,Tulare,107,460477,105486,102983,27228,130211,1295
2022-02-26,Tuolumne,109,53932,12538,12169,546,12715,175
2022-02-26,Ventura,111,848112,171658,171292,9280,180572,1411
2022-02-26,Yolo,113,214977,36459,35615,2959,38574,296
2022-02-26,Yuba,115,75493,15643,15587,1157,16744,113
2022-02-25,Alameda,001,1643700,251952,250867,13307,264174,1716
2022-02-25,Alpine,003,1148,122,125,1,126,0
2022-02-25,Amador,005,37829,8362,8282,629,8911,83
2022-02-25,Butte,007,227075,32741,32466,6821,39287,368
2022-02-25,Calaveras,009,45235,7180,7192,339,7531,110
2022-02-25,Colusa,011,21464,3416,3414,1041,4455,21
2022-02-25,Contra Costa,013,1133247,187603,184686,12815,197501,1209
2022-02-25,Del Norte,015,27424,5657,5639,171,5810,45
2022-02-25,El Dorado,017,186661,26462,26355,3163,29518,191
2022-02-25,Fresno,019,978130,228736,225679,23336,249015,2597
2022-02-25,Glenn,021,27897,4935,4909,1587,6496,40
2022-02-25,Humboldt,023,135768,16610,16619,2868,19487,133
2022-02-25,Imperial,025,180216,54932,54367,10456,64823,871
2022-02-25,Inyo,027,18085,4045,4034,454,4488,56
2022-02-25,Kern,029,883053,190391,188584,45314,233898,2106
2022-02-25,Kings,031,150075,50899,50579,3465,54044,423
2022-02-25,Lake,033,64148,10506,10383,863,11246,128
2022-02-25,Lassen,035,31185,8831,8761,869,9630,55
2022-02-25,Los Angeles,037,10098052,2688447,2660973,121812,2782785,30202
2022-02-25,Madera,039,155013,36928,36933,5940,42873,330
2022-02-25,Marin,041,260295,32790,32651,2148,34799,267
2022-02-25,Mariposa,043,17540,2356,2332,192,2524,6
2022-02-25,Mendocino,045,87422,12870,12762,2939,15701,111
2022-02-25,Merced,047,269075,61580,61348,8428,69776,775
2022-02-25,Modoc,049,8938,726,726,248,974,7
2022-02-25,Mono,051,14174,2956,2959,118,3077,5
2022-02-25,Monterey,053,433212,78479,77610,13105,90715,692
2022-02-25,Napa,055,140530,25283,25221,926,26147,130
2022-02-25,Nevada,057,99092,15767,15850,1150,17000,121
2022-02-25,Orange,059,3164182,542002,539992,40526,580518,6540
2022-02-25,Placer,061,380077,62094,61803,7237,69040,573
2022-02-25,Plumas,063,18699,2944,2673,357,3030,13
2022-02-25,Riverside,065,2383286,587460,584835,27445,612280,6143
2022-02-25,Sacramento,067,1510023,277731,272339,26076,298415,2793
2022-02-25,San Benito,069,59416,12766,12770,503,13273,92
2022-02-25,San Bernardino,071,2135413,569479,555668,24571,580239,6505
2022-02-25,San Diego,073,3302833,742618,736049,51736,787785,5002
2022-02-25,San Francisco,075,870044,121525,123079,8023,131102,769
2022-02-25,San Joaquin,077,732212,164937,164418,9746,174164,2048
2022-02-25,San Luis Obispo,079,281455,51684,51358,3646,55004,438
2022-02-25,San Mateo,081,765935,119446,117860,6753,124613,603
2022-02-25,Santa Barbara,083,443738,84879,84830,4629,89459,652
2022-02-25,Santa Clara,085,1922200,305209,305895,12036,317931,2166
2022-02-25,Santa Cruz,087,273765,46734,46186,2049,48235,251
2022-02-25,Shasta,089,179085,30172,30108,5999,36107,485
2022-02-25,Sierra,091,2930,271,270,47,317,1
2022-02-25,Siskiyou,093,43540,4393,4359,2672,7031,72
2022-02-25,Solano,095,438530,80339,80225,5460,85685,428
2022-02-25,Sonoma,097,501317,82214,81702,2517,84219,432
2022-02-25,Stanislaus,099,539301,116524,116896,17353,134249,1503
2022-02-25,Sutter,101,95872,20243,20230,1990,22220,214
2022-02-25,Tehama,103,63373,11920,11878,2564,14442,158
2022-02-25,Trinity,105,12862,1173,1156,284,1440,20
2022-02-25,Tulare,107,460477,105452,102983,27206,130189,1295
2022-02-25,Tuolumne,109,53932,12535,12169,546,12715,175
2022-02-25,Ventura,111,848112,171607,171292,9279,180571,1411
2022-02-25,Yolo,113,214977,36444,35615,2959,38574,296
2022-02-25,Yuba,115,75493,15636,15587,1157,16744,113
2022-02-24,Alameda,001,1643700,251747,250867,13298,264165,1716
2022-02-24,Alpine,003,1148,122,125,1,126,0
2022-02-24,Amador,005,37829,8357,8282,628,8910,83
2022-02-24,Butte,007,227075,32720,32466,6817,39283,368
2022-02-24,Calaveras,009,45235,7178,7192,337,7529,110
2022-02-24,Colusa,011,21464,3415,3414,1040,4454,21
2022-02-24,Contra Costa,013,1133247,187473,184686,12807,197493,1209
2022-02-24,Del Norte,015,27424,5642,5639,170,5809,45
2022-02-24,El Dorado,017,186661,26447,26355,3163,29518,191
2022-02-24,Fresno,019,978130,228542,225679,23321,249000,2597
2022-02-24,Glenn,021,27897,4933,4909,1586,6495,40
2022-02-24,Humboldt,023,135768,16594,16619,2867,19486,133
2022-02-24,Imperial,025,180216,54892,54367,10447,64814,871
2022-02-24,Inyo,027,18085,4044,4034,453,4487,56
2022-02-24,Kern,029,883053,190250,188584,45281,233865,2106
2022-02-24,Kings,031,150075,50869,50579,3460,54039,423
2022-02-24,Lake,033,64148,10489,10383,863,11246,128
2022-02-24,Lassen,035,31185,8827,8761,868,9629,55
2022-02-24,Los Angeles,037,10098052,2687286,2660973,121756,2782729,30202
2022-02-24,Madera,039,155013,36902,36933,5938,42871,330
2022-02-24,Marin,041,260295,32770,32651,2147,34798,267
2022-02-24,Mariposa,043,17540,2350,2332,191,2523,6
2022-02-24,Mendocino,045,87422,12863,12762,2935,15697,111
2022-02-24,Merced,047,269075,61549,61348,8420,69768,775
2022-02-24,Modoc,049,8938,725,726,248,974,7
2022-02-24,Mono,051,14174,2955,2959,118,3077,5
2022-02-24,Monterey,053,433212,78427,77610,13097,90707,692
2022-02-24,Napa,055,140530,25243,25221,922,26143,130
2022-02-24,Nevada,057,99092,15753,15850,1150,17000,121
2022-02-24,Orange,059,3164182,541752,539992,40492,580484,6540
2022-02-24,Placer,061,380077,62057,61803,7235,69038,573
2022-02-24,Plumas,063,18699,2939,2673,356,3029,13
2022-02-24,Riverside,065,2383286,587208,584835,27419,612254,6143
2022-02-24,Sacramento,067,1510023,277558,272339,26060,298399,2793
2022-02-24,San Benito,069,59416,12755,12770,503,13273,92
2022-02-24,San Bernardino,071,2135413,569286,555668,24559,580227,6505
2022-02-24,San Diego,073,3302833,742205,736049,51689,787738,5002
2022-02-24,San Francisco,075,870044,121403,123079,8016,131095,769
2022-02-24,San Joaquin,077,732212,164809,164418,9742,174160,2048
2022-02-24,San Luis Obispo,079,281455,51638,51358,3644,55002,438
2022-02-24,San Mateo,081,765935,119354,117860,6746,124606,603
2022-02-24,Santa Barbara,083,443738,84814,84830,4628,89458,652
2022-02-24,Santa Clara,085,1922200,304974,305895,12023,317918,2166
2022-02-24,Santa Cruz,087,273765,46654,46186,2047,48233,251
2022-02-24,Shasta,089,179085,30153,30108,5993,36101,485
2022-02-24,Sierra,091,2930,271,270,47,317,1
2022-02-24,Siskiyou,093,43540,4390,4359,2669,7028,72
2022-02-24,Solano,095,438530,80260,80225,5456,85681,428
2022-02-24,Sonoma,097,501317,82160,81702,2512,84214,432
2022-02-24,Stanislaus,099,539301,116449,116896,17344,134240,1503
2022-02-24,Sutter,101,95872,20229,20230,1974,22204,214
2022-02-24,Tehama,103,63373,11914,11878,2563,14441,158
2022-02-24,Trinity,105,12862,1171,1156,284,1440,20
2022-02-24,Tulare,107,460477,105396,102983,27176,130159,1295
2022-02-24,Tuolumne,109,53932,12525,12169,544,12713,175
2022-02-24,Ventura,111,848112,171528,171292,9276,180568,1411
2022-02-24,Yolo,113,214977,36418,35615,2957,38572,296
2022-02-24,Yuba,115,75493,15622,15587,1157,16744,113
2022-02-23,Alameda,001,1643700,251523,247686,13279,260965,1713
2022-02-23,Alpine,003,1148,122,125,1,126,0
2022-02-23,Amador,005,37829,8339,8274,628,8902,79
2022-02-23,Butte,007,227075,32693,32417,6814,39231,367
2022-02-23,Calaveras,009,45235,7168,7182,336,7518,107
2022-02-23,Colusa,011,21464,3411,3411,1040,4451,21
2022-02-23,Contra Costa,013,1133247,187329,184013,12794,196807,1209
2022-02-23,Del Norte,015,27424,5631,5625,169,5794,45
2022-02-23,El Dorado,017,186661,26431,26317,3159,29476,189
2022-02-23,Fresno,019,978130,228355,225308,23299,248607,2596
2022-02-23,Glenn,021,27897,4929,4909,1584,6493,40
2022-02-23,Humboldt,023,135768,16578,16601,2864,19465,132
2022-02-23,Imperial,025,180216,54853,54292,10435,64727,871
2022-02-23,Inyo,027,18085,4043,4031,450,4481,54
2022-02-23,Kern,029,883053,190147,188432,45234,233666,2106
2022-02-23,Kings,031,150075,50836,50416,3459,53875,423
2022-02-23,Lake,033,64148,10471,10368,862,11230,126
2022-02-23,Lassen,035,31185,8811,8749,868,9617,55
2022-02-23,Los Angeles,037,10098052,2685915,2659569,121711,2781280,30167
2022-02-23,Madera,039,155013,36870,36876,5928,42804,330
2022-02-23,Marin,041,260295,32747,32625,2146,34771,267
2022-02-23,Mariposa,043,17540,2345,2325,190,2515,6
2022-02-23,Mendocino,045,87422,12853,12747,2931,15678,111
2022-02-23,Merced,047,269075,61519,61295,8415,69710,772
2022-02-23,Modoc,049,8938,725,723,247,970,7
2022-02-23,Mono,051,14174,2954,2960,118,3078,5
2022-02-23,Monterey,053,433212,78389,77472,13074,90546,691
2022-02-23,Napa,055,140530,25219,25185,917,26102,128
2022-02-23,Nevada,057,99092,15747,15825,1147,16972,121
2022-02-23,Orange,059,3164182,541447,539631,40470,580101,6520
2022-02-23,Placer,061,380077,62010,61758,7228,68986,573
2022-02-23,Plumas,063,18699,2935,2663,356,3019,13
2022-02-23,Riverside,065,2383286,586916,584381,27383,611764,6119
2022-02-23,Sacramento,067,1510023,277399,272057,26040,298097,2796
2022-02-23,San Benito,069,59416,12748,12756,502,13258,92
2022-02-23,San Bernardino,071,2135413,569125,555238,24543,579781,6479
2022-02-23,San Diego,073,3302833,741701,735406,51639,787045,4988
2022-02-23,San Francisco,075,870044,121276,122127,8014,130141,769
2022-02-23,San Joaquin,077,732212,164716,164257,9737,173994,2042
2022-02-23,San Luis Obispo,079,281455,51590,51264,3642,54906,434
2022-02-23,San Mateo,081,765935,119263,117585,6737,124322,603
2022-02-23,Santa Barbara,083,443738,84753,84760,4624,89384,651
2022-02-23,Santa Clara,085,1922200,304718,305484,12014,317498,2157
2022-02-23,Santa Cruz,087,273765,46584,46059,2046,48105,251
2022-02-23,Shasta,089,179085,30126,30066,5990,36056,481
2022-02-23,Sierra,091,2930,271,270,47,317,1
2022-02-23,Siskiyou,093,43540,4387,4356,2667,7023,71
2022-02-23,Solano,095,438530,80170,80103,5454,85557,427
2022-02-23,Sonoma,097,501317,82106,81594,2510,84104,432
2022-02-23,Stanislaus,099,539301,116372,116789,17335,134124,1482
2022-02-23,Sutter,101,95872,20212,20194,1970,22164,213
2022-02-23,Tehama,103,63373,11904,11863,2563,14426,154
2022-02-23,Trinity,105,12862,1171,1156,284,1440,20
2022-02-23,Tulare,107,460477,105330,102812,27153,129965,1290
2022-02-23,Tuolumne,109,53932,12516,12158,543,12701,175
2022-02-23,Ventura,111,848112,171440,171163,9269,180432,1401
2022-02-23,Yolo,113,214977,36381,35590,2950,38540,296
2022-02-23,Yuba,115,75493,15619,15571,1155,16726,113
2022-02-22,Alameda,001,1643700,251279,247434,13265,260699,1706
2022-02-22,Alpine,003,1148,122,124,1,125,0
2022-02-22,Amador,005,37829,8329,8243,628,8871,79
2022-02-22,Butte,007,227075,32658,32359,6807,39166,366
2022-02-22,Calaveras,009,45235,7159,7178,336,7514,107
2022-02-22,Colusa,011,21464,3411,3402,1038,4440,21
2022-02-22,Contra Costa,013,1133247,187176,183812,12775,196587,1201
2022-02-22,Del Norte,015,27424,5622,5611,168,5779,45
2022-02-22,El Dorado,017,186661,26421,26289,3159,29448,189
2022-02-22,Fresno,019,978130,228127,225104,23273,248377,2592
2022-02-22,Glenn,021,27897,4928,4900,1583,6483,40
2022-02-22,Humboldt,023,135768,16555,16559,2860,19419,132
2022-02-22,Imperial,025,180216,54821,54227,10431,64658,864
2022-02-22,Inyo,027,18085,4041,4026,448,4474,54
2022-02-22,Kern,029,883053,190027,188237,45198,233435,2102
2022-02-22,Kings,031,150075,50774,50359,3457,53816,423
2022-02-22,Lake,033,64148,10460,10353,860,11213,126
2022-02-22,Lassen,035,31185,8807,8730,868,9598,55
2022-02-22,Los Angeles,037,10098052,2684450,2658230,121624,2779854,30129
2022-02-22,Madera,039,155013,36837,36833,5918,42751,330
2022-02-22,Marin,041,260295,32722,32591,2145,34736,267
2022-02-22,Mariposa,043,17540,2337,2322,190,2512,6
2022-02-22,Mendocino,045,87422,12839,12714,2921,15635,110
2022-02-22,Merced,047,269075,61458,61241,8409,69650,770
2022-02-22,Modoc,049,8938,722,720,247,967,6
2022-02-22,Mono,051,14174,2954,2961,118,3079,5
2022-02-22,Monterey,053,433212,78335,77359,13055,90414,690
2022-02-22,Napa,055,140530,25190,25151,916,26067,128
2022-02-22,Nevada,057,99092,15730,15815,1146,16961,121
2022-02-22,Orange,059,3164182,541159,539390,40437,579827,6502
2022-02-22,Placer,061,380077,61972,61709,7223,68932,572
2022-02-22,Plumas,063,18699,2929,2659,355,3014,13
2022-02-22,Riverside,065,2383286,586659,583969,27363,611332,6097
2022-02-22,Sacramento,067,1510023,277209,271789,26017,297806,2775
2022-02-22,San Benito,069,59416,12737,12742,501,13243,92
2022-02-22,San Bernardino,071,2135413,568922,554903,24524,579427,6451
2022-02-22,San Diego,073,3302833,741176,734536,51584,786120,4974
2022-02-22,San Francisco,075,870044,121147,121954,8010,129964,769
2022-02-22,San Joaquin,077,732212,164592,164111,9727,173838,2040
2022-02-22,San Luis Obispo,079,281455,51505,51193,3636,54829,431
2022-02-22,San Mateo,081,765935,119169,117418,6732,124150,603
2022-02-22,Santa Barbara,083,443738,84692,84701,4620,89321,650
2022-02-22,Santa Clara,085,1922200,304438,305045,12008,317053,2155
2022-02-22,Santa Cruz,087,273765,46519,45958,2046,48004,251
2022-02-22,Shasta,089,179085,30101,30024,5985,36009,479
2022-02-22,Sierra,091,2930,271,269,46,315,0
2022-02-22,Siskiyou,093,43540,4384,4350,2662,7012,70
2022-02-22,Solano,095,438530,80094,79968,5452,85420,425
2022-02-22,Sonoma,097,501317,82040,81412,2506,83918,431
2022-02-22,Stanislaus,099,539301,116291,116676,17317,133993,1475
2022-02-22,Sutter,101,95872,20196,20164,1968,22132,210
2022-02-22,Tehama,103,63373,11895,11852,2562,14414,152
2022-02-22,Trinity,105,12862,1171,1147,283,1430,20
2022-02-22,Tulare,107,460477,105224,102717,27123,129840,1287
2022-02-22,Tuolumne,109,53932,12498,12136,542,12678,175
2022-02-22,Ventura,111,848112,171355,171064,9263,180327,1401
2022-02-22,Yolo,113,214977,36344,35527,2945,38472,292
2022-02-22,Yuba,115,75493,15609,15550,1154,16704,110
2022-02-21,Alameda,001,1643700,250992,247434,13249,260683,1704
2022-02-21,Alpine,003,1148,122,124,1,125,0
2022-02-21,Amador,005,37829,8323,8246,628,8874,79
2022-02-21,Butte,007,227075,32617,32356,6783,39139,366
2022-02-21,Calaveras,009,45235,7151,7175,336,7511,107
2022-02-21,Colusa,011,21464,3409,3401,1036,4437,21
2022-02-21,Contra Costa,013,1133247,186950,183701,12761,196462,1201
2022-02-21,Del Norte,015,27424,5604,5601,167,5768,45
2022-02-21,El Dorado,017,186661,26393,26273,3154,29427,189
2022-02-21,Fresno,019,978130,227813,224923,23217,248140,2592
2022-02-21,Glenn,021,27897,4923,4897,1583,6480,40
2022-02-21,Humboldt,023,135768,16511,16548,2852,19400,132
2022-02-21,Imperial,025,180216,54761,54208,10418,64626,864
2022-02-21,Inyo,027,18085,4038,4023,448,4471,54
2022-02-21,Kern,029,883053,189834,188188,45146,233334,2102
2022-02-21,Kings,031,150075,50708,50188,3454,53642,422
2022-02-21,Lake,033,64148,10438,10334,858,11192,126
2022-02-21,Lassen,035,31185,8799,8705,863,9568,55
2022-02-21,Los Angeles,037,10098052,2682671,2656873,121528,2778401,30108
2022-02-21,Madera,039,155013,36799,36796,5897,42693,330
2022-02-21,Marin,041,260295,32699,32570,2145,34715,258
2022-02-21,Mariposa,043,17540,2334,2321,190,2511,6
2022-02-21,Mendocino,045,87422,12813,12706,2909,15615,110
2022-02-21,Merced,047,269075,61401,61209,8392,69601,770
2022-02-21,Modoc,049,8938,721,718,247,965,6
2022-02-21,Mono,051,14174,2953,2960,118,3078,5
2022-02-21,Monterey,053,433212,78241,77354,13014,90368,690
2022-02-21,Napa,055,140530,25151,25126,916,26042,128
2022-02-21,Nevada,057,99092,15719,15810,1143,16953,121
2022-02-21,Orange,059,3164182,540809,539068,40412,579480,6502
2022-02-21,Placer,061,380077,61918,61727,7219,68946,572
2022-02-21,Plumas,063,18699,2925,2657,350,3007,13
2022-02-21,Riverside,065,2383286,586290,583712,27316,611028,6097
2022-02-21,Sacramento,067,1510023,276954,271588,25984,297572,2769
2022-02-21,San Benito,069,59416,12724,12731,501,13232,92
2022-02-21,San Bernardino,071,2135413,568681,554662,24503,579165,6441
2022-02-21,San Diego,073,3302833,740559,732298,51506,783804,4974
2022-02-21,San Francisco,075,870044,120966,121865,8006,129871,769
2022-02-21,San Joaquin,077,732212,164448,164036,9716,173752,2040
2022-02-21,San Luis Obispo,079,281455,51414,51184,3629,54813,429
2022-02-21,San Mateo,081,765935,119076,117259,6724,123983,605
2022-02-21,Santa Barbara,083,443738,84616,84626,4612,89238,650
2022-02-21,Santa Clara,085,1922200,304110,304858,12002,316860,2158
2022-02-21,Santa Cruz,087,273765,46393,45941,2045,47986,251
2022-02-21,Shasta,089,179085,30055,30004,5977,35981,479
2022-02-21,Sierra,091,2930,271,269,46,315,0
2022-02-21,Siskiyou,093,43540,4372,4337,2657,6994,70
2022-02-21,Solano,095,438530,80001,79906,5447,85353,425
2022-02-21,Sonoma,097,501317,81927,81361,2499,83860,431
2022-02-21,Stanislaus,099,539301,116179,116597,17293,133890,1475
2022-02-21,Sutter,101,95872,20171,20152,1966,22118,210
2022-02-21,Tehama,103,63373,11882,11842,2561,14403,152
2022-02-21,Trinity,105,12862,1170,1147,283,1430,20
2022-02-21,Tulare,107,460477,105130,102614,27079,129693,1287
2022-02-21,Tuolumne,109,53932,12487,12126,539,12665,175
2022-02-21,Ventura,111,848112,171216,170939,9254,180193,1401
2022-02-21,Yolo,113,214977,36301,35518,2936,38454,292
2022-02-21,Yuba,115,75493,15590,15546,1145,16691,110
2022-02-20,Alameda,001,1643700,250761,246028,13241,259269,1700
2022-02-20,Alpine,003,1148,122,124,1,125,0
2022-02-20,Amador,005,37829,8311,8203,628,8831,79
2022-02-20,Butte,007,227075,32588,32173,6778,38951,364
2022-02-20,Calaveras,009,45235,7148,7136,335,7471,107
2022-02-20,Colusa,011,21464,3406,3389,1035,4424,21
2022-02-20,Contra Costa,013,1133247,186821,182797,12756,195553,1190
2022-02-20,Del Norte,015,27424,5589,5511,167,5678,45
2022-02-20,El Dorado,017,186661,26372,26101,3153,29254,189
2022-02-20,Fresno,019,978130,227622,223594,23201,246795,2544
2022-02-20,Glenn,021,27897,4920,4881,1583,6464,39
2022-02-20,Humboldt,023,135768,16499,16393,2848,19241,132
2022-02-20,Imperial,025,180216,54696,53967,10408,64375,862
2022-02-20,Inyo,027,18085,4038,4018,447,4465,52
2022-02-20,Kern,029,883053,189699,187158,45102,232260,2095
2022-02-20,Kings,031,150075,50680,49724,3451,53175,421
2022-02-20,Lake,033,64148,10405,10184,857,11041,126
2022-02-20,Lassen,035,31185,8787,8640,863,9503,55
2022-02-20,Los Angeles,037,10098052,2681347,2642878,121444,2764322,29842
2022-02-20,Madera,039,155013,36768,36526,5893,42419,330
2022-02-20,Marin,041,260295,32682,32441,2145,34586,258
2022-02-20,Mariposa,043,17540,2328,2310,188,2498,6
2022-02-20,Mendocino,045,87422,12803,12625,2906,15531,110
2022-02-20,Merced,047,269075,61373,60886,8391,69277,769
2022-02-20,Modoc,049,8938,720,714,247,961,6
2022-02-20,Mono,051,14174,2953,2956,118,3074,5
2022-02-20,Monterey,053,433212,78181,76765,13001,89766,682
2022-02-20,Napa,055,140530,25129,24970,914,25884,127
2022-02-20,Nevada,057,99092,15708,15715,1142,16857,121
2022-02-20,Orange,059,3164182,540490,538019,40376,578395,6416
2022-02-20,Placer,061,380077,61886,61417,7211,68628,560
2022-02-20,Plumas,063,18699,2921,2646,348,2994,13
2022-02-20,Riverside,065,2383286,586023,581788,27290,609078,6087
2022-02-20,Sacramento,067,1510023,276774,270080,25960,296040,2747
2022-02-20,San Benito,069,59416,12721,12665,501,13166,92
2022-02-20,San Bernardino,071,2135413,568472,553151,24486,577637,6400
2022-02-20,San Diego,073,3302833,739987,729549,51443,780992,4947
2022-02-20,San Francisco,075,870044,120827,121197,7996,129193,756
2022-02-20,San Joaquin,077,732212,164330,163083,9705,172788,2033
2022-02-20,San Luis Obispo,079,281455,51385,50823,3625,54448,424
2022-02-20,San Mateo,081,765935,119002,116648,6717,123365,598
2022-02-20,Santa Barbara,083,443738,84572,83988,4610,88598,642
2022-02-20,Santa Clara,085,1922200,303831,303077,11994,315071,2138
2022-02-20,Santa Cruz,087,273765,46327,45532,2042,47574,250
2022-02-20,Shasta,089,179085,30025,29847,5970,35817,479
2022-02-20,Sierra,091,2930,271,269,46,315,0
2022-02-20,Siskiyou,093,43540,4367,4307,2656,6963,70
2022-02-20,Solano,095,438530,79926,78914,5443,84357,424
2022-02-20,Sonoma,097,501317,81852,80843,2496,83339,431
2022-02-20,Stanislaus,099,539301,116113,115976,17276,133252,1454
2022-02-20,Sutter,101,95872,20159,20060,1963,22023,210
2022-02-20,Tehama,103,63373,11870,11760,2558,14318,152
2022-02-20,Trinity,105,12862,1169,1130,283,1413,20
2022-02-20,Tulare,107,460477,105042,101996,27053,129049,1286
2022-02-20,Tuolumne,109,53932,12466,12036,539,12575,175
2022-02-20,Ventura,111,848112,171120,170331,9247,179578,1384
2022-02-20,Yolo,113,214977,36275,35363,2933,38296,293
2022-02-20,Yuba,115,75493,15575,15449,1144,16593,112
2022-02-19,Alameda,001,1643700,250586,246028,13237,259265,1700
2022-02-19,Alpine,003,1148,122,124,1,125,0
2022-02-19,Amador,005,37829,8307,8203,628,8831,79
2022-02-19,Butte,007,227075,32564,32173,6775,38948,364
2022-02-19,Calaveras,009,45235,7148,7136,335,7471,107
2022-02-19,Colusa,011,21464,3405,3389,1033,4422,21
2022-02-19,Contra Costa,013,1133247,186724,182797,12755,195552,1190
2022-02-19,Del Norte,015,27424,5579,5511,167,5678,45
2022-02-19,El Dorado,017,186661,26354,26101,3151,29252,189
2022-02-19,Fresno,019,978130,227507,223594,23193,246787,2544
2022-02-19,Glenn,021,27897,4916,4881,1583,6464,39
2022-02-19,Humboldt,023,135768,16484,16393,2848,19241,132
2022-02-19,Imperial,025,180216,54680,53967,10403,64370,862
2022-02-19,Inyo,027,18085,4037,4018,446,4464,52
2022-02-19,Kern,029,883053,189596,187158,45078,232236,2095
2022-02-19,Kings,031,150075,50657,49724,3450,53174,421
2022-02-19,Lake,033,64148,10396,10184,857,11041,126
2022-02-19,Lassen,035,31185,8775,8640,862,9502,55
2022-02-19,Los Angeles,037,10098052,2680555,2642878,121403,2764281,29842
2022-02-19,Madera,039,155013,36746,36526,5891,42417,330
2022-02-19,Marin,041,260295,32659,32441,2144,34585,258
2022-02-19,Mariposa,043,17540,2325,2310,188,2498,6
2022-02-19,Mendocino,045,87422,12793,12625,2906,15531,110
2022-02-19,Merced,047,269075,61328,60886,8387,69273,769
2022-02-19,Modoc,049,8938,720,714,246,960,6
2022-02-19,Mono,051,14174,2952,2956,118,3074,5
2022-02-19,Monterey,053,433212,78092,76765,12990,89755,682
2022-02-19,Napa,055,140530,25119,24970,914,25884,127
2022-02-19,Nevada,057,99092,15700,15715,1142,16857,121
2022-02-19,Orange,059,3164182,540288,538019,40351,578370,6416
2022-02-19,Placer,061,380077,61839,61417,7211,68628,560
2022-02-19,Plumas,063,18699,2920,2646,348,2994,13
2022-02-19,Riverside,065,2383286,585840,581788,27278,609066,6087
2022-02-19,Sacramento,067,1510023,276631,270080,25949,296029,2747
2022-02-19,San Benito,069,59416,12708,12665,500,13165,92
2022-02-19,San Bernardino,071,2135413,568309,553151,24479,577630,6400
2022-02-19,San Diego,073,3302833,739642,729549,51396,780945,4947
2022-02-19,San Francisco,075,870044,120741,121197,7992,129189,756
2022-02-19,San Joaquin,077,732212,164258,163083,9694,172777,2033
2022-02-19,San Luis Obispo,079,281455,51372,50823,3621,54444,424
2022-02-19,San Mateo,081,765935,118961,116648,6716,123364,598
2022-02-19,Santa Barbara,083,443738,84505,83988,4609,88597,642
2022-02-19,Santa Clara,085,1922200,303638,303077,11992,315069,2138
2022-02-19,Santa Cruz,087,273765,46289,45532,2040,47572,250
2022-02-19,Shasta,089,179085,30011,29847,5967,35814,479
2022-02-19,Sierra,091,2930,271,269,46,315,0
2022-02-19,Siskiyou,093,43540,4364,4307,2656,6963,70
2022-02-19,Solano,095,438530,79884,78914,5442,84356,424
2022-02-19,Sonoma,097,501317,81810,80843,2496,83339,431
2022-02-19,Stanislaus,099,539301,116041,115976,17270,133246,1454
2022-02-19,Sutter,101,95872,20151,20060,1963,22023,210
2022-02-19,Tehama,103,63373,11863,11760,2558,14318,152
2022-02-19,Trinity,105,12862,1167,1130,283,1413,20
2022-02-19,Tulare,107,460477,104995,101996,27028,129024,1286
2022-02-19,Tuolumne,109,53932,12457,12036,539,12575,175
2022-02-19,Ventura,111,848112,171045,170331,9243,179574,1384
2022-02-19,Yolo,113,214977,36244,35363,2929,38292,293
2022-02-19,Yuba,115,75493,15566,15449,1144,16593,112
2022-02-18,Alameda,001,1643700,250419,246028,13229,259257,1700
2022-02-18,Alpine,003,1148,121,124,1,125,0
2022-02-18,Amador,005,37829,8300,8203,626,8829,79
2022-02-18,Butte,007,227075,32543,32173,6769,38942,364
2022-02-18,Calaveras,009,45235,7143,7136,334,7470,107
2022-02-18,Colusa,011,21464,3403,3389,1033,4422,21
2022-02-18,Contra Costa,013,1133247,186617,182797,12749,195546,1190
2022-02-18,Del Norte,015,27424,5568,5511,167,5678,45
2022-02-18,El Dorado,017,186661,26343,26101,3151,29252,189
2022-02-18,Fresno,019,978130,227320,223594,23182,246776,2544
2022-02-18,Glenn,021,27897,4915,4881,1582,6463,39
2022-02-18,Humboldt,023,135768,16467,16393,2843,19236,132
2022-02-18,Imperial,025,180216,54654,53967,10392,64359,862
2022-02-18,Inyo,027,18085,4035,4018,446,4464,52
2022-02-18,Kern,029,883053,189484,187158,45033,232191,2095
2022-02-18,Kings,031,150075,50570,49724,3450,53174,421
2022-02-18,Lake,033,64148,10378,10184,855,11039,126
2022-02-18,Lassen,035,31185,8755,8640,861,9501,55
2022-02-18,Los Angeles,037,10098052,2679570,2642878,121348,2764226,29842
2022-02-18,Madera,039,155013,36723,36526,5889,42415,330
2022-02-18,Marin,041,260295,32641,32441,2142,34583,258
2022-02-18,Mariposa,043,17540,2323,2310,188,2498,6
2022-02-18,Mendocino,045,87422,12783,12625,2906,15531,110
2022-02-18,Merced,047,269075,61285,60886,8377,69263,769
2022-02-18,Modoc,049,8938,720,714,246,960,6
2022-02-18,Mono,051,14174,2952,2956,118,3074,5
2022-02-18,Monterey,053,433212,78019,76765,12982,89747,682
2022-02-18,Napa,055,140530,25101,24970,914,25884,127
2022-02-18,Nevada,057,99092,15692,15715,1142,16857,121
2022-02-18,Orange,059,3164182,540052,538019,40312,578331,6416
2022-02-18,Placer,061,380077,61810,61417,7204,68621,560
2022-02-18,Plumas,063,18699,2917,2646,348,2994,13
2022-02-18,Riverside,065,2383286,585660,581788,27270,609058,6087
2022-02-18,Sacramento,067,1510023,276439,270080,25941,296021,2747
2022-02-18,San Benito,069,59416,12700,12665,500,13165,92
2022-02-18,San Bernardino,071,2135413,568131,553151,24474,577625,6400
2022-02-18,San Diego,073,3302833,739218,729549,51371,780920,4947
2022-02-18,San Francisco,075,870044,120653,121197,7984,129181,756
2022-02-18,San Joaquin,077,732212,164189,163083,9687,172770,2033
2022-02-18,San Luis Obispo,079,281455,51356,50823,3618,54441,424
2022-02-18,San Mateo,081,765935,118896,116648,6713,123361,598
2022-02-18,Santa Barbara,083,443738,84465,83988,4607,88595,642
2022-02-18,Santa Clara,085,1922200,303404,303077,11991,315068,2138
2022-02-18,Santa Cruz,087,273765,46255,45532,2039,47571,250
2022-02-18,Shasta,089,179085,29998,29847,5966,35813,479
2022-02-18,Sierra,091,2930,271,269,46,315,0
2022-02-18,Siskiyou,093,43540,4361,4307,2654,6961,70
2022-02-18,Solano,095,438530,79814,78914,5441,84355,424
2022-02-18,Sonoma,097,501317,81754,80843,2495,83338,431
2022-02-18,Stanislaus,099,539301,115991,115976,17256,133232,1454
2022-02-18,Sutter,101,95872,20139,20060,1963,22023,210
2022-02-18,Tehama,103,63373,11852,11760,2558,14318,152
2022-02-18,Trinity,105,12862,1166,1130,282,1412,20
2022-02-18,Tulare,107,460477,104944,101996,26987,128983,1286
2022-02-18,Tuolumne,109,53932,12451,12036,538,12574,175
2022-02-18,Ventura,111,848112,170955,170331,9238,179569,1384
2022-02-18,Yolo,113,214977,36216,35363,2927,38290,293
2022-02-18,Yuba,115,75493,15551,15449,1144,16593,112
2022-02-17,Alameda,001,1643700,250156,246028,13209,259237,1700
2022-02-17,Alpine,003,1148,121,124,1,125,0
2022-02-17,Amador,005,37829,8296,8203,624,8827,79
2022-02-17,Butte,007,227075,32505,32173,6765,38938,364
2022-02-17,Calaveras,009,45235,7134,7136,331,7467,107
2022-02-17,Colusa,011,21464,3400,3389,1033,4422,21
2022-02-17,Contra Costa,013,1133247,186422,182797,12717,195514,1190
2022-02-17,Del Norte,015,27424,5547,5511,167,5678,45
2022-02-17,El Dorado,017,186661,26317,26101,3141,29242,189
2022-02-17,Fresno,019,978130,227026,223594,23151,246745,2544
2022-02-17,Glenn,021,27897,4913,4881,1579,6460,39
2022-02-17,Humboldt,023,135768,16427,16393,2842,19235,132
2022-02-17,Imperial,025,180216,54583,53967,10376,64343,862
2022-02-17,Inyo,027,18085,4033,4018,445,4463,52
2022-02-17,Kern,029,883053,189330,187158,44984,232142,2095
2022-02-17,Kings,031,150075,50506,49724,3445,53169,421
2022-02-17,Lake,033,64148,10348,10184,851,11035,126
2022-02-17,Lassen,035,31185,8745,8640,859,9499,55
2022-02-17,Los Angeles,037,10098052,2677729,2642878,121268,2764146,29842
2022-02-17,Madera,039,155013,36680,36526,5882,42408,330
2022-02-17,Marin,041,260295,32615,32441,2141,34582,258
2022-02-17,Mariposa,043,17540,2321,2310,187,2497,6
2022-02-17,Mendocino,045,87422,12766,12625,2903,15528,110
2022-02-17,Merced,047,269075,61211,60886,8361,69247,769
2022-02-17,Modoc,049,8938,719,714,246,960,6
2022-02-17,Mono,051,14174,2950,2956,118,3074,5
2022-02-17,Monterey,053,433212,77907,76765,12940,89705,682
2022-02-17,Napa,055,140530,25069,24970,912,25882,127
2022-02-17,Nevada,057,99092,15680,15715,1141,16856,121
2022-02-17,Orange,059,3164182,539713,538019,40285,578304,6416
2022-02-17,Placer,061,380077,61768,61417,7196,68613,560
2022-02-17,Plumas,063,18699,2914,2646,348,2994,13
2022-02-17,Riverside,065,2383286,585287,581788,27243,609031,6087
2022-02-17,Sacramento,067,1510023,276154,270080,25893,295973,2747
2022-02-17,San Benito,069,59416,12689,12665,500,13165,92
2022-02-17,San Bernardino,071,2135413,567826,553151,24460,577611,6400
2022-02-17,San Diego,073,3302833,738622,729549,51320,780869,4947
2022-02-17,San Francisco,075,870044,120519,121197,7974,129171,756
2022-02-17,San Joaquin,077,732212,164025,163083,9673,172756,2033
2022-02-17,San Luis Obispo,079,281455,51251,50823,3610,54433,424
2022-02-17,San Mateo,081,765935,118802,116648,6704,123352,598
2022-02-17,Santa Barbara,083,443738,84365,83988,4600,88588,642
2022-02-17,Santa Clara,085,1922200,303040,303077,11977,315054,2138
2022-02-17,Santa Cruz,087,273765,46173,45532,2037,47569,250
2022-02-17,Shasta,089,179085,29971,29847,5963,35810,479
2022-02-17,Sierra,091,2930,271,269,46,315,0
2022-02-17,Siskiyou,093,43540,4352,4307,2650,6957,70
2022-02-17,Solano,095,438530,79733,78914,5434,84348,424
2022-02-17,Sonoma,097,501317,81688,80843,2488,83331,431
2022-02-17,Stanislaus,099,539301,115887,115976,17239,133215,1454
2022-02-17,Sutter,101,95872,20124,20060,1955,22015,210
2022-02-17,Tehama,103,63373,11844,11760,2557,14317,152
2022-02-17,Trinity,105,12862,1164,1130,280,1410,20
2022-02-17,Tulare,107,460477,104831,101996,26963,128959,1286
2022-02-17,Tuolumne,109,53932,12440,12036,538,12574,175
2022-02-17,Ventura,111,848112,170815,170331,9237,179568,1384
2022-02-17,Yolo,113,214977,36178,35363,2926,38289,293
2022-02-17,Yuba,115,75493,15536,15449,1144,16593,112
2022-02-16,Alameda,001,1643700,249845,245662,13171,258833,1691
2022-02-16,Alpine,003,1148,121,124,1,125,0
2022-02-16,Amador,005,37829,8278,8197,623,8820,77
2022-02-16,Butte,007,227075,32462,32095,6752,38847,363
2022-02-16,Calaveras,009,45235,7130,7129,328,7457,107
2022-02-16,Colusa,011,21464,3395,3384,1033,4417,21
2022-02-16,Contra Costa,013,1133247,186187,182423,12681,195104,1179
2022-02-16,Del Norte,015,27424,5527,5473,164,5637,45
2022-02-16,El Dorado,017,186661,26290,26061,3137,29198,189
2022-02-16,Fresno,019,978130,226666,223056,23102,246158,2542
2022-02-16,Glenn,021,27897,4909,4873,1574,6447,39
2022-02-16,Humboldt,023,135768,16403,16342,2832,19174,132
2022-02-16,Imperial,025,180216,54505,53901,10348,64249,861
2022-02-16,Inyo,027,18085,4030,4013,444,4457,52
2022-02-16,Kern,029,883053,189113,186740,44899,231639,2084
2022-02-16,Kings,031,150075,50453,49575,3437,53012,420
2022-02-16,Lake,033,64148,10322,10145,851,10996,125
2022-02-16,Lassen,035,31185,8712,8618,859,9477,55
2022-02-16,Los Angeles,037,10098052,2675634,2640005,121159,2761164,29749
2022-02-16,Madera,039,155013,36612,36382,5868,42250,330
2022-02-16,Marin,041,260295,32579,32381,2139,34520,257
2022-02-16,Mariposa,043,17540,2319,2305,187,2492,6
2022-02-16,Mendocino,045,87422,12744,12605,2893,15498,108
2022-02-16,Merced,047,269075,61145,60776,8329,69105,767
2022-02-16,Modoc,049,8938,719,711,242,953,6
2022-02-16,Mono,051,14174,2948,2953,118,3071,5
2022-02-16,Monterey,053,433212,77760,76624,12899,89523,682
2022-02-16,Napa,055,140530,25030,24897,909,25806,128
2022-02-16,Nevada,057,99092,15663,15677,1137,16814,121
2022-02-16,Orange,059,3164182,539311,537934,40241,578175,6392
2022-02-16,Placer,061,380077,61725,61278,7184,68462,556
2022-02-16,Plumas,063,18699,2911,2644,346,2990,13
2022-02-16,Riverside,065,2383286,584889,580828,27197,608025,6064
2022-02-16,Sacramento,067,1510023,275830,269416,25837,295253,2736
2022-02-16,San Benito,069,59416,12662,12644,500,13144,92
2022-02-16,San Bernardino,071,2135413,567550,552353,24438,576791,6379
2022-02-16,San Diego,073,3302833,737862,728610,51245,779855,4931
2022-02-16,San Francisco,075,870044,120346,120987,7971,128958,756
2022-02-16,San Joaquin,077,732212,163858,162752,9663,172415,2032
2022-02-16,San Luis Obispo,079,281455,51179,50704,3598,54302,425
2022-02-16,San Mateo,081,765935,118684,116438,6686,123124,595
2022-02-16,Santa Barbara,083,443738,84289,83968,4588,88556,642
2022-02-16,Santa Clara,085,1922200,302654,302439,11944,314383,2130
2022-02-16,Santa Cruz,087,273765,46082,45274,2035,47309,250
2022-02-16,Shasta,089,179085,29933,29767,5951,35718,477
2022-02-16,Sierra,091,2930,270,269,46,315,0
2022-02-16,Siskiyou,093,43540,4345,4302,2644,6946,71
2022-02-16,Solano,095,438530,79618,78742,5428,84170,422
2022-02-16,Sonoma,097,501317,81560,80642,2478,83120,431
2022-02-16,Stanislaus,099,539301,115768,115751,17208,132959,1443
2022-02-16,Sutter,101,95872,20107,20020,1952,21972,210
2022-02-16,Tehama,103,63373,11827,11738,2555,14293,152
2022-02-16,Trinity,105,12862,1164,1130,279,1409,20
2022-02-16,Tulare,107,460477,104711,101817,26913,128730,1281
2022-02-16,Tuolumne,109,53932,12428,11991,537,12528,171
2022-02-16,Ventura,111,848112,170679,170117,9229,179346,1372
2022-02-16,Yolo,113,214977,36127,35284,2924,38208,292
2022-02-16,Yuba,115,75493,15514,15405,1141,16546,110
2022-02-15,Alameda,001,1643700,249494,245265,13143,258408,1683
2022-02-15,Alpine,003,1148,121,124,1,125,0
2022-02-15,Amador,005,37829,8268,8183,622,8805,77
2022-02-15,Butte,007,227075,32412,32011,6738,38749,361
2022-02-15,Calaveras,009,45235,7120,7115,328,7443,106
2022-02-15,Colusa,011,21464,3387,3374,1032,4406,21
2022-02-15,Contra Costa,013,1133247,185929,182041,12651,194692,1179
2022-02-15,Del Norte,015,27424,5499,5439,163,5602,45
2022-02-15,El Dorado,017,186661,26271,25988,3132,29120,189
2022-02-15,Fresno,019,978130,226292,222673,23044,245717,2543
2022-02-15,Glenn,021,27897,4900,4862,1573,6435,39
2022-02-15,Humboldt,023,135768,16359,16297,2817,19114,132
2022-02-15,Imperial,025,180216,54442,53813,10333,64146,860
2022-02-15,Inyo,027,18085,4029,4009,443,4452,52
2022-02-15,Kern,029,883053,188893,186324,44809,231133,2072
2022-02-15,Kings,031,150075,50360,49473,3428,52901,418
2022-02-15,Lake,033,64148,10290,10112,845,10957,123
2022-02-15,Lassen,035,31185,8698,8587,857,9444,55
2022-02-15,Los Angeles,037,10098052,2673374,2638266,121027,2759293,29691
2022-02-15,Madera,039,155013,36546,36260,5848,42108,330
2022-02-15,Marin,041,260295,32537,32355,2137,34492,255
2022-02-15,Mariposa,043,17540,2318,2302,187,2489,6
2022-02-15,Mendocino,045,87422,12727,12580,2874,15454,108
2022-02-15,Merced,047,269075,61064,60674,8298,68972,763
2022-02-15,Modoc,049,8938,717,710,239,949,6
2022-02-15,Mono,051,14174,2947,2952,118,3070,5
2022-02-15,Monterey,053,433212,77634,75530,12841,88371,682
2022-02-15,Napa,055,140530,24980,24832,902,25734,127
2022-02-15,Nevada,057,99092,15637,15643,1136,16779,121
2022-02-15,Orange,059,3164182,538853,537478,40199,577677,6374
2022-02-15,Placer,061,380077,61664,61170,7173,68343,554
2022-02-15,Plumas,063,18699,2907,2638,346,2984,13
2022-02-15,Riverside,065,2383286,584402,579940,27138,607078,6049
2022-02-15,Sacramento,067,1510023,275443,268950,25759,294709,2721
2022-02-15,San Benito,069,59416,12643,12616,500,13116,91
2022-02-15,San Bernardino,071,2135413,567188,551803,24418,576221,6372
2022-02-15,San Diego,073,3302833,736900,727486,51147,778633,4914
2022-02-15,San Francisco,075,870044,120175,120759,7960,128719,756
2022-02-15,San Joaquin,077,732212,163640,162518,9650,172168,2021
2022-02-15,San Luis Obispo,079,281455,51082,50534,3583,54117,419
2022-02-15,San Mateo,081,765935,118548,116253,6666,122919,595
2022-02-15,Santa Barbara,083,443738,84154,83734,4574,88308,640
2022-02-15,Santa Clara,085,1922200,302162,301831,11907,313738,2130
2022-02-15,Santa Cruz,087,273765,45978,45171,2030,47201,250
2022-02-15,Shasta,089,179085,29882,29684,5937,35621,477
2022-02-15,Sierra,091,2930,270,269,46,315,0
2022-02-15,Siskiyou,093,43540,4338,4288,2637,6925,70
2022-02-15,Solano,095,438530,79484,78626,5423,84049,426
2022-02-15,Sonoma,097,501317,81439,80433,2472,82905,431
2022-02-15,Stanislaus,099,539301,115627,115549,17177,132726,1429
2022-02-15,Sutter,101,95872,20079,19980,1947,21927,208
2022-02-15,Tehama,103,63373,11809,11717,2553,14270,151
2022-02-15,Trinity,105,12862,1158,1125,276,1401,20
2022-02-15,Tulare,107,460477,104559,101645,26858,128503,1278
2022-02-15,Tuolumne,109,53932,12409,11945,535,12480,171
2022-02-15,Ventura,111,848112,170505,169942,9222,179164,1372
2022-02-15,Yolo,113,214977,36076,35241,2916,38157,289
2022-02-15,Yuba,115,75493,15486,15372,1136,16508,109
2022-02-14,Alameda,001,1643700,249059,244315,13111,257426,1677
2022-02-14,Alpine,003,1148,121,125,1,126,0
2022-02-14,Amador,005,37829,8253,8164,619,8783,77
2022-02-14,Butte,007,227075,32355,31946,6723,38669,360
2022-02-14,Calaveras,009,45235,7107,7097,326,7423,106
2022-02-14,Colusa,011,21464,3384,3367,1028,4395,21
2022-02-14,Contra Costa,013,1133247,185647,181753,12613,194366,1167
2022-02-14,Del Norte,015,27424,5476,5426,162,5588,45
2022-02-14,El Dorado,017,186661,26236,25915,3123,29038,188
2022-02-14,Fresno,019,978130,225812,222360,22956,245316,2538
2022-02-14,Glenn,021,27897,4894,4854,1573,6427,39
2022-02-14,Humboldt,023,135768,16319,16264,2792,19056,132
2022-02-14,Imperial,025,180216,54371,53765,10307,64072,860
2022-02-14,Inyo,027,18085,4028,4010,442,4452,52
2022-02-14,Kern,029,883053,188549,186037,44701,230738,2063
2022-02-14,Kings,031,150075,50254,49395,3419,52814,419
2022-02-14,Lake,033,64148,10253,10090,842,10932,123
2022-02-14,Lassen,035,31185,8688,8539,855,9394,55
2022-02-14,Los Angeles,037,10098052,2670791,2636064,120899,2756963,29650
2022-02-14,Madera,039,155013,36481,36194,5825,42019,330
2022-02-14,Marin,041,260295,32501,32304,2134,34438,255
2022-02-14,Mariposa,043,17540,2311,2295,187,2482,6
2022-02-14,Mendocino,045,87422,12700,12541,2842,15383,108
2022-02-14,Merced,047,269075,60975,60591,8256,68847,758
2022-02-14,Modoc,049,8938,712,707,239,946,6
2022-02-14,Mono,051,14174,2946,2954,118,3072,5
2022-02-14,Monterey,053,433212,77463,75407,12761,88168,678
2022-02-14,Napa,055,140530,24921,24776,902,25678,127
2022-02-14,Nevada,057,99092,15618,15629,1135,16764,121
2022-02-14,Orange,059,3164182,538348,536924,40134,577058,6355
2022-02-14,Placer,061,380077,61594,61123,7158,68281,554
2022-02-14,Plumas,063,18699,2905,2631,346,2977,13
2022-02-14,Riverside,065,2383286,583856,579174,27070,606244,5994
2022-02-14,Sacramento,067,1510023,275003,268547,25648,294195,2717
2022-02-14,San Benito,069,59416,12619,12598,499,13097,91
2022-02-14,San Bernardino,071,2135413,566772,551338,24398,575736,6372
2022-02-14,San Diego,073,3302833,735932,723902,51049,774951,4894
2022-02-14,San Francisco,075,870044,119984,120581,7950,128531,756
2022-02-14,San Joaquin,077,732212,163403,162363,9627,171990,2018
2022-02-14,San Luis Obispo,079,281455,50974,50465,3573,54038,416
2022-02-14,San Mateo,081,765935,118384,116129,6658,122787,592
2022-02-14,Santa Barbara,083,443738,84008,83697,4564,88261,636
2022-02-14,Santa Clara,085,1922200,301630,301319,11883,313202,2127
2022-02-14,Santa Cruz,087,273765,45815,45042,2026,47068,250
2022-02-14,Shasta,089,179085,29796,29595,5920,35515,474
2022-02-14,Sierra,091,2930,270,269,46,315,0
2022-02-14,Siskiyou,093,43540,4325,4278,2623,6901,69
2022-02-14,Solano,095,438530,79305,78533,5411,83944,427
2022-02-14,Sonoma,097,501317,81299,80336,2460,82796,431
2022-02-14,Stanislaus,099,539301,115449,115426,17136,132562,1406
2022-02-14,Sutter,101,95872,20051,19957,1941,21898,209
2022-02-14,Tehama,103,63373,11786,11686,2552,14238,151
2022-02-14,Trinity,105,12862,1155,1123,276,1399,20
2022-02-14,Tulare,107,460477,104353,101448,26763,128211,1276
2022-02-14,Tuolumne,109,53932,12380,11920,532,12452,170
2022-02-14,Ventura,111,848112,170328,169725,9210,178935,1361
2022-02-14,Yolo,113,214977,36017,35112,2906,38018,286
2022-02-14,Yuba,115,75493,15456,15375,1132,16507,108
2022-02-13,Alameda,001,1643700,248569,243681,13076,256757,1677
2022-02-13,Alpine,003,1148,121,125,1,126,0
2022-02-13,Amador,005,37829,8224,8146,616,8762,77
2022-02-13,Butte,007,227075,32282,31865,6701,38566,360
2022-02-13,Calaveras,009,45235,7100,7083,323,7406,106
2022-02-13,Colusa,011,21464,3382,3366,1026,4392,21
2022-02-13,Contra Costa,013,1133247,185283,181313,12549,193862,1159
2022-02-13,Del Norte,015,27424,5443,5379,162,5541,45
2022-02-13,El Dorado,017,186661,26199,25871,3115,28986,188
2022-02-13,Fresno,019,978130,225273,221686,22895,244581,2537
2022-02-13,Glenn,021,27897,4884,4847,1570,6417,39
2022-02-13,Humboldt,023,135768,16272,16210,2764,18974,132
2022-02-13,Imperial,025,180216,54273,53658,10272,63930,860
2022-02-13,Inyo,027,18085,4025,4006,440,4446,52
2022-02-13,Kern,029,883053,188297,185640,44616,230256,2063
2022-02-13,Kings,031,150075,50127,49243,3408,52651,416
2022-02-13,Lake,033,64148,10190,10042,835,10877,123
2022-02-13,Lassen,035,31185,8663,8503,853,9356,55
2022-02-13,Los Angeles,037,10098052,2667618,2631267,120760,2752027,29595
2022-02-13,Madera,039,155013,36364,36054,5797,41851,330
2022-02-13,Marin,041,260295,32430,32222,2127,34349,255
2022-02-13,Mariposa,043,17540,2305,2292,185,2477,6
2022-02-13,Mendocino,045,87422,12670,12521,2803,15324,108
2022-02-13,Merced,047,269075,60833,60460,8203,68663,758
2022-02-13,Modoc,049,8938,710,704,232,936,6
2022-02-13,Mono,051,14174,2945,2949,118,3067,5
2022-02-13,Monterey,053,433212,77256,75295,12687,87982,678
2022-02-13,Napa,055,140530,24844,24743,899,25642,127
2022-02-13,Nevada,057,99092,15584,15590,1128,16718,121
2022-02-13,Orange,059,3164182,537721,536134,40072,576206,6355
2022-02-13,Placer,061,380077,61518,61020,7137,68157,554
2022-02-13,Plumas,063,18699,2897,2626,343,2969,13
2022-02-13,Riverside,065,2383286,583264,578363,27029,605392,5995
2022-02-13,Sacramento,067,1510023,274496,267947,25519,293466,2699
2022-02-13,San Benito,069,59416,12586,12578,498,13076,91
2022-02-13,San Bernardino,071,2135413,566282,550632,24365,574997,6367
2022-02-13,San Diego,073,3302833,734794,723902,50930,774832,4894
2022-02-13,San Francisco,075,870044,119732,120295,7938,128233,756
2022-02-13,San Joaquin,077,732212,163102,162028,9599,171627,2018
2022-02-13,San Luis Obispo,079,281455,50829,50384,3565,53949,415
2022-02-13,San Mateo,081,765935,118163,115876,6633,122509,592
2022-02-13,Santa Barbara,083,443738,83843,83547,4557,88104,635
2022-02-13,Santa Clara,085,1922200,300992,300412,11846,312258,2114
2022-02-13,Santa Cruz,087,273765,45660,44887,2024,46911,240
2022-02-13,Shasta,089,179085,29717,29531,5897,35428,474
2022-02-13,Sierra,091,2930,270,269,46,315,0
2022-02-13,Siskiyou,093,43540,4318,4264,2607,6871,69
2022-02-13,Solano,095,438530,79149,78424,5387,83811,426
2022-02-13,Sonoma,097,501317,81135,80172,2448,82620,431
2022-02-13,Stanislaus,099,539301,115253,115156,17096,132252,1406
2022-02-13,Sutter,101,95872,20012,19900,1941,21841,209
2022-02-13,Tehama,103,63373,11760,11644,2549,14193,151
2022-02-13,Trinity,105,12862,1152,1120,273,1393,20
2022-02-13,Tulare,107,460477,104138,101135,26675,127810,1276
2022-02-13,Tuolumne,109,53932,12354,11891,527,12418,170
2022-02-13,Ventura,111,848112,170134,169422,9190,178612,1361
2022-02-13,Yolo,113,214977,35950,35057,2894,37951,286
2022-02-13,Yuba,115,75493,15422,15346,1131,16477,107
2022-02-12,Alameda,001,1643700,248347,242137,13062,255199,1668
2022-02-12,Alpine,003,1148,121,124,1,125,0
2022-02-12,Amador,005,37829,8218,8091,616,8707,76
2022-02-12,Butte,007,227075,32255,31601,6695,38296,360
2022-02-12,Calaveras,009,45235,7097,7022,322,7344,106
2022-02-12,Colusa,011,21464,3379,3345,1026,4371,21
2022-02-12,Contra Costa,013,1133247,185092,180270,12542,192812,1141
2022-02-12,Del Norte,015,27424,5424,5262,162,5424,45
2022-02-12,El Dorado,017,186661,26183,25692,3115,28807,188
2022-02-12,Fresno,019,978130,225062,219909,22880,242789,2509
2022-02-12,Glenn,021,27897,4883,4818,1569,6387,39
2022-02-12,Humboldt,023,135768,16248,16058,2761,18819,132
2022-02-12,Imperial,025,180216,54229,53304,10262,63566,860
2022-02-12,Inyo,027,18085,4023,3991,440,4431,52
2022-02-12,Kern,029,883053,188186,184639,44579,229218,2037
2022-02-12,Kings,031,150075,50087,48893,3401,52294,415
2022-02-12,Lake,033,64148,10169,9926,831,10757,123
2022-02-12,Lassen,035,31185,8640,8477,852,9329,55
2022-02-12,Los Angeles,037,10098052,2666457,2616426,120688,2737114,29364
2022-02-12,Madera,039,155013,36330,35710,5790,41500,330
2022-02-12,Marin,041,260295,32398,32048,2124,34172,255
2022-02-12,Mariposa,043,17540,2305,2286,185,2471,6
2022-02-12,Mendocino,045,87422,12654,12439,2803,15242,107
2022-02-12,Merced,047,269075,60779,60187,8198,68385,758
2022-02-12,Modoc,049,8938,710,697,232,929,6
2022-02-12,Mono,051,14174,2944,2939,118,3057,5
2022-02-12,Monterey,053,433212,77195,74842,12665,87507,672
2022-02-12,Napa,055,140530,24816,24530,899,25429,124
2022-02-12,Nevada,057,99092,15571,15499,1127,16626,119
2022-02-12,Orange,059,3164182,537431,534503,40036,574539,6305
2022-02-12,Placer,061,380077,61461,60636,7134,67770,554
2022-02-12,Plumas,063,18699,2896,2617,342,2959,13
2022-02-12,Riverside,065,2383286,582902,575566,27006,602572,5961
2022-02-12,Sacramento,067,1510023,274260,266347,25510,291857,2686
2022-02-12,San Benito,069,59416,12574,12526,498,13024,91
2022-02-12,San Bernardino,071,2135413,566047,548822,24353,573175,6360
2022-02-12,San Diego,073,3302833,734294,720287,50881,771168,4854
2022-02-12,San Francisco,075,870044,119610,119113,7927,127040,740
2022-02-12,San Joaquin,077,732212,162971,161234,9593,170827,2014
2022-02-12,San Luis Obispo,079,281455,50793,50064,3562,53626,416
2022-02-12,San Mateo,081,765935,118075,115235,6626,121861,589
2022-02-12,Santa Barbara,083,443738,83757,83390,4550,87940,631
2022-02-12,Santa Clara,085,1922200,300656,298176,11838,310014,2093
2022-02-12,Santa Cruz,087,273765,45624,44447,2022,46469,239
2022-02-12,Shasta,089,179085,29688,29370,5893,35263,473
2022-02-12,Sierra,091,2930,270,268,46,314,0
2022-02-12,Siskiyou,093,43540,4310,4231,2604,6835,68
2022-02-12,Solano,095,438530,79107,77865,5382,83247,424
2022-02-12,Sonoma,097,501317,81031,79533,2446,81979,431
2022-02-12,Stanislaus,099,539301,115128,114531,17084,131615,1406
2022-02-12,Sutter,101,95872,19997,19800,1941,21741,211
2022-02-12,Tehama,103,63373,11745,11580,2549,14129,151
2022-02-12,Trinity,105,12862,1151,1115,273,1388,20
2022-02-12,Tulare,107,460477,104043,100434,26638,127072,1273
2022-02-12,Tuolumne,109,53932,12336,11754,527,12281,125
2022-02-12,Ventura,111,848112,170027,168736,9185,177921,1340
2022-02-12,Yolo,113,214977,35909,34773,2891,37664,286
2022-02-12,Yuba,115,75493,15408,15242,1130,16372,107
2022-02-11,Alameda,001,1643700,248067,242137,13047,255184,1668
2022-02-11,Alpine,003,1148,121,124,1,125,0
2022-02-11,Amador,005,37829,8206,8091,616,8707,76
2022-02-11,Butte,007,227075,32211,31601,6684,38285,360
2022-02-11,Calaveras,009,45235,7094,7022,322,7344,106
2022-02-11,Colusa,011,21464,3377,3345,1025,4370,21
2022-02-11,Contra Costa,013,1133247,184887,180270,12523,192793,1141
2022-02-11,Del Norte,015,27424,5408,5262,161,5423,45
2022-02-11,El Dorado,017,186661,26164,25692,3114,28806,188
2022-02-11,Fresno,019,978130,224767,219909,22862,242771,2509
2022-02-11,Glenn,021,27897,4879,4818,1569,6387,39
2022-02-11,Humboldt,023,135768,16220,16058,2756,18814,132
2022-02-11,Imperial,025,180216,54199,53304,10251,63555,860
2022-02-11,Inyo,027,18085,4019,3991,436,4427,52
2022-02-11,Kern,029,883053,188028,184639,44528,229167,2037
2022-02-11,Kings,031,150075,50047,48893,3400,52293,415
2022-02-11,Lake,033,64148,10144,9926,829,10755,123
2022-02-11,Lassen,035,31185,8600,8477,852,9329,55
2022-02-11,Los Angeles,037,10098052,2664826,2616426,120598,2737024,29364
2022-02-11,Madera,039,155013,36288,35710,5784,41494,330
2022-02-11,Marin,041,260295,32366,32048,2121,34169,255
2022-02-11,Mariposa,043,17540,2300,2286,185,2471,6
2022-02-11,Mendocino,045,87422,12638,12439,2803,15242,107
2022-02-11,Merced,047,269075,60729,60187,8191,68378,758
2022-02-11,Modoc,049,8938,708,697,232,929,6
2022-02-11,Mono,051,14174,2943,2939,118,3057,5
2022-02-11,Monterey,053,433212,77079,74842,12652,87494,672
2022-02-11,Napa,055,140530,24789,24530,899,25429,124
2022-02-11,Nevada,057,99092,15557,15499,1124,16623,119
2022-02-11,Orange,059,3164182,537080,534503,39976,574479,6305
2022-02-11,Placer,061,380077,61409,60636,7132,67768,554
2022-02-11,Plumas,063,18699,2892,2617,340,2957,13
2022-02-11,Riverside,065,2383286,582485,575566,26990,602556,5961
2022-02-11,Sacramento,067,1510023,273996,266347,25498,291845,2686
2022-02-11,San Benito,069,59416,12569,12526,498,13024,91
2022-02-11,San Bernardino,071,2135413,565730,548822,24339,573161,6360
2022-02-11,San Diego,073,3302833,733591,720287,50822,771109,4854
2022-02-11,San Francisco,075,870044,119489,119113,7911,127024,740
2022-02-11,San Joaquin,077,732212,162803,161234,9581,170815,2014
2022-02-11,San Luis Obispo,079,281455,50756,50064,3558,53622,416
2022-02-11,San Mateo,081,765935,117957,115235,6617,121852,589
2022-02-11,Santa Barbara,083,443738,83673,83390,4549,87939,631
2022-02-11,Santa Clara,085,1922200,300233,298176,11821,309997,2093
2022-02-11,Santa Cruz,087,273765,45532,44447,2022,46469,239
2022-02-11,Shasta,089,179085,29657,29370,5885,35255,473
2022-02-11,Sierra,091,2930,269,268,45,313,0
2022-02-11,Siskiyou,093,43540,4299,4231,2598,6829,68
2022-02-11,Solano,095,438530,78982,77865,5376,83241,424
2022-02-11,Sonoma,097,501317,80945,79533,2441,81974,431
2022-02-11,Stanislaus,099,539301,115027,114531,17070,131601,1406
2022-02-11,Sutter,101,95872,19974,19800,1939,21739,211
2022-02-11,Tehama,103,63373,11732,11580,2549,14129,151
2022-02-11,Trinity,105,12862,1150,1115,272,1387,20
2022-02-11,Tulare,107,460477,103925,100434,26587,127021,1273
2022-02-11,Tuolumne,109,53932,12321,11754,525,12279,125
2022-02-11,Ventura,111,848112,169888,168736,9180,177916,1340
2022-02-11,Yolo,113,214977,35876,34773,2889,37662,286
2022-02-11,Yuba,115,75493,15391,15242,1129,16371,107
2022-02-10,Alameda,001,1643700,247541,242137,13000,255137,1668
2022-02-10,Alpine,003,1148,121,124,1,125,0
2022-02-10,Amador,005,37829,8194,8091,610,8701,76
2022-02-10,Butte,007,227075,32159,31601,6670,38271,360
2022-02-10,Calaveras,009,45235,7082,7022,320,7342,106
2022-02-10,Colusa,011,21464,3371,3345,1023,4368,21
2022-02-10,Contra Costa,013,1133247,184524,180270,12459,192729,1141
2022-02-10,Del Norte,015,27424,5379,5262,159,5421,45
2022-02-10,El Dorado,017,186661,26119,25692,3107,28799,188
2022-02-10,Fresno,019,978130,224188,219909,22776,242685,2509
2022-02-10,Glenn,021,27897,4875,4818,1567,6385,39
2022-02-10,Humboldt,023,135768,16170,16058,2734,18792,132
2022-02-10,Imperial,025,180216,54130,53304,10208,63512,860
2022-02-10,Inyo,027,18085,4015,3991,436,4427,52
2022-02-10,Kern,029,883053,187720,184639,44419,229058,2037
2022-02-10,Kings,031,150075,49936,48893,3389,52282,415
2022-02-10,Lake,033,64148,10113,9926,827,10753,123
2022-02-10,Lassen,035,31185,8586,8477,850,9327,55
2022-02-10,Los Angeles,037,10098052,2661670,2616426,120412,2736838,29364
2022-02-10,Madera,039,155013,36191,35710,5753,41463,330
2022-02-10,Marin,041,260295,32308,32048,2109,34157,255
2022-02-10,Mariposa,043,17540,2296,2286,184,2470,6
2022-02-10,Mendocino,045,87422,12616,12439,2779,15218,107
2022-02-10,Merced,047,269075,60605,60187,8138,68325,758
2022-02-10,Modoc,049,8938,707,697,231,928,6
2022-02-10,Mono,051,14174,2941,2939,117,3056,5
2022-02-10,Monterey,053,433212,76896,74842,12572,87414,672
2022-02-10,Napa,055,140530,24725,24530,897,25427,124
2022-02-10,Nevada,057,99092,15532,15499,1123,16622,119
2022-02-10,Orange,059,3164182,536431,534503,39909,574412,6305
2022-02-10,Placer,061,380077,61328,60636,7123,67759,554
2022-02-10,Plumas,063,18699,2889,2617,333,2950,13
2022-02-10,Riverside,065,2383286,581767,575566,26934,602500,5961
2022-02-10,Sacramento,067,1510023,273514,266347,25410,291757,2686
2022-02-10,San Benito,069,59416,12548,12526,496,13022,91
2022-02-10,San Bernardino,071,2135413,565179,548822,24309,573131,6360
2022-02-10,San Diego,073,3302833,732485,720287,50702,770989,4854
2022-02-10,San Francisco,075,870044,119276,119113,7894,127007,740
2022-02-10,San Joaquin,077,732212,162492,161234,9573,170807,2014
2022-02-10,San Luis Obispo,079,281455,50657,50064,3547,53611,416
2022-02-10,San Mateo,081,765935,117731,115235,6600,121835,589
2022-02-10,Santa Barbara,083,443738,83489,83390,4543,87933,631
2022-02-10,Santa Clara,085,1922200,299570,298176,11765,309941,2093
2022-02-10,Santa Cruz,087,273765,45388,44447,2021,46468,239
2022-02-10,Shasta,089,179085,29595,29370,5865,35235,473
2022-02-10,Sierra,091,2930,269,268,45,313,0
2022-02-10,Siskiyou,093,43540,4294,4231,2585,6816,68
2022-02-10,Solano,095,438530,78789,77865,5357,83222,424
2022-02-10,Sonoma,097,501317,80809,79533,2424,81957,431
2022-02-10,Stanislaus,099,539301,114848,114531,17032,131563,1406
2022-02-10,Sutter,101,95872,19935,19800,1924,21724,211
2022-02-10,Tehama,103,63373,11702,11580,2546,14126,151
2022-02-10,Trinity,105,12862,1147,1115,271,1386,20
2022-02-10,Tulare,107,460477,103738,100434,26510,126944,1273
2022-02-10,Tuolumne,109,53932,12299,11754,520,12274,125
2022-02-10,Ventura,111,848112,169607,168736,9166,177902,1340
2022-02-10,Yolo,113,214977,35799,34773,2883,37656,286
2022-02-10,Yuba,115,75493,15359,15242,1124,16366,107
2022-02-09,Alameda,001,1643700,247008,241141,12944,254085,1668
2022-02-09,Alpine,003,1148,120,124,1,125,0
2022-02-09,Amador,005,37829,8180,8069,605,8674,76
2022-02-09,Butte,007,227075,32066,31433,6656,38089,359
2022-02-09,Calaveras,009,45235,7068,7005,316,7321,106
2022-02-09,Colusa,011,21464,3368,3331,1022,4353,21
2022-02-09,Contra Costa,013,1133247,184169,179695,12413,192108,1132
2022-02-09,Del Norte,015,27424,5332,5204,158,5362,45
2022-02-09,El Dorado,017,186661,26082,25572,3095,28667,186
2022-02-09,Fresno,019,978130,223575,218989,22688,241677,2502
2022-02-09,Glenn,021,27897,4862,4804,1566,6370,39
2022-02-09,Humboldt,023,135768,16123,15929,2709,18638,131
2022-02-09,Imperial,025,180216,54027,53102,10135,63237,858
2022-02-09,Inyo,027,18085,4009,3989,435,4424,52
2022-02-09,Kern,029,883053,187344,184068,44305,228373,2021
2022-02-09,Kings,031,150075,49825,48718,3383,52101,410
2022-02-09,Lake,033,64148,10073,9880,822,10702,124
2022-02-09,Lassen,035,31185,8561,8459,849,9308,55
2022-02-09,Los Angeles,037,10098052,2657990,2611611,120278,2731889,29263
2022-02-09,Madera,039,155013,36093,35559,5723,41282,330
2022-02-09,Marin,041,260295,32258,31965,2102,34067,255
2022-02-09,Mariposa,043,17540,2293,2279,184,2463,6
2022-02-09,Mendocino,045,87422,12582,12378,2750,15128,107
2022-02-09,Merced,047,269075,60475,59952,8086,68038,755
2022-02-09,Modoc,049,8938,704,691,230,921,6
2022-02-09,Mono,051,14174,2939,2937,117,3054,5
2022-02-09,Monterey,053,433212,76694,74500,12486,86986,670
2022-02-09,Napa,055,140530,24679,24429,892,25321,123
2022-02-09,Nevada,057,99092,15511,15446,1121,16567,119
2022-02-09,Orange,059,3164182,535801,534316,39829,574145,6263
2022-02-09,Placer,061,380077,61233,60490,7103,67593,553
2022-02-09,Plumas,063,18699,2884,2609,329,2938,13
2022-02-09,Riverside,065,2383286,581027,573907,26889,600796,5911
2022-02-09,Sacramento,067,1510023,272948,265624,25294,290918,2673
2022-02-09,San Benito,069,59416,12524,12492,496,12988,91
2022-02-09,San Bernardino,071,2135413,564569,547768,24283,572051,6349
2022-02-09,San Diego,073,3302833,731128,717896,50592,768488,4832
2022-02-09,San Francisco,075,870044,119027,118550,7883,126433,731
2022-02-09,San Joaquin,077,732212,162189,160618,9563,170181,2014
2022-02-09,San Luis Obispo,079,281455,50511,49833,3542,53375,414
2022-02-09,San Mateo,081,765935,117543,114890,6560,121450,589
2022-02-09,Santa Barbara,083,443738,83307,82830,4537,87367,629
2022-02-09,Santa Clara,085,1922200,298853,297157,11707,308864,2090
2022-02-09,Santa Cruz,087,273765,45207,44200,2014,46214,239
2022-02-09,Shasta,089,179085,29526,29215,5844,35059,471
2022-02-09,Sierra,091,2930,268,268,44,312,0
2022-02-09,Siskiyou,093,43540,4280,4217,2579,6796,68
2022-02-09,Solano,095,438530,78598,77299,5346,82645,423
2022-02-09,Sonoma,097,501317,80635,79165,2417,81582,431
2022-02-09,Stanislaus,099,539301,114599,114039,16800,130839,1406
2022-02-09,Sutter,101,95872,19893,19758,1911,21669,207
2022-02-09,Tehama,103,63373,11675,11542,2542,14084,149
2022-02-09,Trinity,105,12862,1143,1110,270,1380,20
2022-02-09,Tulare,107,460477,103524,100049,26424,126473,1271
2022-02-09,Tuolumne,109,53932,12261,11702,517,12219,95
2022-02-09,Ventura,111,848112,169370,168253,9153,177406,1325
2022-02-09,Yolo,113,214977,35729,34588,2867,37455,285
2022-02-09,Yuba,115,75493,15328,15187,1113,16300,105
2022-02-08,Alameda,001,1643700,246369,240587,12871,253458,1651
2022-02-08,Alpine,003,1148,120,124,1,125,0
2022-02-08,Amador,005,37829,8172,8050,598,8648,76
2022-02-08,Butte,007,227075,31981,31353,6632,37985,359
2022-02-08,Calaveras,009,45235,7051,6981,314,7295,101
2022-02-08,Colusa,011,21464,3360,3320,1021,4341,21
2022-02-08,Contra Costa,013,1133247,183740,179078,12336,191414,1132
2022-02-08,Del Norte,015,27424,5307,5156,153,5309,44
2022-02-08,El Dorado,017,186661,26037,25446,3084,28530,186
2022-02-08,Fresno,019,978130,222829,218416,22583,240999,2502
2022-02-08,Glenn,021,27897,4845,4784,1562,6346,39
2022-02-08,Humboldt,023,135768,16063,15865,2677,18542,130
2022-02-08,Imperial,025,180216,53899,52977,10091,63068,855
2022-02-08,Inyo,027,18085,4004,3983,435,4418,52
2022-02-08,Kern,029,883053,187008,183519,44175,227694,2010
2022-02-08,Kings,031,150075,49665,48479,3371,51850,411
2022-02-08,Lake,033,64148,10043,9806,816,10622,125
2022-02-08,Lassen,035,31185,8552,8423,845,9268,55
2022-02-08,Los Angeles,037,10098052,2653652,2611204,120090,2731294,29259
2022-02-08,Madera,039,155013,35985,35381,5667,41048,330
2022-02-08,Marin,041,260295,32184,31878,2097,33975,255
2022-02-08,Mariposa,043,17540,2291,2266,176,2442,6
2022-02-08,Mendocino,045,87422,12550,12336,2719,15055,107
2022-02-08,Merced,047,269075,60366,59789,8027,67816,751
2022-02-08,Modoc,049,8938,700,684,230,914,6
2022-02-08,Mono,051,14174,2938,2932,117,3049,5
2022-02-08,Monterey,053,433212,76487,74316,12400,86716,670
2022-02-08,Napa,055,140530,24606,24346,885,25231,121
2022-02-08,Nevada,057,99092,15484,15383,1118,16501,117
2022-02-08,Orange,059,3164182,535114,533507,39741,573248,6205
2022-02-08,Placer,061,380077,61125,60301,7091,67392,553
2022-02-08,Plumas,063,18699,2873,2596,322,2918,13
2022-02-08,Riverside,065,2383286,580197,571892,26817,598709,5908
2022-02-08,Sacramento,067,1510023,272278,264479,25119,289598,2664
2022-02-08,San Benito,069,59416,12500,12434,494,12928,91
2022-02-08,San Bernardino,071,2135413,563853,544658,24239,568897,6335
2022-02-08,San Diego,073,3302833,729555,717896,50462,768358,4832
2022-02-08,San Francisco,075,870044,118715,117942,7874,125816,731
2022-02-08,San Joaquin,077,732212,161806,160147,9545,169692,2005
2022-02-08,San Luis Obispo,079,281455,50346,49556,3512,53068,410
2022-02-08,San Mateo,081,765935,117325,114541,6531,121072,589
2022-02-08,Santa Barbara,083,443738,83139,82461,4512,86973,627
2022-02-08,Santa Clara,085,1922200,297977,295679,11660,307339,2091
2022-02-08,Santa Cruz,087,273765,45052,43884,2009,45893,239
2022-02-08,Shasta,089,179085,29443,29084,5816,34900,470
2022-02-08,Sierra,091,2930,268,267,44,311,0
2022-02-08,Siskiyou,093,43540,4270,4191,2570,6761,68
2022-02-08,Solano,095,438530,78366,77031,5331,82362,421
2022-02-08,Sonoma,097,501317,80421,78798,2393,81191,431
2022-02-08,Stanislaus,099,539301,114346,113733,16725,130458,1406
2022-02-08,Sutter,101,95872,19855,19717,1899,21616,203
2022-02-08,Tehama,103,63373,11648,11491,2535,14026,149
2022-02-08,Trinity,105,12862,1137,1110,270,1380,20
2022-02-08,Tulare,107,460477,103233,99694,26293,125987,1267
2022-02-08,Tuolumne,109,53932,12237,11665,515,12180,92
2022-02-08,Ventura,111,848112,169133,167830,9138,176968,1325
2022-02-08,Yolo,113,214977,35647,34462,2854,37316,281
2022-02-08,Yuba,115,75493,15283,15126,1091,16217,107
2022-02-07,Alameda,001,1643700,245655,238678,12805,251483,1643
2022-02-07,Alpine,003,1148,120,124,1,125,0
2022-02-07,Amador,005,37829,8144,7980,590,8570,75
2022-02-07,Butte,007,227075,31892,31184,6603,37787,355
2022-02-07,Calaveras,009,45235,7029,6910,313,7223,100
2022-02-07,Colusa,011,21464,3349,3283,1017,4300,21
2022-02-07,Contra Costa,013,1133247,183272,177767,12264,190031,1130
2022-02-07,Del Norte,015,27424,5266,5093,148,5241,44
2022-02-07,El Dorado,017,186661,25974,25257,3073,28330,185
2022-02-07,Fresno,019,978130,221979,216495,22438,238933,2493
2022-02-07,Glenn,021,27897,4838,4762,1558,6320,39
2022-02-07,Humboldt,023,135768,15988,15764,2652,18416,129
2022-02-07,Imperial,025,180216,53785,52689,10022,62711,853
2022-02-07,Inyo,027,18085,3999,3976,429,4405,51
2022-02-07,Kern,029,883053,186535,182047,44011,226058,1998
2022-02-07,Kings,031,150075,49481,48147,3354,51501,403
2022-02-07,Lake,033,64148,9997,9519,808,10327,125
2022-02-07,Lassen,035,31185,8534,8362,839,9201,55
2022-02-07,Los Angeles,037,10098052,2649188,2607438,119875,2727313,29210
2022-02-07,Madera,039,155013,35861,35083,5620,40703,330
2022-02-07,Marin,041,260295,32118,31670,2086,33756,255
2022-02-07,Mariposa,043,17540,2286,2253,172,2425,6
2022-02-07,Mendocino,045,87422,12492,12237,2681,14918,107
2022-02-07,Merced,047,269075,60239,59472,7934,67406,748
2022-02-07,Modoc,049,8938,696,679,230,909,6
2022-02-07,Mono,051,14174,2936,2917,117,3034,5
2022-02-07,Monterey,053,433212,76233,69433,12293,81726,670
2022-02-07,Napa,055,140530,24520,23237,876,24113,120
2022-02-07,Nevada,057,99092,15449,15268,1112,16380,113
2022-02-07,Orange,059,3164182,534352,531442,39660,571102,6179
2022-02-07,Placer,061,380077,61001,59894,7076,66970,546
2022-02-07,Plumas,063,18699,2862,2573,313,2886,13
2022-02-07,Riverside,065,2383286,579254,568874,26733,595607,5868
2022-02-07,Sacramento,067,1510023,271596,262834,24937,287771,2631
2022-02-07,San Benito,069,59416,12462,12285,492,12777,90
2022-02-07,San Bernardino,071,2135413,563053,542846,24201,567047,6335
2022-02-07,San Diego,073,3302833,727836,716244,50279,766523,4811
2022-02-07,San Francisco,075,870044,118376,113945,7849,121794,727
2022-02-07,San Joaquin,077,732212,161424,159358,9526,168884,1998
2022-02-07,San Luis Obispo,079,281455,50176,48994,3493,52487,406
2022-02-07,San Mateo,081,765935,117039,107060,6502,113562,589
2022-02-07,Santa Barbara,083,443738,82951,81608,4497,86105,624
2022-02-07,Santa Clara,085,1922200,297027,293360,11613,304973,2085
2022-02-07,Santa Cruz,087,273765,44835,43244,2005,45249,239
2022-02-07,Shasta,089,179085,29353,28900,5790,34690,468
2022-02-07,Sierra,091,2930,268,265,44,309,0
2022-02-07,Siskiyou,093,43540,4259,4157,2554,6711,68
2022-02-07,Solano,095,438530,78109,73934,5302,79236,420
2022-02-07,Sonoma,097,501317,80164,78296,2377,80673,431
2022-02-07,Stanislaus,099,539301,114088,113029,16583,129612,1406
2022-02-07,Sutter,101,95872,19823,19599,1871,21470,203
2022-02-07,Tehama,103,63373,11607,11418,2527,13945,146
2022-02-07,Trinity,105,12862,1133,1109,267,1376,20
2022-02-07,Tulare,107,460477,102874,98774,26163,124937,1263
2022-02-07,Tuolumne,109,53932,12189,11578,511,12089,92
2022-02-07,Ventura,111,848112,168816,166904,9123,176027,1324
2022-02-07,Yolo,113,214977,35535,34007,2840,36847,281
2022-02-07,Yuba,115,75493,15236,14998,1084,16082,105
2022-02-06,Alameda,001,1643700,244741,237188,12722,249910,1643
2022-02-06,Alpine,003,1148,120,123,1,124,0
2022-02-06,Amador,005,37829,8113,7922,578,8500,73
2022-02-06,Butte,007,227075,31765,31021,6552,37573,355
2022-02-06,Calaveras,009,45235,7002,6870,308,7178,99
2022-02-06,Colusa,011,21464,3339,3282,1016,4298,21
2022-02-06,Contra Costa,013,1133247,182635,176863,12109,188972,1128
2022-02-06,Del Norte,015,27424,5209,5038,146,5184,44
2022-02-06,El Dorado,017,186661,25911,25165,3061,28226,185
2022-02-06,Fresno,019,978130,221133,214726,22181,236907,2489
2022-02-06,Glenn,021,27897,4824,4738,1549,6287,39
2022-02-06,Humboldt,023,135768,15904,15658,2612,18270,128
2022-02-06,Imperial,025,180216,53598,52396,9976,62372,853
2022-02-06,Inyo,027,18085,3997,3970,426,4396,51
2022-02-06,Kern,029,883053,185983,181188,43771,224959,1996
2022-02-06,Kings,031,150075,49258,47669,3329,50998,401
2022-02-06,Lake,033,64148,9928,9468,791,10259,125
2022-02-06,Lassen,035,31185,8514,8326,834,9160,55
2022-02-06,Los Angeles,037,10098052,2643645,2602620,119616,2722236,29180
2022-02-06,Madera,039,155013,35677,34901,5528,40429,330
2022-02-06,Marin,041,260295,32021,31488,2073,33561,255
2022-02-06,Mariposa,043,17540,2278,2244,161,2405,6
2022-02-06,Mendocino,045,87422,12449,12169,2611,14780,107
2022-02-06,Merced,047,269075,60022,59112,7773,66885,748
2022-02-06,Modoc,049,8938,691,675,229,904,6
2022-02-06,Mono,051,14174,2931,2901,115,3016,5
2022-02-06,Monterey,053,433212,75867,67912,12136,80048,670
2022-02-06,Napa,055,140530,24401,23230,869,24099,120
2022-02-06,Nevada,057,99092,15384,15192,1099,16291,113
2022-02-06,Orange,059,3164182,533400,527906,39559,567465,6171
2022-02-06,Placer,061,380077,60825,59507,7050,66557,544
2022-02-06,Plumas,063,18699,2849,2559,304,2863,13
2022-02-06,Riverside,065,2383286,578118,568276,26656,594932,5865
2022-02-06,Sacramento,067,1510023,270729,261353,24677,286030,2631
2022-02-06,San Benito,069,59416,12407,12186,484,12670,90
2022-02-06,San Bernardino,071,2135413,562068,541103,24131,565234,6334
2022-02-06,San Diego,073,3302833,725774,709938,50039,759977,4786
2022-02-06,San Francisco,075,870044,117994,113115,7823,120938,728
2022-02-06,San Joaquin,077,732212,160859,158510,9487,167997,1997
2022-02-06,San Luis Obispo,079,281455,49951,48843,3436,52279,405
2022-02-06,San Mateo,081,765935,116701,105556,6463,112019,587
2022-02-06,Santa Barbara,083,443738,82633,81118,4460,85578,623
2022-02-06,Santa Clara,085,1922200,295925,291732,11497,303229,2075
2022-02-06,Santa Cruz,087,273765,44521,42952,1991,44943,239
2022-02-06,Shasta,089,179085,29230,28762,5741,34503,468
2022-02-06,Sierra,091,2930,268,265,44,309,0
2022-02-06,Siskiyou,093,43540,4238,4118,2528,6646,68
2022-02-06,Solano,095,438530,77811,73475,5259,78734,419
2022-02-06,Sonoma,097,501317,79829,77887,2357,80244,431
2022-02-06,Stanislaus,099,539301,113691,112521,16438,128959,1406
2022-02-06,Sutter,101,95872,19781,19523,1833,21356,203
2022-02-06,Tehama,103,63373,11567,11366,2507,13873,146
2022-02-06,Trinity,105,12862,1132,1102,266,1368,20
2022-02-06,Tulare,107,460477,102436,98260,25980,124240,1262
2022-02-06,Tuolumne,109,53932,12137,11507,494,12001,92
2022-02-06,Ventura,111,848112,168440,166235,9112,175347,1323
2022-02-06,Yolo,113,214977,35396,33784,2823,36607,281
2022-02-06,Yuba,115,75493,15191,14917,1075,15992,104
2022-02-05,Alameda,001,1643700,244325,235698,12713,248411,1638
2022-02-05,Alpine,003,1148,120,124,1,125,0
2022-02-05,Amador,005,37829,8104,7855,576,8431,71
2022-02-05,Butte,007,227075,31711,30733,6538,37271,355
2022-02-05,Calaveras,009,45235,6986,6789,308,7097,99
2022-02-05,Colusa,011,21464,3332,3234,1016,4250,21
2022-02-05,Contra Costa,013,1133247,182363,175871,12093,187964,1115
2022-02-05,Del Norte,015,27424,5167,4978,146,5124,44
2022-02-05,El Dorado,017,186661,25880,24813,3059,27872,185
2022-02-05,Fresno,019,978130,220788,213539,22160,235699,2477
2022-02-05,Glenn,021,27897,4822,4691,1543,6234,39
2022-02-05,Humboldt,023,135768,15855,15514,2609,18123,127
2022-02-05,Imperial,025,180216,53536,52153,9963,62116,853
2022-02-05,Inyo,027,18085,3994,3948,426,4374,51
2022-02-05,Kern,029,883053,185774,180296,43670,223966,1987
2022-02-05,Kings,031,150075,49171,47538,3322,50860,402
2022-02-05,Lake,033,64148,9909,9289,784,10073,124
2022-02-05,Lassen,035,31185,8503,8288,832,9120,55
2022-02-05,Los Angeles,037,10098052,2641461,2572702,119491,2692193,28947
2022-02-05,Madera,039,155013,35624,34471,5515,39986,329
2022-02-05,Marin,041,260295,31974,31299,2069,33368,255
2022-02-05,Mariposa,043,17540,2277,2222,160,2382,6
2022-02-05,Mendocino,045,87422,12421,12066,2609,14675,107
2022-02-05,Merced,047,269075,59929,58908,7766,66674,744
2022-02-05,Modoc,049,8938,690,664,229,893,6
2022-02-05,Mono,051,14174,2930,2904,115,3019,5
2022-02-05,Monterey,053,433212,75751,67342,12092,79434,666
2022-02-05,Napa,055,140530,24345,22973,868,23841,118
2022-02-05,Nevada,057,99092,15363,15002,1094,16096,113
2022-02-05,Orange,059,3164182,532958,527516,39469,566985,6134
2022-02-05,Placer,061,380077,60699,59043,7037,66080,533
2022-02-05,Plumas,063,18699,2848,2550,303,2853,13
2022-02-05,Riverside,065,2383286,577515,563991,26586,590577,5827
2022-02-05,Sacramento,067,1510023,270337,259437,24643,284080,2610
2022-02-05,San Benito,069,59416,12362,12142,484,12626,90
2022-02-05,San Bernardino,071,2135413,561554,539312,24111,563423,6322
2022-02-05,San Diego,073,3302833,724914,703957,49965,753922,4735
2022-02-05,San Francisco,075,870044,117784,112481,7796,120277,720
2022-02-05,San Joaquin,077,732212,160673,157420,9476,166896,1989
2022-02-05,San Luis Obispo,079,281455,49914,48361,3434,51795,404
2022-02-05,San Mateo,081,765935,116513,104810,6455,111265,587
2022-02-05,Santa Barbara,083,443738,82470,80478,4448,84926,617
2022-02-05,Santa Clara,085,1922200,295273,289262,11481,300743,2067
2022-02-05,Santa Cruz,087,273765,44447,42553,1988,44541,239
2022-02-05,Shasta,089,179085,29187,28604,5731,34335,466
2022-02-05,Sierra,091,2930,268,262,44,306,0
2022-02-05,Siskiyou,093,43540,4231,4106,2515,6621,67
2022-02-05,Solano,095,438530,77736,73112,5250,78362,415
2022-02-05,Sonoma,097,501317,79663,77213,2353,79566,431
2022-02-05,Stanislaus,099,539301,113488,111783,16415,128198,1406
2022-02-05,Sutter,101,95872,19751,19406,1827,21233,203
2022-02-05,Tehama,103,63373,11548,11259,2500,13759,146
2022-02-05,Trinity,105,12862,1130,1085,266,1351,20
2022-02-05,Tulare,107,460477,102267,97414,25899,123313,1254
2022-02-05,Tuolumne,109,53932,12112,11409,491,11900,91
2022-02-05,Ventura,111,848112,168214,165532,9096,174628,1308
2022-02-05,Yolo,113,214977,35311,33614,2808,36422,281
2022-02-05,Yuba,115,75493,15160,14801,1067,15868,105
2022-02-04,Alameda,001,1643700,243836,235698,12703,248401,1638
2022-02-04,Alpine,003,1148,120,124,1,125,0
2022-02-04,Amador,005,37829,8088,7855,572,8427,71
2022-02-04,Butte,007,227075,31651,30733,6526,37259,355
2022-02-04,Calaveras,009,45235,6976,6789,306,7095,99
2022-02-04,Colusa,011,21464,3328,3234,1014,4248,21
2022-02-04,Contra Costa,013,1133247,182035,175871,12065,187936,1115
2022-02-04,Del Norte,015,27424,5146,4978,146,5124,44
2022-02-04,El Dorado,017,186661,25844,24813,3056,27869,185
2022-02-04,Fresno,019,978130,220307,213539,22129,235668,2477
2022-02-04,Glenn,021,27897,4813,4691,1540,6231,39
2022-02-04,Humboldt,023,135768,15828,15514,2606,18120,127
2022-02-04,Imperial,025,180216,53459,52153,9946,62099,853
2022-02-04,Inyo,027,18085,3991,3948,426,4374,51
2022-02-04,Kern,029,883053,185549,180296,43546,223842,1987
2022-02-04,Kings,031,150075,49096,47538,3315,50853,402
2022-02-04,Lake,033,64148,9887,9289,781,10070,124
2022-02-04,Lassen,035,31185,8480,8288,832,9120,55
2022-02-04,Los Angeles,037,10098052,2638825,2572702,119361,2692063,28947
2022-02-04,Madera,039,155013,35541,34471,5507,39978,329
2022-02-04,Marin,041,260295,31910,31299,2060,33359,255
2022-02-04,Mariposa,043,17540,2275,2222,158,2380,6
2022-02-04,Mendocino,045,87422,12390,12066,2607,14673,107
2022-02-04,Merced,047,269075,59849,58908,7756,66664,744
2022-02-04,Modoc,049,8938,690,664,229,893,6
2022-02-04,Mono,051,14174,2928,2904,115,3019,5
2022-02-04,Monterey,053,433212,75561,67342,12049,79391,666
2022-02-04,Napa,055,140530,24298,22973,864,23837,118
2022-02-04,Nevada,057,99092,15329,15002,1090,16092,113
2022-02-04,Orange,059,3164182,532408,527516,39412,566928,6134
2022-02-04,Placer,061,380077,60595,59043,7026,66069,533
2022-02-04,Plumas,063,18699,2841,2550,302,2852,13
2022-02-04,Riverside,065,2383286,576803,563991,26574,590565,5827
2022-02-04,Sacramento,067,1510023,269834,259437,24620,284057,2610
2022-02-04,San Benito,069,59416,12343,12142,482,12624,90
2022-02-04,San Bernardino,071,2135413,560970,539312,24090,563402,6322
2022-02-04,San Diego,073,3302833,723781,703957,49891,753848,4735
2022-02-04,San Francisco,075,870044,117543,112481,7771,120252,720
2022-02-04,San Joaquin,077,732212,160443,157420,9465,166885,1989
2022-02-04,San Luis Obispo,079,281455,49853,48361,3427,51788,404
2022-02-04,San Mateo,081,765935,116282,104810,6441,111251,587
2022-02-04,Santa Barbara,083,443738,82320,80478,4447,84925,617
2022-02-04,Santa Clara,085,1922200,294607,289262,11460,300722,2067
2022-02-04,Santa Cruz,087,273765,44242,42553,1984,44537,239
2022-02-04,Shasta,089,179085,29134,28604,5720,34324,466
2022-02-04,Sierra,091,2930,268,262,44,306,0
2022-02-04,Siskiyou,093,43540,4223,4106,2508,6614,67
2022-02-04,Solano,095,438530,77544,73112,5212,78324,415
2022-02-04,Sonoma,097,501317,79504,77213,2272,79485,431
2022-02-04,Stanislaus,099,539301,113307,111783,16390,128173,1406
2022-02-04,Sutter,101,95872,19727,19406,1820,21226,203
2022-02-04,Tehama,103,63373,11533,11259,2499,13758,146
2022-02-04,Trinity,105,12862,1129,1085,265,1350,20
2022-02-04,Tulare,107,460477,102085,97414,25817,123231,1254
2022-02-04,Tuolumne,109,53932,12100,11409,490,11899,91
2022-02-04,Ventura,111,848112,167945,165532,9088,174620,1308
2022-02-04,Yolo,113,214977,35218,33614,2802,36416,281
2022-02-04,Yuba,115,75493,15142,14801,1067,15868,105
2022-02-03,Alameda,001,1643700,243064,235698,12641,248339,1638
2022-02-03,Alpine,003,1148,120,124,1,125,0
2022-02-03,Amador,005,37829,8068,7855,567,8422,71
2022-02-03,Butte,007,227075,31543,30733,6497,37230,355
2022-02-03,Calaveras,009,45235,6946,6789,303,7092,99
2022-02-03,Colusa,011,21464,3315,3234,1012,4246,21
2022-02-03,Contra Costa,013,1133247,181431,175871,11967,187838,1115
2022-02-03,Del Norte,015,27424,5103,4978,143,5121,44
2022-02-03,El Dorado,017,186661,25773,24813,3050,27863,185
2022-02-03,Fresno,019,978130,219377,213539,21963,235502,2477
2022-02-03,Glenn,021,27897,4796,4691,1523,6214,39
2022-02-03,Humboldt,023,135768,15752,15514,2570,18084,127
2022-02-03,Imperial,025,180216,53315,52153,9896,62049,853
2022-02-03,Inyo,027,18085,3988,3948,422,4370,51
2022-02-03,Kern,029,883053,185086,180296,43332,223628,1987
2022-02-03,Kings,031,150075,48939,47538,3308,50846,402
2022-02-03,Lake,033,64148,9833,9289,775,10064,124
2022-02-03,Lassen,035,31185,8456,8288,831,9119,55
2022-02-03,Los Angeles,037,10098052,2633396,2572702,119098,2691800,28947
2022-02-03,Madera,039,155013,35404,34471,5463,39934,329
2022-02-03,Marin,041,260295,31814,31299,2055,33354,255
2022-02-03,Mariposa,043,17540,2263,2222,155,2377,6
2022-02-03,Mendocino,045,87422,12346,12066,2584,14650,107
2022-02-03,Merced,047,269075,59698,58908,7660,66568,744
2022-02-03,Modoc,049,8938,687,664,229,893,6
2022-02-03,Mono,051,14174,2923,2904,114,3018,5
2022-02-03,Monterey,053,433212,75274,67342,11857,79199,666
2022-02-03,Napa,055,140530,24166,22973,864,23837,118
2022-02-03,Nevada,057,99092,15289,15002,1080,16082,113
2022-02-03,Orange,059,3164182,531484,527516,39320,566836,6134
2022-02-03,Placer,061,380077,60398,59043,7003,66046,533
2022-02-03,Plumas,063,18699,2827,2550,298,2848,13
2022-02-03,Riverside,065,2383286,575604,563991,26503,590494,5827
2022-02-03,Sacramento,067,1510023,268879,259437,24432,283869,2610
2022-02-03,San Benito,069,59416,12316,12142,479,12621,90
2022-02-03,San Bernardino,071,2135413,559954,539312,24051,563363,6322
2022-02-03,San Diego,073,3302833,721810,703957,49728,753685,4735
2022-02-03,San Francisco,075,870044,117210,112481,7741,120222,720
2022-02-03,San Joaquin,077,732212,159961,157420,9436,166856,1989
2022-02-03,San Luis Obispo,079,281455,49654,48361,3412,51773,404
2022-02-03,San Mateo,081,765935,115931,104810,6408,111218,587
2022-02-03,Santa Barbara,083,443738,81962,80478,4418,84896,617
2022-02-03,Santa Clara,085,1922200,293441,289262,11351,300613,2067
2022-02-03,Santa Cruz,087,273765,43902,42553,1977,44530,239
2022-02-03,Shasta,089,179085,29030,28604,5693,34297,466
2022-02-03,Sierra,091,2930,268,262,44,306,0
2022-02-03,Siskiyou,093,43540,4208,4106,2492,6598,67
2022-02-03,Solano,095,438530,77213,73112,5193,78305,415
2022-02-03,Sonoma,097,501317,79208,77213,2265,79478,431
2022-02-03,Stanislaus,099,539301,112929,111783,16306,128089,1406
2022-02-03,Sutter,101,95872,19675,19406,1804,21210,203
2022-02-03,Tehama,103,63373,11502,11259,2491,13750,146
2022-02-03,Trinity,105,12862,1127,1085,264,1349,20
2022-02-03,Tulare,107,460477,101680,97414,25678,123092,1254
2022-02-03,Tuolumne,109,53932,12059,11409,478,11887,91
2022-02-03,Ventura,111,848112,167560,165532,9076,174608,1308
2022-02-03,Yolo,113,214977,35109,33614,2788,36402,281
2022-02-03,Yuba,115,75493,15092,14801,1051,15852,105
2022-02-02,Alameda,001,1643700,242118,234300,12538,246838,1632
2022-02-02,Alpine,003,1148,120,123,1,124,0
2022-02-02,Amador,005,37829,8038,7781,558,8339,71
2022-02-02,Butte,007,227075,31433,30550,6460,37010,355
2022-02-02,Calaveras,009,45235,6920,6753,299,7052,99
2022-02-02,Colusa,011,21464,3300,3211,1011,4222,21
2022-02-02,Contra Costa,013,1133247,180830,174876,11876,186752,1113
2022-02-02,Del Norte,015,27424,5061,4924,139,5063,44
2022-02-02,El Dorado,017,186661,25706,24690,3032,27722,185
2022-02-02,Fresno,019,978130,218371,211976,21831,233807,2463
2022-02-02,Glenn,021,27897,4772,4667,1513,6180,39
2022-02-02,Humboldt,023,135768,15692,15392,2531,17923,127
2022-02-02,Imperial,025,180216,53119,51875,9769,61644,853
2022-02-02,Inyo,027,18085,3982,3944,421,4365,51
2022-02-02,Kern,029,883053,184490,179386,43117,222503,1974
2022-02-02,Kings,031,150075,48748,47061,3283,50344,401
2022-02-02,Lake,033,64148,9775,9235,768,10003,120
2022-02-02,Lassen,035,31185,8443,8258,822,9080,55
2022-02-02,Los Angeles,037,10098052,2627171,2561902,118713,2680615,28850
2022-02-02,Madera,039,155013,35236,34265,5391,39656,329
2022-02-02,Marin,041,260295,31711,31149,2045,33194,255
2022-02-02,Mariposa,043,17540,2252,2215,151,2366,6
2022-02-02,Mendocino,045,87422,12293,11996,2545,14541,105
2022-02-02,Merced,047,269075,59522,58532,7577,66109,744
2022-02-02,Modoc,049,8938,681,662,229,891,6
2022-02-02,Mono,051,14174,2912,2887,114,3001,5
2022-02-02,Monterey,053,433212,74884,66852,11677,78529,666
2022-02-02,Napa,055,140530,24045,22859,851,23710,117
2022-02-02,Nevada,057,99092,15231,14895,1058,15953,112
2022-02-02,Orange,059,3164182,530428,524418,39227,563645,6127
2022-02-02,Placer,061,380077,60206,58654,6974,65628,533
2022-02-02,Plumas,063,18699,2811,2540,295,2835,12
2022-02-02,Riverside,065,2383286,574325,561220,26456,587676,5827
2022-02-02,Sacramento,067,1510023,267881,258078,24227,282305,2602
2022-02-02,San Benito,069,59416,12277,12058,475,12533,90
2022-02-02,San Bernardino,071,2135413,558936,537485,23990,561475,6317
2022-02-02,San Diego,073,3302833,719608,703957,49547,753504,4735
2022-02-02,San Francisco,075,870044,116840,112008,7725,119733,714
2022-02-02,San Joaquin,077,732212,159387,156537,9413,165950,1986
2022-02-02,San Luis Obispo,079,281455,49456,48119,3399,51518,403
2022-02-02,San Mateo,081,765935,115557,104201,6344,110545,587
2022-02-02,Santa Barbara,083,443738,81619,79979,4387,84366,612
2022-02-02,Santa Clara,085,1922200,292297,287443,11238,298681,2051
2022-02-02,Santa Cruz,087,273765,43610,42127,1966,44093,239
2022-02-02,Shasta,089,179085,28928,28429,5648,34077,465
2022-02-02,Sierra,091,2930,268,262,44,306,0
2022-02-02,Siskiyou,093,43540,4198,4078,2463,6541,67
2022-02-02,Solano,095,438530,76856,72711,5166,77877,414
2022-02-02,Sonoma,097,501317,78895,76681,2252,78933,431
2022-02-02,Stanislaus,099,539301,112533,111167,16178,127345,1403
2022-02-02,Sutter,101,95872,19610,19290,1775,21065,203
2022-02-02,Tehama,103,63373,11446,11193,2472,13665,146
2022-02-02,Trinity,105,12862,1124,1074,262,1336,20
2022-02-02,Tulare,107,460477,101291,96820,25526,122346,1249
2022-02-02,Tuolumne,109,53932,11982,11342,475,11817,91
2022-02-02,Ventura,111,848112,167161,164905,9057,173962,1292
2022-02-02,Yolo,113,214977,34983,33332,2765,36097,281
2022-02-02,Yuba,115,75493,15027,14720,1043,15763,104
2022-02-01,Alameda,001,1643700,241039,233782,12435,246217,1620
2022-02-01,Alpine,003,1148,120,123,1,124,0
2022-02-01,Amador,005,37829,7992,7783,552,8335,73
2022-02-01,Butte,007,227075,31297,30496,6417,36913,355
2022-02-01,Calaveras,009,45235,6883,6749,295,7044,98
2022-02-01,Colusa,011,21464,3284,3202,992,4194,21
2022-02-01,Contra Costa,013,1133247,180084,174379,11737,186116,1115
2022-02-01,Del Norte,015,27424,5013,4907,136,5043,44
2022-02-01,El Dorado,017,186661,25647,24664,3015,27679,184
2022-02-01,Fresno,019,978130,217212,211352,21670,233022,2464
2022-02-01,Glenn,021,27897,4758,4649,1503,6152,39
2022-02-01,Humboldt,023,135768,15611,15354,2503,17857,127
2022-02-01,Imperial,025,180216,52906,51675,9704,61379,846
2022-02-01,Inyo,027,18085,3972,3928,418,4346,51
2022-02-01,Kern,029,883053,183843,178987,42872,221859,1967
2022-02-01,Kings,031,150075,48488,46959,3260,50219,400
2022-02-01,Lake,033,64148,9719,9211,761,9972,119
2022-02-01,Lassen,035,31185,8425,8231,818,9049,55
2022-02-01,Los Angeles,037,10098052,2619980,2548794,118342,2667136,28752
2022-02-01,Madera,039,155013,35016,34124,5310,39434,329
2022-02-01,Marin,041,260295,31587,31099,2029,33128,255
2022-02-01,Mariposa,043,17540,2245,2210,150,2360,6
2022-02-01,Mendocino,045,87422,12231,11978,2508,14486,105
2022-02-01,Merced,047,269075,59338,58362,7454,65816,743
2022-02-01,Modoc,049,8938,674,664,229,893,6
2022-02-01,Mono,051,14174,2906,2888,114,3002,5
2022-02-01,Monterey,053,433212,74463,66553,11482,78035,665
2022-02-01,Napa,055,140530,23946,22795,835,23630,116
2022-02-01,Nevada,057,99092,15170,14863,1045,15908,112
2022-02-01,Orange,059,3164182,529278,523741,39084,562825,6108
2022-02-01,Placer,061,380077,59958,58486,6936,65422,532
2022-02-01,Plumas,063,18699,2796,2526,292,2818,12
2022-02-01,Riverside,065,2383286,572939,560010,26408,586418,5825
2022-02-01,Sacramento,067,1510023,266831,257504,23963,281467,2593
2022-02-01,San Benito,069,59416,12211,12053,472,12525,90
2022-02-01,San Bernardino,071,2135413,557649,536591,23926,560517,6311
2022-02-01,San Diego,073,3302833,717087,701009,49328,750337,4710
2022-02-01,San Francisco,075,870044,116374,111606,7706,119312,713
2022-02-01,San Joaquin,077,732212,158856,156300,9390,165690,1987
2022-02-01,San Luis Obispo,079,281455,49228,47842,3337,51179,403
2022-02-01,San Mateo,081,765935,115089,103868,6302,110170,589
2022-02-01,Santa Barbara,083,443738,81174,79659,4351,84010,608
2022-02-01,Santa Clara,085,1922200,290778,286109,11133,297242,2070
2022-02-01,Santa Cruz,087,273765,43311,41782,1950,43732,239
2022-02-01,Shasta,089,179085,28808,28382,5595,33977,465
2022-02-01,Sierra,091,2930,266,262,44,306,0
2022-02-01,Siskiyou,093,43540,4184,4072,2436,6508,66
2022-02-01,Solano,095,438530,76579,72494,5144,77638,415
2022-02-01,Sonoma,097,501317,78535,76379,2229,78608,431
2022-02-01,Stanislaus,099,539301,112122,110925,16078,127003,1403
2022-02-01,Sutter,101,95872,19542,19256,1742,20998,202
2022-02-01,Tehama,103,63373,11389,11165,2459,13624,146
2022-02-01,Trinity,105,12862,1120,1073,262,1335,19
2022-02-01,Tulare,107,460477,100801,96467,25328,121795,1247
2022-02-01,Tuolumne,109,53932,11932,11318,466,11784,91
2022-02-01,Ventura,111,848112,166656,164721,9032,173753,1293
2022-02-01,Yolo,113,214977,34831,33257,2739,35996,275
2022-02-01,Yuba,115,75493,14966,14693,1036,15729,103
2022-01-31,Alameda,001,1643700,239685,232743,12321,245064,1607
2022-01-31,Alpine,003,1148,119,123,1,124,0
2022-01-31,Amador,005,37829,7939,7682,535,8217,73
2022-01-31,Butte,007,227075,31128,30371,6369,36740,354
2022-01-31,Calaveras,009,45235,6847,6700,284,6984,96
2022-01-31,Colusa,011,21464,3272,3187,983,4170,21
2022-01-31,Contra Costa,013,1133247,179273,173466,11613,185079,1115
2022-01-31,Del Norte,015,27424,4979,4879,133,5012,43
2022-01-31,El Dorado,017,186661,25545,24545,2986,27531,184
2022-01-31,Fresno,019,978130,215724,210589,21473,232062,2464
2022-01-31,Glenn,021,27897,4722,4641,1491,6132,39
2022-01-31,Humboldt,023,135768,15521,15308,2470,17778,126
2022-01-31,Imperial,025,180216,52690,51472,9595,61067,846
2022-01-31,Inyo,027,18085,3961,3922,412,4334,50
2022-01-31,Kern,029,883053,183061,178375,42556,220931,1967
2022-01-31,Kings,031,150075,48131,46845,3226,50071,398
2022-01-31,Lake,033,64148,9646,9141,749,9890,119
2022-01-31,Lassen,035,31185,8394,8162,812,8974,55
2022-01-31,Los Angeles,037,10098052,2611743,2541189,117937,2659126,28718
2022-01-31,Madera,039,155013,34800,33886,5214,39100,329
2022-01-31,Marin,041,260295,31462,31023,2012,33035,253
2022-01-31,Mariposa,043,17540,2235,2203,141,2344,6
2022-01-31,Mendocino,045,87422,12165,11896,2467,14363,104
2022-01-31,Merced,047,269075,59059,58198,7265,65463,740
2022-01-31,Modoc,049,8938,671,661,229,890,6
2022-01-31,Mono,051,14174,2892,2889,114,3003,5
2022-01-31,Monterey,053,433212,74012,66117,11269,77386,661
2022-01-31,Napa,055,140530,23778,22707,818,23525,113
2022-01-31,Nevada,057,99092,15094,14813,1032,15845,112
2022-01-31,Orange,059,3164182,527954,522358,38949,561307,6098
2022-01-31,Placer,061,380077,59710,58252,6905,65157,523
2022-01-31,Plumas,063,18699,2783,2513,290,2803,12
2022-01-31,Riverside,065,2383286,571123,558166,26344,584510,5785
2022-01-31,Sacramento,067,1510023,265538,256594,23711,280305,2571
2022-01-31,San Benito,069,59416,12152,11976,471,12447,90
2022-01-31,San Bernardino,071,2135413,556004,535276,23844,559120,6302
2022-01-31,San Diego,073,3302833,714182,698571,49067,747638,4686
2022-01-31,San Francisco,075,870044,115967,111119,7672,118791,712
2022-01-31,San Joaquin,077,732212,158100,155736,9359,165095,1985
2022-01-31,San Luis Obispo,079,281455,48974,47656,3280,50936,395
2022-01-31,San Mateo,081,765935,114579,103313,6244,109557,589
2022-01-31,Santa Barbara,083,443738,80668,79267,4309,83576,606
2022-01-31,Santa Clara,085,1922200,289105,284562,11026,295588,2041
2022-01-31,Santa Cruz,087,273765,42932,41630,1943,43573,239
2022-01-31,Shasta,089,179085,28677,28190,5554,33744,462
2022-01-31,Sierra,091,2930,266,261,44,305,0
2022-01-31,Siskiyou,093,43540,4168,4054,2420,6474,66
2022-01-31,Solano,095,438530,75873,72258,5097,77355,414
2022-01-31,Sonoma,097,501317,78080,76199,2199,78398,431
2022-01-31,Stanislaus,099,539301,111595,110493,15909,126402,1403
2022-01-31,Sutter,101,95872,19462,19189,1692,20881,202
2022-01-31,Tehama,103,63373,11327,11112,2430,13542,145
2022-01-31,Trinity,105,12862,1115,1071,259,1330,19
2022-01-31,Tulare,107,460477,100167,96053,25095,121148,1245
2022-01-31,Tuolumne,109,53932,11842,11278,459,11737,91
2022-01-31,Ventura,111,848112,166120,164060,9007,173067,1286
2022-01-31,Yolo,113,214977,34670,33175,2712,35887,274
2022-01-31,Yuba,115,75493,14903,14652,1016,15668,103
2022-01-30,Alameda,001,1643700,238128,231838,12170,244008,1607
2022-01-30,Alpine,003,1148,119,123,1,124,0
2022-01-30,Amador,005,37829,7889,7644,512,8156,73
2022-01-30,Butte,007,227075,30925,30255,6289,36544,354
2022-01-30,Calaveras,009,45235,6792,6676,273,6949,96
2022-01-30,Colusa,011,21464,3252,3168,974,4142,21
2022-01-30,Contra Costa,013,1133247,178310,172902,11414,184316,1102
2022-01-30,Del Norte,015,27424,4938,4833,130,4963,43
2022-01-30,El Dorado,017,186661,25424,24491,2959,27450,184
2022-01-30,Fresno,019,978130,214168,209645,21215,230860,2463
2022-01-30,Glenn,021,27897,4691,4619,1482,6101,39
2022-01-30,Humboldt,023,135768,15410,15247,2414,17661,126
2022-01-30,Imperial,025,180216,52365,51415,9425,60840,846
2022-01-30,Inyo,027,18085,3944,3921,409,4330,50
2022-01-30,Kern,029,883053,182197,177924,42235,220159,1967
2022-01-30,Kings,031,150075,47779,46654,3169,49823,398
2022-01-30,Lake,033,64148,9557,9080,728,9808,119
2022-01-30,Lassen,035,31185,8370,8158,804,8962,55
2022-01-30,Los Angeles,037,10098052,2601665,2530739,117463,2648202,28678
2022-01-30,Madera,039,155013,34502,33752,5030,38782,329
2022-01-30,Marin,041,260295,31314,30875,1998,32873,253
2022-01-30,Mariposa,043,17540,2223,2177,136,2313,6
2022-01-30,Mendocino,045,87422,12092,11860,2361,14221,104
2022-01-30,Merced,047,269075,58694,58006,6974,64980,740
2022-01-30,Modoc,049,8938,668,661,229,890,6
2022-01-30,Mono,051,14174,2886,2888,114,3002,5
2022-01-30,Monterey,053,433212,73425,65996,10990,76986,661
2022-01-30,Napa,055,140530,23610,22588,801,23389,114
2022-01-30,Nevada,057,99092,15007,14741,1016,15757,112
2022-01-30,Orange,059,3164182,526320,521334,38801,560135,6098
2022-01-30,Placer,061,380077,59381,58030,6865,64895,523
2022-01-30,Plumas,063,18699,2758,2510,276,2786,12
2022-01-30,Riverside,065,2383286,569057,557088,26244,583332,5767
2022-01-30,Sacramento,067,1510023,264080,255715,23219,278934,2572
2022-01-30,San Benito,069,59416,12086,11945,466,12411,90
2022-01-30,San Bernardino,071,2135413,554241,534050,23735,557785,6302
2022-01-30,San Diego,073,3302833,710643,687145,48643,735788,4665
2022-01-30,San Francisco,075,870044,115419,110772,7638,118410,712
2022-01-30,San Joaquin,077,732212,157116,155165,9324,164489,1985
2022-01-30,San Luis Obispo,079,281455,48577,47599,3244,50843,394
2022-01-30,San Mateo,081,765935,114006,102979,6199,109178,589
2022-01-30,Santa Barbara,083,443738,79991,79072,4248,83320,606
2022-01-30,Santa Clara,085,1922200,287143,282846,10895,293741,2035
2022-01-30,Santa Cruz,087,273765,42473,41330,1935,43265,239
2022-01-30,Shasta,089,179085,28517,28105,5470,33575,462
2022-01-30,Sierra,091,2930,266,261,44,305,0
2022-01-30,Siskiyou,093,43540,4138,4039,2373,6412,66
2022-01-30,Solano,095,438530,75347,71857,5046,76903,414
2022-01-30,Sonoma,097,501317,77562,75890,2170,78060,431
2022-01-30,Stanislaus,099,539301,110941,110111,15712,125823,1403
2022-01-30,Sutter,101,95872,19370,19108,1595,20703,202
2022-01-30,Tehama,103,63373,11255,11071,2400,13471,145
2022-01-30,Trinity,105,12862,1109,1068,259,1327,19
2022-01-30,Tulare,107,460477,99425,95676,24835,120511,1245
2022-01-30,Tuolumne,109,53932,11734,11242,422,11664,91
2022-01-30,Ventura,111,848112,165541,163521,8977,172498,1286
2022-01-30,Yolo,113,214977,34451,33043,2679,35722,274
2022-01-30,Yuba,115,75493,14813,14584,996,15580,103
2022-01-29,Alameda,001,1643700,237453,225602,12153,237755,1605
2022-01-29,Alpine,003,1148,119,123,1,124,0
2022-01-29,Amador,005,37829,7867,7505,509,8014,73
2022-01-29,Butte,007,227075,30836,29557,6258,35815,353
2022-01-29,Calaveras,009,45235,6773,6484,273,6757,96
2022-01-29,Colusa,011,21464,3247,3107,970,4077,21
2022-01-29,Contra Costa,013,1133247,177778,168003,11384,179387,1101
2022-01-29,Del Norte,015,27424,4920,4589,128,4717,43
2022-01-29,El Dorado,017,186661,25381,24008,2952,26960,184
2022-01-29,Fresno,019,978130,213713,202691,21174,223865,2457
2022-01-29,Glenn,021,27897,4684,4516,1475,5991,39
2022-01-29,Humboldt,023,135768,15363,14812,2407,17219,126
2022-01-29,Imperial,025,180216,52249,50153,9369,59522,845
2022-01-29,Inyo,027,18085,3942,3895,401,4296,50
2022-01-29,Kern,029,883053,181857,174456,42073,216529,1962
2022-01-29,Kings,031,150075,47660,45047,3162,48209,397
2022-01-29,Lake,033,64148,9524,8747,724,9471,119
2022-01-29,Lassen,035,31185,8349,7961,801,8762,55
2022-01-29,Los Angeles,037,10098052,2597761,2473332,117197,2590529,28467
2022-01-29,Madera,039,155013,34393,32753,5002,37755,329
2022-01-29,Marin,041,260295,31249,30137,1996,32133,253
2022-01-29,Mariposa,043,17540,2221,2117,134,2251,6
2022-01-29,Mendocino,045,87422,12068,11591,2345,13936,104
2022-01-29,Merced,047,269075,58587,56472,6969,63441,735
2022-01-29,Modoc,049,8938,668,654,229,883,6
2022-01-29,Mono,051,14174,2884,2860,114,2974,5
2022-01-29,Monterey,053,433212,73270,64090,10928,75018,658
2022-01-29,Napa,055,140530,23553,22121,799,22920,113
2022-01-29,Nevada,057,99092,14973,14337,1013,15350,112
2022-01-29,Orange,059,3164182,525617,511255,38695,549950,6038
2022-01-29,Placer,061,380077,59190,56562,6849,63411,523
2022-01-29,Plumas,063,18699,2748,2463,272,2735,12
2022-01-29,Riverside,065,2383286,568035,548121,26202,574323,5726
2022-01-29,Sacramento,067,1510023,263442,249130,23173,272303,2558
2022-01-29,San Benito,069,59416,12029,11670,465,12135,90
2022-01-29,San Bernardino,071,2135413,553492,525249,23692,548941,6297
2022-01-29,San Diego,073,3302833,709307,683027,48545,731572,4643
2022-01-29,San Francisco,075,870044,115144,108265,7590,115855,712
2022-01-29,San Joaquin,077,732212,156872,150849,9302,160151,1971
2022-01-29,San Luis Obispo,079,281455,48487,46374,3241,49615,391
2022-01-29,San Mateo,081,765935,113669,100306,6176,106482,586
2022-01-29,Santa Barbara,083,443738,79769,76546,4242,80788,604
2022-01-29,Santa Clara,085,1922200,286210,273879,10867,284746,2019
2022-01-29,Santa Cruz,087,273765,42342,39228,1933,41161,240
2022-01-29,Shasta,089,179085,28457,27504,5457,32961,452
2022-01-29,Sierra,091,2930,266,260,43,303,0
2022-01-29,Siskiyou,093,43540,4128,3987,2366,6353,66
2022-01-29,Solano,095,438530,75202,69862,5033,74895,407
2022-01-29,Sonoma,097,501317,77348,73439,2165,75604,427
2022-01-29,Stanislaus,099,539301,110691,107668,15665,123333,1403
2022-01-29,Sutter,101,95872,19322,18797,1579,20376,202
2022-01-29,Tehama,103,63373,11220,10880,2391,13271,145
2022-01-29,Trinity,105,12862,1106,1033,258,1291,19
2022-01-29,Tulare,107,460477,99169,93154,24763,117917,1237
2022-01-29,Tuolumne,109,53932,11708,10806,414,11220,91
2022-01-29,Ventura,111,848112,165211,160466,8958,169424,1271
2022-01-29,Yolo,113,214977,34336,32123,2663,34786,275
2022-01-29,Yuba,115,75493,14772,14295,994,15289,103
2022-01-28,Alameda,001,1643700,236505,225602,12136,237738,1605
2022-01-28,Alpine,003,1148,119,123,1,124,0
2022-01-28,Amador,005,37829,7841,7505,508,8013,73
2022-01-28,Butte,007,227075,30760,29557,6236,35793,353
2022-01-28,Calaveras,009,45235,6755,6484,272,6756,96
2022-01-28,Colusa,011,21464,3242,3107,969,4076,21
2022-01-28,Contra Costa,013,1133247,177246,168003,11347,179350,1101
2022-01-28,Del Norte,015,27424,4896,4589,127,4716,43
2022-01-28,El Dorado,017,186661,25334,24008,2946,26954,184
2022-01-28,Fresno,019,978130,212845,202691,21119,223810,2457
2022-01-28,Glenn,021,27897,4671,4516,1473,5989,39
2022-01-28,Humboldt,023,135768,15327,14812,2397,17209,126
2022-01-28,Imperial,025,180216,52120,50153,9339,59492,845
2022-01-28,Inyo,027,18085,3938,3895,398,4293,50
2022-01-28,Kern,029,883053,181446,174456,41915,216371,1962
2022-01-28,Kings,031,150075,47529,45047,3152,48199,397
2022-01-28,Lake,033,64148,9492,8747,722,9469,119
2022-01-28,Lassen,035,31185,8279,7961,799,8760,55
2022-01-28,Los Angeles,037,10098052,2592039,2473332,116983,2590315,28467
2022-01-28,Madera,039,155013,34265,32753,4986,37739,329
2022-01-28,Marin,041,260295,31156,30137,1976,32113,253
2022-01-28,Mariposa,043,17540,2211,2117,132,2249,6
2022-01-28,Mendocino,045,87422,12025,11591,2343,13934,104
2022-01-28,Merced,047,269075,58491,56472,6955,63427,735
2022-01-28,Modoc,049,8938,667,654,229,883,6
2022-01-28,Mono,051,14174,2879,2860,113,2973,5
2022-01-28,Monterey,053,433212,73068,64090,10879,74969,658
2022-01-28,Napa,055,140530,23475,22121,797,22918,113
2022-01-28,Nevada,057,99092,14936,14337,1011,15348,112
2022-01-28,Orange,059,3164182,524548,511255,38606,549861,6038
2022-01-28,Placer,061,380077,58989,56562,6826,63388,523
2022-01-28,Plumas,063,18699,2740,2463,270,2733,12
2022-01-28,Riverside,065,2383286,566713,548121,26161,574282,5726
2022-01-28,Sacramento,067,1510023,262699,249130,23120,272250,2558
2022-01-28,San Benito,069,59416,12007,11670,460,12130,90
2022-01-28,San Bernardino,071,2135413,552447,525249,23655,548904,6297
2022-01-28,San Diego,073,3302833,707483,683027,48468,731495,4643
2022-01-28,San Francisco,075,870044,114789,108265,7541,115806,712
2022-01-28,San Joaquin,077,732212,156585,150849,9288,160137,1971
2022-01-28,San Luis Obispo,079,281455,48403,46374,3234,49608,391
2022-01-28,San Mateo,081,765935,113317,100306,6155,106461,586
2022-01-28,Santa Barbara,083,443738,79520,76546,4240,80786,604
2022-01-28,Santa Clara,085,1922200,285029,273879,10818,284697,2019
2022-01-28,Santa Cruz,087,273765,42150,39228,1922,41150,240
2022-01-28,Shasta,089,179085,28397,27504,5443,32947,452
2022-01-28,Sierra,091,2930,266,260,43,303,0
2022-01-28,Siskiyou,093,43540,4118,3987,2362,6349,66
2022-01-28,Solano,095,438530,74650,69862,4967,74829,407
2022-01-28,Sonoma,097,501317,77142,73439,2158,75597,427
2022-01-28,Stanislaus,099,539301,110418,107668,15623,123291,1403
2022-01-28,Sutter,101,95872,19277,18797,1577,20374,202
2022-01-28,Tehama,103,63373,11188,10880,2384,13264,145
2022-01-28,Trinity,105,12862,1097,1033,258,1291,19
2022-01-28,Tulare,107,460477,98894,93154,24657,117811,1237
2022-01-28,Tuolumne,109,53932,11675,10806,410,11216,91
2022-01-28,Ventura,111,848112,164756,160466,8939,169405,1271
2022-01-28,Yolo,113,214977,34231,32123,2657,34780,275
2022-01-28,Yuba,115,75493,14733,14295,990,15285,103
2022-01-27,Alameda,001,1643700,234925,225602,12003,237605,1605
2022-01-27,Alpine,003,1148,119,123,1,124,0
2022-01-27,Amador,005,37829,7794,7505,497,8002,73
2022-01-27,Butte,007,227075,30608,29557,6183,35740,353
2022-01-27,Calaveras,009,45235,6729,6484,256,6740,96
2022-01-27,Colusa,011,21464,3227,3107,965,4072,21
2022-01-27,Contra Costa,013,1133247,176220,168003,11177,179180,1101
2022-01-27,Del Norte,015,27424,4852,4589,123,4712,43
2022-01-27,El Dorado,017,186661,25223,24008,2926,26934,184
2022-01-27,Fresno,019,978130,211217,202691,20903,223594,2457
2022-01-27,Glenn,021,27897,4639,4516,1465,5981,39
2022-01-27,Humboldt,023,135768,15239,14812,2360,17172,126
2022-01-27,Imperial,025,180216,51851,50153,9227,59380,845
2022-01-27,Inyo,027,18085,3931,3895,388,4283,50
2022-01-27,Kern,029,883053,180666,174456,41555,216011,1962
2022-01-27,Kings,031,150075,47188,45047,3114,48161,397
2022-01-27,Lake,033,64148,9438,8747,705,9452,119
2022-01-27,Lassen,035,31185,8238,7961,793,8754,55
2022-01-27,Los Angeles,037,10098052,2580893,2473332,116475,2589807,28467
2022-01-27,Madera,039,155013,34055,32753,4884,37637,329
2022-01-27,Marin,041,260295,30993,30137,1961,32098,253
2022-01-27,Mariposa,043,17540,2188,2117,129,2246,6
2022-01-27,Mendocino,045,87422,11974,11591,2294,13885,104
2022-01-27,Merced,047,269075,58229,56472,6792,63264,735
2022-01-27,Modoc,049,8938,665,654,228,882,6
2022-01-27,Mono,051,14174,2874,2860,113,2973,5
2022-01-27,Monterey,053,433212,72446,64090,10634,74724,658
2022-01-27,Napa,055,140530,23318,22121,770,22891,113
2022-01-27,Nevada,057,99092,14863,14337,984,15321,112
2022-01-27,Orange,059,3164182,522821,511255,38470,549725,6038
2022-01-27,Placer,061,380077,58672,56562,6774,63336,523
2022-01-27,Plumas,063,18699,2729,2463,258,2721,12
2022-01-27,Riverside,065,2383286,564537,548121,26092,574213,5726
2022-01-27,Sacramento,067,1510023,261416,249130,22794,271924,2558
2022-01-27,San Benito,069,59416,11952,11670,455,12125,90
2022-01-27,San Bernardino,071,2135413,550514,525249,23555,548804,6297
2022-01-27,San Diego,073,3302833,704138,683027,48111,731138,4643
2022-01-27,San Francisco,075,870044,114283,108265,7482,115747,712
2022-01-27,San Joaquin,077,732212,155726,150849,9222,160071,1971
2022-01-27,San Luis Obispo,079,281455,48132,46374,3199,49573,391
2022-01-27,San Mateo,081,765935,112733,100306,6086,106392,586
2022-01-27,Santa Barbara,083,443738,79041,76546,4185,80731,604
2022-01-27,Santa Clara,085,1922200,282975,273879,10671,284550,2019
2022-01-27,Santa Cruz,087,273765,41485,39228,1904,41132,240
2022-01-27,Shasta,089,179085,28271,27504,5394,32898,452
2022-01-27,Sierra,091,2930,265,260,42,302,0
2022-01-27,Siskiyou,093,43540,4097,3987,2325,6312,66
2022-01-27,Solano,095,438530,74011,69862,4910,74772,407
2022-01-27,Sonoma,097,501317,76675,73439,2144,75583,427
2022-01-27,Stanislaus,099,539301,109891,107668,15480,123148,1403
2022-01-27,Sutter,101,95872,19172,18797,1552,20349,202
2022-01-27,Tehama,103,63373,11136,10880,2368,13248,145
2022-01-27,Trinity,105,12862,1093,1033,257,1290,19
2022-01-27,Tulare,107,460477,98229,93154,24395,117549,1237
2022-01-27,Tuolumne,109,53932,11622,10806,401,11207,91
2022-01-27,Ventura,111,848112,164105,160466,8903,169369,1271
2022-01-27,Yolo,113,214977,34086,32123,2642,34765,275
2022-01-27,Yuba,115,75493,14655,14295,974,15269,103
2022-01-26,Alameda,001,1643700,233022,222680,11833,234513,1596
2022-01-26,Alpine,003,1148,119,123,1,124,0
2022-01-26,Amador,005,37829,7720,7427,482,7909,73
2022-01-26,Butte,007,227075,30411,29229,6120,35349,353
2022-01-26,Calaveras,009,45235,6691,6387,250,6637,96
2022-01-26,Colusa,011,21464,3209,3094,960,4054,21
2022-01-26,Contra Costa,013,1133247,175066,165972,11011,176983,1095
2022-01-26,Del Norte,015,27424,4794,4542,122,4664,43
2022-01-26,El Dorado,017,186661,25104,23819,2903,26722,181
2022-01-26,Fresno,019,978130,209364,199689,20688,220377,2452
2022-01-26,Glenn,021,27897,4606,4472,1460,5932,39
2022-01-26,Humboldt,023,135768,15141,14715,2317,17032,126
2022-01-26,Imperial,025,180216,51494,49477,9083,58560,839
2022-01-26,Inyo,027,18085,3928,3889,358,4247,50
2022-01-26,Kern,029,883053,179728,173052,41216,214268,1953
2022-01-26,Kings,031,150075,46783,44367,3085,47452,396
2022-01-26,Lake,033,64148,9356,8645,695,9340,119
2022-01-26,Lassen,035,31185,8198,7888,793,8681,55
2022-01-26,Los Angeles,037,10098052,2568694,2450620,116028,2566648,28382
2022-01-26,Madera,039,155013,33817,32323,4747,37070,329
2022-01-26,Marin,041,260295,30811,29813,1944,31757,253
2022-01-26,Mariposa,043,17540,2171,2108,122,2230,6
2022-01-26,Mendocino,045,87422,11927,11453,2243,13696,103
2022-01-26,Merced,047,269075,57861,56060,6616,62676,733
2022-01-26,Modoc,049,8938,664,652,227,879,6
2022-01-26,Mono,051,14174,2871,2852,113,2965,4
2022-01-26,Monterey,053,433212,71890,63264,10345,73609,659
2022-01-26,Napa,055,140530,23162,21864,760,22624,112
2022-01-26,Nevada,057,99092,14769,14128,973,15101,112
2022-01-26,Orange,059,3164182,520833,506419,38308,544727,6007
2022-01-26,Placer,061,380077,58334,55892,6712,62604,524
2022-01-26,Plumas,063,18699,2702,2425,256,2681,12
2022-01-26,Riverside,065,2383286,562011,543788,25976,569764,5701
2022-01-26,Sacramento,067,1510023,259726,246416,22467,268883,2559
2022-01-26,San Benito,069,59416,11881,11563,443,12006,90
2022-01-26,San Bernardino,071,2135413,548247,521699,23448,545147,6291
2022-01-26,San Diego,073,3302833,699916,676392,47753,724145,4622
2022-01-26,San Francisco,075,870044,113644,107174,7449,114623,704
2022-01-26,San Joaquin,077,732212,154736,148770,9168,157938,1971
2022-01-26,San Luis Obispo,079,281455,47828,45716,3172,48888,391
2022-01-26,San Mateo,081,765935,112066,99016,5961,104977,586
2022-01-26,Santa Barbara,083,443738,78512,75548,4125,79673,600
2022-01-26,Santa Clara,085,1922200,280895,270470,10501,280971,2015
2022-01-26,Santa Cruz,087,273765,40967,38298,1890,40188,239
2022-01-26,Shasta,089,179085,28123,27255,5348,32603,452
2022-01-26,Sierra,091,2930,264,260,41,301,0
2022-01-26,Siskiyou,093,43540,4081,3971,2300,6271,66
2022-01-26,Solano,095,438530,73316,69150,4843,73993,401
2022-01-26,Sonoma,097,501317,76115,72509,2109,74618,423
2022-01-26,Stanislaus,099,539301,109334,106582,15267,121849,1396
2022-01-26,Sutter,101,95872,19062,18670,1508,20178,202
2022-01-26,Tehama,103,63373,11082,10749,2354,13103,145
2022-01-26,Trinity,105,12862,1088,1008,257,1265,19
2022-01-26,Tulare,107,460477,97418,91904,24156,116060,1234
2022-01-26,Tuolumne,109,53932,11438,10699,390,11089,91
2022-01-26,Ventura,111,848112,163394,159077,8861,167938,1263
2022-01-26,Yolo,113,214977,33868,31913,2604,34517,275
2022-01-26,Yuba,115,75493,14570,14171,952,15123,103
2022-01-25,Alameda,001,1643700,231126,219753,11656,231409,1589
2022-01-25,Alpine,003,1148,119,122,1,123,0
2022-01-25,Amador,005,37829,7643,7352,471,7823,73
2022-01-25,Butte,007,227075,30203,28887,6043,34930,351
2022-01-25,Calaveras,009,45235,6633,6266,237,6503,95
2022-01-25,Colusa,011,21464,3189,3074,958,4032,21
2022-01-25,Contra Costa,013,1133247,173723,163792,10795,174587,1092
2022-01-25,Del Norte,015,27424,4724,4514,117,4631,43
2022-01-25,El Dorado,017,186661,24968,23339,2877,26216,179
2022-01-25,Fresno,019,978130,207222,198262,20404,218666,2434
2022-01-25,Glenn,021,27897,4574,4418,1444,5862,39
2022-01-25,Humboldt,023,135768,15049,14574,2291,16865,126
2022-01-25,Imperial,025,180216,51038,48913,8862,57775,832
2022-01-25,Inyo,027,18085,3912,3857,316,4173,50
2022-01-25,Kern,029,883053,178723,171695,40768,212463,1947
2022-01-25,Kings,031,150075,46313,43853,3040,46893,396
2022-01-25,Lake,033,64148,9277,8543,683,9226,118
2022-01-25,Lassen,035,31185,8167,7834,784,8618,55
2022-01-25,Los Angeles,037,10098052,2553755,2433516,115393,2548909,28293
2022-01-25,Madera,039,155013,33495,31794,4614,36408,329
2022-01-25,Marin,041,260295,30633,29589,1931,31520,253
2022-01-25,Mariposa,043,17540,2159,2069,116,2185,6
2022-01-25,Mendocino,045,87422,11807,11280,2140,13420,103
2022-01-25,Merced,047,269075,57479,55555,6479,62034,733
2022-01-25,Modoc,049,8938,662,652,227,879,6
2022-01-25,Mono,051,14174,2861,2826,112,2938,4
2022-01-25,Monterey,053,433212,71316,62498,9944,72442,654
2022-01-25,Napa,055,140530,22967,21668,726,22394,111
2022-01-25,Nevada,057,99092,14656,13944,951,14895,112
2022-01-25,Orange,059,3164182,518553,504274,38115,542389,5980
2022-01-25,Placer,061,380077,57932,55465,6639,62104,518
2022-01-25,Plumas,063,18699,2677,2397,252,2649,12
2022-01-25,Riverside,065,2383286,558921,540723,25812,566535,5686
2022-01-25,Sacramento,067,1510023,257784,244468,21941,266409,2545
2022-01-25,San Benito,069,59416,11781,11446,439,11885,88
2022-01-25,San Bernardino,071,2135413,545669,519150,23334,542484,6288
2022-01-25,San Diego,073,3302833,694921,670110,47302,717412,4604
2022-01-25,San Francisco,075,870044,112884,106254,7407,113661,703
2022-01-25,San Joaquin,077,732212,153743,147271,9104,156375,1972
2022-01-25,San Luis Obispo,079,281455,47467,45130,3124,48254,391
2022-01-25,San Mateo,081,765935,111232,98010,5850,103860,586
2022-01-25,Santa Barbara,083,443738,77844,74686,4046,78732,594
2022-01-25,Santa Clara,085,1922200,278282,268031,10299,278330,2006
2022-01-25,Santa Cruz,087,273765,40295,37850,1875,39725,237
2022-01-25,Shasta,089,179085,27961,27090,5282,32372,452
2022-01-25,Sierra,091,2930,264,260,37,297,0
2022-01-25,Siskiyou,093,43540,4057,3958,2265,6223,65
2022-01-25,Solano,095,438530,72747,68657,4784,73441,399
2022-01-25,Sonoma,097,501317,75425,71633,2069,73702,423
2022-01-25,Stanislaus,099,539301,108662,105965,15049,121014,1396
2022-01-25,Sutter,101,95872,18959,18508,1468,19976,200
2022-01-25,Tehama,103,63373,11019,10669,2330,12999,145
2022-01-25,Trinity,105,12862,1081,999,255,1254,19
2022-01-25,Tulare,107,460477,96549,91237,23837,115074,1229
2022-01-25,Tuolumne,109,53932,11256,10516,366,10882,91
2022-01-25,Ventura,111,848112,162540,157971,8812,166783,1263
2022-01-25,Yolo,113,214977,33609,31677,2560,34237,274
2022-01-25,Yuba,115,75493,14485,14038,925,14963,103
2022-01-24,Alameda,001,1643700,228652,216252,11389,227641,1581
2022-01-24,Alpine,003,1148,119,120,1,121,0
2022-01-24,Amador,005,37829,7592,7166,434,7600,73
2022-01-24,Butte,007,227075,29975,28607,5977,34584,350
2022-01-24,Calaveras,009,45235,6585,6172,223,6395,95
2022-01-24,Colusa,011,21464,3170,3052,942,3994,21
2022-01-24,Contra Costa,013,1133247,172214,162161,10581,172742,1092
2022-01-24,Del Norte,015,27424,4664,4460,117,4577,43
2022-01-24,El Dorado,017,186661,24801,23128,2848,25976,179
2022-01-24,Fresno,019,978130,204919,196092,20092,216184,2430
2022-01-24,Glenn,021,27897,4533,4367,1435,5802,39
2022-01-24,Humboldt,023,135768,14938,14416,2246,16662,126
2022-01-24,Imperial,025,180216,50497,48228,8580,56808,824
2022-01-24,Inyo,027,18085,3906,3805,292,4097,50
2022-01-24,Kern,029,883053,177416,169892,40299,210191,1946
2022-01-24,Kings,031,150075,45740,43260,2969,46229,396
2022-01-24,Lake,033,64148,9168,8423,668,9091,118
2022-01-24,Lassen,035,31185,8083,7732,765,8497,55
2022-01-24,Los Angeles,037,10098052,2537232,2391045,114617,2505662,28230
2022-01-24,Madera,039,155013,33059,31339,4430,35769,329
2022-01-24,Marin,041,260295,30402,29301,1894,31195,253
2022-01-24,Mariposa,043,17540,2134,2033,112,2145,6
2022-01-24,Mendocino,045,87422,11703,11002,2061,13063,103
2022-01-24,Merced,047,269075,56987,54970,6198,61168,730
2022-01-24,Modoc,049,8938,659,648,226,874,6
2022-01-24,Mono,051,14174,2851,2802,111,2913,4
2022-01-24,Monterey,053,433212,70456,61975,9589,71564,654
2022-01-24,Napa,055,140530,22787,21494,714,22208,111
2022-01-24,Nevada,057,99092,14529,13774,928,14702,112
2022-01-24,Orange,059,3164182,515980,501634,37852,539486,5969
2022-01-24,Placer,061,380077,57450,54933,6590,61523,518
2022-01-24,Plumas,063,18699,2646,2370,238,2608,12
2022-01-24,Riverside,065,2383286,555193,535962,25604,561566,5661
2022-01-24,Sacramento,067,1510023,255419,241522,21386,262908,2526
2022-01-24,San Benito,069,59416,11684,11331,426,11757,88
2022-01-24,San Bernardino,071,2135413,542693,515604,23172,538776,6285
2022-01-24,San Diego,073,3302833,689264,663580,46753,710333,4586
2022-01-24,San Francisco,075,870044,111926,105418,7311,112729,703
2022-01-24,San Joaquin,077,732212,152431,145984,9029,155013,1959
2022-01-24,San Luis Obispo,079,281455,46996,44616,3070,47686,387
2022-01-24,San Mateo,081,765935,110270,96968,5737,102705,586
2022-01-24,Santa Barbara,083,443738,77033,73866,3953,77819,591
2022-01-24,Santa Clara,085,1922200,275412,265341,10088,275429,2006
2022-01-24,Santa Cruz,087,273765,39495,37188,1857,39045,237
2022-01-24,Shasta,089,179085,27778,26871,5194,32065,452
2022-01-24,Sierra,091,2930,264,258,37,295,0
2022-01-24,Siskiyou,093,43540,4048,3934,2226,6160,64
2022-01-24,Solano,095,438530,72065,68094,4707,72801,400
2022-01-24,Sonoma,097,501317,74510,70733,2032,72765,423
2022-01-24,Stanislaus,099,539301,107905,104933,14778,119711,1395
2022-01-24,Sutter,101,95872,18843,18336,1382,19718,200
2022-01-24,Tehama,103,63373,10949,10567,2310,12877,145
2022-01-24,Trinity,105,12862,1072,978,253,1231,19
2022-01-24,Tulare,107,460477,95482,90089,23477,113566,1219
2022-01-24,Tuolumne,109,53932,11134,10374,358,10732,91
2022-01-24,Ventura,111,848112,161517,156551,8767,165318,1261
2022-01-24,Yolo,113,214977,33316,31480,2531,34011,273
2022-01-24,Yuba,115,75493,14379,13862,886,14748,103
2022-01-23,Alameda,001,1643700,225943,214003,11063,225066,1583
2022-01-23,Alpine,003,1148,119,120,1,121,0
2022-01-23,Amador,005,37829,7536,7090,394,7484,73
2022-01-23,Butte,007,227075,29681,28340,5851,34191,350
2022-01-23,Calaveras,009,45235,6520,6095,202,6297,95
2022-01-23,Colusa,011,21464,3146,3040,935,3975,21
2022-01-23,Contra Costa,013,1133247,170342,160798,10226,171024,1092
2022-01-23,Del Norte,015,27424,4596,4419,111,4530,43
2022-01-23,El Dorado,017,186661,24610,22925,2801,25726,179
2022-01-23,Fresno,019,978130,202458,193642,19626,213268,2430
2022-01-23,Glenn,021,27897,4482,4340,1413,5753,39
2022-01-23,Humboldt,023,135768,14816,14296,2164,16460,126
2022-01-23,Imperial,025,180216,49899,47935,8296,56231,824
2022-01-23,Inyo,027,18085,3879,3781,278,4059,50
2022-01-23,Kern,029,883053,176053,168585,39774,208359,1946
2022-01-23,Kings,031,150075,45105,42622,2867,45489,397
2022-01-23,Lake,033,64148,8998,8363,642,9005,118
2022-01-23,Lassen,035,31185,8034,7710,741,8451,55
2022-01-23,Los Angeles,037,10098052,2516925,2390590,113474,2504064,28231
2022-01-23,Madera,039,155013,32700,30962,4194,35156,329
2022-01-23,Marin,041,260295,30149,29025,1856,30881,253
2022-01-23,Mariposa,043,17540,2119,2011,109,2120,6
2022-01-23,Mendocino,045,87422,11578,10889,1933,12822,103
2022-01-23,Merced,047,269075,56434,54644,5752,60396,730
2022-01-23,Modoc,049,8938,657,645,223,868,6
2022-01-23,Mono,051,14174,2843,2788,109,2897,4
2022-01-23,Monterey,053,433212,69619,61522,9157,70679,654
2022-01-23,Napa,055,140530,22524,21281,701,21982,111
2022-01-23,Nevada,057,99092,14368,13629,899,14528,112
2022-01-23,Orange,059,3164182,512882,498968,37561,536529,5970
2022-01-23,Placer,061,380077,56879,54568,6502,61070,518
2022-01-23,Plumas,063,18699,2613,2368,209,2577,12
2022-01-23,Riverside,065,2383286,550750,532273,25302,557575,5661
2022-01-23,Sacramento,067,1510023,252783,239589,20447,260036,2530
2022-01-23,San Benito,069,59416,11562,11225,415,11640,88
2022-01-23,San Bernardino,071,2135413,539204,512657,22895,535552,6281
2022-01-23,San Diego,073,3302833,682656,640215,45952,686167,4566
2022-01-23,San Francisco,075,870044,110860,104485,7204,111689,704
2022-01-23,San Joaquin,077,732212,150817,144621,8947,153568,1959
2022-01-23,San Luis Obispo,079,281455,46300,44183,2996,47179,386
2022-01-23,San Mateo,081,765935,109155,95940,5593,101533,586
2022-01-23,Santa Barbara,083,443738,75910,73041,3830,76871,590
2022-01-23,Santa Clara,085,1922200,272117,261991,9769,271760,2005
2022-01-23,Santa Cruz,087,273765,38965,36547,1826,38373,237
2022-01-23,Shasta,089,179085,27498,26732,5074,31806,452
2022-01-23,Sierra,091,2930,263,252,37,289,0
2022-01-23,Siskiyou,093,43540,4023,3916,2169,6085,64
2022-01-23,Solano,095,438530,71266,67457,4613,72070,400
2022-01-23,Sonoma,097,501317,73556,69791,1976,71767,423
2022-01-23,Stanislaus,099,539301,107045,104067,14498,118565,1395
2022-01-23,Sutter,101,95872,18686,18175,1269,19444,200
2022-01-23,Tehama,103,63373,10851,10481,2278,12759,145
2022-01-23,Trinity,105,12862,1069,961,251,1212,19
2022-01-23,Tulare,107,460477,94225,89120,23065,112185,1219
2022-01-23,Tuolumne,109,53932,10942,10243,341,10584,91
2022-01-23,Ventura,111,848112,160335,155052,8690,163742,1261
2022-01-23,Yolo,113,214977,32939,30908,2491,33399,273
2022-01-23,Yuba,115,75493,14255,13762,833,14595,103
2022-01-22,Alameda,001,1643700,224864,203927,11033,214960,1575
2022-01-22,Alpine,003,1148,118,119,1,120,0
2022-01-22,Amador,005,37829,7502,6845,389,7234,73
2022-01-22,Butte,007,227075,29561,27232,5820,33052,350
2022-01-22,Calaveras,009,45235,6490,5835,201,6036,95
2022-01-22,Colusa,011,21464,3129,2954,932,3886,21
2022-01-22,Contra Costa,013,1133247,169402,154111,10196,164307,1091
2022-01-22,Del Norte,015,27424,4557,4269,107,4376,43
2022-01-22,El Dorado,017,186661,24542,22273,2791,25064,179
2022-01-22,Fresno,019,978130,201640,185292,19560,204852,2429
2022-01-22,Glenn,021,27897,4476,4174,1410,5584,39
2022-01-22,Humboldt,023,135768,14748,13628,2151,15779,125
2022-01-22,Imperial,025,180216,49709,45741,8237,53978,820
2022-01-22,Inyo,027,18085,3875,3706,254,3960,50
2022-01-22,Kern,029,883053,175428,162902,39474,202376,1946
2022-01-22,Kings,031,150075,44897,40580,2854,43434,396
2022-01-22,Lake,033,64148,8964,8056,634,8690,118
2022-01-22,Lassen,035,31185,8000,7545,734,8279,55
2022-01-22,Los Angeles,037,10098052,2509521,2286280,112968,2399248,28038
2022-01-22,Madera,039,155013,32581,29595,4179,33774,329
2022-01-22,Marin,041,260295,30022,27893,1851,29744,253
2022-01-22,Mariposa,043,17540,2115,1920,109,2029,6
2022-01-22,Mendocino,045,87422,11528,10395,1911,12306,103
2022-01-22,Merced,047,269075,56281,53025,5745,58770,727
2022-01-22,Modoc,049,8938,656,639,223,862,6
2022-01-22,Mono,051,14174,2842,2723,105,2828,4
2022-01-22,Monterey,053,433212,69413,59038,9115,68153,651
2022-01-22,Napa,055,140530,22429,20402,691,21093,111
2022-01-22,Nevada,057,99092,14300,12957,891,13848,112
2022-01-22,Orange,059,3164182,511277,480329,37313,517642,5946
2022-01-22,Placer,061,380077,56608,52557,6465,59022,512
2022-01-22,Plumas,063,18699,2596,2289,205,2494,12
2022-01-22,Riverside,065,2383286,548835,513567,25229,538796,5623
2022-01-22,Sacramento,067,1510023,251740,230206,20347,250553,2510
2022-01-22,San Benito,069,59416,11504,10743,410,11153,88
2022-01-22,San Bernardino,071,2135413,537676,495209,22802,518011,6267
2022-01-22,San Diego,073,3302833,680167,628904,45738,674642,4559
2022-01-22,San Francisco,075,870044,110203,100238,7056,107294,702
2022-01-22,San Joaquin,077,732212,150377,138264,8906,147170,1960
2022-01-22,San Luis Obispo,079,281455,46181,42154,2990,45144,385
2022-01-22,San Mateo,081,765935,108570,91440,5531,96971,585
2022-01-22,Santa Barbara,083,443738,75488,69555,3824,73379,589
2022-01-22,Santa Clara,085,1922200,270438,249205,9703,258908,1993
2022-01-22,Santa Cruz,087,273765,38783,33741,1820,35561,237
2022-01-22,Shasta,089,179085,27402,25919,5052,30971,450
2022-01-22,Sierra,091,2930,263,248,36,284,0
2022-01-22,Siskiyou,093,43540,4005,3845,2148,5993,62
2022-01-22,Solano,095,438530,71043,63882,4575,68457,391
2022-01-22,Sonoma,097,501317,73136,66013,1966,67979,422
2022-01-22,Stanislaus,099,539301,106587,100092,14407,114499,1393
2022-01-22,Sutter,101,95872,18618,17616,1256,18872,199
2022-01-22,Tehama,103,63373,10816,10171,2267,12438,142
2022-01-22,Trinity,105,12862,1067,925,251,1176,19
2022-01-22,Tulare,107,460477,93846,85223,22943,108166,1211
2022-01-22,Tuolumne,109,53932,10874,9731,335,10066,91
2022-01-22,Ventura,111,848112,159644,148742,8650,157392,1250
2022-01-22,Yolo,113,214977,32761,30061,2474,32535,273
2022-01-22,Yuba,115,75493,14166,13288,829,14117,103
2022-01-21,Alameda,001,1643700,223289,203927,11001,214928,1575
2022-01-21,Alpine,003,1148,118,119,1,120,0
2022-01-21,Amador,005,37829,7445,6845,386,7231,73
2022-01-21,Butte,007,227075,29435,27232,5777,33009,350
2022-01-21,Calaveras,009,45235,6444,5835,201,6036,95
2022-01-21,Colusa,011,21464,3122,2954,927,3881,21
2022-01-21,Contra Costa,013,1133247,168334,154111,10118,164229,1091
2022-01-21,Del Norte,015,27424,4517,4269,107,4376,43
2022-01-21,El Dorado,017,186661,24459,22273,2777,25050,179
2022-01-21,Fresno,019,978130,200399,185292,19466,204758,2429
2022-01-21,Glenn,021,27897,4456,4174,1405,5579,39
2022-01-21,Humboldt,023,135768,14678,13628,2132,15760,125
2022-01-21,Imperial,025,180216,49520,45741,8161,53902,820
2022-01-21,Inyo,027,18085,3862,3706,249,3955,50
2022-01-21,Kern,029,883053,174710,162902,39104,202006,1946
2022-01-21,Kings,031,150075,44700,40580,2846,43426,396
2022-01-21,Lake,033,64148,8907,8056,622,8678,118
2022-01-21,Lassen,035,31185,7951,7545,730,8275,55
2022-01-21,Los Angeles,037,10098052,2498222,2286280,112509,2398789,28038
2022-01-21,Madera,039,155013,32290,29595,4151,33746,329
2022-01-21,Marin,041,260295,29847,27893,1832,29725,253
2022-01-21,Mariposa,043,17540,2103,1920,108,2028,6
2022-01-21,Mendocino,045,87422,11447,10395,1908,12303,103
2022-01-21,Merced,047,269075,56122,53025,5741,58766,727
2022-01-21,Modoc,049,8938,655,639,223,862,6
2022-01-21,Mono,051,14174,2828,2723,102,2825,4
2022-01-21,Monterey,053,433212,68943,59038,8989,68027,651
2022-01-21,Napa,055,140530,22309,20402,683,21085,111
2022-01-21,Nevada,057,99092,14202,12957,887,13844,112
2022-01-21,Orange,059,3164182,509040,480329,37068,517397,5946
2022-01-21,Placer,061,380077,56215,52557,6403,58960,512
2022-01-21,Plumas,063,18699,2584,2289,200,2489,12
2022-01-21,Riverside,065,2383286,546178,513567,25150,538717,5623
2022-01-21,Sacramento,067,1510023,250302,230206,20246,250452,2510
2022-01-21,San Benito,069,59416,11468,10743,407,11150,88
2022-01-21,San Bernardino,071,2135413,535616,495209,22728,517937,6267
2022-01-21,San Diego,073,3302833,675999,628904,45561,674465,4559
2022-01-21,San Francisco,075,870044,109445,100238,6968,107206,702
2022-01-21,San Joaquin,077,732212,149779,138264,8851,147115,1960
2022-01-21,San Luis Obispo,079,281455,46055,42154,2987,45141,385
2022-01-21,San Mateo,081,765935,107899,91440,5493,96933,585
2022-01-21,Santa Barbara,083,443738,74986,69555,3815,73370,589
2022-01-21,Santa Clara,085,1922200,268617,249205,9595,258800,1993
2022-01-21,Santa Cruz,087,273765,38064,33741,1807,35548,237
2022-01-21,Shasta,089,179085,27313,25919,5005,30924,450
2022-01-21,Sierra,091,2930,261,248,35,283,0
2022-01-21,Siskiyou,093,43540,3996,3845,2130,5975,62
2022-01-21,Solano,095,438530,70632,63882,4492,68374,391
2022-01-21,Sonoma,097,501317,72612,66013,1956,67969,422
2022-01-21,Stanislaus,099,539301,106084,100092,14346,114438,1393
2022-01-21,Sutter,101,95872,18532,17616,1242,18858,199
2022-01-21,Tehama,103,63373,10780,10171,2265,12436,142
2022-01-21,Trinity,105,12862,1061,925,250,1175,19
2022-01-21,Tulare,107,460477,93369,85223,22789,108012,1211
2022-01-21,Tuolumne,109,53932,10791,9731,328,10059,91
2022-01-21,Ventura,111,848112,158835,148742,8619,157361,1250
2022-01-21,Yolo,113,214977,32598,30061,2453,32514,273
2022-01-21,Yuba,115,75493,14094,13288,822,14110,103
2022-01-20,Alameda,001,1643700,220225,203927,10766,214693,1575
2022-01-20,Alpine,003,1148,118,119,1,120,0
2022-01-20,Amador,005,37829,7381,6845,368,7213,73
2022-01-20,Butte,007,227075,29176,27232,5698,32930,350
2022-01-20,Calaveras,009,45235,6339,5835,192,6027,95
2022-01-20,Colusa,011,21464,3092,2954,915,3869,21
2022-01-20,Contra Costa,013,1133247,166353,154111,9854,163965,1091
2022-01-20,Del Norte,015,27424,4477,4269,104,4373,43
2022-01-20,El Dorado,017,186661,24255,22273,2734,25007,179
2022-01-20,Fresno,019,978130,197796,185292,19100,204392,2429
2022-01-20,Glenn,021,27897,4422,4174,1396,5570,39
2022-01-20,Humboldt,023,135768,14551,13628,2081,15709,125
2022-01-20,Imperial,025,180216,49002,45741,7985,53726,820
2022-01-20,Inyo,027,18085,3849,3706,238,3944,50
2022-01-20,Kern,029,883053,173186,162902,38566,201468,1946
2022-01-20,Kings,031,150075,44144,40580,2806,43386,396
2022-01-20,Lake,033,64148,8811,8056,594,8650,118
2022-01-20,Lassen,035,31185,7898,7545,715,8260,55
2022-01-20,Los Angeles,037,10098052,2473493,2286280,111538,2397818,28038
2022-01-20,Madera,039,155013,31902,29595,4026,33621,329
2022-01-20,Marin,041,260295,29554,27893,1796,29689,253
2022-01-20,Mariposa,043,17540,2076,1920,105,2025,6
2022-01-20,Mendocino,045,87422,11349,10395,1830,12225,103
2022-01-20,Merced,047,269075,55692,53025,5512,58537,727
2022-01-20,Modoc,049,8938,653,639,223,862,6
2022-01-20,Mono,051,14174,2820,2723,101,2824,4
2022-01-20,Monterey,053,433212,68179,59038,8576,67614,651
2022-01-20,Napa,055,140530,22043,20402,644,21046,111
2022-01-20,Nevada,057,99092,14057,12957,865,13822,112
2022-01-20,Orange,059,3164182,505104,480329,36700,517029,5946
2022-01-20,Placer,061,380077,55731,52557,6343,58900,512
2022-01-20,Plumas,063,18699,2557,2289,196,2485,12
2022-01-20,Riverside,065,2383286,541611,513567,24919,538486,5623
2022-01-20,Sacramento,067,1510023,248026,230206,19616,249822,2510
2022-01-20,San Benito,069,59416,11357,10743,394,11137,88
2022-01-20,San Bernardino,071,2135413,531403,495209,22452,517661,6267
2022-01-20,San Diego,073,3302833,668900,628904,44858,673762,4559
2022-01-20,San Francisco,075,870044,108295,100238,6828,107066,702
2022-01-20,San Joaquin,077,732212,148144,138264,8725,146989,1960
2022-01-20,San Luis Obispo,079,281455,45544,42154,2953,45107,385
2022-01-20,San Mateo,081,765935,106676,91440,5290,96730,585
2022-01-20,Santa Barbara,083,443738,74088,69555,3703,73258,589
2022-01-20,Santa Clara,085,1922200,265310,249205,9268,258473,1993
2022-01-20,Santa Cruz,087,273765,37179,33741,1784,35525,237
2022-01-20,Shasta,089,179085,27123,25919,4938,30857,450
2022-01-20,Sierra,091,2930,261,248,33,281,0
2022-01-20,Siskiyou,093,43540,3984,3845,2097,5942,62
2022-01-20,Solano,095,438530,69685,63882,4403,68285,391
2022-01-20,Sonoma,097,501317,71586,66013,1904,67917,422
2022-01-20,Stanislaus,099,539301,105127,100092,14142,114234,1393
2022-01-20,Sutter,101,95872,18367,17616,1214,18830,199
2022-01-20,Tehama,103,63373,10707,10171,2247,12418,142
2022-01-20,Trinity,105,12862,1047,925,249,1174,19
2022-01-20,Tulare,107,460477,92323,85223,22505,107728,1211
2022-01-20,Tuolumne,109,53932,10649,9731,318,10049,91
2022-01-20,Ventura,111,848112,157450,148742,8542,157284,1250
2022-01-20,Yolo,113,214977,32310,30061,2420,32481,273
2022-01-20,Yuba,115,75493,13988,13288,789,14077,103
2022-01-19,Alameda,001,1643700,216831,199739,10436,210175,1571
2022-01-19,Alpine,003,1148,117,119,1,120,0
2022-01-19,Amador,005,37829,7300,6789,326,7115,73
2022-01-19,Butte,007,227075,28873,26839,5612,32451,351
2022-01-19,Calaveras,009,45235,6249,5765,183,5948,95
2022-01-19,Colusa,011,21464,3067,2938,908,3846,21
2022-01-19,Contra Costa,013,1133247,164005,151543,9615,161158,1091
2022-01-19,Del Norte,015,27424,4438,4240,103,4343,43
2022-01-19,El Dorado,017,186661,23999,21953,2692,24645,177
2022-01-19,Fresno,019,978130,194894,181526,18782,200308,2430
2022-01-19,Glenn,021,27897,4371,4127,1386,5513,39
2022-01-19,Humboldt,023,135768,14393,13391,2029,15420,125
2022-01-19,Imperial,025,180216,48267,45156,7786,52942,820
2022-01-19,Inyo,027,18085,3826,3680,199,3879,49
2022-01-19,Kern,029,883053,171422,160747,37888,198635,1946
2022-01-19,Kings,031,150075,43448,40027,2738,42765,395
2022-01-19,Lake,033,64148,8684,7972,581,8553,118
2022-01-19,Lassen,035,31185,7841,7507,693,8200,55
2022-01-19,Los Angeles,037,10098052,2445112,2251718,110118,2361836,27934
2022-01-19,Madera,039,155013,31522,29021,3856,32877,329
2022-01-19,Marin,041,260295,29258,27375,1753,29128,251
2022-01-19,Mariposa,043,17540,2051,1896,99,1995,6
2022-01-19,Mendocino,045,87422,11178,10252,1737,11989,103
2022-01-19,Merced,047,269075,55147,52355,5156,57511,724
2022-01-19,Modoc,049,8938,651,635,222,857,6
2022-01-19,Mono,051,14174,2798,2677,99,2776,4
2022-01-19,Monterey,053,433212,67271,58426,8120,66546,651
2022-01-19,Napa,055,140530,21789,20090,617,20707,110
2022-01-19,Nevada,057,99092,13900,12703,838,13541,112
2022-01-19,Orange,059,3164182,500621,468460,36331,504791,5943
2022-01-19,Placer,061,380077,55167,51545,6275,57820,511
2022-01-19,Plumas,063,18699,2517,2239,190,2429,12
2022-01-19,Riverside,065,2383286,536091,503575,24684,528259,5604
2022-01-19,Sacramento,067,1510023,245133,226035,18900,244935,2512
2022-01-19,San Benito,069,59416,11216,10639,382,11021,88
2022-01-19,San Bernardino,071,2135413,526683,487846,22076,509922,6265
2022-01-19,San Diego,073,3302833,660125,614709,44125,658834,4553
2022-01-19,San Francisco,075,870044,106923,98652,6751,105403,694
2022-01-19,San Joaquin,077,732212,146250,135953,8602,144555,1959
2022-01-19,San Luis Obispo,079,281455,44945,41374,2887,44261,382
2022-01-19,San Mateo,081,765935,105265,89715,5026,94741,585
2022-01-19,Santa Barbara,083,443738,73091,68531,3604,72135,586
2022-01-19,Santa Clara,085,1922200,261584,244922,8908,253830,1991
2022-01-19,Santa Cruz,087,273765,35876,33026,1760,34786,237
2022-01-19,Shasta,089,179085,26856,25355,4866,30221,450
2022-01-19,Sierra,091,2930,261,245,32,277,0
2022-01-19,Siskiyou,093,43540,3960,3821,2044,5865,62
2022-01-19,Solano,095,438530,68843,63003,4273,67276,392
2022-01-19,Sonoma,097,501317,70487,64689,1858,66547,420
2022-01-19,Stanislaus,099,539301,104074,98952,13853,112805,1381
2022-01-19,Sutter,101,95872,18200,17436,1125,18561,199
2022-01-19,Tehama,103,63373,10593,10064,2200,12264,142
2022-01-19,Trinity,105,12862,1035,916,248,1164,19
2022-01-19,Tulare,107,460477,91041,83743,22038,105781,1200
2022-01-19,Tuolumne,109,53932,10490,9613,294,9907,91
2022-01-19,Ventura,111,848112,155934,144738,8467,153205,1234
2022-01-19,Yolo,113,214977,31946,29392,2384,31776,273
2022-01-19,Yuba,115,75493,13826,13114,776,13890,104
2022-01-18,Alameda,001,1643700,213459,195728,10129,205857,1566
2022-01-18,Alpine,003,1148,117,118,1,119,0
2022-01-18,Amador,005,37829,7162,6691,290,6981,73
2022-01-18,Butte,007,227075,28482,26514,5530,32044,347
2022-01-18,Calaveras,009,45235,6160,5684,168,5852,94
2022-01-18,Colusa,011,21464,3023,2903,903,3806,21
2022-01-18,Contra Costa,013,1133247,161948,149446,9244,158690,1085
2022-01-18,Del Norte,015,27424,4368,4229,98,4327,43
2022-01-18,El Dorado,017,186661,23619,21707,2647,24354,175
2022-01-18,Fresno,019,978130,191387,178922,18358,197280,2425
2022-01-18,Glenn,021,27897,4338,4070,1374,5444,39
2022-01-18,Humboldt,023,135768,14229,13218,1957,15175,125
2022-01-18,Imperial,025,180216,47572,44742,7604,52346,819
2022-01-18,Inyo,027,18085,3785,3654,189,3843,49
2022-01-18,Kern,029,883053,169399,158864,37136,196000,1943
2022-01-18,Kings,031,150075,42574,39440,2660,42100,392
2022-01-18,Lake,033,64148,8571,7919,562,8481,117
2022-01-18,Lassen,035,31185,7758,7461,654,8115,55
2022-01-18,Los Angeles,037,10098052,2411700,2227360,108650,2336010,27871
2022-01-18,Madera,039,155013,31000,28717,3667,32384,329
2022-01-18,Marin,041,260295,28955,27036,1710,28746,251
2022-01-18,Mariposa,043,17540,2026,1872,95,1967,6
2022-01-18,Mendocino,045,87422,11009,10114,1652,11766,103
2022-01-18,Merced,047,269075,54535,51746,4869,56615,718
2022-01-18,Modoc,049,8938,649,633,217,850,6
2022-01-18,Mono,051,14174,2777,2643,98,2741,4
2022-01-18,Monterey,053,433212,66496,57846,7641,65487,650
2022-01-18,Napa,055,140530,21456,19911,602,20513,109
2022-01-18,Nevada,057,99092,13716,12584,796,13380,111
2022-01-18,Orange,059,3164182,495277,461324,35827,497151,5938
2022-01-18,Placer,061,380077,54523,50983,6202,57185,508
2022-01-18,Plumas,063,18699,2479,2218,184,2402,12
2022-01-18,Riverside,065,2383286,530114,497278,24377,521655,5599
2022-01-18,Sacramento,067,1510023,242047,223745,17920,241665,2496
2022-01-18,San Benito,069,59416,11075,10520,368,10888,88
2022-01-18,San Bernardino,071,2135413,521254,483753,21649,505402,6258
2022-01-18,San Diego,073,3302833,649926,605137,43087,648224,4547
2022-01-18,San Francisco,075,870044,105458,96505,6635,103140,694
2022-01-18,San Joaquin,077,732212,144306,134365,8387,142752,1957
2022-01-18,San Luis Obispo,079,281455,44263,40848,2801,43649,381
2022-01-18,San Mateo,081,765935,103754,88225,4829,93054,585
2022-01-18,Santa Barbara,083,443738,71873,67216,3431,70647,581
2022-01-18,Santa Clara,085,1922200,257475,240281,8511,248792,1986
2022-01-18,Santa Cruz,087,273765,35226,32203,1725,33928,237
2022-01-18,Shasta,089,179085,26574,25162,4772,29934,448
2022-01-18,Sierra,091,2930,257,244,32,276,0
2022-01-18,Siskiyou,093,43540,3927,3799,1991,5790,62
2022-01-18,Solano,095,438530,67993,62204,4163,66367,391
2022-01-18,Sonoma,097,501317,69100,63714,1803,65517,419
2022-01-18,Stanislaus,099,539301,102857,98000,13485,111485,1379
2022-01-18,Sutter,101,95872,18009,17295,1054,18349,198
2022-01-18,Tehama,103,63373,10497,9975,2148,12123,142
2022-01-18,Trinity,105,12862,1022,907,247,1154,19
2022-01-18,Tulare,107,460477,89579,82667,21635,104302,1196
2022-01-18,Tuolumne,109,53932,10323,9528,283,9811,91
2022-01-18,Ventura,111,848112,154220,143384,8381,151765,1233
2022-01-18,Yolo,113,214977,31548,28786,2334,31120,270
2022-01-18,Yuba,115,75493,13665,12971,751,13722,101
2022-01-17,Alameda,001,1643700,208755,193276,9544,202820,1565
2022-01-17,Alpine,003,1148,116,118,0,118,0
2022-01-17,Amador,005,37829,7047,6640,232,6872,73
2022-01-17,Butte,007,227075,28095,26303,5422,31725,348
2022-01-17,Calaveras,009,45235,6029,5584,140,5724,94
2022-01-17,Colusa,011,21464,2999,2905,896,3801,21
2022-01-17,Contra Costa,013,1133247,159132,147993,8759,156752,1086
2022-01-17,Del Norte,015,27424,4317,4209,91,4300,43
2022-01-17,El Dorado,017,186661,23372,21540,2565,24105,175
2022-01-17,Fresno,019,978130,187681,176959,17860,194819,2426
2022-01-17,Glenn,021,27897,4285,4055,1361,5416,39
2022-01-17,Humboldt,023,135768,14023,13120,1791,14911,125
2022-01-17,Imperial,025,180216,46885,44412,7442,51854,821
2022-01-17,Inyo,027,18085,3763,3650,163,3813,49
2022-01-17,Kern,029,883053,166856,157645,36261,193906,1944
2022-01-17,Kings,031,150075,41440,39143,2540,41683,392
2022-01-17,Lake,033,64148,8422,7864,522,8386,117
2022-01-17,Lassen,035,31185,7665,7417,617,8034,55
2022-01-17,Los Angeles,037,10098052,2372506,2205740,106687,2312427,27832
2022-01-17,Madera,039,155013,30349,28568,3487,32055,329
2022-01-17,Marin,041,260295,28549,26633,1655,28288,251
2022-01-17,Mariposa,043,17540,2000,1862,89,1951,6
2022-01-17,Mendocino,045,87422,10786,10030,1512,11542,103
2022-01-17,Merced,047,269075,53857,51227,4308,55535,718
2022-01-17,Modoc,049,8938,645,630,217,847,6
2022-01-17,Mono,051,14174,2754,2642,97,2739,4
2022-01-17,Monterey,053,433212,65378,57318,7226,64544,647
2022-01-17,Napa,055,140530,21111,19647,579,20226,109
2022-01-17,Nevada,057,99092,13530,12414,759,13173,111
2022-01-17,Orange,059,3164182,489317,457418,35352,492770,5933
2022-01-17,Placer,061,380077,53791,50511,6059,56570,508
2022-01-17,Plumas,063,18699,2433,2205,152,2357,12
2022-01-17,Riverside,065,2383286,523300,491322,23924,515246,5600
2022-01-17,Sacramento,067,1510023,237965,221143,16575,237718,2497
2022-01-17,San Benito,069,59416,10909,10432,340,10772,88
2022-01-17,San Bernardino,071,2135413,514821,480243,21111,501354,6259
2022-01-17,San Diego,073,3302833,637707,569241,41881,611122,4545
2022-01-17,San Francisco,075,870044,103828,95292,6440,101732,694
2022-01-17,San Joaquin,077,732212,141469,133414,8196,141610,1958
2022-01-17,San Luis Obispo,079,281455,43434,40425,2700,43125,379
2022-01-17,San Mateo,081,765935,101785,87013,4575,91588,585
2022-01-17,Santa Barbara,083,443738,70551,66704,3231,69935,581
2022-01-17,Santa Clara,085,1922200,252991,237934,8076,246010,1985
2022-01-17,Santa Cruz,087,273765,34454,31714,1688,33402,237
2022-01-17,Shasta,089,179085,26294,25025,4651,29676,448
2022-01-17,Sierra,091,2930,256,242,32,274,0
2022-01-17,Siskiyou,093,43540,3888,3764,1911,5675,62
2022-01-17,Solano,095,438530,66953,61497,3904,65401,391
2022-01-17,Sonoma,097,501317,67596,62763,1737,64500,419
2022-01-17,Stanislaus,099,539301,101543,96951,13006,109957,1379
2022-01-17,Sutter,101,95872,17800,17159,918,18077,198
2022-01-17,Tehama,103,63373,10374,9912,2090,12002,142
2022-01-17,Trinity,105,12862,1009,906,243,1149,19
2022-01-17,Tulare,107,460477,87829,81741,21086,102827,1199
2022-01-17,Tuolumne,109,53932,10182,9416,251,9667,91
2022-01-17,Ventura,111,848112,152104,142070,8263,150333,1234
2022-01-17,Yolo,113,214977,31017,28638,2268,30906,270
2022-01-17,Yuba,115,75493,13468,12871,695,13566,101
2022-01-16,Alameda,001,1643700,205682,190691,9287,199978,1564
2022-01-16,Alpine,003,1148,116,118,0,118,0
2022-01-16,Amador,005,37829,6974,6618,224,6842,73
2022-01-16,Butte,007,227075,27751,26139,5369,31508,348
2022-01-16,Calaveras,009,45235,5927,5537,136,5673,94
2022-01-16,Colusa,011,21464,2982,2886,884,3770,21
2022-01-16,Contra Costa,013,1133247,157177,146307,8556,154863,1086
2022-01-16,Del Norte,015,27424,4275,4177,89,4266,43
2022-01-16,El Dorado,017,186661,23097,21303,2526,23829,175
2022-01-16,Fresno,019,978130,184972,174818,17503,192321,2425
2022-01-16,Glenn,021,27897,4230,4049,1339,5388,39
2022-01-16,Humboldt,023,135768,13876,13075,1772,14847,125
2022-01-16,Imperial,025,180216,46313,44035,7277,51312,821
2022-01-16,Inyo,027,18085,3726,3602,141,3743,49
2022-01-16,Kern,029,883053,165585,156655,35473,192128,1944
2022-01-16,Kings,031,150075,41067,38861,2520,41381,392
2022-01-16,Lake,033,64148,8318,7823,488,8311,117
2022-01-16,Lassen,035,31185,7620,7391,605,7996,55
2022-01-16,Los Angeles,037,10098052,2349332,2174403,105163,2279566,27805
2022-01-16,Madera,039,155013,29980,28313,3437,31750,329
2022-01-16,Marin,041,260295,28255,26292,1641,27933,251
2022-01-16,Mariposa,043,17540,1973,1851,84,1935,6
2022-01-16,Mendocino,045,87422,10639,9992,1396,11388,102
2022-01-16,Merced,047,269075,53266,50882,4283,55165,718
2022-01-16,Modoc,049,8938,642,629,217,846,6
2022-01-16,Mono,051,14174,2750,2614,95,2709,4
2022-01-16,Monterey,053,433212,64612,57012,7081,64093,647
2022-01-16,Napa,055,140530,20844,19521,568,20089,109
2022-01-16,Nevada,057,99092,13316,12307,741,13048,111
2022-01-16,Orange,059,3164182,483922,451962,34805,486767,5932
2022-01-16,Placer,061,380077,53084,50076,5947,56023,508
2022-01-16,Plumas,063,18699,2398,2204,142,2346,12
2022-01-16,Riverside,065,2383286,517797,485191,23704,508895,5600
2022-01-16,Sacramento,067,1510023,235008,218819,15859,234678,2491
2022-01-16,San Benito,069,59416,10751,10377,338,10715,88
2022-01-16,San Bernardino,071,2135413,510845,474425,20856,495281,6259
2022-01-16,San Diego,073,3302833,630119,569241,41444,610685,4545
2022-01-16,San Francisco,075,870044,102311,94139,6302,100441,694
2022-01-16,San Joaquin,077,732212,139685,132214,8055,140269,1958
2022-01-16,San Luis Obispo,079,281455,42777,40113,2661,42774,379
2022-01-16,San Mateo,081,765935,100260,85966,4482,90448,585
2022-01-16,Santa Barbara,083,443738,69523,66111,3191,69302,582
2022-01-16,Santa Clara,085,1922200,249340,234293,7922,242215,1984
2022-01-16,Santa Cruz,087,273765,33825,31469,1666,33135,237
2022-01-16,Shasta,089,179085,26040,24980,4583,29563,449
2022-01-16,Sierra,091,2930,252,238,31,269,0
2022-01-16,Siskiyou,093,43540,3860,3748,1872,5620,62
2022-01-16,Solano,095,438530,66277,60885,3773,64658,391
2022-01-16,Sonoma,097,501317,66518,61842,1720,63562,419
2022-01-16,Stanislaus,099,539301,100480,96370,12852,109222,1379
2022-01-16,Sutter,101,95872,17600,16996,896,17892,198
2022-01-16,Tehama,103,63373,10290,9868,2069,11937,142
2022-01-16,Trinity,105,12862,1004,889,241,1130,19
2022-01-16,Tulare,107,460477,86515,80867,20832,101699,1199
2022-01-16,Tuolumne,109,53932,10076,9369,243,9612,91
2022-01-16,Ventura,111,848112,150529,140715,8184,148899,1234
2022-01-16,Yolo,113,214977,30625,28481,2215,30696,270
2022-01-16,Yuba,115,75493,13291,12760,689,13449,101
2022-01-15,Alameda,001,1643700,204316,177768,9236,187004,1561
2022-01-15,Alpine,003,1148,116,117,0,117,0
2022-01-15,Amador,005,37829,6942,6434,210,6644,72
2022-01-15,Butte,007,227075,27596,25032,5319,30351,348
2022-01-15,Calaveras,009,45235,5895,5258,136,5394,93
2022-01-15,Colusa,011,21464,2968,2796,877,3673,21
2022-01-15,Contra Costa,013,1133247,155938,137643,8512,146155,1082
2022-01-15,Del Norte,015,27424,4260,4065,87,4152,43
2022-01-15,El Dorado,017,186661,22998,20434,2509,22943,175
2022-01-15,Fresno,019,978130,184043,167361,17418,184779,2415
2022-01-15,Glenn,021,27897,4223,3906,1330,5236,39
2022-01-15,Humboldt,023,135768,13773,12419,1756,14175,123
2022-01-15,Imperial,025,180216,46175,42508,7168,49676,817
2022-01-15,Inyo,027,18085,3716,3395,141,3536,49
2022-01-15,Kern,029,883053,164741,150085,35082,185167,1938
2022-01-15,Kings,031,150075,40818,37221,2508,39729,391
2022-01-15,Lake,033,64148,8279,7641,475,8116,117
2022-01-15,Lassen,035,31185,7579,7274,599,7873,55
2022-01-15,Los Angeles,037,10098052,2337805,2047927,104214,2152141,27641
2022-01-15,Madera,039,155013,29834,27294,3413,30707,329
2022-01-15,Marin,041,260295,28069,25248,1634,26882,251
2022-01-15,Mariposa,043,17540,1966,1762,84,1846,6
2022-01-15,Mendocino,045,87422,10566,9534,1390,10924,102
2022-01-15,Merced,047,269075,53099,48904,4272,53176,715
2022-01-15,Modoc,049,8938,640,628,217,845,6
2022-01-15,Mono,051,14174,2745,2508,94,2602,4
2022-01-15,Monterey,053,433212,64098,55315,7017,62332,647
2022-01-15,Napa,055,140530,20723,17648,564,18212,109
2022-01-15,Nevada,057,99092,13256,11773,728,12501,111
2022-01-15,Orange,059,3164182,481328,433141,34533,467674,5914
2022-01-15,Placer,061,380077,52794,47780,5911,53691,501
2022-01-15,Plumas,063,18699,2377,2158,136,2294,12
2022-01-15,Riverside,065,2383286,515116,466381,23569,489950,5578
2022-01-15,Sacramento,067,1510023,233852,208156,15760,223916,2491
2022-01-15,San Benito,069,59416,10652,9868,333,10201,87
2022-01-15,San Bernardino,071,2135413,508493,454395,20708,475103,6233
2022-01-15,San Diego,073,3302833,626330,559385,41188,600573,4540
2022-01-15,San Francisco,075,870044,101314,88004,6167,94171,692
2022-01-15,San Joaquin,077,732212,139120,125136,7958,133094,1954
2022-01-15,San Luis Obispo,079,281455,42588,38231,2648,40879,374
2022-01-15,San Mateo,081,765935,99305,80494,4441,84935,582
2022-01-15,Santa Barbara,083,443738,68927,62312,3180,65492,579
2022-01-15,Santa Clara,085,1922200,247140,218986,7802,226788,1974
2022-01-15,Santa Cruz,087,273765,33471,29414,1658,31072,235
2022-01-15,Shasta,089,179085,25949,24482,4551,29033,445
2022-01-15,Sierra,091,2930,251,232,30,262,0
2022-01-15,Siskiyou,093,43540,3848,3661,1862,5523,62
2022-01-15,Solano,095,438530,65997,58061,3724,61785,389
2022-01-15,Sonoma,097,501317,65932,58181,1714,59895,418
2022-01-15,Stanislaus,099,539301,99897,92986,12753,105739,1379
2022-01-15,Sutter,101,95872,17509,16345,886,17231,197
2022-01-15,Tehama,103,63373,10241,9572,2051,11623,141
2022-01-15,Trinity,105,12862,1001,872,241,1113,19
2022-01-15,Tulare,107,460477,86069,77769,20721,98490,1192
2022-01-15,Tuolumne,109,53932,9975,9042,238,9280,91
2022-01-15,Ventura,111,848112,149754,134736,8146,142882,1227
2022-01-15,Yolo,113,214977,30445,27311,2195,29506,270
2022-01-15,Yuba,115,75493,13228,12200,685,12885,101
2022-01-14,Alameda,001,1643700,202276,177768,9188,186956,1561
2022-01-14,Alpine,003,1148,116,117,0,117,0
2022-01-14,Amador,005,37829,6866,6434,201,6635,72
2022-01-14,Butte,007,227075,27415,25032,5287,30319,348
2022-01-14,Calaveras,009,45235,5858,5258,135,5393,93
2022-01-14,Colusa,011,21464,2959,2796,867,3663,21
2022-01-14,Contra Costa,013,1133247,154459,137643,8411,146054,1082
2022-01-14,Del Norte,015,27424,4235,4065,86,4151,43
2022-01-14,El Dorado,017,186661,22843,20434,2491,22925,175
2022-01-14,Fresno,019,978130,182388,167361,17342,184703,2415
2022-01-14,Glenn,021,27897,4201,3906,1322,5228,39
2022-01-14,Humboldt,023,135768,13667,12419,1723,14142,123
2022-01-14,Imperial,025,180216,46004,42508,7148,49656,817
2022-01-14,Inyo,027,18085,3691,3395,137,3532,49
2022-01-14,Kern,029,883053,163742,150085,34648,184733,1938
2022-01-14,Kings,031,150075,40566,37221,2500,39721,391
2022-01-14,Lake,033,64148,8222,7641,463,8104,117
2022-01-14,Lassen,035,31185,7545,7274,587,7861,55
2022-01-14,Los Angeles,037,10098052,2318482,2047927,103183,2151110,27641
2022-01-14,Madera,039,155013,29598,27294,3385,30679,329
2022-01-14,Marin,041,260295,27810,25248,1599,26847,251
2022-01-14,Mariposa,043,17540,1951,1762,84,1846,6
2022-01-14,Mendocino,045,87422,10454,9534,1377,10911,102
2022-01-14,Merced,047,269075,52916,48904,4257,53161,715
2022-01-14,Modoc,049,8938,639,628,217,845,6
2022-01-14,Mono,051,14174,2724,2508,92,2600,4
2022-01-14,Monterey,053,433212,63401,55315,6924,62239,647
2022-01-14,Napa,055,140530,20553,17648,559,18207,109
2022-01-14,Nevada,057,99092,13134,11773,715,12488,111
2022-01-14,Orange,059,3164182,477595,433141,34217,467358,5914
2022-01-14,Placer,061,380077,52358,47780,5825,53605,501
2022-01-14,Plumas,063,18699,2369,2158,129,2287,12
2022-01-14,Riverside,065,2383286,511593,466381,23426,489807,5578
2022-01-14,Sacramento,067,1510023,231903,208156,15611,223767,2491
2022-01-14,San Benito,069,59416,10600,9868,332,10200,87
2022-01-14,San Bernardino,071,2135413,505295,454395,20521,474916,6233
2022-01-14,San Diego,073,3302833,620680,559385,40880,600265,4540
2022-01-14,San Francisco,075,870044,100142,88004,5993,93997,692
2022-01-14,San Joaquin,077,732212,138270,125136,7878,133014,1954
2022-01-14,San Luis Obispo,079,281455,42421,38231,2627,40858,374
2022-01-14,San Mateo,081,765935,98076,80494,4412,84906,582
2022-01-14,Santa Barbara,083,443738,68408,62312,3170,65482,579
2022-01-14,Santa Clara,085,1922200,244577,218986,7696,226682,1974
2022-01-14,Santa Cruz,087,273765,33093,29414,1649,31063,235
2022-01-14,Shasta,089,179085,25828,24482,4518,29000,445
2022-01-14,Sierra,091,2930,249,232,28,260,0
2022-01-14,Siskiyou,093,43540,3837,3661,1849,5510,62
2022-01-14,Solano,095,438530,65153,58061,3636,61697,389
2022-01-14,Sonoma,097,501317,65391,58181,1688,59869,418
2022-01-14,Stanislaus,099,539301,99291,92986,12652,105638,1379
2022-01-14,Sutter,101,95872,17383,16345,878,17223,197
2022-01-14,Tehama,103,63373,10188,9572,2039,11611,141
2022-01-14,Trinity,105,12862,996,872,239,1111,19
2022-01-14,Tulare,107,460477,85542,77769,20560,98329,1192
2022-01-14,Tuolumne,109,53932,9852,9042,234,9276,91
2022-01-14,Ventura,111,848112,148648,134736,8087,142823,1227
2022-01-14,Yolo,113,214977,30204,27311,2167,29478,270
2022-01-14,Yuba,115,75493,13125,12200,680,12880,101
2022-01-13,Alameda,001,1643700,197953,177768,8837,186605,1561
2022-01-13,Alpine,003,1148,115,117,0,117,0
2022-01-13,Amador,005,37829,6806,6434,180,6614,72
2022-01-13,Butte,007,227075,27112,25032,5171,30203,348
2022-01-13,Calaveras,009,45235,5768,5258,132,5390,93
2022-01-13,Colusa,011,21464,2928,2796,857,3653,21
2022-01-13,Contra Costa,013,1133247,151883,137643,7957,145600,1082
2022-01-13,Del Norte,015,27424,4199,4065,85,4150,43
2022-01-13,El Dorado,017,186661,22594,20434,2445,22879,175
2022-01-13,Fresno,019,978130,179581,167361,16982,184343,2415
2022-01-13,Glenn,021,27897,4154,3906,1296,5202,39
2022-01-13,Humboldt,023,135768,13515,12419,1661,14080,123
2022-01-13,Imperial,025,180216,45460,42508,6935,49443,817
2022-01-13,Inyo,027,18085,3635,3395,120,3515,49
2022-01-13,Kern,029,883053,162157,150085,34059,184144,1938
2022-01-13,Kings,031,150075,40084,37221,2456,39677,391
2022-01-13,Lake,033,64148,8122,7641,442,8083,117
2022-01-13,Lassen,035,31185,7511,7274,571,7845,55
2022-01-13,Los Angeles,037,10098052,2282012,2047927,101383,2149310,27641
2022-01-13,Madera,039,155013,29131,27294,3292,30586,329
2022-01-13,Marin,041,260295,27466,25248,1556,26804,251
2022-01-13,Mariposa,043,17540,1928,1762,81,1843,6
2022-01-13,Mendocino,045,87422,10363,9534,1309,10843,102
2022-01-13,Merced,047,269075,52258,48904,3997,52901,715
2022-01-13,Modoc,049,8938,636,628,217,845,6
2022-01-13,Mono,051,14174,2701,2508,89,2597,4
2022-01-13,Monterey,053,433212,62464,55315,6639,61954,647
2022-01-13,Napa,055,140530,20253,17648,549,18197,109
2022-01-13,Nevada,057,99092,12941,11773,685,12458,111
2022-01-13,Orange,059,3164182,471152,433141,33761,466902,5914
2022-01-13,Placer,061,380077,51729,47780,5710,53490,501
2022-01-13,Plumas,063,18699,2349,2158,119,2277,12
2022-01-13,Riverside,065,2383286,505292,466381,23099,489480,5578
2022-01-13,Sacramento,067,1510023,228809,208156,14827,222983,2491
2022-01-13,San Benito,069,59416,10496,9868,324,10192,87
2022-01-13,San Bernardino,071,2135413,499477,454395,20057,474452,6233
2022-01-13,San Diego,073,3302833,612163,559385,40005,599390,4540
2022-01-13,San Francisco,075,870044,98406,88004,5799,93803,692
2022-01-13,San Joaquin,077,732212,136202,125136,7728,132864,1954
2022-01-13,San Luis Obispo,079,281455,41819,38231,2522,40753,374
2022-01-13,San Mateo,081,765935,96295,80494,4176,84670,582
2022-01-13,Santa Barbara,083,443738,67411,62312,2994,65306,579
2022-01-13,Santa Clara,085,1922200,240334,218986,7366,226352,1974
2022-01-13,Santa Cruz,087,273765,32278,29414,1627,31041,235
2022-01-13,Shasta,089,179085,25619,24482,4446,28928,445
2022-01-13,Sierra,091,2930,248,232,28,260,0
2022-01-13,Siskiyou,093,43540,3815,3661,1809,5470,62
2022-01-13,Solano,095,438530,64021,58061,3525,61586,389
2022-01-13,Sonoma,097,501317,64326,58181,1632,59813,418
2022-01-13,Stanislaus,099,539301,98174,92986,12374,105360,1379
2022-01-13,Sutter,101,95872,17187,16345,815,17160,197
2022-01-13,Tehama,103,63373,10089,9572,1991,11563,141
2022-01-13,Trinity,105,12862,988,872,239,1111,19
2022-01-13,Tulare,107,460477,84262,77769,20271,98040,1192
2022-01-13,Tuolumne,109,53932,9712,9042,216,9258,91
2022-01-13,Ventura,111,848112,146866,134736,7993,142729,1227
2022-01-13,Yolo,113,214977,29788,27311,2123,29434,270
2022-01-13,Yuba,115,75493,12990,12200,651,12851,101
2022-01-12,Alameda,001,1643700,193339,173001,8380,181381,1563
2022-01-12,Alpine,003,1148,115,117,0,117,0
2022-01-12,Amador,005,37829,6758,6354,166,6520,71
2022-01-12,Butte,007,227075,26785,24631,5080,29711,348
2022-01-12,Calaveras,009,45235,5691,5151,126,5277,93
2022-01-12,Colusa,011,21464,2889,2772,844,3616,21
2022-01-12,Contra Costa,013,1133247,149278,134579,7592,142171,1077
2022-01-12,Del Norte,015,27424,4173,4019,83,4102,43
2022-01-12,El Dorado,017,186661,22271,20092,2405,22497,175
2022-01-12,Fresno,019,978130,176853,165316,16571,181887,2413
2022-01-12,Glenn,021,27897,4103,3859,1274,5133,39
2022-01-12,Humboldt,023,135768,13342,12081,1579,13660,122
2022-01-12,Imperial,025,180216,44804,41985,6633,48618,814
2022-01-12,Inyo,027,18085,3589,3334,104,3438,49
2022-01-12,Kern,029,883053,160017,148435,33337,181772,1933
2022-01-12,Kings,031,150075,39453,36780,2414,39194,391
2022-01-12,Lake,033,64148,8006,7535,398,7933,117
2022-01-12,Lassen,035,31185,7469,7223,544,7767,55
2022-01-12,Los Angeles,037,10098052,2242275,2005065,99145,2104210,27601
2022-01-12,Madera,039,155013,28815,26952,3192,30144,329
2022-01-12,Marin,041,260295,26976,24704,1505,26209,251
2022-01-12,Mariposa,043,17540,1899,1725,79,1804,6
2022-01-12,Mendocino,045,87422,10199,9379,1211,10590,103
2022-01-12,Merced,047,269075,51559,48441,3724,52165,710
2022-01-12,Modoc,049,8938,634,627,217,844,6
2022-01-12,Mono,051,14174,2665,2466,85,2551,4
2022-01-12,Monterey,053,433212,61478,54524,6278,60802,647
2022-01-12,Napa,055,140530,19994,17347,526,17873,109
2022-01-12,Nevada,057,99092,12727,11552,639,12191,111
2022-01-12,Orange,059,3164182,464369,425737,33176,458913,5912
2022-01-12,Placer,061,380077,51069,47004,5595,52599,501
2022-01-12,Plumas,063,18699,2310,2135,108,2243,12
2022-01-12,Riverside,065,2383286,498069,458881,22759,481640,5565
2022-01-12,Sacramento,067,1510023,225237,204696,13953,218649,2479
2022-01-12,San Benito,069,59416,10365,9737,312,10049,87
2022-01-12,San Bernardino,071,2135413,493005,447869,19441,467310,6222
2022-01-12,San Diego,073,3302833,601659,551669,39147,590816,4529
2022-01-12,San Francisco,075,870044,96571,85700,5686,91386,691
2022-01-12,San Joaquin,077,732212,133918,122850,7601,130451,1948
2022-01-12,San Luis Obispo,079,281455,41092,37727,2439,40166,373
2022-01-12,San Mateo,081,765935,94265,78476,3802,82278,582
2022-01-12,Santa Barbara,083,443738,66268,60815,2892,63707,578
2022-01-12,Santa Clara,085,1922200,235846,213177,6987,220164,1971
2022-01-12,Santa Cruz,087,273765,31623,28463,1579,30042,235
2022-01-12,Shasta,089,179085,25407,24324,4381,28705,446
2022-01-12,Sierra,091,2930,247,228,28,256,0
2022-01-12,Siskiyou,093,43540,3787,3639,1762,5401,62
2022-01-12,Solano,095,438530,62973,57052,3404,60456,386
2022-01-12,Sonoma,097,501317,63042,56394,1549,57943,417
2022-01-12,Stanislaus,099,539301,96943,91738,12034,103772,1373
2022-01-12,Sutter,101,95872,16992,16135,782,16917,197
2022-01-12,Tehama,103,63373,10000,9475,1930,11405,141
2022-01-12,Trinity,105,12862,984,868,238,1106,19
2022-01-12,Tulare,107,460477,83145,76943,19892,96835,1192
2022-01-12,Tuolumne,109,53932,9583,8870,199,9069,91
2022-01-12,Ventura,111,848112,144955,132180,7907,140087,1220
2022-01-12,Yolo,113,214977,29373,26888,2050,28938,270
2022-01-12,Yuba,115,75493,12830,12015,624,12639,101
2022-01-11,Alameda,001,1643700,188812,169181,7984,177165,1561
2022-01-11,Alpine,003,1148,115,116,0,116,0
2022-01-11,Amador,005,37829,6674,6317,151,6468,71
2022-01-11,Butte,007,227075,26393,24479,4985,29464,347
2022-01-11,Calaveras,009,45235,5562,5083,112,5195,93
2022-01-11,Colusa,011,21464,2865,2766,831,3597,21
2022-01-11,Contra Costa,013,1133247,146216,132410,7106,139516,1077
2022-01-11,Del Norte,015,27424,4140,4006,81,4087,43
2022-01-11,El Dorado,017,186661,21927,19842,2332,22174,174
2022-01-11,Fresno,019,978130,173810,163509,16228,179737,2404
2022-01-11,Glenn,021,27897,4041,3844,1230,5074,39
2022-01-11,Humboldt,023,135768,13123,11960,1486,13446,122
2022-01-11,Imperial,025,180216,44199,41444,6433,47877,813
2022-01-11,Inyo,027,18085,3491,3278,97,3375,49
2022-01-11,Kern,029,883053,157735,146942,32515,179457,1929
2022-01-11,Kings,031,150075,38865,36524,2383,38907,389
2022-01-11,Lake,033,64148,7928,7494,382,7876,117
2022-01-11,Lassen,035,31185,7419,7210,530,7740,55
2022-01-11,Los Angeles,037,10098052,2199831,1966319,96905,2063224,27563
2022-01-11,Madera,039,155013,28400,26688,3113,29801,329
2022-01-11,Marin,041,260295,26619,24387,1460,25847,251
2022-01-11,Mariposa,043,17540,1877,1718,75,1793,6
2022-01-11,Mendocino,045,87422,10038,9301,1113,10414,102
2022-01-11,Merced,047,269075,50794,48068,3543,51611,708
2022-01-11,Modoc,049,8938,633,626,216,842,6
2022-01-11,Mono,051,14174,2622,2425,84,2509,4
2022-01-11,Monterey,053,433212,60435,53911,5930,59841,646
2022-01-11,Napa,055,140530,19554,17020,479,17499,109
2022-01-11,Nevada,057,99092,12501,11467,604,12071,110
2022-01-11,Orange,059,3164182,456694,417703,32544,450247,5909
2022-01-11,Placer,061,380077,50314,46459,5451,51910,500
2022-01-11,Plumas,063,18699,2275,2099,100,2199,12
2022-01-11,Riverside,065,2383286,490340,453766,22445,476211,5551
2022-01-11,Sacramento,067,1510023,221055,201058,12930,213988,2489
2022-01-11,San Benito,069,59416,10229,9624,299,9923,83
2022-01-11,San Bernardino,071,2135413,485096,442960,18840,461800,6198
2022-01-11,San Diego,073,3302833,589655,536954,38036,574990,4520
2022-01-11,San Francisco,075,870044,94364,83678,5528,89206,691
2022-01-11,San Joaquin,077,732212,131539,121139,7435,128574,1944
2022-01-11,San Luis Obispo,079,281455,40317,37183,2320,39503,372
2022-01-11,San Mateo,081,765935,91974,76756,3580,80336,582
2022-01-11,Santa Barbara,083,443738,64963,59758,2755,62513,578
2022-01-11,Santa Clara,085,1922200,230463,208425,6536,214961,1971
2022-01-11,Santa Cruz,087,273765,31115,27709,1529,29238,232
2022-01-11,Shasta,089,179085,25148,24132,4288,28420,446
2022-01-11,Sierra,091,2930,245,228,28,256,0
2022-01-11,Siskiyou,093,43540,3763,3621,1712,5333,62
2022-01-11,Solano,095,438530,61572,56349,3250,59599,388
2022-01-11,Sonoma,097,501317,61525,55411,1469,56880,416
2022-01-11,Stanislaus,099,539301,95576,90998,11667,102665,1372
2022-01-11,Sutter,101,95872,16792,15993,728,16721,197
2022-01-11,Tehama,103,63373,9872,9406,1882,11288,140
2022-01-11,Trinity,105,12862,972,858,236,1094,19
2022-01-11,Tulare,107,460477,81837,76267,19493,95760,1188
2022-01-11,Tuolumne,109,53932,9424,8811,192,9003,91
2022-01-11,Ventura,111,848112,142725,129548,7761,137309,1220
2022-01-11,Yolo,113,214977,28796,26482,1989,28471,270
2022-01-11,Yuba,115,75493,12656,11912,603,12515,101
2022-01-10,Alameda,001,1643700,183667,165657,7465,173122,1559
2022-01-10,Alpine,003,1148,115,116,0,116,0
2022-01-10,Amador,005,37829,6571,6279,136,6415,71
2022-01-10,Butte,007,227075,26053,24217,4888,29105,347
2022-01-10,Calaveras,009,45235,5464,5025,106,5131,93
2022-01-10,Colusa,011,21464,2836,2758,822,3580,21
2022-01-10,Contra Costa,013,1133247,143371,129951,6588,136539,1077
2022-01-10,Del Norte,015,27424,4117,3970,81,4051,43
2022-01-10,El Dorado,017,186661,21359,19606,2275,21881,172
2022-01-10,Fresno,019,978130,170768,161593,15831,177424,2404
2022-01-10,Glenn,021,27897,3982,3807,1216,5023,39
2022-01-10,Humboldt,023,135768,12881,11778,1353,13131,121
2022-01-10,Imperial,025,180216,43473,41080,6216,47296,811
2022-01-10,Inyo,027,18085,3436,3227,85,3312,49
2022-01-10,Kern,029,883053,155164,145744,31772,177516,1929
2022-01-10,Kings,031,150075,38248,36286,2357,38643,389
2022-01-10,Lake,033,64148,7839,7416,358,7774,117
2022-01-10,Lassen,035,31185,7381,7192,508,7700,55
2022-01-10,Los Angeles,037,10098052,2154300,1932475,94395,2026870,27546
2022-01-10,Madera,039,155013,27951,26501,3010,29511,328
2022-01-10,Marin,041,260295,26129,24023,1386,25409,251
2022-01-10,Mariposa,043,17540,1837,1684,70,1754,6
2022-01-10,Mendocino,045,87422,9865,9163,1026,10189,101
2022-01-10,Merced,047,269075,49986,47632,3261,50893,707
2022-01-10,Modoc,049,8938,632,622,214,836,6
2022-01-10,Mono,051,14174,2556,2415,79,2494,4
2022-01-10,Monterey,053,433212,59481,53485,5616,59101,645
2022-01-10,Napa,055,140530,19177,16775,465,17240,109
2022-01-10,Nevada,057,99092,12277,11300,566,11866,110
2022-01-10,Orange,059,3164182,447995,406170,31698,437868,5906
2022-01-10,Placer,061,380077,49467,45642,5289,50931,498
2022-01-10,Plumas,063,18699,2240,2086,98,2184,12
2022-01-10,Riverside,065,2383286,482087,445536,21996,467532,5546
2022-01-10,Sacramento,067,1510023,216553,198023,11887,209910,2474
2022-01-10,San Benito,069,59416,10058,9467,289,9756,83
2022-01-10,San Bernardino,071,2135413,476690,437207,18118,455325,6184
2022-01-10,San Diego,073,3302833,576960,530506,36898,567404,4500
2022-01-10,San Francisco,075,870044,92572,82209,5269,87478,690
2022-01-10,San Joaquin,077,732212,128869,119587,7151,126738,1927
2022-01-10,San Luis Obispo,079,281455,39501,36618,2225,38843,371
2022-01-10,San Mateo,081,765935,89327,75210,3324,78534,582
2022-01-10,Santa Barbara,083,443738,63702,58957,2566,61523,578
2022-01-10,Santa Clara,085,1922200,224681,203540,6057,209597,1971
2022-01-10,Santa Cruz,087,273765,30274,26906,1491,28397,232
2022-01-10,Shasta,089,179085,24951,23983,4211,28194,446
2022-01-10,Sierra,091,2930,242,223,28,251,0
2022-01-10,Siskiyou,093,43540,3730,3592,1668,5260,62
2022-01-10,Solano,095,438530,60531,55663,3053,58716,385
2022-01-10,Sonoma,097,501317,59978,54478,1423,55901,412
2022-01-10,Stanislaus,099,539301,94240,89997,11322,101319,1372
2022-01-10,Sutter,101,95872,16548,15823,682,16505,196
2022-01-10,Tehama,103,63373,9759,9360,1827,11187,140
2022-01-10,Trinity,105,12862,968,849,234,1083,19
2022-01-10,Tulare,107,460477,80344,75498,19107,94605,1186
2022-01-10,Tuolumne,109,53932,9298,8685,180,8865,91
2022-01-10,Ventura,111,848112,140117,126240,7611,133851,1217
2022-01-10,Yolo,113,214977,28200,26065,1936,28001,270
2022-01-10,Yuba,115,75493,12408,11776,569,12345,101
2022-01-09,Alameda,001,1643700,179141,162701,6795,169496,1561
2022-01-09,Alpine,003,1148,115,116,0,116,0
2022-01-09,Amador,005,37829,6483,6215,124,6339,71
2022-01-09,Butte,007,227075,25665,24018,4770,28788,347
2022-01-09,Calaveras,009,45235,5334,4976,97,5073,93
2022-01-09,Colusa,011,21464,2809,2750,799,3549,21
2022-01-09,Contra Costa,013,1133247,140386,128050,5923,133973,1077
2022-01-09,Del Norte,015,27424,4078,3950,77,4027,43
2022-01-09,El Dorado,017,186661,20996,19430,2209,21639,172
2022-01-09,Fresno,019,978130,168190,159989,15443,175432,2405
2022-01-09,Glenn,021,27897,3926,3797,1195,4992,39
2022-01-09,Humboldt,023,135768,12636,11582,1230,12812,121
2022-01-09,Imperial,025,180216,42634,40608,5956,46564,811
2022-01-09,Inyo,027,18085,3333,3149,76,3225,49
2022-01-09,Kern,029,883053,152710,144819,31031,175850,1927
2022-01-09,Kings,031,150075,37571,36041,2321,38362,389
2022-01-09,Lake,033,64148,7728,7393,314,7707,117
2022-01-09,Lassen,035,31185,7317,7172,479,7651,55
2022-01-09,Los Angeles,037,10098052,2106277,1887830,91329,1979159,27532
2022-01-09,Madera,039,155013,27571,26325,2913,29238,328
2022-01-09,Marin,041,260295,25679,23708,1295,25003,251
2022-01-09,Mariposa,043,17540,1787,1660,69,1729,6
2022-01-09,Mendocino,045,87422,9658,9097,914,10011,101
2022-01-09,Merced,047,269075,49115,47294,2989,50283,706
2022-01-09,Modoc,049,8938,630,619,214,833,6
2022-01-09,Mono,051,14174,2521,2390,72,2462,4
2022-01-09,Monterey,053,433212,58421,53251,5348,58599,645
2022-01-09,Napa,055,140530,18682,16614,449,17063,109
2022-01-09,Nevada,057,99092,12023,11152,505,11657,110
2022-01-09,Orange,059,3164182,437997,400563,30748,431311,5905
2022-01-09,Placer,061,380077,48472,45081,5139,50220,498
2022-01-09,Plumas,063,18699,2201,2081,78,2159,12
2022-01-09,Riverside,065,2383286,473103,440413,21455,461868,5546
2022-01-09,Sacramento,067,1510023,211764,195444,10774,206218,2475
2022-01-09,San Benito,069,59416,9872,9363,261,9624,83
2022-01-09,San Bernardino,071,2135413,468274,430257,17307,447564,6180
2022-01-09,San Diego,073,3302833,563842,478206,35042,513248,4500
2022-01-09,San Francisco,075,870044,90706,80463,5023,85486,690
2022-01-09,San Joaquin,077,732212,125790,118422,6985,125407,1927
2022-01-09,San Luis Obispo,079,281455,38696,36291,2119,38410,371
2022-01-09,San Mateo,081,765935,86816,73867,2997,76864,582
2022-01-09,Santa Barbara,083,443738,62018,58280,2304,60584,578
2022-01-09,Santa Clara,085,1922200,218635,199889,5522,205411,1976
2022-01-09,Santa Cruz,087,273765,29524,26513,1459,27972,232
2022-01-09,Shasta,089,179085,24711,23926,4124,28050,446
2022-01-09,Sierra,091,2930,239,223,26,249,0
2022-01-09,Siskiyou,093,43540,3701,3580,1609,5189,62
2022-01-09,Solano,095,438530,59375,54985,2772,57757,384
2022-01-09,Sonoma,097,501317,58303,53543,1386,54929,412
2022-01-09,Stanislaus,099,539301,92870,89248,11041,100289,1372
2022-01-09,Sutter,101,95872,16260,15695,602,16297,196
2022-01-09,Tehama,103,63373,9642,9306,1776,11082,140
2022-01-09,Trinity,105,12862,964,848,232,1080,19
2022-01-09,Tulare,107,460477,78936,75085,18737,93822,1186
2022-01-09,Tuolumne,109,53932,9140,8595,161,8756,91
2022-01-09,Ventura,111,848112,137064,124269,7368,131637,1217
2022-01-09,Yolo,113,214977,27592,25632,1891,27523,270
2022-01-09,Yuba,115,75493,12210,11666,538,12204,101
2022-01-08,Alameda,001,1643700,177247,148560,6656,155216,1558
2022-01-08,Alpine,003,1148,115,114,0,114,0
2022-01-08,Amador,005,37829,6452,6091,119,6210,71
2022-01-08,Butte,007,227075,25476,23429,4731,28160,347
2022-01-08,Calaveras,009,45235,5288,4823,93,4916,93
2022-01-08,Colusa,011,21464,2801,2713,796,3509,21
2022-01-08,Contra Costa,013,1133247,138830,119907,5840,125747,1077
2022-01-08,Del Norte,015,27424,4061,3902,77,3979,43
2022-01-08,El Dorado,017,186661,20815,18599,2176,20775,172
2022-01-08,Fresno,019,978130,167304,155394,15310,170704,2393
2022-01-08,Glenn,021,27897,3918,3732,1190,4922,39
2022-01-08,Humboldt,023,135768,12512,11149,1204,12353,121
2022-01-08,Imperial,025,180216,42446,39429,5814,45243,800
2022-01-08,Inyo,027,18085,3319,3020,73,3093,49
2022-01-08,Kern,029,883053,151572,140410,30602,171012,1921
2022-01-08,Kings,031,150075,37330,35275,2304,37579,390
2022-01-08,Lake,033,64148,7688,7209,306,7515,117
2022-01-08,Lassen,035,31185,7287,7127,463,7590,55
2022-01-08,Los Angeles,037,10098052,2087883,1765787,89597,1855384,27476
2022-01-08,Madera,039,155013,27404,25767,2875,28642,328
2022-01-08,Marin,041,260295,25395,22377,1284,23661,251
2022-01-08,Mariposa,043,17540,1777,1588,69,1657,6
2022-01-08,Mendocino,045,87422,9584,8792,912,9704,101
2022-01-08,Merced,047,269075,48942,46094,2965,49059,703
2022-01-08,Modoc,049,8938,630,610,214,824,6
2022-01-08,Mono,051,14174,2510,2240,67,2307,4
2022-01-08,Monterey,053,433212,58036,51721,5255,56976,644
2022-01-08,Napa,055,140530,18528,15819,423,16242,109
2022-01-08,Nevada,057,99092,11938,10765,492,11257,110
2022-01-08,Orange,059,3164182,434203,375124,29902,405026,5903
2022-01-08,Placer,061,380077,48029,43172,5097,48269,495
2022-01-08,Plumas,063,18699,2191,2053,73,2126,12
2022-01-08,Riverside,065,2383286,469588,422591,21187,443778,5535
2022-01-08,Sacramento,067,1510023,210328,185118,10617,195735,2470
2022-01-08,San Benito,069,59416,9711,9016,258,9274,83
2022-01-08,San Bernardino,071,2135413,464821,411724,16912,428636,6122
2022-01-08,San Diego,073,3302833,558941,472273,34499,506772,4495
2022-01-08,San Francisco,075,870044,89506,73660,4744,78404,690
2022-01-08,San Joaquin,077,732212,124821,112514,6884,119398,1916
2022-01-08,San Luis Obispo,079,281455,38493,34489,2076,36565,369
2022-01-08,San Mateo,081,765935,85433,67918,2910,70828,582
2022-01-08,Santa Barbara,083,443738,61323,54617,2270,56887,575
2022-01-08,Santa Clara,085,1922200,215603,183842,5314,189156,1966
2022-01-08,Santa Cruz,087,273765,29097,24678,1439,26117,230
2022-01-08,Shasta,089,179085,24620,23585,4093,27678,445
2022-01-08,Sierra,091,2930,235,215,25,240,0
2022-01-08,Siskiyou,093,43540,3689,3545,1595,5140,62
2022-01-08,Solano,095,438530,58967,52452,2700,55152,383
2022-01-08,Sonoma,097,501317,57780,50130,1352,51482,411
2022-01-08,Stanislaus,099,539301,92229,87049,10918,97967,1372
2022-01-08,Sutter,101,95872,16141,15261,589,15850,195
2022-01-08,Tehama,103,63373,9611,9109,1768,10877,140
2022-01-08,Trinity,105,12862,958,836,232,1068,19
2022-01-08,Tulare,107,460477,78543,73600,18603,92203,1185
2022-01-08,Tuolumne,109,53932,9034,8360,158,8518,91
2022-01-08,Ventura,111,848112,135894,117229,7234,124463,1216
2022-01-08,Yolo,113,214977,27298,24006,1863,25869,270
2022-01-08,Yuba,115,75493,12123,11277,535,11812,101
2022-01-07,Alameda,001,1643700,174563,148560,6541,155101,1558
2022-01-07,Alpine,003,1148,115,114,0,114,0
2022-01-07,Amador,005,37829,6403,6091,116,6207,71
2022-01-07,Butte,007,227075,25271,23429,4696,28125,347
2022-01-07,Calaveras,009,45235,5249,4823,93,4916,93
2022-01-07,Colusa,011,21464,2792,2713,785,3498,21
2022-01-07,Contra Costa,013,1133247,136890,119907,5716,125623,1077
2022-01-07,Del Norte,015,27424,4045,3902,76,3978,43
2022-01-07,El Dorado,017,186661,20652,18599,2163,20762,172
2022-01-07,Fresno,019,978130,165943,155394,15217,170611,2393
2022-01-07,Glenn,021,27897,3898,3732,1187,4919,39
2022-01-07,Humboldt,023,135768,12368,11149,1177,12326,121
2022-01-07,Imperial,025,180216,42287,39429,5730,45159,800
2022-01-07,Inyo,027,18085,3300,3020,71,3091,49
2022-01-07,Kern,029,883053,150602,140410,30160,170570,1921
2022-01-07,Kings,031,150075,37149,35275,2290,37565,390
2022-01-07,Lake,033,64148,7640,7209,281,7490,117
2022-01-07,Lassen,035,31185,7271,7127,460,7587,55
2022-01-07,Los Angeles,037,10098052,2056705,1765787,88136,1853923,27476
2022-01-07,Madera,039,155013,27222,25767,2839,28606,328
2022-01-07,Marin,041,260295,25014,22377,1266,23643,251
2022-01-07,Mariposa,043,17540,1761,1588,69,1657,6
2022-01-07,Mendocino,045,87422,9491,8792,911,9703,101
2022-01-07,Merced,047,269075,48775,46094,2941,49035,703
2022-01-07,Modoc,049,8938,629,610,214,824,6
2022-01-07,Mono,051,14174,2472,2240,61,2301,4
2022-01-07,Monterey,053,433212,57616,51721,5160,56881,644
2022-01-07,Napa,055,140530,18301,15819,402,16221,109
2022-01-07,Nevada,057,99092,11808,10765,471,11236,110
2022-01-07,Orange,059,3164182,429391,375124,29285,404409,5903
2022-01-07,Placer,061,380077,47524,43172,5047,48219,495
2022-01-07,Plumas,063,18699,2182,2053,72,2125,12
2022-01-07,Riverside,065,2383286,465761,422591,20958,443549,5535
2022-01-07,Sacramento,067,1510023,208059,185118,10464,195582,2470
2022-01-07,San Benito,069,59416,9666,9016,257,9273,83
2022-01-07,San Bernardino,071,2135413,460764,411724,16684,428408,6122
2022-01-07,San Diego,073,3302833,551828,472273,33952,506225,4495
2022-01-07,San Francisco,075,870044,88065,73660,4485,78145,690
2022-01-07,San Joaquin,077,732212,123869,112514,6823,119337,1916
2022-01-07,San Luis Obispo,079,281455,38278,34489,2021,36510,369
2022-01-07,San Mateo,081,765935,83969,67918,2851,70769,582
2022-01-07,Santa Barbara,083,443738,60627,54617,2249,56866,575
2022-01-07,Santa Clara,085,1922200,212360,183842,5205,189047,1966
2022-01-07,Santa Cruz,087,273765,28617,24678,1423,26101,230
2022-01-07,Shasta,089,179085,24521,23585,4059,27644,445
2022-01-07,Sierra,091,2930,232,215,25,240,0
2022-01-07,Siskiyou,093,43540,3678,3545,1583,5128,62
2022-01-07,Solano,095,438530,58284,52452,2655,55107,383
2022-01-07,Sonoma,097,501317,57178,50130,1267,51397,411
2022-01-07,Stanislaus,099,539301,91701,87049,10819,97868,1372
2022-01-07,Sutter,101,95872,15991,15261,576,15837,195
2022-01-07,Tehama,103,63373,9575,9109,1755,10864,140
2022-01-07,Trinity,105,12862,951,836,231,1067,19
2022-01-07,Tulare,107,460477,78117,73600,18463,92063,1185
2022-01-07,Tuolumne,109,53932,8945,8360,154,8514,91
2022-01-07,Ventura,111,848112,134267,117229,7099,124328,1216
2022-01-07,Yolo,113,214977,26923,24006,1844,25850,270
2022-01-07,Yuba,115,75493,12018,11277,530,11807,101
2022-01-06,Alameda,001,1643700,169189,148560,6135,154695,1558
2022-01-06,Alpine,003,1148,114,114,0,114,0
2022-01-06,Amador,005,37829,6352,6091,111,6202,71
2022-01-06,Butte,007,227075,24975,23429,4612,28041,347
2022-01-06,Calaveras,009,45235,5132,4823,91,4914,93
2022-01-06,Colusa,011,21464,2772,2713,777,3490,21
2022-01-06,Contra Costa,013,1133247,133880,119907,5295,125202,1077
2022-01-06,Del Norte,015,27424,4011,3902,74,3976,43
2022-01-06,El Dorado,017,186661,20319,18599,2123,20722,172
2022-01-06,Fresno,019,978130,163820,155394,14957,170351,2393
2022-01-06,Glenn,021,27897,3871,3732,1161,4893,39
2022-01-06,Humboldt,023,135768,12141,11149,1136,12285,121
2022-01-06,Imperial,025,180216,41702,39429,5530,44959,800
2022-01-06,Inyo,027,18085,3262,3020,71,3091,49
2022-01-06,Kern,029,883053,148933,140410,29494,169904,1921
2022-01-06,Kings,031,150075,36824,35275,2265,37540,390
2022-01-06,Lake,033,64148,7566,7209,270,7479,117
2022-01-06,Lassen,035,31185,7248,7127,454,7581,55
2022-01-06,Los Angeles,037,10098052,2002556,1765787,85783,1851570,27476
2022-01-06,Madera,039,155013,26917,25767,2781,28548,328
2022-01-06,Marin,041,260295,24611,22377,1233,23610,251
2022-01-06,Mariposa,043,17540,1742,1588,69,1657,6
2022-01-06,Mendocino,045,87422,9394,8792,872,9664,101
2022-01-06,Merced,047,269075,48216,46094,2803,48897,703
2022-01-06,Modoc,049,8938,628,610,214,824,6
2022-01-06,Mono,051,14174,2449,2240,58,2298,4
2022-01-06,Monterey,053,433212,56895,51721,4909,56630,644
2022-01-06,Napa,055,140530,17903,15819,393,16212,109
2022-01-06,Nevada,057,99092,11610,10765,459,11224,110
2022-01-06,Orange,059,3164182,419945,375124,28546,403670,5903
2022-01-06,Placer,061,380077,46786,43172,4959,48131,495
2022-01-06,Plumas,063,18699,2164,2053,64,2117,12
2022-01-06,Riverside,065,2383286,458290,422591,20670,443261,5535
2022-01-06,Sacramento,067,1510023,204006,185118,9728,194846,2470
2022-01-06,San Benito,069,59416,9565,9016,250,9266,83
2022-01-06,San Bernardino,071,2135413,453155,411724,16198,427922,6122
2022-01-06,San Diego,073,3302833,540191,472273,32950,505223,4495
2022-01-06,San Francisco,075,870044,85744,73660,4231,77891,690
2022-01-06,San Joaquin,077,732212,121700,112514,6736,119250,1916
2022-01-06,San Luis Obispo,079,281455,37579,34489,1951,36440,369
2022-01-06,San Mateo,081,765935,81546,67918,2671,70589,582
2022-01-06,Santa Barbara,083,443738,59459,54617,2190,56807,575
2022-01-06,Santa Clara,085,1922200,207477,183842,4819,188661,1966
2022-01-06,Santa Cruz,087,273765,28057,24678,1399,26077,230
2022-01-06,Shasta,089,179085,24374,23585,4009,27594,445
2022-01-06,Sierra,091,2930,229,215,25,240,0
2022-01-06,Siskiyou,093,43540,3662,3545,1537,5082,62
2022-01-06,Solano,095,438530,57272,52452,2470,54922,383
2022-01-06,Sonoma,097,501317,55786,50130,1234,51364,411
2022-01-06,Stanislaus,099,539301,90550,87049,10650,97699,1372
2022-01-06,Sutter,101,95872,15814,15261,548,15809,195
2022-01-06,Tehama,103,63373,9497,9109,1728,10837,140
2022-01-06,Trinity,105,12862,944,836,230,1066,19
2022-01-06,Tulare,107,460477,77413,73600,18295,91895,1185
2022-01-06,Tuolumne,109,53932,8834,8360,148,8508,91
2022-01-06,Ventura,111,848112,131572,117229,6939,124168,1216
2022-01-06,Yolo,113,214977,26364,24006,1800,25806,270
2022-01-06,Yuba,115,75493,11882,11277,513,11790,101
2022-01-05,Alameda,001,1643700,164064,144824,5722,150546,1548
2022-01-05,Alpine,003,1148,114,112,0,112,0
2022-01-05,Amador,005,37829,6309,6012,108,6120,70
2022-01-05,Butte,007,227075,24662,23134,4551,27685,343
2022-01-05,Calaveras,009,45235,5077,4758,89,4847,90
2022-01-05,Colusa,011,21464,2760,2704,766,3470,21
2022-01-05,Contra Costa,013,1133247,130755,117188,4842,122030,1071
2022-01-05,Del Norte,015,27424,3991,3862,72,3934,43
2022-01-05,El Dorado,017,186661,19932,18367,2093,20460,171
2022-01-05,Fresno,019,978130,161808,153033,14689,167722,2377
2022-01-05,Glenn,021,27897,3823,3700,1151,4851,39
2022-01-05,Humboldt,023,135768,11937,10938,1088,12026,120
2022-01-05,Imperial,025,180216,41074,38789,5377,44166,800
2022-01-05,Inyo,027,18085,3180,2939,67,3006,49
2022-01-05,Kern,029,883053,147154,138186,28924,167110,1913
2022-01-05,Kings,031,150075,36481,34893,2246,37139,387
2022-01-05,Lake,033,64148,7483,7129,254,7383,117
2022-01-05,Lassen,035,31185,7228,7077,446,7523,55
2022-01-05,Los Angeles,037,10098052,1946258,1729640,83401,1813041,27443
2022-01-05,Madera,039,155013,26677,25392,2689,28081,327
2022-01-05,Marin,041,260295,24265,21829,1183,23012,251
2022-01-05,Mariposa,043,17540,1716,1564,68,1632,6
2022-01-05,Mendocino,045,87422,9263,8625,837,9462,101
2022-01-05,Merced,047,269075,47635,45721,2669,48390,700
2022-01-05,Modoc,049,8938,625,603,214,817,6
2022-01-05,Mono,051,14174,2430,2201,54,2255,4
2022-01-05,Monterey,053,433212,56071,51241,4710,55951,639
2022-01-05,Napa,055,140530,17540,15494,361,15855,108
2022-01-05,Nevada,057,99092,11414,10624,442,11066,110
2022-01-05,Orange,059,3164182,409906,366139,27497,393636,5869
2022-01-05,Placer,061,380077,45902,42456,4866,47322,492
2022-01-05,Plumas,063,18699,2144,2020,62,2082,12
2022-01-05,Riverside,065,2383286,450840,415253,20319,435572,5502
2022-01-05,Sacramento,067,1510023,199237,181488,8780,190268,2455
2022-01-05,San Benito,069,59416,9371,8829,238,9067,83
2022-01-05,San Bernardino,071,2135413,444502,405323,15648,420971,6085
2022-01-05,San Diego,073,3302833,526604,466602,31968,498570,4495
2022-01-05,San Francisco,075,870044,83169,71405,4093,75498,686
2022-01-05,San Joaquin,077,732212,119169,110497,6656,117153,1903
2022-01-05,San Luis Obispo,079,281455,36782,34066,1874,35940,369
2022-01-05,San Mateo,081,765935,79376,66018,2473,68491,578
2022-01-05,Santa Barbara,083,443738,58154,53082,2111,55193,570
2022-01-05,Santa Clara,085,1922200,201715,178629,4402,183031,1961
2022-01-05,Santa Cruz,087,273765,27301,24394,1378,25772,229
2022-01-05,Shasta,089,179085,24218,23361,3980,27341,441
2022-01-05,Sierra,091,2930,226,210,23,233,0
2022-01-05,Siskiyou,093,43540,3652,3513,1508,5021,60
2022-01-05,Solano,095,438530,56226,51505,2335,53840,380
2022-01-05,Sonoma,097,501317,54523,49120,1077,50197,412
2022-01-05,Stanislaus,099,539301,89563,86248,10479,96727,1360
2022-01-05,Sutter,101,95872,15612,15117,509,15626,193
2022-01-05,Tehama,103,63373,9400,9011,1697,10708,140
2022-01-05,Trinity,105,12862,940,822,228,1050,19
2022-01-05,Tulare,107,460477,76638,72718,18121,90839,1173
2022-01-05,Tuolumne,109,53932,8742,8223,141,8364,90
2022-01-05,Ventura,111,848112,128820,114752,6731,121483,1211
2022-01-05,Yolo,113,214977,25752,23401,1761,25162,269
2022-01-05,Yuba,115,75493,11700,11138,487,11625,100
2022-01-04,Alameda,001,1643700,158520,143360,5315,148675,1532
2022-01-04,Alpine,003,1148,114,113,0,113,0
2022-01-04,Amador,005,37829,6242,6025,102,6127,71
2022-01-04,Butte,007,227075,24361,23094,4481,27575,346
2022-01-04,Calaveras,009,45235,5003,4767,86,4853,93
2022-01-04,Colusa,011,21464,2743,2689,760,3449,21
2022-01-04,Contra Costa,013,1133247,127516,116005,4472,120477,1075
2022-01-04,Del Norte,015,27424,3959,3882,69,3951,43
2022-01-04,El Dorado,017,186661,19574,18339,2073,20412,172
2022-01-04,Fresno,019,978130,159660,153244,14444,167688,2380
2022-01-04,Glenn,021,27897,3793,3705,1136,4841,39
2022-01-04,Humboldt,023,135768,11689,10865,1037,11902,120
2022-01-04,Imperial,025,180216,40472,38596,5116,43712,800
2022-01-04,Inyo,027,18085,3097,2870,66,2936,49
2022-01-04,Kern,029,883053,145227,138245,28343,166588,1916
2022-01-04,Kings,031,150075,36159,34931,2229,37160,388
2022-01-04,Lake,033,64148,7442,7152,245,7397,117
2022-01-04,Lassen,035,31185,7205,7111,442,7553,55
2022-01-04,Los Angeles,037,10098052,1886312,1705253,81062,1786315,27419
2022-01-04,Madera,039,155013,26333,25425,2618,28043,328
2022-01-04,Marin,041,260295,23784,21675,1124,22799,251
2022-01-04,Mariposa,043,17540,1680,1564,67,1631,6
2022-01-04,Mendocino,045,87422,9140,8636,813,9449,101
2022-01-04,Merced,047,269075,47013,45583,2540,48123,700
2022-01-04,Modoc,049,8938,622,611,214,825,6
2022-01-04,Mono,051,14174,2381,2190,44,2234,4
2022-01-04,Monterey,053,433212,55339,51176,4486,55662,643
2022-01-04,Napa,055,140530,17036,15370,331,15701,107
2022-01-04,Nevada,057,99092,11256,10608,429,11037,110
2022-01-04,Orange,059,3164182,399153,362051,26363,388414,5897
2022-01-04,Placer,061,380077,45067,42285,4750,47035,494
2022-01-04,Plumas,063,18699,2118,2014,60,2074,12
2022-01-04,Riverside,065,2383286,442315,413366,19971,433337,5504
2022-01-04,Sacramento,067,1510023,194259,181271,8060,189331,2453
2022-01-04,San Benito,069,59416,9184,8763,230,8993,79
2022-01-04,San Bernardino,071,2135413,435414,404409,15113,419522,6060
2022-01-04,San Diego,073,3302833,510267,458499,31000,489499,4487
2022-01-04,San Francisco,075,870044,80320,70666,3950,74616,688
2022-01-04,San Joaquin,077,732212,116755,110374,6502,116876,1911
2022-01-04,San Luis Obispo,079,281455,35976,33788,1787,35575,371
2022-01-04,San Mateo,081,765935,77067,65157,2286,67443,582
2022-01-04,Santa Barbara,083,443738,56630,52449,2034,54483,574
2022-01-04,Santa Clara,085,1922200,195754,176854,3935,180789,1964
2022-01-04,Santa Cruz,087,273765,26538,23904,1343,25247,228
2022-01-04,Shasta,089,179085,24073,23366,3926,27292,442
2022-01-04,Sierra,091,2930,225,214,22,236,0
2022-01-04,Siskiyou,093,43540,3636,3509,1489,4998,61
2022-01-04,Solano,095,438530,54922,51300,2137,53437,383
2022-01-04,Sonoma,097,501317,52816,48653,957,49610,410
2022-01-04,Stanislaus,099,539301,88502,86107,10310,96417,1361
2022-01-04,Sutter,101,95872,15459,15032,485,15517,193
2022-01-04,Tehama,103,63373,9322,9020,1675,10695,140
2022-01-04,Trinity,105,12862,935,833,224,1057,18
2022-01-04,Tulare,107,460477,75848,72893,17921,90814,1172
2022-01-04,Tuolumne,109,53932,8630,8235,136,8371,91
2022-01-04,Ventura,111,848112,125754,114079,6501,120580,1213
2022-01-04,Yolo,113,214977,25101,22938,1717,24655,270
2022-01-04,Yuba,115,75493,11520,11104,471,11575,101
2022-01-03,Alameda,001,1643700,152560,142090,4880,146970,1529
2022-01-03,Alpine,003,1148,113,113,0,113,0
2022-01-03,Amador,005,37829,6180,6004,97,6101,71
2022-01-03,Butte,007,227075,24064,22924,4425,27349,345
2022-01-03,Calaveras,009,45235,4941,4742,80,4822,93
2022-01-03,Colusa,011,21464,2733,2683,753,3436,21
2022-01-03,Contra Costa,013,1133247,124141,114966,3887,118853,1073
2022-01-03,Del Norte,015,27424,3939,3873,65,3938,43
2022-01-03,El Dorado,017,186661,19181,18183,2045,20228,172
2022-01-03,Fresno,019,978130,157687,152674,14246,166920,2379
2022-01-03,Glenn,021,27897,3764,3703,1101,4804,39
2022-01-03,Humboldt,023,135768,11479,10784,989,11773,119
2022-01-03,Imperial,025,180216,39841,38411,4940,43351,800
2022-01-03,Inyo,027,18085,3028,2845,62,2907,49
2022-01-03,Kern,029,883053,143232,137773,27748,165521,1916
2022-01-03,Kings,031,150075,35836,34817,2200,37017,387
2022-01-03,Lake,033,64148,7340,7134,227,7361,117
2022-01-03,Lassen,035,31185,7187,7103,439,7542,55
2022-01-03,Los Angeles,037,10098052,1825512,1686203,78310,1764513,27394
2022-01-03,Madera,039,155013,26040,25323,2574,27897,320
2022-01-03,Marin,041,260295,23191,21532,1085,22617,251
2022-01-03,Mariposa,043,17540,1638,1559,67,1626,6
2022-01-03,Mendocino,045,87422,8992,8573,763,9336,101
2022-01-03,Merced,047,269075,46411,45459,2428,47887,696
2022-01-03,Modoc,049,8938,619,602,214,816,6
2022-01-03,Mono,051,14174,2303,2172,39,2211,4
2022-01-03,Monterey,053,433212,54512,51047,4279,55326,644
2022-01-03,Napa,055,140530,16527,15260,299,15559,107
2022-01-03,Nevada,057,99092,11091,10572,420,10992,110
2022-01-03,Orange,059,3164182,387983,358052,25182,383234,5894
2022-01-03,Placer,061,380077,44243,42054,4689,46743,489
2022-01-03,Plumas,063,18699,2098,2005,60,2065,12
2022-01-03,Riverside,065,2383286,433843,410155,19477,429632,5504
2022-01-03,Sacramento,067,1510023,189104,179992,7508,187500,2452
2022-01-03,San Benito,069,59416,9022,8688,223,8911,79
2022-01-03,San Bernardino,071,2135413,426588,401938,14647,416585,6056
2022-01-03,San Diego,073,3302833,494174,451154,30038,481192,4476
2022-01-03,San Francisco,075,870044,77514,69315,3698,73013,686
2022-01-03,San Joaquin,077,732212,114439,109757,6376,116133,1903
2022-01-03,San Luis Obispo,079,281455,35166,33667,1694,35361,367
2022-01-03,San Mateo,081,765935,74351,64470,2129,66599,582
2022-01-03,Santa Barbara,083,443738,55169,51912,1941,53853,571
2022-01-03,Santa Clara,085,1922200,189817,174215,3462,177677,1963
2022-01-03,Santa Cruz,087,273765,25730,23765,1312,25077,228
2022-01-03,Shasta,089,179085,23896,23301,3899,27200,440
2022-01-03,Sierra,091,2930,218,213,21,234,0
2022-01-03,Siskiyou,093,43540,3610,3500,1467,4967,61
2022-01-03,Solano,095,438530,53624,51030,1951,52981,380
2022-01-03,Sonoma,097,501317,51119,48391,861,49252,410
2022-01-03,Stanislaus,099,539301,87509,85793,10126,95919,1332
2022-01-03,Sutter,101,95872,15303,14973,465,15438,193
2022-01-03,Tehama,103,63373,9247,9005,1649,10654,140
2022-01-03,Trinity,105,12862,930,833,223,1056,18
2022-01-03,Tulare,107,460477,75152,72664,17718,90382,1167
2022-01-03,Tuolumne,109,53932,8494,8179,132,8311,91
2022-01-03,Ventura,111,848112,122582,112762,6262,119024,1211
2022-01-03,Yolo,113,214977,24418,22563,1654,24217,270
2022-01-03,Yuba,115,75493,11387,11037,452,11489,99
2022-01-02,Alameda,001,1643700,148128,133486,4397,137883,1528
2022-01-02,Alpine,003,1148,111,113,0,113,0
2022-01-02,Amador,005,37829,6112,5913,92,6005,70
2022-01-02,Butte,007,227075,23724,22469,4363,26832,341
2022-01-02,Calaveras,009,45235,4871,4668,72,4740,93
2022-01-02,Colusa,011,21464,2727,2659,742,3401,21
2022-01-02,Contra Costa,013,1133247,120569,109593,3451,113044,1073
2022-01-02,Del Norte,015,27424,3907,3841,63,3904,43
2022-01-02,El Dorado,017,186661,18846,17621,1994,19615,172
2022-01-02,Fresno,019,978130,155970,149927,14024,163951,2379
2022-01-02,Glenn,021,27897,3745,3663,1092,4755,39
2022-01-02,Humboldt,023,135768,11237,10381,914,11295,119
2022-01-02,Imperial,025,180216,39185,37672,4731,42403,800
2022-01-02,Inyo,027,18085,2958,2726,51,2777,49
2022-01-02,Kern,029,883053,141314,136123,27156,163279,1917
2022-01-02,Kings,031,150075,35512,34318,2166,36484,386
2022-01-02,Lake,033,64148,7269,7060,213,7273,117
2022-01-02,Lassen,035,31185,7171,7089,437,7526,55
2022-01-02,Los Angeles,037,10098052,1774340,1596123,75442,1671565,27371
2022-01-02,Madera,039,155013,25788,25002,2521,27523,320
2022-01-02,Marin,041,260295,22627,20475,1014,21489,249
2022-01-02,Mariposa,043,17540,1607,1509,65,1574,6
2022-01-02,Mendocino,045,87422,8868,8422,745,9167,101
2022-01-02,Merced,047,269075,45870,44769,2328,47097,694
2022-01-02,Modoc,049,8938,617,601,213,814,6
2022-01-02,Mono,051,14174,2274,2101,34,2135,4
2022-01-02,Monterey,053,433212,53886,50251,4069,54320,643
2022-01-02,Napa,055,140530,15986,14439,288,14727,107
2022-01-02,Nevada,057,99092,10903,10299,405,10704,110
2022-01-02,Orange,059,3164182,376969,339526,24033,363559,5890
2022-01-02,Placer,061,380077,43517,40857,4602,45459,489
2022-01-02,Plumas,063,18699,2083,1994,56,2050,12
2022-01-02,Riverside,065,2383286,425506,397124,18961,416085,5501
2022-01-02,Sacramento,067,1510023,185037,173562,6676,180238,2448
2022-01-02,San Benito,069,59416,8842,8320,208,8528,79
2022-01-02,San Bernardino,071,2135413,418542,386278,14093,400371,6051
2022-01-02,San Diego,073,3302833,479153,427087,28856,455943,4469
2022-01-02,San Francisco,075,870044,74573,64498,3458,67956,682
2022-01-02,San Joaquin,077,732212,112563,106640,6232,112872,1902
2022-01-02,San Luis Obispo,079,281455,34431,32342,1611,33953,365
2022-01-02,San Mateo,081,765935,71784,60504,1889,62393,581
2022-01-02,Santa Barbara,083,443738,53735,49555,1880,51435,568
2022-01-02,Santa Clara,085,1922200,183671,164547,3062,167609,1969
2022-01-02,Santa Cruz,087,273765,25062,22980,1279,24259,228
2022-01-02,Shasta,089,179085,23704,23161,3850,27011,435
2022-01-02,Sierra,091,2930,217,206,21,227,0
2022-01-02,Siskiyou,093,43540,3585,3474,1444,4918,61
2022-01-02,Solano,095,438530,52681,48957,1787,50744,379
2022-01-02,Sonoma,097,501317,49800,46040,824,46864,410
2022-01-02,Stanislaus,099,539301,86654,84367,9989,94356,1332
2022-01-02,Sutter,101,95872,15130,14741,446,15187,193
2022-01-02,Tehama,103,63373,9184,8944,1626,10570,139
2022-01-02,Trinity,105,12862,928,832,222,1054,17
2022-01-02,Tulare,107,460477,74492,71941,17528,89469,1160
2022-01-02,Tuolumne,109,53932,8387,8044,127,8171,91
2022-01-02,Ventura,111,848112,119658,107992,6042,114034,1211
2022-01-02,Yolo,113,214977,23739,21747,1588,23335,270
2022-01-02,Yuba,115,75493,11263,10844,436,11280,99
2022-01-01,Alameda,001,1643700,146305,133486,4145,137631,1528
2022-01-01,Alpine,003,1148,111,113,0,113,0
2022-01-01,Amador,005,37829,6076,5913,87,6000,70
2022-01-01,Butte,007,227075,23529,22469,4325,26794,341
2022-01-01,Calaveras,009,45235,4832,4668,70,4738,93
2022-01-01,Colusa,011,21464,2723,2659,732,3391,21
2022-01-01,Contra Costa,013,1133247,119202,109593,3326,112919,1073
2022-01-01,Del Norte,015,27424,3902,3841,63,3904,43
2022-01-01,El Dorado,017,186661,18698,17621,1979,19600,172
2022-01-01,Fresno,019,978130,155299,149927,13945,163872,2379
2022-01-01,Glenn,021,27897,3738,3663,1092,4755,39
2022-01-01,Humboldt,023,135768,11098,10381,893,11274,119
2022-01-01,Imperial,025,180216,39037,37672,4683,42355,800
2022-01-01,Inyo,027,18085,2929,2726,49,2775,49
2022-01-01,Kern,029,883053,140614,136123,26851,162974,1917
2022-01-01,Kings,031,150075,35370,34318,2139,36457,386
2022-01-01,Lake,033,64148,7231,7060,208,7268,117
2022-01-01,Lassen,035,31185,7165,7089,432,7521,55
2022-01-01,Los Angeles,037,10098052,1754213,1596123,73496,1669619,27371
2022-01-01,Madera,039,155013,25704,25002,2507,27509,320
2022-01-01,Marin,041,260295,22315,20475,973,21448,249
2022-01-01,Mariposa,043,17540,1596,1509,65,1574,6
2022-01-01,Mendocino,045,87422,8776,8422,739,9161,101
2022-01-01,Merced,047,269075,45737,44769,2315,47084,694
2022-01-01,Modoc,049,8938,614,601,213,814,6
2022-01-01,Mono,051,14174,2250,2101,29,2130,4
2022-01-01,Monterey,053,433212,53577,50251,3982,54233,643
2022-01-01,Napa,055,140530,15836,14439,273,14712,107
2022-01-01,Nevada,057,99092,10828,10299,398,10697,110
2022-01-01,Orange,059,3164182,372749,339526,23325,362851,5890
2022-01-01,Placer,061,380077,43214,40857,4536,45393,489
2022-01-01,Plumas,063,18699,2071,1994,56,2050,12
2022-01-01,Riverside,065,2383286,422014,397124,18760,415884,5501
2022-01-01,Sacramento,067,1510023,183763,173562,6420,179982,2448
2022-01-01,San Benito,069,59416,8752,8320,208,8528,79
2022-01-01,San Bernardino,071,2135413,415299,386278,13814,400092,6051
2022-01-01,San Diego,073,3302833,473207,427087,28337,455424,4469
2022-01-01,San Francisco,075,870044,73173,64498,3247,67745,682
2022-01-01,San Joaquin,077,732212,111858,106640,6159,112799,1902
2022-01-01,San Luis Obispo,079,281455,34228,32342,1602,33944,365
2022-01-01,San Mateo,081,765935,70319,60504,1740,62244,581
2022-01-01,Santa Barbara,083,443738,52995,49555,1845,51400,568
2022-01-01,Santa Clara,085,1922200,180637,164547,2866,167413,1969
2022-01-01,Santa Cruz,087,273765,24741,22980,1261,24241,228
2022-01-01,Shasta,089,179085,23620,23161,3832,26993,435
2022-01-01,Sierra,091,2930,216,206,21,227,0
2022-01-01,Siskiyou,093,43540,3582,3474,1434,4908,61
2022-01-01,Solano,095,438530,52414,48957,1728,50685,379
2022-01-01,Sonoma,097,501317,49406,46040,794,46834,410
2022-01-01,Stanislaus,099,539301,86247,84367,9904,94271,1332
2022-01-01,Sutter,101,95872,15053,14741,444,15185,193
2022-01-01,Tehama,103,63373,9152,8944,1614,10558,139
2022-01-01,Trinity,105,12862,925,832,222,1054,17
2022-01-01,Tulare,107,460477,74247,71941,17429,89370,1160
2022-01-01,Tuolumne,109,53932,8327,8044,124,8168,91
2022-01-01,Ventura,111,848112,118271,107992,5913,113905,1211
2022-01-01,Yolo,113,214977,23318,21747,1548,23295,270
2022-01-01,Yuba,115,75493,11197,10844,430,11274,99
2021-12-31,Alameda,001,1643700,145543,133486,4050,137536,1528
2021-12-31,Alpine,003,1148,111,113,0,113,0
2021-12-31,Amador,005,37829,6052,5913,86,5999,70
2021-12-31,Butte,007,227075,23423,22469,4290,26759,341
2021-12-31,Calaveras,009,45235,4799,4668,70,4738,93
2021-12-31,Colusa,011,21464,2714,2659,726,3385,21
2021-12-31,Contra Costa,013,1133247,118312,109593,3247,112840,1073
2021-12-31,Del Norte,015,27424,3893,3841,61,3902,43
2021-12-31,El Dorado,017,186661,18616,17621,1961,19582,172
2021-12-31,Fresno,019,978130,154991,149927,13923,163850,2379
2021-12-31,Glenn,021,27897,3737,3663,1090,4753,39
2021-12-31,Humboldt,023,135768,11011,10381,874,11255,119
2021-12-31,Imperial,025,180216,38905,37672,4667,42339,800
2021-12-31,Inyo,027,18085,2902,2726,48,2774,49
2021-12-31,Kern,029,883053,140107,136123,26714,162837,1917
2021-12-31,Kings,031,150075,35260,34318,2129,36447,386
2021-12-31,Lake,033,64148,7208,7060,203,7263,117
2021-12-31,Lassen,035,31185,7151,7089,432,7521,55
2021-12-31,Los Angeles,037,10098052,1743441,1596123,72745,1668868,27371
2021-12-31,Madera,039,155013,25635,25002,2490,27492,320
2021-12-31,Marin,041,260295,22159,20475,942,21417,249
2021-12-31,Mariposa,043,17540,1589,1509,64,1573,6
2021-12-31,Mendocino,045,87422,8743,8422,736,9158,101
2021-12-31,Merced,047,269075,45653,44769,2297,47066,694
2021-12-31,Modoc,049,8938,610,601,211,812,6
2021-12-31,Mono,051,14174,2238,2101,28,2129,4
2021-12-31,Monterey,053,433212,53450,50251,3916,54167,643
2021-12-31,Napa,055,140530,15724,14439,263,14702,107
2021-12-31,Nevada,057,99092,10761,10299,392,10691,110
2021-12-31,Orange,059,3164182,370238,339526,22903,362429,5890
2021-12-31,Placer,061,380077,42981,40857,4470,45327,489
2021-12-31,Plumas,063,18699,2066,1994,56,2050,12
2021-12-31,Riverside,065,2383286,420327,397124,18605,415729,5501
2021-12-31,Sacramento,067,1510023,182899,173562,6314,179876,2448
2021-12-31,San Benito,069,59416,8738,8320,207,8527,79
2021-12-31,San Bernardino,071,2135413,413004,386278,13625,399903,6051
2021-12-31,San Diego,073,3302833,469989,427087,28019,455106,4469
2021-12-31,San Francisco,075,870044,72249,64498,3190,67688,682
2021-12-31,San Joaquin,077,732212,111231,106640,6093,112733,1902
2021-12-31,San Luis Obispo,079,281455,34120,32342,1590,33932,365
2021-12-31,San Mateo,081,765935,69441,60504,1688,62192,581
2021-12-31,Santa Barbara,083,443738,52596,49555,1833,51388,568
2021-12-31,Santa Clara,085,1922200,178683,164547,2727,167274,1969
2021-12-31,Santa Cruz,087,273765,24503,22980,1240,24220,228
2021-12-31,Shasta,089,179085,23557,23161,3811,26972,435
2021-12-31,Sierra,091,2930,216,206,21,227,0
2021-12-31,Siskiyou,093,43540,3575,3474,1423,4897,61
2021-12-31,Solano,095,438530,52256,48957,1702,50659,379
2021-12-31,Sonoma,097,501317,49153,46040,781,46821,410
2021-12-31,Stanislaus,099,539301,85919,84367,9844,94211,1332
2021-12-31,Sutter,101,95872,14992,14741,438,15179,193
2021-12-31,Tehama,103,63373,9120,8944,1605,10549,139
2021-12-31,Trinity,105,12862,924,832,222,1054,17
2021-12-31,Tulare,107,460477,74042,71941,17345,89286,1160
2021-12-31,Tuolumne,109,53932,8283,8044,123,8167,91
2021-12-31,Ventura,111,848112,117297,107992,5831,113823,1211
2021-12-31,Yolo,113,214977,23097,21747,1526,23273,270
2021-12-31,Yuba,115,75493,11140,10844,424,11268,99
2021-12-30,Alameda,001,1643700,144272,133486,3918,137404,1528
2021-12-30,Alpine,003,1148,110,113,0,113,0
2021-12-30,Amador,005,37829,6033,5913,85,5998,70
2021-12-30,Butte,007,227075,23291,22469,4265,26734,341
2021-12-30,Calaveras,009,45235,4780,4668,70,4738,93
2021-12-30,Colusa,011,21464,2713,2659,724,3383,21
2021-12-30,Contra Costa,013,1133247,117219,109593,3137,112730,1073
2021-12-30,Del Norte,015,27424,3882,3841,60,3901,43
2021-12-30,El Dorado,017,186661,18511,17621,1940,19561,172
2021-12-30,Fresno,019,978130,154461,149927,13853,163780,2379
2021-12-30,Glenn,021,27897,3732,3663,1087,4750,39
2021-12-30,Humboldt,023,135768,10944,10381,862,11243,119
2021-12-30,Imperial,025,180216,38737,37672,4557,42229,800
2021-12-30,Inyo,027,18085,2883,2726,46,2772,49
2021-12-30,Kern,029,883053,139573,136123,26414,162537,1917
2021-12-30,Kings,031,150075,35142,34318,2114,36432,386
2021-12-30,Lake,033,64148,7193,7060,198,7258,117
2021-12-30,Lassen,035,31185,7145,7089,432,7521,55
2021-12-30,Los Angeles,037,10098052,1720130,1596123,71491,1667614,27371
2021-12-30,Madera,039,155013,25558,25002,2470,27472,320
2021-12-30,Marin,041,260295,21985,20475,918,21393,249
2021-12-30,Mariposa,043,17540,1583,1509,64,1573,6
2021-12-30,Mendocino,045,87422,8726,8422,725,9147,101
2021-12-30,Merced,047,269075,45551,44769,2282,47051,694
2021-12-30,Modoc,049,8938,609,601,211,812,6
2021-12-30,Mono,051,14174,2233,2101,27,2128,4
2021-12-30,Monterey,053,433212,53138,50251,3856,54107,643
2021-12-30,Napa,055,140530,15580,14439,254,14693,107
2021-12-30,Nevada,057,99092,10697,10299,383,10682,110
2021-12-30,Orange,059,3164182,365148,339526,22352,361878,5890
2021-12-30,Placer,061,380077,42705,40857,4423,45280,489
2021-12-30,Plumas,063,18699,2062,1994,55,2049,12
2021-12-30,Riverside,065,2383286,417059,397124,18453,415577,5501
2021-12-30,Sacramento,067,1510023,181643,173562,6169,179731,2448
2021-12-30,San Benito,069,59416,8693,8320,205,8525,79
2021-12-30,San Bernardino,071,2135413,410411,386278,13479,399757,6051
2021-12-30,San Diego,073,3302833,464846,427087,27507,454594,4469
2021-12-30,San Francisco,075,870044,71161,64498,3118,67616,682
2021-12-30,San Joaquin,077,732212,110636,106640,6049,112689,1902
2021-12-30,San Luis Obispo,079,281455,34001,32342,1577,33919,365
2021-12-30,San Mateo,081,765935,68399,60504,1559,62063,581
2021-12-30,Santa Barbara,083,443738,52118,49555,1814,51369,568
2021-12-30,Santa Clara,085,1922200,176405,164547,2603,167150,1969
2021-12-30,Santa Cruz,087,273765,24264,22980,1206,24186,228
2021-12-30,Shasta,089,179085,23504,23161,3805,26966,435
2021-12-30,Sierra,091,2930,216,206,21,227,0
2021-12-30,Siskiyou,093,43540,3566,3474,1421,4895,61
2021-12-30,Solano,095,438530,51907,48957,1655,50612,379
2021-12-30,Sonoma,097,501317,48818,46040,772,46812,410
2021-12-30,Stanislaus,099,539301,85605,84367,9788,94155,1332
2021-12-30,Sutter,101,95872,14930,14741,437,15178,193
2021-12-30,Tehama,103,63373,9093,8944,1599,10543,139
2021-12-30,Trinity,105,12862,921,832,222,1054,17
2021-12-30,Tulare,107,460477,73856,71941,17268,89209,1160
2021-12-30,Tuolumne,109,53932,8244,8044,123,8167,91
2021-12-30,Ventura,111,848112,116038,107992,5728,113720,1211
2021-12-30,Yolo,113,214977,22958,21747,1500,23247,270
2021-12-30,Yuba,115,75493,11093,10844,422,11266,99
2021-12-29,Alameda,001,1643700,141089,131586,3767,135353,1529
2021-12-29,Alpine,003,1148,110,113,0,113,0
2021-12-29,Amador,005,37829,6010,5905,82,5987,70
2021-12-29,Butte,007,227075,23149,22353,4227,26580,338
2021-12-29,Calaveras,009,45235,4752,4646,68,4714,93
2021-12-29,Colusa,011,21464,2703,2657,719,3376,21
2021-12-29,Contra Costa,013,1133247,115128,108165,3014,111179,1072
2021-12-29,Del Norte,015,27424,3868,3826,58,3884,43
2021-12-29,El Dorado,017,186661,18288,17489,1922,19411,172
2021-12-29,Fresno,019,978130,153334,149318,13741,163059,2364
2021-12-29,Glenn,021,27897,3722,3653,1084,4737,39
2021-12-29,Humboldt,023,135768,10834,10249,840,11089,119
2021-12-29,Imperial,025,180216,38501,37460,4490,41950,800
2021-12-29,Inyo,027,18085,2850,2703,46,2749,49
2021-12-29,Kern,029,883053,138770,135648,26028,161676,1913
2021-12-29,Kings,031,150075,35027,34216,2108,36324,386
2021-12-29,Lake,033,64148,7162,7048,196,7244,117
2021-12-29,Lassen,035,31185,7141,7085,431,7516,55
2021-12-29,Los Angeles,037,10098052,1690136,1576414,69778,1646192,27349
2021-12-29,Madera,039,155013,25454,24923,2459,27382,320
2021-12-29,Marin,041,260295,21629,20025,897,20922,249
2021-12-29,Mariposa,043,17540,1561,1507,64,1571,6
2021-12-29,Mendocino,045,87422,8667,8386,721,9107,99
2021-12-29,Merced,047,269075,45335,44548,2267,46815,693
2021-12-29,Modoc,049,8938,606,600,211,811,6
2021-12-29,Mono,051,14174,2209,2056,26,2082,4
2021-12-29,Monterey,053,433212,52729,50097,3751,53848,641
2021-12-29,Napa,055,140530,15256,14247,235,14482,107
2021-12-29,Nevada,057,99092,10606,10274,382,10656,110
2021-12-29,Orange,059,3164182,357617,334557,21676,356233,5887
2021-12-29,Placer,061,380077,42218,40545,4348,44893,489
2021-12-29,Plumas,063,18699,2050,1990,55,2045,12
2021-12-29,Riverside,065,2383286,411637,392989,18246,411235,5486
2021-12-29,Sacramento,067,1510023,179315,172145,6011,178156,2437
2021-12-29,San Benito,069,59416,8550,8239,204,8443,79
2021-12-29,San Bernardino,071,2135413,404873,382872,13265,396137,6049
2021-12-29,San Diego,073,3302833,454013,421045,26785,447830,4461
2021-12-29,San Francisco,075,870044,69465,63117,3048,66165,684
2021-12-29,San Joaquin,077,732212,109453,106063,5978,112041,1891
2021-12-29,San Luis Obispo,079,281455,33606,31936,1528,33464,365
2021-12-29,San Mateo,081,765935,66772,59478,1451,60929,581
2021-12-29,Santa Barbara,083,443738,51278,49003,1789,50792,568
2021-12-29,Santa Clara,085,1922200,173256,162008,2472,164480,1962
2021-12-29,Santa Cruz,087,273765,23985,22669,1174,23843,228
2021-12-29,Shasta,089,179085,23429,23083,3793,26876,435
2021-12-29,Sierra,091,2930,215,206,21,227,0
2021-12-29,Siskiyou,093,43540,3554,3472,1410,4882,61
2021-12-29,Solano,095,438530,51202,48562,1602,50164,379
2021-12-29,Sonoma,097,501317,48016,45479,750,46229,410
2021-12-29,Stanislaus,099,539301,85123,84083,9732,93815,1332
2021-12-29,Sutter,101,95872,14861,14688,435,15123,193
2021-12-29,Tehama,103,63373,9068,8914,1586,10500,138
2021-12-29,Trinity,105,12862,919,832,222,1054,17
2021-12-29,Tulare,107,460477,73565,71752,17151,88903,1160
2021-12-29,Tuolumne,109,53932,8191,8012,122,8134,91
2021-12-29,Ventura,111,848112,114096,106974,5550,112524,1207
2021-12-29,Yolo,113,214977,22719,21564,1469,23033,270
2021-12-29,Yuba,115,75493,11032,10808,418,11226,99
2021-12-28,Alameda,001,1643700,137971,130427,3613,134040,1522
2021-12-28,Alpine,003,1148,110,113,0,113,0
2021-12-28,Amador,005,37829,5990,5900,81,5981,70
2021-12-28,Butte,007,227075,23005,22285,4210,26495,338
2021-12-28,Calaveras,009,45235,4734,4641,67,4708,91
2021-12-28,Colusa,011,21464,2697,2653,717,3370,21
2021-12-28,Contra Costa,013,1133247,112827,107160,2900,110060,1072
2021-12-28,Del Norte,015,27424,3862,3815,58,3873,43
2021-12-28,El Dorado,017,186661,18064,17419,1912,19331,172
2021-12-28,Fresno,019,978130,152254,148987,13660,162647,2365
2021-12-28,Glenn,021,27897,3696,3639,1080,4719,39
2021-12-28,Humboldt,023,135768,10713,10198,816,11014,119
2021-12-28,Imperial,025,180216,38205,37223,4389,41612,800
2021-12-28,Inyo,027,18085,2792,2676,45,2721,48
2021-12-28,Kern,029,883053,138049,135346,25678,161024,1909
2021-12-28,Kings,031,150075,34891,34165,2093,36258,386
2021-12-28,Lake,033,64148,7143,7044,191,7235,116
2021-12-28,Lassen,035,31185,7132,7083,431,7514,55
2021-12-28,Los Angeles,037,10098052,1657896,1561791,68129,1629920,27323
2021-12-28,Madera,039,155013,25328,24865,2439,27304,320
2021-12-28,Marin,041,260295,21217,19739,867,20606,249
2021-12-28,Mariposa,043,17540,1550,1499,63,1562,6
2021-12-28,Mendocino,045,87422,8607,8366,713,9079,98
2021-12-28,Merced,047,269075,45095,44434,2255,46689,691
2021-12-28,Modoc,049,8938,606,599,210,809,6
2021-12-28,Mono,051,14174,2186,2045,24,2069,4
2021-12-28,Monterey,053,433212,52354,49973,3678,53651,639
2021-12-28,Napa,055,140530,14939,14131,208,14339,107
2021-12-28,Nevada,057,99092,10515,10250,379,10629,110
2021-12-28,Orange,059,3164182,349953,331279,20940,352219,5882
2021-12-28,Placer,061,380077,41749,40410,4278,44688,489
2021-12-28,Plumas,063,18699,2047,1989,55,2044,12
2021-12-28,Riverside,065,2383286,406398,390343,18003,408346,5470
2021-12-28,Sacramento,067,1510023,177033,171290,5882,177172,2426
2021-12-28,San Benito,069,59416,8407,8170,202,8372,79
2021-12-28,San Bernardino,071,2135413,399042,381316,13046,394362,6047
2021-12-28,San Diego,073,3302833,443320,417383,26229,443612,4450
2021-12-28,San Francisco,075,870044,67843,61745,2990,64735,682
2021-12-28,San Joaquin,077,732212,108400,105572,5934,111506,1884
2021-12-28,San Luis Obispo,079,281455,33140,31759,1512,33271,365
2021-12-28,San Mateo,081,765935,65260,58712,1363,60075,582
2021-12-28,Santa Barbara,083,443738,50633,48493,1769,50262,568
2021-12-28,Santa Clara,085,1922200,170119,160811,2377,163188,1962
2021-12-28,Santa Cruz,087,273765,23612,22513,1135,23648,228
2021-12-28,Shasta,089,179085,23359,23035,3788,26823,434
2021-12-28,Sierra,091,2930,212,206,21,227,0
2021-12-28,Siskiyou,093,43540,3545,3468,1405,4873,60
2021-12-28,Solano,095,438530,50287,48318,1548,49866,378
2021-12-28,Sonoma,097,501317,47158,45086,725,45811,410
2021-12-28,Stanislaus,099,539301,84643,83946,9672,93618,1331
2021-12-28,Sutter,101,95872,14812,14662,432,15094,193
2021-12-28,Tehama,103,63373,9051,8893,1584,10477,138
2021-12-28,Trinity,105,12862,917,831,221,1052,17
2021-12-28,Tulare,107,460477,73285,71630,17034,88664,1156
2021-12-28,Tuolumne,109,53932,8149,8006,122,8128,91
2021-12-28,Ventura,111,848112,111986,105883,5420,111303,1207
2021-12-28,Yolo,113,214977,22384,21320,1420,22740,270
2021-12-28,Yuba,115,75493,10976,10778,415,11193,99
2021-12-27,Alameda,001,1643700,135361,129910,3482,133392,1530
2021-12-27,Alpine,003,1148,110,113,0,113,0
2021-12-27,Amador,005,37829,5962,5891,81,5972,70
2021-12-27,Butte,007,227075,22867,22234,4183,26417,335
2021-12-27,Calaveras,009,45235,4708,4630,66,4696,91
2021-12-27,Colusa,011,21464,2686,2652,711,3363,21
2021-12-27,Contra Costa,013,1133247,110664,106692,2819,109511,1071
2021-12-27,Del Norte,015,27424,3853,3802,57,3859,43
2021-12-27,El Dorado,017,186661,17905,17361,1900,19261,172
2021-12-27,Fresno,019,978130,151297,148826,13579,162405,2364
2021-12-27,Glenn,021,27897,3688,3634,1074,4708,39
2021-12-27,Humboldt,023,135768,10599,10164,794,10958,119
2021-12-27,Imperial,025,180216,37964,37180,4295,41475,800
2021-12-27,Inyo,027,18085,2763,2662,43,2705,48
2021-12-27,Kern,029,883053,137398,135119,25376,160495,1907
2021-12-27,Kings,031,150075,34742,34126,2080,36206,382
2021-12-27,Lake,033,64148,7120,7037,181,7218,116
2021-12-27,Lassen,035,31185,7126,7080,431,7511,55
2021-12-27,Los Angeles,037,10098052,1621564,1554074,66385,1620459,27300
2021-12-27,Madera,039,155013,25208,24840,2420,27260,320
2021-12-27,Marin,041,260295,20829,19601,840,20441,249
2021-12-27,Mariposa,043,17540,1535,1495,63,1558,6
2021-12-27,Mendocino,045,87422,8540,8351,708,9059,98
2021-12-27,Merced,047,269075,44865,44383,2237,46620,690
2021-12-27,Modoc,049,8938,604,599,210,809,6
2021-12-27,Mono,051,14174,2123,2026,24,2050,4
2021-12-27,Monterey,053,433212,52053,49918,3627,53545,639
2021-12-27,Napa,055,140530,14669,14083,199,14282,107
2021-12-27,Nevada,057,99092,10446,10239,371,10610,110
2021-12-27,Orange,059,3164182,342476,329222,20138,349360,5875
2021-12-27,Placer,061,380077,41372,40263,4230,44493,489
2021-12-27,Plumas,063,18699,2045,1988,53,2041,12
2021-12-27,Riverside,065,2383286,401813,389096,17747,406843,5470
2021-12-27,Sacramento,067,1510023,175008,170858,5713,176571,2422
2021-12-27,San Benito,069,59416,8289,8133,198,8331,79
2021-12-27,San Bernardino,071,2135413,393113,380526,12848,393374,6047
2021-12-27,San Diego,073,3302833,433112,414968,25735,440703,4445
2021-12-27,San Francisco,075,870044,66098,60920,2925,63845,682
2021-12-27,San Joaquin,077,732212,107481,105413,5870,111283,1876
2021-12-27,San Luis Obispo,079,281455,32695,31671,1491,33162,365
2021-12-27,San Mateo,081,765935,63735,58397,1264,59661,581
2021-12-27,Santa Barbara,083,443738,49847,48209,1749,49958,568
2021-12-27,Santa Clara,085,1922200,167150,159904,2252,162156,1961
2021-12-27,Santa Cruz,087,273765,23322,22456,1117,23573,228
2021-12-27,Shasta,089,179085,23297,23015,3777,26792,432
2021-12-27,Sierra,091,2930,212,206,21,227,0
2021-12-27,Siskiyou,093,43540,3536,3466,1400,4866,60
2021-12-27,Solano,095,438530,49554,48172,1500,49672,378
2021-12-27,Sonoma,097,501317,46582,44990,707,45697,410
2021-12-27,Stanislaus,099,539301,84193,83833,9631,93464,1331
2021-12-27,Sutter,101,95872,14756,14642,427,15069,191
2021-12-27,Tehama,103,63373,9036,8887,1577,10464,136
2021-12-27,Trinity,105,12862,917,827,221,1048,17
2021-12-27,Tulare,107,460477,73021,71562,16939,88501,1146
2021-12-27,Tuolumne,109,53932,8111,7978,121,8099,91
2021-12-27,Ventura,111,848112,109899,105212,5285,110497,1206
2021-12-27,Yolo,113,214977,22092,21300,1386,22686,270
2021-12-27,Yuba,115,75493,10915,10759,414,11173,98
2021-12-26,Alameda,001,1643700,133275,127221,3410,130631,1525
2021-12-26,Alpine,003,1148,110,113,0,113,0
2021-12-26,Amador,005,37829,5946,5861,79,5940,70
2021-12-26,Butte,007,227075,22711,22087,4153,26240,330
2021-12-26,Calaveras,009,45235,4686,4591,66,4657,91
2021-12-26,Colusa,011,21464,2675,2647,705,3352,21
2021-12-26,Contra Costa,013,1133247,108903,105022,2720,107742,1071
2021-12-26,Del Norte,015,27424,3848,3795,57,3852,43
2021-12-26,El Dorado,017,186661,17750,17188,1892,19080,172
2021-12-26,Fresno,019,978130,150595,148027,13500,161527,2358
2021-12-26,Glenn,021,27897,3679,3611,1060,4671,39
2021-12-26,Humboldt,023,135768,10456,10052,771,10823,119
2021-12-26,Imperial,025,180216,37662,36878,4205,41083,800
2021-12-26,Inyo,027,18085,2739,2636,40,2676,47
2021-12-26,Kern,029,883053,136675,134591,25121,159712,1908
2021-12-26,Kings,031,150075,34589,34009,2074,36083,379
2021-12-26,Lake,033,64148,7098,7019,178,7197,116
2021-12-26,Lassen,035,31185,7120,7072,430,7502,55
2021-12-26,Los Angeles,037,10098052,1591711,1515469,64596,1580065,27257
2021-12-26,Madera,039,155013,25089,24741,2404,27145,320
2021-12-26,Marin,041,260295,20450,19085,781,19866,249
2021-12-26,Mariposa,043,17540,1529,1480,63,1543,6
2021-12-26,Mendocino,045,87422,8489,8314,706,9020,98
2021-12-26,Merced,047,269075,44614,44208,2223,46431,690
2021-12-26,Modoc,049,8938,603,597,208,805,6
2021-12-26,Mono,051,14174,2097,2000,24,2024,4
2021-12-26,Monterey,053,433212,51772,49709,3578,53287,638
2021-12-26,Napa,055,140530,14432,13809,194,14003,107
2021-12-26,Nevada,057,99092,10386,10153,364,10517,110
2021-12-26,Orange,059,3164182,336139,322991,19342,342333,5863
2021-12-26,Placer,061,380077,41021,39852,4160,44012,489
2021-12-26,Plumas,063,18699,2037,1987,52,2039,12
2021-12-26,Riverside,065,2383286,397624,384567,17578,402145,5470
2021-12-26,Sacramento,067,1510023,173284,169144,5567,174711,2418
2021-12-26,San Benito,069,59416,8200,7991,194,8185,79
2021-12-26,San Bernardino,071,2135413,388312,376052,12672,388724,6043
2021-12-26,San Diego,073,3302833,424116,406616,25238,431854,4442
2021-12-26,San Francisco,075,870044,64516,58229,2863,61092,682
2021-12-26,San Joaquin,077,732212,106671,104590,5817,110407,1872
2021-12-26,San Luis Obispo,079,281455,32249,31290,1473,32763,365
2021-12-26,San Mateo,081,765935,62335,56973,1217,58190,581
2021-12-26,Santa Barbara,083,443738,49171,47553,1719,49272,567
2021-12-26,Santa Clara,085,1922200,164454,156872,2120,158992,1967
2021-12-26,Santa Cruz,087,273765,23038,22176,1103,23279,228
2021-12-26,Shasta,089,179085,23215,22959,3765,26724,432
2021-12-26,Sierra,091,2930,212,202,21,223,0
2021-12-26,Siskiyou,093,43540,3528,3460,1391,4851,60
2021-12-26,Solano,095,438530,49052,47646,1463,49109,377
2021-12-26,Sonoma,097,501317,46085,44358,675,45033,408
2021-12-26,Stanislaus,099,539301,83821,83368,9589,92957,1331
2021-12-26,Sutter,101,95872,14691,14533,424,14957,191
2021-12-26,Tehama,103,63373,9003,8861,1573,10434,136
2021-12-26,Trinity,105,12862,917,826,220,1046,17
2021-12-26,Tulare,107,460477,72773,71292,16832,88124,1137
2021-12-26,Tuolumne,109,53932,8074,7919,121,8040,91
2021-12-26,Ventura,111,848112,108064,103498,5138,108636,1206
2021-12-26,Yolo,113,214977,21804,21084,1347,22431,270
2021-12-26,Yuba,115,75493,10864,10694,412,11106,98
2021-12-25,Alameda,001,1643700,132196,127221,3346,130567,1525
2021-12-25,Alpine,003,1148,110,113,0,113,0
2021-12-25,Amador,005,37829,5927,5861,79,5940,70
2021-12-25,Butte,007,227075,22613,22087,4136,26223,330
2021-12-25,Calaveras,009,45235,4657,4591,65,4656,91
2021-12-25,Colusa,011,21464,2670,2647,699,3346,21
2021-12-25,Contra Costa,013,1133247,108081,105022,2667,107689,1071
2021-12-25,Del Norte,015,27424,3841,3795,56,3851,43
2021-12-25,El Dorado,017,186661,17697,17188,1881,19069,172
2021-12-25,Fresno,019,978130,150280,148027,13452,161479,2358
2021-12-25,Glenn,021,27897,3668,3611,1056,4667,39
2021-12-25,Humboldt,023,135768,10374,10052,764,10816,119
2021-12-25,Imperial,025,180216,37540,36878,4183,41061,800
2021-12-25,Inyo,027,18085,2719,2636,40,2676,47
2021-12-25,Kern,029,883053,136328,134591,24995,159586,1908
2021-12-25,Kings,031,150075,34499,34009,2067,36076,379
2021-12-25,Lake,033,64148,7086,7019,176,7195,116
2021-12-25,Lassen,035,31185,7118,7072,430,7502,55
2021-12-25,Los Angeles,037,10098052,1578896,1515469,63278,1578747,27257
2021-12-25,Madera,039,155013,25039,24741,2398,27139,320
2021-12-25,Marin,041,260295,20108,19085,732,19817,249
2021-12-25,Mariposa,043,17540,1523,1480,63,1543,6
2021-12-25,Mendocino,045,87422,8451,8314,706,9020,98
2021-12-25,Merced,047,269075,44514,44208,2221,46429,690
2021-12-25,Modoc,049,8938,603,597,208,805,6
2021-12-25,Mono,051,14174,2080,2000,24,2024,4
2021-12-25,Monterey,053,433212,51605,49709,3544,53253,638
2021-12-25,Napa,055,140530,14317,13809,186,13995,107
2021-12-25,Nevada,057,99092,10357,10153,364,10517,110
2021-12-25,Orange,059,3164182,333273,322991,18773,341764,5863
2021-12-25,Placer,061,380077,40838,39852,4126,43978,489
2021-12-25,Plumas,063,18699,2035,1987,52,2039,12
2021-12-25,Riverside,065,2383286,395343,384567,17459,402026,5470
2021-12-25,Sacramento,067,1510023,172468,169144,5462,174606,2418
2021-12-25,San Benito,069,59416,8135,7991,194,8185,79
2021-12-25,San Bernardino,071,2135413,386080,376052,12540,388592,6043
2021-12-25,San Diego,073,3302833,420051,406616,24968,431584,4442
2021-12-25,San Francisco,075,870044,63485,58229,2827,61056,682
2021-12-25,San Joaquin,077,732212,106334,104590,5785,110375,1872
2021-12-25,San Luis Obispo,079,281455,32096,31290,1464,32754,365
2021-12-25,San Mateo,081,765935,61304,56973,1174,58147,581
2021-12-25,Santa Barbara,083,443738,48807,47553,1707,49260,567
2021-12-25,Santa Clara,085,1922200,162979,156872,2053,158925,1967
2021-12-25,Santa Cruz,087,273765,22878,22176,1097,23273,228
2021-12-25,Shasta,089,179085,23182,22959,3759,26718,432
2021-12-25,Sierra,091,2930,212,202,21,223,0
2021-12-25,Siskiyou,093,43540,3525,3460,1385,4845,60
2021-12-25,Solano,095,438530,48927,47646,1445,49091,377
2021-12-25,Sonoma,097,501317,45702,44358,649,45007,408
2021-12-25,Stanislaus,099,539301,83608,83368,9563,92931,1331
2021-12-25,Sutter,101,95872,14650,14533,422,14955,191
2021-12-25,Tehama,103,63373,8983,8861,1569,10430,136
2021-12-25,Trinity,105,12862,916,826,220,1046,17
2021-12-25,Tulare,107,460477,72637,71292,16755,88047,1137
2021-12-25,Tuolumne,109,53932,8043,7919,121,8040,91
2021-12-25,Ventura,111,848112,106891,103498,5032,108530,1206
2021-12-25,Yolo,113,214977,21694,21084,1326,22410,270
2021-12-25,Yuba,115,75493,10837,10694,411,11105,98
2021-12-24,Alameda,001,1643700,131579,127221,3330,130551,1525
2021-12-24,Alpine,003,1148,110,113,0,113,0
2021-12-24,Amador,005,37829,5919,5861,78,5939,70
2021-12-24,Butte,007,227075,22556,22087,4119,26206,330
2021-12-24,Calaveras,009,45235,4651,4591,65,4656,91
2021-12-24,Colusa,011,21464,2668,2647,698,3345,21
2021-12-24,Contra Costa,013,1133247,107765,105022,2636,107658,1071
2021-12-24,Del Norte,015,27424,3834,3795,56,3851,43
2021-12-24,El Dorado,017,186661,17644,17188,1876,19064,172
2021-12-24,Fresno,019,978130,150114,148027,13439,161466,2358
2021-12-24,Glenn,021,27897,3667,3611,1056,4667,39
2021-12-24,Humboldt,023,135768,10319,10052,759,10811,119
2021-12-24,Imperial,025,180216,37457,36878,4179,41057,800
2021-12-24,Inyo,027,18085,2699,2636,40,2676,47
2021-12-24,Kern,029,883053,136205,134591,24953,159544,1908
2021-12-24,Kings,031,150075,34431,34009,2066,36075,379
2021-12-24,Lake,033,64148,7082,7019,176,7195,116
2021-12-24,Lassen,035,31185,7115,7072,430,7502,55
2021-12-24,Los Angeles,037,10098052,1574027,1515469,62751,1578220,27257
2021-12-24,Madera,039,155013,25004,24741,2393,27134,320
2021-12-24,Marin,041,260295,19962,19085,701,19786,249
2021-12-24,Mariposa,043,17540,1521,1480,63,1543,6
2021-12-24,Mendocino,045,87422,8434,8314,706,9020,98
2021-12-24,Merced,047,269075,44464,44208,2219,46427,690
2021-12-24,Modoc,049,8938,603,597,208,805,6
2021-12-24,Mono,051,14174,2067,2000,24,2024,4
2021-12-24,Monterey,053,433212,51509,49709,3518,53227,638
2021-12-24,Napa,055,140530,14251,13809,182,13991,107
2021-12-24,Nevada,057,99092,10331,10153,362,10515,110
2021-12-24,Orange,059,3164182,332220,322991,18615,341606,5863
2021-12-24,Placer,061,380077,40718,39852,4110,43962,489
2021-12-24,Plumas,063,18699,2034,1987,52,2039,12
2021-12-24,Riverside,065,2383286,394347,384567,17369,401936,5470
2021-12-24,Sacramento,067,1510023,172152,169144,5427,174571,2418
2021-12-24,San Benito,069,59416,8126,7991,193,8184,79
2021-12-24,San Bernardino,071,2135413,384943,376052,12467,388519,6043
2021-12-24,San Diego,073,3302833,418928,406616,24840,431456,4442
2021-12-24,San Francisco,075,870044,62977,58229,2810,61039,682
2021-12-24,San Joaquin,077,732212,106139,104590,5777,110367,1872
2021-12-24,San Luis Obispo,079,281455,32034,31290,1454,32744,365
2021-12-24,San Mateo,081,765935,60872,56973,1151,58124,581
2021-12-24,Santa Barbara,083,443738,48602,47553,1700,49253,567
2021-12-24,Santa Clara,085,1922200,162156,156872,2019,158891,1967
2021-12-24,Santa Cruz,087,273765,22795,22176,1094,23270,228
2021-12-24,Shasta,089,179085,23148,22959,3755,26714,432
2021-12-24,Sierra,091,2930,211,202,21,223,0
2021-12-24,Siskiyou,093,43540,3520,3460,1381,4841,60
2021-12-24,Solano,095,438530,48875,47646,1443,49089,377
2021-12-24,Sonoma,097,501317,45536,44358,641,44999,408
2021-12-24,Stanislaus,099,539301,83497,83368,9540,92908,1331
2021-12-24,Sutter,101,95872,14630,14533,419,14952,191
2021-12-24,Tehama,103,63373,8974,8861,1566,10427,136
2021-12-24,Trinity,105,12862,914,826,220,1046,17
2021-12-24,Tulare,107,460477,72570,71292,16712,88004,1137
2021-12-24,Tuolumne,109,53932,8018,7919,121,8040,91
2021-12-24,Ventura,111,848112,106444,103498,4976,108474,1206
2021-12-24,Yolo,113,214977,21620,21084,1308,22392,270
2021-12-24,Yuba,115,75493,10814,10694,410,11104,98
2021-12-23,Alameda,001,1643700,130873,127221,3296,130517,1525
2021-12-23,Alpine,003,1148,110,113,0,113,0
2021-12-23,Amador,005,37829,5907,5861,76,5937,70
2021-12-23,Butte,007,227075,22504,22087,4108,26195,330
2021-12-23,Calaveras,009,45235,4640,4591,65,4656,91
2021-12-23,Colusa,011,21464,2662,2647,694,3341,21
2021-12-23,Contra Costa,013,1133247,107336,105022,2592,107614,1071
2021-12-23,Del Norte,015,27424,3831,3795,56,3851,43
2021-12-23,El Dorado,017,186661,17581,17188,1870,19058,172
2021-12-23,Fresno,019,978130,149909,148027,13420,161447,2358
2021-12-23,Glenn,021,27897,3663,3611,1056,4667,39
2021-12-23,Humboldt,023,135768,10266,10052,756,10808,119
2021-12-23,Imperial,025,180216,37383,36878,4152,41030,800
2021-12-23,Inyo,027,18085,2686,2636,40,2676,47
2021-12-23,Kern,029,883053,136055,134591,24857,159448,1908
2021-12-23,Kings,031,150075,34390,34009,2065,36074,379
2021-12-23,Lake,033,64148,7070,7019,174,7193,116
2021-12-23,Lassen,035,31185,7114,7072,430,7502,55
2021-12-23,Los Angeles,037,10098052,1564484,1515469,61668,1577137,27257
2021-12-23,Madera,039,155013,24971,24741,2389,27130,320
2021-12-23,Marin,041,260295,19828,19085,684,19769,249
2021-12-23,Mariposa,043,17540,1516,1480,63,1543,6
2021-12-23,Mendocino,045,87422,8425,8314,706,9020,98
2021-12-23,Merced,047,269075,44415,44208,2217,46425,690
2021-12-23,Modoc,049,8938,603,597,208,805,6
2021-12-23,Mono,051,14174,2046,2000,23,2023,4
2021-12-23,Monterey,053,433212,51387,49709,3497,53206,638
2021-12-23,Napa,055,140530,14170,13809,177,13986,107
2021-12-23,Nevada,057,99092,10307,10153,361,10514,110
2021-12-23,Orange,059,3164182,330530,322991,18285,341276,5863
2021-12-23,Placer,061,380077,40595,39852,4094,43946,489
2021-12-23,Plumas,063,18699,2034,1987,52,2039,12
2021-12-23,Riverside,065,2383286,393131,384567,17300,401867,5470
2021-12-23,Sacramento,067,1510023,171696,169144,5380,174524,2418
2021-12-23,San Benito,069,59416,8107,7991,191,8182,79
2021-12-23,San Bernardino,071,2135413,383763,376052,12362,388414,6043
2021-12-23,San Diego,073,3302833,417076,406616,24642,431258,4442
2021-12-23,San Francisco,075,870044,62248,58229,2782,61011,682
2021-12-23,San Joaquin,077,732212,105921,104590,5764,110354,1872
2021-12-23,San Luis Obispo,079,281455,31962,31290,1450,32740,365
2021-12-23,San Mateo,081,765935,60310,56973,1131,58104,581
2021-12-23,Santa Barbara,083,443738,48403,47553,1698,49251,567
2021-12-23,Santa Clara,085,1922200,161250,156872,1960,158832,1967
2021-12-23,Santa Cruz,087,273765,22680,22176,1082,23258,228
2021-12-23,Shasta,089,179085,23118,22959,3752,26711,432
2021-12-23,Sierra,091,2930,208,202,21,223,0
2021-12-23,Siskiyou,093,43540,3520,3460,1379,4839,60
2021-12-23,Solano,095,438530,48768,47646,1427,49073,377
2021-12-23,Sonoma,097,501317,45359,44358,640,44998,408
2021-12-23,Stanislaus,099,539301,83368,83368,9520,92888,1331
2021-12-23,Sutter,101,95872,14613,14533,418,14951,191
2021-12-23,Tehama,103,63373,8962,8861,1562,10423,136
2021-12-23,Trinity,105,12862,914,826,220,1046,17
2021-12-23,Tulare,107,460477,72495,71292,16669,87961,1137
2021-12-23,Tuolumne,109,53932,8000,7919,120,8039,91
2021-12-23,Ventura,111,848112,105909,103498,4910,108408,1206
2021-12-23,Yolo,113,214977,21548,21084,1290,22374,270
2021-12-23,Yuba,115,75493,10801,10694,410,11104,98
2021-12-22,Alameda,001,1643700,129948,126533,3215,129748,1522
2021-12-22,Alpine,003,1148,110,112,0,112,0
2021-12-22,Amador,005,37829,5894,5850,75,5925,70
2021-12-22,Butte,007,227075,22454,22070,4094,26164,330
2021-12-22,Calaveras,009,45235,4631,4580,65,4645,91
2021-12-22,Colusa,011,21464,2662,2645,691,3336,21
2021-12-22,Contra Costa,013,1133247,106698,104559,2550,107109,1070
2021-12-22,Del Norte,015,27424,3831,3794,56,3850,43
2021-12-22,El Dorado,017,186661,17519,17140,1861,19001,172
2021-12-22,Fresno,019,978130,149629,147838,13389,161227,2349
2021-12-22,Glenn,021,27897,3658,3604,1056,4660,39
2021-12-22,Humboldt,023,135768,10205,10022,751,10773,119
2021-12-22,Imperial,025,180216,37297,36755,4115,40870,798
2021-12-22,Inyo,027,18085,2668,2632,40,2672,47
2021-12-22,Kern,029,883053,135820,134433,24775,159208,1900
2021-12-22,Kings,031,150075,34340,33953,2058,36011,376
2021-12-22,Lake,033,64148,7063,7008,172,7180,116
2021-12-22,Lassen,035,31185,7109,7069,429,7498,55
2021-12-22,Los Angeles,037,10098052,1550937,1507110,60510,1567620,27234
2021-12-22,Madera,039,155013,24933,24702,2385,27087,320
2021-12-22,Marin,041,260295,19607,18927,661,19588,249
2021-12-22,Mariposa,043,17540,1509,1480,63,1543,6
2021-12-22,Mendocino,045,87422,8416,8299,706,9005,99
2021-12-22,Merced,047,269075,44344,44137,2215,46352,689
2021-12-22,Modoc,049,8938,603,595,208,803,6
2021-12-22,Mono,051,14174,2042,1979,23,2002,4
2021-12-22,Monterey,053,433212,51231,49650,3480,53130,639
2021-12-22,Napa,055,140530,14043,13746,167,13913,107
2021-12-22,Nevada,057,99092,10279,10101,356,10457,110
2021-12-22,Orange,059,3164182,328237,321765,17857,339622,5858
2021-12-22,Placer,061,380077,40412,39758,4057,43815,489
2021-12-22,Plumas,063,18699,2030,1986,52,2038,12
2021-12-22,Riverside,065,2383286,391300,383319,17187,400506,5472
2021-12-22,Sacramento,067,1510023,171037,168695,5320,174015,2422
2021-12-22,San Benito,069,59416,8055,7971,189,8160,79
2021-12-22,San Bernardino,071,2135413,382048,375044,12278,387322,6039
2021-12-22,San Diego,073,3302833,412956,404269,24313,428582,4434
2021-12-22,San Francisco,075,870044,61261,57520,2739,60259,682
2021-12-22,San Joaquin,077,732212,105651,104385,5750,110135,1870
2021-12-22,San Luis Obispo,079,281455,31821,31175,1430,32605,365
2021-12-22,San Mateo,081,765935,59628,56604,1101,57705,581
2021-12-22,Santa Barbara,083,443738,48146,47372,1682,49054,566
2021-12-22,Santa Clara,085,1922200,160131,156258,1919,158177,1954
2021-12-22,Santa Cruz,087,273765,22573,22075,1077,23152,228
2021-12-22,Shasta,089,179085,23089,22937,3747,26684,432
2021-12-22,Sierra,091,2930,208,202,21,223,0
2021-12-22,Siskiyou,093,43540,3517,3458,1376,4834,59
2021-12-22,Solano,095,438530,48539,47531,1414,48945,375
2021-12-22,Sonoma,097,501317,45084,44201,629,44830,408
2021-12-22,Stanislaus,099,539301,83227,83245,9500,92745,1331
2021-12-22,Sutter,101,95872,14577,14513,415,14928,191
2021-12-22,Tehama,103,63373,8949,8853,1558,10411,136
2021-12-22,Trinity,105,12862,914,826,220,1046,17
2021-12-22,Tulare,107,460477,72396,71226,16620,87846,1137
2021-12-22,Tuolumne,109,53932,7979,7903,120,8023,91
2021-12-22,Ventura,111,848112,105303,103089,4805,107894,1206
2021-12-22,Yolo,113,214977,21473,21012,1276,22288,270
2021-12-22,Yuba,115,75493,10784,10681,410,11091,98
2021-12-21,Alameda,001,1643700,128947,126007,3160,129167,1518
2021-12-21,Alpine,003,1148,110,112,0,112,0
2021-12-21,Amador,005,37829,5884,5845,75,5920,70
2021-12-21,Butte,007,227075,22390,22041,4080,26121,330
2021-12-21,Calaveras,009,45235,4618,4575,65,4640,91
2021-12-21,Colusa,011,21464,2660,2643,690,3333,21
2021-12-21,Contra Costa,013,1133247,106069,104255,2486,106741,1068
2021-12-21,Del Norte,015,27424,3830,3793,56,3849,43
2021-12-21,El Dorado,017,186661,17454,17098,1849,18947,172
2021-12-21,Fresno,019,978130,149344,147707,13354,161061,2341
2021-12-21,Glenn,021,27897,3644,3602,1056,4658,39
2021-12-21,Humboldt,023,135768,10141,9989,746,10735,118
2021-12-21,Imperial,025,180216,37199,36580,4074,40654,792
2021-12-21,Inyo,027,18085,2657,2627,40,2667,47
2021-12-21,Kern,029,883053,135611,134321,24670,158991,1892
2021-12-21,Kings,031,150075,34280,33914,2057,35971,376
2021-12-21,Lake,033,64148,7058,7004,170,7174,116
2021-12-21,Lassen,035,31185,7107,7069,429,7498,55
2021-12-21,Los Angeles,037,10098052,1537036,1501169,59488,1560657,27220
2021-12-21,Madera,039,155013,24896,24688,2378,27066,320
2021-12-21,Marin,041,260295,19437,18828,626,19454,249
2021-12-21,Mariposa,043,17540,1508,1480,62,1542,6
2021-12-21,Mendocino,045,87422,8400,8282,704,8986,97
2021-12-21,Merced,047,269075,44272,44096,2212,46308,688
2021-12-21,Modoc,049,8938,601,595,206,801,6
2021-12-21,Mono,051,14174,2023,1979,23,2002,4
2021-12-21,Monterey,053,433212,51140,49586,3463,53049,638
2021-12-21,Napa,055,140530,13942,13703,156,13859,107
2021-12-21,Nevada,057,99092,10250,10095,356,10451,110
2021-12-21,Orange,059,3164182,326115,320705,17409,338114,5855
2021-12-21,Placer,061,380077,40272,39649,4028,43677,487
2021-12-21,Plumas,063,18699,2030,1975,52,2027,12
2021-12-21,Riverside,065,2383286,389574,382415,17068,399483,5465
2021-12-21,Sacramento,067,1510023,170391,168422,5265,173687,2419
2021-12-21,San Benito,069,59416,8016,7950,186,8136,79
2021-12-21,San Bernardino,071,2135413,380388,374219,12168,386387,6026
2021-12-21,San Diego,073,3302833,409226,402386,23976,426362,4424
2021-12-21,San Francisco,075,870044,60301,56950,2706,59656,681
2021-12-21,San Joaquin,077,732212,105366,104238,5731,109969,1870
2021-12-21,San Luis Obispo,079,281455,31657,31103,1418,32521,365
2021-12-21,San Mateo,081,765935,59011,56381,1078,57459,581
2021-12-21,Santa Barbara,083,443738,47918,47194,1667,48861,564
2021-12-21,Santa Clara,085,1922200,159109,155769,1877,157646,1951
2021-12-21,Santa Cruz,087,273765,22456,22028,1067,23095,228
2021-12-21,Shasta,089,179085,23058,22920,3743,26663,429
2021-12-21,Sierra,091,2930,206,201,21,222,0
2021-12-21,Siskiyou,093,43540,3516,3455,1376,4831,59
2021-12-21,Solano,095,438530,48385,47474,1407,48881,372
2021-12-21,Sonoma,097,501317,44862,44051,619,44670,408
2021-12-21,Stanislaus,099,539301,83072,83167,9469,92636,1331
2021-12-21,Sutter,101,95872,14554,14492,414,14906,190
2021-12-21,Tehama,103,63373,8941,8849,1553,10402,136
2021-12-21,Trinity,105,12862,913,826,220,1046,17
2021-12-21,Tulare,107,460477,72302,71166,16579,87745,1137
2021-12-21,Tuolumne,109,53932,7955,7893,120,8013,91
2021-12-21,Ventura,111,848112,104684,102631,4692,107323,1205
2021-12-21,Yolo,113,214977,21366,20944,1272,22216,267
2021-12-21,Yuba,115,75493,10767,10668,410,11078,98
2021-12-20,Alameda,001,1643700,128012,125762,3092,128854,1515
2021-12-20,Alpine,003,1148,110,112,0,112,0
2021-12-20,Amador,005,37829,5870,5838,75,5913,70
2021-12-20,Butte,007,227075,22328,22030,4067,26097,329
2021-12-20,Calaveras,009,45235,4608,4569,65,4634,91
2021-12-20,Colusa,011,21464,2659,2644,690,3334,21
2021-12-20,Contra Costa,013,1133247,105536,104051,2439,106490,1068
2021-12-20,Del Norte,015,27424,3828,3792,56,3848,43
2021-12-20,El Dorado,017,186661,17393,17083,1841,18924,172
2021-12-20,Fresno,019,978130,149101,147605,13325,160930,2341
2021-12-20,Glenn,021,27897,3638,3597,1056,4653,39
2021-12-20,Humboldt,023,135768,10099,9973,742,10715,118
2021-12-20,Imperial,025,180216,37083,36532,4044,40576,792
2021-12-20,Inyo,027,18085,2654,2615,40,2655,47
2021-12-20,Kern,029,883053,135412,134203,24610,158813,1883
2021-12-20,Kings,031,150075,34238,33898,2056,35954,376
2021-12-20,Lake,033,64148,7053,6999,170,7169,116
2021-12-20,Lassen,035,31185,7105,7065,428,7493,55
2021-12-20,Los Angeles,037,10098052,1525559,1495251,58764,1554015,27188
2021-12-20,Madera,039,155013,24867,24668,2374,27042,313
2021-12-20,Marin,041,260295,19222,18747,608,19355,249
2021-12-20,Mariposa,043,17540,1499,1479,62,1541,6
2021-12-20,Mendocino,045,87422,8388,8264,702,8966,96
2021-12-20,Merced,047,269075,44215,44071,2207,46278,687
2021-12-20,Modoc,049,8938,601,595,203,798,6
2021-12-20,Mono,051,14174,2000,1973,23,1996,4
2021-12-20,Monterey,053,433212,51044,49556,3443,52999,636
2021-12-20,Napa,055,140530,13857,13672,146,13818,107
2021-12-20,Nevada,057,99092,10210,10079,355,10434,109
2021-12-20,Orange,059,3164182,324510,320235,17094,337329,5852
2021-12-20,Placer,061,380077,40142,39579,3998,43577,485
2021-12-20,Plumas,063,18699,2027,1971,50,2021,12
2021-12-20,Riverside,065,2383286,388123,381841,16979,398820,5452
2021-12-20,Sacramento,067,1510023,169820,168153,5225,173378,2414
2021-12-20,San Benito,069,59416,7972,7934,184,8118,79
2021-12-20,San Bernardino,071,2135413,378865,373881,12083,385964,6023
2021-12-20,San Diego,073,3302833,406010,401483,23735,425218,4412
2021-12-20,San Francisco,075,870044,59241,56661,2649,59310,681
2021-12-20,San Joaquin,077,732212,105123,104188,5720,109908,1865
2021-12-20,San Luis Obispo,079,281455,31543,31075,1410,32485,365
2021-12-20,San Mateo,081,765935,58463,56247,1059,57306,581
2021-12-20,Santa Barbara,083,443738,47706,47131,1662,48793,562
2021-12-20,Santa Clara,085,1922200,158149,155427,1829,157256,1950
2021-12-20,Santa Cruz,087,273765,22376,21989,1062,23051,227
2021-12-20,Shasta,089,179085,23037,22888,3738,26626,429
2021-12-20,Sierra,091,2930,205,201,21,222,0
2021-12-20,Siskiyou,093,43540,3515,3453,1374,4827,59
2021-12-20,Solano,095,438530,48257,47394,1399,48793,370
2021-12-20,Sonoma,097,501317,44672,43982,611,44593,408
2021-12-20,Stanislaus,099,539301,82947,83110,9440,92550,1331
2021-12-20,Sutter,101,95872,14531,14480,414,14894,190
2021-12-20,Tehama,103,63373,8933,8840,1550,10390,136
2021-12-20,Trinity,105,12862,913,826,220,1046,17
2021-12-20,Tulare,107,460477,72208,71124,16521,87645,1129
2021-12-20,Tuolumne,109,53932,7941,7867,116,7983,91
2021-12-20,Ventura,111,848112,104177,102452,4616,107068,1203
2021-12-20,Yolo,113,214977,21273,20903,1260,22163,267
2021-12-20,Yuba,115,75493,10751,10656,407,11063,97
2021-12-19,Alameda,001,1643700,127125,125464,3052,128516,1519
2021-12-19,Alpine,003,1148,110,112,0,112,0
2021-12-19,Amador,005,37829,5858,5832,74,5906,70
2021-12-19,Butte,007,227075,22273,22022,4059,26081,329
2021-12-19,Calaveras,009,45235,4592,4563,64,4627,91
2021-12-19,Colusa,011,21464,2659,2643,687,3330,21
2021-12-19,Contra Costa,013,1133247,105045,103906,2405,106311,1068
2021-12-19,Del Norte,015,27424,3824,3797,56,3853,43
2021-12-19,El Dorado,017,186661,17336,17067,1839,18906,172
2021-12-19,Fresno,019,978130,148860,147505,13300,160805,2341
2021-12-19,Glenn,021,27897,3634,3596,1055,4651,39
2021-12-19,Humboldt,023,135768,10056,9957,737,10694,118
2021-12-19,Imperial,025,180216,36954,36501,4001,40502,792
2021-12-19,Inyo,027,18085,2645,2613,40,2653,47
2021-12-19,Kern,029,883053,135213,134136,24542,158678,1883
2021-12-19,Kings,031,150075,34180,33874,2052,35926,378
2021-12-19,Lake,033,64148,7044,6999,167,7166,116
2021-12-19,Lassen,035,31185,7101,7065,428,7493,55
2021-12-19,Los Angeles,037,10098052,1516563,1495082,58165,1553247,27189
2021-12-19,Madera,039,155013,24843,24642,2368,27010,313
2021-12-19,Marin,041,260295,19046,18707,585,19292,249
2021-12-19,Mariposa,043,17540,1493,1475,62,1537,6
2021-12-19,Mendocino,045,87422,8371,8257,699,8956,96
2021-12-19,Merced,047,269075,44120,44045,2200,46245,687
2021-12-19,Modoc,049,8938,600,595,203,798,6
2021-12-19,Mono,051,14174,1989,1968,22,1990,4
2021-12-19,Monterey,053,433212,50943,49516,3422,52938,636
2021-12-19,Napa,055,140530,13784,13659,137,13796,107
2021-12-19,Nevada,057,99092,10174,10057,352,10409,109
2021-12-19,Orange,059,3164182,323107,319615,16868,336483,5852
2021-12-19,Placer,061,380077,40021,39525,3982,43507,485
2021-12-19,Plumas,063,18699,2024,1971,50,2021,12
2021-12-19,Riverside,065,2383286,386678,381305,16904,398209,5452
2021-12-19,Sacramento,067,1510023,169326,167933,5196,173129,2415
2021-12-19,San Benito,069,59416,7947,7929,183,8112,79
2021-12-19,San Bernardino,071,2135413,377541,373480,12045,385525,6023
2021-12-19,San Diego,073,3302833,403530,398197,23539,421736,4406
2021-12-19,San Francisco,075,870044,58363,56358,2593,58951,681
2021-12-19,San Joaquin,077,732212,104866,104125,5706,109831,1865
2021-12-19,San Luis Obispo,079,281455,31420,31035,1398,32433,366
2021-12-19,San Mateo,081,765935,57998,56132,1044,57176,581
2021-12-19,Santa Barbara,083,443738,47483,47070,1655,48725,562
2021-12-19,Santa Clara,085,1922200,157264,155049,1803,156852,1950
2021-12-19,Santa Cruz,087,273765,22277,21960,1057,23017,227
2021-12-19,Shasta,089,179085,23000,22875,3734,26609,429
2021-12-19,Sierra,091,2930,204,201,21,222,0
2021-12-19,Siskiyou,093,43540,3512,3452,1374,4826,59
2021-12-19,Solano,095,438530,48135,47341,1393,48734,370
2021-12-19,Sonoma,097,501317,44488,43944,609,44553,408
2021-12-19,Stanislaus,099,539301,82808,83040,9408,92448,1331
2021-12-19,Sutter,101,95872,14491,14475,413,14888,190
2021-12-19,Tehama,103,63373,8925,8840,1550,10390,136
2021-12-19,Trinity,105,12862,913,826,220,1046,17
2021-12-19,Tulare,107,460477,72115,71085,16479,87564,1129
2021-12-19,Tuolumne,109,53932,7924,7865,115,7980,91
2021-12-19,Ventura,111,848112,103597,102170,4551,106721,1203
2021-12-19,Yolo,113,214977,21192,20887,1241,22128,267
2021-12-19,Yuba,115,75493,10734,10646,405,11051,97
2021-12-18,Alameda,001,1643700,126720,124583,3027,127610,1512
2021-12-18,Alpine,003,1148,110,110,0,110,0
2021-12-18,Amador,005,37829,5852,5821,74,5895,69
2021-12-18,Butte,007,227075,22257,21956,4054,26010,328
2021-12-18,Calaveras,009,45235,4585,4534,64,4598,91
2021-12-18,Colusa,011,21464,2655,2635,685,3320,21
2021-12-18,Contra Costa,013,1133247,104830,103380,2391,105771,1065
2021-12-18,Del Norte,015,27424,3821,3791,56,3847,43
2021-12-18,El Dorado,017,186661,17308,16968,1836,18804,171
2021-12-18,Fresno,019,978130,148757,147038,13287,160325,2335
2021-12-18,Glenn,021,27897,3631,3590,1055,4645,39
2021-12-18,Humboldt,023,135768,10040,9889,737,10626,118
2021-12-18,Imperial,025,180216,36881,36280,3989,40269,790
2021-12-18,Inyo,027,18085,2639,2607,40,2647,47
2021-12-18,Kern,029,883053,135123,133754,24497,158251,1873
2021-12-18,Kings,031,150075,34147,33783,2048,35831,374
2021-12-18,Lake,033,64148,7043,6976,167,7143,115
2021-12-18,Lassen,035,31185,7099,7061,427,7488,55
2021-12-18,Los Angeles,037,10098052,1512472,1484840,57852,1542692,27135
2021-12-18,Madera,039,155013,24828,24575,2366,26941,313
2021-12-18,Marin,041,260295,18945,18537,573,19110,249
2021-12-18,Mariposa,043,17540,1492,1468,62,1530,6
2021-12-18,Mendocino,045,87422,8365,8219,699,8918,95
2021-12-18,Merced,047,269075,44085,43929,2199,46128,686
2021-12-18,Modoc,049,8938,598,595,203,798,6
2021-12-18,Mono,051,14174,1987,1956,22,1978,4
2021-12-18,Monterey,053,433212,50885,49343,3417,52760,635
2021-12-18,Napa,055,140530,13758,13581,135,13716,107
2021-12-18,Nevada,057,99092,10152,9991,350,10341,108
2021-12-18,Orange,059,3164182,322443,318149,16732,334881,5844
2021-12-18,Placer,061,380077,39920,39336,3968,43304,485
2021-12-18,Plumas,063,18699,2024,1964,50,2014,13
2021-12-18,Riverside,065,2383286,385981,379354,16863,396217,5439
2021-12-18,Sacramento,067,1510023,169091,167046,5177,172223,2404
2021-12-18,San Benito,069,59416,7932,7894,183,8077,79
2021-12-18,San Bernardino,071,2135413,376872,371658,12017,383675,6017
2021-12-18,San Diego,073,3302833,402565,397130,23487,420617,4399
2021-12-18,San Francisco,075,870044,57869,55562,2563,58125,679
2021-12-18,San Joaquin,077,732212,104779,103698,5696,109394,1858
2021-12-18,San Luis Obispo,079,281455,31378,30873,1392,32265,365
2021-12-18,San Mateo,081,765935,57758,55730,1039,56769,580
2021-12-18,Santa Barbara,083,443738,47387,46776,1653,48429,562
2021-12-18,Santa Clara,085,1922200,156808,154243,1790,156033,1946
2021-12-18,Santa Cruz,087,273765,22225,21805,1055,22860,225
2021-12-18,Shasta,089,179085,22979,22811,3734,26545,429
2021-12-18,Sierra,091,2930,204,199,21,220,0
2021-12-18,Siskiyou,093,43540,3510,3441,1373,4814,58
2021-12-18,Solano,095,438530,48089,47174,1391,48565,369
2021-12-18,Sonoma,097,501317,44378,43658,605,44263,407
2021-12-18,Stanislaus,099,539301,82726,82736,9396,92132,1330
2021-12-18,Sutter,101,95872,14473,14435,413,14848,190
2021-12-18,Tehama,103,63373,8919,8814,1549,10363,136
2021-12-18,Trinity,105,12862,913,823,220,1043,17
2021-12-18,Tulare,107,460477,72077,70922,16454,87376,1120
2021-12-18,Tuolumne,109,53932,7910,7834,115,7949,91
2021-12-18,Ventura,111,848112,103312,101612,4529,106141,1201
2021-12-18,Yolo,113,214977,21152,20793,1235,22028,267
2021-12-18,Yuba,115,75493,10723,10599,405,11004,96
2021-12-17,Alameda,001,1643700,126382,124583,3008,127591,1512
2021-12-17,Alpine,003,1148,110,110,0,110,0
2021-12-17,Amador,005,37829,5845,5821,74,5895,69
2021-12-17,Butte,007,227075,22236,21956,4047,26003,328
2021-12-17,Calaveras,009,45235,4581,4534,64,4598,91
2021-12-17,Colusa,011,21464,2654,2635,684,3319,21
2021-12-17,Contra Costa,013,1133247,104628,103380,2387,105767,1065
2021-12-17,Del Norte,015,27424,3820,3791,56,3847,43
2021-12-17,El Dorado,017,186661,17280,16968,1833,18801,171
2021-12-17,Fresno,019,978130,148654,147038,13287,160325,2335
2021-12-17,Glenn,021,27897,3624,3590,1055,4645,39
2021-12-17,Humboldt,023,135768,10020,9889,735,10624,118
2021-12-17,Imperial,025,180216,36818,36280,3971,40251,790
2021-12-17,Inyo,027,18085,2634,2607,40,2647,47
2021-12-17,Kern,029,883053,135032,133754,24456,158210,1873
2021-12-17,Kings,031,150075,34128,33783,2048,35831,374
2021-12-17,Lake,033,64148,7039,6976,167,7143,115
2021-12-17,Lassen,035,31185,7099,7061,426,7487,55
2021-12-17,Los Angeles,037,10098052,1508532,1484840,57613,1542453,27135
2021-12-17,Madera,039,155013,24812,24575,2361,26936,313
2021-12-17,Marin,041,260295,18869,18537,569,19106,249
2021-12-17,Mariposa,043,17540,1488,1468,62,1530,6
2021-12-17,Mendocino,045,87422,8354,8219,699,8918,95
2021-12-17,Merced,047,269075,44059,43929,2198,46127,686
2021-12-17,Modoc,049,8938,598,595,203,798,6
2021-12-17,Mono,051,14174,1984,1956,22,1978,4
2021-12-17,Monterey,053,433212,50827,49343,3412,52755,635
2021-12-17,Napa,055,140530,13731,13581,134,13715,107
2021-12-17,Nevada,057,99092,10141,9991,350,10341,108
2021-12-17,Orange,059,3164182,321882,318149,16664,334813,5844
2021-12-17,Placer,061,380077,39865,39336,3962,43298,485
2021-12-17,Plumas,063,18699,2023,1964,50,2014,13
2021-12-17,Riverside,065,2383286,385329,379354,16853,396207,5439
2021-12-17,Sacramento,067,1510023,168858,167046,5164,172210,2404
2021-12-17,San Benito,069,59416,7930,7894,183,8077,79
2021-12-17,San Bernardino,071,2135413,376315,371658,12000,383658,6017
2021-12-17,San Diego,073,3302833,401636,397130,23439,420569,4399
2021-12-17,San Francisco,075,870044,57542,55562,2533,58095,679
2021-12-17,San Joaquin,077,732212,104704,103698,5679,109377,1858
2021-12-17,San Luis Obispo,079,281455,31349,30873,1388,32261,365
2021-12-17,San Mateo,081,765935,57570,55730,1032,56762,580
2021-12-17,Santa Barbara,083,443738,47310,46776,1647,48423,562
2021-12-17,Santa Clara,085,1922200,156436,154243,1776,156019,1946
2021-12-17,Santa Cruz,087,273765,22178,21805,1051,22856,225
2021-12-17,Shasta,089,179085,22967,22811,3732,26543,429
2021-12-17,Sierra,091,2930,203,199,21,220,0
2021-12-17,Siskiyou,093,43540,3506,3441,1371,4812,58
2021-12-17,Solano,095,438530,48021,47174,1387,48561,369
2021-12-17,Sonoma,097,501317,44281,43658,602,44260,407
2021-12-17,Stanislaus,099,539301,82675,82736,9389,92125,1330
2021-12-17,Sutter,101,95872,14461,14435,411,14846,190
2021-12-17,Tehama,103,63373,8912,8814,1548,10362,136
2021-12-17,Trinity,105,12862,913,823,220,1043,17
2021-12-17,Tulare,107,460477,72035,70922,16424,87346,1120
2021-12-17,Tuolumne,109,53932,7898,7834,115,7949,91
2021-12-17,Ventura,111,848112,103062,101612,4517,106129,1201
2021-12-17,Yolo,113,214977,21119,20793,1230,22023,267
2021-12-17,Yuba,115,75493,10712,10599,403,11002,96
2021-12-16,Alameda,001,1643700,126004,124583,2993,127576,1512
2021-12-16,Alpine,003,1148,108,110,0,110,0
2021-12-16,Amador,005,37829,5837,5821,74,5895,69
2021-12-16,Butte,007,227075,22216,21956,4043,25999,328
2021-12-16,Calaveras,009,45235,4574,4534,64,4598,91
2021-12-16,Colusa,011,21464,2654,2635,684,3319,21
2021-12-16,Contra Costa,013,1133247,104405,103380,2377,105757,1065
2021-12-16,Del Norte,015,27424,3817,3791,56,3847,43
2021-12-16,El Dorado,017,186661,17245,16968,1828,18796,171
2021-12-16,Fresno,019,978130,148495,147038,13280,160318,2335
2021-12-16,Glenn,021,27897,3623,3590,1052,4642,39
2021-12-16,Humboldt,023,135768,9996,9889,725,10614,118
2021-12-16,Imperial,025,180216,36734,36280,3943,40223,790
2021-12-16,Inyo,027,18085,2630,2607,39,2646,47
2021-12-16,Kern,029,883053,134888,133754,24407,158161,1873
2021-12-16,Kings,031,150075,34104,33783,2047,35830,374
2021-12-16,Lake,033,64148,7035,6976,167,7143,115
2021-12-16,Lassen,035,31185,7096,7061,425,7486,55
2021-12-16,Los Angeles,037,10098052,1504317,1484840,57348,1542188,27135
2021-12-16,Madera,039,155013,24783,24575,2357,26932,313
2021-12-16,Marin,041,260295,18823,18537,562,19099,249
2021-12-16,Mariposa,043,17540,1486,1468,62,1530,6
2021-12-16,Mendocino,045,87422,8343,8219,694,8913,95
2021-12-16,Merced,047,269075,44020,43929,2197,46126,686
2021-12-16,Modoc,049,8938,598,595,203,798,6
2021-12-16,Mono,051,14174,1981,1956,22,1978,4
2021-12-16,Monterey,053,433212,50756,49343,3395,52738,635
2021-12-16,Napa,055,140530,13699,13581,134,13715,107
2021-12-16,Nevada,057,99092,10115,9991,350,10341,108
2021-12-16,Orange,059,3164182,321273,318149,16586,334735,5844
2021-12-16,Placer,061,380077,39788,39336,3957,43293,485
2021-12-16,Plumas,063,18699,2023,1964,50,2014,13
2021-12-16,Riverside,065,2383286,384523,379354,16839,396193,5439
2021-12-16,Sacramento,067,1510023,168575,167046,5140,172186,2404
2021-12-16,San Benito,069,59416,7923,7894,183,8077,79
2021-12-16,San Bernardino,071,2135413,375653,371658,11981,383639,6017
2021-12-16,San Diego,073,3302833,400467,397130,23373,420503,4399
2021-12-16,San Francisco,075,870044,57165,55562,2511,58073,679
2021-12-16,San Joaquin,077,732212,104580,103698,5672,109370,1858
2021-12-16,San Luis Obispo,079,281455,31279,30873,1382,32255,365
2021-12-16,San Mateo,081,765935,57370,55730,1029,56759,580
2021-12-16,Santa Barbara,083,443738,47189,46776,1643,48419,562
2021-12-16,Santa Clara,085,1922200,156105,154243,1766,156009,1946
2021-12-16,Santa Cruz,087,273765,22132,21805,1050,22855,225
2021-12-16,Shasta,089,179085,22937,22811,3730,26541,429
2021-12-16,Sierra,091,2930,203,199,21,220,0
2021-12-16,Siskiyou,093,43540,3505,3441,1367,4808,58
2021-12-16,Solano,095,438530,47953,47174,1380,48554,369
2021-12-16,Sonoma,097,501317,44182,43658,600,44258,407
2021-12-16,Stanislaus,099,539301,82588,82736,9375,92111,1330
2021-12-16,Sutter,101,95872,14447,14435,410,14845,190
2021-12-16,Tehama,103,63373,8905,8814,1547,10361,136
2021-12-16,Trinity,105,12862,913,823,220,1043,17
2021-12-16,Tulare,107,460477,71986,70922,16399,87321,1120
2021-12-16,Tuolumne,109,53932,7878,7834,115,7949,91
2021-12-16,Ventura,111,848112,102795,101612,4510,106122,1201
2021-12-16,Yolo,113,214977,21068,20793,1225,22018,267
2021-12-16,Yuba,115,75493,10696,10599,402,11001,96
2021-12-15,Alameda,001,1643700,125678,124342,2982,127324,1509
2021-12-15,Alpine,003,1148,108,109,0,109,0
2021-12-15,Amador,005,37829,5831,5810,74,5884,69
2021-12-15,Butte,007,227075,22192,21922,4042,25964,327
2021-12-15,Calaveras,009,45235,4568,4523,64,4587,89
2021-12-15,Colusa,011,21464,2653,2632,683,3315,21
2021-12-15,Contra Costa,013,1133247,104186,103236,2374,105610,1064
2021-12-15,Del Norte,015,27424,3816,3789,55,3844,43
2021-12-15,El Dorado,017,186661,17215,16936,1822,18758,171
2021-12-15,Fresno,019,978130,148368,146859,13266,160125,2319
2021-12-15,Glenn,021,27897,3623,3589,1052,4641,39
2021-12-15,Humboldt,023,135768,9976,9854,724,10578,118
2021-12-15,Imperial,025,180216,36654,36187,3899,40086,789
2021-12-15,Inyo,027,18085,2625,2606,39,2645,47
2021-12-15,Kern,029,883053,134749,133590,24361,157951,1866
2021-12-15,Kings,031,150075,34075,33716,2043,35759,374
2021-12-15,Lake,033,64148,7027,6968,166,7134,115
2021-12-15,Lassen,035,31185,7096,7062,425,7487,55
2021-12-15,Los Angeles,037,10098052,1500421,1482735,57155,1539890,27116
2021-12-15,Madera,039,155013,24765,24549,2351,26900,313
2021-12-15,Marin,041,260295,18764,18514,557,19071,249
2021-12-15,Mariposa,043,17540,1483,1463,62,1525,6
2021-12-15,Mendocino,045,87422,8338,8209,691,8900,95
2021-12-15,Merced,047,269075,43978,43890,2185,46075,685
2021-12-15,Modoc,049,8938,598,595,203,798,6
2021-12-15,Mono,051,14174,1977,1955,22,1977,4
2021-12-15,Monterey,053,433212,50701,49279,3377,52656,635
2021-12-15,Napa,055,140530,13670,13557,132,13689,107
2021-12-15,Nevada,057,99092,10094,9958,350,10308,107
2021-12-15,Orange,059,3164182,320692,317808,16544,334352,5838
2021-12-15,Placer,061,380077,39732,39264,3947,43211,485
2021-12-15,Plumas,063,18699,2019,1957,50,2007,12
2021-12-15,Riverside,065,2383286,383802,378769,16828,395597,5438
2021-12-15,Sacramento,067,1510023,168268,166793,5120,171913,2401
2021-12-15,San Benito,069,59416,7908,7877,183,8060,79
2021-12-15,San Bernardino,071,2135413,375090,371122,11948,383070,6013
2021-12-15,San Diego,073,3302833,399272,396546,23303,419849,4395
2021-12-15,San Francisco,075,870044,56847,55414,2493,57907,679
2021-12-15,San Joaquin,077,732212,104429,103579,5662,109241,1853
2021-12-15,San Luis Obispo,079,281455,31230,30784,1375,32159,365
2021-12-15,San Mateo,081,765935,57229,55657,1019,56676,580
2021-12-15,Santa Barbara,083,443738,47108,46681,1641,48322,562
2021-12-15,Santa Clara,085,1922200,155794,153928,1746,155674,1944
2021-12-15,Santa Cruz,087,273765,22092,21753,1043,22796,225
2021-12-15,Shasta,089,179085,22922,22778,3726,26504,427
2021-12-15,Sierra,091,2930,203,199,21,220,0
2021-12-15,Siskiyou,093,43540,3504,3434,1366,4800,58
2021-12-15,Solano,095,438530,47882,47098,1374,48472,367
2021-12-15,Sonoma,097,501317,44100,43580,595,44175,407
2021-12-15,Stanislaus,099,539301,82482,82628,9367,91995,1298
2021-12-15,Sutter,101,95872,14427,14428,409,14837,189
2021-12-15,Tehama,103,63373,8898,8806,1546,10352,136
2021-12-15,Trinity,105,12862,912,822,220,1042,17
2021-12-15,Tulare,107,460477,71935,70846,16370,87216,1120
2021-12-15,Tuolumne,109,53932,7869,7818,114,7932,91
2021-12-15,Ventura,111,848112,102580,101447,4504,105951,1199
2021-12-15,Yolo,113,214977,21040,20749,1220,21969,267
2021-12-15,Yuba,115,75493,10685,10587,401,10988,96
2021-12-14,Alameda,001,1643700,125348,124272,2970,127242,1506
2021-12-14,Alpine,003,1148,107,109,0,109,0
2021-12-14,Amador,005,37829,5825,5808,73,5881,69
2021-12-14,Butte,007,227075,22159,21901,4040,25941,326
2021-12-14,Calaveras,009,45235,4556,4517,64,4581,89
2021-12-14,Colusa,011,21464,2651,2628,683,3311,21
2021-12-14,Contra Costa,013,1133247,104002,103135,2370,105505,1064
2021-12-14,Del Norte,015,27424,3813,3788,55,3843,43
2021-12-14,El Dorado,017,186661,17180,16915,1820,18735,170
2021-12-14,Fresno,019,978130,148198,146756,13258,160014,2316
2021-12-14,Glenn,021,27897,3622,3589,1052,4641,39
2021-12-14,Humboldt,023,135768,9964,9836,716,10552,118
2021-12-14,Imperial,025,180216,36581,36049,3856,39905,789
2021-12-14,Inyo,027,18085,2624,2601,39,2640,46
2021-12-14,Kern,029,883053,134611,133498,24312,157810,1863
2021-12-14,Kings,031,150075,34038,33693,2040,35733,373
2021-12-14,Lake,033,64148,7018,6961,166,7127,115
2021-12-14,Lassen,035,31185,7095,7061,425,7486,55
2021-12-14,Los Angeles,037,10098052,1496757,1481131,56977,1538108,27099
2021-12-14,Madera,039,155013,24738,24535,2343,26878,313
2021-12-14,Marin,041,260295,18716,18491,555,19046,249
2021-12-14,Mariposa,043,17540,1480,1463,61,1524,6
2021-12-14,Mendocino,045,87422,8310,8206,689,8895,95
2021-12-14,Merced,047,269075,43932,43870,2183,46053,684
2021-12-14,Modoc,049,8938,597,595,203,798,6
2021-12-14,Mono,051,14174,1970,1955,22,1977,4
2021-12-14,Monterey,053,433212,50617,49237,3366,52603,635
2021-12-14,Napa,055,140530,13641,13528,132,13660,107
2021-12-14,Nevada,057,99092,10068,9956,349,10305,106
2021-12-14,Orange,059,3164182,320140,317465,16490,333955,5827
2021-12-14,Placer,061,380077,39657,39221,3942,43163,482
2021-12-14,Plumas,063,18699,2015,1950,48,1998,12
2021-12-14,Riverside,065,2383286,383109,378227,16811,395038,5427
2021-12-14,Sacramento,067,1510023,167958,166605,5097,171702,2394
2021-12-14,San Benito,069,59416,7889,7871,183,8054,79
2021-12-14,San Bernardino,071,2135413,374461,370604,11918,382522,6013
2021-12-14,San Diego,073,3302833,398133,395876,23252,419128,4393
2021-12-14,San Francisco,075,870044,56531,55278,2482,57760,679
2021-12-14,San Joaquin,077,732212,104286,103488,5645,109133,1848
2021-12-14,San Luis Obispo,079,281455,31170,30753,1371,32124,363
2021-12-14,San Mateo,081,765935,57065,55601,1012,56613,580
2021-12-14,Santa Barbara,083,443738,47006,46648,1637,48285,560
2021-12-14,Santa Clara,085,1922200,155473,153814,1733,155547,1945
2021-12-14,Santa Cruz,087,273765,22027,21737,1038,22775,225
2021-12-14,Shasta,089,179085,22895,22756,3725,26481,427
2021-12-14,Sierra,091,2930,201,199,21,220,0
2021-12-14,Siskiyou,093,43540,3499,3430,1365,4795,58
2021-12-14,Solano,095,438530,47835,47065,1368,48433,367
2021-12-14,Sonoma,097,501317,44017,43538,593,44131,407
2021-12-14,Stanislaus,099,539301,82396,82581,9351,91932,1293
2021-12-14,Sutter,101,95872,14415,14421,408,14829,189
2021-12-14,Tehama,103,63373,8894,8805,1546,10351,134
2021-12-14,Trinity,105,12862,912,821,220,1041,17
2021-12-14,Tulare,107,460477,71863,70803,16340,87143,1120
2021-12-14,Tuolumne,109,53932,7856,7815,114,7929,91
2021-12-14,Ventura,111,848112,102355,101343,4497,105840,1199
2021-12-14,Yolo,113,214977,21006,20734,1207,21941,267
2021-12-14,Yuba,115,75493,10668,10574,401,10975,92
2021-12-13,Alameda,001,1643700,125060,124174,2953,127127,1501
2021-12-13,Alpine,003,1148,107,109,0,109,0
2021-12-13,Amador,005,37829,5821,5797,73,5870,69
2021-12-13,Butte,007,227075,22135,21889,4036,25925,326
2021-12-13,Calaveras,009,45235,4549,4507,63,4570,89
2021-12-13,Colusa,011,21464,2649,2627,683,3310,21
2021-12-13,Contra Costa,013,1133247,103851,103041,2359,105400,1064
2021-12-13,Del Norte,015,27424,3809,3787,55,3842,42
2021-12-13,El Dorado,017,186661,17157,16896,1818,18714,170
2021-12-13,Fresno,019,978130,148047,146641,13248,159889,2312
2021-12-13,Glenn,021,27897,3617,3589,1050,4639,37
2021-12-13,Humboldt,023,135768,9935,9821,712,10533,118
2021-12-13,Imperial,025,180216,36497,35974,3835,39809,787
2021-12-13,Inyo,027,18085,2623,2592,39,2631,46
2021-12-13,Kern,029,883053,134485,133381,24259,157640,1863
2021-12-13,Kings,031,150075,33995,33680,2035,35715,372
2021-12-13,Lake,033,64148,7016,6958,164,7122,115
2021-12-13,Lassen,035,31185,7094,7057,425,7482,55
2021-12-13,Los Angeles,037,10098052,1493974,1480195,56816,1537011,27085
2021-12-13,Madera,039,155013,24709,24527,2338,26865,311
2021-12-13,Marin,041,260295,18656,18471,552,19023,249
2021-12-13,Mariposa,043,17540,1478,1462,61,1523,6
2021-12-13,Mendocino,045,87422,8297,8196,687,8883,95
2021-12-13,Merced,047,269075,43892,43848,2179,46027,682
2021-12-13,Modoc,049,8938,596,595,203,798,6
2021-12-13,Mono,051,14174,1963,1952,22,1974,4
2021-12-13,Monterey,053,433212,50565,49222,3347,52569,631
2021-12-13,Napa,055,140530,13628,13518,132,13650,107
2021-12-13,Nevada,057,99092,10049,9946,348,10294,106
2021-12-13,Orange,059,3164182,319671,317112,16437,333549,5824
2021-12-13,Placer,061,380077,39596,39168,3931,43099,481
2021-12-13,Plumas,063,18699,2011,1943,48,1991,12
2021-12-13,Riverside,065,2383286,382527,377728,16796,394524,5414
2021-12-13,Sacramento,067,1510023,167680,166439,5065,171504,2392
2021-12-13,San Benito,069,59416,7880,7856,183,8039,79
2021-12-13,San Bernardino,071,2135413,373881,370274,11910,382184,6011
2021-12-13,San Diego,073,3302833,397328,395266,23199,418465,4389
2021-12-13,San Francisco,075,870044,56261,55245,2469,57714,678
2021-12-13,San Joaquin,077,732212,104171,103449,5636,109085,1846
2021-12-13,San Luis Obispo,079,281455,31120,30746,1367,32113,363
2021-12-13,San Mateo,081,765935,56906,55569,1003,56572,580
2021-12-13,Santa Barbara,083,443738,46918,46608,1632,48240,560
2021-12-13,Santa Clara,085,1922200,155208,153672,1722,155394,1944
2021-12-13,Santa Cruz,087,273765,21972,21698,1035,22733,225
2021-12-13,Shasta,089,179085,22874,22731,3723,26454,426
2021-12-13,Sierra,091,2930,201,199,21,220,0
2021-12-13,Siskiyou,093,43540,3495,3426,1362,4788,57
2021-12-13,Solano,095,438530,47761,47045,1363,48408,365
2021-12-13,Sonoma,097,501317,43921,43492,591,44083,407
2021-12-13,Stanislaus,099,539301,82280,82507,9328,91835,1282
2021-12-13,Sutter,101,95872,14408,14408,408,14816,188
2021-12-13,Tehama,103,63373,8882,8800,1546,10346,134
2021-12-13,Trinity,105,12862,912,820,220,1040,17
2021-12-13,Tulare,107,460477,71805,70758,16316,87074,1114
2021-12-13,Tuolumne,109,53932,7845,7804,114,7918,91
2021-12-13,Ventura,111,848112,102130,101180,4486,105666,1197
2021-12-13,Yolo,113,214977,20957,20706,1202,21908,267
2021-12-13,Yuba,115,75493,10651,10570,401,10971,92
2021-12-12,Alameda,001,1643700,124778,124075,2941,127016,1503
2021-12-12,Alpine,003,1148,107,109,0,109,0
2021-12-12,Amador,005,37829,5813,5797,72,5869,69
2021-12-12,Butte,007,227075,22111,21874,4030,25904,326
2021-12-12,Calaveras,009,45235,4538,4501,63,4564,89
2021-12-12,Colusa,011,21464,2644,2627,680,3307,21
2021-12-12,Contra Costa,013,1133247,103664,102976,2357,105333,1065
2021-12-12,Del Norte,015,27424,3806,3793,55,3848,42
2021-12-12,El Dorado,017,186661,17121,16890,1810,18700,170
2021-12-12,Fresno,019,978130,147885,146518,13233,159751,2310
2021-12-12,Glenn,021,27897,3614,3589,1050,4639,37
2021-12-12,Humboldt,023,135768,9910,9804,705,10509,118
2021-12-12,Imperial,025,180216,36363,35926,3804,39730,787
2021-12-12,Inyo,027,18085,2618,2592,39,2631,46
2021-12-12,Kern,029,883053,134319,133314,24218,157532,1861
2021-12-12,Kings,031,150075,33944,33661,2033,35694,372
2021-12-12,Lake,033,64148,7009,6955,162,7117,115
2021-12-12,Lassen,035,31185,7093,7057,425,7482,55
2021-12-12,Los Angeles,037,10098052,1491062,1479054,56635,1535689,27074
2021-12-12,Madera,039,155013,24680,24493,2331,26824,311
2021-12-12,Marin,041,260295,18603,18451,548,18999,249
2021-12-12,Mariposa,043,17540,1477,1461,61,1522,6
2021-12-12,Mendocino,045,87422,8284,8190,686,8876,95
2021-12-12,Merced,047,269075,43859,43821,2172,45993,682
2021-12-12,Modoc,049,8938,596,595,202,797,6
2021-12-12,Mono,051,14174,1959,1947,22,1969,4
2021-12-12,Monterey,053,433212,50512,49192,3321,52513,631
2021-12-12,Napa,055,140530,13585,13508,130,13638,107
2021-12-12,Nevada,057,99092,10023,9938,347,10285,106
2021-12-12,Orange,059,3164182,319165,316918,16372,333290,5825
2021-12-12,Placer,061,380077,39531,39139,3925,43064,481
2021-12-12,Plumas,063,18699,2007,1942,46,1988,12
2021-12-12,Riverside,065,2383286,381850,377467,16771,394238,5414
2021-12-12,Sacramento,067,1510023,167413,166291,5044,171335,2392
2021-12-12,San Benito,069,59416,7860,7853,183,8036,79
2021-12-12,San Bernardino,071,2135413,373236,369977,11886,381863,6011
2021-12-12,San Diego,073,3302833,396433,393307,23161,416468,4378
2021-12-12,San Francisco,075,870044,56005,55180,2457,57637,678
2021-12-12,San Joaquin,077,732212,104032,103405,5626,109031,1846
2021-12-12,San Luis Obispo,079,281455,31067,30719,1365,32084,363
2021-12-12,San Mateo,081,765935,56789,55505,999,56504,580
2021-12-12,Santa Barbara,083,443738,46843,46586,1630,48216,560
2021-12-12,Santa Clara,085,1922200,154928,153452,1708,155160,1945
2021-12-12,Santa Cruz,087,273765,21923,21671,1033,22704,225
2021-12-12,Shasta,089,179085,22846,22732,3722,26454,426
2021-12-12,Sierra,091,2930,201,199,21,220,0
2021-12-12,Siskiyou,093,43540,3495,3424,1362,4786,57
2021-12-12,Solano,095,438530,47695,47021,1360,48381,365
2021-12-12,Sonoma,097,501317,43828,43424,588,44012,407
2021-12-12,Stanislaus,099,539301,82182,82460,9315,91775,1282
2021-12-12,Sutter,101,95872,14397,14396,408,14804,189
2021-12-12,Tehama,103,63373,8871,8796,1544,10340,134
2021-12-12,Trinity,105,12862,910,820,220,1040,17
2021-12-12,Tulare,107,460477,71728,70733,16274,87007,1115
2021-12-12,Tuolumne,109,53932,7828,7794,114,7908,91
2021-12-12,Ventura,111,848112,101937,101105,4472,105577,1197
2021-12-12,Yolo,113,214977,20907,20685,1190,21875,267
2021-12-12,Yuba,115,75493,10637,10565,398,10963,92
2021-12-11,Alameda,001,1643700,124642,123572,2939,126511,1496
2021-12-11,Alpine,003,1148,107,109,0,109,0
2021-12-11,Amador,005,37829,5808,5787,72,5859,69
2021-12-11,Butte,007,227075,22097,21819,4028,25847,326
2021-12-11,Calaveras,009,45235,4530,4469,62,4531,89
2021-12-11,Colusa,011,21464,2640,2619,679,3298,21
2021-12-11,Contra Costa,013,1133247,103578,102618,2355,104973,1061
2021-12-11,Del Norte,015,27424,3806,3778,55,3833,42
2021-12-11,El Dorado,017,186661,17101,16796,1809,18605,170
2021-12-11,Fresno,019,978130,147798,145988,13224,159212,2294
2021-12-11,Glenn,021,27897,3613,3585,1050,4635,37
2021-12-11,Humboldt,023,135768,9893,9721,702,10423,118
2021-12-11,Imperial,025,180216,36305,35635,3795,39430,782
2021-12-11,Inyo,027,18085,2613,2576,39,2615,46
2021-12-11,Kern,029,883053,134250,132852,24184,157036,1854
2021-12-11,Kings,031,150075,33931,33530,2031,35561,371
2021-12-11,Lake,033,64148,7008,6932,160,7092,114
2021-12-11,Lassen,035,31185,7092,7049,425,7474,55
2021-12-11,Los Angeles,037,10098052,1489848,1474030,56544,1530574,27031
2021-12-11,Madera,039,155013,24674,24417,2330,26747,311
2021-12-11,Marin,041,260295,18570,18339,545,18884,249
2021-12-11,Mariposa,043,17540,1476,1450,61,1511,6
2021-12-11,Mendocino,045,87422,8277,8130,686,8816,95
2021-12-11,Merced,047,269075,43840,43690,2171,45861,681
2021-12-11,Modoc,049,8938,596,594,202,796,6
2021-12-11,Mono,051,14174,1955,1926,22,1948,4
2021-12-11,Monterey,053,433212,50484,49008,3318,52326,631
2021-12-11,Napa,055,140530,13568,13459,130,13589,107
2021-12-11,Nevada,057,99092,10010,9880,347,10227,106
2021-12-11,Orange,059,3164182,318914,315759,16345,332104,5805
2021-12-11,Placer,061,380077,39473,38959,3918,42877,481
2021-12-11,Plumas,063,18699,2001,1934,46,1980,12
2021-12-11,Riverside,065,2383286,381430,375649,16756,392405,5408
2021-12-11,Sacramento,067,1510023,167282,165530,5037,170567,2386
2021-12-11,San Benito,069,59416,7846,7808,183,7991,79
2021-12-11,San Bernardino,071,2135413,372872,368145,11876,380021,6007
2021-12-11,San Diego,073,3302833,396010,392274,23123,415397,4374
2021-12-11,San Francisco,075,870044,55852,54869,2452,57321,678
2021-12-11,San Joaquin,077,732212,103971,103013,5622,108635,1842
2021-12-11,San Luis Obispo,079,281455,31045,30567,1361,31928,362
2021-12-11,San Mateo,081,765935,56710,55284,997,56281,580
2021-12-11,Santa Barbara,083,443738,46808,46309,1630,47939,559
2021-12-11,Santa Clara,085,1922200,154730,152846,1696,154542,1941
2021-12-11,Santa Cruz,087,273765,21899,21557,1033,22590,225
2021-12-11,Shasta,089,179085,22831,22660,3718,26378,419
2021-12-11,Sierra,091,2930,201,199,21,220,0
2021-12-11,Siskiyou,093,43540,3489,3418,1359,4777,57
2021-12-11,Solano,095,438530,47666,46891,1356,48247,365
2021-12-11,Sonoma,097,501317,43780,43227,588,43815,407
2021-12-11,Stanislaus,099,539301,82133,82133,9306,91439,1264
2021-12-11,Sutter,101,95872,14388,14354,408,14762,187
2021-12-11,Tehama,103,63373,8868,8776,1542,10318,134
2021-12-11,Trinity,105,12862,910,819,220,1039,17
2021-12-11,Tulare,107,460477,71684,70523,16264,86787,1103
2021-12-11,Tuolumne,109,53932,7819,7760,114,7874,91
2021-12-11,Ventura,111,848112,101862,100711,4465,105176,1195
2021-12-11,Yolo,113,214977,20888,20608,1186,21794,267
2021-12-11,Yuba,115,75493,10625,10519,397,10916,92
2021-12-10,Alameda,001,1643700,124518,123572,2931,126503,1496
2021-12-10,Alpine,003,1148,106,109,0,109,0
2021-12-10,Amador,005,37829,5801,5787,72,5859,69
2021-12-10,Butte,007,227075,22084,21819,4026,25845,326
2021-12-10,Calaveras,009,45235,4527,4469,62,4531,89
2021-12-10,Colusa,011,21464,2639,2619,679,3298,21
2021-12-10,Contra Costa,013,1133247,103482,102618,2354,104972,1061
2021-12-10,Del Norte,015,27424,3806,3778,55,3833,42
2021-12-10,El Dorado,017,186661,17088,16796,1809,18605,170
2021-12-10,Fresno,019,978130,147710,145988,13213,159201,2294
2021-12-10,Glenn,021,27897,3613,3585,1050,4635,37
2021-12-10,Humboldt,023,135768,9876,9721,700,10421,118
2021-12-10,Imperial,025,180216,36250,35635,3780,39415,782
2021-12-10,Inyo,027,18085,2610,2576,39,2615,46
2021-12-10,Kern,029,883053,134161,132852,24160,157012,1854
2021-12-10,Kings,031,150075,33916,33530,2029,35559,371
2021-12-10,Lake,033,64148,7001,6932,160,7092,114
2021-12-10,Lassen,035,31185,7091,7049,425,7474,55
2021-12-10,Los Angeles,037,10098052,1488760,1474030,56457,1530487,27031
2021-12-10,Madera,039,155013,24656,24417,2328,26745,311
2021-12-10,Marin,041,260295,18548,18339,545,18884,249
2021-12-10,Mariposa,043,17540,1473,1450,61,1511,6
2021-12-10,Mendocino,045,87422,8270,8130,685,8815,95
2021-12-10,Merced,047,269075,43822,43690,2169,45859,681
2021-12-10,Modoc,049,8938,596,594,202,796,6
2021-12-10,Mono,051,14174,1952,1926,22,1948,4
2021-12-10,Monterey,053,433212,50447,49008,3312,52320,631
2021-12-10,Napa,055,140530,13556,13459,129,13588,107
2021-12-10,Nevada,057,99092,10001,9880,347,10227,106
2021-12-10,Orange,059,3164182,318644,315759,16313,332072,5805
2021-12-10,Placer,061,380077,39430,38959,3915,42874,481
2021-12-10,Plumas,063,18699,1999,1934,46,1980,12
2021-12-10,Riverside,065,2383286,381023,375649,16746,392395,5408
2021-12-10,Sacramento,067,1510023,167129,165530,5035,170565,2386
2021-12-10,San Benito,069,59416,7842,7808,183,7991,79
2021-12-10,San Bernardino,071,2135413,372501,368145,11853,379998,6007
2021-12-10,San Diego,073,3302833,395530,392274,23109,415383,4374
2021-12-10,San Francisco,075,870044,55767,54869,2446,57315,678
2021-12-10,San Joaquin,077,732212,103916,103013,5618,108631,1842
2021-12-10,San Luis Obispo,079,281455,31035,30567,1358,31925,362
2021-12-10,San Mateo,081,765935,56653,55284,994,56278,580
2021-12-10,Santa Barbara,083,443738,46772,46309,1629,47938,559
2021-12-10,Santa Clara,085,1922200,154560,152846,1683,154529,1941
2021-12-10,Santa Cruz,087,273765,21879,21557,1032,22589,225
2021-12-10,Shasta,089,179085,22820,22660,3715,26375,419
2021-12-10,Sierra,091,2930,201,199,21,220,0
2021-12-10,Siskiyou,093,43540,3482,3418,1359,4777,57
2021-12-10,Solano,095,438530,47624,46891,1352,48243,365
2021-12-10,Sonoma,097,501317,43746,43227,587,43814,407
2021-12-10,Stanislaus,099,539301,82067,82133,9300,91433,1264
2021-12-10,Sutter,101,95872,14380,14354,408,14762,187
2021-12-10,Tehama,103,63373,8866,8776,1540,10316,134
2021-12-10,Trinity,105,12862,910,819,220,1039,17
2021-12-10,Tulare,107,460477,71655,70523,16240,86763,1103
2021-12-10,Tuolumne,109,53932,7813,7760,114,7874,91
2021-12-10,Ventura,111,848112,101758,100711,4462,105173,1195
2021-12-10,Yolo,113,214977,20874,20608,1184,21792,267
2021-12-10,Yuba,115,75493,10613,10519,396,10915,92
2021-12-09,Alameda,001,1643700,124374,123572,2926,126498,1496
2021-12-09,Alpine,003,1148,106,109,0,109,0
2021-12-09,Amador,005,37829,5798,5787,71,5858,69
2021-12-09,Butte,007,227075,22064,21819,4022,25841,326
2021-12-09,Calaveras,009,45235,4518,4469,62,4531,89
2021-12-09,Colusa,011,21464,2637,2619,679,3298,21
2021-12-09,Contra Costa,013,1133247,103363,102618,2348,104966,1061
2021-12-09,Del Norte,015,27424,3805,3778,55,3833,42
2021-12-09,El Dorado,017,186661,17060,16796,1804,18600,170
2021-12-09,Fresno,019,978130,147563,145988,13201,159189,2294
2021-12-09,Glenn,021,27897,3613,3585,1050,4635,37
2021-12-09,Humboldt,023,135768,9853,9721,699,10420,118
2021-12-09,Imperial,025,180216,36179,35635,3751,39386,782
2021-12-09,Inyo,027,18085,2608,2576,39,2615,46
2021-12-09,Kern,029,883053,134035,132852,24127,156979,1854
2021-12-09,Kings,031,150075,33889,33530,2026,35556,371
2021-12-09,Lake,033,64148,6993,6932,160,7092,114
2021-12-09,Lassen,035,31185,7089,7049,425,7474,55
2021-12-09,Los Angeles,037,10098052,1487220,1474030,56372,1530402,27031
2021-12-09,Madera,039,155013,24631,24417,2325,26742,311
2021-12-09,Marin,041,260295,18534,18339,543,18882,249
2021-12-09,Mariposa,043,17540,1472,1450,61,1511,6
2021-12-09,Mendocino,045,87422,8257,8130,682,8812,95
2021-12-09,Merced,047,269075,43784,43690,2157,45847,681
2021-12-09,Modoc,049,8938,596,594,202,796,6
2021-12-09,Mono,051,14174,1948,1926,22,1948,4
2021-12-09,Monterey,053,433212,50400,49008,3301,52309,631
2021-12-09,Napa,055,140530,13536,13459,125,13584,107
2021-12-09,Nevada,057,99092,9982,9880,347,10227,106
2021-12-09,Orange,059,3164182,318312,315759,16274,332033,5805
2021-12-09,Placer,061,380077,39386,38959,3902,42861,481
2021-12-09,Plumas,063,18699,1991,1934,46,1980,12
2021-12-09,Riverside,065,2383286,380473,375649,16730,392379,5408
2021-12-09,Sacramento,067,1510023,166908,165530,5020,170550,2386
2021-12-09,San Benito,069,59416,7830,7808,182,7990,79
2021-12-09,San Bernardino,071,2135413,371991,368145,11829,379974,6007
2021-12-09,San Diego,073,3302833,394883,392274,23079,415353,4374
2021-12-09,San Francisco,075,870044,55682,54869,2439,57308,678
2021-12-09,San Joaquin,077,732212,103824,103013,5612,108625,1842
2021-12-09,San Luis Obispo,079,281455,31007,30567,1356,31923,362
2021-12-09,San Mateo,081,765935,56565,55284,992,56276,580
2021-12-09,Santa Barbara,083,443738,46692,46309,1623,47932,559
2021-12-09,Santa Clara,085,1922200,154346,152846,1672,154518,1941
2021-12-09,Santa Cruz,087,273765,21851,21557,1032,22589,225
2021-12-09,Shasta,089,179085,22804,22660,3714,26374,419
2021-12-09,Sierra,091,2930,201,199,21,220,0
2021-12-09,Siskiyou,093,43540,3478,3418,1358,4776,57
2021-12-09,Solano,095,438530,47587,46891,1350,48241,365
2021-12-09,Sonoma,097,501317,43689,43227,585,43812,407
2021-12-09,Stanislaus,099,539301,81997,82133,9285,91418,1264
2021-12-09,Sutter,101,95872,14365,14354,408,14762,187
2021-12-09,Tehama,103,63373,8859,8776,1538,10314,134
2021-12-09,Trinity,105,12862,910,819,220,1039,17
2021-12-09,Tulare,107,460477,71600,70523,16211,86734,1103
2021-12-09,Tuolumne,109,53932,7802,7760,113,7873,91
2021-12-09,Ventura,111,848112,101613,100711,4450,105161,1195
2021-12-09,Yolo,113,214977,20851,20608,1176,21784,267
2021-12-09,Yuba,115,75493,10605,10519,393,10912,92
2021-12-08,Alameda,001,1643700,124224,123438,2916,126354,1496
2021-12-08,Alpine,003,1148,106,108,0,108,0
2021-12-08,Amador,005,37829,5793,5781,71,5852,69
2021-12-08,Butte,007,227075,22047,21780,4019,25799,326
2021-12-08,Calaveras,009,45235,4510,4455,62,4517,89
2021-12-08,Colusa,011,21464,2634,2619,678,3297,21
2021-12-08,Contra Costa,013,1133247,103234,102506,2348,104854,1058
2021-12-08,Del Norte,015,27424,3804,3767,55,3822,42
2021-12-08,El Dorado,017,186661,17028,16757,1804,18561,170
2021-12-08,Fresno,019,978130,147402,145830,13187,159017,2293
2021-12-08,Glenn,021,27897,3613,3584,1046,4630,37
2021-12-08,Humboldt,023,135768,9832,9704,697,10401,117
2021-12-08,Imperial,025,180216,36098,35537,3721,39258,782
2021-12-08,Inyo,027,18085,2605,2570,39,2609,46
2021-12-08,Kern,029,883053,133912,132709,24079,156788,1846
2021-12-08,Kings,031,150075,33854,33468,2025,35493,371
2021-12-08,Lake,033,64148,6987,6927,159,7086,114
2021-12-08,Lassen,035,31185,7088,7041,423,7464,55
2021-12-08,Los Angeles,037,10098052,1485672,1472410,56262,1528672,27018
2021-12-08,Madera,039,155013,24610,24396,2318,26714,311
2021-12-08,Marin,041,260295,18513,18305,540,18845,249
2021-12-08,Mariposa,043,17540,1469,1447,61,1508,6
2021-12-08,Mendocino,045,87422,8244,8118,681,8799,95
2021-12-08,Merced,047,269075,43752,43631,2150,45781,680
2021-12-08,Modoc,049,8938,596,594,202,796,6
2021-12-08,Mono,051,14174,1942,1924,22,1946,4
2021-12-08,Monterey,053,433212,50335,48957,3286,52243,631
2021-12-08,Napa,055,140530,13522,13421,125,13546,107
2021-12-08,Nevada,057,99092,9966,9862,347,10209,106
2021-12-08,Orange,059,3164182,317964,315421,16237,331658,5795
2021-12-08,Placer,061,380077,39335,38934,3898,42832,478
2021-12-08,Plumas,063,18699,1989,1924,46,1970,12
2021-12-08,Riverside,065,2383286,379961,375099,16707,391806,5404
2021-12-08,Sacramento,067,1510023,166653,165278,4993,170271,2373
2021-12-08,San Benito,069,59416,7821,7793,182,7975,79
2021-12-08,San Bernardino,071,2135413,371509,367516,11804,379320,6006
2021-12-08,San Diego,073,3302833,394233,391676,23047,414723,4369
2021-12-08,San Francisco,075,870044,55595,54792,2431,57223,677
2021-12-08,San Joaquin,077,732212,103722,102877,5603,108480,1841
2021-12-08,San Luis Obispo,079,281455,30958,30519,1351,31870,361
2021-12-08,San Mateo,081,765935,56498,55220,986,56206,580
2021-12-08,Santa Barbara,083,443738,46637,46250,1620,47870,558
2021-12-08,Santa Clara,085,1922200,154184,152674,1661,154335,1937
2021-12-08,Santa Cruz,087,273765,21805,21505,1030,22535,224
2021-12-08,Shasta,089,179085,22784,22616,3708,26324,419
2021-12-08,Sierra,091,2930,201,199,21,220,0
2021-12-08,Siskiyou,093,43540,3477,3415,1356,4771,57
2021-12-08,Solano,095,438530,47557,46837,1349,48186,365
2021-12-08,Sonoma,097,501317,43627,43179,584,43763,405
2021-12-08,Stanislaus,099,539301,81915,82038,9272,91310,1264
2021-12-08,Sutter,101,95872,14349,14336,406,14742,187
2021-12-08,Tehama,103,63373,8850,8768,1538,10306,133
2021-12-08,Trinity,105,12862,910,818,220,1038,17
2021-12-08,Tulare,107,460477,71537,70472,16186,86658,1102
2021-12-08,Tuolumne,109,53932,7789,7749,113,7862,91
2021-12-08,Ventura,111,848112,101484,100647,4447,105094,1194
2021-12-08,Yolo,113,214977,20825,20575,1170,21745,267
2021-12-08,Yuba,115,75493,10591,10499,390,10889,92
2021-12-07,Alameda,001,1643700,124049,123325,2908,126233,1497
2021-12-07,Alpine,003,1148,106,108,0,108,0
2021-12-07,Amador,005,37829,5790,5778,70,5848,69
2021-12-07,Butte,007,227075,22022,21761,4013,25774,324
2021-12-07,Calaveras,009,45235,4493,4445,62,4507,88
2021-12-07,Colusa,011,21464,2632,2619,678,3297,21
2021-12-07,Contra Costa,013,1133247,103115,102421,2340,104761,1058
2021-12-07,Del Norte,015,27424,3803,3766,55,3821,42
2021-12-07,El Dorado,017,186661,17002,16742,1801,18543,170
2021-12-07,Fresno,019,978130,147254,145715,13173,158888,2289
2021-12-07,Glenn,021,27897,3612,3579,1046,4625,36
2021-12-07,Humboldt,023,135768,9806,9693,692,10385,117
2021-12-07,Imperial,025,180216,36020,35502,3700,39202,778
2021-12-07,Inyo,027,18085,2602,2567,39,2606,46
2021-12-07,Kern,029,883053,133752,132564,24026,156590,1838
2021-12-07,Kings,031,150075,33822,33441,2022,35463,372
2021-12-07,Lake,033,64148,6982,6925,159,7084,113
2021-12-07,Lassen,035,31185,7086,7040,422,7462,55
2021-12-07,Los Angeles,037,10098052,1483894,1470904,56162,1527066,27007
2021-12-07,Madera,039,155013,24587,24367,2311,26678,311
2021-12-07,Marin,041,260295,18480,18284,534,18818,249
2021-12-07,Mariposa,043,17540,1467,1446,61,1507,6
2021-12-07,Mendocino,045,87422,8225,8107,681,8788,95
2021-12-07,Merced,047,269075,43711,43600,2143,45743,675
2021-12-07,Modoc,049,8938,596,594,201,795,6
2021-12-07,Mono,051,14174,1940,1921,22,1943,4
2021-12-07,Monterey,053,433212,50252,48880,3269,52149,631
2021-12-07,Napa,055,140530,13504,13409,125,13534,107
2021-12-07,Nevada,057,99092,9951,9858,346,10204,105
2021-12-07,Orange,059,3164182,317631,315138,16188,331326,5784
2021-12-07,Placer,061,380077,39259,38860,3894,42754,474
2021-12-07,Plumas,063,18699,1985,1915,46,1961,12
2021-12-07,Riverside,065,2383286,379428,374552,16691,391243,5397
2021-12-07,Sacramento,067,1510023,166406,165148,4979,170127,2375
2021-12-07,San Benito,069,59416,7804,7776,182,7958,78
2021-12-07,San Bernardino,071,2135413,370918,366981,11786,378767,6007
2021-12-07,San Diego,073,3302833,393390,391110,23009,414119,4357
2021-12-07,San Francisco,075,870044,55484,54729,2426,57155,676
2021-12-07,San Joaquin,077,732212,103605,102797,5591,108388,1839
2021-12-07,San Luis Obispo,079,281455,30918,30495,1349,31844,361
2021-12-07,San Mateo,081,765935,56406,55163,980,56143,580
2021-12-07,Santa Barbara,083,443738,46565,46205,1618,47823,556
2021-12-07,Santa Clara,085,1922200,154000,152465,1652,154117,1941
2021-12-07,Santa Cruz,087,273765,21758,21493,1030,22523,224
2021-12-07,Shasta,089,179085,22762,22594,3705,26299,418
2021-12-07,Sierra,091,2930,201,199,21,220,0
2021-12-07,Siskiyou,093,43540,3475,3412,1356,4768,57
2021-12-07,Solano,095,438530,47517,46812,1347,48159,365
2021-12-07,Sonoma,097,501317,43553,43154,583,43737,405
2021-12-07,Stanislaus,099,539301,81838,81980,9261,91241,1258
2021-12-07,Sutter,101,95872,14341,14322,405,14727,186
2021-12-07,Tehama,103,63373,8842,8765,1537,10302,133
2021-12-07,Trinity,105,12862,910,818,220,1038,17
2021-12-07,Tulare,107,460477,71481,70411,16158,86569,1103
2021-12-07,Tuolumne,109,53932,7781,7743,113,7856,91
2021-12-07,Ventura,111,848112,101387,100569,4437,105006,1194
2021-12-07,Yolo,113,214977,20799,20560,1167,21727,263
2021-12-07,Yuba,115,75493,10573,10491,389,10880,91
2021-12-06,Alameda,001,1643700,123885,123227,2905,126132,1496
2021-12-06,Alpine,003,1148,106,108,0,108,0
2021-12-06,Amador,005,37829,5783,5769,69,5838,67
2021-12-06,Butte,007,227075,22004,21732,4010,25742,321
2021-12-06,Calaveras,009,45235,4486,4443,62,4505,88
2021-12-06,Colusa,011,21464,2631,2615,674,3289,21
2021-12-06,Contra Costa,013,1133247,102994,102327,2336,104663,1058
2021-12-06,Del Norte,015,27424,3801,3744,55,3799,42
2021-12-06,El Dorado,017,186661,16977,16726,1799,18525,168
2021-12-06,Fresno,019,978130,147056,145539,13163,158702,2285
2021-12-06,Glenn,021,27897,3609,3577,1045,4622,36
2021-12-06,Humboldt,023,135768,9786,9671,685,10356,117
2021-12-06,Imperial,025,180216,35939,35453,3682,39135,778
2021-12-06,Inyo,027,18085,2596,2562,38,2600,46
2021-12-06,Kern,029,883053,133565,132366,23970,156336,1835
2021-12-06,Kings,031,150075,33789,33399,2017,35416,368
2021-12-06,Lake,033,64148,6978,6922,159,7081,113
2021-12-06,Lassen,035,31185,7081,7032,420,7452,51
2021-12-06,Los Angeles,037,10098052,1482231,1470059,56070,1526129,26993
2021-12-06,Madera,039,155013,24560,24334,2308,26642,307
2021-12-06,Marin,041,260295,18452,18252,532,18784,249
2021-12-06,Mariposa,043,17540,1464,1443,61,1504,6
2021-12-06,Mendocino,045,87422,8212,8079,677,8756,95
2021-12-06,Merced,047,269075,43671,43549,2133,45682,672
2021-12-06,Modoc,049,8938,596,593,201,794,6
2021-12-06,Mono,051,14174,1935,1913,22,1935,4
2021-12-06,Monterey,053,433212,50175,48831,3250,52081,626
2021-12-06,Napa,055,140530,13481,13387,123,13510,107
2021-12-06,Nevada,057,99092,9923,9847,345,10192,105
2021-12-06,Orange,059,3164182,317251,314859,16146,331005,5771
2021-12-06,Placer,061,380077,39201,38785,3889,42674,473
2021-12-06,Plumas,063,18699,1977,1913,46,1959,10
2021-12-06,Riverside,065,2383286,378902,374116,16677,390793,5388
2021-12-06,Sacramento,067,1510023,166130,164926,4958,169884,2367
2021-12-06,San Benito,069,59416,7788,7755,182,7937,78
2021-12-06,San Bernardino,071,2135413,370357,366606,11759,378365,5998
2021-12-06,San Diego,073,3302833,392544,390389,22964,413353,4352
2021-12-06,San Francisco,075,870044,55376,54659,2421,57080,674
2021-12-06,San Joaquin,077,732212,103478,102728,5584,108312,1837
2021-12-06,San Luis Obispo,079,281455,30881,30464,1347,31811,361
2021-12-06,San Mateo,081,765935,56332,55112,977,56089,580
2021-12-06,Santa Barbara,083,443738,46472,46146,1617,47763,556
2021-12-06,Santa Clara,085,1922200,153791,152310,1635,153945,1937
2021-12-06,Santa Cruz,087,273765,21723,21450,1027,22477,224
2021-12-06,Shasta,089,179085,22739,22556,3697,26253,416
2021-12-06,Sierra,091,2930,200,198,21,219,0
2021-12-06,Siskiyou,093,43540,3473,3409,1351,4760,57
2021-12-06,Solano,095,438530,47472,46748,1346,48094,360
2021-12-06,Sonoma,097,501317,43482,43114,575,43689,405
2021-12-06,Stanislaus,099,539301,81744,81889,9227,91116,1241
2021-12-06,Sutter,101,95872,14329,14319,405,14724,186
2021-12-06,Tehama,103,63373,8834,8760,1537,10297,133
2021-12-06,Trinity,105,12862,910,815,219,1034,17
2021-12-06,Tulare,107,460477,71404,70285,16119,86404,1101
2021-12-06,Tuolumne,109,53932,7767,7726,113,7839,91
2021-12-06,Ventura,111,848112,101285,100426,4429,104855,1194
2021-12-06,Yolo,113,214977,20775,20548,1166,21714,263
2021-12-06,Yuba,115,75493,10558,10480,384,10864,91
2021-12-05,Alameda,001,1643700,123700,123104,2898,126002,1496
2021-12-05,Alpine,003,1148,105,108,0,108,0
2021-12-05,Amador,005,37829,5780,5761,69,5830,67
2021-12-05,Butte,007,227075,21971,21720,4004,25724,320
2021-12-05,Calaveras,009,45235,4470,4434,62,4496,88
2021-12-05,Colusa,011,21464,2630,2615,673,3288,21
2021-12-05,Contra Costa,013,1133247,102862,102251,2326,104577,1058
2021-12-05,Del Norte,015,27424,3799,3751,55,3806,42
2021-12-05,El Dorado,017,186661,16939,16717,1794,18511,168
2021-12-05,Fresno,019,978130,146882,145452,13142,158594,2284
2021-12-05,Glenn,021,27897,3607,3577,1044,4621,36
2021-12-05,Humboldt,023,135768,9755,9662,682,10344,117
2021-12-05,Imperial,025,180216,35845,35422,3653,39075,778
2021-12-05,Inyo,027,18085,2589,2559,38,2597,46
2021-12-05,Kern,029,883053,133401,132286,23918,156204,1833
2021-12-05,Kings,031,150075,33726,33360,2017,35377,369
2021-12-05,Lake,033,64148,6973,6919,158,7077,113
2021-12-05,Lassen,035,31185,7079,7031,420,7451,51
2021-12-05,Los Angeles,037,10098052,1480382,1468937,55934,1524871,26991
2021-12-05,Madera,039,155013,24519,24311,2305,26616,307
2021-12-05,Marin,041,260295,18405,18216,524,18740,249
2021-12-05,Mariposa,043,17540,1461,1440,60,1500,6
2021-12-05,Mendocino,045,87422,8193,8069,671,8740,95
2021-12-05,Merced,047,269075,43626,43534,2124,45658,672
2021-12-05,Modoc,049,8938,596,593,201,794,6
2021-12-05,Mono,051,14174,1928,1907,22,1929,4
2021-12-05,Monterey,053,433212,50103,48813,3218,52031,626
2021-12-05,Napa,055,140530,13455,13382,120,13502,107
2021-12-05,Nevada,057,99092,9902,9827,345,10172,105
2021-12-05,Orange,059,3164182,316816,314560,16104,330664,5771
2021-12-05,Placer,061,380077,39143,38738,3880,42618,473
2021-12-05,Plumas,063,18699,1973,1913,45,1958,9
2021-12-05,Riverside,065,2383286,378244,373827,16647,390474,5388
2021-12-05,Sacramento,067,1510023,165825,164721,4940,169661,2367
2021-12-05,San Benito,069,59416,7771,7748,181,7929,78
2021-12-05,San Bernardino,071,2135413,369649,366282,11712,377994,5998
2021-12-05,San Diego,073,3302833,391749,387979,22915,410894,4351
2021-12-05,San Francisco,075,870044,55275,54603,2419,57022,674
2021-12-05,San Joaquin,077,732212,103337,102698,5579,108277,1837
2021-12-05,San Luis Obispo,079,281455,30811,30454,1344,31798,360
2021-12-05,San Mateo,081,765935,56243,55050,967,56017,580
2021-12-05,Santa Barbara,083,443738,46389,46097,1609,47706,555
2021-12-05,Santa Clara,085,1922200,153538,152114,1616,153730,1933
2021-12-05,Santa Cruz,087,273765,21673,21424,1027,22451,224
2021-12-05,Shasta,089,179085,22682,22550,3696,26246,416
2021-12-05,Sierra,091,2930,200,198,21,219,0
2021-12-05,Siskiyou,093,43540,3471,3409,1350,4759,57
2021-12-05,Solano,095,438530,47409,46715,1344,48059,360
2021-12-05,Sonoma,097,501317,43405,43038,570,43608,405
2021-12-05,Stanislaus,099,539301,81611,81847,9217,91064,1241
2021-12-05,Sutter,101,95872,14306,14303,400,14703,186
2021-12-05,Tehama,103,63373,8826,8755,1535,10290,133
2021-12-05,Trinity,105,12862,909,815,219,1034,17
2021-12-05,Tulare,107,460477,71323,70254,16071,86325,1102
2021-12-05,Tuolumne,109,53932,7754,7718,113,7831,91
2021-12-05,Ventura,111,848112,101149,100367,4416,104783,1194
2021-12-05,Yolo,113,214977,20733,20512,1164,21676,263
2021-12-05,Yuba,115,75493,10545,10467,377,10844,91
2021-12-04,Alameda,001,1643700,123587,122508,2895,125403,1494
2021-12-04,Alpine,003,1148,105,108,0,108,0
2021-12-04,Amador,005,37829,5777,5729,69,5798,67
2021-12-04,Butte,007,227075,21952,21638,4000,25638,318
2021-12-04,Calaveras,009,45235,4462,4392,61,4453,88
2021-12-04,Colusa,011,21464,2630,2600,671,3271,21
2021-12-04,Contra Costa,013,1133247,102790,101824,2320,104144,1056
2021-12-04,Del Norte,015,27424,3796,3726,55,3781,42
2021-12-04,El Dorado,017,186661,16930,16621,1793,18414,168
2021-12-04,Fresno,019,978130,146793,144734,13133,157867,2270
2021-12-04,Glenn,021,27897,3607,3559,1044,4603,36
2021-12-04,Humboldt,023,135768,9740,9596,678,10274,117
2021-12-04,Imperial,025,180216,35792,35206,3640,38846,776
2021-12-04,Inyo,027,18085,2584,2538,38,2576,46
2021-12-04,Kern,029,883053,133321,131771,23895,155666,1817
2021-12-04,Kings,031,150075,33702,33183,2016,35199,367
2021-12-04,Lake,033,64148,6964,6903,158,7061,113
2021-12-04,Lassen,035,31185,7078,7014,418,7432,51
2021-12-04,Los Angeles,037,10098052,1479506,1463270,55857,1519127,26952
2021-12-04,Madera,039,155013,24505,24188,2301,26489,307
2021-12-04,Marin,041,260295,18384,18075,523,18598,249
2021-12-04,Mariposa,043,17540,1457,1421,60,1481,6
2021-12-04,Mendocino,045,87422,8188,7981,671,8652,91
2021-12-04,Merced,047,269075,43599,43337,2122,45459,671
2021-12-04,Modoc,049,8938,596,591,201,792,6
2021-12-04,Mono,051,14174,1928,1883,22,1905,4
2021-12-04,Monterey,053,433212,50071,48682,3211,51893,626
2021-12-04,Napa,055,140530,13445,13327,119,13446,106
2021-12-04,Nevada,057,99092,9894,9752,345,10097,105
2021-12-04,Orange,059,3164182,316585,313112,16078,329190,5748
2021-12-04,Placer,061,380077,39103,38460,3874,42334,473
2021-12-04,Plumas,063,18699,1970,1903,45,1948,7
2021-12-04,Riverside,065,2383286,377885,371768,16641,388409,5381
2021-12-04,Sacramento,067,1510023,165681,163900,4932,168832,2365
2021-12-04,San Benito,069,59416,7745,7688,181,7869,78
2021-12-04,San Bernardino,071,2135413,369260,364154,11699,375853,5983
2021-12-04,San Diego,073,3302833,391269,386710,22885,409595,4350
2021-12-04,San Francisco,075,870044,55207,54286,2416,56702,674
2021-12-04,San Joaquin,077,732212,103282,102286,5577,107863,1835
2021-12-04,San Luis Obispo,079,281455,30790,30318,1340,31658,360
2021-12-04,San Mateo,081,765935,56194,54774,964,55738,579
2021-12-04,Santa Barbara,083,443738,46344,45774,1609,47383,555
2021-12-04,Santa Clara,085,1922200,153384,151275,1602,152877,1928
2021-12-04,Santa Cruz,087,273765,21647,21286,1026,22312,224
2021-12-04,Shasta,089,179085,22665,22418,3694,26112,414
2021-12-04,Sierra,091,2930,200,196,21,217,0
2021-12-04,Siskiyou,093,43540,3469,3398,1350,4748,57
2021-12-04,Solano,095,438530,47389,46529,1343,47872,360
2021-12-04,Sonoma,097,501317,43360,42778,567,43345,405
2021-12-04,Stanislaus,099,539301,81540,81462,9210,90672,1231
2021-12-04,Sutter,101,95872,14298,14258,399,14657,186
2021-12-04,Tehama,103,63373,8824,8742,1535,10277,131
2021-12-04,Trinity,105,12862,908,801,219,1020,17
2021-12-04,Tulare,107,460477,71285,70014,16043,86057,1100
2021-12-04,Tuolumne,109,53932,7749,7676,113,7789,91
2021-12-04,Ventura,111,848112,101058,99751,4412,104163,1192
2021-12-04,Yolo,113,214977,20710,20442,1162,21604,261
2021-12-04,Yuba,115,75493,10534,10418,376,10794,91
2021-12-03,Alameda,001,1643700,123494,122508,2885,125393,1494
2021-12-03,Alpine,003,1148,105,108,0,108,0
2021-12-03,Amador,005,37829,5772,5729,68,5797,67
2021-12-03,Butte,007,227075,21939,21638,3995,25633,318
2021-12-03,Calaveras,009,45235,4453,4392,61,4453,88
2021-12-03,Colusa,011,21464,2628,2600,671,3271,21
2021-12-03,Contra Costa,013,1133247,102717,101824,2314,104138,1056
2021-12-03,Del Norte,015,27424,3794,3726,55,3781,42
2021-12-03,El Dorado,017,186661,16900,16621,1791,18412,168
2021-12-03,Fresno,019,978130,146679,144734,13130,157864,2270
2021-12-03,Glenn,021,27897,3606,3559,1043,4602,36
2021-12-03,Humboldt,023,135768,9723,9596,676,10272,117
2021-12-03,Imperial,025,180216,35750,35206,3610,38816,776
2021-12-03,Inyo,027,18085,2577,2538,38,2576,46
2021-12-03,Kern,029,883053,133249,131771,23860,155631,1817
2021-12-03,Kings,031,150075,33675,33183,2016,35199,367
2021-12-03,Lake,033,64148,6964,6903,158,7061,113
2021-12-03,Lassen,035,31185,7076,7014,417,7431,51
2021-12-03,Los Angeles,037,10098052,1478560,1463270,55780,1519050,26952
2021-12-03,Madera,039,155013,24479,24188,2297,26485,307
2021-12-03,Marin,041,260295,18351,18075,519,18594,249
2021-12-03,Mariposa,043,17540,1455,1421,60,1481,6
2021-12-03,Mendocino,045,87422,8181,7981,671,8652,91
2021-12-03,Merced,047,269075,43576,43337,2119,45456,671
2021-12-03,Modoc,049,8938,596,591,201,792,6
2021-12-03,Mono,051,14174,1922,1883,22,1905,4
2021-12-03,Monterey,053,433212,50032,48682,3200,51882,626
2021-12-03,Napa,055,140530,13433,13327,119,13446,106
2021-12-03,Nevada,057,99092,9883,9752,345,10097,105
2021-12-03,Orange,059,3164182,316315,313112,16046,329158,5748
2021-12-03,Placer,061,380077,39066,38460,3867,42327,473
2021-12-03,Plumas,063,18699,1967,1903,45,1948,7
2021-12-03,Riverside,065,2383286,377492,371768,16635,388403,5381
2021-12-03,Sacramento,067,1510023,165501,163900,4918,168818,2365
2021-12-03,San Benito,069,59416,7738,7688,181,7869,78
2021-12-03,San Bernardino,071,2135413,368812,364154,11688,375842,5983
2021-12-03,San Diego,073,3302833,390793,386710,22861,409571,4350
2021-12-03,San Francisco,075,870044,55137,54286,2412,56698,674
2021-12-03,San Joaquin,077,732212,103226,102286,5576,107862,1835
2021-12-03,San Luis Obispo,079,281455,30764,30318,1337,31655,360
2021-12-03,San Mateo,081,765935,56129,54774,961,55735,579
2021-12-03,Santa Barbara,083,443738,46308,45774,1609,47383,555
2021-12-03,Santa Clara,085,1922200,153205,151275,1587,152862,1928
2021-12-03,Santa Cruz,087,273765,21620,21286,1026,22312,224
2021-12-03,Shasta,089,179085,22650,22418,3694,26112,414
2021-12-03,Sierra,091,2930,200,196,21,217,0
2021-12-03,Siskiyou,093,43540,3466,3398,1348,4746,57
2021-12-03,Solano,095,438530,47347,46529,1342,47871,360
2021-12-03,Sonoma,097,501317,43324,42778,565,43343,405
2021-12-03,Stanislaus,099,539301,81483,81462,9201,90663,1231
2021-12-03,Sutter,101,95872,14285,14258,397,14655,186
2021-12-03,Tehama,103,63373,8823,8742,1534,10276,131
2021-12-03,Trinity,105,12862,908,801,219,1020,17
2021-12-03,Tulare,107,460477,71246,70014,16012,86026,1100
2021-12-03,Tuolumne,109,53932,7740,7676,113,7789,91
2021-12-03,Ventura,111,848112,100972,99751,4405,104156,1192
2021-12-03,Yolo,113,214977,20693,20442,1161,21603,261
2021-12-03,Yuba,115,75493,10526,10418,376,10794,91
2021-12-02,Alameda,001,1643700,123336,122508,2878,125386,1494
2021-12-02,Alpine,003,1148,105,108,0,108,0
2021-12-02,Amador,005,37829,5767,5729,67,5796,67
2021-12-02,Butte,007,227075,21914,21638,3990,25628,318
2021-12-02,Calaveras,009,45235,4443,4392,60,4452,88
2021-12-02,Colusa,011,21464,2627,2600,671,3271,21
2021-12-02,Contra Costa,013,1133247,102603,101824,2310,104134,1056
2021-12-02,Del Norte,015,27424,3786,3726,55,3781,42
2021-12-02,El Dorado,017,186661,16879,16621,1789,18410,168
2021-12-02,Fresno,019,978130,146510,144734,13118,157852,2270
2021-12-02,Glenn,021,27897,3606,3559,1040,4599,36
2021-12-02,Humboldt,023,135768,9704,9596,675,10271,117
2021-12-02,Imperial,025,180216,35682,35206,3588,38794,776
2021-12-02,Inyo,027,18085,2572,2538,38,2576,46
2021-12-02,Kern,029,883053,133078,131771,23808,155579,1817
2021-12-02,Kings,031,150075,33622,33183,2014,35197,367
2021-12-02,Lake,033,64148,6960,6903,158,7061,113
2021-12-02,Lassen,035,31185,7072,7014,417,7431,51
2021-12-02,Los Angeles,037,10098052,1477037,1463270,55693,1518963,26952
2021-12-02,Madera,039,155013,24442,24188,2288,26476,307
2021-12-02,Marin,041,260295,18320,18075,515,18590,249
2021-12-02,Mariposa,043,17540,1453,1421,60,1481,6
2021-12-02,Mendocino,045,87422,8165,7981,670,8651,91
2021-12-02,Merced,047,269075,43530,43337,2114,45451,671
2021-12-02,Modoc,049,8938,595,591,201,792,6
2021-12-02,Mono,051,14174,1916,1883,22,1905,4
2021-12-02,Monterey,053,433212,49957,48682,3178,51860,626
2021-12-02,Napa,055,140530,13419,13327,119,13446,106
2021-12-02,Nevada,057,99092,9865,9752,344,10096,105
2021-12-02,Orange,059,3164182,315970,313112,16009,329121,5748
2021-12-02,Placer,061,380077,39000,38460,3862,42322,473
2021-12-02,Plumas,063,18699,1964,1903,45,1948,7
2021-12-02,Riverside,065,2383286,376964,371768,16625,388393,5381
2021-12-02,Sacramento,067,1510023,165274,163900,4908,168808,2365
2021-12-02,San Benito,069,59416,7718,7688,181,7869,78
2021-12-02,San Bernardino,071,2135413,368260,364154,11668,375822,5983
2021-12-02,San Diego,073,3302833,390152,386710,22806,409516,4350
2021-12-02,San Francisco,075,870044,55042,54286,2407,56693,674
2021-12-02,San Joaquin,077,732212,103112,102286,5571,107857,1835
2021-12-02,San Luis Obispo,079,281455,30730,30318,1330,31648,360
2021-12-02,San Mateo,081,765935,56048,54774,953,55727,579
2021-12-02,Santa Barbara,083,443738,46227,45774,1606,47380,555
2021-12-02,Santa Clara,085,1922200,152960,151275,1570,152845,1928
2021-12-02,Santa Cruz,087,273765,21568,21286,1025,22311,224
2021-12-02,Shasta,089,179085,22617,22418,3693,26111,414
2021-12-02,Sierra,091,2930,200,196,21,217,0
2021-12-02,Siskiyou,093,43540,3465,3398,1341,4739,57
2021-12-02,Solano,095,438530,47297,46529,1340,47869,360
2021-12-02,Sonoma,097,501317,43250,42778,565,43343,405
2021-12-02,Stanislaus,099,539301,81391,81462,9193,90655,1231
2021-12-02,Sutter,101,95872,14272,14258,394,14652,186
2021-12-02,Tehama,103,63373,8816,8742,1532,10274,131
2021-12-02,Trinity,105,12862,908,801,219,1020,17
2021-12-02,Tulare,107,460477,71159,70014,15962,85976,1100
2021-12-02,Tuolumne,109,53932,7725,7676,112,7788,91
2021-12-02,Ventura,111,848112,100847,99751,4403,104154,1192
2021-12-02,Yolo,113,214977,20669,20442,1157,21599,261
2021-12-02,Yuba,115,75493,10510,10418,373,10791,91
2021-12-01,Alameda,001,1643700,123185,122298,2869,125167,1492
2021-12-01,Alpine,003,1148,105,108,0,108,0
2021-12-01,Amador,005,37829,5760,5723,67,5790,67
2021-12-01,Butte,007,227075,21896,21600,3985,25585,318
2021-12-01,Calaveras,009,45235,4438,4371,60,4431,88
2021-12-01,Colusa,011,21464,2620,2595,669,3264,20
2021-12-01,Contra Costa,013,1133247,102495,101651,2300,103951,1048
2021-12-01,Del Norte,015,27424,3784,3722,55,3777,42
2021-12-01,El Dorado,017,186661,16858,16575,1787,18362,166
2021-12-01,Fresno,019,978130,146303,144507,13110,157617,2264
2021-12-01,Glenn,021,27897,3599,3556,1039,4595,36
2021-12-01,Humboldt,023,135768,9680,9573,670,10243,117
2021-12-01,Imperial,025,180216,35602,35085,3561,38646,776
2021-12-01,Inyo,027,18085,2568,2533,38,2571,46
2021-12-01,Kern,029,883053,132931,131580,23753,155333,1804
2021-12-01,Kings,031,150075,33572,33112,2013,35125,364
2021-12-01,Lake,033,64148,6952,6896,157,7053,112
2021-12-01,Lassen,035,31185,7067,7008,415,7423,51
2021-12-01,Los Angeles,037,10098052,1475446,1461394,55598,1516992,26928
2021-12-01,Madera,039,155013,24411,24134,2279,26413,307
2021-12-01,Marin,041,260295,18282,18038,509,18547,249
2021-12-01,Mariposa,043,17540,1449,1415,60,1475,6
2021-12-01,Mendocino,045,87422,8151,7966,665,8631,90
2021-12-01,Merced,047,269075,43475,43259,2093,45352,670
2021-12-01,Modoc,049,8938,595,576,201,777,5
2021-12-01,Mono,051,14174,1911,1876,22,1898,4
2021-12-01,Monterey,053,433212,49908,48611,3169,51780,626
2021-12-01,Napa,055,140530,13402,13319,116,13435,107
2021-12-01,Nevada,057,99092,9852,9706,344,10050,105
2021-12-01,Orange,059,3164182,315606,312772,15972,328744,5735
2021-12-01,Placer,061,380077,38945,38373,3856,42229,472
2021-12-01,Plumas,063,18699,1960,1893,45,1938,7
2021-12-01,Riverside,065,2383286,376438,371189,16608,387797,5369
2021-12-01,Sacramento,067,1510023,165061,163616,4891,168507,2360
2021-12-01,San Benito,069,59416,7704,7669,181,7850,78
2021-12-01,San Bernardino,071,2135413,367668,363368,11642,375010,5973
2021-12-01,San Diego,073,3302833,389355,386056,22750,408806,4346
2021-12-01,San Francisco,075,870044,54960,54199,2400,56599,672
2021-12-01,San Joaquin,077,732212,103004,102109,5570,107679,1834
2021-12-01,San Luis Obispo,079,281455,30688,30238,1326,31564,360
2021-12-01,San Mateo,081,765935,55967,54711,950,55661,579
2021-12-01,Santa Barbara,083,443738,46157,45681,1604,47285,554
2021-12-01,Santa Clara,085,1922200,152740,150961,1553,152514,1925
2021-12-01,Santa Cruz,087,273765,21539,21191,1024,22215,224
2021-12-01,Shasta,089,179085,22586,22375,3687,26062,410
2021-12-01,Sierra,091,2930,200,195,21,216,0
2021-12-01,Siskiyou,093,43540,3462,3391,1341,4732,55
2021-12-01,Solano,095,438530,47252,46485,1340,47825,360
2021-12-01,Sonoma,097,501317,43175,42713,564,43277,405
2021-12-01,Stanislaus,099,539301,81298,81330,9180,90510,1231
2021-12-01,Sutter,101,95872,14257,14229,393,14622,186
2021-12-01,Tehama,103,63373,8806,8728,1532,10260,130
2021-12-01,Trinity,105,12862,903,801,219,1020,17
2021-12-01,Tulare,107,460477,71083,69953,15922,85875,1098
2021-12-01,Tuolumne,109,53932,7717,7655,112,7767,91
2021-12-01,Ventura,111,848112,100741,99680,4392,104072,1191
2021-12-01,Yolo,113,214977,20641,20393,1157,21550,260
2021-12-01,Yuba,115,75493,10499,10401,373,10774,89
2021-11-30,Alameda,001,1643700,123014,122196,2860,125056,1489
2021-11-30,Alpine,003,1148,105,108,0,108,0
2021-11-30,Amador,005,37829,5752,5716,67,5783,66
2021-11-30,Butte,007,227075,21867,21565,3974,25539,318
2021-11-30,Calaveras,009,45235,4420,4360,60,4420,88
2021-11-30,Colusa,011,21464,2619,2592,669,3261,21
2021-11-30,Contra Costa,013,1133247,102359,101538,2293,103831,1046
2021-11-30,Del Norte,015,27424,3778,3718,55,3773,42
2021-11-30,El Dorado,017,186661,16830,16558,1781,18339,166
2021-11-30,Fresno,019,978130,146103,144384,13102,157486,2259
2021-11-30,Glenn,021,27897,3595,3555,1038,4593,36
2021-11-30,Humboldt,023,135768,9649,9539,664,10203,116
2021-11-30,Imperial,025,180216,35494,34999,3534,38533,773
2021-11-30,Inyo,027,18085,2559,2530,38,2568,46
2021-11-30,Kern,029,883053,132760,131451,23696,155147,1799
2021-11-30,Kings,031,150075,33520,33074,2009,35083,362
2021-11-30,Lake,033,64148,6946,6892,155,7047,110
2021-11-30,Lassen,035,31185,7063,7003,414,7417,51
2021-11-30,Los Angeles,037,10098052,1473643,1460177,55498,1515675,26913
2021-11-30,Madera,039,155013,24377,24108,2274,26382,307
2021-11-30,Marin,041,260295,18238,18010,507,18517,249
2021-11-30,Mariposa,043,17540,1443,1412,60,1472,6
2021-11-30,Mendocino,045,87422,8122,7960,659,8619,89
2021-11-30,Merced,047,269075,43407,43200,2085,45285,668
2021-11-30,Modoc,049,8938,594,576,201,777,5
2021-11-30,Mono,051,14174,1908,1873,22,1895,4
2021-11-30,Monterey,053,433212,49845,48581,3159,51740,626
2021-11-30,Napa,055,140530,13382,13308,116,13424,105
2021-11-30,Nevada,057,99092,9836,9699,343,10042,105
2021-11-30,Orange,059,3164182,315184,312451,15930,328381,5724
2021-11-30,Placer,061,380077,38842,38324,3848,42172,470
2021-11-30,Plumas,063,18699,1955,1887,44,1931,7
2021-11-30,Riverside,065,2383286,375753,370739,16583,387322,5358
2021-11-30,Sacramento,067,1510023,164780,163420,4869,168289,2353
2021-11-30,San Benito,069,59416,7682,7645,180,7825,78
2021-11-30,San Bernardino,071,2135413,366982,363006,11619,374625,5967
2021-11-30,San Diego,073,3302833,388427,385405,22703,408108,4340
2021-11-30,San Francisco,075,870044,54854,54147,2391,56538,672
2021-11-30,San Joaquin,077,732212,102878,101972,5562,107534,1834
2021-11-30,San Luis Obispo,079,281455,30663,30200,1324,31524,360
2021-11-30,San Mateo,081,765935,55862,54656,940,55596,579
2021-11-30,Santa Barbara,083,443738,46061,45628,1598,47226,553
2021-11-30,Santa Clara,085,1922200,152483,150799,1535,152334,1929
2021-11-30,Santa Cruz,087,273765,21480,21169,1020,22189,224
2021-11-30,Shasta,089,179085,22556,22347,3684,26031,401
2021-11-30,Sierra,091,2930,197,195,21,216,0
2021-11-30,Siskiyou,093,43540,3458,3385,1338,4723,55
2021-11-30,Solano,095,438530,47189,46434,1334,47768,358
2021-11-30,Sonoma,097,501317,43096,42663,561,43224,405
2021-11-30,Stanislaus,099,539301,81198,81276,9153,90429,1227
2021-11-30,Sutter,101,95872,14246,14210,390,14600,186
2021-11-30,Tehama,103,63373,8799,8727,1531,10258,130
2021-11-30,Trinity,105,12862,902,799,219,1018,17
2021-11-30,Tulare,107,460477,70996,69900,15877,85777,1099
2021-11-30,Tuolumne,109,53932,7702,7643,112,7755,91
2021-11-30,Ventura,111,848112,100587,99601,4381,103982,1191
2021-11-30,Yolo,113,214977,20599,20376,1151,21527,260
2021-11-30,Yuba,115,75493,10480,10398,368,10766,89
2021-11-29,Alameda,001,1643700,122855,122136,2851,124987,1489
2021-11-29,Alpine,003,1148,105,108,0,108,0
2021-11-29,Amador,005,37829,5745,5706,67,5773,66
2021-11-29,Butte,007,227075,21838,21544,3966,25510,314
2021-11-29,Calaveras,009,45235,4404,4353,60,4413,88
2021-11-29,Colusa,011,21464,2617,2585,666,3251,20
2021-11-29,Contra Costa,013,1133247,102210,101441,2285,103726,1046
2021-11-29,Del Norte,015,27424,3775,3704,55,3759,42
2021-11-29,El Dorado,017,186661,16812,16534,1776,18310,166
2021-11-29,Fresno,019,978130,145897,144282,13079,157361,2254
2021-11-29,Glenn,021,27897,3592,3555,1037,4592,36
2021-11-29,Humboldt,023,135768,9632,9514,657,10171,115
2021-11-29,Imperial,025,180216,35429,34960,3513,38473,773
2021-11-29,Inyo,027,18085,2554,2529,38,2567,46
2021-11-29,Kern,029,883053,132576,131362,23655,155017,1789
2021-11-29,Kings,031,150075,33467,33059,2005,35064,363
2021-11-29,Lake,033,64148,6934,6889,155,7044,110
2021-11-29,Lassen,035,31185,7060,7003,412,7415,51
2021-11-29,Los Angeles,037,10098052,1471796,1459446,55413,1514859,26889
2021-11-29,Madera,039,155013,24341,24069,2266,26335,307
2021-11-29,Marin,041,260295,18191,17980,502,18482,249
2021-11-29,Mariposa,043,17540,1435,1409,60,1469,6
2021-11-29,Mendocino,045,87422,8105,7954,655,8609,89
2021-11-29,Merced,047,269075,43333,43167,2077,45244,667
2021-11-29,Modoc,049,8938,593,569,201,770,5
2021-11-29,Mono,051,14174,1891,1859,22,1881,4
2021-11-29,Monterey,053,433212,49784,48548,3143,51691,626
2021-11-29,Napa,055,140530,13372,13304,116,13420,104
2021-11-29,Nevada,057,99092,9822,9689,343,10032,105
2021-11-29,Orange,059,3164182,314781,312203,15884,328087,5709
2021-11-29,Placer,061,380077,38777,38261,3843,42104,470
2021-11-29,Plumas,063,18699,1952,1884,44,1928,7
2021-11-29,Riverside,065,2383286,375215,370334,16572,386906,5358
2021-11-29,Sacramento,067,1510023,164532,163282,4837,168119,2342
2021-11-29,San Benito,069,59416,7663,7631,179,7810,77
2021-11-29,San Bernardino,071,2135413,366379,362694,11585,374279,5962
2021-11-29,San Diego,073,3302833,387539,384853,22669,407522,4335
2021-11-29,San Francisco,075,870044,54755,54125,2387,56512,669
2021-11-29,San Joaquin,077,732212,102739,101927,5555,107482,1834
2021-11-29,San Luis Obispo,079,281455,30629,30165,1320,31485,359
2021-11-29,San Mateo,081,765935,55759,54622,936,55558,579
2021-11-29,Santa Barbara,083,443738,45964,45576,1594,47170,549
2021-11-29,Santa Clara,085,1922200,152210,150620,1529,152149,1925
2021-11-29,Santa Cruz,087,273765,21442,21149,1019,22168,224
2021-11-29,Shasta,089,179085,22521,22315,3680,25995,399
2021-11-29,Sierra,091,2930,197,195,21,216,0
2021-11-29,Siskiyou,093,43540,3455,3374,1331,4705,55
2021-11-29,Solano,095,438530,47137,46412,1332,47744,357
2021-11-29,Sonoma,097,501317,43019,42624,558,43182,405
2021-11-29,Stanislaus,099,539301,81116,81227,9135,90362,1223
2021-11-29,Sutter,101,95872,14230,14204,387,14591,186
2021-11-29,Tehama,103,63373,8794,8720,1526,10246,130
2021-11-29,Trinity,105,12862,897,798,219,1017,17
2021-11-29,Tulare,107,460477,70916,69850,15843,85693,1096
2021-11-29,Tuolumne,109,53932,7689,7627,112,7739,90
2021-11-29,Ventura,111,848112,100467,99520,4372,103892,1190
2021-11-29,Yolo,113,214977,20554,20344,1149,21493,257
2021-11-29,Yuba,115,75493,10463,10395,367,10762,89
2021-11-28,Alameda,001,1643700,122636,122082,2845,124927,1491
2021-11-28,Alpine,003,1148,105,108,0,108,0
2021-11-28,Amador,005,37829,5735,5703,67,5770,66
2021-11-28,Butte,007,227075,21797,21530,3964,25494,313
2021-11-28,Calaveras,009,45235,4383,4350,60,4410,88
2021-11-28,Colusa,011,21464,2613,2586,665,3251,19
2021-11-28,Contra Costa,013,1133247,102037,101355,2275,103630,1046
2021-11-28,Del Norte,015,27424,3770,3703,55,3758,42
2021-11-28,El Dorado,017,186661,16771,16527,1775,18302,166
2021-11-28,Fresno,019,978130,145651,144164,13053,157217,2252
2021-11-28,Glenn,021,27897,3589,3547,1035,4582,36
2021-11-28,Humboldt,023,135768,9600,9499,653,10152,115
2021-11-28,Imperial,025,180216,35321,34929,3489,38418,773
2021-11-28,Inyo,027,18085,2547,2531,38,2569,46
2021-11-28,Kern,029,883053,132370,131279,23598,154877,1789
2021-11-28,Kings,031,150075,33394,33057,1999,35056,364
2021-11-28,Lake,033,64148,6924,6885,154,7039,110
2021-11-28,Lassen,035,31185,7051,7002,408,7410,51
2021-11-28,Los Angeles,037,10098052,1469624,1458646,55326,1513972,26878
2021-11-28,Madera,039,155013,24293,24055,2259,26314,307
2021-11-28,Marin,041,260295,18144,17962,498,18460,249
2021-11-28,Mariposa,043,17540,1431,1406,60,1466,6
2021-11-28,Mendocino,045,87422,8075,7943,650,8593,89
2021-11-28,Merced,047,269075,43267,43166,2062,45228,667
2021-11-28,Modoc,049,8938,592,569,201,770,5
2021-11-28,Mono,051,14174,1885,1841,22,1863,4
2021-11-28,Monterey,053,433212,49719,48537,3124,51661,626
2021-11-28,Napa,055,140530,13359,13303,116,13419,104
2021-11-28,Nevada,057,99092,9796,9684,342,10026,105
2021-11-28,Orange,059,3164182,314396,312028,15842,327870,5693
2021-11-28,Placer,061,380077,38695,38240,3824,42064,470
2021-11-28,Plumas,063,18699,1946,1884,43,1927,7
2021-11-28,Riverside,065,2383286,374552,370051,16550,386601,5358
2021-11-28,Sacramento,067,1510023,164175,163170,4814,167984,2335
2021-11-28,San Benito,069,59416,7644,7623,178,7801,77
2021-11-28,San Bernardino,071,2135413,365640,362407,11557,373964,5958
2021-11-28,San Diego,073,3302833,386650,383025,22605,405630,4325
2021-11-28,San Francisco,075,870044,54679,54082,2382,56464,669
2021-11-28,San Joaquin,077,732212,102559,101895,5538,107433,1834
2021-11-28,San Luis Obispo,079,281455,30566,30152,1316,31468,358
2021-11-28,San Mateo,081,765935,55665,54567,932,55499,579
2021-11-28,Santa Barbara,083,443738,45885,45551,1583,47134,549
2021-11-28,Santa Clara,085,1922200,151911,150436,1514,151950,1920
2021-11-28,Santa Cruz,087,273765,21371,21110,1018,22128,224
2021-11-28,Shasta,089,179085,22482,22316,3678,25994,400
2021-11-28,Sierra,091,2930,197,195,21,216,0
2021-11-28,Siskiyou,093,43540,3449,3372,1327,4699,55
2021-11-28,Solano,095,438530,47075,46385,1331,47716,356
2021-11-28,Sonoma,097,501317,42933,42583,555,43138,405
2021-11-28,Stanislaus,099,539301,80997,81181,9113,90294,1223
2021-11-28,Sutter,101,95872,14209,14192,381,14573,186
2021-11-28,Tehama,103,63373,8786,8720,1522,10242,130
2021-11-28,Trinity,105,12862,896,797,219,1016,17
2021-11-28,Tulare,107,460477,70819,69833,15791,85624,1095
2021-11-28,Tuolumne,109,53932,7668,7620,112,7732,90
2021-11-28,Ventura,111,848112,100311,99486,4361,103847,1190
2021-11-28,Yolo,113,214977,20511,20333,1148,21481,257
2021-11-28,Yuba,115,75493,10445,10391,365,10756,89
2021-11-27,Alameda,001,1643700,122538,121618,2842,124460,1477
2021-11-27,Alpine,003,1148,105,106,0,106,0
2021-11-27,Amador,005,37829,5734,5670,67,5737,66
2021-11-27,Butte,007,227075,21774,21384,3959,25343,309
2021-11-27,Calaveras,009,45235,4377,4294,60,4354,85
2021-11-27,Colusa,011,21464,2612,2568,663,3231,19
2021-11-27,Contra Costa,013,1133247,101952,100961,2274,103235,1045
2021-11-27,Del Norte,015,27424,3763,3661,55,3716,42
2021-11-27,El Dorado,017,186661,16737,16399,1774,18173,161
2021-11-27,Fresno,019,978130,145539,143386,13047,156433,2246
2021-11-27,Glenn,021,27897,3585,3532,1034,4566,36
2021-11-27,Humboldt,023,135768,9572,9399,651,10050,115
2021-11-27,Imperial,025,180216,35239,34611,3473,38084,769
2021-11-27,Inyo,027,18085,2544,2506,38,2544,45
2021-11-27,Kern,029,883053,132286,130245,23569,153814,1773
2021-11-27,Kings,031,150075,33372,32891,1996,34887,358
2021-11-27,Lake,033,64148,6921,6836,153,6989,110
2021-11-27,Lassen,035,31185,7049,6959,407,7366,47
2021-11-27,Los Angeles,037,10098052,1468618,1454495,55257,1509752,26817
2021-11-27,Madera,039,155013,24272,23880,2254,26134,296
2021-11-27,Marin,041,260295,18105,17857,493,18350,248
2021-11-27,Mariposa,043,17540,1429,1374,60,1434,6
2021-11-27,Mendocino,045,87422,8056,7871,650,8521,89
2021-11-27,Merced,047,269075,43232,42921,2059,44980,664
2021-11-27,Modoc,049,8938,590,551,201,752,5
2021-11-27,Mono,051,14174,1883,1810,22,1832,4
2021-11-27,Monterey,053,433212,49686,48400,3110,51510,625
2021-11-27,Napa,055,140530,13345,13256,116,13372,104
2021-11-27,Nevada,057,99092,9774,9584,341,9925,103
2021-11-27,Orange,059,3164182,314145,310809,15806,326615,5665
2021-11-27,Placer,061,380077,38634,38001,3818,41819,468
2021-11-27,Plumas,063,18699,1942,1860,43,1903,7
2021-11-27,Riverside,065,2383286,374194,367601,16543,384144,5306
2021-11-27,Sacramento,067,1510023,164017,162328,4811,167139,2335
2021-11-27,San Benito,069,59416,7628,7575,178,7753,77
2021-11-27,San Bernardino,071,2135413,365205,360033,11548,371581,5932
2021-11-27,San Diego,073,3302833,386155,382634,22579,405213,4319
2021-11-27,San Francisco,075,870044,54629,53830,2379,56209,669
2021-11-27,San Joaquin,077,732212,102492,101368,5535,106903,1833
2021-11-27,San Luis Obispo,079,281455,30531,29983,1312,31295,358
2021-11-27,San Mateo,081,765935,55608,54360,929,55289,577
2021-11-27,Santa Barbara,083,443738,45831,45318,1581,46899,548
2021-11-27,Santa Clara,085,1922200,151704,149700,1507,151207,1922
2021-11-27,Santa Cruz,087,273765,21331,20929,1015,21944,222
2021-11-27,Shasta,089,179085,22459,22151,3677,25828,396
2021-11-27,Sierra,091,2930,196,194,21,215,0
2021-11-27,Siskiyou,093,43540,3446,3336,1325,4661,54
2021-11-27,Solano,095,438530,47039,46163,1328,47491,356
2021-11-27,Sonoma,097,501317,42870,42368,555,42923,405
2021-11-27,Stanislaus,099,539301,80929,80782,9096,89878,1220
2021-11-27,Sutter,101,95872,14201,14127,380,14507,181
2021-11-27,Tehama,103,63373,8784,8675,1521,10196,129
2021-11-27,Trinity,105,12862,896,789,219,1008,17
2021-11-27,Tulare,107,460477,70767,69377,15775,85152,1082
2021-11-27,Tuolumne,109,53932,7655,7574,112,7686,90
2021-11-27,Ventura,111,848112,100238,99163,4354,103517,1188
2021-11-27,Yolo,113,214977,20490,20237,1139,21376,257
2021-11-27,Yuba,115,75493,10434,10335,365,10700,88
2021-11-26,Alameda,001,1643700,122428,121618,2840,124458,1477
2021-11-26,Alpine,003,1148,105,106,0,106,0
2021-11-26,Amador,005,37829,5730,5670,67,5737,66
2021-11-26,Butte,007,227075,21751,21384,3954,25338,309
2021-11-26,Calaveras,009,45235,4368,4294,60,4354,85
2021-11-26,Colusa,011,21464,2610,2568,662,3230,19
2021-11-26,Contra Costa,013,1133247,101864,100961,2270,103231,1045
2021-11-26,Del Norte,015,27424,3760,3661,55,3716,42
2021-11-26,El Dorado,017,186661,16720,16399,1771,18170,161
2021-11-26,Fresno,019,978130,145406,143386,13037,156423,2246
2021-11-26,Glenn,021,27897,3582,3532,1034,4566,36
2021-11-26,Humboldt,023,135768,9553,9399,647,10046,115
2021-11-26,Imperial,025,180216,35182,34611,3460,38071,769
2021-11-26,Inyo,027,18085,2544,2506,38,2544,45
2021-11-26,Kern,029,883053,132203,130245,23525,153770,1773
2021-11-26,Kings,031,150075,33348,32891,1994,34885,358
2021-11-26,Lake,033,64148,6919,6836,153,6989,110
2021-11-26,Lassen,035,31185,7043,6959,407,7366,47
2021-11-26,Los Angeles,037,10098052,1467770,1454495,55196,1509691,26817
2021-11-26,Madera,039,155013,24245,23880,2252,26132,296
2021-11-26,Marin,041,260295,18076,17857,493,18350,248
2021-11-26,Mariposa,043,17540,1423,1374,59,1433,6
2021-11-26,Mendocino,045,87422,8046,7871,650,8521,89
2021-11-26,Merced,047,269075,43202,42921,2055,44976,664
2021-11-26,Modoc,049,8938,588,551,201,752,5
2021-11-26,Mono,051,14174,1872,1810,22,1832,4
2021-11-26,Monterey,053,433212,49643,48400,3103,51503,625
2021-11-26,Napa,055,140530,13329,13256,116,13372,104
2021-11-26,Nevada,057,99092,9762,9584,341,9925,103
2021-11-26,Orange,059,3164182,313876,310809,15774,326583,5665
2021-11-26,Placer,061,380077,38589,38001,3810,41811,468
2021-11-26,Plumas,063,18699,1937,1860,43,1903,7
2021-11-26,Riverside,065,2383286,373792,367601,16536,384137,5306
2021-11-26,Sacramento,067,1510023,163904,162328,4806,167134,2335
2021-11-26,San Benito,069,59416,7620,7575,178,7753,77
2021-11-26,San Bernardino,071,2135413,364773,360033,11541,371574,5932
2021-11-26,San Diego,073,3302833,385610,382634,22567,405201,4319
2021-11-26,San Francisco,075,870044,54582,53830,2377,56207,669
2021-11-26,San Joaquin,077,732212,102435,101368,5534,106902,1833
2021-11-26,San Luis Obispo,079,281455,30489,29983,1309,31292,358
2021-11-26,San Mateo,081,765935,55545,54360,928,55288,577
2021-11-26,Santa Barbara,083,443738,45784,45318,1580,46898,548
2021-11-26,Santa Clara,085,1922200,151535,149700,1499,151199,1922
2021-11-26,Santa Cruz,087,273765,21291,20929,1015,21944,222
2021-11-26,Shasta,089,179085,22439,22151,3675,25826,396
2021-11-26,Sierra,091,2930,196,194,21,215,0
2021-11-26,Siskiyou,093,43540,3443,3336,1324,4660,54
2021-11-26,Solano,095,438530,46998,46163,1327,47490,356
2021-11-26,Sonoma,097,501317,42820,42368,553,42921,405
2021-11-26,Stanislaus,099,539301,80856,80782,9085,89867,1220
2021-11-26,Sutter,101,95872,14188,14127,379,14506,181
2021-11-26,Tehama,103,63373,8782,8675,1520,10195,129
2021-11-26,Trinity,105,12862,895,789,219,1008,17
2021-11-26,Tulare,107,460477,70721,69377,15743,85120,1082
2021-11-26,Tuolumne,109,53932,7645,7574,112,7686,90
2021-11-26,Ventura,111,848112,100158,99163,4349,103512,1188
2021-11-26,Yolo,113,214977,20471,20237,1132,21369,257
2021-11-26,Yuba,115,75493,10428,10335,365,10700,88
2021-11-25,Alameda,001,1643700,122320,121618,2835,124453,1477
2021-11-25,Alpine,003,1148,105,106,0,106,0
2021-11-25,Amador,005,37829,5722,5670,67,5737,66
2021-11-25,Butte,007,227075,21733,21384,3952,25336,309
2021-11-25,Calaveras,009,45235,4363,4294,60,4354,85
2021-11-25,Colusa,011,21464,2607,2568,660,3228,19
2021-11-25,Contra Costa,013,1133247,101760,100961,2267,103228,1045
2021-11-25,Del Norte,015,27424,3755,3661,55,3716,42
2021-11-25,El Dorado,017,186661,16701,16399,1771,18170,161
2021-11-25,Fresno,019,978130,145272,143386,13028,156414,2246
2021-11-25,Glenn,021,27897,3579,3532,1033,4565,36
2021-11-25,Humboldt,023,135768,9534,9399,644,10043,115
2021-11-25,Imperial,025,180216,35137,34611,3449,38060,769
2021-11-25,Inyo,027,18085,2542,2506,38,2544,45
2021-11-25,Kern,029,883053,132105,130245,23479,153724,1773
2021-11-25,Kings,031,150075,33320,32891,1993,34884,358
2021-11-25,Lake,033,64148,6912,6836,153,6989,110
2021-11-25,Lassen,035,31185,7041,6959,406,7365,47
2021-11-25,Los Angeles,037,10098052,1466800,1454495,55139,1509634,26817
2021-11-25,Madera,039,155013,24209,23880,2251,26131,296
2021-11-25,Marin,041,260295,18049,17857,487,18344,248
2021-11-25,Mariposa,043,17540,1420,1374,59,1433,6
2021-11-25,Mendocino,045,87422,8028,7871,650,8521,89
2021-11-25,Merced,047,269075,43163,42921,2049,44970,664
2021-11-25,Modoc,049,8938,587,551,201,752,5
2021-11-25,Mono,051,14174,1861,1810,22,1832,4
2021-11-25,Monterey,053,433212,49599,48400,3094,51494,625
2021-11-25,Napa,055,140530,13321,13256,116,13372,104
2021-11-25,Nevada,057,99092,9743,9584,338,9922,103
2021-11-25,Orange,059,3164182,313613,310809,15743,326552,5665
2021-11-25,Placer,061,380077,38543,38001,3804,41805,468
2021-11-25,Plumas,063,18699,1935,1860,43,1903,7
2021-11-25,Riverside,065,2383286,373377,367601,16529,384130,5306
2021-11-25,Sacramento,067,1510023,163725,162328,4800,167128,2335
2021-11-25,San Benito,069,59416,7613,7575,178,7753,77
2021-11-25,San Bernardino,071,2135413,364374,360033,11524,371557,5932
2021-11-25,San Diego,073,3302833,385168,382634,22548,405182,4319
2021-11-25,San Francisco,075,870044,54532,53830,2374,56204,669
2021-11-25,San Joaquin,077,732212,102352,101368,5530,106898,1833
2021-11-25,San Luis Obispo,079,281455,30459,29983,1307,31290,358
2021-11-25,San Mateo,081,765935,55496,54360,926,55286,577
2021-11-25,Santa Barbara,083,443738,45745,45318,1578,46896,548
2021-11-25,Santa Clara,085,1922200,151378,149700,1494,151194,1922
2021-11-25,Santa Cruz,087,273765,21258,20929,1015,21944,222
2021-11-25,Shasta,089,179085,22413,22151,3675,25826,396
2021-11-25,Sierra,091,2930,196,194,21,215,0
2021-11-25,Siskiyou,093,43540,3440,3336,1324,4660,54
2021-11-25,Solano,095,438530,46961,46163,1326,47489,356
2021-11-25,Sonoma,097,501317,42763,42368,549,42917,405
2021-11-25,Stanislaus,099,539301,80790,80782,9071,89853,1220
2021-11-25,Sutter,101,95872,14172,14127,378,14505,181
2021-11-25,Tehama,103,63373,8774,8675,1520,10195,129
2021-11-25,Trinity,105,12862,895,789,219,1008,17
2021-11-25,Tulare,107,460477,70653,69377,15717,85094,1082
2021-11-25,Tuolumne,109,53932,7633,7574,112,7686,90
2021-11-25,Ventura,111,848112,100092,99163,4346,103509,1188
2021-11-25,Yolo,113,214977,20441,20237,1128,21365,257
2021-11-25,Yuba,115,75493,10419,10335,364,10699,88
2021-11-24,Alameda,001,1643700,122257,121618,2831,124449,1477
2021-11-24,Alpine,003,1148,105,106,0,106,0
2021-11-24,Amador,005,37829,5712,5670,67,5737,66
2021-11-24,Butte,007,227075,21717,21384,3951,25335,309
2021-11-24,Calaveras,009,45235,4356,4294,60,4354,85
2021-11-24,Colusa,011,21464,2607,2568,659,3227,19
2021-11-24,Contra Costa,013,1133247,101721,100961,2264,103225,1045
2021-11-24,Del Norte,015,27424,3752,3661,55,3716,42
2021-11-24,El Dorado,017,186661,16690,16399,1770,18169,161
2021-11-24,Fresno,019,978130,145218,143386,13027,156413,2246
2021-11-24,Glenn,021,27897,3574,3532,1032,4564,36
2021-11-24,Humboldt,023,135768,9519,9399,644,10043,115
2021-11-24,Imperial,025,180216,35108,34611,3443,38054,769
2021-11-24,Inyo,027,18085,2539,2506,38,2544,45
2021-11-24,Kern,029,883053,132043,130245,23467,153712,1773
2021-11-24,Kings,031,150075,33306,32891,1992,34883,358
2021-11-24,Lake,033,64148,6908,6836,153,6989,110
2021-11-24,Lassen,035,31185,7041,6959,406,7365,47
2021-11-24,Los Angeles,037,10098052,1466315,1454495,55097,1509592,26817
2021-11-24,Madera,039,155013,24186,23880,2245,26125,296
2021-11-24,Marin,041,260295,18037,17857,485,18342,248
2021-11-24,Mariposa,043,17540,1420,1374,59,1433,6
2021-11-24,Mendocino,045,87422,8016,7871,650,8521,89
2021-11-24,Merced,047,269075,43131,42921,2046,44967,664
2021-11-24,Modoc,049,8938,587,551,201,752,5
2021-11-24,Mono,051,14174,1858,1810,22,1832,4
2021-11-24,Monterey,053,433212,49586,48400,3093,51493,625
2021-11-24,Napa,055,140530,13317,13256,116,13372,104
2021-11-24,Nevada,057,99092,9728,9584,338,9922,103
2021-11-24,Orange,059,3164182,313458,310809,15728,326537,5665
2021-11-24,Placer,061,380077,38510,38001,3802,41803,468
2021-11-24,Plumas,063,18699,1933,1860,43,1903,7
2021-11-24,Riverside,065,2383286,373198,367601,16523,384124,5306
2021-11-24,Sacramento,067,1510023,163654,162328,4800,167128,2335
2021-11-24,San Benito,069,59416,7611,7575,178,7753,77
2021-11-24,San Bernardino,071,2135413,364163,360033,11514,371547,5932
2021-11-24,San Diego,073,3302833,384910,382634,22535,405169,4319
2021-11-24,San Francisco,075,870044,54501,53830,2372,56202,669
2021-11-24,San Joaquin,077,732212,102311,101368,5527,106895,1833
2021-11-24,San Luis Obispo,079,281455,30440,29983,1307,31290,358
2021-11-24,San Mateo,081,765935,55466,54360,925,55285,577
2021-11-24,Santa Barbara,083,443738,45718,45318,1578,46896,548
2021-11-24,Santa Clara,085,1922200,151282,149700,1493,151193,1922
2021-11-24,Santa Cruz,087,273765,21235,20929,1014,21943,222
2021-11-24,Shasta,089,179085,22402,22151,3672,25823,396
2021-11-24,Sierra,091,2930,196,194,21,215,0
2021-11-24,Siskiyou,093,43540,3437,3336,1324,4660,54
2021-11-24,Solano,095,438530,46933,46163,1324,47487,356
2021-11-24,Sonoma,097,501317,42731,42368,547,42915,405
2021-11-24,Stanislaus,099,539301,80753,80782,9066,89848,1220
2021-11-24,Sutter,101,95872,14159,14127,376,14503,181
2021-11-24,Tehama,103,63373,8771,8675,1519,10194,129
2021-11-24,Trinity,105,12862,895,789,219,1008,17
2021-11-24,Tulare,107,460477,70629,69377,15698,85075,1082
2021-11-24,Tuolumne,109,53932,7629,7574,112,7686,90
2021-11-24,Ventura,111,848112,100057,99163,4342,103505,1188
2021-11-24,Yolo,113,214977,20433,20237,1127,21364,257
2021-11-24,Yuba,115,75493,10415,10335,363,10698,88
2021-11-23,Alameda,001,1643700,122138,121618,2825,124443,1477
2021-11-23,Alpine,003,1148,105,106,0,106,0
2021-11-23,Amador,005,37829,5705,5670,67,5737,66
2021-11-23,Butte,007,227075,21688,21384,3947,25331,309
2021-11-23,Calaveras,009,45235,4350,4294,59,4353,85
2021-11-23,Colusa,011,21464,2603,2568,657,3225,19
2021-11-23,Contra Costa,013,1133247,101614,100961,2262,103223,1045
2021-11-23,Del Norte,015,27424,3749,3661,55,3716,42
2021-11-23,El Dorado,017,186661,16659,16399,1767,18166,161
2021-11-23,Fresno,019,978130,145080,143386,13018,156404,2246
2021-11-23,Glenn,021,27897,3569,3532,1032,4564,36
2021-11-23,Humboldt,023,135768,9497,9399,641,10040,115
2021-11-23,Imperial,025,180216,35039,34611,3424,38035,769
2021-11-23,Inyo,027,18085,2535,2506,38,2544,45
2021-11-23,Kern,029,883053,131935,130245,23418,153663,1773
2021-11-23,Kings,031,150075,33264,32891,1991,34882,358
2021-11-23,Lake,033,64148,6903,6836,153,6989,110
2021-11-23,Lassen,035,31185,7038,6959,403,7362,47
2021-11-23,Los Angeles,037,10098052,1465306,1454495,55029,1509524,26817
2021-11-23,Madera,039,155013,24160,23880,2243,26123,296
2021-11-23,Marin,041,260295,18007,17857,482,18339,248
2021-11-23,Mariposa,043,17540,1417,1374,59,1433,6
2021-11-23,Mendocino,045,87422,7995,7871,647,8518,89
2021-11-23,Merced,047,269075,43093,42921,2045,44966,664
2021-11-23,Modoc,049,8938,585,551,201,752,5
2021-11-23,Mono,051,14174,1844,1810,22,1832,4
2021-11-23,Monterey,053,433212,49550,48400,3087,51487,625
2021-11-23,Napa,055,140530,13308,13256,116,13372,104
2021-11-23,Nevada,057,99092,9699,9584,337,9921,103
2021-11-23,Orange,059,3164182,313208,310809,15692,326501,5665
2021-11-23,Placer,061,380077,38451,38001,3785,41786,468
2021-11-23,Plumas,063,18699,1929,1860,43,1903,7
2021-11-23,Riverside,065,2383286,372815,367601,16510,384111,5306
2021-11-23,Sacramento,067,1510023,163467,162328,4789,167117,2335
2021-11-23,San Benito,069,59416,7602,7575,176,7751,77
2021-11-23,San Bernardino,071,2135413,363745,360033,11499,371532,5932
2021-11-23,San Diego,073,3302833,384426,382634,22512,405146,4319
2021-11-23,San Francisco,075,870044,54442,53830,2370,56200,669
2021-11-23,San Joaquin,077,732212,102202,101368,5516,106884,1833
2021-11-23,San Luis Obispo,079,281455,30405,29983,1304,31287,358
2021-11-23,San Mateo,081,765935,55416,54360,924,55284,577
2021-11-23,Santa Barbara,083,443738,45665,45318,1578,46896,548
2021-11-23,Santa Clara,085,1922200,151072,149700,1481,151181,1922
2021-11-23,Santa Cruz,087,273765,21197,20929,1014,21943,222
2021-11-23,Shasta,089,179085,22366,22151,3670,25821,396
2021-11-23,Sierra,091,2930,196,194,21,215,0
2021-11-23,Siskiyou,093,43540,3432,3336,1323,4659,54
2021-11-23,Solano,095,438530,46879,46163,1320,47483,356
2021-11-23,Sonoma,097,501317,42680,42368,544,42912,405
2021-11-23,Stanislaus,099,539301,80683,80782,9054,89836,1220
2021-11-23,Sutter,101,95872,14143,14127,375,14502,181
2021-11-23,Tehama,103,63373,8758,8675,1518,10193,129
2021-11-23,Trinity,105,12862,894,789,219,1008,17
2021-11-23,Tulare,107,460477,70582,69377,15668,85045,1082
2021-11-23,Tuolumne,109,53932,7617,7574,111,7685,90
2021-11-23,Ventura,111,848112,99974,99163,4336,103499,1188
2021-11-23,Yolo,113,214977,20412,20237,1119,21356,257
2021-11-23,Yuba,115,75493,10403,10335,363,10698,88
2021-11-22,Alameda,001,1643700,122025,121566,2823,124389,1475
2021-11-22,Alpine,003,1148,105,106,0,106,0
2021-11-22,Amador,005,37829,5692,5670,67,5737,66
2021-11-22,Butte,007,227075,21649,21363,3942,25305,305
2021-11-22,Calaveras,009,45235,4338,4294,59,4353,84
2021-11-22,Colusa,011,21464,2600,2565,657,3222,19
2021-11-22,Contra Costa,013,1133247,101526,100877,2257,103134,1045
2021-11-22,Del Norte,015,27424,3746,3659,55,3714,42
2021-11-22,El Dorado,017,186661,16636,16378,1764,18142,161
2021-11-22,Fresno,019,978130,144947,143290,13010,156300,2243
2021-11-22,Glenn,021,27897,3564,3530,1031,4561,36
2021-11-22,Humboldt,023,135768,9471,9389,636,10025,115
2021-11-22,Imperial,025,180216,34978,34562,3410,37972,766
2021-11-22,Inyo,027,18085,2529,2501,38,2539,44
2021-11-22,Kern,029,883053,131774,130091,23369,153460,1762
2021-11-22,Kings,031,150075,33227,32867,1986,34853,358
2021-11-22,Lake,033,64148,6898,6837,153,6990,110
2021-11-22,Lassen,035,31185,7036,6954,402,7356,47
2021-11-22,Los Angeles,037,10098052,1464242,1453945,54946,1508891,26800
2021-11-22,Madera,039,155013,24126,23872,2235,26107,296
2021-11-22,Marin,041,260295,17976,17842,480,18322,248
2021-11-22,Mariposa,043,17540,1413,1372,59,1431,6
2021-11-22,Mendocino,045,87422,7979,7859,646,8505,89
2021-11-22,Merced,047,269075,43042,42898,2034,44932,660
2021-11-22,Modoc,049,8938,584,551,201,752,5
2021-11-22,Mono,051,14174,1837,1809,22,1831,4
2021-11-22,Monterey,053,433212,49522,48374,3083,51457,611
2021-11-22,Napa,055,140530,13300,13255,115,13370,104
2021-11-22,Nevada,057,99092,9682,9575,335,9910,96
2021-11-22,Orange,059,3164182,312967,310654,15666,326320,5663
2021-11-22,Placer,061,380077,38406,37956,3777,41733,465
2021-11-22,Plumas,063,18699,1926,1858,43,1901,7
2021-11-22,Riverside,065,2383286,372378,367301,16501,383802,5283
2021-11-22,Sacramento,067,1510023,163275,162222,4780,167002,2328
2021-11-22,San Benito,069,59416,7582,7567,176,7743,77
2021-11-22,San Bernardino,071,2135413,363330,359851,11489,371340,5916
2021-11-22,San Diego,073,3302833,383931,382132,22488,404620,4317
2021-11-22,San Francisco,075,870044,54350,53778,2364,56142,669
2021-11-22,San Joaquin,077,732212,102077,101299,5511,106810,1833
2021-11-22,San Luis Obispo,079,281455,30379,29963,1301,31264,358
2021-11-22,San Mateo,081,765935,55359,54330,922,55252,577
2021-11-22,Santa Barbara,083,443738,45589,45279,1578,46857,546
2021-11-22,Santa Clara,085,1922200,150888,149541,1471,151012,1919
2021-11-22,Santa Cruz,087,273765,21156,20891,1014,21905,222
2021-11-22,Shasta,089,179085,22352,22116,3665,25781,393
2021-11-22,Sierra,091,2930,196,193,21,214,0
2021-11-22,Siskiyou,093,43540,3427,3336,1321,4657,54
2021-11-22,Solano,095,438530,46830,46153,1318,47471,356
2021-11-22,Sonoma,097,501317,42619,42344,543,42887,404
2021-11-22,Stanislaus,099,539301,80595,80718,9044,89762,1209
2021-11-22,Sutter,101,95872,14127,14125,373,14498,181
2021-11-22,Tehama,103,63373,8751,8669,1513,10182,127
2021-11-22,Trinity,105,12862,893,785,219,1004,17
2021-11-22,Tulare,107,460477,70522,69314,15632,84946,1075
2021-11-22,Tuolumne,109,53932,7602,7567,111,7678,90
2021-11-22,Ventura,111,848112,99908,99114,4333,103447,1186
2021-11-22,Yolo,113,214977,20389,20227,1117,21344,257
2021-11-22,Yuba,115,75493,10394,10332,362,10694,88
2021-11-21,Alameda,001,1643700,121894,121443,2819,124262,1475
2021-11-21,Alpine,003,1148,103,106,0,106,0
2021-11-21,Amador,005,37829,5687,5662,66,5728,66
2021-11-21,Butte,007,227075,21607,21342,3937,25279,306
2021-11-21,Calaveras,009,45235,4328,4287,59,4346,84
2021-11-21,Colusa,011,21464,2596,2562,656,3218,19
2021-11-21,Contra Costa,013,1133247,101424,100807,2250,103057,1045
2021-11-21,Del Norte,015,27424,3742,3659,55,3714,42
2021-11-21,El Dorado,017,186661,16609,16370,1758,18128,161
2021-11-21,Fresno,019,978130,144775,143203,12990,156193,2242
2021-11-21,Glenn,021,27897,3560,3529,1031,4560,36
2021-11-21,Humboldt,023,135768,9449,9378,635,10013,115
2021-11-21,Imperial,025,180216,34890,34527,3400,37927,766
2021-11-21,Inyo,027,18085,2522,2501,38,2539,44
2021-11-21,Kern,029,883053,131611,130020,23323,153343,1762
2021-11-21,Kings,031,150075,33189,32843,1982,34825,356
2021-11-21,Lake,033,64148,6891,6834,153,6987,110
2021-11-21,Lassen,035,31185,7027,6953,402,7355,47
2021-11-21,Los Angeles,037,10098052,1463174,1453181,54891,1508072,26793
2021-11-21,Madera,039,155013,24101,23856,2230,26086,296
2021-11-21,Marin,041,260295,17947,17829,477,18306,248
2021-11-21,Mariposa,043,17540,1412,1371,58,1429,6
2021-11-21,Mendocino,045,87422,7973,7846,643,8489,89
2021-11-21,Merced,047,269075,42987,42881,2031,44912,660
2021-11-21,Modoc,049,8938,580,551,201,752,5
2021-11-21,Mono,051,14174,1827,1799,21,1820,4
2021-11-21,Monterey,053,433212,49476,48358,3074,51432,611
2021-11-21,Napa,055,140530,13287,13250,115,13365,104
2021-11-21,Nevada,057,99092,9656,9556,334,9890,96
2021-11-21,Orange,059,3164182,312711,310477,15635,326112,5663
2021-11-21,Placer,061,380077,38324,37929,3776,41705,465
2021-11-21,Plumas,063,18699,1921,1858,43,1901,7
2021-11-21,Riverside,065,2383286,371886,367093,16493,383586,5283
2021-11-21,Sacramento,067,1510023,163058,162087,4770,166857,2327
2021-11-21,San Benito,069,59416,7568,7563,175,7738,77
2021-11-21,San Bernardino,071,2135413,362837,359621,11453,371074,5912
2021-11-21,San Diego,073,3302833,383400,380747,22463,403210,4317
2021-11-21,San Francisco,075,870044,54281,53741,2359,56100,669
2021-11-21,San Joaquin,077,732212,101971,101264,5498,106762,1833
2021-11-21,San Luis Obispo,079,281455,30341,29948,1301,31249,358
2021-11-21,San Mateo,081,765935,55307,54290,920,55210,577
2021-11-21,Santa Barbara,083,443738,45529,45237,1575,46812,546
2021-11-21,Santa Clara,085,1922200,150683,149387,1452,150839,1918
2021-11-21,Santa Cruz,087,273765,21112,20866,1012,21878,222
2021-11-21,Shasta,089,179085,22321,22112,3663,25775,393
2021-11-21,Sierra,091,2930,196,193,21,214,0
2021-11-21,Siskiyou,093,43540,3422,3333,1320,4653,54
2021-11-21,Solano,095,438530,46774,46122,1311,47433,356
2021-11-21,Sonoma,097,501317,42559,42298,542,42840,404
2021-11-21,Stanislaus,099,539301,80500,80687,9029,89716,1209
2021-11-21,Sutter,101,95872,14113,14111,373,14484,181
2021-11-21,Tehama,103,63373,8745,8669,1512,10181,127
2021-11-21,Trinity,105,12862,891,784,217,1001,17
2021-11-21,Tulare,107,460477,70439,69285,15593,84878,1075
2021-11-21,Tuolumne,109,53932,7594,7560,110,7670,90
2021-11-21,Ventura,111,848112,99817,99081,4330,103411,1186
2021-11-21,Yolo,113,214977,20361,20209,1114,21323,257
2021-11-21,Yuba,115,75493,10385,10326,362,10688,88
2021-11-20,Alameda,001,1643700,121801,121059,2813,123872,1473
2021-11-20,Alpine,003,1148,103,105,0,105,0
2021-11-20,Amador,005,37829,5681,5652,65,5717,66
2021-11-20,Butte,007,227075,21592,21265,3933,25198,300
2021-11-20,Calaveras,009,45235,4318,4268,59,4327,84
2021-11-20,Colusa,011,21464,2595,2549,655,3204,19
2021-11-20,Contra Costa,013,1133247,101348,100491,2246,102737,1043
2021-11-20,Del Norte,015,27424,3739,3637,55,3692,42
2021-11-20,El Dorado,017,186661,16588,16308,1756,18064,161
2021-11-20,Fresno,019,978130,144706,142579,12981,155560,2233
2021-11-20,Glenn,021,27897,3559,3526,1030,4556,35
2021-11-20,Humboldt,023,135768,9436,9302,633,9935,115
2021-11-20,Imperial,025,180216,34838,34312,3394,37706,766
2021-11-20,Inyo,027,18085,2521,2467,38,2505,44
2021-11-20,Kern,029,883053,131510,129488,23286,152774,1750
2021-11-20,Kings,031,150075,33179,32720,1982,34702,354
2021-11-20,Lake,033,64148,6888,6808,153,6961,110
2021-11-20,Lassen,035,31185,7026,6931,402,7333,47
2021-11-20,Los Angeles,037,10098052,1462554,1448963,54843,1503806,26741
2021-11-20,Madera,039,155013,24087,23720,2226,25946,296
2021-11-20,Marin,041,260295,17932,17774,477,18251,248
2021-11-20,Mariposa,043,17540,1411,1354,58,1412,6
2021-11-20,Mendocino,045,87422,7965,7773,643,8416,89
2021-11-20,Merced,047,269075,42961,42692,2031,44723,656
2021-11-20,Modoc,049,8938,579,550,201,751,5
2021-11-20,Mono,051,14174,1821,1767,21,1788,4
2021-11-20,Monterey,053,433212,49463,48260,3069,51329,609
2021-11-20,Napa,055,140530,13284,13184,115,13299,103
2021-11-20,Nevada,057,99092,9640,9480,334,9814,92
2021-11-20,Orange,059,3164182,312512,309672,15618,325290,5658
2021-11-20,Placer,061,380077,38284,37800,3771,41571,462
2021-11-20,Plumas,063,18699,1917,1841,43,1884,7
2021-11-20,Riverside,065,2383286,371613,365809,16481,382290,5265
2021-11-20,Sacramento,067,1510023,162954,161533,4766,166299,2316
2021-11-20,San Benito,069,59416,7564,7533,175,7708,77
2021-11-20,San Bernardino,071,2135413,362557,358322,11442,369764,5897
2021-11-20,San Diego,073,3302833,383074,380147,22437,402584,4311
2021-11-20,San Francisco,075,870044,54242,53525,2358,55883,669
2021-11-20,San Joaquin,077,732212,101921,100922,5493,106415,1832
2021-11-20,San Luis Obispo,079,281455,30327,29815,1300,31115,355
2021-11-20,San Mateo,081,765935,55273,54132,919,55051,577
2021-11-20,Santa Barbara,083,443738,45497,45074,1575,46649,544
2021-11-20,Santa Clara,085,1922200,150576,148829,1451,150280,1917
2021-11-20,Santa Cruz,087,273765,21094,20756,1012,21768,222
2021-11-20,Shasta,089,179085,22297,21968,3662,25630,383
2021-11-20,Sierra,091,2930,196,191,21,212,0
2021-11-20,Siskiyou,093,43540,3419,3313,1320,4633,54
2021-11-20,Solano,095,438530,46753,46006,1311,47317,356
2021-11-20,Sonoma,097,501317,42528,42151,542,42693,403
2021-11-20,Stanislaus,099,539301,80454,80412,9025,89437,1205
2021-11-20,Sutter,101,95872,14105,14074,373,14447,181
2021-11-20,Tehama,103,63373,8740,8648,1512,10160,125
2021-11-20,Trinity,105,12862,887,771,217,988,17
2021-11-20,Tulare,107,460477,70400,69074,15572,84646,1054
2021-11-20,Tuolumne,109,53932,7586,7511,110,7621,90
2021-11-20,Ventura,111,848112,99768,98893,4323,103216,1186
2021-11-20,Yolo,113,214977,20353,20139,1110,21249,257
2021-11-20,Yuba,115,75493,10379,10290,361,10651,88
2021-11-19,Alameda,001,1643700,121725,121059,2810,123869,1473
2021-11-19,Alpine,003,1148,103,105,0,105,0
2021-11-19,Amador,005,37829,5671,5652,65,5717,66
2021-11-19,Butte,007,227075,21569,21265,3927,25192,300
2021-11-19,Calaveras,009,45235,4311,4268,59,4327,84
2021-11-19,Colusa,011,21464,2593,2549,654,3203,19
2021-11-19,Contra Costa,013,1133247,101291,100491,2241,102732,1043
2021-11-19,Del Norte,015,27424,3734,3637,55,3692,42
2021-11-19,El Dorado,017,186661,16566,16308,1754,18062,161
2021-11-19,Fresno,019,978130,144589,142579,12972,155551,2233
2021-11-19,Glenn,021,27897,3558,3526,1029,4555,35
2021-11-19,Humboldt,023,135768,9424,9302,630,9932,115
2021-11-19,Imperial,025,180216,34801,34312,3387,37699,766
2021-11-19,Inyo,027,18085,2517,2467,38,2505,44
2021-11-19,Kern,029,883053,131407,129488,23243,152731,1750
2021-11-19,Kings,031,150075,33154,32720,1980,34700,354
2021-11-19,Lake,033,64148,6885,6808,153,6961,110
2021-11-19,Lassen,035,31185,7021,6931,401,7332,47
2021-11-19,Los Angeles,037,10098052,1461864,1448963,54790,1503753,26741
2021-11-19,Madera,039,155013,24066,23720,2221,25941,296
2021-11-19,Marin,041,260295,17914,17774,475,18249,248
2021-11-19,Mariposa,043,17540,1409,1354,58,1412,6
2021-11-19,Mendocino,045,87422,7945,7773,643,8416,89
2021-11-19,Merced,047,269075,42935,42692,2030,44722,656
2021-11-19,Modoc,049,8938,578,550,201,751,5
2021-11-19,Mono,051,14174,1810,1767,21,1788,4
2021-11-19,Monterey,053,433212,49441,48260,3069,51329,609
2021-11-19,Napa,055,140530,13274,13184,114,13298,103
2021-11-19,Nevada,057,99092,9627,9480,334,9814,92
2021-11-19,Orange,059,3164182,312358,309672,15593,325265,5658
2021-11-19,Placer,061,380077,38247,37800,3767,41567,462
2021-11-19,Plumas,063,18699,1913,1841,43,1884,7
2021-11-19,Riverside,065,2383286,371339,365809,16477,382286,5265
2021-11-19,Sacramento,067,1510023,162829,161533,4762,166295,2316
2021-11-19,San Benito,069,59416,7558,7533,173,7706,77
2021-11-19,San Bernardino,071,2135413,362233,358322,11433,369755,5897
2021-11-19,San Diego,073,3302833,382683,380147,22411,402558,4311
2021-11-19,San Francisco,075,870044,54204,53525,2358,55883,669
2021-11-19,San Joaquin,077,732212,101864,100922,5489,106411,1832
2021-11-19,San Luis Obispo,079,281455,30309,29815,1298,31113,355
2021-11-19,San Mateo,081,765935,55225,54132,915,55047,577
2021-11-19,Santa Barbara,083,443738,45460,45074,1575,46649,544
2021-11-19,Santa Clara,085,1922200,150429,148829,1448,150277,1917
2021-11-19,Santa Cruz,087,273765,21067,20756,1009,21765,222
2021-11-19,Shasta,089,179085,22285,21968,3661,25629,383
2021-11-19,Sierra,091,2930,196,191,21,212,0
2021-11-19,Siskiyou,093,43540,3416,3313,1320,4633,54
2021-11-19,Solano,095,438530,46723,46006,1307,47313,356
2021-11-19,Sonoma,097,501317,42495,42151,539,42690,403
2021-11-19,Stanislaus,099,539301,80397,80412,9016,89428,1205
2021-11-19,Sutter,101,95872,14103,14074,373,14447,181
2021-11-19,Tehama,103,63373,8737,8648,1512,10160,125
2021-11-19,Trinity,105,12862,885,771,217,988,17
2021-11-19,Tulare,107,460477,70359,69074,15546,84620,1054
2021-11-19,Tuolumne,109,53932,7575,7511,110,7621,90
2021-11-19,Ventura,111,848112,99703,98893,4320,103213,1186
2021-11-19,Yolo,113,214977,20342,20139,1108,21247,257
2021-11-19,Yuba,115,75493,10376,10290,361,10651,88
2021-11-18,Alameda,001,1643700,121600,121059,2803,123862,1473
2021-11-18,Alpine,003,1148,103,105,0,105,0
2021-11-18,Amador,005,37829,5669,5652,65,5717,66
2021-11-18,Butte,007,227075,21552,21265,3919,25184,300
2021-11-18,Calaveras,009,45235,4304,4268,58,4326,84
2021-11-18,Colusa,011,21464,2585,2549,654,3203,19
2021-11-18,Contra Costa,013,1133247,101189,100491,2233,102724,1043
2021-11-18,Del Norte,015,27424,3731,3637,55,3692,42
2021-11-18,El Dorado,017,186661,16546,16308,1751,18059,161
2021-11-18,Fresno,019,978130,144449,142579,12962,155541,2233
2021-11-18,Glenn,021,27897,3557,3526,1028,4554,35
2021-11-18,Humboldt,023,135768,9407,9302,625,9927,115
2021-11-18,Imperial,025,180216,34746,34312,3371,37683,766
2021-11-18,Inyo,027,18085,2509,2467,38,2505,44
2021-11-18,Kern,029,883053,131261,129488,23196,152684,1750
2021-11-18,Kings,031,150075,33117,32720,1977,34697,354
2021-11-18,Lake,033,64148,6880,6808,153,6961,110
2021-11-18,Lassen,035,31185,7018,6931,396,7327,47
2021-11-18,Los Angeles,037,10098052,1460873,1448963,54729,1503692,26741
2021-11-18,Madera,039,155013,24041,23720,2217,25937,296
2021-11-18,Marin,041,260295,17897,17774,471,18245,248
2021-11-18,Mariposa,043,17540,1406,1354,58,1412,6
2021-11-18,Mendocino,045,87422,7923,7773,634,8407,89
2021-11-18,Merced,047,269075,42878,42692,2028,44720,656
2021-11-18,Modoc,049,8938,566,550,201,751,5
2021-11-18,Mono,051,14174,1802,1767,21,1788,4
2021-11-18,Monterey,053,433212,49416,48260,3064,51324,609
2021-11-18,Napa,055,140530,13262,13184,113,13297,103
2021-11-18,Nevada,057,99092,9603,9480,334,9814,92
2021-11-18,Orange,059,3164182,312121,309672,15573,325245,5658
2021-11-18,Placer,061,380077,38204,37800,3756,41556,462
2021-11-18,Plumas,063,18699,1912,1841,43,1884,7
2021-11-18,Riverside,065,2383286,370964,365809,16464,382273,5265
2021-11-18,Sacramento,067,1510023,162601,161533,4747,166280,2316
2021-11-18,San Benito,069,59416,7548,7533,173,7706,77
2021-11-18,San Bernardino,071,2135413,361801,358322,11414,369736,5897
2021-11-18,San Diego,073,3302833,382185,380147,22395,402542,4311
2021-11-18,San Francisco,075,870044,54152,53525,2354,55879,669
2021-11-18,San Joaquin,077,732212,101771,100922,5480,106402,1832
2021-11-18,San Luis Obispo,079,281455,30279,29815,1297,31112,355
2021-11-18,San Mateo,081,765935,55166,54132,912,55044,577
2021-11-18,Santa Barbara,083,443738,45414,45074,1568,46642,544
2021-11-18,Santa Clara,085,1922200,150242,148829,1440,150269,1917
2021-11-18,Santa Cruz,087,273765,21016,20756,1008,21764,222
2021-11-18,Shasta,089,179085,22249,21968,3656,25624,383
2021-11-18,Sierra,091,2930,195,191,21,212,0
2021-11-18,Siskiyou,093,43540,3416,3313,1316,4629,54
2021-11-18,Solano,095,438530,46681,46006,1304,47310,356
2021-11-18,Sonoma,097,501317,42446,42151,537,42688,403
2021-11-18,Stanislaus,099,539301,80330,80412,9008,89420,1205
2021-11-18,Sutter,101,95872,14092,14074,372,14446,181
2021-11-18,Tehama,103,63373,8732,8648,1512,10160,125
2021-11-18,Trinity,105,12862,884,771,217,988,17
2021-11-18,Tulare,107,460477,70285,69074,15502,84576,1054
2021-11-18,Tuolumne,109,53932,7565,7511,110,7621,90
2021-11-18,Ventura,111,848112,99626,98893,4316,103209,1186
2021-11-18,Yolo,113,214977,20325,20139,1104,21243,257
2021-11-18,Yuba,115,75493,10370,10290,361,10651,88
2021-11-17,Alameda,001,1643700,121478,120913,2802,123715,1472
2021-11-17,Alpine,003,1148,103,105,0,105,0
2021-11-17,Amador,005,37829,5663,5646,65,5711,66
2021-11-17,Butte,007,227075,21526,21230,3916,25146,300
2021-11-17,Calaveras,009,45235,4297,4259,58,4317,84
2021-11-17,Colusa,011,21464,2582,2546,653,3199,19
2021-11-17,Contra Costa,013,1133247,101097,100387,2229,102616,1039
2021-11-17,Del Norte,015,27424,3728,3630,55,3685,42
2021-11-17,El Dorado,017,186661,16526,16269,1750,18019,161
2021-11-17,Fresno,019,978130,144267,142366,12949,155315,2230
2021-11-17,Glenn,021,27897,3555,3527,1026,4553,34
2021-11-17,Humboldt,023,135768,9396,9270,622,9892,115
2021-11-17,Imperial,025,180216,34690,34256,3350,37606,766
2021-11-17,Inyo,027,18085,2503,2457,38,2495,44
2021-11-17,Kern,029,883053,131088,129307,23154,152461,1743
2021-11-17,Kings,031,150075,33090,32669,1973,34642,352
2021-11-17,Lake,033,64148,6876,6795,152,6947,110
2021-11-17,Lassen,035,31185,7016,6918,396,7314,47
2021-11-17,Los Angeles,037,10098052,1459773,1447947,54662,1502609,26721
2021-11-17,Madera,039,155013,24008,23673,2215,25888,287
2021-11-17,Marin,041,260295,17877,17757,469,18226,248
2021-11-17,Mariposa,043,17540,1402,1353,58,1411,6
2021-11-17,Mendocino,045,87422,7915,7735,633,8368,89
2021-11-17,Merced,047,269075,42819,42612,2023,44635,654
2021-11-17,Modoc,049,8938,562,540,201,741,5
2021-11-17,Mono,051,14174,1798,1765,21,1786,5
2021-11-17,Monterey,053,433212,49368,48221,3053,51274,609
2021-11-17,Napa,055,140530,13239,13167,113,13280,103
2021-11-17,Nevada,057,99092,9590,9447,334,9781,92
2021-11-17,Orange,059,3164182,311874,309396,15539,324935,5651
2021-11-17,Placer,061,380077,38156,37725,3748,41473,460
2021-11-17,Plumas,063,18699,1907,1833,43,1876,7
2021-11-17,Riverside,065,2383286,370553,365406,16451,381857,5229
2021-11-17,Sacramento,067,1510023,162432,161269,4740,166009,2302
2021-11-17,San Benito,069,59416,7541,7524,173,7697,77
2021-11-17,San Bernardino,071,2135413,361436,357947,11397,369344,5893
2021-11-17,San Diego,073,3302833,381694,379769,22369,402138,4301
2021-11-17,San Francisco,075,870044,54097,53469,2351,55820,667
2021-11-17,San Joaquin,077,732212,101669,100764,5475,106239,1828
2021-11-17,San Luis Obispo,079,281455,30253,29731,1294,31025,354
2021-11-17,San Mateo,081,765935,55098,54092,909,55001,577
2021-11-17,Santa Barbara,083,443738,45375,45000,1568,46568,542
2021-11-17,Santa Clara,085,1922200,150078,148626,1432,150058,1915
2021-11-17,Santa Cruz,087,273765,20981,20700,1008,21708,222
2021-11-17,Shasta,089,179085,22216,21883,3654,25537,382
2021-11-17,Sierra,091,2930,194,189,21,210,0
2021-11-17,Siskiyou,093,43540,3412,3307,1313,4620,54
2021-11-17,Solano,095,438530,46648,45948,1303,47251,353
2021-11-17,Sonoma,097,501317,42400,42093,534,42627,403
2021-11-17,Stanislaus,099,539301,80241,80276,8998,89274,1199
2021-11-17,Sutter,101,95872,14078,14064,370,14434,181
2021-11-17,Tehama,103,63373,8722,8633,1509,10142,125
2021-11-17,Trinity,105,12862,883,765,217,982,17
2021-11-17,Tulare,107,460477,70214,68977,15475,84452,1047
2021-11-17,Tuolumne,109,53932,7548,7485,110,7595,90
2021-11-17,Ventura,111,848112,99564,98812,4310,103122,1183
2021-11-17,Yolo,113,214977,20306,20100,1101,21201,257
2021-11-17,Yuba,115,75493,10358,10275,357,10632,88
2021-11-16,Alameda,001,1643700,121370,120809,2798,123607,1467
2021-11-16,Alpine,003,1148,103,105,0,105,0
2021-11-16,Amador,005,37829,5657,5644,65,5709,66
2021-11-16,Butte,007,227075,21500,21208,3911,25119,297
2021-11-16,Calaveras,009,45235,4288,4249,58,4307,83
2021-11-16,Colusa,011,21464,2576,2538,653,3191,19
2021-11-16,Contra Costa,013,1133247,100976,100320,2226,102546,1038
2021-11-16,Del Norte,015,27424,3722,3630,55,3685,42
2021-11-16,El Dorado,017,186661,16501,16248,1748,17996,159
2021-11-16,Fresno,019,978130,144081,142200,12927,155127,2218
2021-11-16,Glenn,021,27897,3554,3527,1023,4550,34
2021-11-16,Humboldt,023,135768,9376,9252,618,9870,115
2021-11-16,Imperial,025,180216,34606,34177,3336,37513,766
2021-11-16,Inyo,027,18085,2496,2449,38,2487,42
2021-11-16,Kern,029,883053,130928,129136,23093,152229,1735
2021-11-16,Kings,031,150075,33038,32614,1966,34580,350
2021-11-16,Lake,033,64148,6871,6789,152,6941,110
2021-11-16,Lassen,035,31185,7006,6915,396,7311,47
2021-11-16,Los Angeles,037,10098052,1458599,1446815,54590,1501405,26703
2021-11-16,Madera,039,155013,23970,23642,2209,25851,287
2021-11-16,Marin,041,260295,17858,17736,468,18204,248
2021-11-16,Mariposa,043,17540,1394,1349,57,1406,6
2021-11-16,Mendocino,045,87422,7873,7723,629,8352,89
2021-11-16,Merced,047,269075,42782,42578,2016,44594,653
2021-11-16,Modoc,049,8938,561,539,200,739,5
2021-11-16,Mono,051,14174,1789,1767,21,1788,4
2021-11-16,Monterey,053,433212,49338,48195,3039,51234,609
2021-11-16,Napa,055,140530,13228,13151,113,13264,103
2021-11-16,Nevada,057,99092,9573,9435,333,9768,92
2021-11-16,Orange,059,3164182,311607,309170,15505,324675,5651
2021-11-16,Placer,061,380077,38114,37676,3742,41418,459
2021-11-16,Plumas,063,18699,1898,1832,43,1875,7
2021-11-16,Riverside,065,2383286,370130,365078,16429,381507,5208
2021-11-16,Sacramento,067,1510023,162252,161102,4728,165830,2299
2021-11-16,San Benito,069,59416,7527,7513,173,7686,77
2021-11-16,San Bernardino,071,2135413,361015,357528,11344,368872,5901
2021-11-16,San Diego,073,3302833,381139,379435,22342,401777,4287
2021-11-16,San Francisco,075,870044,54024,53415,2343,55758,667
2021-11-16,San Joaquin,077,732212,101529,100637,5460,106097,1807
2021-11-16,San Luis Obispo,079,281455,30221,29703,1291,30994,356
2021-11-16,San Mateo,081,765935,55036,54034,907,54941,577
2021-11-16,Santa Barbara,083,443738,45307,44932,1565,46497,539
2021-11-16,Santa Clara,085,1922200,149897,148452,1420,149872,1916
2021-11-16,Santa Cruz,087,273765,20936,20684,1006,21690,222
2021-11-16,Shasta,089,179085,22177,21853,3650,25503,379
2021-11-16,Sierra,091,2930,194,189,21,210,0
2021-11-16,Siskiyou,093,43540,3409,3304,1311,4615,54
2021-11-16,Solano,095,438530,46608,45908,1302,47210,351
2021-11-16,Sonoma,097,501317,42351,42056,533,42589,401
2021-11-16,Stanislaus,099,539301,80146,80214,8975,89189,1196
2021-11-16,Sutter,101,95872,14066,14058,369,14427,181
2021-11-16,Tehama,103,63373,8715,8621,1502,10123,125
2021-11-16,Trinity,105,12862,883,762,216,978,17
2021-11-16,Tulare,107,460477,70134,68881,15440,84321,1039
2021-11-16,Tuolumne,109,53932,7538,7478,110,7588,90
2021-11-16,Ventura,111,848112,99489,98731,4307,103038,1183
2021-11-16,Yolo,113,214977,20267,20077,1099,21176,257
2021-11-16,Yuba,115,75493,10350,10262,355,10617,85
2021-11-15,Alameda,001,1643700,121214,120731,2794,123525,1464
2021-11-15,Alpine,003,1148,103,105,0,105,0
2021-11-15,Amador,005,37829,5652,5637,65,5702,66
2021-11-15,Butte,007,227075,21476,21182,3906,25088,296
2021-11-15,Calaveras,009,45235,4274,4237,58,4295,83
2021-11-15,Colusa,011,21464,2569,2535,650,3185,19
2021-11-15,Contra Costa,013,1133247,100870,100251,2223,102474,1038
2021-11-15,Del Norte,015,27424,3717,3630,54,3684,42
2021-11-15,El Dorado,017,186661,16477,16236,1744,17980,159
2021-11-15,Fresno,019,978130,143859,142015,12905,154920,2210
2021-11-15,Glenn,021,27897,3552,3526,1023,4549,34
2021-11-15,Humboldt,023,135768,9354,9230,610,9840,115
2021-11-15,Imperial,025,180216,34533,34130,3320,37450,766
2021-11-15,Inyo,027,18085,2491,2442,38,2480,42
2021-11-15,Kern,029,883053,130719,128928,23023,151951,1730
2021-11-15,Kings,031,150075,33004,32584,1961,34545,348
2021-11-15,Lake,033,64148,6867,6784,152,6936,109
2021-11-15,Lassen,035,31185,6995,6915,394,7309,47
2021-11-15,Los Angeles,037,10098052,1457409,1446114,54527,1500641,26677
2021-11-15,Madera,039,155013,23932,23605,2198,25803,287
2021-11-15,Marin,041,260295,17841,17723,467,18190,248
2021-11-15,Mariposa,043,17540,1393,1347,55,1402,6
2021-11-15,Mendocino,045,87422,7853,7694,623,8317,89
2021-11-15,Merced,047,269075,42725,42552,2005,44557,648
2021-11-15,Modoc,049,8938,560,538,199,737,5
2021-11-15,Mono,051,14174,1784,1763,21,1784,4
2021-11-15,Monterey,053,433212,49306,48154,3033,51187,609
2021-11-15,Napa,055,140530,13220,13143,113,13256,103
2021-11-15,Nevada,057,99092,9544,9420,332,9752,92
2021-11-15,Orange,059,3164182,311330,308859,15480,324339,5646
2021-11-15,Placer,061,380077,38050,37610,3738,41348,452
2021-11-15,Plumas,063,18699,1891,1829,43,1872,7
2021-11-15,Riverside,065,2383286,369683,364750,16410,381160,5199
2021-11-15,Sacramento,067,1510023,162032,160937,4716,165653,2293
2021-11-15,San Benito,069,59416,7522,7511,172,7683,77
2021-11-15,San Bernardino,071,2135413,360588,357306,11325,368631,5898
2021-11-15,San Diego,073,3302833,380602,378845,22317,401162,4284
2021-11-15,San Francisco,075,870044,53957,53374,2340,55714,667
2021-11-15,San Joaquin,077,732212,101375,100587,5449,106036,1799
2021-11-15,San Luis Obispo,079,281455,30178,29669,1279,30948,351
2021-11-15,San Mateo,081,765935,54983,54010,905,54915,576
2021-11-15,Santa Barbara,083,443738,45251,44879,1559,46438,539
2021-11-15,Santa Clara,085,1922200,149680,148313,1413,149726,1914
2021-11-15,Santa Cruz,087,273765,20894,20630,1005,21635,223
2021-11-15,Shasta,089,179085,22132,21779,3645,25424,374
2021-11-15,Sierra,091,2930,194,189,21,210,0
2021-11-15,Siskiyou,093,43540,3402,3302,1309,4611,54
2021-11-15,Solano,095,438530,46569,45885,1297,47182,351
2021-11-15,Sonoma,097,501317,42300,42021,532,42553,401
2021-11-15,Stanislaus,099,539301,80061,80129,8961,89090,1174
2021-11-15,Sutter,101,95872,14053,14043,368,14411,181
2021-11-15,Tehama,103,63373,8709,8615,1501,10116,125
2021-11-15,Trinity,105,12862,881,757,214,971,17
2021-11-15,Tulare,107,460477,70047,68826,15395,84221,1039
2021-11-15,Tuolumne,109,53932,7527,7461,110,7571,90
2021-11-15,Ventura,111,848112,99405,98605,4302,102907,1183
2021-11-15,Yolo,113,214977,20237,20065,1094,21159,255
2021-11-15,Yuba,115,75493,10331,10254,351,10605,85
2021-11-14,Alameda,001,1643700,121040,120629,2790,123419,1461
2021-11-14,Alpine,003,1148,102,105,0,105,0
2021-11-14,Amador,005,37829,5645,5632,64,5696,66
2021-11-14,Butte,007,227075,21444,21146,3897,25043,296
2021-11-14,Calaveras,009,45235,4263,4222,58,4280,83
2021-11-14,Colusa,011,21464,2567,2532,647,3179,19
2021-11-14,Contra Costa,013,1133247,100762,100188,2221,102409,1038
2021-11-14,Del Norte,015,27424,3714,3629,54,3683,42
2021-11-14,El Dorado,017,186661,16435,16212,1739,17951,159
2021-11-14,Fresno,019,978130,143577,141869,12872,154741,2209
2021-11-14,Glenn,021,27897,3550,3521,1023,4544,34
2021-11-14,Humboldt,023,135768,9323,9215,600,9815,115
2021-11-14,Imperial,025,180216,34430,34078,3305,37383,766
2021-11-14,Inyo,027,18085,2479,2441,38,2479,42
2021-11-14,Kern,029,883053,130479,128842,22953,151795,1730
2021-11-14,Kings,031,150075,32947,32545,1954,34499,349
2021-11-14,Lake,033,64148,6859,6777,152,6929,109
2021-11-14,Lassen,035,31185,6985,6911,393,7304,47
2021-11-14,Los Angeles,037,10098052,1456041,1445284,54451,1499735,26667
2021-11-14,Madera,039,155013,23882,23566,2189,25755,287
2021-11-14,Marin,041,260295,17826,17712,467,18179,247
2021-11-14,Mariposa,043,17540,1383,1337,51,1388,6
2021-11-14,Mendocino,045,87422,7820,7684,618,8302,89
2021-11-14,Merced,047,269075,42635,42513,1999,44512,648
2021-11-14,Modoc,049,8938,558,538,199,737,5
2021-11-14,Mono,051,14174,1772,1760,21,1781,4
2021-11-14,Monterey,053,433212,49251,48135,3015,51150,609
2021-11-14,Napa,055,140530,13202,13132,113,13245,103
2021-11-14,Nevada,057,99092,9516,9408,332,9740,92
2021-11-14,Orange,059,3164182,311011,308699,15459,324158,5646
2021-11-14,Placer,061,380077,37970,37569,3728,41297,452
2021-11-14,Plumas,063,18699,1888,1829,42,1871,7
2021-11-14,Riverside,065,2383286,369185,364490,16393,380883,5199
2021-11-14,Sacramento,067,1510023,161797,160761,4699,165460,2295
2021-11-14,San Benito,069,59416,7511,7507,171,7678,77
2021-11-14,San Bernardino,071,2135413,360007,357014,11308,368322,5897
2021-11-14,San Diego,073,3302833,380005,377633,22286,399919,4280
2021-11-14,San Francisco,075,870044,53881,53338,2335,55673,667
2021-11-14,San Joaquin,077,732212,101247,100518,5444,105962,1799
2021-11-14,San Luis Obispo,079,281455,30097,29645,1275,30920,352
2021-11-14,San Mateo,081,765935,54930,53978,903,54881,576
2021-11-14,Santa Barbara,083,443738,45172,44842,1556,46398,539
2021-11-14,Santa Clara,085,1922200,149482,148152,1405,149557,1913
2021-11-14,Santa Cruz,087,273765,20840,20609,1003,21612,223
2021-11-14,Shasta,089,179085,22080,21771,3632,25403,373
2021-11-14,Sierra,091,2930,194,189,21,210,0
2021-11-14,Siskiyou,093,43540,3393,3302,1308,4610,54
2021-11-14,Solano,095,438530,46514,45860,1290,47150,351
2021-11-14,Sonoma,097,501317,42234,41974,530,42504,401
2021-11-14,Stanislaus,099,539301,79926,80076,8943,89019,1174
2021-11-14,Sutter,101,95872,14036,14031,363,14394,181
2021-11-14,Tehama,103,63373,8699,8607,1499,10106,125
2021-11-14,Trinity,105,12862,878,754,212,966,17
2021-11-14,Tulare,107,460477,69929,68772,15337,84109,1037
2021-11-14,Tuolumne,109,53932,7509,7439,109,7548,90
2021-11-14,Ventura,111,848112,99290,98550,4301,102851,1183
2021-11-14,Yolo,113,214977,20210,20040,1088,21128,255
2021-11-14,Yuba,115,75493,10324,10238,350,10588,85
2021-11-13,Alameda,001,1643700,120970,120407,2789,123196,1454
2021-11-13,Alpine,003,1148,102,105,0,105,0
2021-11-13,Amador,005,37829,5644,5614,64,5678,66
2021-11-13,Butte,007,227075,21423,21104,3894,24998,296
2021-11-13,Calaveras,009,45235,4252,4203,58,4261,83
2021-11-13,Colusa,011,21464,2565,2522,647,3169,19
2021-11-13,Contra Costa,013,1133247,100690,100004,2215,102219,1028
2021-11-13,Del Norte,015,27424,3714,3629,54,3683,42
2021-11-13,El Dorado,017,186661,16422,16163,1736,17899,159
2021-11-13,Fresno,019,978130,143470,141452,12858,154310,2205
2021-11-13,Glenn,021,27897,3550,3514,1022,4536,34
2021-11-13,Humboldt,023,135768,9307,9177,595,9772,115
2021-11-13,Imperial,025,180216,34380,33990,3288,37278,766
2021-11-13,Inyo,027,18085,2473,2436,38,2474,42
2021-11-13,Kern,029,883053,130377,128472,22909,151381,1719
2021-11-13,Kings,031,150075,32930,32452,1953,34405,347
2021-11-13,Lake,033,64148,6854,6769,152,6921,109
2021-11-13,Lassen,035,31185,6980,6897,393,7290,47
2021-11-13,Los Angeles,037,10098052,1455385,1443088,54412,1497500,26649
2021-11-13,Madera,039,155013,23851,23462,2184,25646,287
2021-11-13,Marin,041,260295,17813,17684,465,18149,247
2021-11-13,Mariposa,043,17540,1380,1323,51,1374,6
2021-11-13,Mendocino,045,87422,7801,7652,617,8269,89
2021-11-13,Merced,047,269075,42597,42411,1996,44407,644
2021-11-13,Modoc,049,8938,557,536,199,735,5
2021-11-13,Mono,051,14174,1768,1750,21,1771,4
2021-11-13,Monterey,053,433212,49225,48087,3013,51100,609
2021-11-13,Napa,055,140530,13194,13110,113,13223,103
2021-11-13,Nevada,057,99092,9496,9369,330,9699,92
2021-11-13,Orange,059,3164182,310844,308211,15431,323642,5641
2021-11-13,Placer,061,380077,37920,37453,3725,41178,445
2021-11-13,Plumas,063,18699,1885,1828,42,1870,8
2021-11-13,Riverside,065,2383286,368879,363801,16386,380187,5187
2021-11-13,Sacramento,067,1510023,161660,160397,4687,165084,2291
2021-11-13,San Benito,069,59416,7498,7491,170,7661,77
2021-11-13,San Bernardino,071,2135413,359754,356325,11301,367626,5873
2021-11-13,San Diego,073,3302833,379675,377633,22258,399891,4280
2021-11-13,San Francisco,075,870044,53849,53195,2334,55529,667
2021-11-13,San Joaquin,077,732212,101190,100263,5435,105698,1799
2021-11-13,San Luis Obispo,079,281455,30067,29589,1273,30862,351
2021-11-13,San Mateo,081,765935,54892,53853,902,54755,574
2021-11-13,Santa Barbara,083,443738,45139,44734,1556,46290,537
2021-11-13,Santa Clara,085,1922200,149363,147821,1400,149221,1905
2021-11-13,Santa Cruz,087,273765,20825,20565,1002,21567,223
2021-11-13,Shasta,089,179085,22049,21713,3628,25341,366
2021-11-13,Sierra,091,2930,193,188,21,209,0
2021-11-13,Siskiyou,093,43540,3384,3299,1307,4606,54
2021-11-13,Solano,095,438530,46485,45774,1286,47060,350
2021-11-13,Sonoma,097,501317,42200,41882,529,42411,399
2021-11-13,Stanislaus,099,539301,79851,79872,8929,88801,1174
2021-11-13,Sutter,101,95872,14026,14017,362,14379,181
2021-11-13,Tehama,103,63373,8693,8592,1495,10087,125
2021-11-13,Trinity,105,12862,877,749,212,961,17
2021-11-13,Tulare,107,460477,69864,68619,15314,83933,1033
2021-11-13,Tuolumne,109,53932,7491,7392,109,7501,90
2021-11-13,Ventura,111,848112,99232,98452,4298,102750,1183
2021-11-13,Yolo,113,214977,20196,20009,1083,21092,255
2021-11-13,Yuba,115,75493,10314,10218,348,10566,85
2021-11-12,Alameda,001,1643700,120886,120407,2786,123193,1454
2021-11-12,Alpine,003,1148,102,105,0,105,0
2021-11-12,Amador,005,37829,5640,5614,63,5677,66
2021-11-12,Butte,007,227075,21405,21104,3890,24994,296
2021-11-12,Calaveras,009,45235,4241,4203,58,4261,83
2021-11-12,Colusa,011,21464,2561,2522,646,3168,19
2021-11-12,Contra Costa,013,1133247,100636,100004,2214,102218,1028
2021-11-12,Del Norte,015,27424,3714,3629,54,3683,42
2021-11-12,El Dorado,017,186661,16403,16163,1735,17898,159
2021-11-12,Fresno,019,978130,143327,141452,12845,154297,2205
2021-11-12,Glenn,021,27897,3547,3514,1021,4535,34
2021-11-12,Humboldt,023,135768,9300,9177,593,9770,115
2021-11-12,Imperial,025,180216,34353,33990,3278,37268,766
2021-11-12,Inyo,027,18085,2469,2436,38,2474,42
2021-11-12,Kern,029,883053,130240,128472,22877,151349,1719
2021-11-12,Kings,031,150075,32904,32452,1951,34403,347
2021-11-12,Lake,033,64148,6850,6769,152,6921,109
2021-11-12,Lassen,035,31185,6976,6897,392,7289,47
2021-11-12,Los Angeles,037,10098052,1454658,1443088,54367,1497455,26649
2021-11-12,Madera,039,155013,23822,23462,2179,25641,287
2021-11-12,Marin,041,260295,17797,17684,464,18148,247
2021-11-12,Mariposa,043,17540,1373,1323,51,1374,6
2021-11-12,Mendocino,045,87422,7789,7652,614,8266,89
2021-11-12,Merced,047,269075,42568,42411,1994,44405,644
2021-11-12,Modoc,049,8938,556,536,199,735,5
2021-11-12,Mono,051,14174,1766,1750,21,1771,4
2021-11-12,Monterey,053,433212,49193,48087,3007,51094,609
2021-11-12,Napa,055,140530,13185,13110,113,13223,103
2021-11-12,Nevada,057,99092,9483,9369,329,9698,92
2021-11-12,Orange,059,3164182,310656,308211,15413,323624,5641
2021-11-12,Placer,061,380077,37881,37453,3722,41175,445
2021-11-12,Plumas,063,18699,1879,1828,42,1870,8
2021-11-12,Riverside,065,2383286,368612,363801,16382,380183,5187
2021-11-12,Sacramento,067,1510023,161501,160397,4682,165079,2291
2021-11-12,San Benito,069,59416,7498,7491,170,7661,77
2021-11-12,San Bernardino,071,2135413,359445,356325,11291,367616,5873
2021-11-12,San Diego,073,3302833,379308,377633,22236,399869,4280
2021-11-12,San Francisco,075,870044,53815,53195,2330,55525,667
2021-11-12,San Joaquin,077,732212,101145,100263,5428,105691,1799
2021-11-12,San Luis Obispo,079,281455,30038,29589,1272,30861,351
2021-11-12,San Mateo,081,765935,54842,53853,899,54752,574
2021-11-12,Santa Barbara,083,443738,45084,44734,1555,46289,537
2021-11-12,Santa Clara,085,1922200,149221,147821,1396,149217,1905
2021-11-12,Santa Cruz,087,273765,20797,20565,1000,21565,223
2021-11-12,Shasta,089,179085,22016,21713,3625,25338,366
2021-11-12,Sierra,091,2930,192,188,21,209,0
2021-11-12,Siskiyou,093,43540,3383,3299,1305,4604,54
2021-11-12,Solano,095,438530,46458,45774,1282,47056,350
2021-11-12,Sonoma,097,501317,42160,41882,529,42411,399
2021-11-12,Stanislaus,099,539301,79799,79872,8921,88793,1174
2021-11-12,Sutter,101,95872,14019,14017,362,14379,181
2021-11-12,Tehama,103,63373,8689,8592,1494,10086,125
2021-11-12,Trinity,105,12862,870,749,212,961,17
2021-11-12,Tulare,107,460477,69822,68619,15279,83898,1033
2021-11-12,Tuolumne,109,53932,7478,7392,108,7500,90
2021-11-12,Ventura,111,848112,99167,98452,4297,102749,1183
2021-11-12,Yolo,113,214977,20182,20009,1077,21086,255
2021-11-12,Yuba,115,75493,10305,10218,347,10565,85
2021-11-11,Alameda,001,1643700,120772,120147,2778,122925,1453
2021-11-11,Alpine,003,1148,102,105,0,105,0
2021-11-11,Amador,005,37829,5637,5603,62,5665,66
2021-11-11,Butte,007,227075,21362,21047,3883,24930,293
2021-11-11,Calaveras,009,45235,4223,4179,58,4237,83
2021-11-11,Colusa,011,21464,2553,2518,644,3162,19
2021-11-11,Contra Costa,013,1133247,100532,99808,2210,102018,1028
2021-11-11,Del Norte,015,27424,3712,3622,54,3676,42
2021-11-11,El Dorado,017,186661,16369,16085,1732,17817,159
2021-11-11,Fresno,019,978130,143122,140833,12811,153644,2202
2021-11-11,Glenn,021,27897,3545,3503,1020,4523,34
2021-11-11,Humboldt,023,135768,9277,9125,590,9715,115
2021-11-11,Imperial,025,180216,34284,33844,3256,37100,766
2021-11-11,Inyo,027,18085,2464,2428,38,2466,42
2021-11-11,Kern,029,883053,130055,128023,22814,150837,1709
2021-11-11,Kings,031,150075,32854,32318,1949,34267,345
2021-11-11,Lake,033,64148,6843,6745,152,6897,107
2021-11-11,Lassen,035,31185,6970,6875,392,7267,47
2021-11-11,Los Angeles,037,10098052,1453563,1440436,54309,1494745,26614
2021-11-11,Madera,039,155013,23774,23316,2171,25487,287
2021-11-11,Marin,041,260295,17787,17639,464,18103,247
2021-11-11,Mariposa,043,17540,1363,1317,51,1368,6
2021-11-11,Mendocino,045,87422,7774,7612,605,8217,89
2021-11-11,Merced,047,269075,42512,42292,1991,44283,643
2021-11-11,Modoc,049,8938,554,536,199,735,5
2021-11-11,Mono,051,14174,1762,1743,21,1764,4
2021-11-11,Monterey,053,433212,49158,48008,2995,51003,609
2021-11-11,Napa,055,140530,13177,13075,113,13188,103
2021-11-11,Nevada,057,99092,9461,9308,329,9637,92
2021-11-11,Orange,059,3164182,310383,307674,15376,323050,5633
2021-11-11,Placer,061,380077,37830,37333,3714,41047,440
2021-11-11,Plumas,063,18699,1875,1814,42,1856,7
2021-11-11,Riverside,065,2383286,368177,362930,16364,379294,5175
2021-11-11,Sacramento,067,1510023,161289,159962,4663,164625,2289
2021-11-11,San Benito,069,59416,7490,7473,170,7643,76
2021-11-11,San Bernardino,071,2135413,359015,355413,11278,366691,5849
2021-11-11,San Diego,073,3302833,378799,376428,22213,398641,4272
2021-11-11,San Francisco,075,870044,53756,53063,2329,55392,666
2021-11-11,San Joaquin,077,732212,101050,99937,5412,105349,1799
2021-11-11,San Luis Obispo,079,281455,29987,29532,1270,30802,351
2021-11-11,San Mateo,081,765935,54794,53722,894,54616,574
2021-11-11,Santa Barbara,083,443738,45027,44603,1552,46155,534
2021-11-11,Santa Clara,085,1922200,149039,147458,1390,148848,1901
2021-11-11,Santa Cruz,087,273765,20752,20479,1000,21479,222
2021-11-11,Shasta,089,179085,21969,21600,3623,25223,364
2021-11-11,Sierra,091,2930,191,186,21,207,0
2021-11-11,Siskiyou,093,43540,3377,3297,1304,4601,53
2021-11-11,Solano,095,438530,46421,45679,1281,46960,350
2021-11-11,Sonoma,097,501317,42123,41774,529,42303,395
2021-11-11,Stanislaus,099,539301,79717,79570,8905,88475,1166
2021-11-11,Sutter,101,95872,14005,13993,361,14354,181
2021-11-11,Tehama,103,63373,8677,8565,1492,10057,125
2021-11-11,Trinity,105,12862,869,748,212,960,17
2021-11-11,Tulare,107,460477,69729,68367,15243,83610,1028
2021-11-11,Tuolumne,109,53932,7465,7354,108,7462,90
2021-11-11,Ventura,111,848112,99089,98297,4290,102587,1182
2021-11-11,Yolo,113,214977,20155,19946,1075,21021,255
2021-11-11,Yuba,115,75493,10289,10191,347,10538,85
2021-11-10,Alameda,001,1643700,120663,120147,2769,122916,1453
2021-11-10,Alpine,003,1148,102,105,0,105,0
2021-11-10,Amador,005,37829,5631,5603,62,5665,66
2021-11-10,Butte,007,227075,21335,21047,3879,24926,293
2021-11-10,Calaveras,009,45235,4212,4179,58,4237,83
2021-11-10,Colusa,011,21464,2547,2518,644,3162,19
2021-11-10,Contra Costa,013,1133247,100449,99808,2206,102014,1028
2021-11-10,Del Norte,015,27424,3711,3622,54,3676,42
2021-11-10,El Dorado,017,186661,16353,16085,1731,17816,159
2021-11-10,Fresno,019,978130,142944,140833,12798,153631,2202
2021-11-10,Glenn,021,27897,3545,3503,1019,4522,34
2021-11-10,Humboldt,023,135768,9259,9125,590,9715,115
2021-11-10,Imperial,025,180216,34236,33844,3237,37081,766
2021-11-10,Inyo,027,18085,2457,2428,38,2466,42
2021-11-10,Kern,029,883053,129905,128023,22759,150782,1709
2021-11-10,Kings,031,150075,32821,32318,1947,34265,345
2021-11-10,Lake,033,64148,6833,6745,152,6897,107
2021-11-10,Lassen,035,31185,6965,6875,392,7267,47
2021-11-10,Los Angeles,037,10098052,1452613,1440436,54251,1494687,26614
2021-11-10,Madera,039,155013,23724,23316,2165,25481,287
2021-11-10,Marin,041,260295,17774,17639,462,18101,247
2021-11-10,Mariposa,043,17540,1357,1317,51,1368,6
2021-11-10,Mendocino,045,87422,7762,7612,604,8216,89
2021-11-10,Merced,047,269075,42477,42292,1989,44281,643
2021-11-10,Modoc,049,8938,553,536,198,734,5
2021-11-10,Mono,051,14174,1760,1743,21,1764,4
2021-11-10,Monterey,053,433212,49124,48008,2984,50992,609
2021-11-10,Napa,055,140530,13163,13075,112,13187,103
2021-11-10,Nevada,057,99092,9454,9308,327,9635,92
2021-11-10,Orange,059,3164182,310120,307674,15344,323018,5633
2021-11-10,Placer,061,380077,37784,37333,3707,41040,440
2021-11-10,Plumas,063,18699,1869,1814,41,1855,7
2021-11-10,Riverside,065,2383286,367796,362930,16358,379288,5175
2021-11-10,Sacramento,067,1510023,161134,159962,4653,164615,2289
2021-11-10,San Benito,069,59416,7482,7473,170,7643,76
2021-11-10,San Bernardino,071,2135413,358674,355413,11271,366684,5849
2021-11-10,San Diego,073,3302833,378395,376428,22191,398619,4272
2021-11-10,San Francisco,075,870044,53695,53063,2326,55389,666
2021-11-10,San Joaquin,077,732212,100944,99937,5407,105344,1799
2021-11-10,San Luis Obispo,079,281455,29956,29532,1269,30801,351
2021-11-10,San Mateo,081,765935,54741,53722,893,54615,574
2021-11-10,Santa Barbara,083,443738,44989,44603,1551,46154,534
2021-11-10,Santa Clara,085,1922200,148892,147458,1384,148842,1901
2021-11-10,Santa Cruz,087,273765,20725,20479,999,21478,222
2021-11-10,Shasta,089,179085,21933,21600,3621,25221,364
2021-11-10,Sierra,091,2930,190,186,21,207,0
2021-11-10,Siskiyou,093,43540,3375,3297,1304,4601,53
2021-11-10,Solano,095,438530,46391,45679,1279,46958,350
2021-11-10,Sonoma,097,501317,42072,41774,529,42303,395
2021-11-10,Stanislaus,099,539301,79615,79570,8889,88459,1166
2021-11-10,Sutter,101,95872,13997,13993,361,14354,181
2021-11-10,Tehama,103,63373,8665,8565,1486,10051,125
2021-11-10,Trinity,105,12862,865,748,211,959,17
2021-11-10,Tulare,107,460477,69669,68367,15204,83571,1028
2021-11-10,Tuolumne,109,53932,7441,7354,108,7462,90
2021-11-10,Ventura,111,848112,99018,98297,4290,102587,1182
2021-11-10,Yolo,113,214977,20136,19946,1074,21020,255
2021-11-10,Yuba,115,75493,10280,10191,347,10538,85
2021-11-09,Alameda,001,1643700,120525,120051,2760,122811,1450
2021-11-09,Alpine,003,1148,102,105,0,105,0
2021-11-09,Amador,005,37829,5625,5596,62,5658,66
2021-11-09,Butte,007,227075,21311,21022,3875,24897,291
2021-11-09,Calaveras,009,45235,4208,4174,58,4232,84
2021-11-09,Colusa,011,21464,2542,2517,643,3160,19
2021-11-09,Contra Costa,013,1133247,100354,99732,2198,101930,1028
2021-11-09,Del Norte,015,27424,3710,3620,54,3674,42
2021-11-09,El Dorado,017,186661,16315,16073,1726,17799,160
2021-11-09,Fresno,019,978130,142698,140666,12783,153449,2188
2021-11-09,Glenn,021,27897,3540,3499,1018,4517,34
2021-11-09,Humboldt,023,135768,9238,9112,585,9697,115
2021-11-09,Imperial,025,180216,34183,33751,3223,36974,766
2021-11-09,Inyo,027,18085,2453,2404,38,2442,42
2021-11-09,Kern,029,883053,129659,127901,22697,150598,1694
2021-11-09,Kings,031,150075,32754,32279,1943,34222,344
2021-11-09,Lake,033,64148,6824,6743,152,6895,106
2021-11-09,Lassen,035,31185,6953,6846,392,7238,47
2021-11-09,Los Angeles,037,10098052,1451351,1439125,54189,1493314,26581
2021-11-09,Madera,039,155013,23674,23285,2156,25441,287
2021-11-09,Marin,041,260295,17755,17630,460,18090,247
2021-11-09,Mariposa,043,17540,1349,1317,51,1368,5
2021-11-09,Mendocino,045,87422,7739,7598,598,8196,85
2021-11-09,Merced,047,269075,42436,42251,1983,44234,613
2021-11-09,Modoc,049,8938,552,536,196,732,5
2021-11-09,Mono,051,14174,1755,1738,21,1759,4
2021-11-09,Monterey,053,433212,49088,47975,2960,50935,609
2021-11-09,Napa,055,140530,13145,13051,112,13163,103
2021-11-09,Nevada,057,99092,9435,9288,327,9615,92
2021-11-09,Orange,059,3164182,309836,307412,15317,322729,5621
2021-11-09,Placer,061,380077,37729,37291,3690,40981,440
2021-11-09,Plumas,063,18699,1867,1802,41,1843,7
2021-11-09,Riverside,065,2383286,367330,362557,16344,378901,5160
2021-11-09,Sacramento,067,1510023,160892,159856,4644,164500,2286
2021-11-09,San Benito,069,59416,7472,7471,169,7640,76
2021-11-09,San Bernardino,071,2135413,358225,354972,11254,366226,5839
2021-11-09,San Diego,073,3302833,377900,375997,22165,398162,4272
2021-11-09,San Francisco,075,870044,53621,52996,2320,55316,666
2021-11-09,San Joaquin,077,732212,100770,99848,5394,105242,1794
2021-11-09,San Luis Obispo,079,281455,29916,29488,1268,30756,350
2021-11-09,San Mateo,081,765935,54695,53697,884,54581,574
2021-11-09,Santa Barbara,083,443738,44922,44579,1544,46123,533
2021-11-09,Santa Clara,085,1922200,148686,147281,1377,148658,1901
2021-11-09,Santa Cruz,087,273765,20691,20463,998,21461,222
2021-11-09,Shasta,089,179085,21878,21558,3616,25174,364
2021-11-09,Sierra,091,2930,190,186,21,207,0
2021-11-09,Siskiyou,093,43540,3373,3295,1302,4597,52
2021-11-09,Solano,095,438530,46336,45639,1278,46917,350
2021-11-09,Sonoma,097,501317,42015,41727,527,42254,395
2021-11-09,Stanislaus,099,539301,79509,79505,8872,88377,1165
2021-11-09,Sutter,101,95872,13982,13988,359,14347,180
2021-11-09,Tehama,103,63373,8647,8555,1484,10039,125
2021-11-09,Trinity,105,12862,864,746,211,957,17
2021-11-09,Tulare,107,460477,69563,68298,15165,83463,1024
2021-11-09,Tuolumne,109,53932,7421,7347,108,7455,90
2021-11-09,Ventura,111,848112,98940,98202,4285,102487,1182
2021-11-09,Yolo,113,214977,20112,19931,1070,21001,255
2021-11-09,Yuba,115,75493,10263,10175,341,10516,85
2021-11-08,Alameda,001,1643700,120382,119983,2754,122737,1447
2021-11-08,Alpine,003,1148,102,105,0,105,0
2021-11-08,Amador,005,37829,5619,5590,62,5652,66
2021-11-08,Butte,007,227075,21283,21000,3866,24866,288
2021-11-08,Calaveras,009,45235,4200,4166,58,4224,82
2021-11-08,Colusa,011,21464,2541,2514,642,3156,19
2021-11-08,Contra Costa,013,1133247,100251,99669,2194,101863,1028
2021-11-08,Del Norte,015,27424,3706,3619,54,3673,42
2021-11-08,El Dorado,017,186661,16296,16055,1721,17776,156
2021-11-08,Fresno,019,978130,142397,140466,12761,153227,2179
2021-11-08,Glenn,021,27897,3538,3496,1014,4510,34
2021-11-08,Humboldt,023,135768,9212,9095,575,9670,109
2021-11-08,Imperial,025,180216,34103,33690,3205,36895,766
2021-11-08,Inyo,027,18085,2446,2398,38,2436,41
2021-11-08,Kern,029,883053,129423,127722,22614,150336,1692
2021-11-08,Kings,031,150075,32708,32248,1942,34190,344
2021-11-08,Lake,033,64148,6818,6737,152,6889,106
2021-11-08,Lassen,035,31185,6946,6830,390,7220,46
2021-11-08,Los Angeles,037,10098052,1450006,1438322,54131,1492453,26575
2021-11-08,Madera,039,155013,23625,23253,2145,25398,287
2021-11-08,Marin,041,260295,17738,17617,457,18074,247
2021-11-08,Mariposa,043,17540,1341,1316,50,1366,5
2021-11-08,Mendocino,045,87422,7726,7581,592,8173,85
2021-11-08,Merced,047,269075,42366,42224,1973,44197,607
2021-11-08,Modoc,049,8938,551,529,196,725,5
2021-11-08,Mono,051,14174,1751,1739,21,1760,4
2021-11-08,Monterey,053,433212,49047,47942,2940,50882,602
2021-11-08,Napa,055,140530,13131,13045,112,13157,103
2021-11-08,Nevada,057,99092,9416,9278,325,9603,92
2021-11-08,Orange,059,3164182,309564,307156,15286,322442,5616
2021-11-08,Placer,061,380077,37675,37250,3687,40937,439
2021-11-08,Plumas,063,18699,1866,1788,40,1828,7
2021-11-08,Riverside,065,2383286,366875,362201,16330,378531,5152
2021-11-08,Sacramento,067,1510023,160676,159735,4623,164358,2275
2021-11-08,San Benito,069,59416,7470,7461,169,7630,75
2021-11-08,San Bernardino,071,2135413,357715,354741,11236,365977,5836
2021-11-08,San Diego,073,3302833,377338,375557,22118,397675,4259
2021-11-08,San Francisco,075,870044,53568,52942,2314,55256,666
2021-11-08,San Joaquin,077,732212,100654,99736,5392,105128,1794
2021-11-08,San Luis Obispo,079,281455,29865,29464,1263,30727,350
2021-11-08,San Mateo,081,765935,54622,53658,879,54537,574
2021-11-08,Santa Barbara,083,443738,44868,44548,1543,46091,532
2021-11-08,Santa Clara,085,1922200,148461,147183,1371,148554,1899
2021-11-08,Santa Cruz,087,273765,20662,20435,998,21433,222
2021-11-08,Shasta,089,179085,21831,21504,3610,25114,354
2021-11-08,Sierra,091,2930,190,183,21,204,0
2021-11-08,Siskiyou,093,43540,3369,3290,1291,4581,50
2021-11-08,Solano,095,438530,46295,45613,1274,46887,350
2021-11-08,Sonoma,097,501317,41947,41669,526,42195,395
2021-11-08,Stanislaus,099,539301,79357,79417,8858,88275,1150
2021-11-08,Sutter,101,95872,13974,13976,355,14331,180
2021-11-08,Tehama,103,63373,8638,8534,1484,10018,123
2021-11-08,Trinity,105,12862,864,743,210,953,13
2021-11-08,Tulare,107,460477,69446,68199,15127,83326,1020
2021-11-08,Tuolumne,109,53932,7402,7328,107,7435,90
2021-11-08,Ventura,111,848112,98847,98144,4283,102427,1182
2021-11-08,Yolo,113,214977,20074,19916,1065,20981,255
2021-11-08,Yuba,115,75493,10252,10172,338,10510,83
2021-11-07,Alameda,001,1643700,120225,119902,2748,122650,1444
2021-11-07,Alpine,003,1148,102,105,0,105,0
2021-11-07,Amador,005,37829,5611,5580,60,5640,66
2021-11-07,Butte,007,227075,21242,20969,3857,24826,288
2021-11-07,Calaveras,009,45235,4173,4158,57,4215,82
2021-11-07,Colusa,011,21464,2535,2511,640,3151,19
2021-11-07,Contra Costa,013,1133247,100140,99596,2185,101781,1028
2021-11-07,Del Norte,015,27424,3704,3617,54,3671,42
2021-11-07,El Dorado,017,186661,16259,16040,1718,17758,156
2021-11-07,Fresno,019,978130,142056,140263,12734,152997,2179
2021-11-07,Glenn,021,27897,3531,3493,1013,4506,34
2021-11-07,Humboldt,023,135768,9188,9074,571,9645,109
2021-11-07,Imperial,025,180216,34030,33674,3186,36860,766
2021-11-07,Inyo,027,18085,2433,2394,38,2432,41
2021-11-07,Kern,029,883053,129151,127583,22523,150106,1692
2021-11-07,Kings,031,150075,32617,32221,1939,34160,343
2021-11-07,Lake,033,64148,6802,6734,151,6885,106
2021-11-07,Lassen,035,31185,6938,6819,386,7205,46
2021-11-07,Los Angeles,037,10098052,1448512,1437314,54056,1491370,26573
2021-11-07,Madera,039,155013,23580,23225,2137,25362,287
2021-11-07,Marin,041,260295,17718,17594,456,18050,247
2021-11-07,Mariposa,043,17540,1339,1306,50,1356,5
2021-11-07,Mendocino,045,87422,7698,7567,588,8155,85
2021-11-07,Merced,047,269075,42288,42186,1942,44128,607
2021-11-07,Modoc,049,8938,548,528,195,723,5
2021-11-07,Mono,051,14174,1745,1739,21,1760,4
2021-11-07,Monterey,053,433212,48995,47924,2936,50860,602
2021-11-07,Napa,055,140530,13110,13041,112,13153,103
2021-11-07,Nevada,057,99092,9368,9254,325,9579,92
2021-11-07,Orange,059,3164182,309240,306954,15248,322202,5616
2021-11-07,Placer,061,380077,37599,37202,3672,40874,439
2021-11-07,Plumas,063,18699,1859,1787,39,1826,7
2021-11-07,Riverside,065,2383286,366337,361960,16310,378270,5152
2021-11-07,Sacramento,067,1510023,160444,159549,4606,164155,2277
2021-11-07,San Benito,069,59416,7457,7460,169,7629,75
2021-11-07,San Bernardino,071,2135413,357203,354488,11213,365701,5832
2021-11-07,San Diego,073,3302833,376757,375165,22085,397250,4250
2021-11-07,San Francisco,075,870044,53484,52868,2308,55176,666
2021-11-07,San Joaquin,077,732212,100469,99696,5386,105082,1794
2021-11-07,San Luis Obispo,079,281455,29816,29454,1259,30713,350
2021-11-07,San Mateo,081,765935,54563,53600,877,54477,574
2021-11-07,Santa Barbara,083,443738,44805,44501,1542,46043,532
2021-11-07,Santa Clara,085,1922200,148257,147054,1358,148412,1898
2021-11-07,Santa Cruz,087,273765,20604,20397,997,21394,222
2021-11-07,Shasta,089,179085,21783,21479,3604,25083,354
2021-11-07,Sierra,091,2930,188,183,21,204,0
2021-11-07,Siskiyou,093,43540,3363,3289,1289,4578,51
2021-11-07,Solano,095,438530,46240,45582,1267,46849,350
2021-11-07,Sonoma,097,501317,41897,41630,525,42155,395
2021-11-07,Stanislaus,099,539301,79202,79351,8836,88187,1150
2021-11-07,Sutter,101,95872,13961,13964,352,14316,180
2021-11-07,Tehama,103,63373,8613,8528,1482,10010,121
2021-11-07,Trinity,105,12862,863,742,209,951,13
2021-11-07,Tulare,107,460477,69293,68145,15084,83229,1020
2021-11-07,Tuolumne,109,53932,7384,7300,105,7405,90
2021-11-07,Ventura,111,848112,98756,98085,4281,102366,1182
2021-11-07,Yolo,113,214977,20054,19899,1060,20959,255
2021-11-07,Yuba,115,75493,10235,10162,333,10495,83
2021-11-06,Alameda,001,1643700,120162,119499,2745,122244,1436
2021-11-06,Alpine,003,1148,102,105,0,105,0
2021-11-06,Amador,005,37829,5605,5557,60,5617,66
2021-11-06,Butte,007,227075,21222,20796,3853,24649,288
2021-11-06,Calaveras,009,45235,4165,4105,57,4162,82
2021-11-06,Colusa,011,21464,2534,2501,639,3140,19
2021-11-06,Contra Costa,013,1133247,100085,99282,2183,101465,1025
2021-11-06,Del Norte,015,27424,3701,3607,54,3661,42
2021-11-06,El Dorado,017,186661,16242,15958,1718,17676,156
2021-11-06,Fresno,019,978130,141938,139249,12729,151978,2170
2021-11-06,Glenn,021,27897,3528,3479,1013,4492,33
2021-11-06,Humboldt,023,135768,9176,8972,567,9539,109
2021-11-06,Imperial,025,180216,33986,33471,3180,36651,766
2021-11-06,Inyo,027,18085,2427,2353,38,2391,41
2021-11-06,Kern,029,883053,129017,126848,22471,149319,1684
2021-11-06,Kings,031,150075,32584,32018,1934,33952,342
2021-11-06,Lake,033,64148,6800,6695,151,6846,106
2021-11-06,Lassen,035,31185,6933,6796,385,7181,46
2021-11-06,Los Angeles,037,10098052,1447741,1433081,54013,1487094,26533
2021-11-06,Madera,039,155013,23544,22994,2127,25121,287
2021-11-06,Marin,041,260295,17699,17520,453,17973,247
2021-11-06,Mariposa,043,17540,1337,1282,50,1332,5
2021-11-06,Mendocino,045,87422,7676,7486,588,8074,85
2021-11-06,Merced,047,269075,42264,41958,1934,43892,604
2021-11-06,Modoc,049,8938,547,523,195,718,5
2021-11-06,Mono,051,14174,1743,1725,21,1746,4
2021-11-06,Monterey,053,433212,48963,47830,2926,50756,602
2021-11-06,Napa,055,140530,13100,12950,112,13062,103
2021-11-06,Nevada,057,99092,9346,9169,324,9493,91
2021-11-06,Orange,059,3164182,309033,306049,15222,321271,5611
2021-11-06,Placer,061,380077,37558,36967,3669,40636,438
2021-11-06,Plumas,063,18699,1855,1755,38,1793,7
2021-11-06,Riverside,065,2383286,366019,360584,16302,376886,5138
2021-11-06,Sacramento,067,1510023,160351,158766,4601,163367,2263
2021-11-06,San Benito,069,59416,7450,7429,169,7598,75
2021-11-06,San Bernardino,071,2135413,356933,353142,11209,364351,5813
2021-11-06,San Diego,073,3302833,376421,373423,22067,395490,4246
2021-11-06,San Francisco,075,870044,53431,52556,2305,54861,666
2021-11-06,San Joaquin,077,732212,100411,99372,5385,104757,1782
2021-11-06,San Luis Obispo,079,281455,29788,29335,1255,30590,350
2021-11-06,San Mateo,081,765935,54528,53442,876,54318,574
2021-11-06,Santa Barbara,083,443738,44769,44301,1541,45842,532
2021-11-06,Santa Clara,085,1922200,148112,146519,1353,147872,1894
2021-11-06,Santa Cruz,087,273765,20585,20311,995,21306,222
2021-11-06,Shasta,089,179085,21764,21281,3599,24880,349
2021-11-06,Sierra,091,2930,188,181,21,202,0
2021-11-06,Siskiyou,093,43540,3363,3279,1287,4566,48
2021-11-06,Solano,095,438530,46210,45465,1266,46731,350
2021-11-06,Sonoma,097,501317,41847,41398,524,41922,395
2021-11-06,Stanislaus,099,539301,79134,78902,8828,87730,1193
2021-11-06,Sutter,101,95872,13957,13908,351,14259,180
2021-11-06,Tehama,103,63373,8602,8474,1480,9954,120
2021-11-06,Trinity,105,12862,860,732,209,941,11
2021-11-06,Tulare,107,460477,69243,67767,15055,82822,1010
2021-11-06,Tuolumne,109,53932,7372,7245,105,7350,90
2021-11-06,Ventura,111,848112,98689,97770,4276,102046,1180
2021-11-06,Yolo,113,214977,20037,19827,1056,20883,255
2021-11-06,Yuba,115,75493,10221,10107,333,10440,83
2021-11-05,Alameda,001,1643700,120078,119499,2743,122242,1436
2021-11-05,Alpine,003,1148,102,105,0,105,0
2021-11-05,Amador,005,37829,5600,5557,60,5617,66
2021-11-05,Butte,007,227075,21209,20796,3852,24648,288
2021-11-05,Calaveras,009,45235,4160,4105,57,4162,82
2021-11-05,Colusa,011,21464,2534,2501,638,3139,19
2021-11-05,Contra Costa,013,1133247,100020,99282,2181,101463,1025
2021-11-05,Del Norte,015,27424,3699,3607,54,3661,42
2021-11-05,El Dorado,017,186661,16225,15958,1712,17670,156
2021-11-05,Fresno,019,978130,141760,139249,12719,151968,2170
2021-11-05,Glenn,021,27897,3528,3479,1012,4491,33
2021-11-05,Humboldt,023,135768,9162,8972,567,9539,109
2021-11-05,Imperial,025,180216,33950,33471,3177,36648,766
2021-11-05,Inyo,027,18085,2419,2353,38,2391,41
2021-11-05,Kern,029,883053,128890,126848,22416,149264,1684
2021-11-05,Kings,031,150075,32560,32018,1933,33951,342
2021-11-05,Lake,033,64148,6794,6695,151,6846,106
2021-11-05,Lassen,035,31185,6929,6796,384,7180,46
2021-11-05,Los Angeles,037,10098052,1446919,1433081,53975,1487056,26533
2021-11-05,Madera,039,155013,23506,22994,2126,25120,287
2021-11-05,Marin,041,260295,17677,17520,452,17972,247
2021-11-05,Mariposa,043,17540,1334,1282,49,1331,5
2021-11-05,Mendocino,045,87422,7665,7486,587,8073,85
2021-11-05,Merced,047,269075,42238,41958,1925,43883,604
2021-11-05,Modoc,049,8938,547,523,195,718,5
2021-11-05,Mono,051,14174,1742,1725,21,1746,4
2021-11-05,Monterey,053,433212,48933,47830,2924,50754,602
2021-11-05,Napa,055,140530,13078,12950,112,13062,103
2021-11-05,Nevada,057,99092,9333,9169,324,9493,91
2021-11-05,Orange,059,3164182,308836,306049,15200,321249,5611
2021-11-05,Placer,061,380077,37531,36967,3660,40627,438
2021-11-05,Plumas,063,18699,1847,1755,38,1793,7
2021-11-05,Riverside,065,2383286,365678,360584,16292,376876,5138
2021-11-05,Sacramento,067,1510023,160229,158766,4595,163361,2263
2021-11-05,San Benito,069,59416,7448,7429,168,7597,75
2021-11-05,San Bernardino,071,2135413,356602,353142,11199,364341,5813
2021-11-05,San Diego,073,3302833,376068,373423,22055,395478,4246
2021-11-05,San Francisco,075,870044,53380,52556,2302,54858,666
2021-11-05,San Joaquin,077,732212,100358,99372,5376,104748,1782
2021-11-05,San Luis Obispo,079,281455,29765,29335,1255,30590,350
2021-11-05,San Mateo,081,765935,54486,53442,874,54316,574
2021-11-05,Santa Barbara,083,443738,44724,44301,1540,45841,532
2021-11-05,Santa Clara,085,1922200,147975,146519,1352,147871,1894
2021-11-05,Santa Cruz,087,273765,20561,20311,994,21305,222
2021-11-05,Shasta,089,179085,21732,21281,3594,24875,349
2021-11-05,Sierra,091,2930,188,181,21,202,0
2021-11-05,Siskiyou,093,43540,3358,3279,1286,4565,48
2021-11-05,Solano,095,438530,46165,45465,1264,46729,350
2021-11-05,Sonoma,097,501317,41807,41398,524,41922,395
2021-11-05,Stanislaus,099,539301,79076,78902,8816,87718,1193
2021-11-05,Sutter,101,95872,13949,13908,350,14258,180
2021-11-05,Tehama,103,63373,8595,8474,1479,9953,120
2021-11-05,Trinity,105,12862,860,732,209,941,11
2021-11-05,Tulare,107,460477,69171,67767,15018,82785,1010
2021-11-05,Tuolumne,109,53932,7355,7245,104,7349,90
2021-11-05,Ventura,111,848112,98649,97770,4273,102043,1180
2021-11-05,Yolo,113,214977,20026,19827,1055,20882,255
2021-11-05,Yuba,115,75493,10208,10107,331,10438,83
2021-11-04,Alameda,001,1643700,119962,119499,2737,122236,1436
2021-11-04,Alpine,003,1148,102,105,0,105,0
2021-11-04,Amador,005,37829,5592,5557,60,5617,66
2021-11-04,Butte,007,227075,21167,20796,3841,24637,288
2021-11-04,Calaveras,009,45235,4146,4105,55,4160,82
2021-11-04,Colusa,011,21464,2528,2501,637,3138,19
2021-11-04,Contra Costa,013,1133247,99929,99282,2176,101458,1025
2021-11-04,Del Norte,015,27424,3696,3607,54,3661,42
2021-11-04,El Dorado,017,186661,16199,15958,1708,17666,156
2021-11-04,Fresno,019,978130,141478,139249,12710,151959,2170
2021-11-04,Glenn,021,27897,3523,3479,1011,4490,33
2021-11-04,Humboldt,023,135768,9137,8972,564,9536,109
2021-11-04,Imperial,025,180216,33893,33471,3168,36639,766
2021-11-04,Inyo,027,18085,2411,2353,38,2391,41
2021-11-04,Kern,029,883053,128658,126848,22348,149196,1684
2021-11-04,Kings,031,150075,32481,32018,1924,33942,342
2021-11-04,Lake,033,64148,6784,6695,149,6844,106
2021-11-04,Lassen,035,31185,6919,6796,379,7175,46
2021-11-04,Los Angeles,037,10098052,1445600,1433081,53894,1486975,26533
2021-11-04,Madera,039,155013,23451,22994,2115,25109,287
2021-11-04,Marin,041,260295,17665,17520,450,17970,247
2021-11-04,Mariposa,043,17540,1327,1282,49,1331,5
2021-11-04,Mendocino,045,87422,7652,7486,581,8067,85
2021-11-04,Merced,047,269075,42184,41958,1921,43879,604
2021-11-04,Modoc,049,8938,546,523,195,718,5
2021-11-04,Mono,051,14174,1737,1725,21,1746,4
2021-11-04,Monterey,053,433212,48889,47830,2908,50738,602
2021-11-04,Napa,055,140530,13057,12950,112,13062,103
2021-11-04,Nevada,057,99092,9302,9169,323,9492,91
2021-11-04,Orange,059,3164182,308588,306049,15182,321231,5611
2021-11-04,Placer,061,380077,37459,36967,3651,40618,438
2021-11-04,Plumas,063,18699,1839,1755,34,1789,7
2021-11-04,Riverside,065,2383286,365280,360584,16283,376867,5138
2021-11-04,Sacramento,067,1510023,159995,158766,4575,163341,2263
2021-11-04,San Benito,069,59416,7442,7429,168,7597,75
2021-11-04,San Bernardino,071,2135413,356164,353142,11191,364333,5813
2021-11-04,San Diego,073,3302833,375599,373423,22034,395457,4246
2021-11-04,San Francisco,075,870044,53299,52556,2298,54854,666
2021-11-04,San Joaquin,077,732212,100251,99372,5364,104736,1782
2021-11-04,San Luis Obispo,079,281455,29741,29335,1249,30584,350
2021-11-04,San Mateo,081,765935,54427,53442,868,54310,574
2021-11-04,Santa Barbara,083,443738,44668,44301,1540,45841,532
2021-11-04,Santa Clara,085,1922200,147821,146519,1348,147867,1894
2021-11-04,Santa Cruz,087,273765,20526,20311,994,21305,222
2021-11-04,Shasta,089,179085,21674,21281,3588,24869,349
2021-11-04,Sierra,091,2930,186,181,21,202,0
2021-11-04,Siskiyou,093,43540,3354,3279,1279,4558,48
2021-11-04,Solano,095,438530,46123,45465,1263,46728,350
2021-11-04,Sonoma,097,501317,41747,41398,524,41922,395
2021-11-04,Stanislaus,099,539301,78938,78902,8808,87710,1193
2021-11-04,Sutter,101,95872,13938,13908,348,14256,180
2021-11-04,Tehama,103,63373,8586,8474,1475,9949,120
2021-11-04,Trinity,105,12862,859,732,209,941,11
2021-11-04,Tulare,107,460477,69056,67767,14972,82739,1010
2021-11-04,Tuolumne,109,53932,7333,7245,102,7347,90
2021-11-04,Ventura,111,848112,98561,97770,4270,102040,1180
2021-11-04,Yolo,113,214977,20001,19827,1050,20877,255
2021-11-04,Yuba,115,75493,10194,10107,329,10436,83
2021-11-03,Alameda,001,1643700,119821,119356,2733,122089,1428
2021-11-03,Alpine,003,1148,102,105,0,105,0
2021-11-03,Amador,005,37829,5586,5545,59,5604,66
2021-11-03,Butte,007,227075,21122,20769,3832,24601,284
2021-11-03,Calaveras,009,45235,4128,4087,54,4141,82
2021-11-03,Colusa,011,21464,2522,2499,637,3136,20
2021-11-03,Contra Costa,013,1133247,99830,99168,2171,101339,1025
2021-11-03,Del Norte,015,27424,3694,3600,53,3653,42
2021-11-03,El Dorado,017,186661,16172,15915,1704,17619,156
2021-11-03,Fresno,019,978130,141116,138873,12688,151561,2166
2021-11-03,Glenn,021,27897,3519,3470,1011,4481,33
2021-11-03,Humboldt,023,135768,9120,8949,559,9508,109
2021-11-03,Imperial,025,180216,33821,33402,3158,36560,766
2021-11-03,Inyo,027,18085,2389,2344,38,2382,41
2021-11-03,Kern,029,883053,128398,126523,22248,148771,1681
2021-11-03,Kings,031,150075,32427,31923,1917,33840,341
2021-11-03,Lake,033,64148,6768,6685,149,6834,106
2021-11-03,Lassen,035,31185,6902,6782,374,7156,46
2021-11-03,Los Angeles,037,10098052,1444246,1431209,53811,1485020,26517
2021-11-03,Madera,039,155013,23383,22893,2106,24999,287
2021-11-03,Marin,041,260295,17644,17491,446,17937,247
2021-11-03,Mariposa,043,17540,1317,1276,49,1325,5
2021-11-03,Mendocino,045,87422,7636,7457,573,8030,84
2021-11-03,Merced,047,269075,42123,41849,1911,43760,597
2021-11-03,Modoc,049,8938,546,521,193,714,5
2021-11-03,Mono,051,14174,1733,1719,21,1740,4
2021-11-03,Monterey,053,433212,48839,47794,2895,50689,601
2021-11-03,Napa,055,140530,13045,12937,111,13048,103
2021-11-03,Nevada,057,99092,9275,9131,322,9453,91
2021-11-03,Orange,059,3164182,308277,305661,15150,320811,5607
2021-11-03,Placer,061,380077,37389,36868,3646,40514,438
2021-11-03,Plumas,063,18699,1828,1739,33,1772,7
2021-11-03,Riverside,065,2383286,364822,360060,16279,376339,5131
2021-11-03,Sacramento,067,1510023,159772,158311,4565,162876,2259
2021-11-03,San Benito,069,59416,7434,7419,168,7587,75
2021-11-03,San Bernardino,071,2135413,355690,352225,11171,363396,5813
2021-11-03,San Diego,073,3302833,375099,372951,22011,394962,4241
2021-11-03,San Francisco,075,870044,53207,52493,2293,54786,663
2021-11-03,San Joaquin,077,732212,100139,99188,5354,104542,1776
2021-11-03,San Luis Obispo,079,281455,29699,29276,1243,30519,348
2021-11-03,San Mateo,081,765935,54363,53396,862,54258,571
2021-11-03,Santa Barbara,083,443738,44611,44220,1537,45757,531
2021-11-03,Santa Clara,085,1922200,147651,146259,1341,147600,1897
2021-11-03,Santa Cruz,087,273765,20491,20275,994,21269,222
2021-11-03,Shasta,089,179085,21616,21215,3581,24796,346
2021-11-03,Sierra,091,2930,184,180,21,201,0
2021-11-03,Siskiyou,093,43540,3350,3276,1277,4553,46
2021-11-03,Solano,095,438530,46096,45411,1261,46672,351
2021-11-03,Sonoma,097,501317,41670,41326,522,41848,395
2021-11-03,Stanislaus,099,539301,78807,78736,8792,87528,1193
2021-11-03,Sutter,101,95872,13925,13876,346,14222,179
2021-11-03,Tehama,103,63373,8574,8438,1475,9913,118
2021-11-03,Trinity,105,12862,858,730,209,939,11
2021-11-03,Tulare,107,460477,68928,67588,14931,82519,1007
2021-11-03,Tuolumne,109,53932,7315,7218,100,7318,90
2021-11-03,Ventura,111,848112,98453,97682,4266,101948,1178
2021-11-03,Yolo,113,214977,19983,19758,1042,20800,250
2021-11-03,Yuba,115,75493,10182,10092,329,10421,83
2021-11-02,Alameda,001,1643700,119676,119241,2727,121968,1425
2021-11-02,Alpine,003,1148,101,105,0,105,0
2021-11-02,Amador,005,37829,5581,5535,59,5594,66
2021-11-02,Butte,007,227075,21078,20744,3820,24564,282
2021-11-02,Calaveras,009,45235,4105,4075,54,4129,82
2021-11-02,Colusa,011,21464,2517,2497,636,3133,19
2021-11-02,Contra Costa,013,1133247,99726,99080,2159,101239,1025
2021-11-02,Del Norte,015,27424,3692,3596,53,3649,42
2021-11-02,El Dorado,017,186661,16143,15883,1704,17587,154
2021-11-02,Fresno,019,978130,140792,138644,12657,151301,2158
2021-11-02,Glenn,021,27897,3511,3469,1008,4477,33
2021-11-02,Humboldt,023,135768,9078,8937,558,9495,109
2021-11-02,Imperial,025,180216,33748,33371,3146,36517,766
2021-11-02,Inyo,027,18085,2382,2324,38,2362,41
2021-11-02,Kern,029,883053,128143,126311,22128,148439,1665
2021-11-02,Kings,031,150075,32368,31896,1912,33808,339
2021-11-02,Lake,033,64148,6763,6681,148,6829,106
2021-11-02,Lassen,035,31185,6890,6777,371,7148,45
2021-11-02,Los Angeles,037,10098052,1442799,1429601,53735,1483336,26496
2021-11-02,Madera,039,155013,23302,22837,2095,24932,287
2021-11-02,Marin,041,260295,17616,17482,446,17928,247
2021-11-02,Mariposa,043,17540,1306,1270,48,1318,5
2021-11-02,Mendocino,045,87422,7612,7447,561,8008,84
2021-11-02,Merced,047,269075,42056,41785,1903,43688,596
2021-11-02,Modoc,049,8938,543,520,192,712,5
2021-11-02,Mono,051,14174,1729,1718,21,1739,4
2021-11-02,Monterey,053,433212,48788,47775,2877,50652,599
2021-11-02,Napa,055,140530,13027,12930,111,13041,104
2021-11-02,Nevada,057,99092,9245,9122,321,9443,91
2021-11-02,Orange,059,3164182,307961,305369,15105,320474,5600
2021-11-02,Placer,061,380077,37317,36817,3631,40448,438
2021-11-02,Plumas,063,18699,1817,1721,33,1754,7
2021-11-02,Riverside,065,2383286,364368,359586,16260,375846,5116
2021-11-02,Sacramento,067,1510023,159516,158112,4543,162655,2250
2021-11-02,San Benito,069,59416,7418,7407,168,7575,75
2021-11-02,San Bernardino,071,2135413,355215,351832,11117,362949,5813
2021-11-02,San Diego,073,3302833,374514,372440,21981,394421,4232
2021-11-02,San Francisco,075,870044,53088,52450,2289,54739,663
2021-11-02,San Joaquin,077,732212,100006,99076,5343,104419,1772
2021-11-02,San Luis Obispo,079,281455,29666,29224,1239,30463,348
2021-11-02,San Mateo,081,765935,54291,53351,859,54210,571
2021-11-02,Santa Barbara,083,443738,44555,44177,1534,45711,531
2021-11-02,Santa Clara,085,1922200,147457,146115,1334,147449,1896
2021-11-02,Santa Cruz,087,273765,20458,20266,993,21259,222
2021-11-02,Shasta,089,179085,21542,21127,3571,24698,344
2021-11-02,Sierra,091,2930,184,180,20,200,0
2021-11-02,Siskiyou,093,43540,3348,3272,1274,4546,46
2021-11-02,Solano,095,438530,46056,45378,1255,46633,350
2021-11-02,Sonoma,097,501317,41589,41288,521,41809,395
2021-11-02,Stanislaus,099,539301,78652,78629,8772,87401,1193
2021-11-02,Sutter,101,95872,13905,13868,346,14214,179
2021-11-02,Tehama,103,63373,8558,8422,1472,9894,116
2021-11-02,Trinity,105,12862,858,729,209,938,11
2021-11-02,Tulare,107,460477,68803,67502,14883,82385,1002
2021-11-02,Tuolumne,109,53932,7294,7204,98,7302,90
2021-11-02,Ventura,111,848112,98348,97574,4262,101836,1178
2021-11-02,Yolo,113,214977,19953,19736,1040,20776,250
2021-11-02,Yuba,115,75493,10159,10080,327,10407,83
2021-11-01,Alameda,001,1643700,119537,119159,2725,121884,1421
2021-11-01,Alpine,003,1148,101,105,0,105,0
2021-11-01,Amador,005,37829,5579,5532,59,5591,64
2021-11-01,Butte,007,227075,21028,20710,3814,24524,281
2021-11-01,Calaveras,009,45235,4095,4059,53,4112,82
2021-11-01,Colusa,011,21464,2515,2494,633,3127,19
2021-11-01,Contra Costa,013,1133247,99602,99011,2151,101162,1025
2021-11-01,Del Norte,015,27424,3690,3594,53,3647,42
2021-11-01,El Dorado,017,186661,16119,15858,1699,17557,154
2021-11-01,Fresno,019,978130,140416,138421,12621,151042,2149
2021-11-01,Glenn,021,27897,3503,3461,1006,4467,33
2021-11-01,Humboldt,023,135768,9050,8929,555,9484,108
2021-11-01,Imperial,025,180216,33698,33342,3137,36479,766
2021-11-01,Inyo,027,18085,2370,2307,38,2345,41
2021-11-01,Kern,029,883053,127843,126092,22013,148105,1660
2021-11-01,Kings,031,150075,32315,31866,1908,33774,337
2021-11-01,Lake,033,64148,6752,6676,147,6823,106
2021-11-01,Lassen,035,31185,6875,6775,368,7143,42
2021-11-01,Los Angeles,037,10098052,1441415,1428891,53644,1482535,26483
2021-11-01,Madera,039,155013,23223,22801,2090,24891,283
2021-11-01,Marin,041,260295,17596,17460,445,17905,247
2021-11-01,Mariposa,043,17540,1298,1266,47,1313,5
2021-11-01,Mendocino,045,87422,7579,7422,543,7965,84
2021-11-01,Merced,047,269075,41965,41740,1901,43641,594
2021-11-01,Modoc,049,8938,538,520,190,710,5
2021-11-01,Mono,051,14174,1725,1714,21,1735,3
2021-11-01,Monterey,053,433212,48745,47756,2865,50621,597
2021-11-01,Napa,055,140530,13000,12916,110,13026,101
2021-11-01,Nevada,057,99092,9222,9108,320,9428,91
2021-11-01,Orange,059,3164182,307619,305192,15064,320256,5596
2021-11-01,Placer,061,380077,37234,36747,3619,40366,435
2021-11-01,Plumas,063,18699,1798,1719,33,1752,7
2021-11-01,Riverside,065,2383286,363865,359263,16238,375501,5115
2021-11-01,Sacramento,067,1510023,159244,157893,4520,162413,2239
2021-11-01,San Benito,069,59416,7408,7406,167,7573,73
2021-11-01,San Bernardino,071,2135413,354726,351620,11097,362717,5815
2021-11-01,San Diego,073,3302833,373949,372043,21963,394006,4232
2021-11-01,San Francisco,075,870044,53003,52418,2282,54700,661
2021-11-01,San Joaquin,077,732212,99843,98969,5336,104305,1772
2021-11-01,San Luis Obispo,079,281455,29622,29199,1234,30433,343
2021-11-01,San Mateo,081,765935,54224,53314,855,54169,571
2021-11-01,Santa Barbara,083,443738,44488,44146,1530,45676,529
2021-11-01,Santa Clara,085,1922200,147260,145978,1329,147307,1907
2021-11-01,Santa Cruz,087,273765,20423,20238,993,21231,221
2021-11-01,Shasta,089,179085,21489,21104,3564,24668,338
2021-11-01,Sierra,091,2930,184,180,20,200,0
2021-11-01,Siskiyou,093,43540,3341,3272,1269,4541,46
2021-11-01,Solano,095,438530,46002,45358,1255,46613,350
2021-11-01,Sonoma,097,501317,41516,41234,520,41754,395
2021-11-01,Stanislaus,099,539301,78522,78534,8757,87291,1193
2021-11-01,Sutter,101,95872,13881,13852,344,14196,179
2021-11-01,Tehama,103,63373,8530,8412,1469,9881,116
2021-11-01,Trinity,105,12862,856,727,209,936,11
2021-11-01,Tulare,107,460477,68660,67388,14831,82219,1002
2021-11-01,Tuolumne,109,53932,7278,7175,97,7272,90
2021-11-01,Ventura,111,848112,98258,97507,4260,101767,1178
2021-11-01,Yolo,113,214977,19933,19708,1033,20741,250
2021-11-01,Yuba,115,75493,10141,10066,325,10391,83
2021-10-31,Alameda,001,1643700,119393,119071,2722,121793,1419
2021-10-31,Alpine,003,1148,101,105,0,105,0
2021-10-31,Amador,005,37829,5568,5518,59,5577,64
2021-10-31,Butte,007,227075,20967,20689,3802,24491,281
2021-10-31,Calaveras,009,45235,4077,4052,52,4104,82
2021-10-31,Colusa,011,21464,2513,2493,630,3123,18
2021-10-31,Contra Costa,013,1133247,99474,98936,2149,101085,1025
2021-10-31,Del Norte,015,27424,3684,3591,53,3644,42
2021-10-31,El Dorado,017,186661,16073,15841,1696,17537,154
2021-10-31,Fresno,019,978130,140012,138165,12584,150749,2147
2021-10-31,Glenn,021,27897,3498,3459,1006,4465,33
2021-10-31,Humboldt,023,135768,9002,8919,549,9468,108
2021-10-31,Imperial,025,180216,33623,33334,3125,36459,766
2021-10-31,Inyo,027,18085,2351,2309,38,2347,41
2021-10-31,Kern,029,883053,127474,125917,21889,147806,1666
2021-10-31,Kings,031,150075,32229,31814,1896,33710,338
2021-10-31,Lake,033,64148,6741,6665,145,6810,106
2021-10-31,Lassen,035,31185,6860,6768,363,7131,42
2021-10-31,Los Angeles,037,10098052,1439864,1427933,53562,1481495,26474
2021-10-31,Madera,039,155013,23127,22744,2077,24821,283
2021-10-31,Marin,041,260295,17568,17443,444,17887,247
2021-10-31,Mariposa,043,17540,1292,1257,46,1303,5
2021-10-31,Mendocino,045,87422,7538,7403,526,7929,84
2021-10-31,Merced,047,269075,41872,41699,1881,43580,589
2021-10-31,Modoc,049,8938,532,517,187,704,5
2021-10-31,Mono,051,14174,1721,1711,21,1732,3
2021-10-31,Monterey,053,433212,48704,47744,2847,50591,596
2021-10-31,Napa,055,140530,12982,12906,108,13014,101
2021-10-31,Nevada,057,99092,9185,9084,315,9399,91
2021-10-31,Orange,059,3164182,307271,305032,14981,320013,5596
2021-10-31,Placer,061,380077,37137,36698,3606,40304,435
2021-10-31,Plumas,063,18699,1780,1716,33,1749,7
2021-10-31,Riverside,065,2383286,363285,359005,16224,375229,5104
2021-10-31,Sacramento,067,1510023,158892,157667,4507,162174,2243
2021-10-31,San Benito,069,59416,7399,7397,165,7562,73
2021-10-31,San Bernardino,071,2135413,354194,351411,11083,362494,5810
2021-10-31,San Diego,073,3302833,373396,371603,21932,393535,4218
2021-10-31,San Francisco,075,870044,52894,52370,2276,54646,661
2021-10-31,San Joaquin,077,732212,99679,98893,5321,104214,1772
2021-10-31,San Luis Obispo,079,281455,29569,29176,1233,30409,343
2021-10-31,San Mateo,081,765935,54165,53284,853,54137,571
2021-10-31,Santa Barbara,083,443738,44418,44113,1525,45638,529
2021-10-31,Santa Clara,085,1922200,147045,145829,1315,147144,1908
2021-10-31,Santa Cruz,087,273765,20388,20218,992,21210,221
2021-10-31,Shasta,089,179085,21406,21086,3552,24638,338
2021-10-31,Sierra,091,2930,184,180,20,200,0
2021-10-31,Siskiyou,093,43540,3335,3271,1268,4539,46
2021-10-31,Solano,095,438530,45954,45310,1248,46558,350
2021-10-31,Sonoma,097,501317,41446,41183,517,41700,395
2021-10-31,Stanislaus,099,539301,78333,78426,8740,87166,1193
2021-10-31,Sutter,101,95872,13862,13838,341,14179,179
2021-10-31,Tehama,103,63373,8499,8391,1465,9856,116
2021-10-31,Trinity,105,12862,856,724,209,933,11
2021-10-31,Tulare,107,460477,68465,67310,14743,82053,1002
2021-10-31,Tuolumne,109,53932,7249,7141,96,7237,90
2021-10-31,Ventura,111,848112,98136,97460,4255,101715,1178
2021-10-31,Yolo,113,214977,19889,19662,1027,20689,250
2021-10-31,Yuba,115,75493,10123,10051,315,10366,83
2021-10-30,Alameda,001,1643700,119333,118632,2719,121351,1419
2021-10-30,Alpine,003,1148,101,105,0,105,0
2021-10-30,Amador,005,37829,5559,5480,58,5538,64
2021-10-30,Butte,007,227075,20952,20516,3795,24311,277
2021-10-30,Calaveras,009,45235,4070,3992,52,4044,82
2021-10-30,Colusa,011,21464,2513,2484,629,3113,19
2021-10-30,Contra Costa,013,1133247,99412,98562,2148,100710,1024
2021-10-30,Del Norte,015,27424,3681,3574,53,3627,42
2021-10-30,El Dorado,017,186661,16057,15752,1692,17444,154
2021-10-30,Fresno,019,978130,139866,136901,12572,149473,2131
2021-10-30,Glenn,021,27897,3494,3442,1006,4448,33
2021-10-30,Humboldt,023,135768,8987,8871,547,9418,105
2021-10-30,Imperial,025,180216,33577,33156,3121,36277,766
2021-10-30,Inyo,027,18085,2348,2249,38,2287,41
2021-10-30,Kern,029,883053,127322,124892,21820,146712,1653
2021-10-30,Kings,031,150075,32195,31578,1892,33470,337
2021-10-30,Lake,033,64148,6736,6610,145,6755,106
2021-10-30,Lassen,035,31185,6854,6719,361,7080,42
2021-10-30,Los Angeles,037,10098052,1439142,1424257,53509,1477766,26625
2021-10-30,Madera,039,155013,23083,22524,2072,24596,283
2021-10-30,Marin,041,260295,17553,17380,442,17822,247
2021-10-30,Mariposa,043,17540,1289,1228,46,1274,5
2021-10-30,Mendocino,045,87422,7515,7338,524,7862,84
2021-10-30,Merced,047,269075,41832,41428,1879,43307,586
2021-10-30,Modoc,049,8938,530,513,186,699,5
2021-10-30,Mono,051,14174,1721,1684,21,1705,3
2021-10-30,Monterey,053,433212,48687,47649,2841,50490,588
2021-10-30,Napa,055,140530,12968,12863,107,12970,101
2021-10-30,Nevada,057,99092,9166,9015,315,9330,91
2021-10-30,Orange,059,3164182,307092,304120,14959,319079,5588
2021-10-30,Placer,061,380077,37092,36400,3600,40000,434
2021-10-30,Plumas,063,18699,1775,1695,33,1728,7
2021-10-30,Riverside,065,2383286,362983,357645,16216,373861,5088
2021-10-30,Sacramento,067,1510023,158735,157125,4498,161623,2233
2021-10-30,San Benito,069,59416,7392,7362,165,7527,71
2021-10-30,San Bernardino,071,2135413,353917,350076,11069,361145,5777
2021-10-30,San Diego,073,3302833,373033,370006,21910,391916,4213
2021-10-30,San Francisco,075,870044,52865,52161,2274,54435,661
2021-10-30,San Joaquin,077,732212,99623,98314,5320,103634,1768
2021-10-30,San Luis Obispo,079,281455,29537,29053,1230,30283,341
2021-10-30,San Mateo,081,765935,54126,53083,853,53936,571
2021-10-30,Santa Barbara,083,443738,44383,43972,1524,45496,528
2021-10-30,Santa Clara,085,1922200,146940,145262,1311,146573,1903
2021-10-30,Santa Cruz,087,273765,20370,20134,990,21124,221
2021-10-30,Shasta,089,179085,21362,20878,3546,24424,332
2021-10-30,Sierra,091,2930,184,175,20,195,0
2021-10-30,Siskiyou,093,43540,3334,3257,1265,4522,46
2021-10-30,Solano,095,438530,45933,45146,1246,46392,346
2021-10-30,Sonoma,097,501317,41407,40924,517,41441,393
2021-10-30,Stanislaus,099,539301,78263,77871,8733,86604,1191
2021-10-30,Sutter,101,95872,13848,13773,341,14114,178
2021-10-30,Tehama,103,63373,8488,8307,1460,9767,114
2021-10-30,Trinity,105,12862,854,708,208,916,11
2021-10-30,Tulare,107,460477,68394,66745,14699,81444,995
2021-10-30,Tuolumne,109,53932,7225,7050,95,7145,90
2021-10-30,Ventura,111,848112,98087,97182,4252,101434,1174
2021-10-30,Yolo,113,214977,19870,19568,1025,20593,250
2021-10-30,Yuba,115,75493,10112,9969,315,10284,82
2021-10-29,Alameda,001,1643700,119254,118632,2714,121346,1419
2021-10-29,Alpine,003,1148,101,105,0,105,0
2021-10-29,Amador,005,37829,5548,5480,58,5538,64
2021-10-29,Butte,007,227075,20928,20516,3784,24300,277
2021-10-29,Calaveras,009,45235,4063,3992,52,4044,82
2021-10-29,Colusa,011,21464,2513,2484,627,3111,19
2021-10-29,Contra Costa,013,1133247,99344,98562,2146,100708,1024
2021-10-29,Del Norte,015,27424,3674,3574,53,3627,42
2021-10-29,El Dorado,017,186661,16043,15752,1692,17444,154
2021-10-29,Fresno,019,978130,139652,136901,12558,149459,2131
2021-10-29,Glenn,021,27897,3493,3442,1005,4447,33
2021-10-29,Humboldt,023,135768,8982,8871,546,9417,105
2021-10-29,Imperial,025,180216,33550,33156,3118,36274,766
2021-10-29,Inyo,027,18085,2345,2249,38,2287,41
2021-10-29,Kern,029,883053,127145,124892,21730,146622,1653
2021-10-29,Kings,031,150075,32161,31578,1890,33468,337
2021-10-29,Lake,033,64148,6727,6610,142,6752,106
2021-10-29,Lassen,035,31185,6845,6719,358,7077,42
2021-10-29,Los Angeles,037,10098052,1438302,1424257,53465,1477722,26625
2021-10-29,Madera,039,155013,23031,22524,2067,24591,283
2021-10-29,Marin,041,260295,17537,17380,441,17821,247
2021-10-29,Mariposa,043,17540,1285,1228,46,1274,5
2021-10-29,Mendocino,045,87422,7507,7338,524,7862,84
2021-10-29,Merced,047,269075,41782,41428,1873,43301,586
2021-10-29,Modoc,049,8938,528,513,185,698,5
2021-10-29,Mono,051,14174,1719,1684,21,1705,3
2021-10-29,Monterey,053,433212,48664,47649,2841,50490,588
2021-10-29,Napa,055,140530,12947,12863,107,12970,101
2021-10-29,Nevada,057,99092,9154,9015,315,9330,91
2021-10-29,Orange,059,3164182,306868,304120,14939,319059,5588
2021-10-29,Placer,061,380077,37056,36400,3590,39990,434
2021-10-29,Plumas,063,18699,1769,1695,33,1728,7
2021-10-29,Riverside,065,2383286,362649,357645,16211,373856,5088
2021-10-29,Sacramento,067,1510023,158546,157125,4489,161614,2233
2021-10-29,San Benito,069,59416,7389,7362,165,7527,71
2021-10-29,San Bernardino,071,2135413,353616,350076,11058,361134,5777
2021-10-29,San Diego,073,3302833,372661,370006,21882,391888,4213
2021-10-29,San Francisco,075,870044,52805,52161,2268,54429,661
2021-10-29,San Joaquin,077,732212,99563,98314,5315,103629,1768
2021-10-29,San Luis Obispo,079,281455,29511,29053,1228,30281,341
2021-10-29,San Mateo,081,765935,54083,53083,851,53934,571
2021-10-29,Santa Barbara,083,443738,44343,43972,1521,45493,528
2021-10-29,Santa Clara,085,1922200,146826,145262,1304,146566,1903
2021-10-29,Santa Cruz,087,273765,20363,20134,989,21123,221
2021-10-29,Shasta,089,179085,21324,20878,3540,24418,332
2021-10-29,Sierra,091,2930,182,175,20,195,0
2021-10-29,Siskiyou,093,43540,3334,3257,1264,4521,46
2021-10-29,Solano,095,438530,45896,45146,1245,46391,346
2021-10-29,Sonoma,097,501317,41386,40924,517,41441,393
2021-10-29,Stanislaus,099,539301,78178,77871,8721,86592,1191
2021-10-29,Sutter,101,95872,13829,13773,341,14114,178
2021-10-29,Tehama,103,63373,8475,8307,1459,9766,114
2021-10-29,Trinity,105,12862,853,708,208,916,11
2021-10-29,Tulare,107,460477,68289,66745,14656,81401,995
2021-10-29,Tuolumne,109,53932,7212,7050,95,7145,90
2021-10-29,Ventura,111,848112,98032,97182,4248,101430,1174
2021-10-29,Yolo,113,214977,19852,19568,1020,20588,250
2021-10-29,Yuba,115,75493,10104,9969,311,10280,82
2021-10-28,Alameda,001,1643700,119132,118632,2707,121339,1419
2021-10-28,Alpine,003,1148,101,105,0,105,0
2021-10-28,Amador,005,37829,5535,5480,58,5538,64
2021-10-28,Butte,007,227075,20885,20516,3772,24288,277
2021-10-28,Calaveras,009,45235,4050,3992,52,4044,82
2021-10-28,Colusa,011,21464,2510,2484,626,3110,19
2021-10-28,Contra Costa,013,1133247,99214,98562,2142,100704,1024
2021-10-28,Del Norte,015,27424,3673,3574,53,3627,42
2021-10-28,El Dorado,017,186661,16017,15752,1689,17441,154
2021-10-28,Fresno,019,978130,139319,136901,12527,149428,2131
2021-10-28,Glenn,021,27897,3490,3442,1003,4445,33
2021-10-28,Humboldt,023,135768,8966,8871,541,9412,105
2021-10-28,Imperial,025,180216,33484,33156,3111,36267,766
2021-10-28,Inyo,027,18085,2328,2249,38,2287,41
2021-10-28,Kern,029,883053,126898,124892,21617,146509,1653
2021-10-28,Kings,031,150075,32092,31578,1885,33463,337
2021-10-28,Lake,033,64148,6717,6610,142,6752,106
2021-10-28,Lassen,035,31185,6835,6719,355,7074,42
2021-10-28,Los Angeles,037,10098052,1437164,1424257,53391,1477648,26625
2021-10-28,Madera,039,155013,22977,22524,2056,24580,283
2021-10-28,Marin,041,260295,17519,17380,440,17820,247
2021-10-28,Mariposa,043,17540,1281,1228,46,1274,5
2021-10-28,Mendocino,045,87422,7494,7338,513,7851,84
2021-10-28,Merced,047,269075,41697,41428,1863,43291,586
2021-10-28,Modoc,049,8938,527,513,185,698,5
2021-10-28,Mono,051,14174,1713,1684,21,1705,3
2021-10-28,Monterey,053,433212,48633,47649,2824,50473,588
2021-10-28,Napa,055,140530,12938,12863,106,12969,101
2021-10-28,Nevada,057,99092,9136,9015,315,9330,91
2021-10-28,Orange,059,3164182,306582,304120,14876,318996,5588
2021-10-28,Placer,061,380077,36977,36400,3581,39981,434
2021-10-28,Plumas,063,18699,1761,1695,33,1728,7
2021-10-28,Riverside,065,2383286,362210,357645,16188,373833,5088
2021-10-28,Sacramento,067,1510023,158280,157125,4478,161603,2233
2021-10-28,San Benito,069,59416,7381,7362,165,7527,71
2021-10-28,San Bernardino,071,2135413,353201,350076,11035,361111,5777
2021-10-28,San Diego,073,3302833,372205,370006,21859,391865,4213
2021-10-28,San Francisco,075,870044,52759,52161,2261,54422,661
2021-10-28,San Joaquin,077,732212,99435,98314,5314,103628,1768
2021-10-28,San Luis Obispo,079,281455,29482,29053,1225,30278,341
2021-10-28,San Mateo,081,765935,54038,53083,849,53932,571
2021-10-28,Santa Barbara,083,443738,44304,43972,1519,45491,528
2021-10-28,Santa Clara,085,1922200,146669,145262,1299,146561,1903
2021-10-28,Santa Cruz,087,273765,20339,20134,989,21123,221
2021-10-28,Shasta,089,179085,21250,20878,3533,24411,332
2021-10-28,Sierra,091,2930,181,175,20,195,0
2021-10-28,Siskiyou,093,43540,3333,3257,1264,4521,46
2021-10-28,Solano,095,438530,45857,45146,1244,46390,346
2021-10-28,Sonoma,097,501317,41318,40924,516,41440,393
2021-10-28,Stanislaus,099,539301,78025,77871,8705,86576,1191
2021-10-28,Sutter,101,95872,13816,13773,337,14110,178
2021-10-28,Tehama,103,63373,8438,8307,1456,9763,114
2021-10-28,Trinity,105,12862,850,708,208,916,11
2021-10-28,Tulare,107,460477,68150,66745,14600,81345,995
2021-10-28,Tuolumne,109,53932,7181,7050,95,7145,90
2021-10-28,Ventura,111,848112,97947,97182,4245,101427,1174
2021-10-28,Yolo,113,214977,19814,19568,1016,20584,250
2021-10-28,Yuba,115,75493,10075,9969,308,10277,82
2021-10-27,Alameda,001,1643700,119010,118487,2705,121192,1414
2021-10-27,Alpine,003,1148,101,105,0,105,0
2021-10-27,Amador,005,37829,5523,5470,57,5527,64
2021-10-27,Butte,007,227075,20840,20446,3757,24203,274
2021-10-27,Calaveras,009,45235,4032,3970,51,4021,82
2021-10-27,Colusa,011,21464,2509,2480,625,3105,18
2021-10-27,Contra Costa,013,1133247,99106,98442,2130,100572,1018
2021-10-27,Del Norte,015,27424,3666,3571,52,3623,42
2021-10-27,El Dorado,017,186661,15986,15723,1684,17407,154
2021-10-27,Fresno,019,978130,138938,136447,12493,148940,2128
2021-10-27,Glenn,021,27897,3488,3435,1002,4437,33
2021-10-27,Humboldt,023,135768,8946,8851,539,9390,105
2021-10-27,Imperial,025,180216,33444,33068,3106,36174,766
2021-10-27,Inyo,027,18085,2308,2236,38,2274,41
2021-10-27,Kern,029,883053,126629,124557,21517,146074,1647
2021-10-27,Kings,031,150075,32026,31437,1879,33316,335
2021-10-27,Lake,033,64148,6691,6589,142,6731,105
2021-10-27,Lassen,035,31185,6822,6706,353,7059,42
2021-10-27,Los Angeles,037,10098052,1435935,1422615,53333,1475948,26604
2021-10-27,Madera,039,155013,22893,22413,2032,24445,283
2021-10-27,Marin,041,260295,17504,17362,440,17802,247
2021-10-27,Mariposa,043,17540,1268,1228,46,1274,5
2021-10-27,Mendocino,045,87422,7480,7321,506,7827,84
2021-10-27,Merced,047,269075,41600,41310,1849,43159,583
2021-10-27,Modoc,049,8938,523,513,185,698,5
2021-10-27,Mono,051,14174,1710,1682,21,1703,3
2021-10-27,Monterey,053,433212,48596,47610,2803,50413,588
2021-10-27,Napa,055,140530,12923,12856,106,12962,101
2021-10-27,Nevada,057,99092,9118,8987,314,9301,90
2021-10-27,Orange,059,3164182,306260,303825,14827,318652,5584
2021-10-27,Placer,061,380077,36912,36296,3574,39870,434
2021-10-27,Plumas,063,18699,1753,1686,33,1719,7
2021-10-27,Riverside,065,2383286,361780,357152,16180,373332,5081
2021-10-27,Sacramento,067,1510023,158012,156830,4457,161287,2230
2021-10-27,San Benito,069,59416,7374,7337,165,7502,71
2021-10-27,San Bernardino,071,2135413,352777,349624,11013,360637,5770
2021-10-27,San Diego,073,3302833,371648,369579,21835,391414,4207
2021-10-27,San Francisco,075,870044,52708,52108,2257,54365,655
2021-10-27,San Joaquin,077,732212,99278,98168,5299,103467,1753
2021-10-27,San Luis Obispo,079,281455,29443,29002,1223,30225,341
2021-10-27,San Mateo,081,765935,53983,53032,841,53873,571
2021-10-27,Santa Barbara,083,443738,44251,43901,1516,45417,527
2021-10-27,Santa Clara,085,1922200,146493,145081,1291,146372,1902
2021-10-27,Santa Cruz,087,273765,20312,20091,987,21078,221
2021-10-27,Shasta,089,179085,21175,20813,3525,24338,331
2021-10-27,Sierra,091,2930,180,176,20,196,0
2021-10-27,Siskiyou,093,43540,3330,3256,1260,4516,46
2021-10-27,Solano,095,438530,45812,45089,1237,46326,346
2021-10-27,Sonoma,097,501317,41242,40829,514,41343,393
2021-10-27,Stanislaus,099,539301,77865,77687,8690,86377,1191
2021-10-27,Sutter,101,95872,13802,13754,337,14091,177
2021-10-27,Tehama,103,63373,8416,8265,1454,9719,113
2021-10-27,Trinity,105,12862,850,706,207,913,11
2021-10-27,Tulare,107,460477,67996,66568,14544,81112,991
2021-10-27,Tuolumne,109,53932,7154,7009,94,7103,90
2021-10-27,Ventura,111,848112,97855,97108,4240,101348,1172
2021-10-27,Yolo,113,214977,19785,19517,1009,20526,250
2021-10-27,Yuba,115,75493,10054,9945,306,10251,82
2021-10-26,Alameda,001,1643700,118874,118360,2703,121063,1407
2021-10-26,Alpine,003,1148,101,105,0,105,0
2021-10-26,Amador,005,37829,5515,5465,56,5521,64
2021-10-26,Butte,007,227075,20780,20387,3740,24127,274
2021-10-26,Calaveras,009,45235,4021,3966,51,4017,81
2021-10-26,Colusa,011,21464,2507,2478,624,3102,18
2021-10-26,Contra Costa,013,1133247,98984,98352,2119,100471,1017
2021-10-26,Del Norte,015,27424,3661,3563,52,3615,42
2021-10-26,El Dorado,017,186661,15957,15690,1675,17365,153
2021-10-26,Fresno,019,978130,138490,136211,12448,148659,2122
2021-10-26,Glenn,021,27897,3473,3431,999,4430,33
2021-10-26,Humboldt,023,135768,8928,8830,533,9363,105
2021-10-26,Imperial,025,180216,33379,33012,3101,36113,766
2021-10-26,Inyo,027,18085,2293,2200,38,2238,41
2021-10-26,Kern,029,883053,126286,124351,21399,145750,1645
2021-10-26,Kings,031,150075,31959,31382,1872,33254,336
2021-10-26,Lake,033,64148,6681,6584,140,6724,105
2021-10-26,Lassen,035,31185,6801,6689,351,7040,42
2021-10-26,Los Angeles,037,10098052,1434593,1421795,53263,1475058,26599
2021-10-26,Madera,039,155013,22803,22363,2021,24384,283
2021-10-26,Marin,041,260295,17487,17354,439,17793,244
2021-10-26,Mariposa,043,17540,1263,1225,45,1270,5
2021-10-26,Mendocino,045,87422,7451,7308,490,7798,83
2021-10-26,Merced,047,269075,41522,41267,1842,43109,583
2021-10-26,Modoc,049,8938,523,513,185,698,5
2021-10-26,Mono,051,14174,1705,1680,21,1701,3
2021-10-26,Monterey,053,433212,48557,47572,2793,50365,588
2021-10-26,Napa,055,140530,12911,12849,106,12955,101
2021-10-26,Nevada,057,99092,9087,8971,313,9284,90
2021-10-26,Orange,059,3164182,305990,303533,14788,318321,5580
2021-10-26,Placer,061,380077,36815,36245,3568,39813,434
2021-10-26,Plumas,063,18699,1744,1645,33,1678,7
2021-10-26,Riverside,065,2383286,361290,356775,16170,372945,5068
2021-10-26,Sacramento,067,1510023,157711,156643,4440,161083,2228
2021-10-26,San Benito,069,59416,7351,7325,165,7490,71
2021-10-26,San Bernardino,071,2135413,352349,349346,10998,360344,5764
2021-10-26,San Diego,073,3302833,371131,369043,21805,390848,4198
2021-10-26,San Francisco,075,870044,52634,52063,2254,54317,655
2021-10-26,San Joaquin,077,732212,99099,98036,5284,103320,1748
2021-10-26,San Luis Obispo,079,281455,29404,28928,1217,30145,337
2021-10-26,San Mateo,081,765935,53911,52974,838,53812,571
2021-10-26,Santa Barbara,083,443738,44205,43835,1515,45350,525
2021-10-26,Santa Clara,085,1922200,146293,144932,1285,146217,1903
2021-10-26,Santa Cruz,087,273765,20281,20067,987,21054,221
2021-10-26,Shasta,089,179085,21114,20725,3507,24232,330
2021-10-26,Sierra,091,2930,180,169,20,189,0
2021-10-26,Siskiyou,093,43540,3324,3254,1258,4512,46
2021-10-26,Solano,095,438530,45756,45044,1236,46280,344
2021-10-26,Sonoma,097,501317,41160,40794,512,41306,393
2021-10-26,Stanislaus,099,539301,77691,77552,8665,86217,1157
2021-10-26,Sutter,101,95872,13773,13739,336,14075,176
2021-10-26,Tehama,103,63373,8388,8247,1449,9696,112
2021-10-26,Trinity,105,12862,846,705,207,912,11
2021-10-26,Tulare,107,460477,67836,66476,14487,80963,991
2021-10-26,Tuolumne,109,53932,7128,6995,92,7087,90
2021-10-26,Ventura,111,848112,97746,97014,4237,101251,1170
2021-10-26,Yolo,113,214977,19756,19490,1006,20496,248
2021-10-26,Yuba,115,75493,10036,9927,301,10228,82
2021-10-25,Alameda,001,1643700,118730,118319,2702,121021,1404
2021-10-25,Alpine,003,1148,101,105,0,105,0
2021-10-25,Amador,005,37829,5501,5455,56,5511,64
2021-10-25,Butte,007,227075,20707,20331,3732,24063,273
2021-10-25,Calaveras,009,45235,3991,3942,50,3992,82
2021-10-25,Colusa,011,21464,2505,2471,622,3093,18
2021-10-25,Contra Costa,013,1133247,98867,98267,2115,100382,1017
2021-10-25,Del Norte,015,27424,3654,3562,52,3614,42
2021-10-25,El Dorado,017,186661,15922,15663,1673,17336,149
2021-10-25,Fresno,019,978130,138056,135974,12413,148387,2112
2021-10-25,Glenn,021,27897,3470,3421,998,4419,33
2021-10-25,Humboldt,023,135768,8905,8825,528,9353,105
2021-10-25,Imperial,025,180216,33318,32968,3090,36058,766
2021-10-25,Inyo,027,18085,2275,2183,38,2221,41
2021-10-25,Kern,029,883053,125935,124078,21260,145338,1649
2021-10-25,Kings,031,150075,31870,31329,1863,33192,335
2021-10-25,Lake,033,64148,6668,6571,140,6711,105
2021-10-25,Lassen,035,31185,6790,6688,349,7037,42
2021-10-25,Los Angeles,037,10098052,1433238,1421061,53197,1474258,26579
2021-10-25,Madera,039,155013,22749,22325,2014,24339,281
2021-10-25,Marin,041,260295,17465,17334,437,17771,244
2021-10-25,Mariposa,043,17540,1249,1220,45,1265,5
2021-10-25,Mendocino,045,87422,7421,7296,486,7782,82
2021-10-25,Merced,047,269075,41454,41207,1815,43022,583
2021-10-25,Modoc,049,8938,521,512,183,695,5
2021-10-25,Mono,051,14174,1697,1677,21,1698,3
2021-10-25,Monterey,053,433212,48524,47547,2791,50338,587
2021-10-25,Napa,055,140530,12898,12841,106,12947,100
2021-10-25,Nevada,057,99092,9061,8958,313,9271,90
2021-10-25,Orange,059,3164182,305692,303279,14751,318030,5574
2021-10-25,Placer,061,380077,36707,36153,3558,39711,431
2021-10-25,Plumas,063,18699,1732,1641,33,1674,7
2021-10-25,Riverside,065,2383286,360863,356381,16155,372536,5056
2021-10-25,Sacramento,067,1510023,157407,156516,4417,160933,2235
2021-10-25,San Benito,069,59416,7338,7314,164,7478,71
2021-10-25,San Bernardino,071,2135413,351843,349075,10986,360061,5748
2021-10-25,San Diego,073,3302833,370562,368386,21777,390163,4196
2021-10-25,San Francisco,075,870044,52561,52041,2248,54289,649
2021-10-25,San Joaquin,077,732212,98896,97980,5275,103255,1740
2021-10-25,San Luis Obispo,079,281455,29356,28907,1212,30119,336
2021-10-25,San Mateo,081,765935,53850,52927,834,53761,571
2021-10-25,Santa Barbara,083,443738,44146,43775,1515,45290,525
2021-10-25,Santa Clara,085,1922200,146102,144895,1280,146175,1901
2021-10-25,Santa Cruz,087,273765,20252,20053,986,21039,221
2021-10-25,Shasta,089,179085,21042,20666,3500,24166,326
2021-10-25,Sierra,091,2930,180,168,20,188,0
2021-10-25,Siskiyou,093,43540,3320,3248,1253,4501,46
2021-10-25,Solano,095,438530,45695,45022,1234,46256,344
2021-10-25,Sonoma,097,501317,41087,40746,510,41256,393
2021-10-25,Stanislaus,099,539301,77499,77452,8637,86089,1145
2021-10-25,Sutter,101,95872,13760,13721,333,14054,176
2021-10-25,Tehama,103,63373,8361,8224,1445,9669,111
2021-10-25,Trinity,105,12862,841,699,206,905,11
2021-10-25,Tulare,107,460477,67641,66357,14425,80782,986
2021-10-25,Tuolumne,109,53932,7094,6952,91,7043,90
2021-10-25,Ventura,111,848112,97655,96932,4234,101166,1167
2021-10-25,Yolo,113,214977,19707,19457,1002,20459,248
2021-10-25,Yuba,115,75493,10020,9924,297,10221,82
2021-10-24,Alameda,001,1643700,118598,117816,2697,120513,1397
2021-10-24,Alpine,003,1148,101,105,0,105,0
2021-10-24,Amador,005,37829,5496,5412,56,5468,64
2021-10-24,Butte,007,227075,20635,20101,3720,23821,273
2021-10-24,Calaveras,009,45235,3972,3865,49,3914,81
2021-10-24,Colusa,011,21464,2501,2458,619,3077,18
2021-10-24,Contra Costa,013,1133247,98749,97855,2106,99961,1008
2021-10-24,Del Norte,015,27424,3650,3540,52,3592,42
2021-10-24,El Dorado,017,186661,15886,15540,1669,17209,149
2021-10-24,Fresno,019,978130,137620,134466,12364,146830,2094
2021-10-24,Glenn,021,27897,3463,3399,996,4395,33
2021-10-24,Humboldt,023,135768,8892,8753,522,9275,105
2021-10-24,Imperial,025,180216,33240,32777,3084,35861,766
2021-10-24,Inyo,027,18085,2243,2108,38,2146,41
2021-10-24,Kern,029,883053,125601,122939,21144,144083,1636
2021-10-24,Kings,031,150075,31741,30942,1848,32790,325
2021-10-24,Lake,033,64148,6645,6501,139,6640,105
2021-10-24,Lassen,035,31185,6773,6632,348,6980,27
2021-10-24,Los Angeles,037,10098052,1431803,1415919,53129,1469048,26527
2021-10-24,Madera,039,155013,22672,22062,2002,24064,281
2021-10-24,Marin,041,260295,17449,17264,436,17700,244
2021-10-24,Mariposa,043,17540,1246,1184,45,1229,5
2021-10-24,Mendocino,045,87422,7397,7220,476,7696,82
2021-10-24,Merced,047,269075,41333,40808,1809,42617,581
2021-10-24,Modoc,049,8938,520,507,183,690,5
2021-10-24,Mono,051,14174,1692,1655,21,1676,3
2021-10-24,Monterey,053,433212,48476,47456,2781,50237,586
2021-10-24,Napa,055,140530,12887,12789,106,12895,100
2021-10-24,Nevada,057,99092,9038,8861,310,9171,90
2021-10-24,Orange,059,3164182,305342,302237,14714,316951,5546
2021-10-24,Placer,061,380077,36603,35822,3544,39366,426
2021-10-24,Plumas,063,18699,1722,1623,32,1655,7
2021-10-24,Riverside,065,2383286,360389,354688,16135,370823,5041
2021-10-24,Sacramento,067,1510023,157066,155125,4394,159519,2232
2021-10-24,San Benito,069,59416,7318,7280,164,7444,71
2021-10-24,San Bernardino,071,2135413,351286,347681,10974,358655,5688
2021-10-24,San Diego,073,3302833,369979,366085,21746,387831,4183
2021-10-24,San Francisco,075,870044,52498,51820,2242,54062,649
2021-10-24,San Joaquin,077,732212,98723,97440,5269,102709,1721
2021-10-24,San Luis Obispo,079,281455,29295,28755,1205,29960,333
2021-10-24,San Mateo,081,765935,53778,52719,834,53553,571
2021-10-24,Santa Barbara,083,443738,44079,43552,1513,45065,523
2021-10-24,Santa Clara,085,1922200,145911,144276,1270,145546,1897
2021-10-24,Santa Cruz,087,273765,20214,19967,985,20952,221
2021-10-24,Shasta,089,179085,20943,20386,3494,23880,321
2021-10-24,Sierra,091,2930,180,168,20,188,0
2021-10-24,Siskiyou,093,43540,3313,3231,1249,4480,46
2021-10-24,Solano,095,438530,45645,44861,1229,46090,341
2021-10-24,Sonoma,097,501317,41004,40476,510,40986,393
2021-10-24,Stanislaus,099,539301,77307,76812,8626,85438,1145
2021-10-24,Sutter,101,95872,13733,13616,325,13941,175
2021-10-24,Tehama,103,63373,8313,8105,1434,9539,110
2021-10-24,Trinity,105,12862,837,696,204,900,11
2021-10-24,Tulare,107,460477,67468,65585,14354,79939,978
2021-10-24,Tuolumne,109,53932,7054,6840,89,6929,90
2021-10-24,Ventura,111,848112,97548,96664,4233,100897,1167
2021-10-24,Yolo,113,214977,19658,19280,1000,20280,248
2021-10-24,Yuba,115,75493,9995,9838,296,10134,82
2021-10-23,Alameda,001,1643700,118510,117816,2692,120508,1397
2021-10-23,Alpine,003,1148,101,105,0,105,0
2021-10-23,Amador,005,37829,5489,5412,56,5468,64
2021-10-23,Butte,007,227075,20598,20101,3712,23813,273
2021-10-23,Calaveras,009,45235,3965,3865,48,3913,81
2021-10-23,Colusa,011,21464,2499,2458,618,3076,18
2021-10-23,Contra Costa,013,1133247,98697,97855,2102,99957,1008
2021-10-23,Del Norte,015,27424,3648,3540,52,3592,42
2021-10-23,El Dorado,017,186661,15860,15540,1667,17207,149
2021-10-23,Fresno,019,978130,137442,134466,12351,146817,2094
2021-10-23,Glenn,021,27897,3461,3399,995,4394,33
2021-10-23,Humboldt,023,135768,8878,8753,517,9270,105
2021-10-23,Imperial,025,180216,33193,32777,3080,35857,766
2021-10-23,Inyo,027,18085,2232,2108,38,2146,41
2021-10-23,Kern,029,883053,125441,122939,21057,143996,1636
2021-10-23,Kings,031,150075,31695,30942,1846,32788,325
2021-10-23,Lake,033,64148,6640,6501,139,6640,105
2021-10-23,Lassen,035,31185,6770,6632,346,6978,27
2021-10-23,Los Angeles,037,10098052,1431121,1415919,53075,1468994,26527
2021-10-23,Madera,039,155013,22623,22062,1994,24056,281
2021-10-23,Marin,041,260295,17432,17264,436,17700,244
2021-10-23,Mariposa,043,17540,1243,1184,44,1228,5
2021-10-23,Mendocino,045,87422,7390,7220,475,7695,82
2021-10-23,Merced,047,269075,41292,40808,1804,42612,581
2021-10-23,Modoc,049,8938,518,507,183,690,5
2021-10-23,Mono,051,14174,1686,1655,21,1676,3
2021-10-23,Monterey,053,433212,48459,47456,2777,50233,586
2021-10-23,Napa,055,140530,12882,12789,106,12895,100
2021-10-23,Nevada,057,99092,9027,8861,308,9169,90
2021-10-23,Orange,059,3164182,305156,302237,14699,316936,5546
2021-10-23,Placer,061,380077,36541,35822,3538,39360,426
2021-10-23,Plumas,063,18699,1721,1623,32,1655,7
2021-10-23,Riverside,065,2383286,360068,354688,16128,370816,5041
2021-10-23,Sacramento,067,1510023,156937,155125,4386,159511,2232
2021-10-23,San Benito,069,59416,7308,7280,164,7444,71
2021-10-23,San Bernardino,071,2135413,351015,347681,10966,358647,5688
2021-10-23,San Diego,073,3302833,369638,366085,21715,387800,4183
2021-10-23,San Francisco,075,870044,52462,51820,2241,54061,649
2021-10-23,San Joaquin,077,732212,98655,97440,5260,102700,1721
2021-10-23,San Luis Obispo,079,281455,29258,28755,1203,29958,333
2021-10-23,San Mateo,081,765935,53740,52719,833,53552,571
2021-10-23,Santa Barbara,083,443738,44048,43552,1511,45063,523
2021-10-23,Santa Clara,085,1922200,145803,144276,1266,145542,1897
2021-10-23,Santa Cruz,087,273765,20202,19967,985,20952,221
2021-10-23,Shasta,089,179085,20907,20386,3482,23868,321
2021-10-23,Sierra,091,2930,179,168,20,188,0
2021-10-23,Siskiyou,093,43540,3311,3231,1249,4480,46
2021-10-23,Solano,095,438530,45620,44861,1226,46087,341
2021-10-23,Sonoma,097,501317,40964,40476,510,40986,393
2021-10-23,Stanislaus,099,539301,77218,76812,8606,85418,1145
2021-10-23,Sutter,101,95872,13727,13616,324,13940,175
2021-10-23,Tehama,103,63373,8301,8105,1433,9538,110
2021-10-23,Trinity,105,12862,836,696,204,900,11
2021-10-23,Tulare,107,460477,67380,65585,14295,79880,978
2021-10-23,Tuolumne,109,53932,7033,6840,89,6929,90
2021-10-23,Ventura,111,848112,97487,96664,4233,100897,1167
2021-10-23,Yolo,113,214977,19641,19280,997,20277,248
2021-10-23,Yuba,115,75493,9987,9838,296,10134,82
2021-10-22,Alameda,001,1643700,118428,117816,2689,120505,1397
2021-10-22,Alpine,003,1148,101,105,0,105,0
2021-10-22,Amador,005,37829,5478,5412,56,5468,64
2021-10-22,Butte,007,227075,20566,20101,3708,23809,273
2021-10-22,Calaveras,009,45235,3957,3865,48,3913,81
2021-10-22,Colusa,011,21464,2496,2458,618,3076,18
2021-10-22,Contra Costa,013,1133247,98606,97855,2100,99955,1008
2021-10-22,Del Norte,015,27424,3644,3540,52,3592,42
2021-10-22,El Dorado,017,186661,15847,15540,1665,17205,149
2021-10-22,Fresno,019,978130,137227,134466,12329,146795,2094
2021-10-22,Glenn,021,27897,3451,3399,995,4394,33
2021-10-22,Humboldt,023,135768,8864,8753,516,9269,105
2021-10-22,Imperial,025,180216,33150,32777,3080,35857,766
2021-10-22,Inyo,027,18085,2219,2108,38,2146,41
2021-10-22,Kern,029,883053,125254,122939,20984,143923,1636
2021-10-22,Kings,031,150075,31660,30942,1845,32787,325
2021-10-22,Lake,033,64148,6630,6501,139,6640,105
2021-10-22,Lassen,035,31185,6763,6632,343,6975,27
2021-10-22,Los Angeles,037,10098052,1430358,1415919,53016,1468935,26527
2021-10-22,Madera,039,155013,22573,22062,1982,24044,281
2021-10-22,Marin,041,260295,17420,17264,436,17700,244
2021-10-22,Mariposa,043,17540,1240,1184,44,1228,5
2021-10-22,Mendocino,045,87422,7376,7220,474,7694,82
2021-10-22,Merced,047,269075,41255,40808,1797,42605,581
2021-10-22,Modoc,049,8938,518,507,183,690,5
2021-10-22,Mono,051,14174,1684,1655,21,1676,3
2021-10-22,Monterey,053,433212,48426,47456,2775,50231,586
2021-10-22,Napa,055,140530,12876,12789,106,12895,100
2021-10-22,Nevada,057,99092,9010,8861,307,9168,90
2021-10-22,Orange,059,3164182,304940,302237,14669,316906,5546
2021-10-22,Placer,061,380077,36513,35822,3529,39351,426
2021-10-22,Plumas,063,18699,1715,1623,32,1655,7
2021-10-22,Riverside,065,2383286,359757,354688,16123,370811,5041
2021-10-22,Sacramento,067,1510023,156750,155125,4377,159502,2232
2021-10-22,San Benito,069,59416,7303,7280,164,7444,71
2021-10-22,San Bernardino,071,2135413,350686,347681,10951,358632,5688
2021-10-22,San Diego,073,3302833,369240,366085,21697,387782,4183
2021-10-22,San Francisco,075,870044,52426,51820,2234,54054,649
2021-10-22,San Joaquin,077,732212,98596,97440,5257,102697,1721
2021-10-22,San Luis Obispo,079,281455,29228,28755,1203,29958,333
2021-10-22,San Mateo,081,765935,53689,52719,827,53546,571
2021-10-22,Santa Barbara,083,443738,44007,43552,1511,45063,523
2021-10-22,Santa Clara,085,1922200,145647,144276,1259,145535,1897
2021-10-22,Santa Cruz,087,273765,20180,19967,985,20952,221
2021-10-22,Shasta,089,179085,20874,20386,3479,23865,321
2021-10-22,Sierra,091,2930,178,168,19,187,0
2021-10-22,Siskiyou,093,43540,3309,3231,1246,4477,46
2021-10-22,Solano,095,438530,45585,44861,1222,46083,341
2021-10-22,Sonoma,097,501317,40907,40476,510,40986,393
2021-10-22,Stanislaus,099,539301,77115,76812,8589,85401,1145
2021-10-22,Sutter,101,95872,13712,13616,324,13940,175
2021-10-22,Tehama,103,63373,8279,8105,1428,9533,110
2021-10-22,Trinity,105,12862,835,696,204,900,11
2021-10-22,Tulare,107,460477,67294,65585,14242,79827,978
2021-10-22,Tuolumne,109,53932,6998,6840,89,6929,90
2021-10-22,Ventura,111,848112,97434,96664,4227,100891,1167
2021-10-22,Yolo,113,214977,19614,19280,995,20275,248
2021-10-22,Yuba,115,75493,9973,9838,294,10132,82
2021-10-21,Alameda,001,1643700,118313,117816,2684,120500,1397
2021-10-21,Alpine,003,1148,101,105,0,105,0
2021-10-21,Amador,005,37829,5470,5412,56,5468,64
2021-10-21,Butte,007,227075,20482,20101,3694,23795,273
2021-10-21,Calaveras,009,45235,3938,3865,48,3913,81
2021-10-21,Colusa,011,21464,2492,2458,614,3072,18
2021-10-21,Contra Costa,013,1133247,98489,97855,2095,99950,1008
2021-10-21,Del Norte,015,27424,3638,3540,51,3591,42
2021-10-21,El Dorado,017,186661,15818,15540,1658,17198,149
2021-10-21,Fresno,019,978130,136877,134466,12285,146751,2094
2021-10-21,Glenn,021,27897,3447,3399,992,4391,33
2021-10-21,Humboldt,023,135768,8850,8753,512,9265,105
2021-10-21,Imperial,025,180216,33095,32777,3076,35853,766
2021-10-21,Inyo,027,18085,2197,2108,38,2146,41
2021-10-21,Kern,029,883053,125007,122939,20875,143814,1636
2021-10-21,Kings,031,150075,31562,30942,1839,32781,325
2021-10-21,Lake,033,64148,6616,6501,138,6639,105
2021-10-21,Lassen,035,31185,6750,6632,339,6971,27
2021-10-21,Los Angeles,037,10098052,1429238,1415919,52967,1468886,26527
2021-10-21,Madera,039,155013,22515,22062,1972,24034,281
2021-10-21,Marin,041,260295,17402,17264,436,17700,244
2021-10-21,Mariposa,043,17540,1234,1184,43,1227,5
2021-10-21,Mendocino,045,87422,7358,7220,467,7687,82
2021-10-21,Merced,047,269075,41158,40808,1786,42594,581
2021-10-21,Modoc,049,8938,518,507,183,690,5
2021-10-21,Mono,051,14174,1675,1655,21,1676,3
2021-10-21,Monterey,053,433212,48392,47456,2764,50220,586
2021-10-21,Napa,055,140530,12864,12789,106,12895,100
2021-10-21,Nevada,057,99092,8985,8861,307,9168,90
2021-10-21,Orange,059,3164182,304668,302237,14633,316870,5546
2021-10-21,Placer,061,380077,36424,35822,3516,39338,426
2021-10-21,Plumas,063,18699,1701,1623,32,1655,7
2021-10-21,Riverside,065,2383286,359310,354688,16113,370801,5041
2021-10-21,Sacramento,067,1510023,156431,155125,4351,159476,2232
2021-10-21,San Benito,069,59416,7296,7280,162,7442,71
2021-10-21,San Bernardino,071,2135413,350306,347681,10917,358598,5688
2021-10-21,San Diego,073,3302833,368728,366085,21667,387752,4183
2021-10-21,San Francisco,075,870044,52371,51820,2233,54053,649
2021-10-21,San Joaquin,077,732212,98457,97440,5250,102690,1721
2021-10-21,San Luis Obispo,079,281455,29186,28755,1201,29956,333
2021-10-21,San Mateo,081,765935,53642,52719,826,53545,571
2021-10-21,Santa Barbara,083,443738,43941,43552,1509,45061,523
2021-10-21,Santa Clara,085,1922200,145476,144276,1255,145531,1897
2021-10-21,Santa Cruz,087,273765,20156,19967,983,20950,221
2021-10-21,Shasta,089,179085,20813,20386,3464,23850,321
2021-10-21,Sierra,091,2930,177,168,18,186,0
2021-10-21,Siskiyou,093,43540,3304,3231,1244,4475,46
2021-10-21,Solano,095,438530,45533,44861,1220,46081,341
2021-10-21,Sonoma,097,501317,40838,40476,508,40984,393
2021-10-21,Stanislaus,099,539301,76946,76812,8578,85390,1145
2021-10-21,Sutter,101,95872,13684,13616,320,13936,175
2021-10-21,Tehama,103,63373,8252,8105,1421,9526,110
2021-10-21,Trinity,105,12862,833,696,204,900,11
2021-10-21,Tulare,107,460477,67105,65585,14173,79758,978
2021-10-21,Tuolumne,109,53932,6960,6840,88,6928,90
2021-10-21,Ventura,111,848112,97343,96664,4225,100889,1167
2021-10-21,Yolo,113,214977,19569,19280,993,20273,248
2021-10-21,Yuba,115,75493,9949,9838,293,10131,82
2021-10-20,Alameda,001,1643700,118193,117654,2684,120338,1390
2021-10-20,Alpine,003,1148,101,103,0,103,0
2021-10-20,Amador,005,37829,5462,5379,56,5435,64
2021-10-20,Butte,007,227075,20427,20021,3678,23699,270
2021-10-20,Calaveras,009,45235,3918,3844,47,3891,81
2021-10-20,Colusa,011,21464,2488,2454,612,3066,18
2021-10-20,Contra Costa,013,1133247,98373,97721,2091,99812,1008
2021-10-20,Del Norte,015,27424,3634,3536,51,3587,42
2021-10-20,El Dorado,017,186661,15788,15502,1655,17157,149
2021-10-20,Fresno,019,978130,136477,134025,12248,146273,2084
2021-10-20,Glenn,021,27897,3439,3382,991,4373,33
2021-10-20,Humboldt,023,135768,8828,8727,510,9237,105
2021-10-20,Imperial,025,180216,33021,32705,3068,35773,766
2021-10-20,Inyo,027,18085,2178,2077,37,2114,40
2021-10-20,Kern,029,883053,124713,122630,20756,143386,1623
2021-10-20,Kings,031,150075,31485,30805,1829,32634,322
2021-10-20,Lake,033,64148,6594,6475,137,6612,104
2021-10-20,Lassen,035,31185,6735,6622,339,6961,27
2021-10-20,Los Angeles,037,10098052,1428120,1414931,52897,1467828,26506
2021-10-20,Madera,039,155013,22445,21983,1963,23946,281
2021-10-20,Marin,041,260295,17381,17250,434,17684,244
2021-10-20,Mariposa,043,17540,1227,1174,43,1217,5
2021-10-20,Mendocino,045,87422,7330,7189,464,7653,82
2021-10-20,Merced,047,269075,41077,40685,1770,42455,581
2021-10-20,Modoc,049,8938,518,504,183,687,5
2021-10-20,Mono,051,14174,1675,1653,21,1674,3
2021-10-20,Monterey,053,433212,48360,47430,2755,50185,587
2021-10-20,Napa,055,140530,12850,12773,105,12878,100
2021-10-20,Nevada,057,99092,8957,8836,307,9143,90
2021-10-20,Orange,059,3164182,304382,301957,14611,316568,5534
2021-10-20,Placer,061,380077,36335,35729,3507,39236,425
2021-10-20,Plumas,063,18699,1694,1604,32,1636,7
2021-10-20,Riverside,065,2383286,358866,354311,16096,370407,5030
2021-10-20,Sacramento,067,1510023,156132,154822,4328,159150,2222
2021-10-20,San Benito,069,59416,7293,7275,160,7435,71
2021-10-20,San Bernardino,071,2135413,349906,347217,10886,358103,5663
2021-10-20,San Diego,073,3302833,368219,365698,21648,387346,4178
2021-10-20,San Francisco,075,870044,52322,51755,2232,53987,646
2021-10-20,San Joaquin,077,732212,98312,97246,5242,102488,1721
2021-10-20,San Luis Obispo,079,281455,29140,28727,1197,29924,332
2021-10-20,San Mateo,081,765935,53571,52663,818,53481,571
2021-10-20,Santa Barbara,083,443738,43878,43489,1508,44997,523
2021-10-20,Santa Clara,085,1922200,145341,144124,1250,145374,1896
2021-10-20,Santa Cruz,087,273765,20143,19951,983,20934,219
2021-10-20,Shasta,089,179085,20751,20313,3437,23750,320
2021-10-20,Sierra,091,2930,177,168,18,186,0
2021-10-20,Siskiyou,093,43540,3304,3224,1238,4462,46
2021-10-20,Solano,095,438530,45501,44819,1218,46037,341
2021-10-20,Sonoma,097,501317,40791,40404,508,40912,393
2021-10-20,Stanislaus,099,539301,76796,76631,8559,85190,1145
2021-10-20,Sutter,101,95872,13660,13592,314,13906,175
2021-10-20,Tehama,103,63373,8221,8081,1410,9491,110
2021-10-20,Trinity,105,12862,833,693,203,896,11
2021-10-20,Tulare,107,460477,66930,65413,14129,79542,967
2021-10-20,Tuolumne,109,53932,6937,6803,88,6891,89
2021-10-20,Ventura,111,848112,97261,96610,4221,100831,1166
2021-10-20,Yolo,113,214977,19524,19236,991,20227,248
2021-10-20,Yuba,115,75493,9932,9808,290,10098,82
2021-10-19,Alameda,001,1643700,118071,117542,2678,120220,1383
2021-10-19,Alpine,003,1148,101,103,0,103,0
2021-10-19,Amador,005,37829,5446,5367,56,5423,64
2021-10-19,Butte,007,227075,20374,19974,3670,23644,268
2021-10-19,Calaveras,009,45235,3901,3826,46,3872,80
2021-10-19,Colusa,011,21464,2485,2447,610,3057,18
2021-10-19,Contra Costa,013,1133247,98282,97613,2086,99699,1004
2021-10-19,Del Norte,015,27424,3627,3531,51,3582,42
2021-10-19,El Dorado,017,186661,15763,15478,1650,17128,149
2021-10-19,Fresno,019,978130,136113,133813,12200,146013,2073
2021-10-19,Glenn,021,27897,3436,3380,989,4369,33
2021-10-19,Humboldt,023,135768,8804,8714,504,9218,105
2021-10-19,Imperial,025,180216,32955,32632,3064,35696,764
2021-10-19,Inyo,027,18085,2147,2045,37,2082,40
2021-10-19,Kern,029,883053,124396,122391,20632,143023,1613
2021-10-19,Kings,031,150075,31392,30757,1822,32579,322
2021-10-19,Lake,033,64148,6590,6465,137,6602,104
2021-10-19,Lassen,035,31185,6729,6612,335,6947,27
2021-10-19,Los Angeles,037,10098052,1426873,1413882,52824,1466706,26473
2021-10-19,Madera,039,155013,22382,21950,1955,23905,281
2021-10-19,Marin,041,260295,17367,17241,431,17672,244
2021-10-19,Mariposa,043,17540,1221,1171,41,1212,5
2021-10-19,Mendocino,045,87422,7315,7172,461,7633,82
2021-10-19,Merced,047,269075,40962,40628,1749,42377,580
2021-10-19,Modoc,049,8938,516,502,183,685,5
2021-10-19,Mono,051,14174,1671,1651,21,1672,3
2021-10-19,Monterey,053,433212,48323,47412,2744,50156,583
2021-10-19,Napa,055,140530,12843,12769,105,12874,100
2021-10-19,Nevada,057,99092,8936,8829,306,9135,90
2021-10-19,Orange,059,3164182,304125,301700,14578,316278,5527
2021-10-19,Placer,061,380077,36214,35663,3492,39155,422
2021-10-19,Plumas,063,18699,1676,1586,32,1618,8
2021-10-19,Riverside,065,2383286,358444,353891,16089,369980,5020
2021-10-19,Sacramento,067,1510023,155826,154570,4302,158872,2227
2021-10-19,San Benito,069,59416,7278,7264,160,7424,71
2021-10-19,San Bernardino,071,2135413,349504,346814,10857,357671,5627
2021-10-19,San Diego,073,3302833,367638,365285,21617,386902,4170
2021-10-19,San Francisco,075,870044,52259,51704,2230,53934,645
2021-10-19,San Joaquin,077,732212,98145,97105,5231,102336,1721
2021-10-19,San Luis Obispo,079,281455,29092,28670,1194,29864,332
2021-10-19,San Mateo,081,765935,53513,52617,816,53433,571
2021-10-19,Santa Barbara,083,443738,43811,43413,1507,44920,522
2021-10-19,Santa Clara,085,1922200,145168,143989,1243,145232,1898
2021-10-19,Santa Cruz,087,273765,20119,19895,981,20876,218
2021-10-19,Shasta,089,179085,20675,20209,3429,23638,319
2021-10-19,Sierra,091,2930,174,168,18,186,0
2021-10-19,Siskiyou,093,43540,3300,3216,1233,4449,46
2021-10-19,Solano,095,438530,45459,44782,1212,45994,341
2021-10-19,Sonoma,097,501317,40717,40379,507,40886,392
2021-10-19,Stanislaus,099,539301,76654,76526,8547,85073,1145
2021-10-19,Sutter,101,95872,13636,13569,313,13882,174
2021-10-19,Tehama,103,63373,8191,8057,1394,9451,108
2021-10-19,Trinity,105,12862,826,691,203,894,11
2021-10-19,Tulare,107,460477,66743,65253,14061,79314,958
2021-10-19,Tuolumne,109,53932,6908,6782,87,6869,89
2021-10-19,Ventura,111,848112,97185,96539,4216,100755,1166
2021-10-19,Yolo,113,214977,19478,19206,987,20193,248
2021-10-19,Yuba,115,75493,9914,9796,289,10085,82
2021-10-18,Alameda,001,1643700,117934,117506,2668,120174,1381
2021-10-18,Alpine,003,1148,101,103,0,103,0
2021-10-18,Amador,005,37829,5435,5345,56,5401,64
2021-10-18,Butte,007,227075,20323,19921,3658,23579,265
2021-10-18,Calaveras,009,45235,3876,3819,45,3864,80
2021-10-18,Colusa,011,21464,2484,2444,608,3052,18
2021-10-18,Contra Costa,013,1133247,98171,97585,2082,99667,995
2021-10-18,Del Norte,015,27424,3620,3529,51,3580,41
2021-10-18,El Dorado,017,186661,15733,15452,1648,17100,149
2021-10-18,Fresno,019,978130,135711,133688,12158,145846,2063
2021-10-18,Glenn,021,27897,3432,3370,985,4355,32
2021-10-18,Humboldt,023,135768,8784,8699,496,9195,104
2021-10-18,Imperial,025,180216,32864,32558,3064,35622,764
2021-10-18,Inyo,027,18085,2129,2020,37,2057,40
2021-10-18,Kern,029,883053,124097,122231,20538,142769,1605
2021-10-18,Kings,031,150075,31278,30698,1809,32507,320
2021-10-18,Lake,033,64148,6571,6455,133,6588,104
2021-10-18,Lassen,035,31185,6709,6607,332,6939,26
2021-10-18,Los Angeles,037,10098052,1425628,1413291,52748,1466039,26446
2021-10-18,Madera,039,155013,22328,21909,1942,23851,277
2021-10-18,Marin,041,260295,17347,17232,428,17660,244
2021-10-18,Mariposa,043,17540,1213,1160,41,1201,5
2021-10-18,Mendocino,045,87422,7296,7156,453,7609,82
2021-10-18,Merced,047,269075,40839,40573,1739,42312,579
2021-10-18,Modoc,049,8938,516,498,183,681,5
2021-10-18,Mono,051,14174,1665,1648,20,1668,3
2021-10-18,Monterey,053,433212,48301,47389,2739,50128,583
2021-10-18,Napa,055,140530,12828,12762,105,12867,100
2021-10-18,Nevada,057,99092,8917,8816,306,9122,90
2021-10-18,Orange,059,3164182,303786,301573,14543,316116,5524
2021-10-18,Placer,061,380077,36137,35598,3488,39086,420
2021-10-18,Plumas,063,18699,1668,1579,32,1611,6
2021-10-18,Riverside,065,2383286,358029,353699,16075,369774,5008
2021-10-18,Sacramento,067,1510023,155521,154428,4272,158700,2203
2021-10-18,San Benito,069,59416,7266,7253,160,7413,71
2021-10-18,San Bernardino,071,2135413,349084,346742,10843,357585,5606
2021-10-18,San Diego,073,3302833,367082,364948,21579,386527,4169
2021-10-18,San Francisco,075,870044,52196,51671,2224,53895,644
2021-10-18,San Joaquin,077,732212,97980,97041,5221,102262,1721
2021-10-18,San Luis Obispo,079,281455,29053,28644,1191,29835,331
2021-10-18,San Mateo,081,765935,53448,52594,815,53409,571
2021-10-18,Santa Barbara,083,443738,43752,43386,1505,44891,522
2021-10-18,Santa Clara,085,1922200,145013,143891,1235,145126,1895
2021-10-18,Santa Cruz,087,273765,20105,19876,979,20855,218
2021-10-18,Shasta,089,179085,20595,20146,3418,23564,313
2021-10-18,Sierra,091,2930,174,166,18,184,0
2021-10-18,Siskiyou,093,43540,3297,3210,1225,4435,42
2021-10-18,Solano,095,438530,45415,44758,1209,45967,339
2021-10-18,Sonoma,097,501317,40653,40349,504,40853,392
2021-10-18,Stanislaus,099,539301,76489,76466,8533,84999,1145
2021-10-18,Sutter,101,95872,13602,13557,311,13868,172
2021-10-18,Tehama,103,63373,8156,8042,1382,9424,107
2021-10-18,Trinity,105,12862,825,688,203,891,11
2021-10-18,Tulare,107,460477,66568,65171,13997,79168,958
2021-10-18,Tuolumne,109,53932,6879,6755,87,6842,89
2021-10-18,Ventura,111,848112,97090,96506,4213,100719,1165
2021-10-18,Yolo,113,214977,19441,19197,984,20181,248
2021-10-18,Yuba,115,75493,9887,9782,287,10069,82
2021-10-17,Alameda,001,1643700,117783,117423,2663,120086,1376
2021-10-17,Alpine,003,1148,101,103,0,103,0
2021-10-17,Amador,005,37829,5412,5341,56,5397,64
2021-10-17,Butte,007,227075,20239,19897,3648,23545,265
2021-10-17,Calaveras,009,45235,3860,3805,45,3850,80
2021-10-17,Colusa,011,21464,2479,2442,601,3043,18
2021-10-17,Contra Costa,013,1133247,98050,97485,2071,99556,995
2021-10-17,Del Norte,015,27424,3615,3526,51,3577,41
2021-10-17,El Dorado,017,186661,15675,15438,1641,17079,149
2021-10-17,Fresno,019,978130,135244,133429,12115,145544,2063
2021-10-17,Glenn,021,27897,3422,3364,980,4344,32
2021-10-17,Humboldt,023,135768,8764,8690,493,9183,104
2021-10-17,Imperial,025,180216,32782,32520,3057,35577,764
2021-10-17,Inyo,027,18085,2101,2000,37,2037,40
2021-10-17,Kern,029,883053,123747,122085,20440,142525,1603
2021-10-17,Kings,031,150075,31165,30636,1801,32437,315
2021-10-17,Lake,033,64148,6555,6437,133,6570,104
2021-10-17,Lassen,035,31185,6697,6605,328,6933,26
2021-10-17,Los Angeles,037,10098052,1424288,1412371,52673,1465044,26443
2021-10-17,Madera,039,155013,22266,21869,1931,23800,277
2021-10-17,Marin,041,260295,17325,17211,428,17639,243
2021-10-17,Mariposa,043,17540,1206,1150,41,1191,5
2021-10-17,Mendocino,045,87422,7267,7148,447,7595,82
2021-10-17,Merced,047,269075,40713,40531,1723,42254,579
2021-10-17,Modoc,049,8938,513,498,181,679,5
2021-10-17,Mono,051,14174,1663,1640,19,1659,3
2021-10-17,Monterey,053,433212,48260,47369,2729,50098,583
2021-10-17,Napa,055,140530,12813,12753,102,12855,100
2021-10-17,Nevada,057,99092,8900,8794,305,9099,90
2021-10-17,Orange,059,3164182,303471,301414,14510,315924,5524
2021-10-17,Placer,061,380077,36037,35559,3473,39032,420
2021-10-17,Plumas,063,18699,1644,1571,31,1602,6
2021-10-17,Riverside,065,2383286,357545,353500,16061,369561,5008
2021-10-17,Sacramento,067,1510023,155121,154080,4255,158335,2213
2021-10-17,San Benito,069,59416,7257,7250,159,7409,71
2021-10-17,San Bernardino,071,2135413,348649,346524,10823,357347,5597
2021-10-17,San Diego,073,3302833,366491,364675,21551,386226,4163
2021-10-17,San Francisco,075,870044,52124,51625,2215,53840,644
2021-10-17,San Joaquin,077,732212,97807,96950,5212,102162,1721
2021-10-17,San Luis Obispo,079,281455,29001,28604,1183,29787,331
2021-10-17,San Mateo,081,765935,53396,52541,811,53352,571
2021-10-17,Santa Barbara,083,443738,43689,43344,1504,44848,522
2021-10-17,Santa Clara,085,1922200,144836,143768,1226,144994,1895
2021-10-17,Santa Cruz,087,273765,20077,19861,977,20838,218
2021-10-17,Shasta,089,179085,20505,20116,3408,23524,312
2021-10-17,Sierra,091,2930,172,165,18,183,0
2021-10-17,Siskiyou,093,43540,3289,3204,1222,4426,42
2021-10-17,Solano,095,438530,45358,44722,1208,45930,340
2021-10-17,Sonoma,097,501317,40577,40306,503,40809,392
2021-10-17,Stanislaus,099,539301,76291,76354,8519,84873,1145
2021-10-17,Sutter,101,95872,13585,13543,309,13852,172
2021-10-17,Tehama,103,63373,8124,8015,1366,9381,107
2021-10-17,Trinity,105,12862,822,686,202,888,11
2021-10-17,Tulare,107,460477,66385,65057,13925,78982,958
2021-10-17,Tuolumne,109,53932,6845,6735,86,6821,89
2021-10-17,Ventura,111,848112,96990,96458,4210,100668,1165
2021-10-17,Yolo,113,214977,19399,19171,975,20146,248
2021-10-17,Yuba,115,75493,9861,9771,285,10056,82
2021-10-16,Alameda,001,1643700,117692,117027,2661,119688,1365
2021-10-16,Alpine,003,1148,100,102,0,102,0
2021-10-16,Amador,005,37829,5405,5310,56,5366,64
2021-10-16,Butte,007,227075,20208,19612,3639,23251,260
2021-10-16,Calaveras,009,45235,3853,3771,45,3816,80
2021-10-16,Colusa,011,21464,2475,2431,598,3029,18
2021-10-16,Contra Costa,013,1133247,97958,97107,2064,99171,982
2021-10-16,Del Norte,015,27424,3612,3516,51,3567,41
2021-10-16,El Dorado,017,186661,15654,15315,1639,16954,149
2021-10-16,Fresno,019,978130,135090,132433,12098,144531,2051
2021-10-16,Glenn,021,27897,3416,3331,980,4311,26
2021-10-16,Humboldt,023,135768,8753,8621,488,9109,104
2021-10-16,Imperial,025,180216,32767,32368,3055,35423,764
2021-10-16,Inyo,027,18085,2087,1932,37,1969,39
2021-10-16,Kern,029,883053,123591,121354,20359,141713,1590
2021-10-16,Kings,031,150075,31119,30418,1798,32216,314
2021-10-16,Lake,033,64148,6544,6378,133,6511,104
2021-10-16,Lassen,035,31185,6688,6559,324,6883,26
2021-10-16,Los Angeles,037,10098052,1423633,1409418,52619,1462037,26398
2021-10-16,Madera,039,155013,22222,21707,1927,23634,277
2021-10-16,Marin,041,260295,17315,17148,428,17576,243
2021-10-16,Mariposa,043,17540,1203,1096,41,1137,5
2021-10-16,Mendocino,045,87422,7256,7099,447,7546,82
2021-10-16,Merced,047,269075,40681,40265,1721,41986,577
2021-10-16,Modoc,049,8938,510,492,181,673,5
2021-10-16,Mono,051,14174,1659,1628,19,1647,3
2021-10-16,Monterey,053,433212,48243,47293,2721,50014,582
2021-10-16,Napa,055,140530,12802,12706,102,12808,100
2021-10-16,Nevada,057,99092,8880,8739,305,9044,90
2021-10-16,Orange,059,3164182,303295,300722,14485,315207,5509
2021-10-16,Placer,061,380077,35953,35343,3467,38810,412
2021-10-16,Plumas,063,18699,1639,1542,30,1572,6
2021-10-16,Riverside,065,2383286,357275,352435,16049,368484,4990
2021-10-16,Sacramento,067,1510023,154922,153264,4251,157515,2192
2021-10-16,San Benito,069,59416,7244,7210,158,7368,71
2021-10-16,San Bernardino,071,2135413,348441,345418,10815,356233,5566
2021-10-16,San Diego,073,3302833,366175,363109,21535,384644,4151
2021-10-16,San Francisco,075,870044,52077,51436,2211,53647,645
2021-10-16,San Joaquin,077,732212,97735,96507,5209,101716,1708
2021-10-16,San Luis Obispo,079,281455,28975,28460,1182,29642,329
2021-10-16,San Mateo,081,765935,53347,52399,810,53209,569
2021-10-16,Santa Barbara,083,443738,43653,43175,1503,44678,521
2021-10-16,Santa Clara,085,1922200,144736,143282,1218,144500,1890
2021-10-16,Santa Cruz,087,273765,20062,19794,976,20770,218
2021-10-16,Shasta,089,179085,20455,19932,3397,23329,309
2021-10-16,Sierra,091,2930,170,160,18,178,0
2021-10-16,Siskiyou,093,43540,3287,3173,1215,4388,42
2021-10-16,Solano,095,438530,45332,44585,1204,45789,334
2021-10-16,Sonoma,097,501317,40537,40195,503,40698,390
2021-10-16,Stanislaus,099,539301,76205,75868,8509,84377,1142
2021-10-16,Sutter,101,95872,13566,13471,308,13779,169
2021-10-16,Tehama,103,63373,8111,7907,1361,9268,104
2021-10-16,Trinity,105,12862,822,679,202,881,11
2021-10-16,Tulare,107,460477,66247,64489,13894,78383,951
2021-10-16,Tuolumne,109,53932,6813,6666,86,6752,89
2021-10-16,Ventura,111,848112,96958,96181,4205,100386,1164
2021-10-16,Yolo,113,214977,19372,19078,969,20047,247
2021-10-16,Yuba,115,75493,9837,9705,282,9987,82
2021-10-15,Alameda,001,1643700,117620,117027,2657,119684,1365
2021-10-15,Alpine,003,1148,100,102,0,102,0
2021-10-15,Amador,005,37829,5381,5310,56,5366,64
2021-10-15,Butte,007,227075,20172,19612,3632,23244,260
2021-10-15,Calaveras,009,45235,3847,3771,45,3816,80
2021-10-15,Colusa,011,21464,2473,2431,595,3026,18
2021-10-15,Contra Costa,013,1133247,97876,97107,2061,99168,982
2021-10-15,Del Norte,015,27424,3610,3516,51,3567,41
2021-10-15,El Dorado,017,186661,15634,15315,1634,16949,149
2021-10-15,Fresno,019,978130,134837,132433,12089,144522,2051
2021-10-15,Glenn,021,27897,3410,3331,979,4310,26
2021-10-15,Humboldt,023,135768,8744,8621,486,9107,104
2021-10-15,Imperial,025,180216,32720,32368,3051,35419,764
2021-10-15,Inyo,027,18085,2069,1932,37,1969,39
2021-10-15,Kern,029,883053,123455,121354,20285,141639,1590
2021-10-15,Kings,031,150075,31064,30418,1794,32212,314
2021-10-15,Lake,033,64148,6535,6378,133,6511,104
2021-10-15,Lassen,035,31185,6676,6559,323,6882,26
2021-10-15,Los Angeles,037,10098052,1422940,1409418,52571,1461989,26398
2021-10-15,Madera,039,155013,22178,21707,1919,23626,277
2021-10-15,Marin,041,260295,17304,17148,428,17576,243
2021-10-15,Mariposa,043,17540,1195,1096,41,1137,5
2021-10-15,Mendocino,045,87422,7241,7099,447,7546,82
2021-10-15,Merced,047,269075,40651,40265,1718,41983,577
2021-10-15,Modoc,049,8938,509,492,181,673,5
2021-10-15,Mono,051,14174,1656,1628,19,1647,3
2021-10-15,Monterey,053,433212,48221,47293,2719,50012,582
2021-10-15,Napa,055,140530,12798,12706,102,12808,100
2021-10-15,Nevada,057,99092,8865,8739,305,9044,90
2021-10-15,Orange,059,3164182,303126,300722,14467,315189,5509
2021-10-15,Placer,061,380077,35899,35343,3461,38804,412
2021-10-15,Plumas,063,18699,1631,1542,30,1572,6
2021-10-15,Riverside,065,2383286,357033,352435,16044,368479,4990
2021-10-15,Sacramento,067,1510023,154735,153264,4241,157505,2192
2021-10-15,San Benito,069,59416,7241,7210,158,7368,71
2021-10-15,San Bernardino,071,2135413,348209,345418,10812,356230,5566
2021-10-15,San Diego,073,3302833,365815,363109,21510,384619,4151
2021-10-15,San Francisco,075,870044,52036,51436,2204,53640,645
2021-10-15,San Joaquin,077,732212,97657,96507,5202,101709,1708
2021-10-15,San Luis Obispo,079,281455,28954,28460,1180,29640,329
2021-10-15,San Mateo,081,765935,53303,52399,809,53208,569
2021-10-15,Santa Barbara,083,443738,43615,43175,1503,44678,521
2021-10-15,Santa Clara,085,1922200,144614,143282,1210,144492,1890
2021-10-15,Santa Cruz,087,273765,20051,19794,976,20770,218
2021-10-15,Shasta,089,179085,20399,19932,3389,23321,309
2021-10-15,Sierra,091,2930,170,160,18,178,0
2021-10-15,Siskiyou,093,43540,3286,3173,1212,4385,42
2021-10-15,Solano,095,438530,45306,44585,1204,45789,334
2021-10-15,Sonoma,097,501317,40503,40195,502,40697,390
2021-10-15,Stanislaus,099,539301,76125,75868,8493,84361,1142
2021-10-15,Sutter,101,95872,13549,13471,306,13777,169
2021-10-15,Tehama,103,63373,8090,7907,1355,9262,104
2021-10-15,Trinity,105,12862,822,679,202,881,11
2021-10-15,Tulare,107,460477,66168,64489,13857,78346,951
2021-10-15,Tuolumne,109,53932,6790,6666,84,6750,89
2021-10-15,Ventura,111,848112,96916,96181,4202,100383,1164
2021-10-15,Yolo,113,214977,19357,19078,965,20043,247
2021-10-15,Yuba,115,75493,9827,9705,281,9986,82
2021-10-14,Alameda,001,1643700,117511,117027,2652,119679,1365
2021-10-14,Alpine,003,1148,100,102,0,102,0
2021-10-14,Amador,005,37829,5370,5310,56,5366,64
2021-10-14,Butte,007,227075,20120,19612,3626,23238,260
2021-10-14,Calaveras,009,45235,3834,3771,44,3815,80
2021-10-14,Colusa,011,21464,2471,2431,593,3024,18
2021-10-14,Contra Costa,013,1133247,97742,97107,2054,99161,982
2021-10-14,Del Norte,015,27424,3604,3516,51,3567,41
2021-10-14,El Dorado,017,186661,15596,15315,1631,16946,149
2021-10-14,Fresno,019,978130,134542,132433,12060,144493,2051
2021-10-14,Glenn,021,27897,3405,3331,978,4309,26
2021-10-14,Humboldt,023,135768,8727,8621,483,9104,104
2021-10-14,Imperial,025,180216,32657,32368,3044,35412,764
2021-10-14,Inyo,027,18085,2050,1932,37,1969,39
2021-10-14,Kern,029,883053,123183,121354,20186,141540,1590
2021-10-14,Kings,031,150075,30999,30418,1786,32204,314
2021-10-14,Lake,033,64148,6514,6378,132,6510,104
2021-10-14,Lassen,035,31185,6670,6559,322,6881,26
2021-10-14,Los Angeles,037,10098052,1421948,1409418,52521,1461939,26398
2021-10-14,Madera,039,155013,22113,21707,1913,23620,277
2021-10-14,Marin,041,260295,17299,17148,426,17574,243
2021-10-14,Mariposa,043,17540,1182,1096,40,1136,5
2021-10-14,Mendocino,045,87422,7227,7099,445,7544,82
2021-10-14,Merced,047,269075,40563,40265,1704,41969,577
2021-10-14,Modoc,049,8938,509,492,181,673,5
2021-10-14,Mono,051,14174,1649,1628,19,1647,3
2021-10-14,Monterey,053,433212,48195,47293,2714,50007,582
2021-10-14,Napa,055,140530,12783,12706,102,12808,100
2021-10-14,Nevada,057,99092,8838,8739,303,9042,90
2021-10-14,Orange,059,3164182,302918,300722,14450,315172,5509
2021-10-14,Placer,061,380077,35832,35343,3447,38790,412
2021-10-14,Plumas,063,18699,1616,1542,30,1572,6
2021-10-14,Riverside,065,2383286,356636,352435,16033,368468,4990
2021-10-14,Sacramento,067,1510023,154484,153264,4221,157485,2192
2021-10-14,San Benito,069,59416,7230,7210,158,7368,71
2021-10-14,San Bernardino,071,2135413,347851,345418,10805,356223,5566
2021-10-14,San Diego,073,3302833,365375,363109,21483,384592,4151
2021-10-14,San Francisco,075,870044,51980,51436,2200,53636,645
2021-10-14,San Joaquin,077,732212,97528,96507,5193,101700,1708
2021-10-14,San Luis Obispo,079,281455,28910,28460,1176,29636,329
2021-10-14,San Mateo,081,765935,53255,52399,808,53207,569
2021-10-14,Santa Barbara,083,443738,43559,43175,1498,44673,521
2021-10-14,Santa Clara,085,1922200,144473,143282,1204,144486,1890
2021-10-14,Santa Cruz,087,273765,20028,19794,976,20770,218
2021-10-14,Shasta,089,179085,20342,19932,3377,23309,309
2021-10-14,Sierra,091,2930,169,160,18,178,0
2021-10-14,Siskiyou,093,43540,3283,3173,1204,4377,42
2021-10-14,Solano,095,438530,45256,44585,1196,45781,334
2021-10-14,Sonoma,097,501317,40453,40195,499,40694,390
2021-10-14,Stanislaus,099,539301,75979,75868,8480,84348,1142
2021-10-14,Sutter,101,95872,13529,13471,305,13776,169
2021-10-14,Tehama,103,63373,8059,7907,1348,9255,104
2021-10-14,Trinity,105,12862,821,679,201,880,11
2021-10-14,Tulare,107,460477,65983,64489,13810,78299,951
2021-10-14,Tuolumne,109,53932,6758,6666,83,6749,89
2021-10-14,Ventura,111,848112,96848,96181,4196,100377,1164
2021-10-14,Yolo,113,214977,19324,19078,958,20036,247
2021-10-14,Yuba,115,75493,9813,9705,272,9977,82
2021-10-13,Alameda,001,1643700,117405,116914,2646,119560,1360
2021-10-13,Alpine,003,1148,100,102,0,102,0
2021-10-13,Amador,005,37829,5356,5305,56,5361,63
2021-10-13,Butte,007,227075,20045,19546,3621,23167,257
2021-10-13,Calaveras,009,45235,3813,3756,42,3798,79
2021-10-13,Colusa,011,21464,2464,2430,589,3019,18
2021-10-13,Contra Costa,013,1133247,97626,96975,2053,99028,969
2021-10-13,Del Norte,015,27424,3599,3512,51,3563,39
2021-10-13,El Dorado,017,186661,15572,15302,1626,16928,149
2021-10-13,Fresno,019,978130,134208,132055,12029,144084,2048
2021-10-13,Glenn,021,27897,3400,3327,974,4301,26
2021-10-13,Humboldt,023,135768,8716,8604,479,9083,102
2021-10-13,Imperial,025,180216,32597,32317,3042,35359,762
2021-10-13,Inyo,027,18085,2013,1907,37,1944,39
2021-10-13,Kern,029,883053,122939,120956,20094,141050,1586
2021-10-13,Kings,031,150075,30918,30246,1779,32025,312
2021-10-13,Lake,033,64148,6494,6371,132,6503,103
2021-10-13,Lassen,035,31185,6659,6535,316,6851,25
2021-10-13,Los Angeles,037,10098052,1420896,1408384,52465,1460849,26379
2021-10-13,Madera,039,155013,22060,21609,1899,23508,277
2021-10-13,Marin,041,260295,17275,17137,425,17562,243
2021-10-13,Mariposa,043,17540,1168,1090,40,1130,5
2021-10-13,Mendocino,045,87422,7211,7088,437,7525,82
2021-10-13,Merced,047,269075,40478,40164,1693,41857,577
2021-10-13,Modoc,049,8938,507,490,179,669,5
2021-10-13,Mono,051,14174,1649,1612,19,1631,3
2021-10-13,Monterey,053,433212,48176,47273,2707,49980,582
2021-10-13,Napa,055,140530,12772,12695,100,12795,100
2021-10-13,Nevada,057,99092,8816,8725,303,9028,90
2021-10-13,Orange,059,3164182,302710,300468,14434,314902,5503
2021-10-13,Placer,061,380077,35765,35254,3438,38692,412
2021-10-13,Plumas,063,18699,1602,1514,30,1544,6
2021-10-13,Riverside,065,2383286,356306,352044,16020,368064,4978
2021-10-13,Sacramento,067,1510023,154235,153141,4200,157341,2182
2021-10-13,San Benito,069,59416,7224,7196,157,7353,71
2021-10-13,San Bernardino,071,2135413,347526,344951,10788,355739,5562
2021-10-13,San Diego,073,3302833,364944,362564,21461,384025,4141
2021-10-13,San Francisco,075,870044,51937,51379,2196,53575,644
2021-10-13,San Joaquin,077,732212,97385,96343,5189,101532,1696
2021-10-13,San Luis Obispo,079,281455,28872,28397,1173,29570,330
2021-10-13,San Mateo,081,765935,53203,52352,804,53156,569
2021-10-13,Santa Barbara,083,443738,43507,43109,1498,44607,518
2021-10-13,Santa Clara,085,1922200,144335,143064,1203,144267,1886
2021-10-13,Santa Cruz,087,273765,20002,19763,975,20738,217
2021-10-13,Shasta,089,179085,20272,19802,3357,23159,307
2021-10-13,Sierra,091,2930,169,155,18,173,0
2021-10-13,Siskiyou,093,43540,3275,3173,1203,4376,42
2021-10-13,Solano,095,438530,45217,44558,1193,45751,334
2021-10-13,Sonoma,097,501317,40397,40122,499,40621,390
2021-10-13,Stanislaus,099,539301,75837,75698,8470,84168,1136
2021-10-13,Sutter,101,95872,13499,13458,303,13761,169
2021-10-13,Tehama,103,63373,8023,7849,1342,9191,103
2021-10-13,Trinity,105,12862,818,677,201,878,11
2021-10-13,Tulare,107,460477,65802,64297,13756,78053,945
2021-10-13,Tuolumne,109,53932,6744,6644,82,6726,89
2021-10-13,Ventura,111,848112,96774,96099,4190,100289,1162
2021-10-13,Yolo,113,214977,19296,19023,956,19979,247
2021-10-13,Yuba,115,75493,9788,9690,259,9949,80
2021-10-12,Alameda,001,1643700,117302,116813,2642,119455,1357
2021-10-12,Alpine,003,1148,100,102,0,102,0
2021-10-12,Amador,005,37829,5345,5301,56,5357,63
2021-10-12,Butte,007,227075,19973,19506,3610,23116,256
2021-10-12,Calaveras,009,45235,3798,3750,42,3792,75
2021-10-12,Colusa,011,21464,2461,2428,587,3015,18
2021-10-12,Contra Costa,013,1133247,97513,96894,2044,98938,960
2021-10-12,Del Norte,015,27424,3593,3511,51,3562,39
2021-10-12,El Dorado,017,186661,15538,15287,1624,16911,148
2021-10-12,Fresno,019,978130,133847,131848,11998,143846,2042
2021-10-12,Glenn,021,27897,3386,3321,973,4294,26
2021-10-12,Humboldt,023,135768,8689,8587,473,9060,102
2021-10-12,Imperial,025,180216,32545,32267,3040,35307,762
2021-10-12,Inyo,027,18085,1981,1889,37,1926,39
2021-10-12,Kern,029,883053,122652,120826,19985,140811,1580
2021-10-12,Kings,031,150075,30844,30200,1768,31968,312
2021-10-12,Lake,033,64148,6479,6372,130,6502,97
2021-10-12,Lassen,035,31185,6649,6526,315,6841,25
2021-10-12,Los Angeles,037,10098052,1419836,1407462,52419,1459881,26362
2021-10-12,Madera,039,155013,21989,21574,1886,23460,277
2021-10-12,Marin,041,260295,17252,17126,425,17551,242
2021-10-12,Mariposa,043,17540,1154,1088,40,1128,5
2021-10-12,Mendocino,045,87422,7182,7077,434,7511,82
2021-10-12,Merced,047,269075,40399,40113,1687,41800,567
2021-10-12,Modoc,049,8938,502,485,178,663,5
2021-10-12,Mono,051,14174,1647,1608,19,1627,3
2021-10-12,Monterey,053,433212,48145,47254,2699,49953,582
2021-10-12,Napa,055,140530,12758,12671,100,12771,97
2021-10-12,Nevada,057,99092,8804,8720,302,9022,89
2021-10-12,Orange,059,3164182,302455,300256,14408,314664,5499
2021-10-12,Placer,061,380077,35702,35214,3430,38644,404
2021-10-12,Plumas,063,18699,1588,1488,29,1517,6
2021-10-12,Riverside,065,2383286,355980,351771,16006,367777,4973
2021-10-12,Sacramento,067,1510023,153930,152935,4175,157110,2170
2021-10-12,San Benito,069,59416,7210,7193,157,7350,71
2021-10-12,San Bernardino,071,2135413,347215,344788,10778,355566,5563
2021-10-12,San Diego,073,3302833,364431,362256,21432,383688,4137
2021-10-12,San Francisco,075,870044,51873,51301,2195,53496,643
2021-10-12,San Joaquin,077,732212,97248,96237,5184,101421,1690
2021-10-12,San Luis Obispo,079,281455,28825,28379,1172,29551,327
2021-10-12,San Mateo,081,765935,53152,52328,803,53131,569
2021-10-12,Santa Barbara,083,443738,43446,43076,1498,44574,515
2021-10-12,Santa Clara,085,1922200,144182,142954,1201,144155,1882
2021-10-12,Santa Cruz,087,273765,19977,19757,975,20732,218
2021-10-12,Shasta,089,179085,20198,19731,3336,23067,304
2021-10-12,Sierra,091,2930,169,153,18,171,0
2021-10-12,Siskiyou,093,43540,3264,3166,1197,4363,42
2021-10-12,Solano,095,438530,45175,44516,1187,45703,329
2021-10-12,Sonoma,097,501317,40356,40105,498,40603,390
2021-10-12,Stanislaus,099,539301,75685,75589,8458,84047,1126
2021-10-12,Sutter,101,95872,13476,13436,299,13735,168
2021-10-12,Tehama,103,63373,7991,7820,1338,9158,103
2021-10-12,Trinity,105,12862,815,676,201,877,11
2021-10-12,Tulare,107,460477,65617,64216,13701,77917,944
2021-10-12,Tuolumne,109,53932,6727,6637,81,6718,89
2021-10-12,Ventura,111,848112,96673,96022,4185,100207,1160
2021-10-12,Yolo,113,214977,19269,18987,948,19935,247
2021-10-12,Yuba,115,75493,9773,9676,255,9931,70
2021-10-11,Alameda,001,1643700,117160,116759,2641,119400,1358
2021-10-11,Alpine,003,1148,100,102,0,102,0
2021-10-11,Amador,005,37829,5333,5286,56,5342,62
2021-10-11,Butte,007,227075,19914,19452,3605,23057,253
2021-10-11,Calaveras,009,45235,3777,3750,42,3792,75
2021-10-11,Colusa,011,21464,2457,2427,579,3006,18
2021-10-11,Contra Costa,013,1133247,97377,96832,2039,98871,960
2021-10-11,Del Norte,015,27424,3590,3510,47,3557,39
2021-10-11,El Dorado,017,186661,15509,15273,1620,16893,146
2021-10-11,Fresno,019,978130,133517,131703,11963,143666,2036
2021-10-11,Glenn,021,27897,3369,3308,971,4279,26
2021-10-11,Humboldt,023,135768,8664,8571,466,9037,101
2021-10-11,Imperial,025,180216,32495,32207,3034,35241,762
2021-10-11,Inyo,027,18085,1958,1862,36,1898,39
2021-10-11,Kern,029,883053,122416,120684,19890,140574,1575
2021-10-11,Kings,031,150075,30755,30180,1758,31938,309
2021-10-11,Lake,033,64148,6463,6361,126,6487,97
2021-10-11,Lassen,035,31185,6629,6499,312,6811,25
2021-10-11,Los Angeles,037,10098052,1418789,1406826,52368,1459194,26346
2021-10-11,Madera,039,155013,21931,21555,1869,23424,272
2021-10-11,Marin,041,260295,17234,17121,421,17542,242
2021-10-11,Mariposa,043,17540,1124,1083,39,1122,5
2021-10-11,Mendocino,045,87422,7166,7064,430,7494,82
2021-10-11,Merced,047,269075,40283,40064,1662,41726,566
2021-10-11,Modoc,049,8938,499,482,175,657,5
2021-10-11,Mono,051,14174,1637,1604,19,1623,3
2021-10-11,Monterey,053,433212,48116,47241,2692,49933,580
2021-10-11,Napa,055,140530,12735,12654,98,12752,96
2021-10-11,Nevada,057,99092,8784,8716,301,9017,90
2021-10-11,Orange,059,3164182,302226,299941,14378,314319,5499
2021-10-11,Placer,061,380077,35633,35173,3413,38586,404
2021-10-11,Plumas,063,18699,1570,1469,27,1496,6
2021-10-11,Riverside,065,2383286,355635,351444,16001,367445,4973
2021-10-11,Sacramento,067,1510023,153641,152681,4144,156825,2169
2021-10-11,San Benito,069,59416,7189,7184,155,7339,71
2021-10-11,San Bernardino,071,2135413,346832,344594,10770,355364,5549
2021-10-11,San Diego,073,3302833,363919,361712,21400,383112,4124
2021-10-11,San Francisco,075,870044,51802,51275,2192,53467,643
2021-10-11,San Joaquin,077,732212,97093,96152,5173,101325,1681
2021-10-11,San Luis Obispo,079,281455,28777,28355,1167,29522,327
2021-10-11,San Mateo,081,765935,53104,52298,803,53101,569
2021-10-11,Santa Barbara,083,443738,43399,43018,1497,44515,515
2021-10-11,Santa Clara,085,1922200,144021,142836,1197,144033,1882
2021-10-11,Santa Cruz,087,273765,19953,19745,974,20719,217
2021-10-11,Shasta,089,179085,20119,19662,3320,22982,295
2021-10-11,Sierra,091,2930,166,147,17,164,0
2021-10-11,Siskiyou,093,43540,3257,3159,1193,4352,42
2021-10-11,Solano,095,438530,45126,44474,1184,45658,329
2021-10-11,Sonoma,097,501317,40311,40067,498,40565,390
2021-10-11,Stanislaus,099,539301,75514,75478,8437,83915,1118
2021-10-11,Sutter,101,95872,13457,13427,297,13724,165
2021-10-11,Tehama,103,63373,7950,7795,1329,9124,102
2021-10-11,Trinity,105,12862,809,675,200,875,11
2021-10-11,Tulare,107,460477,65438,64094,13635,77729,942
2021-10-11,Tuolumne,109,53932,6689,6602,81,6683,89
2021-10-11,Ventura,111,848112,96576,95876,4178,100054,1160
2021-10-11,Yolo,113,214977,19222,18977,945,19922,247
2021-10-11,Yuba,115,75493,9756,9657,243,9900,69
2021-10-10,Alameda,001,1643700,117041,116679,2637,119316,1358
2021-10-10,Alpine,003,1148,100,102,0,102,0
2021-10-10,Amador,005,37829,5319,5278,56,5334,62
2021-10-10,Butte,007,227075,19849,19430,3589,23019,253
2021-10-10,Calaveras,009,45235,3765,3747,42,3789,75
2021-10-10,Colusa,011,21464,2456,2425,578,3003,18
2021-10-10,Contra Costa,013,1133247,97278,96760,2033,98793,960
2021-10-10,Del Norte,015,27424,3586,3507,47,3554,39
2021-10-10,El Dorado,017,186661,15479,15250,1614,16864,146
2021-10-10,Fresno,019,978130,133187,131434,11932,143366,2035
2021-10-10,Glenn,021,27897,3364,3297,969,4266,26
2021-10-10,Humboldt,023,135768,8643,8554,462,9016,101
2021-10-10,Imperial,025,180216,32420,32167,3033,35200,762
2021-10-10,Inyo,027,18085,1937,1857,36,1893,39
2021-10-10,Kern,029,883053,122090,120552,19787,140339,1573
2021-10-10,Kings,031,150075,30666,30122,1748,31870,308
2021-10-10,Lake,033,64148,6447,6349,125,6474,97
2021-10-10,Lassen,035,31185,6609,6495,311,6806,26
2021-10-10,Los Angeles,037,10098052,1417600,1406034,52294,1458328,26338
2021-10-10,Madera,039,155013,21885,21486,1860,23346,272
2021-10-10,Marin,041,260295,17217,17112,421,17533,242
2021-10-10,Mariposa,043,17540,1121,1074,39,1113,5
2021-10-10,Mendocino,045,87422,7151,7060,422,7482,81
2021-10-10,Merced,047,269075,40200,40036,1643,41679,566
2021-10-10,Modoc,049,8938,499,482,175,657,5
2021-10-10,Mono,051,14174,1636,1596,19,1615,3
2021-10-10,Monterey,053,433212,48086,47228,2691,49919,580
2021-10-10,Napa,055,140530,12712,12641,98,12739,96
2021-10-10,Nevada,057,99092,8772,8689,301,8990,90
2021-10-10,Orange,059,3164182,301964,299787,14350,314137,5499
2021-10-10,Placer,061,380077,35540,35128,3401,38529,404
2021-10-10,Plumas,063,18699,1554,1468,25,1493,6
2021-10-10,Riverside,065,2383286,355261,351248,15983,367231,4973
2021-10-10,Sacramento,067,1510023,153376,152405,4127,156532,2178
2021-10-10,San Benito,069,59416,7184,7180,154,7334,71
2021-10-10,San Bernardino,071,2135413,346518,344423,10762,355185,5551
2021-10-10,San Diego,073,3302833,363403,361038,21353,382391,4113
2021-10-10,San Francisco,075,870044,51755,51216,2190,53406,643
2021-10-10,San Joaquin,077,732212,96922,96084,5159,101243,1681
2021-10-10,San Luis Obispo,079,281455,28733,28343,1167,29510,326
2021-10-10,San Mateo,081,765935,53062,52273,802,53075,569
2021-10-10,Santa Barbara,083,443738,43352,42987,1496,44483,515
2021-10-10,Santa Clara,085,1922200,143856,142768,1190,143958,1881
2021-10-10,Santa Cruz,087,273765,19933,19727,974,20701,217
2021-10-10,Shasta,089,179085,20031,19635,3311,22946,296
2021-10-10,Sierra,091,2930,164,147,17,164,0
2021-10-10,Siskiyou,093,43540,3243,3155,1186,4341,42
2021-10-10,Solano,095,438530,45070,44431,1184,45615,329
2021-10-10,Sonoma,097,501317,40259,40027,498,40525,390
2021-10-10,Stanislaus,099,539301,75336,75403,8423,83826,1118
2021-10-10,Sutter,101,95872,13433,13412,292,13704,165
2021-10-10,Tehama,103,63373,7912,7764,1320,9084,102
2021-10-10,Trinity,105,12862,808,669,199,868,11
2021-10-10,Tulare,107,460477,65267,63930,13586,77516,940
2021-10-10,Tuolumne,109,53932,6665,6580,80,6660,89
2021-10-10,Ventura,111,848112,96487,95829,4178,100007,1160
2021-10-10,Yolo,113,214977,19190,18952,940,19892,247
2021-10-10,Yuba,115,75493,9740,9641,238,9879,69
2021-10-09,Alameda,001,1643700,116943,116253,2635,118888,1356
2021-10-09,Alpine,003,1148,99,102,0,102,0
2021-10-09,Amador,005,37829,5317,5237,55,5292,62
2021-10-09,Butte,007,227075,19818,19277,3585,22862,250
2021-10-09,Calaveras,009,45235,3761,3716,42,3758,75
2021-10-09,Colusa,011,21464,2452,2419,577,2996,18
2021-10-09,Contra Costa,013,1133247,97209,96378,2027,98405,958
2021-10-09,Del Norte,015,27424,3585,3495,47,3542,39
2021-10-09,El Dorado,017,186661,15461,15153,1611,16764,144
2021-10-09,Fresno,019,978130,133055,130508,11914,142422,2018
2021-10-09,Glenn,021,27897,3360,3277,967,4244,26
2021-10-09,Humboldt,023,135768,8629,8448,460,8908,97
2021-10-09,Imperial,025,180216,32386,31989,3031,35020,760
2021-10-09,Inyo,027,18085,1928,1808,36,1844,39
2021-10-09,Kern,029,883053,121949,119795,19760,139555,1559
2021-10-09,Kings,031,150075,30617,29894,1746,31640,308
2021-10-09,Lake,033,64148,6428,6283,124,6407,97
2021-10-09,Lassen,035,31185,6604,6442,310,6752,25
2021-10-09,Los Angeles,037,10098052,1417012,1402810,52257,1455067,26280
2021-10-09,Madera,039,155013,21852,21313,1846,23159,271
2021-10-09,Marin,041,260295,17212,17049,419,17468,242
2021-10-09,Mariposa,043,17540,1114,1042,38,1080,5
2021-10-09,Mendocino,045,87422,7144,7011,421,7432,82
2021-10-09,Merced,047,269075,40157,39784,1643,41427,565
2021-10-09,Modoc,049,8938,497,477,174,651,5
2021-10-09,Mono,051,14174,1633,1577,19,1596,3
2021-10-09,Monterey,053,433212,48074,47168,2688,49856,577
2021-10-09,Napa,055,140530,12708,12586,98,12684,96
2021-10-09,Nevada,057,99092,8761,8613,300,8913,90
2021-10-09,Orange,059,3164182,301783,299089,14331,313420,5457
2021-10-09,Placer,061,380077,35502,34877,3394,38271,393
2021-10-09,Plumas,063,18699,1543,1418,25,1443,6
2021-10-09,Riverside,065,2383286,355009,350082,15967,366049,4965
2021-10-09,Sacramento,067,1510023,153166,151566,4114,155680,2160
2021-10-09,San Benito,069,59416,7176,7123,154,7277,71
2021-10-09,San Bernardino,071,2135413,346332,343452,10758,354210,5556
2021-10-09,San Diego,073,3302833,363097,359909,21348,381257,4111
2021-10-09,San Francisco,075,870044,51707,50960,2183,53143,643
2021-10-09,San Joaquin,077,732212,96856,95606,5154,100760,1669
2021-10-09,San Luis Obispo,079,281455,28716,28197,1165,29362,324
2021-10-09,San Mateo,081,765935,53031,52121,801,52922,569
2021-10-09,Santa Barbara,083,443738,43325,42735,1496,44231,514
2021-10-09,Santa Clara,085,1922200,143732,142298,1184,143482,1873
2021-10-09,Santa Cruz,087,273765,19923,19635,973,20608,217
2021-10-09,Shasta,089,179085,19980,19437,3306,22743,290
2021-10-09,Sierra,091,2930,161,141,17,158,0
2021-10-09,Siskiyou,093,43540,3242,3124,1185,4309,42
2021-10-09,Solano,095,438530,45053,44265,1183,45448,329
2021-10-09,Sonoma,097,501317,40215,39848,498,40346,387
2021-10-09,Stanislaus,099,539301,75246,74899,8412,83311,1114
2021-10-09,Sutter,101,95872,13424,13314,290,13604,165
2021-10-09,Tehama,103,63373,7901,7670,1315,8985,99
2021-10-09,Trinity,105,12862,807,660,199,859,11
2021-10-09,Tulare,107,460477,65159,63398,13565,76963,932
2021-10-09,Tuolumne,109,53932,6646,6521,80,6601,89
2021-10-09,Ventura,111,848112,96433,95542,4175,99717,1158
2021-10-09,Yolo,113,214977,19168,18850,938,19788,247
2021-10-09,Yuba,115,75493,9728,9551,237,9788,69
2021-10-08,Alameda,001,1643700,116862,116253,2631,118884,1356
2021-10-08,Alpine,003,1148,99,102,0,102,0
2021-10-08,Amador,005,37829,5304,5237,55,5292,62
2021-10-08,Butte,007,227075,19789,19277,3581,22858,250
2021-10-08,Calaveras,009,45235,3756,3716,42,3758,75
2021-10-08,Colusa,011,21464,2450,2419,577,2996,18
2021-10-08,Contra Costa,013,1133247,97165,96378,2022,98400,958
2021-10-08,Del Norte,015,27424,3584,3495,47,3542,39
2021-10-08,El Dorado,017,186661,15441,15153,1607,16760,144
2021-10-08,Fresno,019,978130,132859,130508,11893,142401,2018
2021-10-08,Glenn,021,27897,3352,3277,965,4242,26
2021-10-08,Humboldt,023,135768,8618,8448,457,8905,97
2021-10-08,Imperial,025,180216,32357,31989,3027,35016,760
2021-10-08,Inyo,027,18085,1910,1808,36,1844,39
2021-10-08,Kern,029,883053,121812,119795,19718,139513,1559
2021-10-08,Kings,031,150075,30523,29894,1745,31639,308
2021-10-08,Lake,033,64148,6420,6283,124,6407,97
2021-10-08,Lassen,035,31185,6590,6442,307,6749,25
2021-10-08,Los Angeles,037,10098052,1416352,1402810,52223,1455033,26280
2021-10-08,Madera,039,155013,21793,21313,1839,23152,271
2021-10-08,Marin,041,260295,17201,17049,418,17467,242
2021-10-08,Mariposa,043,17540,1107,1042,36,1078,5
2021-10-08,Mendocino,045,87422,7131,7011,421,7432,82
2021-10-08,Merced,047,269075,40125,39784,1640,41424,565
2021-10-08,Modoc,049,8938,495,477,174,651,5
2021-10-08,Mono,051,14174,1630,1577,19,1596,3
2021-10-08,Monterey,053,433212,48047,47168,2686,49854,577
2021-10-08,Napa,055,140530,12692,12586,98,12684,96
2021-10-08,Nevada,057,99092,8749,8613,300,8913,90
2021-10-08,Orange,059,3164182,301636,299089,14311,313400,5457
2021-10-08,Placer,061,380077,35464,34877,3387,38264,393
2021-10-08,Plumas,063,18699,1531,1418,25,1443,6
2021-10-08,Riverside,065,2383286,354740,350082,15956,366038,4965
2021-10-08,Sacramento,067,1510023,153001,151566,4100,155666,2160
2021-10-08,San Benito,069,59416,7172,7123,152,7275,71
2021-10-08,San Bernardino,071,2135413,346123,343452,10750,354202,5556
2021-10-08,San Diego,073,3302833,362771,359909,21329,381238,4111
2021-10-08,San Francisco,075,870044,51660,50960,2176,53136,643
2021-10-08,San Joaquin,077,732212,96788,95606,5148,100754,1669
2021-10-08,San Luis Obispo,079,281455,28689,28197,1164,29361,324
2021-10-08,San Mateo,081,765935,53003,52121,801,52922,569
2021-10-08,Santa Barbara,083,443738,43290,42735,1495,44230,514
2021-10-08,Santa Clara,085,1922200,143619,142298,1179,143477,1873
2021-10-08,Santa Cruz,087,273765,19908,19635,973,20608,217
2021-10-08,Shasta,089,179085,19938,19437,3300,22737,290
2021-10-08,Sierra,091,2930,159,141,15,156,0
2021-10-08,Siskiyou,093,43540,3234,3124,1184,4308,42
2021-10-08,Solano,095,438530,45014,44265,1183,45448,329
2021-10-08,Sonoma,097,501317,40179,39848,498,40346,387
2021-10-08,Stanislaus,099,539301,75177,74899,8403,83302,1114
2021-10-08,Sutter,101,95872,13410,13314,288,13602,165
2021-10-08,Tehama,103,63373,7884,7670,1313,8983,99
2021-10-08,Trinity,105,12862,806,660,199,859,11
2021-10-08,Tulare,107,460477,65041,63398,13533,76931,932
2021-10-08,Tuolumne,109,53932,6623,6521,80,6601,89
2021-10-08,Ventura,111,848112,96382,95542,4169,99711,1158
2021-10-08,Yolo,113,214977,19155,18850,934,19784,247
2021-10-08,Yuba,115,75493,9708,9551,236,9787,69
2021-10-07,Alameda,001,1643700,116742,116253,2630,118883,1356
2021-10-07,Alpine,003,1148,99,102,0,102,0
2021-10-07,Amador,005,37829,5297,5237,55,5292,62
2021-10-07,Butte,007,227075,19740,19277,3570,22847,250
2021-10-07,Calaveras,009,45235,3744,3716,42,3758,75
2021-10-07,Colusa,011,21464,2447,2419,571,2990,18
2021-10-07,Contra Costa,013,1133247,97042,96378,2019,98397,958
2021-10-07,Del Norte,015,27424,3581,3495,47,3542,39
2021-10-07,El Dorado,017,186661,15404,15153,1603,16756,144
2021-10-07,Fresno,019,978130,132585,130508,11869,142377,2018
2021-10-07,Glenn,021,27897,3345,3277,962,4239,26
2021-10-07,Humboldt,023,135768,8592,8448,454,8902,97
2021-10-07,Imperial,025,180216,32286,31989,3014,35003,760
2021-10-07,Inyo,027,18085,1891,1808,36,1844,39
2021-10-07,Kern,029,883053,121581,119795,19653,139448,1559
2021-10-07,Kings,031,150075,30458,29894,1739,31633,308
2021-10-07,Lake,033,64148,6409,6283,124,6407,97
2021-10-07,Lassen,035,31185,6572,6442,305,6747,25
2021-10-07,Los Angeles,037,10098052,1415396,1402810,52178,1454988,26280
2021-10-07,Madera,039,155013,21720,21313,1825,23138,271
2021-10-07,Marin,041,260295,17183,17049,418,17467,242
2021-10-07,Mariposa,043,17540,1099,1042,36,1078,5
2021-10-07,Mendocino,045,87422,7121,7011,417,7428,82
2021-10-07,Merced,047,269075,40058,39784,1623,41407,565
2021-10-07,Modoc,049,8938,492,477,173,650,5
2021-10-07,Mono,051,14174,1622,1577,19,1596,3
2021-10-07,Monterey,053,433212,48022,47168,2677,49845,577
2021-10-07,Napa,055,140530,12677,12586,98,12684,96
2021-10-07,Nevada,057,99092,8721,8613,300,8913,90
2021-10-07,Orange,059,3164182,301410,299089,14297,313386,5457
2021-10-07,Placer,061,380077,35402,34877,3380,38257,393
2021-10-07,Plumas,063,18699,1514,1418,25,1443,6
2021-10-07,Riverside,065,2383286,354408,350082,15944,366026,4965
2021-10-07,Sacramento,067,1510023,152719,151566,4073,155639,2160
2021-10-07,San Benito,069,59416,7156,7123,150,7273,71
2021-10-07,San Bernardino,071,2135413,345849,343452,10742,354194,5556
2021-10-07,San Diego,073,3302833,362376,359909,21308,381217,4111
2021-10-07,San Francisco,075,870044,51589,50960,2173,53133,643
2021-10-07,San Joaquin,077,732212,96634,95606,5140,100746,1669
2021-10-07,San Luis Obispo,079,281455,28638,28197,1162,29359,324
2021-10-07,San Mateo,081,765935,52963,52121,800,52921,569
2021-10-07,Santa Barbara,083,443738,43222,42735,1489,44224,514
2021-10-07,Santa Clara,085,1922200,143470,142298,1173,143471,1873
2021-10-07,Santa Cruz,087,273765,19888,19635,972,20607,217
2021-10-07,Shasta,089,179085,19849,19437,3285,22722,290
2021-10-07,Sierra,091,2930,158,141,15,156,0
2021-10-07,Siskiyou,093,43540,3230,3124,1179,4303,42
2021-10-07,Solano,095,438530,44969,44265,1179,45444,329
2021-10-07,Sonoma,097,501317,40142,39848,496,40344,387
2021-10-07,Stanislaus,099,539301,75015,74899,8378,83277,1114
2021-10-07,Sutter,101,95872,13388,13314,285,13599,165
2021-10-07,Tehama,103,63373,7851,7670,1307,8977,99
2021-10-07,Trinity,105,12862,804,660,199,859,11
2021-10-07,Tulare,107,460477,64874,63398,13497,76895,932
2021-10-07,Tuolumne,109,53932,6601,6521,80,6601,89
2021-10-07,Ventura,111,848112,96309,95542,4166,99708,1158
2021-10-07,Yolo,113,214977,19122,18850,930,19780,247
2021-10-07,Yuba,115,75493,9682,9551,229,9780,69
2021-10-06,Alameda,001,1643700,116605,116058,2624,118682,1353
2021-10-06,Alpine,003,1148,99,102,0,102,0
2021-10-06,Amador,005,37829,5294,5205,55,5260,62
2021-10-06,Butte,007,227075,19678,19208,3563,22771,247
2021-10-06,Calaveras,009,45235,3735,3669,42,3711,75
2021-10-06,Colusa,011,21464,2445,2414,564,2978,18
2021-10-06,Contra Costa,013,1133247,96917,96184,2015,98199,953
2021-10-06,Del Norte,015,27424,3578,3490,44,3534,39
2021-10-06,El Dorado,017,186661,15378,15078,1600,16678,140
2021-10-06,Fresno,019,978130,132295,130074,11844,141918,2008
2021-10-06,Glenn,021,27897,3336,3270,960,4230,26
2021-10-06,Humboldt,023,135768,8577,8416,448,8864,94
2021-10-06,Imperial,025,180216,32233,31930,3004,34934,760
2021-10-06,Inyo,027,18085,1876,1806,36,1842,39
2021-10-06,Kern,029,883053,121324,119491,19562,139053,1552
2021-10-06,Kings,031,150075,30392,29785,1731,31516,308
2021-10-06,Lake,033,64148,6395,6271,124,6395,97
2021-10-06,Lassen,035,31185,6556,6429,304,6733,25
2021-10-06,Los Angeles,037,10098052,1414440,1401675,52129,1453804,26252
2021-10-06,Madera,039,155013,21665,21230,1815,23045,269
2021-10-06,Marin,041,260295,17174,17042,415,17457,242
2021-10-06,Mariposa,043,17540,1092,1036,36,1072,5
2021-10-06,Mendocino,045,87422,7112,6986,415,7401,81
2021-10-06,Merced,047,269075,39983,39666,1611,41277,563
2021-10-06,Modoc,049,8938,492,477,171,648,5
2021-10-06,Mono,051,14174,1610,1568,19,1587,3
2021-10-06,Monterey,053,433212,47989,47136,2672,49808,577
2021-10-06,Napa,055,140530,12653,12552,97,12649,96
2021-10-06,Nevada,057,99092,8705,8582,299,8881,90
2021-10-06,Orange,059,3164182,301172,298785,14285,313070,5448
2021-10-06,Placer,061,380077,35351,34764,3374,38138,390
2021-10-06,Plumas,063,18699,1491,1383,25,1408,6
2021-10-06,Riverside,065,2383286,354052,349645,15923,365568,4953
2021-10-06,Sacramento,067,1510023,152466,151164,4042,155206,2141
2021-10-06,San Benito,069,59416,7141,7108,150,7258,69
2021-10-06,San Bernardino,071,2135413,345558,343022,10735,353757,5551
2021-10-06,San Diego,073,3302833,361884,359564,21282,380846,4104
2021-10-06,San Francisco,075,870044,51526,50894,2170,53064,641
2021-10-06,San Joaquin,077,732212,96500,95418,5128,100546,1658
2021-10-06,San Luis Obispo,079,281455,28589,28170,1156,29326,323
2021-10-06,San Mateo,081,765935,52913,52056,795,52851,569
2021-10-06,Santa Barbara,083,443738,43139,42687,1487,44174,513
2021-10-06,Santa Clara,085,1922200,143319,142124,1168,143292,1872
2021-10-06,Santa Cruz,087,273765,19859,19604,970,20574,217
2021-10-06,Shasta,089,179085,19774,19325,3272,22597,287
2021-10-06,Sierra,091,2930,156,138,15,153,0
2021-10-06,Siskiyou,093,43540,3220,3116,1172,4288,42
2021-10-06,Solano,095,438530,44935,44185,1178,45363,328
2021-10-06,Sonoma,097,501317,40092,39787,495,40282,383
2021-10-06,Stanislaus,099,539301,74873,74699,8365,83064,1114
2021-10-06,Sutter,101,95872,13367,13284,283,13567,164
2021-10-06,Tehama,103,63373,7815,7629,1299,8928,99
2021-10-06,Trinity,105,12862,801,656,199,855,11
2021-10-06,Tulare,107,460477,64695,63198,13441,76639,926
2021-10-06,Tuolumne,109,53932,6576,6486,80,6566,89
2021-10-06,Ventura,111,848112,96218,95449,4158,99607,1158
2021-10-06,Yolo,113,214977,19090,18815,926,19741,247
2021-10-06,Yuba,115,75493,9658,9520,228,9748,69
2021-10-05,Alameda,001,1643700,116461,115968,2619,118587,1350
2021-10-05,Alpine,003,1148,99,102,0,102,0
2021-10-05,Amador,005,37829,5273,5194,54,5248,61
2021-10-05,Butte,007,227075,19629,19137,3548,22685,246
2021-10-05,Calaveras,009,45235,3719,3657,42,3699,73
2021-10-05,Colusa,011,21464,2438,2414,563,2977,18
2021-10-05,Contra Costa,013,1133247,96800,96108,2010,98118,941
2021-10-05,Del Norte,015,27424,3576,3485,43,3528,39
2021-10-05,El Dorado,017,186661,15339,15052,1597,16649,140
2021-10-05,Fresno,019,978130,131956,129957,11808,141765,1987
2021-10-05,Glenn,021,27897,3325,3270,955,4225,26
2021-10-05,Humboldt,023,135768,8546,8398,444,8842,94
2021-10-05,Imperial,025,180216,32186,31909,2999,34908,759
2021-10-05,Inyo,027,18085,1859,1800,36,1836,39
2021-10-05,Kern,029,883053,121059,119260,19462,138722,1540
2021-10-05,Kings,031,150075,30317,29749,1726,31475,301
2021-10-05,Lake,033,64148,6374,6264,123,6387,97
2021-10-05,Lassen,035,31185,6537,6417,302,6719,25
2021-10-05,Los Angeles,037,10098052,1413297,1400300,52075,1452375,26223
2021-10-05,Madera,039,155013,21607,21183,1803,22986,269
2021-10-05,Marin,041,260295,17162,17024,415,17439,242
2021-10-05,Mariposa,043,17540,1073,1033,33,1066,5
2021-10-05,Mendocino,045,87422,7096,6972,408,7380,79
2021-10-05,Merced,047,269075,39917,39608,1603,41211,562
2021-10-05,Modoc,049,8938,488,475,170,645,5
2021-10-05,Mono,051,14174,1602,1565,19,1584,3
2021-10-05,Monterey,053,433212,47972,47087,2662,49749,573
2021-10-05,Napa,055,140530,12629,12533,97,12630,96
2021-10-05,Nevada,057,99092,8675,8576,299,8875,90
2021-10-05,Orange,059,3164182,300895,298589,14253,312842,5441
2021-10-05,Placer,061,380077,35271,34728,3367,38095,382
2021-10-05,Plumas,063,18699,1466,1357,25,1382,6
2021-10-05,Riverside,065,2383286,353692,349365,15908,365273,4942
2021-10-05,Sacramento,067,1510023,152191,151111,4014,155125,2126
2021-10-05,San Benito,069,59416,7123,7103,148,7251,69
2021-10-05,San Bernardino,071,2135413,345231,342711,10728,353439,5557
2021-10-05,San Diego,073,3302833,361309,359194,21255,380449,4092
2021-10-05,San Francisco,075,870044,51429,50826,2167,52993,641
2021-10-05,San Joaquin,077,732212,96347,95276,5102,100378,1651
2021-10-05,San Luis Obispo,079,281455,28545,28113,1154,29267,324
2021-10-05,San Mateo,081,765935,52866,52008,795,52803,569
2021-10-05,Santa Barbara,083,443738,43061,42595,1483,44078,511
2021-10-05,Santa Clara,085,1922200,143159,141971,1161,143132,1873
2021-10-05,Santa Cruz,087,273765,19817,19582,970,20552,216
2021-10-05,Shasta,089,179085,19700,19285,3259,22544,286
2021-10-05,Sierra,091,2930,152,136,15,151,0
2021-10-05,Siskiyou,093,43540,3206,3107,1172,4279,42
2021-10-05,Solano,095,438530,44864,44149,1177,45326,325
2021-10-05,Sonoma,097,501317,40037,39756,490,40246,383
2021-10-05,Stanislaus,099,539301,74711,74599,8348,82947,1114
2021-10-05,Sutter,101,95872,13339,13270,282,13552,164
2021-10-05,Tehama,103,63373,7786,7607,1290,8897,98
2021-10-05,Trinity,105,12862,798,655,199,854,11
2021-10-05,Tulare,107,460477,64488,63093,13388,76481,920
2021-10-05,Tuolumne,109,53932,6561,6473,79,6552,89
2021-10-05,Ventura,111,848112,96112,95351,4157,99508,1155
2021-10-05,Yolo,113,214977,19054,18782,920,19702,245
2021-10-05,Yuba,115,75493,9626,9504,225,9729,69
2021-10-04,Alameda,001,1643700,116299,115845,2616,118461,1347
2021-10-04,Alpine,003,1148,99,102,0,102,0
2021-10-04,Amador,005,37829,5263,5163,53,5216,61
2021-10-04,Butte,007,227075,19551,19081,3537,22618,245
2021-10-04,Calaveras,009,45235,3710,3641,42,3683,73
2021-10-04,Colusa,011,21464,2437,2414,561,2975,18
2021-10-04,Contra Costa,013,1133247,96659,95958,2005,97963,937
2021-10-04,Del Norte,015,27424,3574,3485,39,3524,39
2021-10-04,El Dorado,017,186661,15293,15031,1590,16621,138
2021-10-04,Fresno,019,978130,131646,129665,11778,141443,1978
2021-10-04,Glenn,021,27897,3318,3270,952,4222,26
2021-10-04,Humboldt,023,135768,8514,8355,437,8792,94
2021-10-04,Imperial,025,180216,32137,31866,2992,34858,757
2021-10-04,Inyo,027,18085,1847,1792,34,1826,39
2021-10-04,Kern,029,883053,120768,118984,19342,138326,1531
2021-10-04,Kings,031,150075,30224,29702,1723,31425,303
2021-10-04,Lake,033,64148,6361,6248,123,6371,97
2021-10-04,Lassen,035,31185,6520,6405,302,6707,25
2021-10-04,Los Angeles,037,10098052,1412178,1399604,52018,1451622,26186
2021-10-04,Madera,039,155013,21543,21126,1791,22917,266
2021-10-04,Marin,041,260295,17146,17008,414,17422,242
2021-10-04,Mariposa,043,17540,1061,1024,33,1057,5
2021-10-04,Mendocino,045,87422,7078,6947,405,7352,79
2021-10-04,Merced,047,269075,39801,39565,1587,41152,558
2021-10-04,Modoc,049,8938,485,473,170,643,5
2021-10-04,Mono,051,14174,1594,1561,19,1580,3
2021-10-04,Monterey,053,433212,47951,47058,2655,49713,571
2021-10-04,Napa,055,140530,12605,12506,97,12603,96
2021-10-04,Nevada,057,99092,8655,8563,299,8862,90
2021-10-04,Orange,059,3164182,300599,298165,14221,312386,5438
2021-10-04,Placer,061,380077,35189,34630,3340,37970,379
2021-10-04,Plumas,063,18699,1444,1329,25,1354,6
2021-10-04,Riverside,065,2383286,353312,348828,15898,364726,4923
2021-10-04,Sacramento,067,1510023,151868,150887,3987,154874,2115
2021-10-04,San Benito,069,59416,7110,7099,148,7247,69
2021-10-04,San Bernardino,071,2135413,344871,342418,10716,353134,5551
2021-10-04,San Diego,073,3302833,360743,358525,21224,379749,4090
2021-10-04,San Francisco,075,870044,51334,50798,2163,52961,638
2021-10-04,San Joaquin,077,732212,96150,95198,5082,100280,1649
2021-10-04,San Luis Obispo,079,281455,28500,28090,1148,29238,323
2021-10-04,San Mateo,081,765935,52806,51958,794,52752,569
2021-10-04,Santa Barbara,083,443738,42976,42585,1482,44067,511
2021-10-04,Santa Clara,085,1922200,143014,141840,1155,142995,1869
2021-10-04,Santa Cruz,087,273765,19788,19559,969,20528,216
2021-10-04,Shasta,089,179085,19593,19170,3245,22415,279
2021-10-04,Sierra,091,2930,145,136,14,150,0
2021-10-04,Siskiyou,093,43540,3197,3103,1157,4260,42
2021-10-04,Solano,095,438530,44805,44092,1173,45265,322
2021-10-04,Sonoma,097,501317,39971,39720,490,40210,381
2021-10-04,Stanislaus,099,539301,74560,74444,8329,82773,1106
2021-10-04,Sutter,101,95872,13310,13261,281,13542,164
2021-10-04,Tehama,103,63373,7745,7585,1284,8869,95
2021-10-04,Trinity,105,12862,797,649,198,847,11
2021-10-04,Tulare,107,460477,64301,62957,13320,76277,920
2021-10-04,Tuolumne,109,53932,6535,6442,79,6521,89
2021-10-04,Ventura,111,848112,96020,95170,4151,99321,1153
2021-10-04,Yolo,113,214977,19010,18761,916,19677,242
2021-10-04,Yuba,115,75493,9587,9481,223,9704,68
2021-10-03,Alameda,001,1643700,116155,115751,2606,118357,1349
2021-10-03,Alpine,003,1148,99,102,0,102,0
2021-10-03,Amador,005,37829,5245,5160,51,5211,61
2021-10-03,Butte,007,227075,19478,19066,3520,22586,245
2021-10-03,Calaveras,009,45235,3693,3632,42,3674,73
2021-10-03,Colusa,011,21464,2436,2413,558,2971,18
2021-10-03,Contra Costa,013,1133247,96527,95890,1998,97888,937
2021-10-03,Del Norte,015,27424,3568,3483,38,3521,39
2021-10-03,El Dorado,017,186661,15234,15014,1583,16597,139
2021-10-03,Fresno,019,978130,131265,129365,11737,141102,1978
2021-10-03,Glenn,021,27897,3311,3266,944,4210,26
2021-10-03,Humboldt,023,135768,8468,8352,433,8785,94
2021-10-03,Imperial,025,180216,32070,31844,2984,34828,757
2021-10-03,Inyo,027,18085,1826,1788,34,1822,39
2021-10-03,Kern,029,883053,120463,118851,19220,138071,1535
2021-10-03,Kings,031,150075,30125,29623,1716,31339,300
2021-10-03,Lake,033,64148,6335,6239,123,6362,97
2021-10-03,Lassen,035,31185,6498,6400,300,6700,25
2021-10-03,Los Angeles,037,10098052,1410916,1398790,51964,1450754,26179
2021-10-03,Madera,039,155013,21471,21066,1781,22847,266
2021-10-03,Marin,041,260295,17123,16995,409,17404,242
2021-10-03,Mariposa,043,17540,1054,1011,33,1044,5
2021-10-03,Mendocino,045,87422,7058,6939,397,7336,79
2021-10-03,Merced,047,269075,39694,39516,1567,41083,558
2021-10-03,Modoc,049,8938,484,472,169,641,5
2021-10-03,Mono,051,14174,1590,1554,19,1573,3
2021-10-03,Monterey,053,433212,47926,47049,2644,49693,571
2021-10-03,Napa,055,140530,12577,12489,95,12584,96
2021-10-03,Nevada,057,99092,8620,8545,299,8844,90
2021-10-03,Orange,059,3164182,300317,298027,14201,312228,5447
2021-10-03,Placer,061,380077,35051,34596,3324,37920,379
2021-10-03,Plumas,063,18699,1416,1328,25,1353,6
2021-10-03,Riverside,065,2383286,352881,348593,15878,364471,4924
2021-10-03,Sacramento,067,1510023,151580,150664,3958,154622,2120
2021-10-03,San Benito,069,59416,7101,7095,148,7243,69
2021-10-03,San Bernardino,071,2135413,344454,342302,10709,353011,5555
2021-10-03,San Diego,073,3302833,360163,358153,21192,379345,4081
2021-10-03,San Francisco,075,870044,51247,50733,2160,52893,638
2021-10-03,San Joaquin,077,732212,95960,95133,5074,100207,1649
2021-10-03,San Luis Obispo,079,281455,28433,28065,1143,29208,325
2021-10-03,San Mateo,081,765935,52739,51923,793,52716,569
2021-10-03,Santa Barbara,083,443738,42880,42550,1474,44024,511
2021-10-03,Santa Clara,085,1922200,142844,141737,1147,142884,1869
2021-10-03,Santa Cruz,087,273765,19748,19548,967,20515,216
2021-10-03,Shasta,089,179085,19488,19132,3217,22349,279
2021-10-03,Sierra,091,2930,142,136,14,150,0
2021-10-03,Siskiyou,093,43540,3184,3096,1147,4243,42
2021-10-03,Solano,095,438530,44741,44051,1170,45221,322
2021-10-03,Sonoma,097,501317,39905,39679,490,40169,381
2021-10-03,Stanislaus,099,539301,74372,74366,8311,82677,1106
2021-10-03,Sutter,101,95872,13295,13248,277,13525,164
2021-10-03,Tehama,103,63373,7702,7564,1279,8843,94
2021-10-03,Trinity,105,12862,793,647,196,843,11
2021-10-03,Tulare,107,460477,64098,62860,13248,76108,924
2021-10-03,Tuolumne,109,53932,6506,6430,77,6507,89
2021-10-03,Ventura,111,848112,95914,95108,4148,99256,1153
2021-10-03,Yolo,113,214977,18981,18720,908,19628,242
2021-10-03,Yuba,115,75493,9570,9462,222,9684,68
2021-10-02,Alameda,001,1643700,116046,115185,2602,117787,1343
2021-10-02,Alpine,003,1148,99,102,0,102,0
2021-10-02,Amador,005,37829,5236,5105,51,5156,61
2021-10-02,Butte,007,227075,19448,18911,3513,22424,243
2021-10-02,Calaveras,009,45235,3686,3585,42,3627,72
2021-10-02,Colusa,011,21464,2435,2403,556,2959,18
2021-10-02,Contra Costa,013,1133247,96456,95369,1994,97363,933
2021-10-02,Del Norte,015,27424,3563,3468,38,3506,39
2021-10-02,El Dorado,017,186661,15208,14887,1582,16469,136
2021-10-02,Fresno,019,978130,131094,128450,11724,140174,1964
2021-10-02,Glenn,021,27897,3306,3234,944,4178,26
2021-10-02,Humboldt,023,135768,8450,8244,433,8677,94
2021-10-02,Imperial,025,180216,32035,31674,2981,34655,757
2021-10-02,Inyo,027,18085,1817,1746,34,1780,39
2021-10-02,Kern,029,883053,120330,117962,19139,137101,1524
2021-10-02,Kings,031,150075,30076,29339,1712,31051,301
2021-10-02,Lake,033,64148,6326,6191,123,6314,97
2021-10-02,Lassen,035,31185,6493,6360,300,6660,25
2021-10-02,Los Angeles,037,10098052,1410305,1395070,51928,1446998,26126
2021-10-02,Madera,039,155013,21446,20931,1772,22703,266
2021-10-02,Marin,041,260295,17118,16936,406,17342,242
2021-10-02,Mariposa,043,17540,1052,967,33,1000,5
2021-10-02,Mendocino,045,87422,7048,6869,397,7266,78
2021-10-02,Merced,047,269075,39667,39196,1563,40759,552
2021-10-02,Modoc,049,8938,482,468,169,637,5
2021-10-02,Mono,051,14174,1588,1540,19,1559,3
2021-10-02,Monterey,053,433212,47871,46964,2643,49607,571
2021-10-02,Napa,055,140530,12566,12433,95,12528,96
2021-10-02,Nevada,057,99092,8609,8474,298,8772,87
2021-10-02,Orange,059,3164182,300152,297307,14181,311488,5435
2021-10-02,Placer,061,380077,34985,34377,3315,37692,381
2021-10-02,Plumas,063,18699,1405,1298,25,1323,6
2021-10-02,Riverside,065,2383286,352640,347227,15867,363094,4895
2021-10-02,Sacramento,067,1510023,151407,149897,3950,153847,2099
2021-10-02,San Benito,069,59416,7094,7055,148,7203,69
2021-10-02,San Bernardino,071,2135413,344267,341212,10657,351869,5540
2021-10-02,San Diego,073,3302833,359846,356454,21170,377624,4078
2021-10-02,San Francisco,075,870044,51198,50393,2155,52548,634
2021-10-02,San Joaquin,077,732212,95895,94599,5068,99667,1646
2021-10-02,San Luis Obispo,079,281455,28409,27915,1143,29058,323
2021-10-02,San Mateo,081,765935,52698,51767,789,52556,573
2021-10-02,Santa Barbara,083,443738,42840,42423,1474,43897,508
2021-10-02,Santa Clara,085,1922200,142730,141231,1143,142374,1862
2021-10-02,Santa Cruz,087,273765,19731,19461,966,20427,214
2021-10-02,Shasta,089,179085,19442,18912,3211,22123,270
2021-10-02,Sierra,091,2930,141,131,14,145,0
2021-10-02,Siskiyou,093,43540,3183,3053,1144,4197,42
2021-10-02,Solano,095,438530,44696,43800,1169,44969,321
2021-10-02,Sonoma,097,501317,39871,39497,489,39986,382
2021-10-02,Stanislaus,099,539301,74286,73859,8298,82157,1099
2021-10-02,Sutter,101,95872,13286,13160,276,13436,160
2021-10-02,Tehama,103,63373,7687,7453,1279,8732,93
2021-10-02,Trinity,105,12862,790,625,196,821,10
2021-10-02,Tulare,107,460477,64022,62247,13222,75469,908
2021-10-02,Tuolumne,109,53932,6492,6369,77,6446,89
2021-10-02,Ventura,111,848112,95842,94854,4143,98997,1148
2021-10-02,Yolo,113,214977,18956,18640,904,19544,242
2021-10-02,Yuba,115,75493,9551,9370,221,9591,66
2021-10-01,Alameda,001,1643700,115970,115185,2596,117781,1343
2021-10-01,Alpine,003,1148,99,102,0,102,0
2021-10-01,Amador,005,37829,5216,5105,51,5156,61
2021-10-01,Butte,007,227075,19407,18911,3506,22417,243
2021-10-01,Calaveras,009,45235,3676,3585,42,3627,72
2021-10-01,Colusa,011,21464,2433,2403,556,2959,18
2021-10-01,Contra Costa,013,1133247,96360,95369,1990,97359,933
2021-10-01,Del Norte,015,27424,3560,3468,37,3505,39
2021-10-01,El Dorado,017,186661,15191,14887,1578,16465,136
2021-10-01,Fresno,019,978130,130906,128450,11714,140164,1964
2021-10-01,Glenn,021,27897,3304,3234,943,4177,26
2021-10-01,Humboldt,023,135768,8433,8244,433,8677,94
2021-10-01,Imperial,025,180216,32016,31674,2972,34646,757
2021-10-01,Inyo,027,18085,1808,1746,34,1780,39
2021-10-01,Kern,029,883053,120177,117962,19083,137045,1524
2021-10-01,Kings,031,150075,30042,29339,1707,31046,301
2021-10-01,Lake,033,64148,6316,6191,123,6314,97
2021-10-01,Lassen,035,31185,6482,6360,299,6659,25
2021-10-01,Los Angeles,037,10098052,1409541,1395070,51884,1446954,26126
2021-10-01,Madera,039,155013,21396,20931,1763,22694,266
2021-10-01,Marin,041,260295,17103,16936,405,17341,242
2021-10-01,Mariposa,043,17540,1045,967,33,1000,5
2021-10-01,Mendocino,045,87422,7036,6869,397,7266,78
2021-10-01,Merced,047,269075,39623,39196,1554,40750,552
2021-10-01,Modoc,049,8938,481,468,169,637,5
2021-10-01,Mono,051,14174,1585,1540,19,1559,3
2021-10-01,Monterey,053,433212,47850,46964,2640,49604,571
2021-10-01,Napa,055,140530,12556,12433,94,12527,96
2021-10-01,Nevada,057,99092,8595,8474,297,8771,87
2021-10-01,Orange,059,3164182,299968,297307,14161,311468,5435
2021-10-01,Placer,061,380077,34951,34377,3311,37688,381
2021-10-01,Plumas,063,18699,1396,1298,25,1323,6
2021-10-01,Riverside,065,2383286,352347,347227,15860,363087,4895
2021-10-01,Sacramento,067,1510023,151255,149897,3939,153836,2099
2021-10-01,San Benito,069,59416,7092,7055,146,7201,69
2021-10-01,San Bernardino,071,2135413,344067,341212,10654,351866,5540
2021-10-01,San Diego,073,3302833,359486,356454,21149,377603,4078
2021-10-01,San Francisco,075,870044,51157,50393,2154,52547,634
2021-10-01,San Joaquin,077,732212,95825,94599,5064,99663,1646
2021-10-01,San Luis Obispo,079,281455,28385,27915,1140,29055,323
2021-10-01,San Mateo,081,765935,52658,51767,786,52553,573
2021-10-01,Santa Barbara,083,443738,42804,42423,1474,43897,508
2021-10-01,Santa Clara,085,1922200,142637,141231,1138,142369,1862
2021-10-01,Santa Cruz,087,273765,19711,19461,965,20426,214
2021-10-01,Shasta,089,179085,19388,18912,3204,22116,270
2021-10-01,Sierra,091,2930,141,131,14,145,0
2021-10-01,Siskiyou,093,43540,3182,3053,1141,4194,42
2021-10-01,Solano,095,438530,44644,43800,1163,44963,321
2021-10-01,Sonoma,097,501317,39839,39497,488,39985,382
2021-10-01,Stanislaus,099,539301,74202,73859,8287,82146,1099
2021-10-01,Sutter,101,95872,13270,13160,274,13434,160
2021-10-01,Tehama,103,63373,7675,7453,1277,8730,93
2021-10-01,Trinity,105,12862,788,625,196,821,10
2021-10-01,Tulare,107,460477,63919,62247,13187,75434,908
2021-10-01,Tuolumne,109,53932,6475,6369,77,6446,89
2021-10-01,Ventura,111,848112,95775,94854,4138,98992,1148
2021-10-01,Yolo,113,214977,18932,18640,902,19542,242
2021-10-01,Yuba,115,75493,9529,9370,221,9591,66
2021-09-30,Alameda,001,1643700,115825,115185,2593,117778,1343
2021-09-30,Alpine,003,1148,99,102,0,102,0
2021-09-30,Amador,005,37829,5204,5105,51,5156,61
2021-09-30,Butte,007,227075,19358,18911,3497,22408,243
2021-09-30,Calaveras,009,45235,3662,3585,42,3627,72
2021-09-30,Colusa,011,21464,2430,2403,555,2958,18
2021-09-30,Contra Costa,013,1133247,96255,95369,1985,97354,933
2021-09-30,Del Norte,015,27424,3556,3468,34,3502,39
2021-09-30,El Dorado,017,186661,15165,14887,1570,16457,136
2021-09-30,Fresno,019,978130,130630,128450,11680,140130,1964
2021-09-30,Glenn,021,27897,3294,3234,940,4174,26
2021-09-30,Humboldt,023,135768,8401,8244,427,8671,94
2021-09-30,Imperial,025,180216,31964,31674,2970,34644,757
2021-09-30,Inyo,027,18085,1798,1746,34,1780,39
2021-09-30,Kern,029,883053,119933,117962,19002,136964,1524
2021-09-30,Kings,031,150075,29952,29339,1703,31042,301
2021-09-30,Lake,033,64148,6298,6191,123,6314,97
2021-09-30,Lassen,035,31185,6468,6360,299,6659,25
2021-09-30,Los Angeles,037,10098052,1408333,1395070,51824,1446894,26126
2021-09-30,Madera,039,155013,21313,20931,1748,22679,266
2021-09-30,Marin,041,260295,17083,16936,404,17340,242
2021-09-30,Mariposa,043,17540,1023,967,33,1000,5
2021-09-30,Mendocino,045,87422,7027,6869,388,7257,78
2021-09-30,Merced,047,269075,39527,39196,1550,40746,552
2021-09-30,Modoc,049,8938,481,468,168,636,5
2021-09-30,Mono,051,14174,1577,1540,19,1559,3
2021-09-30,Monterey,053,433212,47820,46964,2629,49593,571
2021-09-30,Napa,055,140530,12536,12433,94,12527,96
2021-09-30,Nevada,057,99092,8578,8474,296,8770,87
2021-09-30,Orange,059,3164182,299696,297307,14123,311430,5435
2021-09-30,Placer,061,380077,34897,34377,3291,37668,381
2021-09-30,Plumas,063,18699,1378,1298,25,1323,6
2021-09-30,Riverside,065,2383286,351913,347227,15839,363066,4895
2021-09-30,Sacramento,067,1510023,150994,149897,3913,153810,2099
2021-09-30,San Benito,069,59416,7086,7055,146,7201,69
2021-09-30,San Bernardino,071,2135413,343755,341212,10640,351852,5540
2021-09-30,San Diego,073,3302833,359005,356454,21123,377577,4078
2021-09-30,San Francisco,075,870044,51080,50393,2150,52543,634
2021-09-30,San Joaquin,077,732212,95695,94599,5056,99655,1646
2021-09-30,San Luis Obispo,079,281455,28337,27915,1136,29051,323
2021-09-30,San Mateo,081,765935,52609,51767,783,52550,573
2021-09-30,Santa Barbara,083,443738,42747,42423,1473,43896,508
2021-09-30,Santa Clara,085,1922200,142487,141231,1135,142366,1862
2021-09-30,Santa Cruz,087,273765,19671,19461,964,20425,214
2021-09-30,Shasta,089,179085,19326,18912,3189,22101,270
2021-09-30,Sierra,091,2930,140,131,14,145,0
2021-09-30,Siskiyou,093,43540,3174,3053,1136,4189,42
2021-09-30,Solano,095,438530,44590,43800,1160,44960,321
2021-09-30,Sonoma,097,501317,39790,39497,488,39985,382
2021-09-30,Stanislaus,099,539301,74042,73859,8268,82127,1099
2021-09-30,Sutter,101,95872,13249,13160,274,13434,160
2021-09-30,Tehama,103,63373,7638,7453,1265,8718,93
2021-09-30,Trinity,105,12862,784,625,196,821,10
2021-09-30,Tulare,107,460477,63743,62247,13130,75377,908
2021-09-30,Tuolumne,109,53932,6452,6369,77,6446,89
2021-09-30,Ventura,111,848112,95670,94854,4131,98985,1148
2021-09-30,Yolo,113,214977,18893,18640,899,19539,242
2021-09-30,Yuba,115,75493,9506,9370,220,9590,66
2021-09-29,Alameda,001,1643700,115680,114998,2590,117588,1339
2021-09-29,Alpine,003,1148,99,101,0,101,0
2021-09-29,Amador,005,37829,5182,5058,51,5109,61
2021-09-29,Butte,007,227075,19304,18835,3490,22325,242
2021-09-29,Calaveras,009,45235,3645,3553,41,3594,72
2021-09-29,Colusa,011,21464,2428,2401,555,2956,18
2021-09-29,Contra Costa,013,1133247,96141,95213,1977,97190,929
2021-09-29,Del Norte,015,27424,3550,3467,34,3501,39
2021-09-29,El Dorado,017,186661,15131,14834,1563,16397,136
2021-09-29,Fresno,019,978130,130330,128068,11659,139727,1957
2021-09-29,Glenn,021,27897,3289,3213,938,4151,26
2021-09-29,Humboldt,023,135768,8378,8203,426,8629,94
2021-09-29,Imperial,025,180216,31898,31600,2965,34565,757
2021-09-29,Inyo,027,18085,1788,1740,33,1773,39
2021-09-29,Kern,029,883053,119698,117605,18926,136531,1513
2021-09-29,Kings,031,150075,29870,29195,1688,30883,299
2021-09-29,Lake,033,64148,6278,6164,123,6287,97
2021-09-29,Lassen,035,31185,6454,6347,299,6646,25
2021-09-29,Los Angeles,037,10098052,1407114,1393617,51754,1445371,26098
2021-09-29,Madera,039,155013,21269,20818,1732,22550,266
2021-09-29,Marin,041,260295,17065,16921,402,17323,242
2021-09-29,Mariposa,043,17540,1008,963,33,996,5
2021-09-29,Mendocino,045,87422,7015,6821,380,7201,78
2021-09-29,Merced,047,269075,39433,39026,1539,40565,552
2021-09-29,Modoc,049,8938,479,468,168,636,5
2021-09-29,Mono,051,14174,1575,1527,19,1546,3
2021-09-29,Monterey,053,433212,47782,46917,2615,49532,571
2021-09-29,Napa,055,140530,12516,12416,91,12507,96
2021-09-29,Nevada,057,99092,8565,8434,296,8730,87
2021-09-29,Orange,059,3164182,299428,296936,14087,311023,5429
2021-09-29,Placer,061,380077,34833,34271,3269,37540,379
2021-09-29,Plumas,063,18699,1359,1289,25,1314,6
2021-09-29,Riverside,065,2383286,351479,346558,15826,362384,4886
2021-09-29,Sacramento,067,1510023,150743,149686,3903,153589,2099
2021-09-29,San Benito,069,59416,7075,7039,146,7185,69
2021-09-29,San Bernardino,071,2135413,343435,340672,10625,351297,5539
2021-09-29,San Diego,073,3302833,358518,355899,21093,376992,4066
2021-09-29,San Francisco,075,870044,50996,50286,2146,52432,629
2021-09-29,San Joaquin,077,732212,95537,94356,5034,99390,1645
2021-09-29,San Luis Obispo,079,281455,28291,27800,1130,28930,323
2021-09-29,San Mateo,081,765935,52549,51673,781,52454,573
2021-09-29,Santa Barbara,083,443738,42675,42328,1470,43798,507
2021-09-29,Santa Clara,085,1922200,142352,141036,1129,142165,1861
2021-09-29,Santa Cruz,087,273765,19653,19425,963,20388,214
2021-09-29,Shasta,089,179085,19260,18805,3178,21983,271
2021-09-29,Sierra,091,2930,136,130,14,144,0
2021-09-29,Siskiyou,093,43540,3161,3043,1129,4172,42
2021-09-29,Solano,095,438530,44534,43724,1153,44877,321
2021-09-29,Sonoma,097,501317,39729,39426,486,39912,370
2021-09-29,Stanislaus,099,539301,73911,73634,8257,81891,1096
2021-09-29,Sutter,101,95872,13222,13135,271,13406,155
2021-09-29,Tehama,103,63373,7608,7409,1250,8659,88
2021-09-29,Trinity,105,12862,780,616,196,812,10
2021-09-29,Tulare,107,460477,63569,62046,13071,75117,908
2021-09-29,Tuolumne,109,53932,6435,6336,77,6413,89
2021-09-29,Ventura,111,848112,95580,94753,4127,98880,1144
2021-09-29,Yolo,113,214977,18860,18587,894,19481,239
2021-09-29,Yuba,115,75493,9475,9351,216,9567,66
2021-09-28,Alameda,001,1643700,115522,114869,2584,117453,1333
2021-09-28,Alpine,003,1148,99,101,0,101,0
2021-09-28,Amador,005,37829,5160,5049,51,5100,61
2021-09-28,Butte,007,227075,19255,18764,3475,22239,241
2021-09-28,Calaveras,009,45235,3625,3530,41,3571,72
2021-09-28,Colusa,011,21464,2425,2399,553,2952,18
2021-09-28,Contra Costa,013,1133247,96000,95115,1972,97087,929
2021-09-28,Del Norte,015,27424,3547,3462,34,3496,39
2021-09-28,El Dorado,017,186661,15085,14793,1559,16352,133
2021-09-28,Fresno,019,978130,129986,127877,11625,139502,1948
2021-09-28,Glenn,021,27897,3284,3205,937,4142,26
2021-09-28,Humboldt,023,135768,8338,8159,423,8582,91
2021-09-28,Imperial,025,180216,31853,31543,2961,34504,757
2021-09-28,Inyo,027,18085,1774,1708,32,1740,39
2021-09-28,Kern,029,883053,119429,117420,18831,136251,1506
2021-09-28,Kings,031,150075,29768,29141,1680,30821,295
2021-09-28,Lake,033,64148,6263,6155,123,6278,95
2021-09-28,Lassen,035,31185,6448,6340,295,6635,25
2021-09-28,Los Angeles,037,10098052,1405824,1392445,51686,1444131,26068
2021-09-28,Madera,039,155013,21215,20764,1717,22481,266
2021-09-28,Marin,041,260295,17046,16887,400,17287,242
2021-09-28,Mariposa,043,17540,1003,952,33,985,5
2021-09-28,Mendocino,045,87422,6993,6804,378,7182,78
2021-09-28,Merced,047,269075,39347,38953,1526,40479,551
2021-09-28,Modoc,049,8938,478,467,168,635,5
2021-09-28,Mono,051,14174,1565,1527,19,1546,3
2021-09-28,Monterey,053,433212,47745,46859,2606,49465,571
2021-09-28,Napa,055,140530,12499,12388,90,12478,96
2021-09-28,Nevada,057,99092,8542,8409,295,8704,84
2021-09-28,Orange,059,3164182,299175,296596,14058,310654,5421
2021-09-28,Placer,061,380077,34768,34187,3251,37438,370
2021-09-28,Plumas,063,18699,1350,1276,25,1301,6
2021-09-28,Riverside,065,2383286,351020,346096,15805,361901,4874
2021-09-28,Sacramento,067,1510023,150453,149310,3881,153191,2086
2021-09-28,San Benito,069,59416,7058,7028,145,7173,69
2021-09-28,San Bernardino,071,2135413,343088,340342,10608,350950,5540
2021-09-28,San Diego,073,3302833,357971,355373,21061,376434,4054
2021-09-28,San Francisco,075,870044,50895,50234,2145,52379,627
2021-09-28,San Joaquin,077,732212,95384,94194,5021,99215,1639
2021-09-28,San Luis Obispo,079,281455,28257,27755,1125,28880,321
2021-09-28,San Mateo,081,765935,52504,51620,781,52401,571
2021-09-28,Santa Barbara,083,443738,42602,42226,1469,43695,506
2021-09-28,Santa Clara,085,1922200,142191,140886,1120,142006,1858
2021-09-28,Santa Cruz,087,273765,19612,19324,962,20286,214
2021-09-28,Shasta,089,179085,19199,18701,3164,21865,267
2021-09-28,Sierra,091,2930,135,130,13,143,0
2021-09-28,Siskiyou,093,43540,3149,3032,1126,4158,42
2021-09-28,Solano,095,438530,44461,43652,1150,44802,316
2021-09-28,Sonoma,097,501317,39682,39395,485,39880,370
2021-09-28,Stanislaus,099,539301,73740,73528,8245,81773,1094
2021-09-28,Sutter,101,95872,13203,13102,267,13369,155
2021-09-28,Tehama,103,63373,7590,7382,1235,8617,88
2021-09-28,Trinity,105,12862,777,613,196,809,10
2021-09-28,Tulare,107,460477,63408,61916,13013,74929,905
2021-09-28,Tuolumne,109,53932,6408,6308,77,6385,89
2021-09-28,Ventura,111,848112,95454,94632,4124,98756,1143
2021-09-28,Yolo,113,214977,18834,18564,890,19454,239
2021-09-28,Yuba,115,75493,9456,9323,215,9538,66
2021-09-27,Alameda,001,1643700,115328,114731,2575,117306,1327
2021-09-27,Alpine,003,1148,99,101,0,101,0
2021-09-27,Amador,005,37829,5146,5017,51,5068,59
2021-09-27,Butte,007,227075,19195,18687,3458,22145,239
2021-09-27,Calaveras,009,45235,3605,3514,40,3554,70
2021-09-27,Colusa,011,21464,2424,2393,552,2945,18
2021-09-27,Contra Costa,013,1133247,95869,94979,1963,96942,924
2021-09-27,Del Norte,015,27424,3545,3468,32,3500,37
2021-09-27,El Dorado,017,186661,15046,14764,1552,16316,132
2021-09-27,Fresno,019,978130,129666,127475,11592,139067,1942
2021-09-27,Glenn,021,27897,3271,3189,933,4122,26
2021-09-27,Humboldt,023,135768,8298,8118,423,8541,91
2021-09-27,Imperial,025,180216,31790,31491,2954,34445,756
2021-09-27,Inyo,027,18085,1762,1698,32,1730,39
2021-09-27,Kern,029,883053,119154,117064,18736,135800,1503
2021-09-27,Kings,031,150075,29670,28998,1668,30666,297
2021-09-27,Lake,033,64148,6243,6126,122,6248,95
2021-09-27,Lassen,035,31185,6433,6327,291,6618,25
2021-09-27,Los Angeles,037,10098052,1404487,1391538,51618,1443156,26040
2021-09-27,Madera,039,155013,21150,20691,1709,22400,262
2021-09-27,Marin,041,260295,17025,16861,399,17260,242
2021-09-27,Mariposa,043,17540,993,931,33,964,5
2021-09-27,Mendocino,045,87422,6967,6761,371,7132,74
2021-09-27,Merced,047,269075,39247,38840,1520,40360,548
2021-09-27,Modoc,049,8938,477,465,166,631,5
2021-09-27,Mono,051,14174,1553,1525,19,1544,3
2021-09-27,Monterey,053,433212,47702,46811,2595,49406,571
2021-09-27,Napa,055,140530,12475,12354,89,12443,95
2021-09-27,Nevada,057,99092,8518,8379,292,8671,84
2021-09-27,Orange,059,3164182,298869,296334,14028,310362,5409
2021-09-27,Placer,061,380077,34681,34087,3246,37333,370
2021-09-27,Plumas,063,18699,1340,1269,25,1294,6
2021-09-27,Riverside,065,2383286,350578,345529,15795,361324,4864
2021-09-27,Sacramento,067,1510023,150136,149096,3859,152955,2076
2021-09-27,San Benito,069,59416,7041,7017,145,7162,67
2021-09-27,San Bernardino,071,2135413,342671,339952,10584,350536,5544
2021-09-27,San Diego,073,3302833,357319,354755,21036,375791,4054
2021-09-27,San Francisco,075,870044,50811,50157,2142,52299,622
2021-09-27,San Joaquin,077,732212,95199,94085,5018,99103,1633
2021-09-27,San Luis Obispo,079,281455,28202,27674,1122,28796,320
2021-09-27,San Mateo,081,765935,52428,51552,781,52333,571
2021-09-27,Santa Barbara,083,443738,42535,42012,1465,43477,505
2021-09-27,Santa Clara,085,1922200,142010,140802,1110,141912,1853
2021-09-27,Santa Cruz,087,273765,19588,19292,961,20253,214
2021-09-27,Shasta,089,179085,19118,18599,3137,21736,267
2021-09-27,Sierra,091,2930,135,128,13,141,0
2021-09-27,Siskiyou,093,43540,3137,3015,1121,4136,42
2021-09-27,Solano,095,438530,44386,43582,1144,44726,314
2021-09-27,Sonoma,097,501317,39628,39347,485,39832,370
2021-09-27,Stanislaus,099,539301,73586,73370,8225,81595,1091
2021-09-27,Sutter,101,95872,13172,13082,264,13346,155
2021-09-27,Tehama,103,63373,7550,7345,1226,8571,88
2021-09-27,Trinity,105,12862,766,605,195,800,9
2021-09-27,Tulare,107,460477,63209,61708,12942,74650,904
2021-09-27,Tuolumne,109,53932,6387,6264,77,6341,89
2021-09-27,Ventura,111,848112,95329,94477,4120,98597,1138
2021-09-27,Yolo,113,214977,18800,18524,889,19413,239
2021-09-27,Yuba,115,75493,9419,9292,211,9503,64
2021-09-26,Alameda,001,1643700,115133,114601,2568,117169,1326
2021-09-26,Alpine,003,1148,99,101,0,101,0
2021-09-26,Amador,005,37829,5114,5001,50,5051,59
2021-09-26,Butte,007,227075,19120,18634,3439,22073,238
2021-09-26,Calaveras,009,45235,3583,3505,40,3545,70
2021-09-26,Colusa,011,21464,2419,2392,550,2942,18
2021-09-26,Contra Costa,013,1133247,95694,94877,1950,96827,924
2021-09-26,Del Norte,015,27424,3540,3466,31,3497,37
2021-09-26,El Dorado,017,186661,15004,14738,1544,16282,132
2021-09-26,Fresno,019,978130,129309,127235,11546,138781,1939
2021-09-26,Glenn,021,27897,3263,3182,929,4111,26
2021-09-26,Humboldt,023,135768,8261,8098,422,8520,91
2021-09-26,Imperial,025,180216,31730,31462,2953,34415,756
2021-09-26,Inyo,027,18085,1747,1685,32,1717,39
2021-09-26,Kern,029,883053,118816,116927,18626,135553,1502
2021-09-26,Kings,031,150075,29569,28930,1657,30587,293
2021-09-26,Lake,033,64148,6226,6113,122,6235,95
2021-09-26,Lassen,035,31185,6423,6319,286,6605,25
2021-09-26,Los Angeles,037,10098052,1402997,1390577,51550,1442127,26035
2021-09-26,Madera,039,155013,21075,20629,1690,22319,262
2021-09-26,Marin,041,260295,17002,16860,399,17259,242
2021-09-26,Mariposa,043,17540,987,929,33,962,5
2021-09-26,Mendocino,045,87422,6933,6744,356,7100,74
2021-09-26,Merced,047,269075,39086,38717,1512,40229,548
2021-09-26,Modoc,049,8938,477,465,165,630,5
2021-09-26,Mono,051,14174,1549,1516,19,1535,3
2021-09-26,Monterey,053,433212,47655,46792,2582,49374,571
2021-09-26,Napa,055,140530,12451,12340,88,12428,95
2021-09-26,Nevada,057,99092,8487,8356,287,8643,84
2021-09-26,Orange,059,3164182,298530,296085,13995,310080,5409
2021-09-26,Placer,061,380077,34587,34043,3237,37280,370
2021-09-26,Plumas,063,18699,1322,1268,25,1293,6
2021-09-26,Riverside,065,2383286,350046,345257,15781,361038,4864
2021-09-26,Sacramento,067,1510023,149730,148745,3840,152585,2071
2021-09-26,San Benito,069,59416,7024,7012,144,7156,67
2021-09-26,San Bernardino,071,2135413,342213,339771,10570,350341,5545
2021-09-26,San Diego,073,3302833,356697,354414,20995,375409,4051
2021-09-26,San Francisco,075,870044,50685,50092,2133,52225,622
2021-09-26,San Joaquin,077,732212,94995,93935,5004,98939,1633
2021-09-26,San Luis Obispo,079,281455,28129,27624,1117,28741,319
2021-09-26,San Mateo,081,765935,52359,51496,779,52275,571
2021-09-26,Santa Barbara,083,443738,42449,41946,1462,43408,505
2021-09-26,Santa Clara,085,1922200,141809,140667,1107,141774,1852
2021-09-26,Santa Cruz,087,273765,19563,19279,961,20240,214
2021-09-26,Shasta,089,179085,19009,18566,3114,21680,266
2021-09-26,Sierra,091,2930,135,128,13,141,0
2021-09-26,Siskiyou,093,43540,3123,2998,1111,4109,42
2021-09-26,Solano,095,438530,44319,43537,1143,44680,314
2021-09-26,Sonoma,097,501317,39569,39302,485,39787,370
2021-09-26,Stanislaus,099,539301,73386,73243,8197,81440,1091
2021-09-26,Sutter,101,95872,13135,13045,263,13308,155
2021-09-26,Tehama,103,63373,7493,7323,1215,8538,88
2021-09-26,Trinity,105,12862,763,591,195,786,9
2021-09-26,Tulare,107,460477,62988,61560,12865,74425,904
2021-09-26,Tuolumne,109,53932,6359,6236,75,6311,89
2021-09-26,Ventura,111,848112,95215,94391,4113,98504,1138
2021-09-26,Yolo,113,214977,18764,18496,881,19377,239
2021-09-26,Yuba,115,75493,9392,9275,211,9486,64
2021-09-25,Alameda,001,1643700,115054,114014,2565,116579,1324
2021-09-25,Alpine,003,1148,99,101,0,101,0
2021-09-25,Amador,005,37829,5100,4934,50,4984,59
2021-09-25,Butte,007,227075,19091,18396,3431,21827,236
2021-09-25,Calaveras,009,45235,3580,3461,40,3501,70
2021-09-25,Colusa,011,21464,2416,2387,548,2935,16
2021-09-25,Contra Costa,013,1133247,95623,94337,1946,96283,924
2021-09-25,Del Norte,015,27424,3539,3404,31,3435,35
2021-09-25,El Dorado,017,186661,14981,14641,1540,16181,130
2021-09-25,Fresno,019,978130,129164,126299,11530,137829,1927
2021-09-25,Glenn,021,27897,3258,3144,928,4072,25
2021-09-25,Humboldt,023,135768,8242,8014,420,8434,88
2021-09-25,Imperial,025,180216,31703,31280,2953,34233,755
2021-09-25,Inyo,027,18085,1739,1657,32,1689,39
2021-09-25,Kern,029,883053,118661,116021,18559,134580,1485
2021-09-25,Kings,031,150075,29518,28636,1654,30290,293
2021-09-25,Lake,033,64148,6221,6046,120,6166,92
2021-09-25,Lassen,035,31185,6411,6248,285,6533,25
2021-09-25,Los Angeles,037,10098052,1402287,1386417,51509,1437926,25964
2021-09-25,Madera,039,155013,21050,20432,1684,22116,262
2021-09-25,Marin,041,260295,16993,16802,397,17199,242
2021-09-25,Mariposa,043,17540,982,906,33,939,5
2021-09-25,Mendocino,045,87422,6914,6657,355,7012,74
2021-09-25,Merced,047,269075,39040,38393,1510,39903,546
2021-09-25,Modoc,049,8938,477,460,165,625,5
2021-09-25,Mono,051,14174,1546,1501,19,1520,3
2021-09-25,Monterey,053,433212,47625,46653,2580,49233,567
2021-09-25,Napa,055,140530,12431,12266,88,12354,95
2021-09-25,Nevada,057,99092,8470,8285,287,8572,84
2021-09-25,Orange,059,3164182,298357,294514,13978,308492,5374
2021-09-25,Placer,061,380077,34523,33764,3235,36999,367
2021-09-25,Plumas,063,18699,1318,1238,25,1263,6
2021-09-25,Riverside,065,2383286,349723,343463,15773,359236,4843
2021-09-25,Sacramento,067,1510023,149555,147728,3832,151560,2049
2021-09-25,San Benito,069,59416,7019,6965,144,7109,67
2021-09-25,San Bernardino,071,2135413,341976,338413,10557,348970,5540
2021-09-25,San Diego,073,3302833,356352,352017,20969,372986,4039
2021-09-25,San Francisco,075,870044,50641,49840,2132,51972,615
2021-09-25,San Joaquin,077,732212,94909,93273,5002,98275,1628
2021-09-25,San Luis Obispo,079,281455,28091,27447,1113,28560,318
2021-09-25,San Mateo,081,765935,52295,51266,777,52043,568
2021-09-25,Santa Barbara,083,443738,42391,41728,1462,43190,505
2021-09-25,Santa Clara,085,1922200,141703,140023,1105,141128,1844
2021-09-25,Santa Cruz,087,273765,19547,19200,959,20159,214
2021-09-25,Shasta,089,179085,18958,18256,3105,21361,262
2021-09-25,Sierra,091,2930,134,127,13,140,0
2021-09-25,Siskiyou,093,43540,3116,2956,1101,4057,41
2021-09-25,Solano,095,438530,44278,43331,1140,44471,312
2021-09-25,Sonoma,097,501317,39528,39112,485,39597,369
2021-09-25,Stanislaus,099,539301,73276,72628,8183,80811,1091
2021-09-25,Sutter,101,95872,13117,12976,260,13236,154
2021-09-25,Tehama,103,63373,7477,7200,1213,8413,86
2021-09-25,Trinity,105,12862,763,576,195,771,9
2021-09-25,Tulare,107,460477,62906,60909,12822,73731,898
2021-09-25,Tuolumne,109,53932,6347,6168,75,6243,89
2021-09-25,Ventura,111,848112,95148,94059,4109,98168,1129
2021-09-25,Yolo,113,214977,18742,18393,880,19273,239
2021-09-25,Yuba,115,75493,9372,9191,211,9402,61
2021-09-24,Alameda,001,1643700,114949,114014,2561,116575,1324
2021-09-24,Alpine,003,1148,99,101,0,101,0
2021-09-24,Amador,005,37829,5070,4934,50,4984,59
2021-09-24,Butte,007,227075,19038,18396,3420,21816,236
2021-09-24,Calaveras,009,45235,3573,3461,39,3500,70
2021-09-24,Colusa,011,21464,2413,2387,547,2934,16
2021-09-24,Contra Costa,013,1133247,95513,94337,1942,96279,924
2021-09-24,Del Norte,015,27424,3536,3404,31,3435,35
2021-09-24,El Dorado,017,186661,14963,14641,1538,16179,130
2021-09-24,Fresno,019,978130,128966,126299,11518,137817,1927
2021-09-24,Glenn,021,27897,3250,3144,928,4072,25
2021-09-24,Humboldt,023,135768,8223,8014,417,8431,88
2021-09-24,Imperial,025,180216,31665,31280,2951,34231,755
2021-09-24,Inyo,027,18085,1730,1657,32,1689,39
2021-09-24,Kern,029,883053,118525,116021,18493,134514,1485
2021-09-24,Kings,031,150075,29477,28636,1650,30286,293
2021-09-24,Lake,033,64148,6213,6046,120,6166,92
2021-09-24,Lassen,035,31185,6403,6248,284,6532,25
2021-09-24,Los Angeles,037,10098052,1401400,1386417,51468,1437885,25964
2021-09-24,Madera,039,155013,21019,20432,1675,22107,262
2021-09-24,Marin,041,260295,16979,16802,396,17198,242
2021-09-24,Mariposa,043,17540,970,906,33,939,5
2021-09-24,Mendocino,045,87422,6901,6657,355,7012,74
2021-09-24,Merced,047,269075,38996,38393,1510,39903,546
2021-09-24,Modoc,049,8938,477,460,164,624,5
2021-09-24,Mono,051,14174,1541,1501,19,1520,3
2021-09-24,Monterey,053,433212,47604,46653,2572,49225,567
2021-09-24,Napa,055,140530,12412,12266,88,12354,95
2021-09-24,Nevada,057,99092,8456,8285,284,8569,84
2021-09-24,Orange,059,3164182,298150,294514,13960,308474,5374
2021-09-24,Placer,061,380077,34468,33764,3223,36987,367
2021-09-24,Plumas,063,18699,1314,1238,25,1263,6
2021-09-24,Riverside,065,2383286,349389,343463,15766,359229,4843
2021-09-24,Sacramento,067,1510023,149370,147728,3828,151556,2049
2021-09-24,San Benito,069,59416,7013,6965,144,7109,67
2021-09-24,San Bernardino,071,2135413,341708,338413,10547,348960,5540
2021-09-24,San Diego,073,3302833,356001,352017,20954,372971,4039
2021-09-24,San Francisco,075,870044,50577,49840,2125,51965,615
2021-09-24,San Joaquin,077,732212,94796,93273,5000,98273,1628
2021-09-24,San Luis Obispo,079,281455,28060,27447,1108,28555,318
2021-09-24,San Mateo,081,765935,52235,51266,776,52042,568
2021-09-24,Santa Barbara,083,443738,42351,41728,1461,43189,505
2021-09-24,Santa Clara,085,1922200,141591,140023,1104,141127,1844
2021-09-24,Santa Cruz,087,273765,19524,19200,958,20158,214
2021-09-24,Shasta,089,179085,18904,18256,3091,21347,262
2021-09-24,Sierra,091,2930,133,127,13,140,0
2021-09-24,Siskiyou,093,43540,3107,2956,1095,4051,41
2021-09-24,Solano,095,438530,44241,43331,1138,44469,312
2021-09-24,Sonoma,097,501317,39495,39112,485,39597,369
2021-09-24,Stanislaus,099,539301,73160,72628,8168,80796,1091
2021-09-24,Sutter,101,95872,13098,12976,259,13235,154
2021-09-24,Tehama,103,63373,7465,7200,1208,8408,86
2021-09-24,Trinity,105,12862,760,576,195,771,9
2021-09-24,Tulare,107,460477,62815,60909,12780,73689,898
2021-09-24,Tuolumne,109,53932,6318,6168,75,6243,89
2021-09-24,Ventura,111,848112,95070,94059,4102,98161,1129
2021-09-24,Yolo,113,214977,18710,18393,876,19269,239
2021-09-24,Yuba,115,75493,9353,9191,211,9402,61
2021-09-23,Alameda,001,1643700,114792,114014,2555,116569,1324
2021-09-23,Alpine,003,1148,99,101,0,101,0
2021-09-23,Amador,005,37829,5057,4934,50,4984,59
2021-09-23,Butte,007,227075,18976,18396,3395,21791,236
2021-09-23,Calaveras,009,45235,3552,3461,39,3500,70
2021-09-23,Colusa,011,21464,2411,2387,544,2931,16
2021-09-23,Contra Costa,013,1133247,95372,94337,1935,96272,924
2021-09-23,Del Norte,015,27424,3527,3404,30,3434,35
2021-09-23,El Dorado,017,186661,14937,14641,1532,16173,130
2021-09-23,Fresno,019,978130,128669,126299,11499,137798,1927
2021-09-23,Glenn,021,27897,3236,3144,925,4069,25
2021-09-23,Humboldt,023,135768,8199,8014,415,8429,88
2021-09-23,Imperial,025,180216,31629,31280,2951,34231,755
2021-09-23,Inyo,027,18085,1716,1657,32,1689,39
2021-09-23,Kern,029,883053,118267,116021,18413,134434,1485
2021-09-23,Kings,031,150075,29373,28636,1641,30277,293
2021-09-23,Lake,033,64148,6203,6046,120,6166,92
2021-09-23,Lassen,035,31185,6394,6248,279,6527,25
2021-09-23,Los Angeles,037,10098052,1400205,1386417,51404,1437821,25964
2021-09-23,Madera,039,155013,20935,20432,1671,22103,262
2021-09-23,Marin,041,260295,16964,16802,393,17195,242
2021-09-23,Mariposa,043,17540,957,906,33,939,5
2021-09-23,Mendocino,045,87422,6878,6657,350,7007,74
2021-09-23,Merced,047,269075,38892,38393,1503,39896,546
2021-09-23,Modoc,049,8938,476,460,164,624,5
2021-09-23,Mono,051,14174,1538,1501,19,1520,3
2021-09-23,Monterey,053,433212,47555,46653,2561,49214,567
2021-09-23,Napa,055,140530,12395,12266,88,12354,95
2021-09-23,Nevada,057,99092,8429,8285,284,8569,84
2021-09-23,Orange,059,3164182,297853,294514,13936,308450,5374
2021-09-23,Placer,061,380077,34392,33764,3217,36981,367
2021-09-23,Plumas,063,18699,1297,1238,24,1262,6
2021-09-23,Riverside,065,2383286,348936,343463,15759,359222,4843
2021-09-23,Sacramento,067,1510023,149047,147728,3809,151537,2049
2021-09-23,San Benito,069,59416,7002,6965,144,7109,67
2021-09-23,San Bernardino,071,2135413,341342,338413,10532,348945,5540
2021-09-23,San Diego,073,3302833,355545,352017,20915,372932,4039
2021-09-23,San Francisco,075,870044,50504,49840,2123,51963,615
2021-09-23,San Joaquin,077,732212,94623,93273,4985,98258,1628
2021-09-23,San Luis Obispo,079,281455,28017,27447,1106,28553,318
2021-09-23,San Mateo,081,765935,52160,51266,775,52041,568
2021-09-23,Santa Barbara,083,443738,42273,41728,1458,43186,505
2021-09-23,Santa Clara,085,1922200,141439,140023,1097,141120,1844
2021-09-23,Santa Cruz,087,273765,19493,19200,958,20158,214
2021-09-23,Shasta,089,179085,18824,18256,3074,21330,262
2021-09-23,Sierra,091,2930,133,127,13,140,0
2021-09-23,Siskiyou,093,43540,3103,2956,1084,4040,41
2021-09-23,Solano,095,438530,44173,43331,1135,44466,312
2021-09-23,Sonoma,097,501317,39436,39112,482,39594,369
2021-09-23,Stanislaus,099,539301,73003,72628,8136,80764,1091
2021-09-23,Sutter,101,95872,13069,12976,259,13235,154
2021-09-23,Tehama,103,63373,7424,7200,1203,8403,86
2021-09-23,Trinity,105,12862,746,576,194,770,9
2021-09-23,Tulare,107,460477,62638,60909,12726,73635,898
2021-09-23,Tuolumne,109,53932,6293,6168,74,6242,89
2021-09-23,Ventura,111,848112,94966,94059,4095,98154,1129
2021-09-23,Yolo,113,214977,18680,18393,871,19264,239
2021-09-23,Yuba,115,75493,9324,9191,210,9401,61
2021-09-22,Alameda,001,1643700,114636,113862,2551,116413,1322
2021-09-22,Alpine,003,1148,99,100,0,100,0
2021-09-22,Amador,005,37829,5041,4915,50,4965,59
2021-09-22,Butte,007,227075,18915,18337,3377,21714,235
2021-09-22,Calaveras,009,45235,3536,3448,39,3487,70
2021-09-22,Colusa,011,21464,2406,2384,543,2927,16
2021-09-22,Contra Costa,013,1133247,95186,94209,1926,96135,924
2021-09-22,Del Norte,015,27424,3516,3386,29,3415,35
2021-09-22,El Dorado,017,186661,14901,14605,1526,16131,127
2021-09-22,Fresno,019,978130,128413,126006,11484,137490,1908
2021-09-22,Glenn,021,27897,3229,3138,924,4062,25
2021-09-22,Humboldt,023,135768,8177,7998,407,8405,80
2021-09-22,Imperial,025,180216,31577,31243,2944,34187,755
2021-09-22,Inyo,027,18085,1706,1651,32,1683,39
2021-09-22,Kern,029,883053,118026,115757,18291,134048,1477
2021-09-22,Kings,031,150075,29288,28589,1635,30224,292
2021-09-22,Lake,033,64148,6191,6035,120,6155,93
2021-09-22,Lassen,035,31185,6374,6209,275,6484,25
2021-09-22,Los Angeles,037,10098052,1398882,1384719,51349,1436068,25930
2021-09-22,Madera,039,155013,20878,20382,1661,22043,262
2021-09-22,Marin,041,260295,16953,16782,390,17172,242
2021-09-22,Mariposa,043,17540,951,901,33,934,5
2021-09-22,Mendocino,045,87422,6852,6624,344,6968,70
2021-09-22,Merced,047,269075,38759,38305,1501,39806,541
2021-09-22,Modoc,049,8938,473,458,164,622,5
2021-09-22,Mono,051,14174,1529,1496,18,1514,3
2021-09-22,Monterey,053,433212,47504,46615,2554,49169,566
2021-09-22,Napa,055,140530,12372,12248,87,12335,95
2021-09-22,Nevada,057,99092,8406,8273,281,8554,84
2021-09-22,Orange,059,3164182,297577,294214,13919,308133,5366
2021-09-22,Placer,061,380077,34304,33661,3204,36865,367
2021-09-22,Plumas,063,18699,1284,1230,24,1254,6
2021-09-22,Riverside,065,2383286,348401,342946,15734,358680,4830
2021-09-22,Sacramento,067,1510023,148742,147533,3780,151313,2043
2021-09-22,San Benito,069,59416,6991,6961,142,7103,67
2021-09-22,San Bernardino,071,2135413,340948,337938,10523,348461,5528
2021-09-22,San Diego,073,3302833,355094,351132,20891,372023,4027
2021-09-22,San Francisco,075,870044,50419,49734,2118,51852,610
2021-09-22,San Joaquin,077,732212,94391,93010,4961,97971,1626
2021-09-22,San Luis Obispo,079,281455,27967,27398,1102,28500,315
2021-09-22,San Mateo,081,765935,52087,51197,771,51968,568
2021-09-22,Santa Barbara,083,443738,42210,41678,1457,43135,504
2021-09-22,Santa Clara,085,1922200,141276,139803,1090,140893,1844
2021-09-22,Santa Cruz,087,273765,19455,19177,958,20135,214
2021-09-22,Shasta,089,179085,18734,18153,3063,21216,260
2021-09-22,Sierra,091,2930,133,127,13,140,0
2021-09-22,Siskiyou,093,43540,3086,2947,1074,4021,41
2021-09-22,Solano,095,438530,44108,43269,1134,44403,312
2021-09-22,Sonoma,097,501317,39383,39063,481,39544,369
2021-09-22,Stanislaus,099,539301,72838,72355,8117,80472,1091
2021-09-22,Sutter,101,95872,13049,12960,256,13216,153
2021-09-22,Tehama,103,63373,7397,7173,1200,8373,86
2021-09-22,Trinity,105,12862,745,572,194,766,9
2021-09-22,Tulare,107,460477,62427,60776,12657,73433,896
2021-09-22,Tuolumne,109,53932,6272,6155,73,6228,89
2021-09-22,Ventura,111,848112,94861,93978,4090,98068,1122
2021-09-22,Yolo,113,214977,18641,18342,864,19206,239
2021-09-22,Yuba,115,75493,9295,9169,205,9374,61
2021-09-21,Alameda,001,1643700,114483,113765,2551,116316,1321
2021-09-21,Alpine,003,1148,99,100,0,100,0
2021-09-21,Amador,005,37829,5019,4897,50,4947,59
2021-09-21,Butte,007,227075,18819,18229,3337,21566,232
2021-09-21,Calaveras,009,45235,3519,3437,39,3476,70
2021-09-21,Colusa,011,21464,2403,2378,542,2920,16
2021-09-21,Contra Costa,013,1133247,94992,94101,1912,96013,924
2021-09-21,Del Norte,015,27424,3504,3378,29,3407,34
2021-09-21,El Dorado,017,186661,14871,14578,1519,16097,127
2021-09-21,Fresno,019,978130,128062,125789,11457,137246,1892
2021-09-21,Glenn,021,27897,3222,3134,920,4054,25
2021-09-21,Humboldt,023,135768,8145,7955,402,8357,80
2021-09-21,Imperial,025,180216,31521,31185,2942,34127,755
2021-09-21,Inyo,027,18085,1696,1646,32,1678,39
2021-09-21,Kern,029,883053,117733,115534,18178,133712,1467
2021-09-21,Kings,031,150075,29200,28545,1627,30172,291
2021-09-21,Lake,033,64148,6168,6013,120,6133,90
2021-09-21,Lassen,035,31185,6356,6159,271,6430,25
2021-09-21,Los Angeles,037,10098052,1397427,1383277,51294,1434571,25893
2021-09-21,Madera,039,155013,20818,20317,1651,21968,262
2021-09-21,Marin,041,260295,16938,16748,389,17137,242
2021-09-21,Mariposa,043,17540,946,894,32,926,5
2021-09-21,Mendocino,045,87422,6814,6580,333,6913,68
2021-09-21,Merced,047,269075,38637,38225,1497,39722,539
2021-09-21,Modoc,049,8938,470,458,164,622,5
2021-09-21,Mono,051,14174,1527,1495,17,1512,3
2021-09-21,Monterey,053,433212,47436,46583,2542,49125,565
2021-09-21,Napa,055,140530,12351,12238,87,12325,95
2021-09-21,Nevada,057,99092,8379,8259,273,8532,84
2021-09-21,Orange,059,3164182,297246,293898,13889,307787,5357
2021-09-21,Placer,061,380077,34203,33609,3193,36802,365
2021-09-21,Plumas,063,18699,1277,1225,24,1249,5
2021-09-21,Riverside,065,2383286,347841,342460,15710,358170,4817
2021-09-21,Sacramento,067,1510023,148361,147378,3752,151130,2027
2021-09-21,San Benito,069,59416,6980,6950,141,7091,67
2021-09-21,San Bernardino,071,2135413,340509,337387,10506,347893,5520
2021-09-21,San Diego,073,3302833,354488,350265,20865,371130,4021
2021-09-21,San Francisco,075,870044,50322,49653,2114,51767,609
2021-09-21,San Joaquin,077,732212,94157,92762,4950,97712,1621
2021-09-21,San Luis Obispo,079,281455,27908,27318,1098,28416,314
2021-09-21,San Mateo,081,765935,52018,51136,771,51907,568
2021-09-21,Santa Barbara,083,443738,42141,41644,1453,43097,503
2021-09-21,Santa Clara,085,1922200,141059,139657,1086,140743,1843
2021-09-21,Santa Cruz,087,273765,19425,19140,957,20097,212
2021-09-21,Shasta,089,179085,18606,18027,3039,21066,258
2021-09-21,Sierra,091,2930,133,127,13,140,0
2021-09-21,Siskiyou,093,43540,3072,2927,1060,3987,36
2021-09-21,Solano,095,438530,44032,43220,1134,44354,311
2021-09-21,Sonoma,097,501317,39330,39042,481,39523,369
2021-09-21,Stanislaus,099,539301,72654,72211,8097,80308,1091
2021-09-21,Sutter,101,95872,13026,12930,253,13183,153
2021-09-21,Tehama,103,63373,7351,7151,1196,8347,85
2021-09-21,Trinity,105,12862,734,572,192,764,9
2021-09-21,Tulare,107,460477,62212,60607,12596,73203,896
2021-09-21,Tuolumne,109,53932,6239,6139,73,6212,89
2021-09-21,Ventura,111,848112,94756,93818,4082,97900,1120
2021-09-21,Yolo,113,214977,18605,18313,861,19174,239
2021-09-21,Yuba,115,75493,9267,9135,205,9340,61
2021-09-20,Alameda,001,1643700,114302,113637,2547,116184,1320
2021-09-20,Alpine,003,1148,99,100,0,100,0
2021-09-20,Amador,005,37829,5001,4883,49,4932,59
2021-09-20,Butte,007,227075,18737,18135,3322,21457,231
2021-09-20,Calaveras,009,45235,3497,3395,38,3433,66
2021-09-20,Colusa,011,21464,2401,2376,539,2915,16
2021-09-20,Contra Costa,013,1133247,94842,93919,1906,95825,924
2021-09-20,Del Norte,015,27424,3496,3374,28,3402,34
2021-09-20,El Dorado,017,186661,14838,14545,1507,16052,127
2021-09-20,Fresno,019,978130,127649,125287,11431,136718,1889
2021-09-20,Glenn,021,27897,3211,3112,917,4029,25
2021-09-20,Humboldt,023,135768,8110,7938,397,8335,80
2021-09-20,Imperial,025,180216,31438,31146,2941,34087,755
2021-09-20,Inyo,027,18085,1688,1641,31,1672,39
2021-09-20,Kern,029,883053,117394,115271,18047,133318,1459
2021-09-20,Kings,031,150075,29113,28471,1621,30092,285
2021-09-20,Lake,033,64148,6153,5984,119,6103,87
2021-09-20,Lassen,035,31185,6326,6132,271,6403,25
2021-09-20,Los Angeles,037,10098052,1395903,1382206,51214,1433420,25858
2021-09-20,Madera,039,155013,20765,20203,1644,21847,257
2021-09-20,Marin,041,260295,16913,16732,387,17119,242
2021-09-20,Mariposa,043,17540,935,887,32,919,5
2021-09-20,Mendocino,045,87422,6780,6568,328,6896,67
2021-09-20,Merced,047,269075,38526,38144,1486,39630,536
2021-09-20,Modoc,049,8938,469,457,162,619,5
2021-09-20,Mono,051,14174,1521,1480,17,1497,3
2021-09-20,Monterey,053,433212,47394,46506,2524,49030,565
2021-09-20,Napa,055,140530,12326,12209,86,12295,95
2021-09-20,Nevada,057,99092,8359,8228,271,8499,84
2021-09-20,Orange,059,3164182,296902,293642,13862,307504,5354
2021-09-20,Placer,061,380077,34113,33531,3178,36709,364
2021-09-20,Plumas,063,18699,1272,1211,24,1235,5
2021-09-20,Riverside,065,2383286,347340,341961,15697,357658,4802
2021-09-20,Sacramento,067,1510023,147988,147016,3719,150735,2016
2021-09-20,San Benito,069,59416,6971,6947,140,7087,67
2021-09-20,San Bernardino,071,2135413,340108,337059,10490,347549,5507
2021-09-20,San Diego,073,3302833,353816,349579,20828,370407,4009
2021-09-20,San Francisco,075,870044,50215,49559,2113,51672,605
2021-09-20,San Joaquin,077,732212,93914,92614,4937,97551,1615
2021-09-20,San Luis Obispo,079,281455,27832,27259,1090,28349,313
2021-09-20,San Mateo,081,765935,51931,51100,768,51868,567
2021-09-20,Santa Barbara,083,443738,42042,41589,1449,43038,500
2021-09-20,Santa Clara,085,1922200,140859,139578,1084,140662,1841
2021-09-20,Santa Cruz,087,273765,19393,19121,957,20078,211
2021-09-20,Shasta,089,179085,18507,17893,3009,20902,258
2021-09-20,Sierra,091,2930,131,126,13,139,0
2021-09-20,Siskiyou,093,43540,3050,2902,1047,3949,35
2021-09-20,Solano,095,438530,43964,43152,1126,44278,312
2021-09-20,Sonoma,097,501317,39284,38991,481,39472,369
2021-09-20,Stanislaus,099,539301,72455,72031,8078,80109,1091
2021-09-20,Sutter,101,95872,12990,12896,248,13144,153
2021-09-20,Tehama,103,63373,7319,7121,1184,8305,84
2021-09-20,Trinity,105,12862,728,568,191,759,7
2021-09-20,Tulare,107,460477,62010,60302,12543,72845,896
2021-09-20,Tuolumne,109,53932,6213,6113,73,6186,89
2021-09-20,Ventura,111,848112,94643,93700,4076,97776,1120
2021-09-20,Yolo,113,214977,18559,18287,859,19146,239
2021-09-20,Yuba,115,75493,9232,9107,203,9310,61
2021-09-19,Alameda,001,1643700,114088,113446,2542,115988,1320
2021-09-19,Alpine,003,1148,99,100,0,100,0
2021-09-19,Amador,005,37829,4961,4875,48,4923,59
2021-09-19,Butte,007,227075,18643,18063,3293,21356,230
2021-09-19,Calaveras,009,45235,3473,3390,35,3425,66
2021-09-19,Colusa,011,21464,2399,2375,537,2912,16
2021-09-19,Contra Costa,013,1133247,94656,93788,1896,95684,924
2021-09-19,Del Norte,015,27424,3470,3344,27,3371,34
2021-09-19,El Dorado,017,186661,14785,14512,1501,16013,127
2021-09-19,Fresno,019,978130,127244,124985,11386,136371,1888
2021-09-19,Glenn,021,27897,3202,3102,914,4016,25
2021-09-19,Humboldt,023,135768,8064,7914,395,8309,80
2021-09-19,Imperial,025,180216,31369,31122,2938,34060,755
2021-09-19,Inyo,027,18085,1679,1639,31,1670,39
2021-09-19,Kern,029,883053,117082,115074,17941,133015,1459
2021-09-19,Kings,031,150075,28986,28416,1612,30028,284
2021-09-19,Lake,033,64148,6122,5962,119,6081,87
2021-09-19,Lassen,035,31185,6306,6129,265,6394,25
2021-09-19,Los Angeles,037,10098052,1393924,1381200,51120,1432320,25852
2021-09-19,Madera,039,155013,20687,20161,1634,21795,257
2021-09-19,Marin,041,260295,16884,16711,385,17096,242
2021-09-19,Mariposa,043,17540,927,881,32,913,5
2021-09-19,Mendocino,045,87422,6735,6538,322,6860,67
2021-09-19,Merced,047,269075,38369,38068,1477,39545,535
2021-09-19,Modoc,049,8938,466,457,160,617,5
2021-09-19,Mono,051,14174,1516,1480,17,1497,3
2021-09-19,Monterey,053,433212,47339,46486,2521,49007,565
2021-09-19,Napa,055,140530,12305,12190,84,12274,95
2021-09-19,Nevada,057,99092,8331,8203,269,8472,84
2021-09-19,Orange,059,3164182,296534,293258,13840,307098,5354
2021-09-19,Placer,061,380077,34000,33406,3160,36566,364
2021-09-19,Plumas,063,18699,1264,1211,24,1235,5
2021-09-19,Riverside,065,2383286,346747,341566,15688,357254,4804
2021-09-19,Sacramento,067,1510023,147628,146603,3675,150278,2012
2021-09-19,San Benito,069,59416,6952,6942,140,7082,67
2021-09-19,San Bernardino,071,2135413,339612,336688,10479,347167,5506
2021-09-19,San Diego,073,3302833,353113,349225,20791,370016,4006
2021-09-19,San Francisco,075,870044,50108,49458,2104,51562,605
2021-09-19,San Joaquin,077,732212,93618,92467,4926,97393,1615
2021-09-19,San Luis Obispo,079,281455,27731,27208,1081,28289,313
2021-09-19,San Mateo,081,765935,51833,51028,767,51795,567
2021-09-19,Santa Barbara,083,443738,41936,41512,1449,42961,500
2021-09-19,Santa Clara,085,1922200,140672,139410,1079,140489,1841
2021-09-19,Santa Cruz,087,273765,19354,19096,957,20053,211
2021-09-19,Shasta,089,179085,18393,17813,2974,20787,258
2021-09-19,Sierra,091,2930,130,126,13,139,0
2021-09-19,Siskiyou,093,43540,3024,2882,1038,3920,35
2021-09-19,Solano,095,438530,43875,43056,1121,44177,312
2021-09-19,Sonoma,097,501317,39212,38956,477,39433,369
2021-09-19,Stanislaus,099,539301,72210,71830,8053,79883,1091
2021-09-19,Sutter,101,95872,12963,12868,241,13109,153
2021-09-19,Tehama,103,63373,7265,7081,1175,8256,84
2021-09-19,Trinity,105,12862,717,562,189,751,7
2021-09-19,Tulare,107,460477,61749,60160,12450,72610,896
2021-09-19,Tuolumne,109,53932,6172,6097,73,6170,89
2021-09-19,Ventura,111,848112,94481,93491,4067,97558,1120
2021-09-19,Yolo,113,214977,18510,18238,853,19091,239
2021-09-19,Yuba,115,75493,9206,9087,202,9289,61
2021-09-18,Alameda,001,1643700,113988,113300,2541,115841,1320
2021-09-18,Alpine,003,1148,99,100,0,100,0
2021-09-18,Amador,005,37829,4951,4850,48,4898,59
2021-09-18,Butte,007,227075,18604,17961,3277,21238,230
2021-09-18,Calaveras,009,45235,3468,3361,34,3395,66
2021-09-18,Colusa,011,21464,2399,2373,536,2909,16
2021-09-18,Contra Costa,013,1133247,94566,93656,1892,95548,924
2021-09-18,Del Norte,015,27424,3462,3326,25,3351,34
2021-09-18,El Dorado,017,186661,14762,14472,1498,15970,127
2021-09-18,Fresno,019,978130,127102,124771,11368,136139,1889
2021-09-18,Glenn,021,27897,3193,3086,911,3997,25
2021-09-18,Humboldt,023,135768,8050,7881,394,8275,80
2021-09-18,Imperial,025,180216,31345,31096,2937,34033,755
2021-09-18,Inyo,027,18085,1673,1636,31,1667,39
2021-09-18,Kern,029,883053,116927,114781,17877,132658,1459
2021-09-18,Kings,031,150075,28938,28330,1607,29937,285
2021-09-18,Lake,033,64148,6105,5936,119,6055,87
2021-09-18,Lassen,035,31185,6296,6121,263,6384,25
2021-09-18,Los Angeles,037,10098052,1393163,1379880,51070,1430950,25849
2021-09-18,Madera,039,155013,20643,20126,1624,21750,257
2021-09-18,Marin,041,260295,16867,16685,384,17069,242
2021-09-18,Mariposa,043,17540,924,871,32,903,5
2021-09-18,Mendocino,045,87422,6714,6523,322,6845,67
2021-09-18,Merced,047,269075,38333,37977,1471,39448,535
2021-09-18,Modoc,049,8938,466,457,159,616,5
2021-09-18,Mono,051,14174,1513,1480,17,1497,3
2021-09-18,Monterey,053,433212,47301,46466,2518,48984,565
2021-09-18,Napa,055,140530,12293,12168,84,12252,95
2021-09-18,Nevada,057,99092,8314,8183,269,8452,84
2021-09-18,Orange,059,3164182,296340,293005,13826,306831,5354
2021-09-18,Placer,061,380077,33928,33309,3157,36466,364
2021-09-18,Plumas,063,18699,1263,1204,24,1228,5
2021-09-18,Riverside,065,2383286,346363,341136,15674,356810,4802
2021-09-18,Sacramento,067,1510023,147446,146162,3666,149828,2016
2021-09-18,San Benito,069,59416,6948,6937,140,7077,67
2021-09-18,San Bernardino,071,2135413,339338,336380,10466,346846,5501
2021-09-18,San Diego,073,3302833,352722,348848,20778,369626,4006
2021-09-18,San Francisco,075,870044,50045,49359,2099,51458,605
2021-09-18,San Joaquin,077,732212,93507,92242,4914,97156,1615
2021-09-18,San Luis Obispo,079,281455,27694,27181,1078,28259,313
2021-09-18,San Mateo,081,765935,51783,50961,765,51726,567
2021-09-18,Santa Barbara,083,443738,41871,41465,1449,42914,500
2021-09-18,Santa Clara,085,1922200,140552,139233,1076,140309,1841
2021-09-18,Santa Cruz,087,273765,19334,19079,957,20036,211
2021-09-18,Shasta,089,179085,18330,17777,2958,20735,258
2021-09-18,Sierra,091,2930,129,125,13,138,0
2021-09-18,Siskiyou,093,43540,3021,2875,1032,3907,35
2021-09-18,Solano,095,438530,43835,42966,1118,44084,312
2021-09-18,Sonoma,097,501317,39177,38891,475,39366,369
2021-09-18,Stanislaus,099,539301,72065,71587,8031,79618,1091
2021-09-18,Sutter,101,95872,12949,12829,241,13070,153
2021-09-18,Tehama,103,63373,7251,7055,1168,8223,84
2021-09-18,Trinity,105,12862,715,561,189,750,7
2021-09-18,Tulare,107,460477,61673,60003,12400,72403,896
2021-09-18,Tuolumne,109,53932,6157,6069,73,6142,89
2021-09-18,Ventura,111,848112,94413,93424,4062,97486,1120
2021-09-18,Yolo,113,214977,18483,18213,848,19061,239
2021-09-18,Yuba,115,75493,9192,9061,201,9262,61
2021-09-17,Alameda,001,1643700,113862,113070,2539,115609,1320
2021-09-17,Alpine,003,1148,99,99,0,99,0
2021-09-17,Amador,005,37829,4935,4835,47,4882,58
2021-09-17,Butte,007,227075,18552,17870,3268,21138,230
2021-09-17,Calaveras,009,45235,3456,3338,33,3371,66
2021-09-17,Colusa,011,21464,2398,2369,531,2900,16
2021-09-17,Contra Costa,013,1133247,94464,93485,1889,95374,924
2021-09-17,Del Norte,015,27424,3457,3311,23,3334,34
2021-09-17,El Dorado,017,186661,14743,14421,1496,15917,127
2021-09-17,Fresno,019,978130,126883,124296,11352,135648,1882
2021-09-17,Glenn,021,27897,3176,3072,907,3979,25
2021-09-17,Humboldt,023,135768,8029,7850,394,8244,80
2021-09-17,Imperial,025,180216,31319,31031,2936,33967,755
2021-09-17,Inyo,027,18085,1665,1634,31,1665,39
2021-09-17,Kern,029,883053,116736,114303,17780,132083,1456
2021-09-17,Kings,031,150075,28873,28240,1605,29845,281
2021-09-17,Lake,033,64148,6092,5915,119,6034,87
2021-09-17,Lassen,035,31185,6281,6080,261,6341,25
2021-09-17,Los Angeles,037,10098052,1392184,1377905,51004,1428909,25820
2021-09-17,Madera,039,155013,20592,20040,1612,21652,257
2021-09-17,Marin,041,260295,16854,16658,382,17040,242
2021-09-17,Mariposa,043,17540,922,869,32,901,5
2021-09-17,Mendocino,045,87422,6695,6498,322,6820,67
2021-09-17,Merced,047,269075,38286,37803,1469,39272,533
2021-09-17,Modoc,049,8938,466,456,159,615,5
2021-09-17,Mono,051,14174,1509,1457,17,1474,3
2021-09-17,Monterey,053,433212,47278,46421,2517,48938,564
2021-09-17,Napa,055,140530,12272,12153,84,12237,95
2021-09-17,Nevada,057,99092,8299,8157,269,8426,84
2021-09-17,Orange,059,3164182,296121,292685,13808,306493,5346
2021-09-17,Placer,061,380077,33868,33188,3147,36335,362
2021-09-17,Plumas,063,18699,1254,1192,23,1215,5
2021-09-17,Riverside,065,2383286,345963,340445,15663,356108,4792
2021-09-17,Sacramento,067,1510023,147247,145985,3655,149640,1999
2021-09-17,San Benito,069,59416,6945,6929,140,7069,67
2021-09-17,San Bernardino,071,2135413,338978,335810,10459,346269,5488
2021-09-17,San Diego,073,3302833,352298,348098,20761,368859,4002
2021-09-17,San Francisco,075,870044,49993,49249,2094,51343,605
2021-09-17,San Joaquin,077,732212,93369,91977,4903,96880,1610
2021-09-17,San Luis Obispo,079,281455,27660,27102,1067,28169,311
2021-09-17,San Mateo,081,765935,51730,50854,764,51618,564
2021-09-17,Santa Barbara,083,443738,41808,41354,1448,42802,498
2021-09-17,Santa Clara,085,1922200,140403,138939,1075,140014,1838
2021-09-17,Santa Cruz,087,273765,19310,19039,957,19996,211
2021-09-17,Shasta,089,179085,18260,17617,2945,20562,254
2021-09-17,Sierra,091,2930,129,124,13,137,0
2021-09-17,Siskiyou,093,43540,3006,2852,1032,3884,35
2021-09-17,Solano,095,438530,43772,42898,1114,44012,312
2021-09-17,Sonoma,097,501317,39140,38808,474,39282,369
2021-09-17,Stanislaus,099,539301,71958,71408,8013,79421,1091
2021-09-17,Sutter,101,95872,12933,12799,238,13037,153
2021-09-17,Tehama,103,63373,7228,7020,1156,8176,84
2021-09-17,Trinity,105,12862,710,556,188,744,7
2021-09-17,Tulare,107,460477,61558,59689,12365,72054,895
2021-09-17,Tuolumne,109,53932,6138,6047,73,6120,89
2021-09-17,Ventura,111,848112,94301,93273,4060,97333,1116
2021-09-17,Yolo,113,214977,18452,18177,844,19021,239
2021-09-17,Yuba,115,75493,9165,9019,200,9219,61
2021-09-16,Alameda,001,1643700,113687,112770,2536,115306,1318
2021-09-16,Alpine,003,1148,99,99,0,99,0
2021-09-16,Amador,005,37829,4915,4819,47,4866,58
2021-09-16,Butte,007,227075,18477,17750,3252,21002,230
2021-09-16,Calaveras,009,45235,3425,3313,33,3346,66
2021-09-16,Colusa,011,21464,2396,2363,529,2892,16
2021-09-16,Contra Costa,013,1133247,94292,93213,1881,95094,917
2021-09-16,Del Norte,015,27424,3439,3285,23,3308,34
2021-09-16,El Dorado,017,186661,14702,14372,1488,15860,127
2021-09-16,Fresno,019,978130,126526,123853,11311,135164,1868
2021-09-16,Glenn,021,27897,3166,3068,905,3973,24
2021-09-16,Humboldt,023,135768,7996,7809,386,8195,80
2021-09-16,Imperial,025,180216,31276,30966,2928,33894,753
2021-09-16,Inyo,027,18085,1663,1623,31,1654,39
2021-09-16,Kern,029,883053,116464,113828,17713,131541,1448
2021-09-16,Kings,031,150075,28787,28114,1597,29711,280
2021-09-16,Lake,033,64148,6068,5890,116,6006,87
2021-09-16,Lassen,035,31185,6246,6028,256,6284,25
2021-09-16,Los Angeles,037,10098052,1390791,1376277,50939,1427216,25796
2021-09-16,Madera,039,155013,20514,19974,1607,21581,257
2021-09-16,Marin,041,260295,16827,16625,381,17006,242
2021-09-16,Mariposa,043,17540,916,849,32,881,6
2021-09-16,Mendocino,045,87422,6657,6445,311,6756,67
2021-09-16,Merced,047,269075,38179,37675,1467,39142,532
2021-09-16,Modoc,049,8938,464,455,159,614,5
2021-09-16,Mono,051,14174,1503,1449,17,1466,3
2021-09-16,Monterey,053,433212,47224,46342,2511,48853,562
2021-09-16,Napa,055,140530,12247,12115,80,12195,95
2021-09-16,Nevada,057,99092,8272,8121,268,8389,84
2021-09-16,Orange,059,3164182,295775,292183,13788,305971,5340
2021-09-16,Placer,061,380077,33772,33037,3127,36164,354
2021-09-16,Plumas,063,18699,1245,1178,23,1201,5
2021-09-16,Riverside,065,2383286,345433,339770,15649,355419,4786
2021-09-16,Sacramento,067,1510023,146891,145754,3623,149377,1996
2021-09-16,San Benito,069,59416,6933,6913,139,7052,67
2021-09-16,San Bernardino,071,2135413,338555,335129,10452,345581,5474
2021-09-16,San Diego,073,3302833,351684,347472,20722,368194,3994
2021-09-16,San Francisco,075,870044,49907,49133,2086,51219,605
2021-09-16,San Joaquin,077,732212,93131,91650,4860,96510,1608
2021-09-16,San Luis Obispo,079,281455,27587,27044,1063,28107,310
2021-09-16,San Mateo,081,765935,51653,50773,762,51535,564
2021-09-16,Santa Barbara,083,443738,41742,41272,1445,42717,497
2021-09-16,Santa Clara,085,1922200,140249,138685,1071,139756,1835
2021-09-16,Santa Cruz,087,273765,19283,19011,957,19968,211
2021-09-16,Shasta,089,179085,18135,17438,2912,20350,251
2021-09-16,Sierra,091,2930,129,123,13,136,0
2021-09-16,Siskiyou,093,43540,2986,2819,1025,3844,35
2021-09-16,Solano,095,438530,43700,42792,1105,43897,312
2021-09-16,Sonoma,097,501317,39077,38707,473,39180,369
2021-09-16,Stanislaus,099,539301,71725,71105,7997,79102,1091
2021-09-16,Sutter,101,95872,12889,12729,233,12962,152
2021-09-16,Tehama,103,63373,7188,6953,1145,8098,83
2021-09-16,Trinity,105,12862,707,547,187,734,7
2021-09-16,Tulare,107,460477,61336,59459,12292,71751,894
2021-09-16,Tuolumne,109,53932,6118,5999,72,6071,89
2021-09-16,Ventura,111,848112,94161,93087,4056,97143,1110
2021-09-16,Yolo,113,214977,18420,18135,842,18977,239
2021-09-16,Yuba,115,75493,9131,8981,197,9178,61
2021-09-15,Alameda,001,1643700,113522,112498,2529,115027,1317
2021-09-15,Alpine,003,1148,99,99,0,99,0
2021-09-15,Amador,005,37829,4907,4792,47,4839,58
2021-09-15,Butte,007,227075,18379,17664,3232,20896,228
2021-09-15,Calaveras,009,45235,3396,3293,31,3324,66
2021-09-15,Colusa,011,21464,2394,2352,526,2878,16
2021-09-15,Contra Costa,013,1133247,94111,92989,1870,94859,913
2021-09-15,Del Norte,015,27424,3426,3271,21,3292,34
2021-09-15,El Dorado,017,186661,14676,14309,1478,15787,127
2021-09-15,Fresno,019,978130,126147,123370,11255,134625,1867
2021-09-15,Glenn,021,27897,3154,3051,900,3951,20
2021-09-15,Humboldt,023,135768,7960,7754,381,8135,52
2021-09-15,Imperial,025,180216,31221,30891,2923,33814,753
2021-09-15,Inyo,027,18085,1659,1614,31,1645,39
2021-09-15,Kern,029,883053,116117,113546,17615,131161,1434
2021-09-15,Kings,031,150075,28708,27991,1589,29580,279
2021-09-15,Lake,033,64148,6035,5852,115,5967,85
2021-09-15,Lassen,035,31185,6186,6018,251,6269,25
2021-09-15,Los Angeles,037,10098052,1389290,1374307,50870,1425177,25767
2021-09-15,Madera,039,155013,20439,19880,1600,21480,257
2021-09-15,Marin,041,260295,16792,16592,376,16968,242
2021-09-15,Mariposa,043,17540,904,843,32,875,5
2021-09-15,Mendocino,045,87422,6627,6399,306,6705,66
2021-09-15,Merced,047,269075,38071,37508,1465,38973,529
2021-09-15,Modoc,049,8938,464,454,159,613,5
2021-09-15,Mono,051,14174,1497,1445,17,1462,3
2021-09-15,Monterey,053,433212,47154,46317,2500,48817,562
2021-09-15,Napa,055,140530,12226,12082,80,12162,95
2021-09-15,Nevada,057,99092,8250,8081,265,8346,84
2021-09-15,Orange,059,3164182,295451,291834,13769,305603,5328
2021-09-15,Placer,061,380077,33660,32860,3106,35966,352
2021-09-15,Plumas,063,18699,1240,1164,22,1186,5
2021-09-15,Riverside,065,2383286,344850,339077,15625,354702,4769
2021-09-15,Sacramento,067,1510023,146465,145202,3592,148794,1981
2021-09-15,San Benito,069,59416,6930,6902,139,7041,67
2021-09-15,San Bernardino,071,2135413,338092,334556,10438,344994,5470
2021-09-15,San Diego,073,3302833,351065,346933,20694,367627,3983
2021-09-15,San Francisco,075,870044,49796,48999,2081,51080,605
2021-09-15,San Joaquin,077,732212,92854,91322,4820,96142,1607
2021-09-15,San Luis Obispo,079,281455,27504,26943,1057,28000,306
2021-09-15,San Mateo,081,765935,51571,50691,759,51450,564
2021-09-15,Santa Barbara,083,443738,41639,41077,1440,42517,497
2021-09-15,Santa Clara,085,1922200,140075,138410,1066,139476,1833
2021-09-15,Santa Cruz,087,273765,19245,18984,955,19939,210
2021-09-15,Shasta,089,179085,18024,17317,2891,20208,250
2021-09-15,Sierra,091,2930,129,123,13,136,0
2021-09-15,Siskiyou,093,43540,2966,2804,995,3799,35
2021-09-15,Solano,095,438530,43628,42682,1100,43782,312
2021-09-15,Sonoma,097,501317,39020,38629,473,39102,369
2021-09-15,Stanislaus,099,539301,71501,70852,7975,78827,1091
2021-09-15,Sutter,101,95872,12856,12699,228,12927,151
2021-09-15,Tehama,103,63373,7147,6894,1136,8030,79
2021-09-15,Trinity,105,12862,705,541,185,726,7
2021-09-15,Tulare,107,460477,61077,59149,12231,71380,890
2021-09-15,Tuolumne,109,53932,6092,5969,72,6041,89
2021-09-15,Ventura,111,848112,94018,92960,4049,97009,1109
2021-09-15,Yolo,113,214977,18386,18064,836,18900,239
2021-09-15,Yuba,115,75493,9097,8953,197,9150,61
2021-09-14,Alameda,001,1643700,113314,112329,2526,114855,1316
2021-09-14,Alpine,003,1148,99,98,0,98,0
2021-09-14,Amador,005,37829,4887,4790,47,4837,57
2021-09-14,Butte,007,227075,18245,17516,3208,20724,226
2021-09-14,Calaveras,009,45235,3376,3280,28,3308,66
2021-09-14,Colusa,011,21464,2390,2344,523,2867,16
2021-09-14,Contra Costa,013,1133247,93913,92822,1862,94684,908
2021-09-14,Del Norte,015,27424,3410,3252,21,3273,32
2021-09-14,El Dorado,017,186661,14623,14247,1470,15717,123
2021-09-14,Fresno,019,978130,125672,123151,11203,134354,1856
2021-09-14,Glenn,021,27897,3137,3045,896,3941,20
2021-09-14,Humboldt,023,135768,7926,7717,376,8093,52
2021-09-14,Imperial,025,180216,31172,30845,2920,33765,752
2021-09-14,Inyo,027,18085,1650,1605,30,1635,39
2021-09-14,Kern,029,883053,115734,113250,17492,130742,1428
2021-09-14,Kings,031,150075,28632,27955,1581,29536,278
2021-09-14,Lake,033,64148,6003,5845,115,5960,83
2021-09-14,Lassen,035,31185,6172,5977,246,6223,25
2021-09-14,Los Angeles,037,10098052,1387453,1372831,50788,1423619,25729
2021-09-14,Madera,039,155013,20357,19800,1589,21389,254
2021-09-14,Marin,041,260295,16764,16584,374,16958,242
2021-09-14,Mariposa,043,17540,893,834,31,865,5
2021-09-14,Mendocino,045,87422,6591,6372,295,6667,65
2021-09-14,Merced,047,269075,37921,37430,1461,38891,526
2021-09-14,Modoc,049,8938,463,453,159,612,5
2021-09-14,Mono,051,14174,1493,1440,17,1457,4
2021-09-14,Monterey,053,433212,47113,46224,2489,48713,558
2021-09-14,Napa,055,140530,12193,12070,79,12149,91
2021-09-14,Nevada,057,99092,8216,8056,265,8321,83
2021-09-14,Orange,059,3164182,295058,291423,13745,305168,5319
2021-09-14,Placer,061,380077,33528,32735,3086,35821,350
2021-09-14,Plumas,063,18699,1225,1148,22,1170,5
2021-09-14,Riverside,065,2383286,344209,338534,15594,354128,4748
2021-09-14,Sacramento,067,1510023,146080,145051,3544,148595,1977
2021-09-14,San Benito,069,59416,6920,6887,139,7026,64
2021-09-14,San Bernardino,071,2135413,337594,333968,10413,344381,5465
2021-09-14,San Diego,073,3302833,350405,346204,20643,366847,3966
2021-09-14,San Francisco,075,870044,49662,48998,2079,51077,603
2021-09-14,San Joaquin,077,732212,92615,91128,4811,95939,1596
2021-09-14,San Luis Obispo,079,281455,27431,26845,1052,27897,304
2021-09-14,San Mateo,081,765935,51474,50602,756,51358,564
2021-09-14,Santa Barbara,083,443738,41543,40783,1431,42214,495
2021-09-14,Santa Clara,085,1922200,139840,138321,1063,139384,1828
2021-09-14,Santa Cruz,087,273765,19205,18965,953,19918,210
2021-09-14,Shasta,089,179085,17893,17152,2870,20022,246
2021-09-14,Sierra,091,2930,129,123,13,136,0
2021-09-14,Siskiyou,093,43540,2942,2756,978,3734,35
2021-09-14,Solano,095,438530,43545,42599,1097,43696,307
2021-09-14,Sonoma,097,501317,38951,38595,469,39064,369
2021-09-14,Stanislaus,099,539301,71241,70697,7947,78644,1091
2021-09-14,Sutter,101,95872,12814,12670,221,12891,149
2021-09-14,Tehama,103,63373,7093,6859,1128,7987,80
2021-09-14,Trinity,105,12862,699,538,184,722,7
2021-09-14,Tulare,107,460477,60824,58961,12160,71121,888
2021-09-14,Tuolumne,109,53932,6071,5951,70,6021,89
2021-09-14,Ventura,111,848112,93833,92841,4032,96873,1107
2021-09-14,Yolo,113,214977,18342,18039,831,18870,239
2021-09-14,Yuba,115,75493,9061,8928,197,9125,61
2021-09-13,Alameda,001,1643700,113100,112159,2521,114680,1309
2021-09-13,Alpine,003,1148,98,98,0,98,0
2021-09-13,Amador,005,37829,4869,4761,47,4808,56
2021-09-13,Butte,007,227075,18120,17393,3180,20573,225
2021-09-13,Calaveras,009,45235,3350,3253,27,3280,65
2021-09-13,Colusa,011,21464,2381,2346,519,2865,16
2021-09-13,Contra Costa,013,1133247,93668,92658,1857,94515,908
2021-09-13,Del Norte,015,27424,3374,3232,21,3253,28
2021-09-13,El Dorado,017,186661,14562,14194,1462,15656,119
2021-09-13,Fresno,019,978130,125205,122650,11137,133787,1853
2021-09-13,Glenn,021,27897,3123,3026,890,3916,20
2021-09-13,Humboldt,023,135768,7893,7659,373,8032,52
2021-09-13,Imperial,025,180216,31119,30802,2917,33719,751
2021-09-13,Inyo,027,18085,1643,1602,30,1632,39
2021-09-13,Kern,029,883053,115351,112930,17370,130300,1424
2021-09-13,Kings,031,150075,28522,27858,1569,29427,275
2021-09-13,Lake,033,64148,5981,5809,115,5924,82
2021-09-13,Lassen,035,31185,6137,5953,245,6198,25
2021-09-13,Los Angeles,037,10098052,1385589,1371423,50721,1422144,25703
2021-09-13,Madera,039,155013,20287,19735,1574,21309,252
2021-09-13,Marin,041,260295,16728,16557,373,16930,242
2021-09-13,Mariposa,043,17540,879,825,31,856,5
2021-09-13,Mendocino,045,87422,6556,6323,286,6609,61
2021-09-13,Merced,047,269075,37771,37291,1456,38747,521
2021-09-13,Modoc,049,8938,462,451,159,610,5
2021-09-13,Mono,051,14174,1487,1435,17,1452,3
2021-09-13,Monterey,053,433212,47022,46188,2476,48664,558
2021-09-13,Napa,055,140530,12175,12039,79,12118,91
2021-09-13,Nevada,057,99092,8190,8021,263,8284,83
2021-09-13,Orange,059,3164182,294626,291128,13724,304852,5312
2021-09-13,Placer,061,380077,33363,32617,3069,35686,343
2021-09-13,Plumas,063,18699,1216,1142,22,1164,5
2021-09-13,Riverside,065,2383286,343564,337876,15576,353452,4731
2021-09-13,Sacramento,067,1510023,145593,144537,3511,148048,1956
2021-09-13,San Benito,069,59416,6905,6867,138,7005,64
2021-09-13,San Bernardino,071,2135413,337103,333613,10388,344001,5441
2021-09-13,San Diego,073,3302833,349618,345647,20591,366238,3961
2021-09-13,San Francisco,075,870044,49533,48914,2073,50987,603
2021-09-13,San Joaquin,077,732212,92330,90966,4793,95759,1581
2021-09-13,San Luis Obispo,079,281455,27334,26805,1049,27854,300
2021-09-13,San Mateo,081,765935,51382,50525,751,51276,564
2021-09-13,Santa Barbara,083,443738,41424,40661,1424,42085,494
2021-09-13,Santa Clara,085,1922200,139595,138152,1058,139210,1820
2021-09-13,Santa Cruz,087,273765,19165,18917,952,19869,210
2021-09-13,Shasta,089,179085,17763,17033,2830,19863,243
2021-09-13,Sierra,091,2930,129,123,13,136,0
2021-09-13,Siskiyou,093,43540,2927,2745,966,3711,35
2021-09-13,Solano,095,438530,43441,42501,1094,43595,306
2021-09-13,Sonoma,097,501317,38884,38513,466,38979,368
2021-09-13,Stanislaus,099,539301,70987,70477,7911,78388,1091
2021-09-13,Sutter,101,95872,12756,12624,217,12841,145
2021-09-13,Tehama,103,63373,7030,6803,1116,7919,79
2021-09-13,Trinity,105,12862,697,533,182,715,7
2021-09-13,Tulare,107,460477,60541,58768,12100,70868,887
2021-09-13,Tuolumne,109,53932,6040,5909,70,5979,89
2021-09-13,Ventura,111,848112,93671,92679,4025,96704,1107
2021-09-13,Yolo,113,214977,18297,17974,825,18799,239
2021-09-13,Yuba,115,75493,9016,8884,196,9080,61
2021-09-12,Alameda,001,1643700,112838,111961,2518,114479,1309
2021-09-12,Alpine,003,1148,98,98,0,98,0
2021-09-12,Amador,005,37829,4848,4752,47,4799,56
2021-09-12,Butte,007,227075,17975,17257,3132,20389,221
2021-09-12,Calaveras,009,45235,3319,3236,23,3259,65
2021-09-12,Colusa,011,21464,2378,2344,518,2862,16
2021-09-12,Contra Costa,013,1133247,93400,92498,1845,94343,908
2021-09-12,Del Norte,015,27424,3339,3200,21,3221,28
2021-09-12,El Dorado,017,186661,14489,14167,1446,15613,119
2021-09-12,Fresno,019,978130,124688,122407,11080,133487,1853
2021-09-12,Glenn,021,27897,3106,3016,884,3900,20
2021-09-12,Humboldt,023,135768,7823,7636,362,7998,52
2021-09-12,Imperial,025,180216,31056,30790,2912,33702,751
2021-09-12,Inyo,027,18085,1633,1596,30,1626,39
2021-09-12,Kern,029,883053,114939,112602,17211,129813,1424
2021-09-12,Kings,031,150075,28411,27764,1552,29316,274
2021-09-12,Lake,033,64148,5941,5781,113,5894,82
2021-09-12,Lassen,035,31185,6100,5943,236,6179,25
2021-09-12,Los Angeles,037,10098052,1383530,1365968,50649,1416617,25630
2021-09-12,Madera,039,155013,20200,19691,1562,21253,252
2021-09-12,Marin,041,260295,16705,16526,373,16899,242
2021-09-12,Mariposa,043,17540,868,811,29,840,5
2021-09-12,Mendocino,045,87422,6516,6283,277,6560,61
2021-09-12,Merced,047,269075,37599,37172,1445,38617,521
2021-09-12,Modoc,049,8938,462,451,158,609,5
2021-09-12,Mono,051,14174,1480,1431,17,1448,3
2021-09-12,Monterey,053,433212,46923,46167,2466,48633,558
2021-09-12,Napa,055,140530,12145,12011,79,12090,91
2021-09-12,Nevada,057,99092,8150,7987,262,8249,83
2021-09-12,Orange,059,3164182,294162,290718,13703,304421,5312
2021-09-12,Placer,061,380077,33214,32520,3047,35567,343
2021-09-12,Plumas,063,18699,1197,1138,22,1160,5
2021-09-12,Riverside,065,2383286,342880,337332,15542,352874,4731
2021-09-12,Sacramento,067,1510023,145087,144030,3472,147502,1959
2021-09-12,San Benito,069,59416,6886,6852,137,6989,64
2021-09-12,San Bernardino,071,2135413,336492,333049,10375,343424,5439
2021-09-12,San Diego,073,3302833,348808,345058,20515,365573,3942
2021-09-12,San Francisco,075,870044,49422,48819,2066,50885,603
2021-09-12,San Joaquin,077,732212,92001,90730,4785,95515,1581
2021-09-12,San Luis Obispo,079,281455,27215,26729,1036,27765,299
2021-09-12,San Mateo,081,765935,51272,50432,747,51179,564
2021-09-12,Santa Barbara,083,443738,41312,40600,1417,42017,494
2021-09-12,Santa Clara,085,1922200,139338,137899,1055,138954,1820
2021-09-12,Santa Cruz,087,273765,19132,18892,951,19843,210
2021-09-12,Shasta,089,179085,17598,16957,2772,19729,243
2021-09-12,Sierra,091,2930,129,123,13,136,0
2021-09-12,Siskiyou,093,43540,2899,2730,951,3681,35
2021-09-12,Solano,095,438530,43335,42409,1091,43500,306
2021-09-12,Sonoma,097,501317,38804,38456,464,38920,368
2021-09-12,Stanislaus,099,539301,70688,70184,7872,78056,1091
2021-09-12,Sutter,101,95872,12714,12589,211,12800,145
2021-09-12,Tehama,103,63373,6966,6732,1104,7836,79
2021-09-12,Trinity,105,12862,693,529,180,709,7
2021-09-12,Tulare,107,460477,60188,58582,12040,70622,887
2021-09-12,Tuolumne,109,53932,6007,5888,70,5958,89
2021-09-12,Ventura,111,848112,93544,92496,4019,96515,1107
2021-09-12,Yolo,113,214977,18231,17943,817,18760,239
2021-09-12,Yuba,115,75493,8981,8842,196,9038,61
2021-09-11,Alameda,001,1643700,112714,111715,2516,114231,1309
2021-09-11,Alpine,003,1148,98,98,0,98,0
2021-09-11,Amador,005,37829,4835,4728,46,4774,56
2021-09-11,Butte,007,227075,17892,17218,3105,20323,221
2021-09-11,Calaveras,009,45235,3311,3208,22,3230,65
2021-09-11,Colusa,011,21464,2377,2338,515,2853,16
2021-09-11,Contra Costa,013,1133247,93281,92269,1841,94110,908
2021-09-11,Del Norte,015,27424,3323,3184,21,3205,28
2021-09-11,El Dorado,017,186661,14470,14117,1439,15556,119
2021-09-11,Fresno,019,978130,124509,122224,11055,133279,1853
2021-09-11,Glenn,021,27897,3096,3007,881,3888,20
2021-09-11,Humboldt,023,135768,7801,7615,359,7974,52
2021-09-11,Imperial,025,180216,31031,30760,2909,33669,751
2021-09-11,Inyo,027,18085,1630,1590,30,1620,39
2021-09-11,Kern,029,883053,114689,112205,17097,129302,1424
2021-09-11,Kings,031,150075,28362,27631,1546,29177,275
2021-09-11,Lake,033,64148,5920,5761,113,5874,82
2021-09-11,Lassen,035,31185,6085,5930,232,6162,25
2021-09-11,Los Angeles,037,10098052,1382558,1365831,50585,1416416,25630
2021-09-11,Madera,039,155013,20147,19648,1557,21205,252
2021-09-11,Marin,041,260295,16677,16496,372,16868,242
2021-09-11,Mariposa,043,17540,863,799,29,828,5
2021-09-11,Mendocino,045,87422,6492,6257,277,6534,61
2021-09-11,Merced,047,269075,37545,37042,1442,38484,521
2021-09-11,Modoc,049,8938,462,449,158,607,5
2021-09-11,Mono,051,14174,1474,1431,17,1448,3
2021-09-11,Monterey,053,433212,46886,46140,2463,48603,558
2021-09-11,Napa,055,140530,12122,11991,79,12070,91
2021-09-11,Nevada,057,99092,8135,7967,262,8229,83
2021-09-11,Orange,059,3164182,293860,290429,13687,304116,5306
2021-09-11,Placer,061,380077,33131,32414,3036,35450,344
2021-09-11,Plumas,063,18699,1190,1112,22,1134,5
2021-09-11,Riverside,065,2383286,342442,336585,15529,352114,4731
2021-09-11,Sacramento,067,1510023,144786,143557,3460,147017,1955
2021-09-11,San Benito,069,59416,6873,6844,137,6981,64
2021-09-11,San Bernardino,071,2135413,336149,332512,10361,342873,5430
2021-09-11,San Diego,073,3302833,348324,344355,20491,364846,3942
2021-09-11,San Francisco,075,870044,49367,48660,2061,50721,603
2021-09-11,San Joaquin,077,732212,91858,90482,4778,95260,1581
2021-09-11,San Luis Obispo,079,281455,27169,26651,1035,27686,299
2021-09-11,San Mateo,081,765935,51200,50341,746,51087,564
2021-09-11,Santa Barbara,083,443738,41239,40451,1417,41868,494
2021-09-11,Santa Clara,085,1922200,139185,137659,1052,138711,1820
2021-09-11,Santa Cruz,087,273765,19103,18865,951,19816,210
2021-09-11,Shasta,089,179085,17504,16877,2752,19629,243
2021-09-11,Sierra,091,2930,129,123,13,136,0
2021-09-11,Siskiyou,093,43540,2882,2717,948,3665,35
2021-09-11,Solano,095,438530,43284,42344,1088,43432,306
2021-09-11,Sonoma,097,501317,38757,38399,462,38861,368
2021-09-11,Stanislaus,099,539301,70563,69974,7859,77833,1091
2021-09-11,Sutter,101,95872,12688,12538,208,12746,145
2021-09-11,Tehama,103,63373,6945,6703,1096,7799,79
2021-09-11,Trinity,105,12862,686,526,180,706,7
2021-09-11,Tulare,107,460477,60076,58321,11994,70315,889
2021-09-11,Tuolumne,109,53932,5988,5879,67,5946,89
2021-09-11,Ventura,111,848112,93462,92328,4014,96342,1107
2021-09-11,Yolo,113,214977,18207,17906,813,18719,239
2021-09-11,Yuba,115,75493,8956,8813,196,9009,61
2021-09-10,Alameda,001,1643700,112523,111386,2515,113901,1306
2021-09-10,Alpine,003,1148,97,97,0,97,0
2021-09-10,Amador,005,37829,4823,4706,46,4752,56
2021-09-10,Butte,007,227075,17817,17051,3087,20138,222
2021-09-10,Calaveras,009,45235,3303,3183,22,3205,65
2021-09-10,Colusa,011,21464,2373,2327,512,2839,16
2021-09-10,Contra Costa,013,1133247,93158,92024,1839,93863,908
2021-09-10,Del Norte,015,27424,3308,3128,20,3148,28
2021-09-10,El Dorado,017,186661,14440,14051,1435,15486,119
2021-09-10,Fresno,019,978130,124186,121659,11026,132685,1846
2021-09-10,Glenn,021,27897,3089,2977,880,3857,20
2021-09-10,Humboldt,023,135768,7769,7543,355,7898,52
2021-09-10,Imperial,025,180216,31008,30716,2907,33623,751
2021-09-10,Inyo,027,18085,1626,1590,30,1620,39
2021-09-10,Kern,029,883053,114435,111832,16981,128813,1419
2021-09-10,Kings,031,150075,28288,27473,1539,29012,274
2021-09-10,Lake,033,64148,5904,5713,111,5824,79
2021-09-10,Lassen,035,31185,6077,5914,229,6143,25
2021-09-10,Los Angeles,037,10098052,1381355,1365709,50520,1416229,25630
2021-09-10,Madera,039,155013,20101,19520,1550,21070,252
2021-09-10,Marin,041,260295,16657,16458,369,16827,242
2021-09-10,Mariposa,043,17540,858,795,29,824,5
2021-09-10,Mendocino,045,87422,6460,6184,276,6460,61
2021-09-10,Merced,047,269075,37493,36884,1441,38325,521
2021-09-10,Modoc,049,8938,462,448,158,606,5
2021-09-10,Mono,051,14174,1469,1422,17,1439,3
2021-09-10,Monterey,053,433212,46842,46084,2461,48545,557
2021-09-10,Napa,055,140530,12097,11948,79,12027,90
2021-09-10,Nevada,057,99092,8117,7932,261,8193,83
2021-09-10,Orange,059,3164182,293552,290022,13677,303699,5302
2021-09-10,Placer,061,380077,33029,32264,3023,35287,343
2021-09-10,Plumas,063,18699,1182,1111,22,1133,5
2021-09-10,Riverside,065,2383286,341969,335988,15522,351510,4720
2021-09-10,Sacramento,067,1510023,144443,143244,3452,146696,1950
2021-09-10,San Benito,069,59416,6869,6824,137,6961,64
2021-09-10,San Bernardino,071,2135413,335730,331894,10352,342246,5422
2021-09-10,San Diego,073,3302833,347777,343173,20454,363627,3941
2021-09-10,San Francisco,075,870044,49288,48518,2054,50572,602
2021-09-10,San Joaquin,077,732212,91678,90208,4772,94980,1573
2021-09-10,San Luis Obispo,079,281455,27136,26526,1033,27559,299
2021-09-10,San Mateo,081,765935,51133,50251,745,50996,564
2021-09-10,Santa Barbara,083,443738,41186,40321,1414,41735,492
2021-09-10,Santa Clara,085,1922200,139001,137337,1051,138388,1817
2021-09-10,Santa Cruz,087,273765,19084,18785,950,19735,210
2021-09-10,Shasta,089,179085,17410,16667,2724,19391,242
2021-09-10,Sierra,091,2930,129,117,13,130,0
2021-09-10,Siskiyou,093,43540,2870,2702,944,3646,35
2021-09-10,Solano,095,438530,43210,42230,1081,43311,305
2021-09-10,Sonoma,097,501317,38699,38271,461,38732,368
2021-09-10,Stanislaus,099,539301,70407,69617,7835,77452,1091
2021-09-10,Sutter,101,95872,12654,12468,208,12676,145
2021-09-10,Tehama,103,63373,6912,6652,1090,7742,77
2021-09-10,Trinity,105,12862,682,524,180,704,7
2021-09-10,Tulare,107,460477,59928,57930,11947,69877,883
2021-09-10,Tuolumne,109,53932,5969,5842,67,5909,89
2021-09-10,Ventura,111,848112,93365,92145,4010,96155,1104
2021-09-10,Yolo,113,214977,18182,17825,808,18633,239
2021-09-10,Yuba,115,75493,8937,8760,195,8955,62
2021-09-09,Alameda,001,1643700,112304,111014,2511,113525,1306
2021-09-09,Alpine,003,1148,97,94,0,94,0
2021-09-09,Amador,005,37829,4802,4698,45,4743,56
2021-09-09,Butte,007,227075,17670,16874,3060,19934,221
2021-09-09,Calaveras,009,45235,3269,3165,22,3187,65
2021-09-09,Colusa,011,21464,2366,2321,511,2832,16
2021-09-09,Contra Costa,013,1133247,92948,91687,1834,93521,904
2021-09-09,Del Norte,015,27424,3285,3102,20,3122,28
2021-09-09,El Dorado,017,186661,14383,13970,1425,15395,119
2021-09-09,Fresno,019,978130,123710,121040,10980,132020,1838
2021-09-09,Glenn,021,27897,3077,2947,876,3823,20
2021-09-09,Humboldt,023,135768,7719,7471,349,7820,52
2021-09-09,Imperial,025,180216,30970,30661,2904,33565,751
2021-09-09,Inyo,027,18085,1619,1586,30,1616,39
2021-09-09,Kern,029,883053,114088,111390,16825,128215,1414
2021-09-09,Kings,031,150075,28187,27282,1528,28810,273
2021-09-09,Lake,033,64148,5880,5638,109,5747,79
2021-09-09,Lassen,035,31185,6027,5860,223,6083,25
2021-09-09,Los Angeles,037,10098052,1379488,1363735,50446,1414181,25583
2021-09-09,Madera,039,155013,20028,19401,1537,20938,252
2021-09-09,Marin,041,260295,16634,16416,366,16782,242
2021-09-09,Mariposa,043,17540,845,779,28,807,5
2021-09-09,Mendocino,045,87422,6426,6089,267,6356,61
2021-09-09,Merced,047,269075,37339,36634,1428,38062,516
2021-09-09,Modoc,049,8938,462,448,158,606,5
2021-09-09,Mono,051,14174,1459,1420,17,1437,3
2021-09-09,Monterey,053,433212,46788,45991,2450,48441,556
2021-09-09,Napa,055,140530,12065,11878,79,11957,90
2021-09-09,Nevada,057,99092,8079,7855,261,8116,82
2021-09-09,Orange,059,3164182,293143,289109,13646,302755,5299
2021-09-09,Placer,061,380077,32911,32048,3008,35056,342
2021-09-09,Plumas,063,18699,1171,1098,22,1120,5
2021-09-09,Riverside,065,2383286,341330,334774,15504,350278,4701
2021-09-09,Sacramento,067,1510023,143964,142728,3407,146135,1929
2021-09-09,San Benito,069,59416,6859,6820,136,6956,64
2021-09-09,San Bernardino,071,2135413,335159,331040,10339,341379,5417
2021-09-09,San Diego,073,3302833,347063,342149,20397,362546,3929
2021-09-09,San Francisco,075,870044,49174,48404,2045,50449,597
2021-09-09,San Joaquin,077,732212,91405,89874,4754,94628,1570
2021-09-09,San Luis Obispo,079,281455,27054,26472,1030,27502,296
2021-09-09,San Mateo,081,765935,51012,50143,742,50885,561
2021-09-09,Santa Barbara,083,443738,41080,40180,1410,41590,490
2021-09-09,Santa Clara,085,1922200,138778,137017,1046,138063,1816
2021-09-09,Santa Cruz,087,273765,19038,18728,950,19678,210
2021-09-09,Shasta,089,179085,17264,16401,2683,19084,238
2021-09-09,Sierra,091,2930,129,115,13,128,0
2021-09-09,Siskiyou,093,43540,2847,2683,930,3613,35
2021-09-09,Solano,095,438530,43094,42081,1077,43158,303
2021-09-09,Sonoma,097,501317,38631,38171,460,38631,360
2021-09-09,Stanislaus,099,539301,70127,69178,7803,76981,1074
2021-09-09,Sutter,101,95872,12599,12396,206,12602,144
2021-09-09,Tehama,103,63373,6858,6554,1085,7639,75
2021-09-09,Trinity,105,12862,676,523,178,701,6
2021-09-09,Tulare,107,460477,59686,57564,11888,69452,879
2021-09-09,Tuolumne,109,53932,5941,5802,66,5868,89
2021-09-09,Ventura,111,848112,93220,91610,4001,95611,1098
2021-09-09,Yolo,113,214977,18125,17724,805,18529,239
2021-09-09,Yuba,115,75493,8892,8707,192,8899,55
2021-09-08,Alameda,001,1643700,112059,110781,2509,113290,1305
2021-09-08,Alpine,003,1148,97,94,0,94,0
2021-09-08,Amador,005,37829,4790,4693,45,4738,56
2021-09-08,Butte,007,227075,17535,16775,3041,19816,220
2021-09-08,Calaveras,009,45235,3251,3157,22,3179,63
2021-09-08,Colusa,011,21464,2364,2308,511,2819,16
2021-09-08,Contra Costa,013,1133247,92668,91471,1829,93300,900
2021-09-08,Del Norte,015,27424,3262,3085,20,3105,25
2021-09-08,El Dorado,017,186661,14303,13928,1405,15333,119
2021-09-08,Fresno,019,978130,123213,120644,10917,131561,1831
2021-09-08,Glenn,021,27897,3062,2942,867,3809,20
2021-09-08,Humboldt,023,135768,7674,7438,341,7779,52
2021-09-08,Imperial,025,180216,30937,30609,2891,33500,751
2021-09-08,Inyo,027,18085,1608,1580,30,1610,39
2021-09-08,Kern,029,883053,113690,110933,16687,127620,1409
2021-09-08,Kings,031,150075,28058,27235,1514,28749,267
2021-09-08,Lake,033,64148,5849,5618,107,5725,79
2021-09-08,Lassen,035,31185,6009,5848,216,6064,25
2021-09-08,Los Angeles,037,10098052,1377419,1362029,50358,1412387,25533
2021-09-08,Madera,039,155013,19968,19352,1524,20876,252
2021-09-08,Marin,041,260295,16606,16386,365,16751,242
2021-09-08,Mariposa,043,17540,833,777,27,804,5
2021-09-08,Mendocino,045,87422,6382,6069,258,6327,61
2021-09-08,Merced,047,269075,37178,36500,1416,37916,516
2021-09-08,Modoc,049,8938,462,448,158,606,5
2021-09-08,Mono,051,14174,1453,1418,17,1435,3
2021-09-08,Monterey,053,433212,46739,45959,2444,48403,554
2021-09-08,Napa,055,140530,12030,11842,77,11919,90
2021-09-08,Nevada,057,99092,8044,7843,260,8103,82
2021-09-08,Orange,059,3164182,292734,288511,13623,302134,5290
2021-09-08,Placer,061,380077,32774,31852,2991,34843,337
2021-09-08,Plumas,063,18699,1164,1072,22,1094,5
2021-09-08,Riverside,065,2383286,340571,334037,15479,349516,4683
2021-09-08,Sacramento,067,1510023,143485,142448,3359,145807,1921
2021-09-08,San Benito,069,59416,6841,6800,136,6936,64
2021-09-08,San Bernardino,071,2135413,334553,330279,10322,340601,5411
2021-09-08,San Diego,073,3302833,346146,341437,20346,361783,3926
2021-09-08,San Francisco,075,870044,49036,48263,2041,50304,589
2021-09-08,San Joaquin,077,732212,91125,89631,4730,94361,1561
2021-09-08,San Luis Obispo,079,281455,26960,26303,1025,27328,294
2021-09-08,San Mateo,081,765935,50907,50051,742,50793,561
2021-09-08,Santa Barbara,083,443738,40968,40000,1406,41406,490
2021-09-08,Santa Clara,085,1922200,138545,136836,1042,137878,1810
2021-09-08,Santa Cruz,087,273765,19001,18699,950,19649,210
2021-09-08,Shasta,089,179085,17109,16227,2636,18863,234
2021-09-08,Sierra,091,2930,129,113,13,126,0
2021-09-08,Siskiyou,093,43540,2814,2643,919,3562,35
2021-09-08,Solano,095,438530,43002,41971,1074,43045,302
2021-09-08,Sonoma,097,501317,38547,38075,459,38534,360
2021-09-08,Stanislaus,099,539301,69895,68945,7764,76709,1074
2021-09-08,Sutter,101,95872,12534,12349,203,12552,144
2021-09-08,Tehama,103,63373,6791,6520,1067,7587,75
2021-09-08,Trinity,105,12862,673,520,174,694,6
2021-09-08,Tulare,107,460477,59362,57425,11833,69258,876
2021-09-08,Tuolumne,109,53932,5909,5783,64,5847,89
2021-09-08,Ventura,111,848112,93068,91345,3983,95328,1096
2021-09-08,Yolo,113,214977,18044,17680,800,18480,239
2021-09-08,Yuba,115,75493,8850,8675,190,8865,55
2021-09-07,Alameda,001,1643700,111758,110550,2502,113052,1301
2021-09-07,Alpine,003,1148,96,94,0,94,0
2021-09-07,Amador,005,37829,4763,4679,45,4724,53
2021-09-07,Butte,007,227075,17379,16723,3004,19727,220
2021-09-07,Calaveras,009,45235,3210,3140,20,3160,63
2021-09-07,Colusa,011,21464,2354,2306,509,2815,16
2021-09-07,Contra Costa,013,1133247,92404,91167,1823,92990,891
2021-09-07,Del Norte,015,27424,3248,3081,20,3101,24
2021-09-07,El Dorado,017,186661,14231,13892,1390,15282,119
2021-09-07,Fresno,019,978130,122655,120268,10824,131092,1828
2021-09-07,Glenn,021,27897,3050,2937,861,3798,20
2021-09-07,Humboldt,023,135768,7614,7397,324,7721,52
2021-09-07,Imperial,025,180216,30897,30584,2883,33467,751
2021-09-07,Inyo,027,18085,1602,1579,29,1608,39
2021-09-07,Kern,029,883053,113258,110674,16529,127203,1408
2021-09-07,Kings,031,150075,27934,27169,1496,28665,267
2021-09-07,Lake,033,64148,5806,5597,99,5696,78
2021-09-07,Lassen,035,31185,5991,5842,210,6052,21
2021-09-07,Los Angeles,037,10098052,1375189,1360407,50267,1410674,25486
2021-09-07,Madera,039,155013,19881,19316,1516,20832,249
2021-09-07,Marin,041,260295,16567,16363,365,16728,242
2021-09-07,Mariposa,043,17540,817,771,27,798,5
2021-09-07,Mendocino,045,87422,6322,6036,248,6284,61
2021-09-07,Merced,047,269075,37004,36400,1410,37810,513
2021-09-07,Modoc,049,8938,460,449,158,607,5
2021-09-07,Mono,051,14174,1444,1416,17,1433,3
2021-09-07,Monterey,053,433212,46656,45911,2432,48343,543
2021-09-07,Napa,055,140530,11989,11814,77,11891,90
2021-09-07,Nevada,057,99092,8017,7829,260,8089,82
2021-09-07,Orange,059,3164182,292305,288225,13592,301817,5274
2021-09-07,Placer,061,380077,32621,31710,2963,34673,337
2021-09-07,Plumas,063,18699,1149,1071,22,1093,5
2021-09-07,Riverside,065,2383286,339784,333390,15460,348850,4666
2021-09-07,Sacramento,067,1510023,142947,142364,3313,145677,1905
2021-09-07,San Benito,069,59416,6823,6786,136,6922,64
2021-09-07,San Bernardino,071,2135413,333804,329962,10297,340259,5407
2021-09-07,San Diego,073,3302833,345148,340709,20280,360989,3922
2021-09-07,San Francisco,075,870044,48896,48175,2036,50211,589
2021-09-07,San Joaquin,077,732212,90789,89468,4716,94184,1548
2021-09-07,San Luis Obispo,079,281455,26843,26253,1016,27269,287
2021-09-07,San Mateo,081,765935,50812,49913,741,50654,561
2021-09-07,Santa Barbara,083,443738,40842,39957,1401,41358,489
2021-09-07,Santa Clara,085,1922200,138257,136631,1037,137668,1807
2021-09-07,Santa Cruz,087,273765,18952,18669,948,19617,210
2021-09-07,Shasta,089,179085,16953,16096,2584,18680,226
2021-09-07,Sierra,091,2930,129,111,13,124,0
2021-09-07,Siskiyou,093,43540,2788,2607,902,3509,34
2021-09-07,Solano,095,438530,42872,41862,1070,42932,300
2021-09-07,Sonoma,097,501317,38463,38013,457,38470,358
2021-09-07,Stanislaus,099,539301,69624,68831,7737,76568,1074
2021-09-07,Sutter,101,95872,12460,12310,197,12507,138
2021-09-07,Tehama,103,63373,6739,6482,1047,7529,74
2021-09-07,Trinity,105,12862,667,517,174,691,6
2021-09-07,Tulare,107,460477,59012,57228,11755,68983,874
2021-09-07,Tuolumne,109,53932,5872,5759,64,5823,88
2021-09-07,Ventura,111,848112,92857,91246,3973,95219,1093
2021-09-07,Yolo,113,214977,17975,17653,795,18448,235
2021-09-07,Yuba,115,75493,8807,8642,185,8827,55
2021-09-06,Alameda,001,1643700,111447,110357,2494,112851,1301
2021-09-06,Alpine,003,1148,94,94,0,94,0
2021-09-06,Amador,005,37829,4747,4648,44,4692,53
2021-09-06,Butte,007,227075,17187,16588,2961,19549,218
2021-09-06,Calaveras,009,45235,3188,3122,20,3142,63
2021-09-06,Colusa,011,21464,2347,2306,505,2811,16
2021-09-06,Contra Costa,013,1133247,92108,90971,1813,92784,891
2021-09-06,Del Norte,015,27424,3207,3037,19,3056,24
2021-09-06,El Dorado,017,186661,14162,13848,1374,15222,119
2021-09-06,Fresno,019,978130,122082,119738,10749,130487,1828
2021-09-06,Glenn,021,27897,3021,2912,853,3765,20
2021-09-06,Humboldt,023,135768,7538,7320,306,7626,52
2021-09-06,Imperial,025,180216,30834,30576,2877,33453,751
2021-09-06,Inyo,027,18085,1593,1578,17,1595,39
2021-09-06,Kern,029,883053,112744,110347,16341,126688,1408
2021-09-06,Kings,031,150075,27791,27094,1481,28575,264
2021-09-06,Lake,033,64148,5742,5548,92,5640,78
2021-09-06,Lassen,035,31185,5965,5822,200,6022,21
2021-09-06,Los Angeles,037,10098052,1372814,1359348,50152,1409500,25477
2021-09-06,Madera,039,155013,19778,19191,1493,20684,249
2021-09-06,Marin,041,260295,16527,16356,365,16721,242
2021-09-06,Mariposa,043,17540,805,764,27,791,5
2021-09-06,Mendocino,045,87422,6252,5984,235,6219,61
2021-09-06,Merced,047,269075,36790,36300,1396,37696,513
2021-09-06,Modoc,049,8938,457,449,158,607,5
2021-09-06,Mono,051,14174,1440,1416,17,1433,3
2021-09-06,Monterey,053,433212,46562,45833,2416,48249,541
2021-09-06,Napa,055,140530,11946,11792,76,11868,90
2021-09-06,Nevada,057,99092,7969,7748,258,8006,82
2021-09-06,Orange,059,3164182,291811,287948,13541,301489,5274
2021-09-06,Placer,061,380077,32444,31595,2925,34520,337
2021-09-06,Plumas,063,18699,1128,1068,19,1087,5
2021-09-06,Riverside,065,2383286,338968,333052,15440,348492,4666
2021-09-06,Sacramento,067,1510023,142312,141730,3245,144975,1905
2021-09-06,San Benito,069,59416,6800,6777,133,6910,64
2021-09-06,San Bernardino,071,2135413,332918,329693,10267,339960,5398
2021-09-06,San Diego,073,3302833,344149,340222,20183,360405,3922
2021-09-06,San Francisco,075,870044,48761,48120,2031,50151,589
2021-09-06,San Joaquin,077,732212,90445,89293,4690,93983,1548
2021-09-06,San Luis Obispo,079,281455,26714,26183,1012,27195,286
2021-09-06,San Mateo,081,765935,50682,49859,739,50598,561
2021-09-06,Santa Barbara,083,443738,40711,39876,1392,41268,489
2021-09-06,Santa Clara,085,1922200,137965,136458,1035,137493,1807
2021-09-06,Santa Cruz,087,273765,18903,18615,945,19560,210
2021-09-06,Shasta,089,179085,16772,15985,2530,18515,226
2021-09-06,Sierra,091,2930,129,109,13,122,0
2021-09-06,Siskiyou,093,43540,2744,2595,868,3463,34
2021-09-06,Solano,095,438530,42724,41774,1064,42838,300
2021-09-06,Sonoma,097,501317,38342,37929,456,38385,358
2021-09-06,Stanislaus,099,539301,69282,68596,7693,76289,1074
2021-09-06,Sutter,101,95872,12398,12238,188,12426,138
2021-09-06,Tehama,103,63373,6677,6413,1020,7433,74
2021-09-06,Trinity,105,12862,664,515,172,687,6
2021-09-06,Tulare,107,460477,58653,57068,11675,68743,874
2021-09-06,Tuolumne,109,53932,5836,5697,64,5761,88
2021-09-06,Ventura,111,848112,92680,91132,3961,95093,1093
2021-09-06,Yolo,113,214977,17889,17576,790,18366,235
2021-09-06,Yuba,115,75493,8757,8584,181,8765,55
2021-09-05,Alameda,001,1643700,111254,110173,2491,112664,1301
2021-09-05,Alpine,003,1148,94,94,0,94,0
2021-09-05,Amador,005,37829,4735,4642,44,4686,53
2021-09-05,Butte,007,227075,17097,16504,2933,19437,218
2021-09-05,Calaveras,009,45235,3182,3106,20,3126,63
2021-09-05,Colusa,011,21464,2339,2305,503,2808,16
2021-09-05,Contra Costa,013,1133247,91923,90862,1808,92670,891
2021-09-05,Del Norte,015,27424,3187,3023,19,3042,24
2021-09-05,El Dorado,017,186661,14133,13827,1361,15188,119
2021-09-05,Fresno,019,978130,121783,119384,10708,130092,1828
2021-09-05,Glenn,021,27897,3007,2899,851,3750,20
2021-09-05,Humboldt,023,135768,7505,7312,303,7615,52
2021-09-05,Imperial,025,180216,30805,30548,2875,33423,751
2021-09-05,Inyo,027,18085,1590,1572,17,1589,39
2021-09-05,Kern,029,883053,112444,110073,16182,126255,1408
2021-09-05,Kings,031,150075,27714,26989,1477,28466,264
2021-09-05,Lake,033,64148,5722,5525,92,5617,78
2021-09-05,Lassen,035,31185,5943,5820,196,6016,21
2021-09-05,Los Angeles,037,10098052,1371519,1357748,50084,1407832,25465
2021-09-05,Madera,039,155013,19737,19155,1482,20637,249
2021-09-05,Marin,041,260295,16508,16342,364,16706,242
2021-09-05,Mariposa,043,17540,801,761,27,788,5
2021-09-05,Mendocino,045,87422,6218,5965,235,6200,61
2021-09-05,Merced,047,269075,36715,36243,1394,37637,513
2021-09-05,Modoc,049,8938,457,447,158,605,5
2021-09-05,Mono,051,14174,1440,1416,17,1433,3
2021-09-05,Monterey,053,433212,46534,45795,2407,48202,540
2021-09-05,Napa,055,140530,11921,11770,76,11846,90
2021-09-05,Nevada,057,99092,7947,7722,257,7979,82
2021-09-05,Orange,059,3164182,291523,287614,13524,301138,5274
2021-09-05,Placer,061,380077,32316,31487,2911,34398,337
2021-09-05,Plumas,063,18699,1121,1067,19,1086,5
2021-09-05,Riverside,065,2383286,338513,332604,15428,348032,4654
2021-09-05,Sacramento,067,1510023,141875,141276,3228,144504,1905
2021-09-05,San Benito,069,59416,6799,6764,133,6897,64
2021-09-05,San Bernardino,071,2135413,332534,329062,10251,339313,5392
2021-09-05,San Diego,073,3302833,343597,339427,20142,359569,3914
2021-09-05,San Francisco,075,870044,48683,48035,2027,50062,589
2021-09-05,San Joaquin,077,732212,90279,89121,4673,93794,1548
2021-09-05,San Luis Obispo,079,281455,26664,26098,1011,27109,285
2021-09-05,San Mateo,081,765935,50614,49809,735,50544,561
2021-09-05,Santa Barbara,083,443738,40644,39762,1390,41152,489
2021-09-05,Santa Clara,085,1922200,137755,136146,1033,137179,1807
2021-09-05,Santa Cruz,087,273765,18883,18588,943,19531,210
2021-09-05,Shasta,089,179085,16690,15960,2504,18464,226
2021-09-05,Sierra,091,2930,128,109,13,122,0
2021-09-05,Siskiyou,093,43540,2727,2585,854,3439,34
2021-09-05,Solano,095,438530,42629,41687,1059,42746,300
2021-09-05,Sonoma,097,501317,38257,37881,455,38336,358
2021-09-05,Stanislaus,099,539301,69142,68434,7669,76103,1074
2021-09-05,Sutter,101,95872,12368,12179,182,12361,138
2021-09-05,Tehama,103,63373,6650,6400,1014,7414,74
2021-09-05,Trinity,105,12862,658,505,171,676,6
2021-09-05,Tulare,107,460477,58484,56915,11631,68546,874
2021-09-05,Tuolumne,109,53932,5824,5688,64,5752,88
2021-09-05,Ventura,111,848112,92544,91004,3957,94961,1093
2021-09-05,Yolo,113,214977,17852,17557,785,18342,235
2021-09-05,Yuba,115,75493,8730,8521,179,8700,55
2021-09-04,Alameda,001,1643700,111131,109944,2484,112428,1301
2021-09-04,Alpine,003,1148,94,94,0,94,0
2021-09-04,Amador,005,37829,4717,4637,43,4680,53
2021-09-04,Butte,007,227075,17039,16403,2918,19321,218
2021-09-04,Calaveras,009,45235,3170,3087,19,3106,63
2021-09-04,Colusa,011,21464,2337,2301,503,2804,16
2021-09-04,Contra Costa,013,1133247,91806,90623,1805,92428,891
2021-09-04,Del Norte,015,27424,3176,2984,19,3003,24
2021-09-04,El Dorado,017,186661,14107,13782,1353,15135,119
2021-09-04,Fresno,019,978130,121588,119033,10687,129720,1828
2021-09-04,Glenn,021,27897,2997,2878,845,3723,20
2021-09-04,Humboldt,023,135768,7474,7298,297,7595,52
2021-09-04,Imperial,025,180216,30782,30526,2873,33399,751
2021-09-04,Inyo,027,18085,1588,1571,17,1588,39
2021-09-04,Kern,029,883053,112201,109751,16052,125803,1408
2021-09-04,Kings,031,150075,27627,26896,1471,28367,263
2021-09-04,Lake,033,64148,5704,5507,92,5599,78
2021-09-04,Lassen,035,31185,5928,5814,188,6002,21
2021-09-04,Los Angeles,037,10098052,1370564,1355634,50025,1405659,25454
2021-09-04,Madera,039,155013,19704,19112,1475,20587,249
2021-09-04,Marin,041,260295,16492,16319,363,16682,242
2021-09-04,Mariposa,043,17540,796,759,27,786,5
2021-09-04,Mendocino,045,87422,6182,5933,235,6168,61
2021-09-04,Merced,047,269075,36671,36083,1389,37472,513
2021-09-04,Modoc,049,8938,457,447,158,605,5
2021-09-04,Mono,051,14174,1437,1417,17,1434,3
2021-09-04,Monterey,053,433212,46503,45756,2403,48159,540
2021-09-04,Napa,055,140530,11896,11760,74,11834,90
2021-09-04,Nevada,057,99092,7932,7691,256,7947,82
2021-09-04,Orange,059,3164182,291260,287244,13503,300747,5274
2021-09-04,Placer,061,380077,32212,31374,2894,34268,337
2021-09-04,Plumas,063,18699,1113,1067,19,1086,5
2021-09-04,Riverside,065,2383286,338043,331958,15416,347374,4654
2021-09-04,Sacramento,067,1510023,141582,140735,3220,143955,1896
2021-09-04,San Benito,069,59416,6790,6758,133,6891,64
2021-09-04,San Bernardino,071,2135413,332202,328425,10237,338662,5393
2021-09-04,San Diego,073,3302833,343162,338748,20120,358868,3914
2021-09-04,San Francisco,075,870044,48608,47937,2019,49956,589
2021-09-04,San Joaquin,077,732212,90164,88846,4665,93511,1548
2021-09-04,San Luis Obispo,079,281455,26632,26020,1011,27031,285
2021-09-04,San Mateo,081,765935,50560,49721,735,50456,560
2021-09-04,Santa Barbara,083,443738,40578,39667,1388,41055,489
2021-09-04,Santa Clara,085,1922200,137570,135845,1030,136875,1806
2021-09-04,Santa Cruz,087,273765,18865,18579,939,19518,210
2021-09-04,Shasta,089,179085,16613,15924,2478,18402,226
2021-09-04,Sierra,091,2930,126,108,13,121,0
2021-09-04,Siskiyou,093,43540,2701,2563,843,3406,34
2021-09-04,Solano,095,438530,42556,41614,1057,42671,300
2021-09-04,Sonoma,097,501317,38224,37809,455,38264,358
2021-09-04,Stanislaus,099,539301,68995,68210,7644,75854,1074
2021-09-04,Sutter,101,95872,12327,12137,181,12318,138
2021-09-04,Tehama,103,63373,6625,6367,996,7363,74
2021-09-04,Trinity,105,12862,656,497,171,668,6
2021-09-04,Tulare,107,460477,58376,56719,11588,68307,874
2021-09-04,Tuolumne,109,53932,5805,5667,62,5729,88
2021-09-04,Ventura,111,848112,92409,90904,3954,94858,1090
2021-09-04,Yolo,113,214977,17816,17522,781,18303,235
2021-09-04,Yuba,115,75493,8701,8475,178,8653,55
2021-09-03,Alameda,001,1643700,110971,109636,2481,112117,1301
2021-09-03,Alpine,003,1148,94,94,0,94,0
2021-09-03,Amador,005,37829,4695,4614,43,4657,53
2021-09-03,Butte,007,227075,16948,16259,2892,19151,215
2021-09-03,Calaveras,009,45235,3160,3069,19,3088,63
2021-09-03,Colusa,011,21464,2332,2295,502,2797,16
2021-09-03,Contra Costa,013,1133247,91654,90299,1802,92101,886
2021-09-03,Del Norte,015,27424,3148,2943,18,2961,24
2021-09-03,El Dorado,017,186661,14074,13710,1348,15058,119
2021-09-03,Fresno,019,978130,121252,118508,10665,129173,1822
2021-09-03,Glenn,021,27897,2988,2867,838,3705,20
2021-09-03,Humboldt,023,135768,7449,7194,292,7486,52
2021-09-03,Imperial,025,180216,30759,30475,2868,33343,751
2021-09-03,Inyo,027,18085,1583,1567,17,1584,39
2021-09-03,Kern,029,883053,111985,109296,15941,125237,1407
2021-09-03,Kings,031,150075,27543,26753,1468,28221,263
2021-09-03,Lake,033,64148,5684,5479,90,5569,78
2021-09-03,Lassen,035,31185,5911,5789,184,5973,21
2021-09-03,Los Angeles,037,10098052,1369233,1351185,49959,1401144,25384
2021-09-03,Madera,039,155013,19619,19021,1469,20490,247
2021-09-03,Marin,041,260295,16470,16293,362,16655,242
2021-09-03,Mariposa,043,17540,789,753,25,778,5
2021-09-03,Mendocino,045,87422,6147,5891,235,6126,61
2021-09-03,Merced,047,269075,36617,35941,1380,37321,512
2021-09-03,Modoc,049,8938,457,445,158,603,5
2021-09-03,Mono,051,14174,1436,1410,17,1427,3
2021-09-03,Monterey,053,433212,46465,45707,2399,48106,540
2021-09-03,Napa,055,140530,11875,11733,74,11807,89
2021-09-03,Nevada,057,99092,7898,7632,256,7888,82
2021-09-03,Orange,059,3164182,290943,286818,13476,300294,5253
2021-09-03,Placer,061,380077,32105,31238,2870,34108,335
2021-09-03,Plumas,063,18699,1102,1057,19,1076,5
2021-09-03,Riverside,065,2383286,337511,331011,15400,346411,4653
2021-09-03,Sacramento,067,1510023,141218,139982,3202,143184,1886
2021-09-03,San Benito,069,59416,6784,6746,133,6879,64
2021-09-03,San Bernardino,071,2135413,331786,327599,10227,337826,5381
2021-09-03,San Diego,073,3302833,342542,337627,20087,357714,3911
2021-09-03,San Francisco,075,870044,48532,47822,2013,49835,589
2021-09-03,San Joaquin,077,732212,90011,88366,4657,93023,1540
2021-09-03,San Luis Obispo,079,281455,26557,25917,1009,26926,283
2021-09-03,San Mateo,081,765935,50465,49617,733,50350,560
2021-09-03,Santa Barbara,083,443738,40511,39507,1385,40892,489
2021-09-03,Santa Clara,085,1922200,137368,135522,1026,136548,1801
2021-09-03,Santa Cruz,087,273765,18840,18532,939,19471,210
2021-09-03,Shasta,089,179085,16538,15778,2454,18232,226
2021-09-03,Sierra,091,2930,124,105,13,118,0
2021-09-03,Siskiyou,093,43540,2689,2529,830,3359,34
2021-09-03,Solano,095,438530,42460,41457,1054,42511,300
2021-09-03,Sonoma,097,501317,38161,37699,455,38154,358
2021-09-03,Stanislaus,099,539301,68820,67887,7618,75505,1074
2021-09-03,Sutter,101,95872,12288,12073,180,12253,139
2021-09-03,Tehama,103,63373,6586,6334,989,7323,72
2021-09-03,Trinity,105,12862,654,490,167,657,6
2021-09-03,Tulare,107,460477,58250,56401,11536,67937,872
2021-09-03,Tuolumne,109,53932,5763,5630,62,5692,88
2021-09-03,Ventura,111,848112,92275,90742,3950,94692,1088
2021-09-03,Yolo,113,214977,17793,17446,776,18222,235
2021-09-03,Yuba,115,75493,8670,8412,178,8590,55
2021-09-02,Alameda,001,1643700,110712,109377,2478,111855,1301
2021-09-02,Alpine,003,1148,93,92,0,92,0
2021-09-02,Amador,005,37829,4679,4606,43,4649,53
2021-09-02,Butte,007,227075,16821,16154,2873,19027,215
2021-09-02,Calaveras,009,45235,3147,3042,19,3061,62
2021-09-02,Colusa,011,21464,2328,2290,502,2792,16
2021-09-02,Contra Costa,013,1133247,91472,90038,1791,91829,886
2021-09-02,Del Norte,015,27424,3117,2891,18,2909,24
2021-09-02,El Dorado,017,186661,14015,13641,1323,14964,119
2021-09-02,Fresno,019,978130,120764,117974,10611,128585,1804
2021-09-02,Glenn,021,27897,2972,2855,832,3687,20
2021-09-02,Humboldt,023,135768,7402,7141,281,7422,52
2021-09-02,Imperial,025,180216,30715,30449,2863,33312,751
2021-09-02,Inyo,027,18085,1578,1564,16,1580,39
2021-09-02,Kern,029,883053,111573,108930,15797,124727,1404
2021-09-02,Kings,031,150075,27450,26638,1458,28096,263
2021-09-02,Lake,033,64148,5654,5432,86,5518,78
2021-09-02,Lassen,035,31185,5897,5747,177,5924,21
2021-09-02,Los Angeles,037,10098052,1367377,1351105,49866,1400971,25382
2021-09-02,Madera,039,155013,19528,18937,1451,20388,247
2021-09-02,Marin,041,260295,16457,16244,360,16604,242
2021-09-02,Mariposa,043,17540,782,745,22,767,5
2021-09-02,Mendocino,045,87422,6105,5848,232,6080,61
2021-09-02,Merced,047,269075,36454,35820,1373,37193,508
2021-09-02,Modoc,049,8938,457,437,158,595,5
2021-09-02,Mono,051,14174,1436,1409,17,1426,3
2021-09-02,Monterey,053,433212,46399,45648,2384,48032,539
2021-09-02,Napa,055,140530,11846,11684,74,11758,88
2021-09-02,Nevada,057,99092,7846,7575,255,7830,82
2021-09-02,Orange,059,3164182,290483,286326,13442,299768,5240
2021-09-02,Placer,061,380077,31968,31067,2841,33908,330
2021-09-02,Plumas,063,18699,1091,1045,18,1063,5
2021-09-02,Riverside,065,2383286,336796,330190,15376,345566,4644
2021-09-02,Sacramento,067,1510023,140637,139274,3163,142437,1882
2021-09-02,San Benito,069,59416,6779,6734,132,6866,64
2021-09-02,San Bernardino,071,2135413,331179,326940,10154,337094,5369
2021-09-02,San Diego,073,3302833,341584,336382,20034,356416,3909
2021-09-02,San Francisco,075,870044,48424,47674,2009,49683,587
2021-09-02,San Joaquin,077,732212,89727,88056,4633,92689,1540
2021-09-02,San Luis Obispo,079,281455,26472,25851,1004,26855,283
2021-09-02,San Mateo,081,765935,50364,49490,731,50221,558
2021-09-02,Santa Barbara,083,443738,40421,39386,1372,40758,486
2021-09-02,Santa Clara,085,1922200,137067,135216,1020,136236,1799
2021-09-02,Santa Cruz,087,273765,18806,18473,936,19409,210
2021-09-02,Shasta,089,179085,16400,15670,2425,18095,224
2021-09-02,Sierra,091,2930,124,105,13,118,0
2021-09-02,Siskiyou,093,43540,2668,2513,802,3315,34
2021-09-02,Solano,095,438530,42354,41293,1051,42344,294
2021-09-02,Sonoma,097,501317,38080,37558,455,38013,352
2021-09-02,Stanislaus,099,539301,68579,67576,7598,75174,1074
2021-09-02,Sutter,101,95872,12219,11995,176,12171,138
2021-09-02,Tehama,103,63373,6528,6265,970,7235,72
2021-09-02,Trinity,105,12862,650,484,165,649,6
2021-09-02,Tulare,107,460477,58020,56105,11485,67590,872
2021-09-02,Tuolumne,109,53932,5707,5578,62,5640,88
2021-09-02,Ventura,111,848112,92092,90610,3945,94555,1084
2021-09-02,Yolo,113,214977,17723,17357,765,18122,235
2021-09-02,Yuba,115,75493,8610,8363,178,8541,55
2021-09-01,Alameda,001,1643700,110446,109075,2473,111548,1299
2021-09-01,Alpine,003,1148,93,92,0,92,0
2021-09-01,Amador,005,37829,4663,4599,42,4641,53
2021-09-01,Butte,007,227075,16706,16046,2845,18891,215
2021-09-01,Calaveras,009,45235,3135,3023,19,3042,59
2021-09-01,Colusa,011,21464,2323,2281,501,2782,16
2021-09-01,Contra Costa,013,1133247,91237,89834,1784,91618,877
2021-09-01,Del Norte,015,27424,3084,2860,18,2878,24
2021-09-01,El Dorado,017,186661,13959,13577,1294,14871,119
2021-09-01,Fresno,019,978130,120273,117492,10542,128034,1800
2021-09-01,Glenn,021,27897,2947,2846,824,3670,20
2021-09-01,Humboldt,023,135768,7355,7090,274,7364,52
2021-09-01,Imperial,025,180216,30677,30393,2858,33251,750
2021-09-01,Inyo,027,18085,1574,1561,15,1576,39
2021-09-01,Kern,029,883053,111142,108449,15659,124108,1400
2021-09-01,Kings,031,150075,27337,26443,1447,27890,263
2021-09-01,Lake,033,64148,5613,5396,81,5477,77
2021-09-01,Lassen,035,31185,5875,5731,173,5904,21
2021-09-01,Los Angeles,037,10098052,1365112,1348589,49763,1398352,25341
2021-09-01,Madera,039,155013,19450,18852,1436,20288,247
2021-09-01,Marin,041,260295,16435,16224,355,16579,240
2021-09-01,Mariposa,043,17540,774,735,22,757,5
2021-09-01,Mendocino,045,87422,6062,5821,227,6048,59
2021-09-01,Merced,047,269075,36277,35686,1363,37049,500
2021-09-01,Modoc,049,8938,451,436,156,592,5
2021-09-01,Mono,051,14174,1436,1400,17,1417,3
2021-09-01,Monterey,053,433212,46319,45590,2369,47959,539
2021-09-01,Napa,055,140530,11813,11653,74,11727,88
2021-09-01,Nevada,057,99092,7793,7508,254,7762,82
2021-09-01,Orange,059,3164182,290008,285840,13405,299245,5233
2021-09-01,Placer,061,380077,31813,30902,2827,33729,330
2021-09-01,Plumas,063,18699,1083,1033,18,1051,5
2021-09-01,Riverside,065,2383286,335980,329388,15346,344734,4634
2021-09-01,Sacramento,067,1510023,140029,138499,3118,141617,1875
2021-09-01,San Benito,069,59416,6762,6716,132,6848,64
2021-09-01,San Bernardino,071,2135413,330531,326250,10125,336375,5364
2021-09-01,San Diego,073,3302833,340562,335302,19978,355280,3908
2021-09-01,San Francisco,075,870044,48316,47538,2002,49540,584
2021-09-01,San Joaquin,077,732212,89405,87640,4610,92250,1540
2021-09-01,San Luis Obispo,079,281455,26376,25691,999,26690,283
2021-09-01,San Mateo,081,765935,50244,49394,725,50119,558
2021-09-01,Santa Barbara,083,443738,40303,39263,1356,40619,483
2021-09-01,Santa Clara,085,1922200,136799,134855,1014,135869,1796
2021-09-01,Santa Cruz,087,273765,18759,18453,934,19387,210
2021-09-01,Shasta,089,179085,16268,15552,2385,17937,221
2021-09-01,Sierra,091,2930,123,98,13,111,0
2021-09-01,Siskiyou,093,43540,2638,2482,782,3264,34
2021-09-01,Solano,095,438530,42203,41194,1045,42239,293
2021-09-01,Sonoma,097,501317,37986,37454,454,37908,352
2021-09-01,Stanislaus,099,539301,68294,67287,7567,74854,1075
2021-09-01,Sutter,101,95872,12155,11945,169,12114,136
2021-09-01,Tehama,103,63373,6494,6228,953,7181,72
2021-09-01,Trinity,105,12862,649,482,162,644,5
2021-09-01,Tulare,107,460477,57737,55768,11448,67216,870
2021-09-01,Tuolumne,109,53932,5668,5553,62,5615,88
2021-09-01,Ventura,111,848112,91877,90471,3929,94400,1089
2021-09-01,Yolo,113,214977,17667,17264,759,18023,235
2021-09-01,Yuba,115,75493,8548,8308,178,8486,55
2021-08-31,Alameda,001,1643700,110149,108837,2467,111304,1297
2021-08-31,Alpine,003,1148,91,92,0,92,0
2021-08-31,Amador,005,37829,4642,4555,42,4597,53
2021-08-31,Butte,007,227075,16565,15896,2804,18700,216
2021-08-31,Calaveras,009,45235,3095,3008,19,3027,59
2021-08-31,Colusa,011,21464,2321,2275,499,2774,16
2021-08-31,Contra Costa,013,1133247,90942,89546,1772,91318,871
2021-08-31,Del Norte,015,27424,3048,2830,18,2848,19
2021-08-31,El Dorado,017,186661,13888,13539,1276,14815,119
2021-08-31,Fresno,019,978130,119697,117155,10463,127618,1801
2021-08-31,Glenn,021,27897,2931,2829,814,3643,20
2021-08-31,Humboldt,023,135768,7280,7030,261,7291,52
2021-08-31,Imperial,025,180216,30640,30348,2850,33198,750
2021-08-31,Inyo,027,18085,1570,1550,15,1565,39
2021-08-31,Kern,029,883053,110640,108151,15480,123631,1393
2021-08-31,Kings,031,150075,27195,26405,1433,27838,260
2021-08-31,Lake,033,64148,5569,5359,80,5439,74
2021-08-31,Lassen,035,31185,5849,5702,170,5872,21
2021-08-31,Los Angeles,037,10098052,1362521,1346686,49685,1396371,25303
2021-08-31,Madera,039,155013,19360,18811,1419,20230,247
2021-08-31,Marin,041,260295,16406,16215,352,16567,240
2021-08-31,Mariposa,043,17540,766,732,22,754,5
2021-08-31,Mendocino,045,87422,6020,5777,226,6003,59
2021-08-31,Merced,047,269075,36107,35512,1358,36870,498
2021-08-31,Modoc,049,8938,450,436,156,592,5
2021-08-31,Mono,051,14174,1424,1398,17,1415,3
2021-08-31,Monterey,053,433212,46235,45550,2356,47906,539
2021-08-31,Napa,055,140530,11766,11618,74,11692,88
2021-08-31,Nevada,057,99092,7727,7460,254,7714,82
2021-08-31,Orange,059,3164182,289410,285310,13373,298683,5229
2021-08-31,Placer,061,380077,31623,30745,2790,33535,325
2021-08-31,Plumas,063,18699,1079,1018,17,1035,5
2021-08-31,Riverside,065,2383286,335006,328556,15313,343869,4627
2021-08-31,Sacramento,067,1510023,139345,137879,3086,140965,1863
2021-08-31,San Benito,069,59416,6750,6694,130,6824,64
2021-08-31,San Bernardino,071,2135413,329784,325446,10105,335551,5350
2021-08-31,San Diego,073,3302833,339309,334377,19920,354297,3888
2021-08-31,San Francisco,075,870044,48166,47440,1991,49431,581
2021-08-31,San Joaquin,077,732212,88961,87365,4595,91960,1540
2021-08-31,San Luis Obispo,079,281455,26253,25518,995,26513,282
2021-08-31,San Mateo,081,765935,50132,49299,725,50024,556
2021-08-31,Santa Barbara,083,443738,40153,39091,1350,40441,481
2021-08-31,Santa Clara,085,1922200,136448,134637,1007,135644,1793
2021-08-31,Santa Cruz,087,273765,18721,18419,931,19350,210
2021-08-31,Shasta,089,179085,16116,15368,2358,17726,220
2021-08-31,Sierra,091,2930,120,95,13,108,0
2021-08-31,Siskiyou,093,43540,2618,2435,766,3201,33
2021-08-31,Solano,095,438530,42064,41067,1039,42106,289
2021-08-31,Sonoma,097,501317,37890,37379,453,37832,352
2021-08-31,Stanislaus,099,539301,67939,67004,7532,74536,1075
2021-08-31,Sutter,101,95872,12090,11901,165,12066,136
2021-08-31,Tehama,103,63373,6433,6169,922,7091,72
2021-08-31,Trinity,105,12862,643,480,162,642,3
2021-08-31,Tulare,107,460477,57403,55567,11378,66945,870
2021-08-31,Tuolumne,109,53932,5632,5516,62,5578,88
2021-08-31,Ventura,111,848112,91658,90292,3917,94209,1081
2021-08-31,Yolo,113,214977,17586,17205,751,17956,234
2021-08-31,Yuba,115,75493,8494,8253,178,8431,54
2021-08-30,Alameda,001,1643700,109829,107734,2456,110190,1296
2021-08-30,Alpine,003,1148,91,92,0,92,0
2021-08-30,Amador,005,37829,4631,4507,42,4549,53
2021-08-30,Butte,007,227075,16414,15719,2770,18489,214
2021-08-30,Calaveras,009,45235,3080,2975,19,2994,59
2021-08-30,Colusa,011,21464,2312,2271,496,2767,16
2021-08-30,Contra Costa,013,1133247,90682,87679,1762,89441,872
2021-08-30,Del Norte,015,27424,3006,2796,17,2813,11
2021-08-30,El Dorado,017,186661,13819,13217,1259,14476,119
2021-08-30,Fresno,019,978130,119125,115867,10391,126258,1790
2021-08-30,Glenn,021,27897,2920,2804,808,3612,20
2021-08-30,Humboldt,023,135768,7226,6930,255,7185,52
2021-08-30,Imperial,025,180216,30602,30311,2845,33156,750
2021-08-30,Inyo,027,18085,1565,1544,15,1559,39
2021-08-30,Kern,029,883053,110161,107615,15318,122933,1389
2021-08-30,Kings,031,150075,27079,26236,1418,27654,259
2021-08-30,Lake,033,64148,5534,5323,77,5400,74
2021-08-30,Lassen,035,31185,5827,5667,164,5831,21
2021-08-30,Los Angeles,037,10098052,1360060,1344949,49600,1394549,25269
2021-08-30,Madera,039,155013,19278,18622,1399,20021,247
2021-08-30,Marin,041,260295,16375,16160,352,16512,240
2021-08-30,Mariposa,043,17540,760,715,21,736,5
2021-08-30,Mendocino,045,87422,5986,5721,222,5943,55
2021-08-30,Merced,047,269075,35979,35335,1354,36689,497
2021-08-30,Modoc,049,8938,448,436,155,591,5
2021-08-30,Mono,051,14174,1423,1390,17,1407,3
2021-08-30,Monterey,053,433212,46173,45463,2339,47802,539
2021-08-30,Napa,055,140530,11717,11579,72,11651,87
2021-08-30,Nevada,057,99092,7668,7356,251,7607,82
2021-08-30,Orange,059,3164182,288829,284750,13324,298074,5223
2021-08-30,Placer,061,380077,31458,29825,2767,32592,319
2021-08-30,Plumas,063,18699,1062,998,17,1015,5
2021-08-30,Riverside,065,2383286,334110,327593,15282,342875,4623
2021-08-30,Sacramento,067,1510023,138687,134571,3040,137611,1847
2021-08-30,San Benito,069,59416,6741,6663,130,6793,64
2021-08-30,San Bernardino,071,2135413,329106,324870,10075,334945,5348
2021-08-30,San Diego,073,3302833,338038,333011,19840,352851,3885
2021-08-30,San Francisco,075,870044,48027,46966,1978,48944,581
2021-08-30,San Joaquin,077,732212,88630,86203,4574,90777,1528
2021-08-30,San Luis Obispo,079,281455,26128,25422,988,26410,280
2021-08-30,San Mateo,081,765935,50006,48839,719,49558,554
2021-08-30,Santa Barbara,083,443738,40001,38998,1345,40343,481
2021-08-30,Santa Clara,085,1922200,136127,133281,1000,134281,1789
2021-08-30,Santa Cruz,087,273765,18667,18326,927,19253,210
2021-08-30,Shasta,089,179085,15987,15238,2319,17557,217
2021-08-30,Sierra,091,2930,118,91,13,104,0
2021-08-30,Siskiyou,093,43540,2605,2411,755,3166,33
2021-08-30,Solano,095,438530,41903,39986,1035,41021,290
2021-08-30,Sonoma,097,501317,37785,36764,453,37217,352
2021-08-30,Stanislaus,099,539301,67599,66173,7501,73674,1074
2021-08-30,Sutter,101,95872,12020,11791,158,11949,136
2021-08-30,Tehama,103,63373,6354,6085,898,6983,71
2021-08-30,Trinity,105,12862,632,468,159,627,3
2021-08-30,Tulare,107,460477,57091,55140,11303,66443,870
2021-08-30,Tuolumne,109,53932,5586,5492,62,5554,74
2021-08-30,Ventura,111,848112,91442,90149,3905,94054,1082
2021-08-30,Yolo,113,214977,17524,17071,747,17818,231
2021-08-30,Yuba,115,75493,8420,8129,177,8306,54
2021-08-29,Alameda,001,1643700,109489,107494,2445,109939,1296
2021-08-29,Alpine,003,1148,91,92,0,92,0
2021-08-29,Amador,005,37829,4617,4501,42,4543,53
2021-08-29,Butte,007,227075,16244,15602,2733,18335,214
2021-08-29,Calaveras,009,45235,3048,2970,19,2989,59
2021-08-29,Colusa,011,21464,2305,2260,490,2750,16
2021-08-29,Contra Costa,013,1133247,90386,87439,1757,89196,872
2021-08-29,Del Norte,015,27424,2963,2752,17,2769,11
2021-08-29,El Dorado,017,186661,13763,13166,1248,14414,119
2021-08-29,Fresno,019,978130,118528,115502,10322,125824,1790
2021-08-29,Glenn,021,27897,2902,2778,801,3579,20
2021-08-29,Humboldt,023,135768,7182,6922,240,7162,52
2021-08-29,Imperial,025,180216,30541,30293,2834,33127,750
2021-08-29,Inyo,027,18085,1555,1543,14,1557,39
2021-08-29,Kern,029,883053,109710,107324,15148,122472,1389
2021-08-29,Kings,031,150075,26925,26143,1404,27547,259
2021-08-29,Lake,033,64148,5494,5293,67,5360,74
2021-08-29,Lassen,035,31185,5804,5666,160,5826,21
2021-08-29,Los Angeles,037,10098052,1357312,1342541,49489,1392030,25263
2021-08-29,Madera,039,155013,19191,18594,1383,19977,247
2021-08-29,Marin,041,260295,16344,16134,350,16484,240
2021-08-29,Mariposa,043,17540,754,709,19,728,5
2021-08-29,Mendocino,045,87422,5928,5689,209,5898,55
2021-08-29,Merced,047,269075,35740,35250,1342,36592,497
2021-08-29,Modoc,049,8938,445,436,155,591,5
2021-08-29,Mono,051,14174,1416,1387,17,1404,3
2021-08-29,Monterey,053,433212,46067,45424,2316,47740,539
2021-08-29,Napa,055,140530,11686,11552,72,11624,87
2021-08-29,Nevada,057,99092,7611,7294,250,7544,82
2021-08-29,Orange,059,3164182,288200,284432,13282,297714,5223
2021-08-29,Placer,061,380077,31286,29674,2726,32400,319
2021-08-29,Plumas,063,18699,1051,996,17,1013,5
2021-08-29,Riverside,065,2383286,333253,326987,15261,342248,4623
2021-08-29,Sacramento,067,1510023,137934,133981,2991,136972,1843
2021-08-29,San Benito,069,59416,6716,6646,130,6776,64
2021-08-29,San Bernardino,071,2135413,328321,324266,10041,334307,5347
2021-08-29,San Diego,073,3302833,336932,332014,19745,351759,3880
2021-08-29,San Francisco,075,870044,47892,46885,1966,48851,581
2021-08-29,San Joaquin,077,732212,88181,85922,4554,90476,1528
2021-08-29,San Luis Obispo,079,281455,25930,25288,980,26268,280
2021-08-29,San Mateo,081,765935,49893,48737,714,49451,554
2021-08-29,Santa Barbara,083,443738,39835,38900,1341,40241,481
2021-08-29,Santa Clara,085,1922200,135774,132979,994,133973,1789
2021-08-29,Santa Cruz,087,273765,18620,18285,925,19210,210
2021-08-29,Shasta,089,179085,15833,15198,2292,17490,217
2021-08-29,Sierra,091,2930,116,91,13,104,0
2021-08-29,Siskiyou,093,43540,2558,2407,735,3142,33
2021-08-29,Solano,095,438530,41749,39887,1028,40915,290
2021-08-29,Sonoma,097,501317,37650,36650,449,37099,352
2021-08-29,Stanislaus,099,539301,67254,65956,7465,73421,1074
2021-08-29,Sutter,101,95872,11961,11719,151,11870,136
2021-08-29,Tehama,103,63373,6283,6040,875,6915,71
2021-08-29,Trinity,105,12862,629,468,156,624,3
2021-08-29,Tulare,107,460477,56758,54974,11219,66193,870
2021-08-29,Tuolumne,109,53932,5561,5478,61,5539,74
2021-08-29,Ventura,111,848112,91184,90114,3896,94010,1082
2021-08-29,Yolo,113,214977,17424,17015,734,17749,231
2021-08-29,Yuba,115,75493,8356,8042,177,8219,54
2021-08-28,Alameda,001,1643700,109324,107007,2436,109443,1296
2021-08-28,Alpine,003,1148,91,92,0,92,0
2021-08-28,Amador,005,37829,4598,4484,41,4525,53
2021-08-28,Butte,007,227075,16184,15487,2705,18192,214
2021-08-28,Calaveras,009,45235,3038,2926,19,2945,59
2021-08-28,Colusa,011,21464,2301,2252,488,2740,16
2021-08-28,Contra Costa,013,1133247,90174,86938,1754,88692,872
2021-08-28,Del Norte,015,27424,2936,2734,16,2750,11
2021-08-28,El Dorado,017,186661,13724,13089,1242,14331,119
2021-08-28,Fresno,019,978130,118287,115079,10291,125370,1792
2021-08-28,Glenn,021,27897,2893,2773,794,3567,20
2021-08-28,Humboldt,023,135768,7147,6887,235,7122,52
2021-08-28,Imperial,025,180216,30514,30260,2831,33091,750
2021-08-28,Inyo,027,18085,1553,1539,14,1553,39
2021-08-28,Kern,029,883053,109472,107012,15008,122020,1389
2021-08-28,Kings,031,150075,26858,26059,1401,27460,257
2021-08-28,Lake,033,64148,5471,5267,63,5330,74
2021-08-28,Lassen,035,31185,5789,5665,159,5824,21
2021-08-28,Los Angeles,037,10098052,1356100,1337097,49417,1386514,25234
2021-08-28,Madera,039,155013,19140,18553,1369,19922,247
2021-08-28,Marin,041,260295,16329,16106,350,16456,240
2021-08-28,Mariposa,043,17540,752,704,19,723,5
2021-08-28,Mendocino,045,87422,5903,5658,209,5867,55
2021-08-28,Merced,047,269075,35688,35108,1339,36447,497
2021-08-28,Modoc,049,8938,445,436,154,590,5
2021-08-28,Mono,051,14174,1413,1385,17,1402,3
2021-08-28,Monterey,053,433212,46025,45394,2311,47705,539
2021-08-28,Napa,055,140530,11663,11512,71,11583,88
2021-08-28,Nevada,057,99092,7587,7238,248,7486,82
2021-08-28,Orange,059,3164182,287842,283953,13234,297187,5222
2021-08-28,Placer,061,380077,31177,29428,2713,32141,319
2021-08-28,Plumas,063,18699,1044,991,17,1008,5
2021-08-28,Riverside,065,2383286,332665,326222,15251,341473,4623
2021-08-28,Sacramento,067,1510023,137543,132985,2975,135960,1844
2021-08-28,San Benito,069,59416,6709,6636,130,6766,64
2021-08-28,San Bernardino,071,2135413,327874,323672,10033,333705,5348
2021-08-28,San Diego,073,3302833,336348,331330,19709,351039,3880
2021-08-28,San Francisco,075,870044,47820,46654,1959,48613,581
2021-08-28,San Joaquin,077,732212,88011,85481,4545,90026,1527
2021-08-28,San Luis Obispo,079,281455,25863,25138,975,26113,280
2021-08-28,San Mateo,081,765935,49819,48575,710,49285,554
2021-08-28,Santa Barbara,083,443738,39764,38780,1341,40121,481
2021-08-28,Santa Clara,085,1922200,135567,132488,992,133480,1789
2021-08-28,Santa Cruz,087,273765,18602,18240,922,19162,210
2021-08-28,Shasta,089,179085,15730,15147,2274,17421,217
2021-08-28,Sierra,091,2930,112,91,13,104,0
2021-08-28,Siskiyou,093,43540,2550,2402,724,3126,33
2021-08-28,Solano,095,438530,41700,39610,1027,40637,290
2021-08-28,Sonoma,097,501317,37577,36466,447,36913,352
2021-08-28,Stanislaus,099,539301,67096,65670,7448,73118,1074
2021-08-28,Sutter,101,95872,11940,11669,150,11819,136
2021-08-28,Tehama,103,63373,6258,6004,864,6868,71
2021-08-28,Trinity,105,12862,625,463,155,618,3
2021-08-28,Tulare,107,460477,56628,54746,11177,65923,870
2021-08-28,Tuolumne,109,53932,5545,5469,61,5530,74
2021-08-28,Ventura,111,848112,91066,89934,3894,93828,1081
2021-08-28,Yolo,113,214977,17388,16907,727,17634,231
2021-08-28,Yuba,115,75493,8325,7985,176,8161,55
2021-08-27,Alameda,001,1643700,109113,106622,2434,109056,1296
2021-08-27,Alpine,003,1148,91,92,0,92,0
2021-08-27,Amador,005,37829,4582,4458,40,4498,53
2021-08-27,Butte,007,227075,16104,15277,2683,17960,214
2021-08-27,Calaveras,009,45235,3024,2903,19,2922,59
2021-08-27,Colusa,011,21464,2295,2240,486,2726,16
2021-08-27,Contra Costa,013,1133247,89976,86386,1751,88137,872
2021-08-27,Del Norte,015,27424,2904,2695,16,2711,11
2021-08-27,El Dorado,017,186661,13685,12968,1238,14206,119
2021-08-27,Fresno,019,978130,117853,114481,10269,124750,1774
2021-08-27,Glenn,021,27897,2875,2754,785,3539,20
2021-08-27,Humboldt,023,135768,7114,6782,232,7014,52
2021-08-27,Imperial,025,180216,30494,30201,2829,33030,750
2021-08-27,Inyo,027,18085,1552,1529,14,1543,39
2021-08-27,Kern,029,883053,109178,106570,14898,121468,1385
2021-08-27,Kings,031,150075,26779,25957,1399,27356,257
2021-08-27,Lake,033,64148,5446,5228,62,5290,74
2021-08-27,Lassen,035,31185,5773,5646,154,5800,21
2021-08-27,Los Angeles,037,10098052,1354573,1337006,49354,1386360,25230
2021-08-27,Madera,039,155013,19084,18476,1356,19832,247
2021-08-27,Marin,041,260295,16313,16055,348,16403,240
2021-08-27,Mariposa,043,17540,746,690,19,709,5
2021-08-27,Mendocino,045,87422,5872,5602,208,5810,55
2021-08-27,Merced,047,269075,35634,34906,1330,36236,495
2021-08-27,Modoc,049,8938,445,434,154,588,5
2021-08-27,Mono,051,14174,1408,1385,17,1402,3
2021-08-27,Monterey,053,433212,45976,45337,2303,47640,539
2021-08-27,Napa,055,140530,11629,11460,71,11531,87
2021-08-27,Nevada,057,99092,7547,7169,246,7415,82
2021-08-27,Orange,059,3164182,287481,283407,13195,296602,5206
2021-08-27,Placer,061,380077,31047,29157,2694,31851,320
2021-08-27,Plumas,063,18699,1038,984,17,1001,5
2021-08-27,Riverside,065,2383286,332147,325379,15236,340615,4622
2021-08-27,Sacramento,067,1510023,137108,131921,2962,134883,1838
2021-08-27,San Benito,069,59416,6703,6622,130,6752,64
2021-08-27,San Bernardino,071,2135413,327349,322893,10015,332908,5342
2021-08-27,San Diego,073,3302833,335567,330162,19655,349817,3877
2021-08-27,San Francisco,075,870044,47744,46456,1941,48397,581
2021-08-27,San Joaquin,077,732212,87828,84949,4526,89475,1524
2021-08-27,San Luis Obispo,079,281455,25814,24952,972,25924,280
2021-08-27,San Mateo,081,765935,49744,48424,706,49130,553
2021-08-27,Santa Barbara,083,443738,39672,38675,1339,40014,480
2021-08-27,Santa Clara,085,1922200,135337,132011,989,133000,1783
2021-08-27,Santa Cruz,087,273765,18563,18163,918,19081,210
2021-08-27,Shasta,089,179085,15650,14996,2258,17254,217
2021-08-27,Sierra,091,2930,111,91,13,104,0
2021-08-27,Siskiyou,093,43540,2535,2358,710,3068,33
2021-08-27,Solano,095,438530,41586,39347,1023,40370,287
2021-08-27,Sonoma,097,501317,37506,36326,446,36772,342
2021-08-27,Stanislaus,099,539301,66887,65167,7411,72578,1061
2021-08-27,Sutter,101,95872,11894,11590,148,11738,135
2021-08-27,Tehama,103,63373,6226,5964,849,6813,71
2021-08-27,Trinity,105,12862,625,458,154,612,3
2021-08-27,Tulare,107,460477,56493,54443,11132,65575,870
2021-08-27,Tuolumne,109,53932,5513,5438,61,5499,74
2021-08-27,Ventura,111,848112,90937,89774,3890,93664,1076
2021-08-27,Yolo,113,214977,17345,16805,722,17527,231
2021-08-27,Yuba,115,75493,8268,7926,176,8102,54
2021-08-26,Alameda,001,1643700,108844,106146,2425,108571,1296
2021-08-26,Alpine,003,1148,91,92,0,92,0
2021-08-26,Amador,005,37829,4567,4442,39,4481,53
2021-08-26,Butte,007,227075,15969,15159,2645,17804,214
2021-08-26,Calaveras,009,45235,3013,2873,19,2892,59
2021-08-26,Colusa,011,21464,2288,2234,482,2716,16
2021-08-26,Contra Costa,013,1133247,89616,85808,1745,87553,866
2021-08-26,Del Norte,015,27424,2868,2625,16,2641,8
2021-08-26,El Dorado,017,186661,13616,12863,1224,14087,118
2021-08-26,Fresno,019,978130,117352,113854,10216,124070,1770
2021-08-26,Glenn,021,27897,2857,2740,776,3516,20
2021-08-26,Humboldt,023,135768,7056,6695,222,6917,53
2021-08-26,Imperial,025,180216,30445,30121,2822,32943,748
2021-08-26,Inyo,027,18085,1542,1521,13,1534,39
2021-08-26,Kern,029,883053,108750,106051,14756,120807,1380
2021-08-26,Kings,031,150075,26656,25838,1391,27229,260
2021-08-26,Lake,033,64148,5400,5196,59,5255,74
2021-08-26,Lassen,035,31185,5761,5626,152,5778,21
2021-08-26,Los Angeles,037,10098052,1352297,1334372,49261,1383633,25199
2021-08-26,Madera,039,155013,19014,18393,1343,19736,247
2021-08-26,Marin,041,260295,16284,15983,345,16328,240
2021-08-26,Mariposa,043,17540,736,677,19,696,5
2021-08-26,Mendocino,045,87422,5833,5533,203,5736,55
2021-08-26,Merced,047,269075,35467,34755,1309,36064,495
2021-08-26,Modoc,049,8938,445,433,154,587,5
2021-08-26,Mono,051,14174,1404,1385,17,1402,3
2021-08-26,Monterey,053,433212,45903,45265,2292,47557,539
2021-08-26,Napa,055,140530,11607,11394,70,11464,87
2021-08-26,Nevada,057,99092,7489,7086,243,7329,80
2021-08-26,Orange,059,3164182,286989,282814,13171,295985,5200
2021-08-26,Placer,061,380077,30877,28898,2668,31566,319
2021-08-26,Plumas,063,18699,1031,971,16,987,5
2021-08-26,Riverside,065,2383286,331356,324486,15216,339702,4615
2021-08-26,Sacramento,067,1510023,136574,130977,2921,133898,1827
2021-08-26,San Benito,069,59416,6693,6604,130,6734,64
2021-08-26,San Bernardino,071,2135413,326692,322100,9992,332092,5339
2021-08-26,San Diego,073,3302833,334540,328276,19589,347865,3869
2021-08-26,San Francisco,075,870044,47617,46288,1936,48224,581
2021-08-26,San Joaquin,077,732212,87450,84429,4505,88934,1513
2021-08-26,San Luis Obispo,079,281455,25664,24831,965,25796,278
2021-08-26,San Mateo,081,765935,49616,48263,704,48967,553
2021-08-26,Santa Barbara,083,443738,39587,38566,1338,39904,479
2021-08-26,Santa Clara,085,1922200,135012,131443,985,132428,1782
2021-08-26,Santa Cruz,087,273765,18503,18072,916,18988,210
2021-08-26,Shasta,089,179085,15528,14891,2230,17121,217
2021-08-26,Sierra,091,2930,109,90,13,103,0
2021-08-26,Siskiyou,093,43540,2513,2342,697,3039,33
2021-08-26,Solano,095,438530,41437,39027,1015,40042,286
2021-08-26,Sonoma,097,501317,37417,36102,446,36548,337
2021-08-26,Stanislaus,099,539301,66587,64785,7370,72155,1061
2021-08-26,Sutter,101,95872,11834,11499,145,11644,135
2021-08-26,Tehama,103,63373,6168,5913,836,6749,68
2021-08-26,Trinity,105,12862,620,450,152,602,3
2021-08-26,Tulare,107,460477,56236,54157,11086,65243,870
2021-08-26,Tuolumne,109,53932,5493,5387,61,5448,74
2021-08-26,Ventura,111,848112,90751,89595,3881,93476,1080
2021-08-26,Yolo,113,214977,17281,16727,711,17438,231
2021-08-26,Yuba,115,75493,8195,7834,174,8008,54
2021-08-25,Alameda,001,1643700,108520,105636,2418,108054,1296
2021-08-25,Alpine,003,1148,91,92,0,92,0
2021-08-25,Amador,005,37829,4552,4415,39,4454,53
2021-08-25,Butte,007,227075,15861,15039,2604,17643,214
2021-08-25,Calaveras,009,45235,2994,2851,19,2870,59
2021-08-25,Colusa,011,21464,2281,2227,473,2700,16
2021-08-25,Contra Costa,013,1133247,89232,85322,1739,87061,863
2021-08-25,Del Norte,015,27424,2823,2573,16,2589,8
2021-08-25,El Dorado,017,186661,13556,12787,1209,13996,118
2021-08-25,Fresno,019,978130,116811,113384,10174,123558,1761
2021-08-25,Glenn,021,27897,2839,2728,761,3489,20
2021-08-25,Humboldt,023,135768,6987,6653,213,6866,52
2021-08-25,Imperial,025,180216,30408,30085,2816,32901,748
2021-08-25,Inyo,027,18085,1538,1518,13,1531,39
2021-08-25,Kern,029,883053,108319,105687,14601,120288,1379
2021-08-25,Kings,031,150075,26549,25676,1385,27061,258
2021-08-25,Lake,033,64148,5370,5163,56,5219,74
2021-08-25,Lassen,035,31185,5744,5583,151,5734,21
2021-08-25,Los Angeles,037,10098052,1349698,1331400,49163,1380563,25170
2021-08-25,Madera,039,155013,18950,18311,1321,19632,247
2021-08-25,Marin,041,260295,16262,15938,339,16277,240
2021-08-25,Mariposa,043,17540,730,676,19,695,5
2021-08-25,Mendocino,045,87422,5799,5486,197,5683,53
2021-08-25,Merced,047,269075,35335,34600,1296,35896,492
2021-08-25,Modoc,049,8938,445,433,154,587,5
2021-08-25,Mono,051,14174,1400,1382,17,1399,3
2021-08-25,Monterey,053,433212,45829,45196,2277,47473,539
2021-08-25,Napa,055,140530,11573,11348,69,11417,87
2021-08-25,Nevada,057,99092,7423,7000,242,7242,77
2021-08-25,Orange,059,3164182,286463,282061,13137,295198,5193
2021-08-25,Placer,061,380077,30701,28740,2636,31376,319
2021-08-25,Plumas,063,18699,1016,962,16,978,5
2021-08-25,Riverside,065,2383286,330512,323548,15194,338742,4610
2021-08-25,Sacramento,067,1510023,135894,130046,2883,132929,1827
2021-08-25,San Benito,069,59416,6672,6587,129,6716,64
2021-08-25,San Bernardino,071,2135413,326000,321228,9971,331199,5337
2021-08-25,San Diego,073,3302833,333272,327166,19504,346670,3859
2021-08-25,San Francisco,075,870044,47467,46107,1931,48038,578
2021-08-25,San Joaquin,077,732212,87066,84002,4488,88490,1510
2021-08-25,San Luis Obispo,079,281455,25472,24607,961,25568,276
2021-08-25,San Mateo,081,765935,49494,48153,701,48854,553
2021-08-25,Santa Barbara,083,443738,39458,38450,1338,39788,479
2021-08-25,Santa Clara,085,1922200,134644,130995,983,131978,1783
2021-08-25,Santa Cruz,087,273765,18443,17987,913,18900,210
2021-08-25,Shasta,089,179085,15402,14752,2198,16950,217
2021-08-25,Sierra,091,2930,106,90,13,103,0
2021-08-25,Siskiyou,093,43540,2468,2322,679,3001,33
2021-08-25,Solano,095,438530,41265,38848,1003,39851,286
2021-08-25,Sonoma,097,501317,37293,35986,443,36429,336
2021-08-25,Stanislaus,099,539301,66305,64441,7338,71779,1061
2021-08-25,Sutter,101,95872,11766,11451,141,11592,134
2021-08-25,Tehama,103,63373,6109,5861,819,6680,68
2021-08-25,Trinity,105,12862,614,450,151,601,3
2021-08-25,Tulare,107,460477,55952,53877,11016,64893,866
2021-08-25,Tuolumne,109,53932,5467,5354,61,5415,74
2021-08-25,Ventura,111,848112,90567,89379,3867,93246,1068
2021-08-25,Yolo,113,214977,17216,16667,701,17368,231
2021-08-25,Yuba,115,75493,8129,7771,173,7944,54
2021-08-24,Alameda,001,1643700,108208,105319,2406,107725,1296
2021-08-24,Alpine,003,1148,91,92,0,92,0
2021-08-24,Amador,005,37829,4533,4380,39,4419,50
2021-08-24,Butte,007,227075,15707,14964,2571,17535,214
2021-08-24,Calaveras,009,45235,2955,2811,19,2830,59
2021-08-24,Colusa,011,21464,2273,2221,468,2689,16
2021-08-24,Contra Costa,013,1133247,88869,84963,1734,86697,857
2021-08-24,Del Norte,015,27424,2796,2543,16,2559,8
2021-08-24,El Dorado,017,186661,13479,12732,1194,13926,118
2021-08-24,Fresno,019,978130,116204,113024,10111,123135,1761
2021-08-24,Glenn,021,27897,2824,2717,754,3471,20
2021-08-24,Humboldt,023,135768,6924,6585,200,6785,52
2021-08-24,Imperial,025,180216,30347,30045,2811,32856,748
2021-08-24,Inyo,027,18085,1533,1512,13,1525,39
2021-08-24,Kern,029,883053,107855,105399,14437,119836,1375
2021-08-24,Kings,031,150075,26428,25629,1370,26999,258
2021-08-24,Lake,033,64148,5335,5135,56,5191,72
2021-08-24,Lassen,035,31185,5728,5576,149,5725,21
2021-08-24,Los Angeles,037,10098052,1346833,1328777,49057,1377834,25135
2021-08-24,Madera,039,155013,18874,18251,1304,19555,247
2021-08-24,Marin,041,260295,16226,15900,335,16235,240
2021-08-24,Mariposa,043,17540,723,670,19,689,5
2021-08-24,Mendocino,045,87422,5756,5416,190,5606,52
2021-08-24,Merced,047,269075,35167,34490,1285,35775,491
2021-08-24,Modoc,049,8938,445,432,154,586,5
2021-08-24,Mono,051,14174,1398,1382,17,1399,3
2021-08-24,Monterey,053,433212,45763,45126,2260,47386,539
2021-08-24,Napa,055,140530,11540,11299,68,11367,85
2021-08-24,Nevada,057,99092,7353,6981,240,7221,77
2021-08-24,Orange,059,3164182,285863,281461,13113,294574,5187
2021-08-24,Placer,061,380077,30496,28618,2597,31215,318
2021-08-24,Plumas,063,18699,1006,953,16,969,5
2021-08-24,Riverside,065,2383286,329639,322620,15165,337785,4605
2021-08-24,Sacramento,067,1510023,135210,129542,2837,132379,1812
2021-08-24,San Benito,069,59416,6659,6576,129,6705,64
2021-08-24,San Bernardino,071,2135413,325244,320300,9941,330241,5328
2021-08-24,San Diego,073,3302833,331829,325823,19395,345218,3851
2021-08-24,San Francisco,075,870044,47292,46010,1921,47931,574
2021-08-24,San Joaquin,077,732212,86626,83684,4451,88135,1508
2021-08-24,San Luis Obispo,079,281455,25295,24443,950,25393,274
2021-08-24,San Mateo,081,765935,49345,48050,699,48749,553
2021-08-24,Santa Barbara,083,443738,39327,38307,1337,39644,478
2021-08-24,Santa Clara,085,1922200,134220,130763,979,131742,1779
2021-08-24,Santa Cruz,087,273765,18368,17928,907,18835,209
2021-08-24,Shasta,089,179085,15294,14664,2167,16831,217
2021-08-24,Sierra,091,2930,103,90,13,103,0
2021-08-24,Siskiyou,093,43540,2446,2294,664,2958,33
2021-08-24,Solano,095,438530,41056,38724,991,39715,283
2021-08-24,Sonoma,097,501317,37165,35849,441,36290,336
2021-08-24,Stanislaus,099,539301,65976,64195,7284,71479,1058
2021-08-24,Sutter,101,95872,11699,11384,138,11522,134
2021-08-24,Tehama,103,63373,6063,5826,805,6631,67
2021-08-24,Trinity,105,12862,603,446,143,589,3
2021-08-24,Tulare,107,460477,55601,53702,10926,64628,856
2021-08-24,Tuolumne,109,53932,5436,5287,61,5348,74
2021-08-24,Ventura,111,848112,90383,89167,3856,93023,1068
2021-08-24,Yolo,113,214977,17138,16492,688,17180,231
2021-08-24,Yuba,115,75493,8046,7723,171,7894,54
2021-08-23,Alameda,001,1643700,107797,104922,2393,107315,1294
2021-08-23,Alpine,003,1148,91,91,0,91,0
2021-08-23,Amador,005,37829,4519,4369,39,4408,50
2021-08-23,Butte,007,227075,15561,14847,2533,17380,211
2021-08-23,Calaveras,009,45235,2928,2803,19,2822,59
2021-08-23,Colusa,011,21464,2269,2206,465,2671,16
2021-08-23,Contra Costa,013,1133247,88491,84651,1727,86378,857
2021-08-23,Del Norte,015,27424,2750,2499,16,2515,8
2021-08-23,El Dorado,017,186661,13376,12684,1172,13856,118
2021-08-23,Fresno,019,978130,115643,112445,10061,122506,1759
2021-08-23,Glenn,021,27897,2808,2696,744,3440,20
2021-08-23,Humboldt,023,135768,6851,6498,186,6684,52
2021-08-23,Imperial,025,180216,30296,30011,2808,32819,748
2021-08-23,Inyo,027,18085,1526,1509,13,1522,39
2021-08-23,Kern,029,883053,107400,104995,14283,119278,1375
2021-08-23,Kings,031,150075,26297,25465,1364,26829,257
2021-08-23,Lake,033,64148,5295,5099,54,5153,69
2021-08-23,Lassen,035,31185,5716,5562,149,5711,21
2021-08-23,Los Angeles,037,10098052,1343863,1326412,48927,1375339,25096
2021-08-23,Madera,039,155013,18788,18155,1289,19444,246
2021-08-23,Marin,041,260295,16178,15856,331,16187,240
2021-08-23,Mariposa,043,17540,712,645,19,664,5
2021-08-23,Mendocino,045,87422,5689,5374,183,5557,51
2021-08-23,Merced,047,269075,34985,34322,1280,35602,488
2021-08-23,Modoc,049,8938,442,431,153,584,6
2021-08-23,Mono,051,14174,1394,1384,17,1401,3
2021-08-23,Monterey,053,433212,45663,45047,2250,47297,538
2021-08-23,Napa,055,140530,11502,11257,68,11325,85
2021-08-23,Nevada,057,99092,7272,6930,238,7168,77
2021-08-23,Orange,059,3164182,285231,280891,13080,293971,5181
2021-08-23,Placer,061,380077,30296,28540,2559,31099,314
2021-08-23,Plumas,063,18699,998,934,16,950,5
2021-08-23,Riverside,065,2383286,328726,321650,15139,336789,4598
2021-08-23,Sacramento,067,1510023,134422,128969,2770,131739,1807
2021-08-23,San Benito,069,59416,6641,6562,127,6689,64
2021-08-23,San Bernardino,071,2135413,324439,319577,9902,329479,5324
2021-08-23,San Diego,073,3302833,330396,324536,19272,343808,3848
2021-08-23,San Francisco,075,870044,47137,45945,1912,47857,573
2021-08-23,San Joaquin,077,732212,86193,83466,4418,87884,1499
2021-08-23,San Luis Obispo,079,281455,25112,24317,948,25265,274
2021-08-23,San Mateo,081,765935,49207,47935,696,48631,553
2021-08-23,Santa Barbara,083,443738,39148,38181,1335,39516,478
2021-08-23,Santa Clara,085,1922200,133820,130489,975,131464,1778
2021-08-23,Santa Cruz,087,273765,18311,17871,906,18777,209
2021-08-23,Shasta,089,179085,15167,14537,2129,16666,216
2021-08-23,Sierra,091,2930,103,90,13,103,0
2021-08-23,Siskiyou,093,43540,2425,2274,643,2917,33
2021-08-23,Solano,095,438530,40902,38612,982,39594,283
2021-08-23,Sonoma,097,501317,37045,35769,440,36209,336
2021-08-23,Stanislaus,099,539301,65642,63922,7245,71167,1058
2021-08-23,Sutter,101,95872,11610,11314,130,11444,133
2021-08-23,Tehama,103,63373,6009,5805,789,6594,67
2021-08-23,Trinity,105,12862,600,435,140,575,3
2021-08-23,Tulare,107,460477,55294,53370,10854,64224,856
2021-08-23,Tuolumne,109,53932,5394,5240,61,5301,73
2021-08-23,Ventura,111,848112,90165,88960,3844,92804,1063
2021-08-23,Yolo,113,214977,17050,16445,674,17119,226
2021-08-23,Yuba,115,75493,7975,7653,169,7822,54
2021-08-22,Alameda,001,1643700,107350,104539,2366,106905,1294
2021-08-22,Alpine,003,1148,91,91,0,91,0
2021-08-22,Amador,005,37829,4489,4349,39,4388,50
2021-08-22,Butte,007,227075,15421,14791,2499,17290,211
2021-08-22,Calaveras,009,45235,2890,2771,19,2790,59
2021-08-22,Colusa,011,21464,2262,2201,459,2660,16
2021-08-22,Contra Costa,013,1133247,87949,84371,1714,86085,857
2021-08-22,Del Norte,015,27424,2690,2455,16,2471,8
2021-08-22,El Dorado,017,186661,13272,12629,1152,13781,118
2021-08-22,Fresno,019,978130,115044,112057,9993,122050,1759
2021-08-22,Glenn,021,27897,2781,2678,731,3409,20
2021-08-22,Humboldt,023,135768,6773,6483,168,6651,52
2021-08-22,Imperial,025,180216,30238,29993,2803,32796,748
2021-08-22,Inyo,027,18085,1520,1505,13,1518,39
2021-08-22,Kern,029,883053,106874,104691,14131,118822,1375
2021-08-22,Kings,031,150075,26139,25391,1347,26738,257
2021-08-22,Lake,033,64148,5250,5069,51,5120,69
2021-08-22,Lassen,035,31185,5684,5556,145,5701,21
2021-08-22,Los Angeles,037,10098052,1340542,1324151,48798,1372949,25089
2021-08-22,Madera,039,155013,18669,18120,1275,19395,246
2021-08-22,Marin,041,260295,16126,15822,323,16145,240
2021-08-22,Mariposa,043,17540,702,638,17,655,5
2021-08-22,Mendocino,045,87422,5630,5336,183,5519,51
2021-08-22,Merced,047,269075,34782,34234,1267,35501,488
2021-08-22,Modoc,049,8938,440,431,153,584,6
2021-08-22,Mono,051,14174,1392,1378,17,1395,3
2021-08-22,Monterey,053,433212,45564,45017,2236,47253,538
2021-08-22,Napa,055,140530,11457,11231,68,11299,85
2021-08-22,Nevada,057,99092,7198,6864,236,7100,77
2021-08-22,Orange,059,3164182,284537,280390,13036,293426,5181
2021-08-22,Placer,061,380077,30088,28395,2523,30918,314
2021-08-22,Plumas,063,18699,980,923,15,938,5
2021-08-22,Riverside,065,2383286,327705,320836,15092,335928,4594
2021-08-22,Sacramento,067,1510023,133647,128231,2730,130961,1802
2021-08-22,San Benito,069,59416,6625,6550,127,6677,64
2021-08-22,San Bernardino,071,2135413,323471,318839,9867,328706,5324
2021-08-22,San Diego,073,3302833,329074,323591,19166,342757,3848
2021-08-22,San Francisco,075,870044,46971,45831,1903,47734,573
2021-08-22,San Joaquin,077,732212,85735,83121,4383,87504,1498
2021-08-22,San Luis Obispo,079,281455,24906,24250,941,25191,274
2021-08-22,San Mateo,081,765935,49031,47821,691,48512,553
2021-08-22,Santa Barbara,083,443738,38967,38099,1327,39426,478
2021-08-22,Santa Clara,085,1922200,133403,130189,968,131157,1778
2021-08-22,Santa Cruz,087,273765,18253,17823,901,18724,209
2021-08-22,Shasta,089,179085,15030,14478,2093,16571,216
2021-08-22,Sierra,091,2930,103,87,13,100,0
2021-08-22,Siskiyou,093,43540,2396,2261,625,2886,33
2021-08-22,Solano,095,438530,40704,38489,969,39458,283
2021-08-22,Sonoma,097,501317,36888,35676,438,36114,336
2021-08-22,Stanislaus,099,539301,65289,63683,7155,70838,1058
2021-08-22,Sutter,101,95872,11528,11251,126,11377,133
2021-08-22,Tehama,103,63373,5963,5791,770,6561,67
2021-08-22,Trinity,105,12862,593,433,138,571,3
2021-08-22,Tulare,107,460477,54975,53220,10771,63991,856
2021-08-22,Tuolumne,109,53932,5352,5214,61,5275,73
2021-08-22,Ventura,111,848112,89956,88791,3827,92618,1063
2021-08-22,Yolo,113,214977,16947,16374,666,17040,226
2021-08-22,Yuba,115,75493,7902,7626,168,7794,54
2021-08-21,Alameda,001,1643700,107149,104281,2359,106640,1294
2021-08-21,Alpine,003,1148,91,91,0,91,0
2021-08-21,Amador,005,37829,4479,4338,38,4376,50
2021-08-21,Butte,007,227075,15353,14714,2480,17194,211
2021-08-21,Calaveras,009,45235,2874,2744,19,2763,59
2021-08-21,Colusa,011,21464,2256,2192,455,2647,16
2021-08-21,Contra Costa,013,1133247,87690,84136,1706,85842,857
2021-08-21,Del Norte,015,27424,2667,2409,16,2425,8
2021-08-21,El Dorado,017,186661,13228,12590,1148,13738,118
2021-08-21,Fresno,019,978130,114844,111765,9981,121746,1759
2021-08-21,Glenn,021,27897,2768,2654,723,3377,20
2021-08-21,Humboldt,023,135768,6735,6446,163,6609,52
2021-08-21,Imperial,025,180216,30195,29976,2800,32776,748
2021-08-21,Inyo,027,18085,1517,1500,13,1513,39
2021-08-21,Kern,029,883053,106619,104443,14008,118451,1375
2021-08-21,Kings,031,150075,26068,25313,1342,26655,257
2021-08-21,Lake,033,64148,5230,5055,49,5104,69
2021-08-21,Lassen,035,31185,5670,5553,145,5698,21
2021-08-21,Los Angeles,037,10098052,1339244,1321308,48706,1370014,25080
2021-08-21,Madera,039,155013,18631,18067,1269,19336,246
2021-08-21,Marin,041,260295,16092,15775,321,16096,240
2021-08-21,Mariposa,043,17540,692,634,17,651,5
2021-08-21,Mendocino,045,87422,5584,5307,182,5489,51
2021-08-21,Merced,047,269075,34677,34148,1262,35410,488
2021-08-21,Modoc,049,8938,440,430,153,583,6
2021-08-21,Mono,051,14174,1392,1378,17,1395,3
2021-08-21,Monterey,053,433212,45517,44969,2229,47198,538
2021-08-21,Napa,055,140530,11422,11211,68,11279,85
2021-08-21,Nevada,057,99092,7154,6810,235,7045,77
2021-08-21,Orange,059,3164182,284085,279855,13002,292857,5181
2021-08-21,Placer,061,380077,29950,28289,2499,30788,314
2021-08-21,Plumas,063,18699,976,916,14,930,5
2021-08-21,Riverside,065,2383286,327125,320086,15079,335165,4594
2021-08-21,Sacramento,067,1510023,133152,127751,2719,130470,1809
2021-08-21,San Benito,069,59416,6615,6542,126,6668,64
2021-08-21,San Bernardino,071,2135413,323022,318293,9846,328139,5324
2021-08-21,San Diego,073,3302833,328418,322620,19117,341737,3848
2021-08-21,San Francisco,075,870044,46869,45637,1896,47533,573
2021-08-21,San Joaquin,077,732212,85518,82825,4367,87192,1498
2021-08-21,San Luis Obispo,079,281455,24848,24169,941,25110,273
2021-08-21,San Mateo,081,765935,48936,47685,691,48376,553
2021-08-21,Santa Barbara,083,443738,38885,37951,1323,39274,478
2021-08-21,Santa Clara,085,1922200,133138,129911,964,130875,1778
2021-08-21,Santa Cruz,087,273765,18216,17763,896,18659,209
2021-08-21,Shasta,089,179085,14956,14417,2079,16496,217
2021-08-21,Sierra,091,2930,98,85,13,98,0
2021-08-21,Siskiyou,093,43540,2382,2246,614,2860,33
2021-08-21,Solano,095,438530,40593,38423,959,39382,281
2021-08-21,Sonoma,097,501317,36801,35582,437,36019,336
2021-08-21,Stanislaus,099,539301,65107,63512,7138,70650,1058
2021-08-21,Sutter,101,95872,11483,11204,124,11328,133
2021-08-21,Tehama,103,63373,5938,5757,763,6520,67
2021-08-21,Trinity,105,12862,588,431,136,567,3
2021-08-21,Tulare,107,460477,54831,53045,10728,63773,857
2021-08-21,Tuolumne,109,53932,5321,5193,61,5254,73
2021-08-21,Ventura,111,848112,89811,88558,3812,92370,1063
2021-08-21,Yolo,113,214977,16900,16322,660,16982,226
2021-08-21,Yuba,115,75493,7856,7580,167,7747,54
2021-08-20,Alameda,001,1643700,106912,103812,2351,106163,1294
2021-08-20,Alpine,003,1148,91,91,0,91,0
2021-08-20,Amador,005,37829,4453,4323,38,4361,50
2021-08-20,Butte,007,227075,15280,14617,2458,17075,211
2021-08-20,Calaveras,009,45235,2854,2717,19,2736,59
2021-08-20,Colusa,011,21464,2251,2178,453,2631,16
2021-08-20,Contra Costa,013,1133247,87415,83721,1699,85420,857
2021-08-20,Del Norte,015,27424,2635,2316,16,2332,8
2021-08-20,El Dorado,017,186661,13190,12495,1140,13635,118
2021-08-20,Fresno,019,978130,114487,111315,9947,121262,1759
2021-08-20,Glenn,021,27897,2761,2642,713,3355,20
2021-08-20,Humboldt,023,135768,6683,6349,158,6507,52
2021-08-20,Imperial,025,180216,30172,29934,2800,32734,747
2021-08-20,Inyo,027,18085,1511,1495,13,1508,39
2021-08-20,Kern,029,883053,106335,104048,13882,117930,1373
2021-08-20,Kings,031,150075,26002,25241,1340,26581,256
2021-08-20,Lake,033,64148,5215,5024,46,5070,69
2021-08-20,Lassen,035,31185,5650,5539,145,5684,21
2021-08-20,Los Angeles,037,10098052,1337366,1317541,48605,1366146,25049
2021-08-20,Madera,039,155013,18582,18018,1254,19272,246
2021-08-20,Marin,041,260295,16074,15727,317,16044,240
2021-08-20,Mariposa,043,17540,687,630,17,647,5
2021-08-20,Mendocino,045,87422,5538,5241,181,5422,51
2021-08-20,Merced,047,269075,34613,34035,1252,35287,486
2021-08-20,Modoc,049,8938,440,429,153,582,6
2021-08-20,Mono,051,14174,1391,1368,17,1385,3
2021-08-20,Monterey,053,433212,45479,44890,2223,47113,538
2021-08-20,Napa,055,140530,11390,11152,68,11220,83
2021-08-20,Nevada,057,99092,7112,6753,229,6982,77
2021-08-20,Orange,059,3164182,283640,279193,12981,292174,5179
2021-08-20,Placer,061,380077,29855,28156,2470,30626,313
2021-08-20,Plumas,063,18699,966,908,14,922,5
2021-08-20,Riverside,065,2383286,326429,319072,15048,334120,4594
2021-08-20,Sacramento,067,1510023,132676,127226,2702,129928,1797
2021-08-20,San Benito,069,59416,6601,6508,126,6634,64
2021-08-20,San Bernardino,071,2135413,322409,317372,9817,327189,5322
2021-08-20,San Diego,073,3302833,327509,321102,19047,340149,3846
2021-08-20,San Francisco,075,870044,46772,45432,1881,47313,573
2021-08-20,San Joaquin,077,732212,85287,82419,4348,86767,1496
2021-08-20,San Luis Obispo,079,281455,24770,23986,937,24923,273
2021-08-20,San Mateo,081,765935,48823,47561,688,48249,551
2021-08-20,Santa Barbara,083,443738,38800,37794,1318,39112,477
2021-08-20,Santa Clara,085,1922200,132855,129510,959,130469,1774
2021-08-20,Santa Cruz,087,273765,18176,17701,893,18594,209
2021-08-20,Shasta,089,179085,14876,14277,2061,16338,215
2021-08-20,Sierra,091,2930,97,83,13,96,0
2021-08-20,Siskiyou,093,43540,2366,2226,609,2835,33
2021-08-20,Solano,095,438530,40452,38214,948,39162,277
2021-08-20,Sonoma,097,501317,36733,35416,436,35852,336
2021-08-20,Stanislaus,099,539301,64918,63219,7114,70333,1047
2021-08-20,Sutter,101,95872,11427,11136,123,11259,133
2021-08-20,Tehama,103,63373,5922,5730,751,6481,66
2021-08-20,Trinity,105,12862,588,422,135,557,3
2021-08-20,Tulare,107,460477,54701,52855,10685,63540,856
2021-08-20,Tuolumne,109,53932,5297,5153,60,5213,73
2021-08-20,Ventura,111,848112,89643,88285,3809,92094,1061
2021-08-20,Yolo,113,214977,16845,16236,654,16890,225
2021-08-20,Yuba,115,75493,7815,7523,167,7690,54
2021-08-19,Alameda,001,1643700,106465,103276,2329,105605,1294
2021-08-19,Alpine,003,1148,91,91,0,91,0
2021-08-19,Amador,005,37829,4446,4317,38,4355,50
2021-08-19,Butte,007,227075,15146,14518,2430,16948,211
2021-08-19,Calaveras,009,45235,2832,2673,19,2692,59
2021-08-19,Colusa,011,21464,2242,2167,448,2615,16
2021-08-19,Contra Costa,013,1133247,86977,83296,1686,84982,852
2021-08-19,Del Norte,015,27424,2585,2257,16,2273,8
2021-08-19,El Dorado,017,186661,13104,12410,1121,13531,118
2021-08-19,Fresno,019,978130,114048,110947,9893,120840,1759
2021-08-19,Glenn,021,27897,2743,2629,706,3335,20
2021-08-19,Humboldt,023,135768,6622,6246,152,6398,52
2021-08-19,Imperial,025,180216,30126,29865,2795,32660,747
2021-08-19,Inyo,027,18085,1504,1494,13,1507,39
2021-08-19,Kern,029,883053,105939,103731,13741,117472,1371
2021-08-19,Kings,031,150075,25871,25128,1328,26456,256
2021-08-19,Lake,033,64148,5183,4991,42,5033,69
2021-08-19,Lassen,035,31185,5632,5520,144,5664,21
2021-08-19,Los Angeles,037,10098052,1334381,1314453,48464,1362917,25020
2021-08-19,Madera,039,155013,18520,17947,1239,19186,246
2021-08-19,Marin,041,260295,16041,15672,314,15986,240
2021-08-19,Mariposa,043,17540,672,618,17,635,5
2021-08-19,Mendocino,045,87422,5505,5167,178,5345,51
2021-08-19,Merced,047,269075,34478,33851,1239,35090,486
2021-08-19,Modoc,049,8938,440,427,153,580,6
2021-08-19,Mono,051,14174,1387,1349,17,1366,3
2021-08-19,Monterey,053,433212,45406,44821,2213,47034,538
2021-08-19,Napa,055,140530,11338,11104,68,11172,83
2021-08-19,Nevada,057,99092,7048,6695,227,6922,77
2021-08-19,Orange,059,3164182,283003,278562,12930,291492,5172
2021-08-19,Placer,061,380077,29675,27953,2453,30406,313
2021-08-19,Plumas,063,18699,953,896,14,910,5
2021-08-19,Riverside,065,2383286,325401,318056,15019,333075,4589
2021-08-19,Sacramento,067,1510023,131972,126720,2667,129387,1801
2021-08-19,San Benito,069,59416,6584,6493,125,6618,64
2021-08-19,San Bernardino,071,2135413,321585,316398,9794,326192,5318
2021-08-19,San Diego,073,3302833,326258,319582,18949,338531,3839
2021-08-19,San Francisco,075,870044,46609,45220,1868,47088,571
2021-08-19,San Joaquin,077,732212,84838,82047,4299,86346,1491
2021-08-19,San Luis Obispo,079,281455,24632,23878,930,24808,271
2021-08-19,San Mateo,081,765935,48691,47431,687,48118,551
2021-08-19,Santa Barbara,083,443738,38655,37693,1315,39008,477
2021-08-19,Santa Clara,085,1922200,132465,129133,952,130085,1774
2021-08-19,Santa Cruz,087,273765,18113,17644,886,18530,209
2021-08-19,Shasta,089,179085,14752,14200,2038,16238,214
2021-08-19,Sierra,091,2930,93,83,13,96,0
2021-08-19,Siskiyou,093,43540,2351,2218,597,2815,33
2021-08-19,Solano,095,438530,40294,38025,937,38962,273
2021-08-19,Sonoma,097,501317,36645,35233,435,35668,336
2021-08-19,Stanislaus,099,539301,64574,62928,7070,69998,1047
2021-08-19,Sutter,101,95872,11342,11057,122,11179,133
2021-08-19,Tehama,103,63373,5886,5683,725,6408,66
2021-08-19,Trinity,105,12862,584,414,133,547,3
2021-08-19,Tulare,107,460477,54469,52685,10622,63307,856
2021-08-19,Tuolumne,109,53932,5261,5112,59,5171,64
2021-08-19,Ventura,111,848112,89440,88073,3795,91868,1060
2021-08-19,Yolo,113,214977,16760,16153,646,16799,225
2021-08-19,Yuba,115,75493,7762,7458,166,7624,51
2021-08-18,Alameda,001,1643700,106061,102696,2307,105003,1294
2021-08-18,Alpine,003,1148,90,91,0,91,0
2021-08-18,Amador,005,37829,4430,4279,37,4316,50
2021-08-18,Butte,007,227075,15036,14426,2402,16828,208
2021-08-18,Calaveras,009,45235,2795,2643,18,2661,59
2021-08-18,Colusa,011,21464,2234,2160,444,2604,16
2021-08-18,Contra Costa,013,1133247,86478,82767,1680,84447,851
2021-08-18,Del Norte,015,27424,2528,2219,16,2235,8
2021-08-18,El Dorado,017,186661,13014,12306,1107,13413,118
2021-08-18,Fresno,019,978130,113593,110523,9832,120355,1759
2021-08-18,Glenn,021,27897,2710,2623,698,3321,20
2021-08-18,Humboldt,023,135768,6551,6195,147,6342,52
2021-08-18,Imperial,025,180216,30093,29821,2793,32614,746
2021-08-18,Inyo,027,18085,1501,1494,13,1507,39
2021-08-18,Kern,029,883053,105592,103440,13647,117087,1370
2021-08-18,Kings,031,150075,25762,24984,1320,26304,256
2021-08-18,Lake,033,64148,5142,4957,41,4998,69
2021-08-18,Lassen,035,31185,5613,5506,143,5649,21
2021-08-18,Los Angeles,037,10098052,1331228,1311477,48332,1359809,24984
2021-08-18,Madera,039,155013,18461,17871,1226,19097,246
2021-08-18,Marin,041,260295,16003,15610,311,15921,240
2021-08-18,Mariposa,043,17540,659,615,16,631,5
2021-08-18,Mendocino,045,87422,5454,5129,176,5305,51
2021-08-18,Merced,047,269075,34314,33708,1228,34936,484
2021-08-18,Modoc,049,8938,440,427,152,579,6
2021-08-18,Mono,051,14174,1384,1344,17,1361,3
2021-08-18,Monterey,053,433212,45322,44735,2196,46931,532
2021-08-18,Napa,055,140530,11299,11060,67,11127,83
2021-08-18,Nevada,057,99092,6982,6633,227,6860,76
2021-08-18,Orange,059,3164182,282366,277795,12878,290673,5168
2021-08-18,Placer,061,380077,29448,27741,2425,30166,312
2021-08-18,Plumas,063,18699,944,874,14,888,5
2021-08-18,Riverside,065,2383286,324403,317107,14986,332093,4585
2021-08-18,Sacramento,067,1510023,131210,125599,2635,128234,1781
2021-08-18,San Benito,069,59416,6573,6481,124,6605,64
2021-08-18,San Bernardino,071,2135413,320786,315477,9775,325252,5304
2021-08-18,San Diego,073,3302833,324918,318152,18883,337035,3834
2021-08-18,San Francisco,075,870044,46407,44957,1859,46816,568
2021-08-18,San Joaquin,077,732212,84385,81601,4268,85869,1491
2021-08-18,San Luis Obispo,079,281455,24482,23726,917,24643,270
2021-08-18,San Mateo,081,765935,48527,47255,686,47941,551
2021-08-18,Santa Barbara,083,443738,38524,37599,1309,38908,475
2021-08-18,Santa Clara,085,1922200,132101,128563,949,129512,1773
2021-08-18,Santa Cruz,087,273765,18058,17566,882,18448,209
2021-08-18,Shasta,089,179085,14653,14087,2019,16106,213
2021-08-18,Sierra,091,2930,92,83,13,96,0
2021-08-18,Siskiyou,093,43540,2322,2204,585,2789,33
2021-08-18,Solano,095,438530,40088,37812,922,38734,271
2021-08-18,Sonoma,097,501317,36501,35063,434,35497,333
2021-08-18,Stanislaus,099,539301,64243,62613,7027,69640,1047
2021-08-18,Sutter,101,95872,11270,11004,117,11121,130
2021-08-18,Tehama,103,63373,5851,5653,715,6368,66
2021-08-18,Trinity,105,12862,577,409,130,539,3
2021-08-18,Tulare,107,460477,54229,52486,10553,63039,856
2021-08-18,Tuolumne,109,53932,5225,5081,57,5138,64
2021-08-18,Ventura,111,848112,89208,87835,3785,91620,1055
2021-08-18,Yolo,113,214977,16677,16047,628,16675,225
2021-08-18,Yuba,115,75493,7697,7391,166,7557,51
2021-08-17,Alameda,001,1643700,105664,102379,2292,104671,1290
2021-08-17,Alpine,003,1148,90,91,0,91,0
2021-08-17,Amador,005,37829,4401,4266,37,4303,50
2021-08-17,Butte,007,227075,14929,14357,2367,16724,206
2021-08-17,Calaveras,009,45235,2761,2624,18,2642,59
2021-08-17,Colusa,011,21464,2225,2156,440,2596,16
2021-08-17,Contra Costa,013,1133247,86031,82482,1670,84152,848
2021-08-17,Del Norte,015,27424,2474,2188,16,2204,8
2021-08-17,El Dorado,017,186661,12927,12242,1094,13336,118
2021-08-17,Fresno,019,978130,113109,110263,9769,120032,1755
2021-08-17,Glenn,021,27897,2696,2608,689,3297,20
2021-08-17,Humboldt,023,135768,6471,6155,145,6300,52
2021-08-17,Imperial,025,180216,30042,29768,2789,32557,746
2021-08-17,Inyo,027,18085,1498,1492,13,1505,39
2021-08-17,Kern,029,883053,105198,103048,13525,116573,1367
2021-08-17,Kings,031,150075,25657,24930,1309,26239,254
2021-08-17,Lake,033,64148,5099,4930,35,4965,68
2021-08-17,Lassen,035,31185,5596,5499,141,5640,21
2021-08-17,Los Angeles,037,10098052,1327662,1307999,48203,1356202,24952
2021-08-17,Madera,039,155013,18387,17838,1208,19046,246
2021-08-17,Marin,041,260295,15947,15570,311,15881,240
2021-08-17,Mariposa,043,17540,651,609,15,624,5
2021-08-17,Mendocino,045,87422,5399,5097,176,5273,51
2021-08-17,Merced,047,269075,34164,33508,1217,34725,482
2021-08-17,Modoc,049,8938,437,424,150,574,6
2021-08-17,Mono,051,14174,1379,1341,17,1358,3
2021-08-17,Monterey,053,433212,45238,44672,2186,46858,528
2021-08-17,Napa,055,140530,11258,11007,66,11073,83
2021-08-17,Nevada,057,99092,6907,6605,225,6830,75
2021-08-17,Orange,059,3164182,281720,277121,12842,289963,5164
2021-08-17,Placer,061,380077,29233,27634,2396,30030,312
2021-08-17,Plumas,063,18699,932,860,14,874,5
2021-08-17,Riverside,065,2383286,323391,316051,14943,330994,4582
2021-08-17,Sacramento,067,1510023,130416,125151,2593,127744,1774
2021-08-17,San Benito,069,59416,6554,6470,124,6594,64
2021-08-17,San Bernardino,071,2135413,319847,314402,9735,324137,5302
2021-08-17,San Diego,073,3302833,323308,317058,18785,335843,3824
2021-08-17,San Francisco,075,870044,46207,44820,1853,46673,567
2021-08-17,San Joaquin,077,732212,83917,81300,4234,85534,1489
2021-08-17,San Luis Obispo,079,281455,24326,23556,914,24470,268
2021-08-17,San Mateo,081,765935,48372,47127,681,47808,551
2021-08-17,Santa Barbara,083,443738,38365,37478,1302,38780,475
2021-08-17,Santa Clara,085,1922200,131698,128354,943,129297,1773
2021-08-17,Santa Cruz,087,273765,17973,17528,881,18409,209
2021-08-17,Shasta,089,179085,14522,14012,2000,16012,214
2021-08-17,Sierra,091,2930,91,82,13,95,0
2021-08-17,Siskiyou,093,43540,2306,2183,572,2755,33
2021-08-17,Solano,095,438530,39859,37662,909,38571,269
2021-08-17,Sonoma,097,501317,36353,34943,430,35373,333
2021-08-17,Stanislaus,099,539301,63902,62385,6968,69353,1047
2021-08-17,Sutter,101,95872,11198,10973,117,11090,130
2021-08-17,Tehama,103,63373,5817,5612,693,6305,66
2021-08-17,Trinity,105,12862,572,406,128,534,3
2021-08-17,Tulare,107,460477,53961,52362,10488,62850,856
2021-08-17,Tuolumne,109,53932,5182,5042,56,5098,64
2021-08-17,Ventura,111,848112,88970,87601,3764,91365,1053
2021-08-17,Yolo,113,214977,16588,15975,614,16589,225
2021-08-17,Yuba,115,75493,7626,7355,166,7521,51
2021-08-16,Alameda,001,1643700,105168,102052,2284,104336,1287
2021-08-16,Alpine,003,1148,90,91,0,91,0
2021-08-16,Amador,005,37829,4391,4235,37,4272,50
2021-08-16,Butte,007,227075,14809,14283,2331,16614,206
2021-08-16,Calaveras,009,45235,2701,2609,17,2626,57
2021-08-16,Colusa,011,21464,2214,2147,436,2583,16
2021-08-16,Contra Costa,013,1133247,85489,82070,1660,83730,848
2021-08-16,Del Norte,015,27424,2397,2125,16,2141,8
2021-08-16,El Dorado,017,186661,12826,12139,1081,13220,118
2021-08-16,Fresno,019,978130,112611,109623,9717,119340,1753
2021-08-16,Glenn,021,27897,2677,2593,683,3276,20
2021-08-16,Humboldt,023,135768,6400,6064,124,6188,52
2021-08-16,Imperial,025,180216,30001,29737,2775,32512,746
2021-08-16,Inyo,027,18085,1495,1490,13,1503,39
2021-08-16,Kern,029,883053,104823,102690,13409,116099,1367
2021-08-16,Kings,031,150075,25554,24817,1300,26117,254
2021-08-16,Lake,033,64148,5072,4898,34,4932,68
2021-08-16,Lassen,035,31185,5580,5481,133,5614,21
2021-08-16,Los Angeles,037,10098052,1324281,1305330,48061,1353391,24923
2021-08-16,Madera,039,155013,18312,17756,1187,18943,246
2021-08-16,Marin,041,260295,15888,15497,310,15807,239
2021-08-16,Mariposa,043,17540,634,597,15,612,5
2021-08-16,Mendocino,045,87422,5343,5037,174,5211,49
2021-08-16,Merced,047,269075,33963,33364,1204,34568,481
2021-08-16,Modoc,049,8938,435,421,149,570,5
2021-08-16,Mono,051,14174,1374,1339,17,1356,3
2021-08-16,Monterey,053,433212,45159,44595,2174,46769,527
2021-08-16,Napa,055,140530,11229,10946,66,11012,83
2021-08-16,Nevada,057,99092,6852,6535,224,6759,74
2021-08-16,Orange,059,3164182,280926,275985,12796,288781,5161
2021-08-16,Placer,061,380077,29050,27384,2364,29748,306
2021-08-16,Plumas,063,18699,921,851,14,865,5
2021-08-16,Riverside,065,2383286,322300,314774,14906,329680,4582
2021-08-16,Sacramento,067,1510023,129605,124554,2550,127104,1762
2021-08-16,San Benito,069,59416,6530,6452,124,6576,64
2021-08-16,San Bernardino,071,2135413,318880,313617,9708,323325,5301
2021-08-16,San Diego,073,3302833,321710,315348,18645,333993,3824
2021-08-16,San Francisco,075,870044,46003,44681,1846,46527,567
2021-08-16,San Joaquin,077,732212,83413,81087,4206,85293,1488
2021-08-16,San Luis Obispo,079,281455,24176,23452,906,24358,265
2021-08-16,San Mateo,081,765935,48189,47024,675,47699,548
2021-08-16,Santa Barbara,083,443738,38194,37358,1297,38655,475
2021-08-16,Santa Clara,085,1922200,131234,127978,939,128917,1773
2021-08-16,Santa Cruz,087,273765,17909,17491,875,18366,209
2021-08-16,Shasta,089,179085,14433,13862,1984,15846,211
2021-08-16,Sierra,091,2930,88,82,13,95,0
2021-08-16,Siskiyou,093,43540,2289,2169,552,2721,33
2021-08-16,Solano,095,438530,39578,37436,897,38333,263
2021-08-16,Sonoma,097,501317,36185,34844,427,35271,333
2021-08-16,Stanislaus,099,539301,63563,62033,6916,68949,1039
2021-08-16,Sutter,101,95872,11129,10902,116,11018,130
2021-08-16,Tehama,103,63373,5754,5565,688,6253,66
2021-08-16,Trinity,105,12862,566,400,127,527,3
2021-08-16,Tulare,107,460477,53718,52162,10420,62582,856
2021-08-16,Tuolumne,109,53932,5143,4984,55,5039,64
2021-08-16,Ventura,111,848112,88725,86954,3746,90700,1052
2021-08-16,Yolo,113,214977,16487,15922,606,16528,225
2021-08-16,Yuba,115,75493,7542,7314,165,7479,51
2021-08-15,Alameda,001,1643700,104684,101660,2267,103927,1287
2021-08-15,Alpine,003,1148,90,91,0,91,0
2021-08-15,Amador,005,37829,4363,4231,37,4268,49
2021-08-15,Butte,007,227075,14684,14263,2308,16571,206
2021-08-15,Calaveras,009,45235,2659,2599,17,2616,57
2021-08-15,Colusa,011,21464,2202,2140,426,2566,16
2021-08-15,Contra Costa,013,1133247,85006,81781,1645,83426,848
2021-08-15,Del Norte,015,27424,2330,2060,16,2076,8
2021-08-15,El Dorado,017,186661,12691,12057,1064,13121,118
2021-08-15,Fresno,019,978130,112132,109382,9651,119033,1753
2021-08-15,Glenn,021,27897,2654,2592,671,3263,20
2021-08-15,Humboldt,023,135768,6326,6024,118,6142,52
2021-08-15,Imperial,025,180216,29935,29711,2771,32482,746
2021-08-15,Inyo,027,18085,1494,1489,13,1502,39
2021-08-15,Kern,029,883053,104379,102524,13297,115821,1367
2021-08-15,Kings,031,150075,25409,24736,1290,26026,254
2021-08-15,Lake,033,64148,5013,4886,33,4919,68
2021-08-15,Lassen,035,31185,5563,5482,132,5614,21
2021-08-15,Los Angeles,037,10098052,1320744,1302882,47892,1350774,24918
2021-08-15,Madera,039,155013,18224,17714,1171,18885,246
2021-08-15,Marin,041,260295,15829,15461,308,15769,239
2021-08-15,Mariposa,043,17540,627,591,14,605,5
2021-08-15,Mendocino,045,87422,5286,5022,168,5190,49
2021-08-15,Merced,047,269075,33719,33305,1193,34498,481
2021-08-15,Modoc,049,8938,433,421,149,570,5
2021-08-15,Mono,051,14174,1370,1334,17,1351,3
2021-08-15,Monterey,053,433212,45037,44567,2153,46720,527
2021-08-15,Napa,055,140530,11174,10919,66,10985,83
2021-08-15,Nevada,057,99092,6767,6486,224,6710,74
2021-08-15,Orange,059,3164182,280155,275447,12756,288203,5161
2021-08-15,Placer,061,380077,28828,27220,2316,29536,306
2021-08-15,Plumas,063,18699,909,850,14,864,5
2021-08-15,Riverside,065,2383286,321162,314133,14879,329012,4582
2021-08-15,Sacramento,067,1510023,128789,123924,2518,126442,1761
2021-08-15,San Benito,069,59416,6512,6446,123,6569,64
2021-08-15,San Bernardino,071,2135413,317808,313120,9677,322797,5301
2021-08-15,San Diego,073,3302833,320238,314247,18518,332765,3824
2021-08-15,San Francisco,075,870044,45779,44531,1831,46362,567
2021-08-15,San Joaquin,077,732212,82926,80832,4167,84999,1488
2021-08-15,San Luis Obispo,079,281455,23980,23404,896,24300,265
2021-08-15,San Mateo,081,765935,48002,46897,669,47566,548
2021-08-15,Santa Barbara,083,443738,38022,37276,1290,38566,475
2021-08-15,Santa Clara,085,1922200,130801,127715,933,128648,1773
2021-08-15,Santa Cruz,087,273765,17839,17440,868,18308,209
2021-08-15,Shasta,089,179085,14330,13835,1959,15794,211
2021-08-15,Sierra,091,2930,87,82,12,94,0
2021-08-15,Siskiyou,093,43540,2268,2169,538,2707,33
2021-08-15,Solano,095,438530,39322,37320,886,38206,263
2021-08-15,Sonoma,097,501317,35989,34706,419,35125,333
2021-08-15,Stanislaus,099,539301,63193,61795,6839,68634,1039
2021-08-15,Sutter,101,95872,11038,10863,116,10979,130
2021-08-15,Tehama,103,63373,5705,5550,682,6232,66
2021-08-15,Trinity,105,12862,562,400,126,526,3
2021-08-15,Tulare,107,460477,53462,52046,10361,62407,856
2021-08-15,Tuolumne,109,53932,5105,4934,53,4987,64
2021-08-15,Ventura,111,848112,88420,86797,3732,90529,1052
2021-08-15,Yolo,113,214977,16390,15873,596,16469,225
2021-08-15,Yuba,115,75493,7465,7265,164,7429,51
2021-08-14,Alameda,001,1643700,104467,101305,2263,103568,1287
2021-08-14,Alpine,003,1148,90,91,0,91,0
2021-08-14,Amador,005,37829,4345,4206,37,4243,49
2021-08-14,Butte,007,227075,14648,14192,2292,16484,206
2021-08-14,Calaveras,009,45235,2652,2579,17,2596,57
2021-08-14,Colusa,011,21464,2191,2134,422,2556,16
2021-08-14,Contra Costa,013,1133247,84758,81458,1637,83095,848
2021-08-14,Del Norte,015,27424,2303,2015,16,2031,8
2021-08-14,El Dorado,017,186661,12655,12019,1056,13075,118
2021-08-14,Fresno,019,978130,111970,109056,9621,118677,1753
2021-08-14,Glenn,021,27897,2643,2583,668,3251,20
2021-08-14,Humboldt,023,135768,6273,5998,115,6113,52
2021-08-14,Imperial,025,180216,29908,29671,2771,32442,746
2021-08-14,Inyo,027,18085,1492,1487,13,1500,39
2021-08-14,Kern,029,883053,104184,102306,13201,115507,1367
2021-08-14,Kings,031,150075,25311,24647,1282,25929,254
2021-08-14,Lake,033,64148,4996,4850,32,4882,68
2021-08-14,Lassen,035,31185,5556,5475,131,5606,21
2021-08-14,Los Angeles,037,10098052,1318975,1299346,47753,1347099,24911
2021-08-14,Madera,039,155013,18177,17691,1166,18857,246
2021-08-14,Marin,041,260295,15795,15441,308,15749,239
2021-08-14,Mariposa,043,17540,623,584,14,598,5
2021-08-14,Mendocino,045,87422,5250,4977,165,5142,49
2021-08-14,Merced,047,269075,33655,33234,1187,34421,481
2021-08-14,Modoc,049,8938,433,421,149,570,5
2021-08-14,Mono,051,14174,1365,1332,17,1349,3
2021-08-14,Monterey,053,433212,44992,44514,2150,46664,527
2021-08-14,Napa,055,140530,11144,10878,65,10943,83
2021-08-14,Nevada,057,99092,6732,6419,223,6642,74
2021-08-14,Orange,059,3164182,279721,274732,12729,287461,5161
2021-08-14,Placer,061,380077,28682,27115,2292,29407,306
2021-08-14,Plumas,063,18699,899,849,14,863,5
2021-08-14,Riverside,065,2383286,320446,313264,14858,328122,4582
2021-08-14,Sacramento,067,1510023,128295,123438,2500,125938,1758
2021-08-14,San Benito,069,59416,6499,6428,123,6551,64
2021-08-14,San Bernardino,071,2135413,317257,312142,9656,321798,5301
2021-08-14,San Diego,073,3302833,319567,313589,18450,332039,3824
2021-08-14,San Francisco,075,870044,45650,44353,1812,46165,567
2021-08-14,San Joaquin,077,732212,82710,80585,4152,84737,1488
2021-08-14,San Luis Obispo,079,281455,23919,23328,893,24221,265
2021-08-14,San Mateo,081,765935,47883,46792,665,47457,548
2021-08-14,Santa Barbara,083,443738,37928,37118,1288,38406,475
2021-08-14,Santa Clara,085,1922200,130522,127432,930,128362,1772
2021-08-14,Santa Cruz,087,273765,17800,17384,867,18251,209
2021-08-14,Shasta,089,179085,14255,13813,1938,15751,211
2021-08-14,Sierra,091,2930,86,81,12,93,0
2021-08-14,Siskiyou,093,43540,2258,2160,528,2688,33
2021-08-14,Solano,095,438530,39235,37237,874,38111,263
2021-08-14,Sonoma,097,501317,35866,34606,417,35023,333
2021-08-14,Stanislaus,099,539301,63017,61564,6795,68359,1039
2021-08-14,Sutter,101,95872,10993,10808,115,10923,130
2021-08-14,Tehama,103,63373,5681,5530,678,6208,66
2021-08-14,Trinity,105,12862,556,399,126,525,3
2021-08-14,Tulare,107,460477,53326,51951,10316,62267,856
2021-08-14,Tuolumne,109,53932,5070,4924,53,4977,64
2021-08-14,Ventura,111,848112,88264,86569,3712,90281,1052
2021-08-14,Yolo,113,214977,16345,15815,587,16402,225
2021-08-14,Yuba,115,75493,7416,7223,164,7387,51
2021-08-13,Alameda,001,1643700,104171,100930,2255,103185,1284
2021-08-13,Alpine,003,1148,90,91,0,91,0
2021-08-13,Amador,005,37829,4317,4169,37,4206,49
2021-08-13,Butte,007,227075,14578,14100,2276,16376,206
2021-08-13,Calaveras,009,45235,2646,2564,17,2581,57
2021-08-13,Colusa,011,21464,2184,2123,417,2540,16
2021-08-13,Contra Costa,013,1133247,84447,81046,1630,82676,848
2021-08-13,Del Norte,015,27424,2262,1973,16,1989,8
2021-08-13,El Dorado,017,186661,12615,11951,1044,12995,118
2021-08-13,Fresno,019,978130,111678,108638,9596,118234,1753
2021-08-13,Glenn,021,27897,2632,2574,665,3239,20
2021-08-13,Humboldt,023,135768,6226,5882,112,5994,52
2021-08-13,Imperial,025,180216,29881,29654,2770,32424,745
2021-08-13,Inyo,027,18085,1491,1484,13,1497,39
2021-08-13,Kern,029,883053,103975,102029,13092,115121,1364
2021-08-13,Kings,031,150075,25226,24531,1275,25806,253
2021-08-13,Lake,033,64148,4973,4811,31,4842,68
2021-08-13,Lassen,035,31185,5548,5455,130,5585,21
2021-08-13,Los Angeles,037,10098052,1316652,1295406,47616,1343022,24891
2021-08-13,Madera,039,155013,18128,17614,1157,18771,246
2021-08-13,Marin,041,260295,15764,15380,308,15688,239
2021-08-13,Mariposa,043,17540,617,577,14,591,5
2021-08-13,Mendocino,045,87422,5197,4924,163,5087,49
2021-08-13,Merced,047,269075,33608,33111,1181,34292,480
2021-08-13,Modoc,049,8938,432,421,148,569,5
2021-08-13,Mono,051,14174,1362,1331,17,1348,3
2021-08-13,Monterey,053,433212,44932,44450,2148,46598,527
2021-08-13,Napa,055,140530,11108,10830,65,10895,83
2021-08-13,Nevada,057,99092,6691,6356,222,6578,74
2021-08-13,Orange,059,3164182,279227,274004,12680,286684,5159
2021-08-13,Placer,061,380077,28581,26987,2265,29252,306
2021-08-13,Plumas,063,18699,885,842,14,856,5
2021-08-13,Riverside,065,2383286,319707,312408,14833,327241,4581
2021-08-13,Sacramento,067,1510023,127825,122868,2475,125343,1758
2021-08-13,San Benito,069,59416,6493,6422,121,6543,64
2021-08-13,San Bernardino,071,2135413,316589,311378,9637,321015,5301
2021-08-13,San Diego,073,3302833,318521,312293,18371,330664,3821
2021-08-13,San Francisco,075,870044,45514,44196,1789,45985,567
2021-08-13,San Joaquin,077,732212,82493,80232,4136,84368,1481
2021-08-13,San Luis Obispo,079,281455,23856,23226,890,24116,265
2021-08-13,San Mateo,081,765935,47764,46660,664,47324,548
2021-08-13,Santa Barbara,083,443738,37843,37023,1284,38307,474
2021-08-13,Santa Clara,085,1922200,130235,126958,924,127882,1769
2021-08-13,Santa Cruz,087,273765,17760,17332,860,18192,209
2021-08-13,Shasta,089,179085,14192,13698,1924,15622,211
2021-08-13,Sierra,091,2930,85,81,12,93,0
2021-08-13,Siskiyou,093,43540,2249,2147,524,2671,33
2021-08-13,Solano,095,438530,39101,37104,866,37970,264
2021-08-13,Sonoma,097,501317,35761,34464,417,34881,333
2021-08-13,Stanislaus,099,539301,62845,61294,6754,68048,1039
2021-08-13,Sutter,101,95872,10949,10751,114,10865,130
2021-08-13,Tehama,103,63373,5657,5496,676,6172,66
2021-08-13,Trinity,105,12862,552,392,126,518,3
2021-08-13,Tulare,107,460477,53222,51770,10243,62013,856
2021-08-13,Tuolumne,109,53932,5037,4899,52,4951,64
2021-08-13,Ventura,111,848112,88106,86368,3699,90067,1052
2021-08-13,Yolo,113,214977,16291,15761,577,16338,225
2021-08-13,Yuba,115,75493,7378,7184,164,7348,51
2021-08-12,Alameda,001,1643700,103681,100472,2242,102714,1284
2021-08-12,Alpine,003,1148,90,91,0,91,0
2021-08-12,Amador,005,37829,4287,4161,36,4197,49
2021-08-12,Butte,007,227075,14508,14006,2258,16264,206
2021-08-12,Calaveras,009,45235,2630,2531,17,2548,57
2021-08-12,Colusa,011,21464,2179,2111,416,2527,17
2021-08-12,Contra Costa,013,1133247,83964,80738,1615,82353,846
2021-08-12,Del Norte,015,27424,2190,1923,16,1939,8
2021-08-12,El Dorado,017,186661,12501,11880,1035,12915,118
2021-08-12,Fresno,019,978130,111256,108193,9528,117721,1753
2021-08-12,Glenn,021,27897,2624,2559,653,3212,20
2021-08-12,Humboldt,023,135768,6157,5845,108,5953,52
2021-08-12,Imperial,025,180216,29825,29585,2764,32349,745
2021-08-12,Inyo,027,18085,1489,1483,13,1496,39
2021-08-12,Kern,029,883053,103686,101698,13013,114711,1364
2021-08-12,Kings,031,150075,25126,24423,1267,25690,252
2021-08-12,Lake,033,64148,4947,4774,31,4805,68
2021-08-12,Lassen,035,31185,5526,5428,129,5557,21
2021-08-12,Los Angeles,037,10098052,1313461,1291875,47481,1339356,24874
2021-08-12,Madera,039,155013,18064,17564,1145,18709,246
2021-08-12,Marin,041,260295,15715,15277,305,15582,239
2021-08-12,Mariposa,043,17540,608,568,13,581,5
2021-08-12,Mendocino,045,87422,5167,4873,157,5030,49
2021-08-12,Merced,047,269075,33484,32960,1174,34134,480
2021-08-12,Modoc,049,8938,431,423,148,571,5
2021-08-12,Mono,051,14174,1357,1325,17,1342,3
2021-08-12,Monterey,053,433212,44856,44383,2133,46516,527
2021-08-12,Napa,055,140530,11059,10780,64,10844,83
2021-08-12,Nevada,057,99092,6630,6283,222,6505,74
2021-08-12,Orange,059,3164182,278549,273167,12622,285789,5158
2021-08-12,Placer,061,380077,28382,26856,2242,29098,306
2021-08-12,Plumas,063,18699,877,829,14,843,5
2021-08-12,Riverside,065,2383286,318698,311304,14801,326105,4575
2021-08-12,Sacramento,067,1510023,127054,122222,2445,124667,1758
2021-08-12,San Benito,069,59416,6476,6398,119,6517,64
2021-08-12,San Bernardino,071,2135413,315715,310420,9607,320027,5297
2021-08-12,San Diego,073,3302833,317151,310596,18282,328878,3821
2021-08-12,San Francisco,075,870044,45307,43774,1776,45550,564
2021-08-12,San Joaquin,077,732212,82098,79945,4112,84057,1479
2021-08-12,San Luis Obispo,079,281455,23756,23101,877,23978,264
2021-08-12,San Mateo,081,765935,47620,46435,661,47096,548
2021-08-12,Santa Barbara,083,443738,37706,36881,1276,38157,473
2021-08-12,Santa Clara,085,1922200,129786,126614,918,127532,1769
2021-08-12,Santa Cruz,087,273765,17696,17261,859,18120,209
2021-08-12,Shasta,089,179085,14106,13621,1897,15518,211
2021-08-12,Sierra,091,2930,85,81,12,93,0
2021-08-12,Siskiyou,093,43540,2242,2134,515,2649,33
2021-08-12,Solano,095,438530,38872,36980,857,37837,262
2021-08-12,Sonoma,097,501317,35613,34299,414,34713,333
2021-08-12,Stanislaus,099,539301,62579,61026,6695,67721,1039
2021-08-12,Sutter,101,95872,10888,10695,112,10807,130
2021-08-12,Tehama,103,63373,5627,5462,667,6129,66
2021-08-12,Trinity,105,12862,548,386,125,511,3
2021-08-12,Tulare,107,460477,53077,51632,10194,61826,856
2021-08-12,Tuolumne,109,53932,4990,4845,50,4895,64
2021-08-12,Ventura,111,848112,87869,86106,3675,89781,1052
2021-08-12,Yolo,113,214977,16219,15686,563,16249,224
2021-08-12,Yuba,115,75493,7330,7128,163,7291,51
2021-08-11,Alameda,001,1643700,103170,100040,2239,102279,1281
2021-08-11,Alpine,003,1148,90,91,0,91,0
2021-08-11,Amador,005,37829,4263,4127,36,4163,49
2021-08-11,Butte,007,227075,14407,13905,2233,16138,206
2021-08-11,Calaveras,009,45235,2608,2505,17,2522,57
2021-08-11,Colusa,011,21464,2169,2101,414,2515,16
2021-08-11,Contra Costa,013,1133247,83464,80275,1597,81872,843
2021-08-11,Del Norte,015,27424,2131,1893,16,1909,8
2021-08-11,El Dorado,017,186661,12390,11799,1023,12822,119
2021-08-11,Fresno,019,978130,110802,107773,9482,117255,1751
2021-08-11,Glenn,021,27897,2615,2547,643,3190,20
2021-08-11,Humboldt,023,135768,6110,5765,107,5872,52
2021-08-11,Imperial,025,180216,29782,29565,2760,32325,745
2021-08-11,Inyo,027,18085,1489,1483,13,1496,39
2021-08-11,Kern,029,883053,103372,101448,12906,114354,1363
2021-08-11,Kings,031,150075,25013,24304,1258,25562,250
2021-08-11,Lake,033,64148,4910,4713,30,4743,68
2021-08-11,Lassen,035,31185,5517,5408,127,5535,21
2021-08-11,Los Angeles,037,10098052,1310133,1288238,47295,1335533,24851
2021-08-11,Madera,039,155013,18014,17511,1134,18645,245
2021-08-11,Marin,041,260295,15666,15235,305,15540,239
2021-08-11,Mariposa,043,17540,598,554,12,566,5
2021-08-11,Mendocino,045,87422,5098,4796,148,4944,49
2021-08-11,Merced,047,269075,33351,32802,1170,33972,479
2021-08-11,Modoc,049,8938,431,421,148,569,5
2021-08-11,Mono,051,14174,1352,1320,17,1337,3
2021-08-11,Monterey,053,433212,44757,44314,2115,46429,527
2021-08-11,Napa,055,140530,11018,10732,64,10796,83
2021-08-11,Nevada,057,99092,6577,6172,219,6391,74
2021-08-11,Orange,059,3164182,277692,272212,12577,284789,5155
2021-08-11,Placer,061,380077,28170,26687,2216,28903,305
2021-08-11,Plumas,063,18699,868,824,14,838,5
2021-08-11,Riverside,065,2383286,317705,310265,14766,325031,4570
2021-08-11,Sacramento,067,1510023,126261,121603,2406,124009,1757
2021-08-11,San Benito,069,59416,6463,6381,119,6500,64
2021-08-11,San Bernardino,071,2135413,314821,309498,9588,319086,5296
2021-08-11,San Diego,073,3302833,315681,309406,18178,327584,3818
2021-08-11,San Francisco,075,870044,45082,43555,1768,45323,564
2021-08-11,San Joaquin,077,732212,81691,79641,4085,83726,1478
2021-08-11,San Luis Obispo,079,281455,23652,22920,870,23790,264
2021-08-11,San Mateo,081,765935,47452,46300,658,46958,548
2021-08-11,Santa Barbara,083,443738,37543,36699,1268,37967,472
2021-08-11,Santa Clara,085,1922200,129305,126301,910,127211,1769
2021-08-11,Santa Cruz,087,273765,17631,17191,856,18047,209
2021-08-11,Shasta,089,179085,14032,13546,1882,15428,211
2021-08-11,Sierra,091,2930,84,81,12,93,0
2021-08-11,Siskiyou,093,43540,2228,2124,508,2632,33
2021-08-11,Solano,095,438530,38637,36862,843,37705,262
2021-08-11,Sonoma,097,501317,35434,34188,409,34597,333
2021-08-11,Stanislaus,099,539301,62248,60767,6665,67432,1037
2021-08-11,Sutter,101,95872,10816,10628,112,10740,130
2021-08-11,Tehama,103,63373,5598,5410,651,6061,66
2021-08-11,Trinity,105,12862,546,385,125,510,3
2021-08-11,Tulare,107,460477,52909,51464,10149,61613,854
2021-08-11,Tuolumne,109,53932,4958,4794,50,4844,64
2021-08-11,Ventura,111,848112,87617,85863,3654,89517,1051
2021-08-11,Yolo,113,214977,16144,15593,547,16140,218
2021-08-11,Yuba,115,75493,7271,7063,162,7225,53
2021-08-10,Alameda,001,1643700,102697,99771,2232,102003,1281
2021-08-10,Alpine,003,1148,90,91,0,91,0
2021-08-10,Amador,005,37829,4247,4093,36,4129,49
2021-08-10,Butte,007,227075,14323,13853,2212,16065,205
2021-08-10,Calaveras,009,45235,2584,2491,15,2506,57
2021-08-10,Colusa,011,21464,2156,2088,405,2493,16
2021-08-10,Contra Costa,013,1133247,82920,80018,1587,81605,840
2021-08-10,Del Norte,015,27424,2087,1870,16,1886,8
2021-08-10,El Dorado,017,186661,12289,11734,1011,12745,117
2021-08-10,Fresno,019,978130,110346,107616,9427,117043,1747
2021-08-10,Glenn,021,27897,2602,2538,633,3171,20
2021-08-10,Humboldt,023,135768,6056,5718,104,5822,52
2021-08-10,Imperial,025,180216,29747,29522,2753,32275,745
2021-08-10,Inyo,027,18085,1489,1482,13,1495,39
2021-08-10,Kern,029,883053,103044,101254,12810,114064,1359
2021-08-10,Kings,031,150075,24887,24252,1242,25494,251
2021-08-10,Lake,033,64148,4869,4700,30,4730,67
2021-08-10,Lassen,035,31185,5499,5401,127,5528,21
2021-08-10,Los Angeles,037,10098052,1306377,1285140,47130,1332270,24821
2021-08-10,Madera,039,155013,17941,17481,1124,18605,245
2021-08-10,Marin,041,260295,15619,15194,305,15499,239
2021-08-10,Mariposa,043,17540,585,550,12,562,5
2021-08-10,Mendocino,045,87422,5053,4775,144,4919,49
2021-08-10,Merced,047,269075,33204,32721,1161,33882,477
2021-08-10,Modoc,049,8938,430,421,148,569,5
2021-08-10,Mono,051,14174,1347,1320,17,1337,3
2021-08-10,Monterey,053,433212,44695,44259,2100,46359,527
2021-08-10,Napa,055,140530,10962,10703,63,10766,83
2021-08-10,Nevada,057,99092,6512,6151,218,6369,73
2021-08-10,Orange,059,3164182,276812,271688,12530,284218,5155
2021-08-10,Placer,061,380077,27951,26561,2174,28735,305
2021-08-10,Plumas,063,18699,859,816,14,830,5
2021-08-10,Riverside,065,2383286,316590,309529,14740,324269,4564
2021-08-10,Sacramento,067,1510023,125408,121159,2376,123535,1755
2021-08-10,San Benito,069,59416,6449,6371,119,6490,64
2021-08-10,San Bernardino,071,2135413,313896,308672,9570,318242,5295
2021-08-10,San Diego,073,3302833,314039,308288,18086,326374,3815
2021-08-10,San Francisco,075,870044,44828,43389,1753,45142,564
2021-08-10,San Joaquin,077,732212,81293,79391,4067,83458,1478
2021-08-10,San Luis Obispo,079,281455,23526,22776,868,23644,264
2021-08-10,San Mateo,081,765935,47280,46184,656,46840,548
2021-08-10,Santa Barbara,083,443738,37378,36574,1261,37835,472
2021-08-10,Santa Clara,085,1922200,128842,126019,903,126922,1770
2021-08-10,Santa Cruz,087,273765,17548,17142,854,17996,209
2021-08-10,Shasta,089,179085,13954,13461,1859,15320,211
2021-08-10,Sierra,091,2930,84,76,12,88,0
2021-08-10,Siskiyou,093,43540,2219,2088,501,2589,33
2021-08-10,Solano,095,438530,38391,36767,832,37599,262
2021-08-10,Sonoma,097,501317,35289,34054,406,34460,333
2021-08-10,Stanislaus,099,539301,61902,60605,6628,67233,1037
2021-08-10,Sutter,101,95872,10751,10569,112,10681,130
2021-08-10,Tehama,103,63373,5569,5392,646,6038,66
2021-08-10,Trinity,105,12862,546,384,125,509,3
2021-08-10,Tulare,107,460477,52744,51390,10097,61487,854
2021-08-10,Tuolumne,109,53932,4929,4780,48,4828,64
2021-08-10,Ventura,111,848112,87327,85714,3633,89347,1051
2021-08-10,Yolo,113,214977,16057,15568,537,16105,218
2021-08-10,Yuba,115,75493,7222,7028,162,7190,50
2021-08-09,Alameda,001,1643700,102145,99496,2228,101724,1276
2021-08-09,Alpine,003,1148,90,91,0,91,0
2021-08-09,Amador,005,37829,4221,4078,36,4114,48
2021-08-09,Butte,007,227075,14224,13813,2183,15996,205
2021-08-09,Calaveras,009,45235,2559,2472,15,2487,57
2021-08-09,Colusa,011,21464,2146,2075,398,2473,16
2021-08-09,Contra Costa,013,1133247,82377,79740,1575,81315,840
2021-08-09,Del Norte,015,27424,2019,1848,16,1864,8
2021-08-09,El Dorado,017,186661,12182,11672,998,12670,117
2021-08-09,Fresno,019,978130,109852,107310,9389,116699,1747
2021-08-09,Glenn,021,27897,2591,2532,621,3153,20
2021-08-09,Humboldt,023,135768,5965,5632,102,5734,52
2021-08-09,Imperial,025,180216,29702,29512,2749,32261,745
2021-08-09,Inyo,027,18085,1489,1481,13,1494,39
2021-08-09,Kern,029,883053,102732,101069,12724,113793,1359
2021-08-09,Kings,031,150075,24780,24155,1228,25383,250
2021-08-09,Lake,033,64148,4834,4670,28,4698,66
2021-08-09,Lassen,035,31185,5477,5393,126,5519,21
2021-08-09,Los Angeles,037,10098052,1302364,1282891,46927,1329818,24798
2021-08-09,Madera,039,155013,17882,17429,1104,18533,245
2021-08-09,Marin,041,260295,15566,15154,304,15458,239
2021-08-09,Mariposa,043,17540,572,545,12,557,5
2021-08-09,Mendocino,045,87422,5002,4732,136,4868,49
2021-08-09,Merced,047,269075,33058,32666,1154,33820,477
2021-08-09,Modoc,049,8938,430,419,148,567,5
2021-08-09,Mono,051,14174,1344,1337,17,1354,3
2021-08-09,Monterey,053,433212,44623,44190,2085,46275,527
2021-08-09,Napa,055,140530,10915,10679,63,10742,83
2021-08-09,Nevada,057,99092,6440,6088,217,6305,73
2021-08-09,Orange,059,3164182,275772,271036,12475,283511,5153
2021-08-09,Placer,061,380077,27728,26457,2143,28600,305
2021-08-09,Plumas,063,18699,842,803,14,817,5
2021-08-09,Riverside,065,2383286,315514,308678,14722,323400,4562
2021-08-09,Sacramento,067,1510023,124573,120812,2351,123163,1748
2021-08-09,San Benito,069,59416,6429,6359,117,6476,63
2021-08-09,San Bernardino,071,2135413,312911,308038,9547,317585,5295
2021-08-09,San Diego,073,3302833,312381,306855,17987,324842,3811
2021-08-09,San Francisco,075,870044,44582,43261,1737,44998,564
2021-08-09,San Joaquin,077,732212,80910,79198,4049,83247,1469
2021-08-09,San Luis Obispo,079,281455,23387,22695,859,23554,264
2021-08-09,San Mateo,081,765935,47108,46040,653,46693,548
2021-08-09,Santa Barbara,083,443738,37194,36474,1253,37727,470
2021-08-09,Santa Clara,085,1922200,128339,125791,894,126685,2187
2021-08-09,Santa Cruz,087,273765,17486,17082,854,17936,209
2021-08-09,Shasta,089,179085,13837,13397,1848,15245,210
2021-08-09,Sierra,091,2930,83,75,12,87,0
2021-08-09,Siskiyou,093,43540,2207,2047,486,2533,32
2021-08-09,Solano,095,438530,38115,36653,830,37483,262
2021-08-09,Sonoma,097,501317,35108,33933,404,34337,333
2021-08-09,Stanislaus,099,539301,61623,60410,6579,66989,1037
2021-08-09,Sutter,101,95872,10702,10525,109,10634,129
2021-08-09,Tehama,103,63373,5527,5373,645,6018,66
2021-08-09,Trinity,105,12862,544,378,123,501,3
2021-08-09,Tulare,107,460477,52583,51274,10035,61309,854
2021-08-09,Tuolumne,109,53932,4887,4745,48,4793,64
2021-08-09,Ventura,111,848112,87055,85514,3622,89136,1047
2021-08-09,Yolo,113,214977,15979,15521,516,16037,218
2021-08-09,Yuba,115,75493,7163,6994,162,7156,50
2021-08-08,Alameda,001,1643700,101594,99135,2222,101357,1276
2021-08-08,Alpine,003,1148,90,91,0,91,0
2021-08-08,Amador,005,37829,4187,4057,35,4092,48
2021-08-08,Butte,007,227075,14142,13791,2163,15954,205
2021-08-08,Calaveras,009,45235,2526,2462,15,2477,57
2021-08-08,Colusa,011,21464,2129,2070,391,2461,16
2021-08-08,Contra Costa,013,1133247,81853,79454,1568,81022,840
2021-08-08,Del Norte,015,27424,1973,1810,16,1826,8
2021-08-08,El Dorado,017,186661,12061,11631,987,12618,117
2021-08-08,Fresno,019,978130,109409,107078,9352,116430,1747
2021-08-08,Glenn,021,27897,2583,2527,614,3141,20
2021-08-08,Humboldt,023,135768,5876,5571,102,5673,52
2021-08-08,Imperial,025,180216,29678,29485,2739,32224,745
2021-08-08,Inyo,027,18085,1489,1481,13,1494,39
2021-08-08,Kern,029,883053,102412,100909,12612,113521,1359
2021-08-08,Kings,031,150075,24666,24095,1219,25314,250
2021-08-08,Lake,033,64148,4784,4636,27,4663,66
2021-08-08,Lassen,035,31185,5462,5391,125,5516,21
2021-08-08,Los Angeles,037,10098052,1298111,1279982,46743,1326725,24793
2021-08-08,Madera,039,155013,17803,17398,1087,18485,245
2021-08-08,Marin,041,260295,15513,15124,302,15426,239
2021-08-08,Mariposa,043,17540,568,538,12,550,5
2021-08-08,Mendocino,045,87422,4940,4702,123,4825,49
2021-08-08,Merced,047,269075,32911,32634,1145,33779,477
2021-08-08,Modoc,049,8938,429,419,147,566,5
2021-08-08,Mono,051,14174,1340,1336,17,1353,3
2021-08-08,Monterey,053,433212,44553,44171,2074,46245,527
2021-08-08,Napa,055,140530,10879,10668,63,10731,83
2021-08-08,Nevada,057,99092,6356,6009,215,6224,73
2021-08-08,Orange,059,3164182,274859,270532,12433,282965,5153
2021-08-08,Placer,061,380077,27519,26332,2102,28434,305
2021-08-08,Plumas,063,18699,833,803,14,817,5
2021-08-08,Riverside,065,2383286,314393,308042,14699,322741,4562
2021-08-08,Sacramento,067,1510023,123745,120109,2339,122448,1744
2021-08-08,San Benito,069,59416,6412,6350,116,6466,63
2021-08-08,San Bernardino,071,2135413,311769,307378,9518,316896,5295
2021-08-08,San Diego,073,3302833,311040,305983,17889,323872,3811
2021-08-08,San Francisco,075,870044,44322,43098,1714,44812,564
2021-08-08,San Joaquin,077,732212,80461,79002,4033,83035,1469
2021-08-08,San Luis Obispo,079,281455,23212,22668,851,23519,263
2021-08-08,San Mateo,081,765935,46918,45927,650,46577,548
2021-08-08,Santa Barbara,083,443738,37017,36417,1246,37663,470
2021-08-08,Santa Clara,085,1922200,127888,125553,889,126442,2187
2021-08-08,Santa Cruz,087,273765,17415,17035,849,17884,209
2021-08-08,Shasta,089,179085,13752,13381,1837,15218,210
2021-08-08,Sierra,091,2930,83,74,12,86,0
2021-08-08,Siskiyou,093,43540,2191,2041,481,2522,32
2021-08-08,Solano,095,438530,37863,36551,826,37377,262
2021-08-08,Sonoma,097,501317,34864,33805,403,34208,333
2021-08-08,Stanislaus,099,539301,61297,60269,6534,66803,1037
2021-08-08,Sutter,101,95872,10642,10481,108,10589,129
2021-08-08,Tehama,103,63373,5491,5359,642,6001,66
2021-08-08,Trinity,105,12862,539,378,123,501,3
2021-08-08,Tulare,107,460477,52404,51220,9976,61196,854
2021-08-08,Tuolumne,109,53932,4848,4731,48,4779,64
2021-08-08,Ventura,111,848112,86764,85382,3612,88994,1047
2021-08-08,Yolo,113,214977,15887,15477,509,15986,218
2021-08-08,Yuba,115,75493,7124,6967,162,7129,50
2021-08-07,Alameda,001,1643700,101345,98812,2216,101028,1276
2021-08-07,Alpine,003,1148,90,91,0,91,0
2021-08-07,Amador,005,37829,4170,4041,34,4075,48
2021-08-07,Butte,007,227075,14090,13714,2151,15865,205
2021-08-07,Calaveras,009,45235,2516,2446,15,2461,57
2021-08-07,Colusa,011,21464,2124,2067,382,2449,16
2021-08-07,Contra Costa,013,1133247,81557,79168,1565,80733,840
2021-08-07,Del Norte,015,27424,1941,1791,16,1807,8
2021-08-07,El Dorado,017,186661,12013,11575,980,12555,117
2021-08-07,Fresno,019,978130,109206,106861,9326,116187,1747
2021-08-07,Glenn,021,27897,2575,2515,613,3128,20
2021-08-07,Humboldt,023,135768,5826,5510,99,5609,52
2021-08-07,Imperial,025,180216,29659,29470,2739,32209,745
2021-08-07,Inyo,027,18085,1487,1476,13,1489,39
2021-08-07,Kern,029,883053,102254,100693,12557,113250,1359
2021-08-07,Kings,031,150075,24605,24048,1213,25261,250
2021-08-07,Lake,033,64148,4763,4613,27,4640,66
2021-08-07,Lassen,035,31185,5458,5386,125,5511,21
2021-08-07,Los Angeles,037,10098052,1296073,1276853,46597,1323450,24786
2021-08-07,Madera,039,155013,17768,17366,1083,18449,245
2021-08-07,Marin,041,260295,15479,15085,301,15386,239
2021-08-07,Mariposa,043,17540,565,530,12,542,5
2021-08-07,Mendocino,045,87422,4904,4690,121,4811,49
2021-08-07,Merced,047,269075,32847,32569,1142,33711,477
2021-08-07,Modoc,049,8938,429,419,147,566,5
2021-08-07,Mono,051,14174,1337,1329,17,1346,3
2021-08-07,Monterey,053,433212,44501,44124,2069,46193,527
2021-08-07,Napa,055,140530,10858,10658,62,10720,83
2021-08-07,Nevada,057,99092,6306,5967,213,6180,73
2021-08-07,Orange,059,3164182,274267,269900,12403,282303,5153
2021-08-07,Placer,061,380077,27330,26244,2094,28338,305
2021-08-07,Plumas,063,18699,828,801,14,815,5
2021-08-07,Riverside,065,2383286,313721,307326,14692,322018,4562
2021-08-07,Sacramento,067,1510023,123244,119636,2335,121971,1744
2021-08-07,San Benito,069,59416,6402,6332,116,6448,63
2021-08-07,San Bernardino,071,2135413,311179,306663,9501,316164,5295
2021-08-07,San Diego,073,3302833,310285,304974,17854,322828,3811
2021-08-07,San Francisco,075,870044,44151,42926,1696,44622,564
2021-08-07,San Joaquin,077,732212,80297,78769,4018,82787,1469
2021-08-07,San Luis Obispo,079,281455,23143,22579,850,23429,263
2021-08-07,San Mateo,081,765935,46790,45804,648,46452,548
2021-08-07,Santa Barbara,083,443738,36921,36303,1240,37543,470
2021-08-07,Santa Clara,085,1922200,127617,125196,884,126080,2188
2021-08-07,Santa Cruz,087,273765,17372,16994,847,17841,209
2021-08-07,Shasta,089,179085,13696,13361,1830,15191,210
2021-08-07,Sierra,091,2930,83,74,12,86,0
2021-08-07,Siskiyou,093,43540,2179,2039,479,2518,32
2021-08-07,Solano,095,438530,37747,36458,818,37276,262
2021-08-07,Sonoma,097,501317,34742,33716,403,34119,333
2021-08-07,Stanislaus,099,539301,61125,60093,6504,66597,1037
2021-08-07,Sutter,101,95872,10605,10447,108,10555,129
2021-08-07,Tehama,103,63373,5480,5343,637,5980,66
2021-08-07,Trinity,105,12862,535,377,122,499,3
2021-08-07,Tulare,107,460477,52318,51133,9938,61071,854
2021-08-07,Tuolumne,109,53932,4818,4721,48,4769,64
2021-08-07,Ventura,111,848112,86584,85232,3598,88830,1047
2021-08-07,Yolo,113,214977,15843,15423,502,15925,218
2021-08-07,Yuba,115,75493,7099,6937,160,7097,50
2021-08-06,Alameda,001,1643700,101016,98487,2210,100697,1275
2021-08-06,Alpine,003,1148,90,91,0,91,0
2021-08-06,Amador,005,37829,4149,4002,34,4036,48
2021-08-06,Butte,007,227075,14040,13626,2136,15762,205
2021-08-06,Calaveras,009,45235,2505,2419,15,2434,57
2021-08-06,Colusa,011,21464,2117,2045,376,2421,16
2021-08-06,Contra Costa,013,1133247,81262,78796,1560,80356,840
2021-08-06,Del Norte,015,27424,1914,1755,15,1770,8
2021-08-06,El Dorado,017,186661,11963,11498,968,12466,117
2021-08-06,Fresno,019,978130,108942,106542,9299,115841,1747
2021-08-06,Glenn,021,27897,2560,2504,610,3114,20
2021-08-06,Humboldt,023,135768,5775,5421,96,5517,52
2021-08-06,Imperial,025,180216,29648,29404,2735,32139,745
2021-08-06,Inyo,027,18085,1484,1471,13,1484,39
2021-08-06,Kern,029,883053,102077,100427,12472,112899,1359
2021-08-06,Kings,031,150075,24550,23974,1209,25183,250
2021-08-06,Lake,033,64148,4740,4557,27,4584,66
2021-08-06,Lassen,035,31185,5436,5368,125,5493,21
2021-08-06,Los Angeles,037,10098052,1293581,1273081,46445,1319526,24772
2021-08-06,Madera,039,155013,17729,17324,1074,18398,245
2021-08-06,Marin,041,260295,15446,15051,301,15352,239
2021-08-06,Mariposa,043,17540,556,511,12,523,5
2021-08-06,Mendocino,045,87422,4862,4649,120,4769,49
2021-08-06,Merced,047,269075,32787,32456,1139,33595,477
2021-08-06,Modoc,049,8938,429,419,147,566,5
2021-08-06,Mono,051,14174,1336,1328,17,1345,3
2021-08-06,Monterey,053,433212,44433,44058,2056,46114,527
2021-08-06,Napa,055,140530,10831,10620,62,10682,83
2021-08-06,Nevada,057,99092,6250,5874,213,6087,73
2021-08-06,Orange,059,3164182,273702,269077,12386,281463,5151
2021-08-06,Placer,061,380077,27207,26086,2073,28159,305
2021-08-06,Plumas,063,18699,819,795,14,809,5
2021-08-06,Riverside,065,2383286,313011,306304,14681,320985,4562
2021-08-06,Sacramento,067,1510023,122752,119169,2316,121485,1740
2021-08-06,San Benito,069,59416,6385,6315,116,6431,63
2021-08-06,San Bernardino,071,2135413,310478,305806,9492,315298,5286
2021-08-06,San Diego,073,3302833,309246,303691,17805,321496,3810
2021-08-06,San Francisco,075,870044,43994,42659,1678,44337,565
2021-08-06,San Joaquin,077,732212,80147,78405,4006,82411,1469
2021-08-06,San Luis Obispo,079,281455,23075,22472,845,23317,263
2021-08-06,San Mateo,081,765935,46638,45665,643,46308,548
2021-08-06,Santa Barbara,083,443738,36832,36208,1236,37444,470
2021-08-06,Santa Clara,085,1922200,127327,124767,879,125646,2185
2021-08-06,Santa Cruz,087,273765,17328,16924,843,17767,207
2021-08-06,Shasta,089,179085,13630,13284,1824,15108,210
2021-08-06,Sierra,091,2930,83,73,12,85,0
2021-08-06,Siskiyou,093,43540,2169,2030,475,2505,32
2021-08-06,Solano,095,438530,37637,36351,809,37160,262
2021-08-06,Sonoma,097,501317,34656,33594,402,33996,333
2021-08-06,Stanislaus,099,539301,60987,59854,6484,66338,1037
2021-08-06,Sutter,101,95872,10562,10391,108,10499,128
2021-08-06,Tehama,103,63373,5456,5325,635,5960,66
2021-08-06,Trinity,105,12862,534,371,121,492,3
2021-08-06,Tulare,107,460477,52217,51018,9891,60909,854
2021-08-06,Tuolumne,109,53932,4791,4674,48,4722,64
2021-08-06,Ventura,111,848112,86413,85046,3586,88632,1047
2021-08-06,Yolo,113,214977,15790,15299,497,15796,218
2021-08-06,Yuba,115,75493,7076,6904,160,7064,50
2021-08-05,Alameda,001,1643700,100531,98052,2205,100257,1275
2021-08-05,Alpine,003,1148,90,91,0,91,0
2021-08-05,Amador,005,37829,4129,3992,34,4026,48
2021-08-05,Butte,007,227075,13979,13564,2113,15677,206
2021-08-05,Calaveras,009,45235,2486,2397,15,2412,57
2021-08-05,Colusa,011,21464,2105,2036,372,2408,16
2021-08-05,Contra Costa,013,1133247,80835,78514,1553,80067,840
2021-08-05,Del Norte,015,27424,1887,1731,15,1746,8
2021-08-05,El Dorado,017,186661,11878,11408,957,12365,117
2021-08-05,Fresno,019,978130,108570,106219,9263,115482,1747
2021-08-05,Glenn,021,27897,2554,2494,607,3101,20
2021-08-05,Humboldt,023,135768,5701,5328,95,5423,52
2021-08-05,Imperial,025,180216,29617,29383,2731,32114,745
2021-08-05,Inyo,027,18085,1480,1468,13,1481,38
2021-08-05,Kern,029,883053,101855,100091,12387,112478,1358
2021-08-05,Kings,031,150075,24466,23906,1204,25110,249
2021-08-05,Lake,033,64148,4701,4490,25,4515,66
2021-08-05,Lassen,035,31185,5428,5344,125,5469,21
2021-08-05,Los Angeles,037,10098052,1290361,1269445,46314,1315759,24756
2021-08-05,Madera,039,155013,17688,17301,1066,18367,245
2021-08-05,Marin,041,260295,15402,15005,297,15302,239
2021-08-05,Mariposa,043,17540,545,504,11,515,5
2021-08-05,Mendocino,045,87422,4819,4597,111,4708,49
2021-08-05,Merced,047,269075,32720,32381,1128,33509,477
2021-08-05,Modoc,049,8938,428,418,147,565,5
2021-08-05,Mono,051,14174,1328,1309,17,1326,3
2021-08-05,Monterey,053,433212,44376,43992,2038,46030,527
2021-08-05,Napa,055,140530,10795,10591,60,10651,83
2021-08-05,Nevada,057,99092,6168,5778,210,5988,73
2021-08-05,Orange,059,3164182,272921,268329,12360,280689,5149
2021-08-05,Placer,061,380077,27007,25965,2046,28011,305
2021-08-05,Plumas,063,18699,810,787,14,801,5
2021-08-05,Riverside,065,2383286,312094,305415,14655,320070,4562
2021-08-05,Sacramento,067,1510023,122043,118590,2303,120893,1739
2021-08-05,San Benito,069,59416,6367,6305,116,6421,63
2021-08-05,San Bernardino,071,2135413,309641,304956,9471,314427,5284
2021-08-05,San Diego,073,3302833,307974,302220,17723,319943,3806
2021-08-05,San Francisco,075,870044,43783,42301,1669,43970,564
2021-08-05,San Joaquin,077,732212,79785,78151,3988,82139,1468
2021-08-05,San Luis Obispo,079,281455,22960,22362,839,23201,263
2021-08-05,San Mateo,081,765935,46465,45554,641,46195,548
2021-08-05,Santa Barbara,083,443738,36725,36112,1233,37345,470
2021-08-05,Santa Clara,085,1922200,126994,124490,879,125369,2185
2021-08-05,Santa Cruz,087,273765,17284,16867,840,17707,207
2021-08-05,Shasta,089,179085,13572,13217,1816,15033,210
2021-08-05,Sierra,091,2930,78,73,12,85,0
2021-08-05,Siskiyou,093,43540,2148,2024,466,2490,32
2021-08-05,Solano,095,438530,37456,36250,802,37052,262
2021-08-05,Sonoma,097,501317,34521,33455,401,33856,330
2021-08-05,Stanislaus,099,539301,60765,59692,6445,66137,1037
2021-08-05,Sutter,101,95872,10507,10349,108,10457,127
2021-08-05,Tehama,103,63373,5438,5305,632,5937,66
2021-08-05,Trinity,105,12862,528,367,121,488,3
2021-08-05,Tulare,107,460477,52100,50889,9837,60726,854
2021-08-05,Tuolumne,109,53932,4761,4619,48,4667,64
2021-08-05,Ventura,111,848112,86162,84837,3572,88409,1047
2021-08-05,Yolo,113,214977,15723,15250,487,15737,218
2021-08-05,Yuba,115,75493,7033,6872,158,7030,50
2021-08-04,Alameda,001,1643700,100030,97477,2194,99671,1274
2021-08-04,Alpine,003,1148,90,91,0,91,0
2021-08-04,Amador,005,37829,4099,3962,33,3995,48
2021-08-04,Butte,007,227075,13911,13509,2096,15605,205
2021-08-04,Calaveras,009,45235,2461,2374,15,2389,57
2021-08-04,Colusa,011,21464,2093,2025,366,2391,16
2021-08-04,Contra Costa,013,1133247,80318,77966,1548,79514,840
2021-08-04,Del Norte,015,27424,1864,1701,15,1716,8
2021-08-04,El Dorado,017,186661,11798,11319,946,12265,117
2021-08-04,Fresno,019,978130,108202,105899,9224,115123,1747
2021-08-04,Glenn,021,27897,2546,2487,605,3092,20
2021-08-04,Humboldt,023,135768,5625,5271,94,5365,52
2021-08-04,Imperial,025,180216,29569,29375,2729,32104,745
2021-08-04,Inyo,027,18085,1479,1465,13,1478,38
2021-08-04,Kern,029,883053,101605,99868,12304,112172,1358
2021-08-04,Kings,031,150075,24394,23840,1196,25036,250
2021-08-04,Lake,033,64148,4671,4423,20,4443,65
2021-08-04,Lassen,035,31185,5420,5340,125,5465,21
2021-08-04,Los Angeles,037,10098052,1286866,1265788,46155,1311943,24737
2021-08-04,Madera,039,155013,17653,17251,1059,18310,245
2021-08-04,Marin,041,260295,15355,14950,295,15245,239
2021-08-04,Mariposa,043,17540,530,497,11,508,5
2021-08-04,Mendocino,045,87422,4795,4560,107,4667,49
2021-08-04,Merced,047,269075,32582,32274,1123,33397,476
2021-08-04,Modoc,049,8938,428,416,147,563,5
2021-08-04,Mono,051,14174,1324,1307,17,1324,3
2021-08-04,Monterey,053,433212,44311,43926,2027,45953,526
2021-08-04,Napa,055,140530,10758,10544,60,10604,82
2021-08-04,Nevada,057,99092,6104,5702,209,5911,73
2021-08-04,Orange,059,3164182,272047,267199,12323,279522,5146
2021-08-04,Placer,061,380077,26790,25688,2026,27714,305
2021-08-04,Plumas,063,18699,804,784,14,798,5
2021-08-04,Riverside,065,2383286,311169,304272,14630,318902,4562
2021-08-04,Sacramento,067,1510023,121285,117882,2277,120159,1736
2021-08-04,San Benito,069,59416,6352,6300,116,6416,63
2021-08-04,San Bernardino,071,2135413,308785,304164,9452,313616,5285
2021-08-04,San Diego,073,3302833,306461,301100,17656,318756,3805
2021-08-04,San Francisco,075,870044,43528,41913,1657,43570,562
2021-08-04,San Joaquin,077,732212,79428,77846,3976,81822,1466
2021-08-04,San Luis Obispo,079,281455,22850,22245,833,23078,262
2021-08-04,San Mateo,081,765935,46293,45392,640,46032,548
2021-08-04,Santa Barbara,083,443738,36596,36013,1225,37238,470
2021-08-04,Santa Clara,085,1922200,126603,124127,872,124999,2183
2021-08-04,Santa Cruz,087,273765,17222,16820,833,17653,208
2021-08-04,Shasta,089,179085,13521,13134,1805,14939,211
2021-08-04,Sierra,091,2930,78,73,12,85,0
2021-08-04,Siskiyou,093,43540,2128,2010,462,2472,32
2021-08-04,Solano,095,438530,37255,36025,793,36818,262
2021-08-04,Sonoma,097,501317,34349,33311,399,33710,330
2021-08-04,Stanislaus,099,539301,60539,59396,6407,65803,1037
2021-08-04,Sutter,101,95872,10470,10294,108,10402,127
2021-08-04,Tehama,103,63373,5412,5281,626,5907,66
2021-08-04,Trinity,105,12862,526,362,118,480,3
2021-08-04,Tulare,107,460477,51989,50797,9793,60590,855
2021-08-04,Tuolumne,109,53932,4736,4584,48,4632,64
2021-08-04,Ventura,111,848112,85904,84406,3550,87956,1047
2021-08-04,Yolo,113,214977,15643,15189,474,15663,215
2021-08-04,Yuba,115,75493,6993,6827,157,6984,50
2021-08-03,Alameda,001,1643700,99582,97275,2189,99464,1270
2021-08-03,Alpine,003,1148,90,91,0,91,0
2021-08-03,Amador,005,37829,4063,3953,33,3986,48
2021-08-03,Butte,007,227075,13843,13468,2081,15549,205
2021-08-03,Calaveras,009,45235,2439,2356,15,2371,57
2021-08-03,Colusa,011,21464,2080,2023,360,2383,16
2021-08-03,Contra Costa,013,1133247,79836,77739,1541,79280,836
2021-08-03,Del Norte,015,27424,1832,1691,14,1705,8
2021-08-03,El Dorado,017,186661,11705,11255,936,12191,117
2021-08-03,Fresno,019,978130,107840,105732,9193,114925,1746
2021-08-03,Glenn,021,27897,2539,2481,599,3080,20
2021-08-03,Humboldt,023,135768,5560,5199,89,5288,52
2021-08-03,Imperial,025,180216,29547,29333,2722,32055,745
2021-08-03,Inyo,027,18085,1476,1459,13,1472,38
2021-08-03,Kern,029,883053,101343,99708,12225,111933,1358
2021-08-03,Kings,031,150075,24306,23780,1189,24969,249
2021-08-03,Lake,033,64148,4615,4408,16,4424,66
2021-08-03,Lassen,035,31185,5410,5341,125,5466,21
2021-08-03,Los Angeles,037,10098052,1283122,1262678,45977,1308655,24721
2021-08-03,Madera,039,155013,17612,17220,1044,18264,245
2021-08-03,Marin,041,260295,15306,14906,292,15198,243
2021-08-03,Mariposa,043,17540,519,495,11,506,5
2021-08-03,Mendocino,045,87422,4746,4546,106,4652,49
2021-08-03,Merced,047,269075,32499,32197,1121,33318,476
2021-08-03,Modoc,049,8938,428,416,147,563,5
2021-08-03,Mono,051,14174,1319,1303,17,1320,3
2021-08-03,Monterey,053,433212,44248,43872,2014,45886,525
2021-08-03,Napa,055,140530,10715,10527,59,10586,82
2021-08-03,Nevada,057,99092,6023,5685,208,5893,73
2021-08-03,Orange,059,3164182,271308,266649,12293,278942,5146
2021-08-03,Placer,061,380077,26589,25624,2002,27626,305
2021-08-03,Plumas,063,18699,797,779,14,793,5
2021-08-03,Riverside,065,2383286,310245,303499,14603,318102,4562
2021-08-03,Sacramento,067,1510023,120540,117591,2257,119848,1732
2021-08-03,San Benito,069,59416,6337,6284,115,6399,63
2021-08-03,San Bernardino,071,2135413,307865,303386,9434,312820,5265
2021-08-03,San Diego,073,3302833,305022,300189,17546,317735,3803
2021-08-03,San Francisco,075,870044,43246,41758,1637,43395,562
2021-08-03,San Joaquin,077,732212,79077,77615,3955,81570,1461
2021-08-03,San Luis Obispo,079,281455,22710,22166,826,22992,264
2021-08-03,San Mateo,081,765935,46101,45255,635,45890,548
2021-08-03,Santa Barbara,083,443738,36477,35912,1219,37131,469
2021-08-03,Santa Clara,085,1922200,126182,123914,866,124780,2183
2021-08-03,Santa Cruz,087,273765,17156,16778,830,17608,207
2021-08-03,Shasta,089,179085,13446,13091,1794,14885,211
2021-08-03,Sierra,091,2930,78,72,12,84,0
2021-08-03,Siskiyou,093,43540,2117,1998,457,2455,32
2021-08-03,Solano,095,438530,37035,35953,781,36734,261
2021-08-03,Sonoma,097,501317,34168,33243,398,33641,330
2021-08-03,Stanislaus,099,539301,60317,59282,6388,65670,1037
2021-08-03,Sutter,101,95872,10430,10263,107,10370,127
2021-08-03,Tehama,103,63373,5385,5269,621,5890,66
2021-08-03,Trinity,105,12862,523,361,115,476,3
2021-08-03,Tulare,107,460477,51894,50729,9747,60476,854
2021-08-03,Tuolumne,109,53932,4701,4563,48,4611,64
2021-08-03,Ventura,111,848112,85660,84270,3529,87799,1046
2021-08-03,Yolo,113,214977,15551,15149,459,15608,215
2021-08-03,Yuba,115,75493,6956,6781,155,6936,50
2021-08-02,Alameda,001,1643700,99024,96954,2185,99139,1270
2021-08-02,Alpine,003,1148,90,91,0,91,0
2021-08-02,Amador,005,37829,4043,3927,33,3960,48
2021-08-02,Butte,007,227075,13763,13442,2062,15504,205
2021-08-02,Calaveras,009,45235,2414,2347,15,2362,57
2021-08-02,Colusa,011,21464,2068,2019,357,2376,16
2021-08-02,Contra Costa,013,1133247,79327,77516,1527,79043,836
2021-08-02,Del Norte,015,27424,1802,1653,14,1667,8
2021-08-02,El Dorado,017,186661,11602,11226,922,12148,116
2021-08-02,Fresno,019,978130,107494,105471,9156,114627,1744
2021-08-02,Glenn,021,27897,2531,2477,596,3073,20
2021-08-02,Humboldt,023,135768,5477,5161,87,5248,52
2021-08-02,Imperial,025,180216,29514,29302,2719,32021,743
2021-08-02,Inyo,027,18085,1470,1455,13,1468,38
2021-08-02,Kern,029,883053,101088,99556,12134,111690,1357
2021-08-02,Kings,031,150075,24236,23722,1183,24905,249
2021-08-02,Lake,033,64148,4572,4375,16,4391,66
2021-08-02,Lassen,035,31185,5387,5338,123,5461,21
2021-08-02,Los Angeles,037,10098052,1279400,1260807,45771,1306578,24705
2021-08-02,Madera,039,155013,17568,17158,1031,18189,245
2021-08-02,Marin,041,260295,15263,14859,291,15150,239
2021-08-02,Mariposa,043,17540,510,490,11,501,5
2021-08-02,Mendocino,045,87422,4706,4512,103,4615,49
2021-08-02,Merced,047,269075,32401,32163,1114,33277,474
2021-08-02,Modoc,049,8938,428,415,147,562,5
2021-08-02,Mono,051,14174,1312,1296,17,1313,3
2021-08-02,Monterey,053,433212,44188,43842,2006,45848,525
2021-08-02,Napa,055,140530,10672,10490,56,10546,82
2021-08-02,Nevada,057,99092,5952,5611,207,5818,73
2021-08-02,Orange,059,3164182,270394,266050,12248,278298,5146
2021-08-02,Placer,061,380077,26442,25516,1968,27484,306
2021-08-02,Plumas,063,18699,790,762,14,776,5
2021-08-02,Riverside,065,2383286,309307,302756,14588,317344,4562
2021-08-02,Sacramento,067,1510023,119843,117183,2237,119420,1728
2021-08-02,San Benito,069,59416,6318,6276,114,6390,63
2021-08-02,San Bernardino,071,2135413,306990,303000,9401,312401,5253
2021-08-02,San Diego,073,3302833,303542,299021,17466,316487,3798
2021-08-02,San Francisco,075,870044,42960,41553,1614,43167,562
2021-08-02,San Joaquin,077,732212,78734,77447,3930,81377,1461
2021-08-02,San Luis Obispo,079,281455,22616,22093,819,22912,261
2021-08-02,San Mateo,081,765935,45924,45154,623,45777,548
2021-08-02,Santa Barbara,083,443738,36339,35851,1213,37064,469
2021-08-02,Santa Clara,085,1922200,125712,123655,858,124513,2183
2021-08-02,Santa Cruz,087,273765,17098,16746,826,17572,207
2021-08-02,Shasta,089,179085,13384,13049,1780,14829,212
2021-08-02,Sierra,091,2930,78,71,12,83,0
2021-08-02,Siskiyou,093,43540,2106,1992,443,2435,31
2021-08-02,Solano,095,438530,36787,35852,768,36620,260
2021-08-02,Sonoma,097,501317,33942,33132,393,33525,330
2021-08-02,Stanislaus,099,539301,60098,59160,6361,65521,1037
2021-08-02,Sutter,101,95872,10384,10220,107,10327,127
2021-08-02,Tehama,103,63373,5362,5260,617,5877,66
2021-08-02,Trinity,105,12862,518,359,114,473,3
2021-08-02,Tulare,107,460477,51793,50640,9675,60315,854
2021-08-02,Tuolumne,109,53932,4634,4524,48,4572,64
2021-08-02,Ventura,111,848112,85475,84143,3506,87649,1044
2021-08-02,Yolo,113,214977,15453,15072,442,15514,215
2021-08-02,Yuba,115,75493,6914,6743,152,6895,50
2021-08-01,Alameda,001,1643700,98491,96775,2179,98954,1270
2021-08-01,Alpine,003,1148,90,91,0,91,0
2021-08-01,Amador,005,37829,4005,3923,33,3956,48
2021-08-01,Butte,007,227075,13685,13406,2045,15451,205
2021-08-01,Calaveras,009,45235,2390,2341,15,2356,57
2021-08-01,Colusa,011,21464,2057,2014,355,2369,16
2021-08-01,Contra Costa,013,1133247,78892,77360,1520,78880,836
2021-08-01,Del Norte,015,27424,1770,1642,14,1656,8
2021-08-01,El Dorado,017,186661,11502,11189,911,12100,116
2021-08-01,Fresno,019,978130,107168,105339,9111,114450,1744
2021-08-01,Glenn,021,27897,2525,2476,593,3069,20
2021-08-01,Humboldt,023,135768,5400,5118,83,5201,52
2021-08-01,Imperial,025,180216,29479,29297,2715,32012,743
2021-08-01,Inyo,027,18085,1468,1454,13,1467,38
2021-08-01,Kern,029,883053,100810,99396,12059,111455,1357
2021-08-01,Kings,031,150075,24149,23700,1178,24878,249
2021-08-01,Lake,033,64148,4493,4356,16,4372,66
2021-08-01,Lassen,035,31185,5374,5336,121,5457,21
2021-08-01,Los Angeles,037,10098052,1275710,1258461,45546,1304007,24700
2021-08-01,Madera,039,155013,17512,17146,1026,18172,245
2021-08-01,Marin,041,260295,15186,14844,290,15134,239
2021-08-01,Mariposa,043,17540,503,482,11,493,5
2021-08-01,Mendocino,045,87422,4660,4476,99,4575,49
2021-08-01,Merced,047,269075,32310,32144,1108,33252,474
2021-08-01,Modoc,049,8938,426,413,147,560,5
2021-08-01,Mono,051,14174,1309,1294,17,1311,3
2021-08-01,Monterey,053,433212,44141,43808,1993,45801,525
2021-08-01,Napa,055,140530,10624,10473,54,10527,82
2021-08-01,Nevada,057,99092,5865,5561,206,5767,73
2021-08-01,Orange,059,3164182,269580,265467,12205,277672,5146
2021-08-01,Placer,061,380077,26227,25464,1938,27402,306
2021-08-01,Plumas,063,18699,784,761,14,775,5
2021-08-01,Riverside,065,2383286,308374,302256,14570,316826,4562
2021-08-01,Sacramento,067,1510023,119108,116923,2223,119146,1727
2021-08-01,San Benito,069,59416,6301,6271,114,6385,63
2021-08-01,San Bernardino,071,2135413,306056,302542,9390,311932,5248
2021-08-01,San Diego,073,3302833,302356,298002,17401,315403,3798
2021-08-01,San Francisco,075,870044,42622,41432,1601,43033,562
2021-08-01,San Joaquin,077,732212,78367,77338,3905,81243,1461
2021-08-01,San Luis Obispo,079,281455,22514,22083,814,22897,261
2021-08-01,San Mateo,081,765935,45742,45036,616,45652,548
2021-08-01,Santa Barbara,083,443738,36215,35809,1209,37018,469
2021-08-01,Santa Clara,085,1922200,125300,123511,850,124361,2183
2021-08-01,Santa Cruz,087,273765,17019,16709,819,17528,207
2021-08-01,Shasta,089,179085,13313,13036,1771,14807,212
2021-08-01,Sierra,091,2930,76,71,12,83,0
2021-08-01,Siskiyou,093,43540,2100,1989,437,2426,31
2021-08-01,Solano,095,438530,36552,35800,759,36559,260
2021-08-01,Sonoma,097,501317,33750,33076,390,33466,330
2021-08-01,Stanislaus,099,539301,59861,59078,6329,65407,1037
2021-08-01,Sutter,101,95872,10329,10198,104,10302,127
2021-08-01,Tehama,103,63373,5345,5252,613,5865,66
2021-08-01,Trinity,105,12862,515,359,113,472,3
2021-08-01,Tulare,107,460477,51636,50600,9614,60214,854
2021-08-01,Tuolumne,109,53932,4596,4489,48,4537,64
2021-08-01,Ventura,111,848112,85245,84040,3491,87531,1044
2021-08-01,Yolo,113,214977,15381,15042,432,15474,215
2021-08-01,Yuba,115,75493,6877,6721,151,6872,50
2021-07-31,Alameda,001,1643700,98159,95279,2174,97453,1265
2021-07-31,Alpine,003,1148,90,89,0,89,0
2021-07-31,Amador,005,37829,3985,3877,33,3910,48
2021-07-31,Butte,007,227075,13651,13235,2025,15260,205
2021-07-31,Calaveras,009,45235,2381,2294,15,2309,57
2021-07-31,Colusa,011,21464,2051,2006,353,2359,16
2021-07-31,Contra Costa,013,1133247,78613,75866,1518,77384,832
2021-07-31,Del Norte,015,27424,1744,1576,14,1590,8
2021-07-31,El Dorado,017,186661,11449,11017,905,11922,116
2021-07-31,Fresno,019,978130,107009,104639,9098,113737,1744
2021-07-31,Glenn,021,27897,2520,2465,588,3053,20
2021-07-31,Humboldt,023,135768,5345,4978,82,5060,52
2021-07-31,Imperial,025,180216,29462,29164,2712,31876,743
2021-07-31,Inyo,027,18085,1465,1442,13,1455,38
2021-07-31,Kern,029,883053,100645,98903,12000,110903,1357
2021-07-31,Kings,031,150075,24096,23548,1173,24721,248
2021-07-31,Lake,033,64148,4468,4238,16,4254,66
2021-07-31,Lassen,035,31185,5367,5320,121,5441,21
2021-07-31,Los Angeles,037,10098052,1273507,1248545,45404,1293949,24691
2021-07-31,Madera,039,155013,17479,17058,1020,18078,245
2021-07-31,Marin,041,260295,15142,14701,289,14990,239
2021-07-31,Mariposa,043,17540,494,470,11,481,5
2021-07-31,Mendocino,045,87422,4635,4400,96,4496,49
2021-07-31,Merced,047,269075,32262,31959,1103,33062,474
2021-07-31,Modoc,049,8938,426,413,147,560,5
2021-07-31,Mono,051,14174,1307,1287,17,1304,3
2021-07-31,Monterey,053,433212,44101,43720,1983,45703,525
2021-07-31,Napa,055,140530,10604,10401,53,10454,82
2021-07-31,Nevada,057,99092,5826,5373,205,5578,72
2021-07-31,Orange,059,3164182,269006,263446,12187,275633,5144
2021-07-31,Placer,061,380077,26094,25104,1931,27035,306
2021-07-31,Plumas,063,18699,781,743,14,757,5
2021-07-31,Riverside,065,2383286,307758,300315,14560,314875,4554
2021-07-31,Sacramento,067,1510023,118696,115259,2217,117476,1720
2021-07-31,San Benito,069,59416,6290,6251,114,6365,63
2021-07-31,San Bernardino,071,2135413,305482,300726,9387,310113,5240
2021-07-31,San Diego,073,3302833,301683,295054,17355,312409,3798
2021-07-31,San Francisco,075,870044,42394,40412,1581,41993,562
2021-07-31,San Joaquin,077,732212,78202,76575,3892,80467,1443
2021-07-31,San Luis Obispo,079,281455,22460,21922,812,22734,260
2021-07-31,San Mateo,081,765935,45585,44622,611,45233,548
2021-07-31,Santa Barbara,083,443738,36134,35531,1208,36739,467
2021-07-31,Santa Clara,085,1922200,125045,122614,848,123462,2099
2021-07-31,Santa Cruz,087,273765,16980,16576,818,17394,207
2021-07-31,Shasta,089,179085,13276,12918,1763,14681,212
2021-07-31,Sierra,091,2930,76,68,12,80,0
2021-07-31,Siskiyou,093,43540,2091,1976,431,2407,31
2021-07-31,Solano,095,438530,36451,35340,752,36092,263
2021-07-31,Sonoma,097,501317,33624,32601,390,32991,329
2021-07-31,Stanislaus,099,539301,59702,58586,6307,64893,1035
2021-07-31,Sutter,101,95872,10295,10068,103,10171,127
2021-07-31,Tehama,103,63373,5330,5216,610,5826,66
2021-07-31,Trinity,105,12862,514,354,112,466,3
2021-07-31,Tulare,107,460477,51546,50409,9561,59970,854
2021-07-31,Tuolumne,109,53932,4557,4362,48,4410,64
2021-07-31,Ventura,111,848112,85084,83509,3475,86984,1044
2021-07-31,Yolo,113,214977,15333,14863,421,15284,215
2021-07-31,Yuba,115,75493,6854,6615,147,6762,50
2021-07-30,Alameda,001,1643700,97828,95279,2170,97449,1265
2021-07-30,Alpine,003,1148,90,89,0,89,0
2021-07-30,Amador,005,37829,3962,3877,33,3910,48
2021-07-30,Butte,007,227075,13596,13235,2012,15247,205
2021-07-30,Calaveras,009,45235,2371,2294,15,2309,57
2021-07-30,Colusa,011,21464,2047,2006,351,2357,16
2021-07-30,Contra Costa,013,1133247,78367,75866,1514,77380,832
2021-07-30,Del Norte,015,27424,1726,1576,14,1590,8
2021-07-30,El Dorado,017,186661,11415,11017,899,11916,116
2021-07-30,Fresno,019,978130,106814,104639,9086,113725,1744
2021-07-30,Glenn,021,27897,2515,2465,587,3052,20
2021-07-30,Humboldt,023,135768,5282,4978,79,5057,52
2021-07-30,Imperial,025,180216,29448,29164,2709,31873,743
2021-07-30,Inyo,027,18085,1464,1442,13,1455,38
2021-07-30,Kern,029,883053,100521,98903,11953,110856,1357
2021-07-30,Kings,031,150075,24056,23548,1169,24717,248
2021-07-30,Lake,033,64148,4440,4238,16,4254,66
2021-07-30,Lassen,035,31185,5363,5320,121,5441,21
2021-07-30,Los Angeles,037,10098052,1271176,1248545,45255,1293800,24691
2021-07-30,Madera,039,155013,17437,17058,1017,18075,245
2021-07-30,Marin,041,260295,15108,14701,289,14990,239
2021-07-30,Mariposa,043,17540,490,470,11,481,5
2021-07-30,Mendocino,045,87422,4605,4400,95,4495,49
2021-07-30,Merced,047,269075,32221,31959,1099,33058,474
2021-07-30,Modoc,049,8938,424,413,147,560,5
2021-07-30,Mono,051,14174,1302,1287,17,1304,3
2021-07-30,Monterey,053,433212,44067,43720,1974,45694,525
2021-07-30,Napa,055,140530,10582,10401,52,10453,82
2021-07-30,Nevada,057,99092,5769,5373,205,5578,72
2021-07-30,Orange,059,3164182,268381,263446,12161,275607,5144
2021-07-30,Placer,061,380077,26005,25104,1913,27017,306
2021-07-30,Plumas,063,18699,776,743,14,757,5
2021-07-30,Riverside,065,2383286,307121,300315,14550,314865,4554
2021-07-30,Sacramento,067,1510023,118244,115259,2213,117472,1720
2021-07-30,San Benito,069,59416,6283,6251,114,6365,63
2021-07-30,San Bernardino,071,2135413,304969,300726,9380,310106,5240
2021-07-30,San Diego,073,3302833,300909,295054,17297,312351,3798
2021-07-30,San Francisco,075,870044,42181,40412,1567,41979,562
2021-07-30,San Joaquin,077,732212,78048,76575,3887,80462,1443
2021-07-30,San Luis Obispo,079,281455,22422,21922,808,22730,260
2021-07-30,San Mateo,081,765935,45460,44622,598,45220,548
2021-07-30,Santa Barbara,083,443738,36065,35531,1202,36733,467
2021-07-30,Santa Clara,085,1922200,124822,122614,846,123460,2099
2021-07-30,Santa Cruz,087,273765,16954,16576,816,17392,207
2021-07-30,Shasta,089,179085,13231,12918,1763,14681,212
2021-07-30,Sierra,091,2930,75,68,12,80,0
2021-07-30,Siskiyou,093,43540,2082,1976,430,2406,31
2021-07-30,Solano,095,438530,36360,35340,736,36076,263
2021-07-30,Sonoma,097,501317,33529,32601,390,32991,329
2021-07-30,Stanislaus,099,539301,59558,58586,6287,64873,1035
2021-07-30,Sutter,101,95872,10260,10068,103,10171,127
2021-07-30,Tehama,103,63373,5320,5216,610,5826,66
2021-07-30,Trinity,105,12862,514,354,112,466,3
2021-07-30,Tulare,107,460477,51503,50409,9526,59935,854
2021-07-30,Tuolumne,109,53932,4539,4362,48,4410,64
2021-07-30,Ventura,111,848112,84920,83509,3460,86969,1044
2021-07-30,Yolo,113,214977,15272,14863,417,15280,215
2021-07-30,Yuba,115,75493,6818,6615,146,6761,50
2021-07-29,Alameda,001,1643700,97414,95279,2164,97443,1265
2021-07-29,Alpine,003,1148,90,89,0,89,0
2021-07-29,Amador,005,37829,3943,3877,33,3910,48
2021-07-29,Butte,007,227075,13547,13235,2004,15239,205
2021-07-29,Calaveras,009,45235,2356,2294,15,2309,57
2021-07-29,Colusa,011,21464,2040,2006,351,2357,16
2021-07-29,Contra Costa,013,1133247,77927,75866,1512,77378,832
2021-07-29,Del Norte,015,27424,1702,1576,14,1590,8
2021-07-29,El Dorado,017,186661,11351,11017,887,11904,116
2021-07-29,Fresno,019,978130,106550,104639,9060,113699,1744
2021-07-29,Glenn,021,27897,2505,2465,586,3051,20
2021-07-29,Humboldt,023,135768,5222,4978,77,5055,52
2021-07-29,Imperial,025,180216,29403,29164,2707,31871,743
2021-07-29,Inyo,027,18085,1460,1442,13,1455,38
2021-07-29,Kern,029,883053,100314,98903,11876,110779,1357
2021-07-29,Kings,031,150075,24010,23548,1165,24713,248
2021-07-29,Lake,033,64148,4405,4238,16,4254,66
2021-07-29,Lassen,035,31185,5355,5320,118,5438,21
2021-07-29,Los Angeles,037,10098052,1268079,1248545,45073,1293618,24691
2021-07-29,Madera,039,155013,17390,17058,1013,18071,245
2021-07-29,Marin,041,260295,15065,14701,289,14990,239
2021-07-29,Mariposa,043,17540,486,470,11,481,5
2021-07-29,Mendocino,045,87422,4582,4400,93,4493,49
2021-07-29,Merced,047,269075,32166,31959,1099,33058,474
2021-07-29,Modoc,049,8938,424,413,147,560,5
2021-07-29,Mono,051,14174,1300,1287,17,1304,3
2021-07-29,Monterey,053,433212,44018,43720,1964,45684,525
2021-07-29,Napa,055,140530,10550,10401,50,10451,82
2021-07-29,Nevada,057,99092,5717,5373,204,5577,72
2021-07-29,Orange,059,3164182,267669,263446,12129,275575,5144
2021-07-29,Placer,061,380077,25882,25104,1898,27002,306
2021-07-29,Plumas,063,18699,768,743,14,757,5
2021-07-29,Riverside,065,2383286,306416,300315,14526,314841,4554
2021-07-29,Sacramento,067,1510023,117689,115259,2200,117459,1720
2021-07-29,San Benito,069,59416,6272,6251,114,6365,63
2021-07-29,San Bernardino,071,2135413,304332,300726,9371,310097,5240
2021-07-29,San Diego,073,3302833,299852,295054,17229,312283,3798
2021-07-29,San Francisco,075,870044,41933,40412,1546,41958,562
2021-07-29,San Joaquin,077,732212,77793,76575,3879,80454,1443
2021-07-29,San Luis Obispo,079,281455,22367,21922,806,22728,260
2021-07-29,San Mateo,081,765935,45333,44622,588,45210,548
2021-07-29,Santa Barbara,083,443738,35979,35531,1201,36732,467
2021-07-29,Santa Clara,085,1922200,124525,122614,843,123457,2099
2021-07-29,Santa Cruz,087,273765,16901,16576,814,17390,207
2021-07-29,Shasta,089,179085,13177,12918,1754,14672,212
2021-07-29,Sierra,091,2930,75,68,12,80,0
2021-07-29,Siskiyou,093,43540,2077,1976,428,2404,31
2021-07-29,Solano,095,438530,36200,35340,726,36066,263
2021-07-29,Sonoma,097,501317,33355,32601,388,32989,329
2021-07-29,Stanislaus,099,539301,59386,58586,6272,64858,1035
2021-07-29,Sutter,101,95872,10214,10068,102,10170,127
2021-07-29,Tehama,103,63373,5307,5216,604,5820,66
2021-07-29,Trinity,105,12862,512,354,111,465,3
2021-07-29,Tulare,107,460477,51413,50409,9486,59895,854
2021-07-29,Tuolumne,109,53932,4499,4362,47,4409,64
2021-07-29,Ventura,111,848112,84754,83509,3453,86962,1044
2021-07-29,Yolo,113,214977,15204,14863,403,15266,215
2021-07-29,Yuba,115,75493,6769,6615,143,6758,50
2021-07-28,Alameda,001,1643700,96953,94965,2157,97122,1262
2021-07-28,Alpine,003,1148,90,89,0,89,0
2021-07-28,Amador,005,37829,3929,3870,33,3903,48
2021-07-28,Butte,007,227075,13490,13184,1991,15175,205
2021-07-28,Calaveras,009,45235,2335,2289,15,2304,57
2021-07-28,Colusa,011,21464,2037,2001,350,2351,16
2021-07-28,Contra Costa,013,1133247,77438,75487,1504,76991,832
2021-07-28,Del Norte,015,27424,1669,1545,14,1559,8
2021-07-28,El Dorado,017,186661,11301,10967,878,11845,116
2021-07-28,Fresno,019,978130,106301,104458,9040,113498,1744
2021-07-28,Glenn,021,27897,2502,2464,583,3047,20
2021-07-28,Humboldt,023,135768,5171,4946,76,5022,52
2021-07-28,Imperial,025,180216,29356,29096,2707,31803,743
2021-07-28,Inyo,027,18085,1454,1439,12,1451,38
2021-07-28,Kern,029,883053,100158,98781,11830,110611,1352
2021-07-28,Kings,031,150075,23946,23503,1155,24658,248
2021-07-28,Lake,033,64148,4359,4191,15,4206,65
2021-07-28,Lassen,035,31185,5347,5318,118,5436,21
2021-07-28,Los Angeles,037,10098052,1264903,1245485,44888,1290373,24673
2021-07-28,Madera,039,155013,17349,17024,1007,18031,245
2021-07-28,Marin,041,260295,15010,14652,289,14941,239
2021-07-28,Mariposa,043,17540,479,469,11,480,5
2021-07-28,Mendocino,045,87422,4554,4377,93,4470,49
2021-07-28,Merced,047,269075,32110,31886,1095,32981,474
2021-07-28,Modoc,049,8938,422,413,147,560,5
2021-07-28,Mono,051,14174,1299,1286,17,1303,3
2021-07-28,Monterey,053,433212,43971,43668,1955,45623,524
2021-07-28,Napa,055,140530,10510,10376,48,10424,82
2021-07-28,Nevada,057,99092,5663,5320,204,5524,72
2021-07-28,Orange,059,3164182,266877,262735,12100,274835,5143
2021-07-28,Placer,061,380077,25735,24978,1883,26861,306
2021-07-28,Plumas,063,18699,763,754,14,768,5
2021-07-28,Riverside,065,2383286,305649,299611,14507,314118,4554
2021-07-28,Sacramento,067,1510023,117037,114665,2181,116846,1714
2021-07-28,San Benito,069,59416,6261,6236,114,6350,63
2021-07-28,San Bernardino,071,2135413,303711,300121,9359,309480,5236
2021-07-28,San Diego,073,3302833,298578,294176,17156,311332,3798
2021-07-28,San Francisco,075,870044,41629,40144,1520,41664,561
2021-07-28,San Joaquin,077,732212,77541,76312,3849,80161,1443
2021-07-28,San Luis Obispo,079,281455,22308,21865,805,22670,260
2021-07-28,San Mateo,081,765935,45183,44477,579,45056,547
2021-07-28,Santa Barbara,083,443738,35904,35431,1196,36627,467
2021-07-28,Santa Clara,085,1922200,124263,122345,841,123186,2099
2021-07-28,Santa Cruz,087,273765,16863,16551,813,17364,207
2021-07-28,Shasta,089,179085,13132,12882,1744,14626,212
2021-07-28,Sierra,091,2930,71,67,12,79,0
2021-07-28,Siskiyou,093,43540,2068,1971,425,2396,31
2021-07-28,Solano,095,438530,36026,35204,719,35923,262
2021-07-28,Sonoma,097,501317,33212,32434,385,32819,328
2021-07-28,Stanislaus,099,539301,59189,58427,6256,64683,1035
2021-07-28,Sutter,101,95872,10182,10033,101,10134,126
2021-07-28,Tehama,103,63373,5295,5209,601,5810,66
2021-07-28,Trinity,105,12862,511,352,111,463,3
2021-07-28,Tulare,107,460477,51325,50363,9439,59802,854
2021-07-28,Tuolumne,109,53932,4460,4313,47,4360,64
2021-07-28,Ventura,111,848112,84558,83360,3437,86797,1043
2021-07-28,Yolo,113,214977,15132,14801,394,15195,215
2021-07-28,Yuba,115,75493,6736,6591,142,6733,51
2021-07-27,Alameda,001,1643700,96550,94682,2149,96831,1256
2021-07-27,Alpine,003,1148,90,89,0,89,0
2021-07-27,Amador,005,37829,3913,3861,33,3894,48
2021-07-27,Butte,007,227075,13442,13127,1980,15107,205
2021-07-27,Calaveras,009,45235,2324,2280,15,2295,57
2021-07-27,Colusa,011,21464,2028,1999,349,2348,16
2021-07-27,Contra Costa,013,1133247,76953,75227,1500,76727,830
2021-07-27,Del Norte,015,27424,1649,1538,14,1552,8
2021-07-27,El Dorado,017,186661,11241,10941,868,11809,116
2021-07-27,Fresno,019,978130,106008,104288,9017,113305,1746
2021-07-27,Glenn,021,27897,2494,2460,581,3041,20
2021-07-27,Humboldt,023,135768,5117,4925,75,5000,52
2021-07-27,Imperial,025,180216,29311,29048,2706,31754,743
2021-07-27,Inyo,027,18085,1452,1430,12,1442,38
2021-07-27,Kern,029,883053,99988,98724,11775,110499,1352
2021-07-27,Kings,031,150075,23889,23463,1145,24608,248
2021-07-27,Lake,033,64148,4320,4157,15,4172,65
2021-07-27,Lassen,035,31185,5341,5315,118,5433,21
2021-07-27,Los Angeles,037,10098052,1261438,1243336,44681,1288017,24658
2021-07-27,Madera,039,155013,17296,16998,1001,17999,245
2021-07-27,Marin,041,260295,14962,14631,286,14917,239
2021-07-27,Mariposa,043,17540,476,468,11,479,5
2021-07-27,Mendocino,045,87422,4531,4371,93,4464,49
2021-07-27,Merced,047,269075,32043,31825,1092,32917,473
2021-07-27,Modoc,049,8938,421,413,147,560,5
2021-07-27,Mono,051,14174,1295,1288,17,1305,3
2021-07-27,Monterey,053,433212,43931,43646,1944,45590,523
2021-07-27,Napa,055,140530,10480,10354,48,10402,82
2021-07-27,Nevada,057,99092,5586,5305,202,5507,72
2021-07-27,Orange,059,3164182,266134,262193,12074,274267,5143
2021-07-27,Placer,061,380077,25576,24916,1857,26773,306
2021-07-27,Plumas,063,18699,760,752,14,766,5
2021-07-27,Riverside,065,2383286,304920,299160,14488,313648,4554
2021-07-27,Sacramento,067,1510023,116434,114413,2172,116585,1710
2021-07-27,San Benito,069,59416,6252,6229,114,6343,63
2021-07-27,San Bernardino,071,2135413,303026,299593,9337,308930,5236
2021-07-27,San Diego,073,3302833,297489,293408,17077,310485,3798
2021-07-27,San Francisco,075,870044,41273,39939,1502,41441,561
2021-07-27,San Joaquin,077,732212,77278,76166,3830,79996,1442
2021-07-27,San Luis Obispo,079,281455,22253,21803,796,22599,260
2021-07-27,San Mateo,081,765935,45032,44378,576,44954,547
2021-07-27,Santa Barbara,083,443738,35809,35355,1194,36549,467
2021-07-27,Santa Clara,085,1922200,123969,122154,839,122993,2099
2021-07-27,Santa Cruz,087,273765,16817,16523,812,17335,207
2021-07-27,Shasta,089,179085,13082,12846,1731,14577,212
2021-07-27,Sierra,091,2930,71,65,12,77,0
2021-07-27,Siskiyou,093,43540,2063,1964,422,2386,31
2021-07-27,Solano,095,438530,35894,35093,709,35802,261
2021-07-27,Sonoma,097,501317,33068,32367,383,32750,328
2021-07-27,Stanislaus,099,539301,59021,58333,6228,64561,1033
2021-07-27,Sutter,101,95872,10141,9998,101,10099,115
2021-07-27,Tehama,103,63373,5273,5192,599,5791,66
2021-07-27,Trinity,105,12862,510,351,111,462,3
2021-07-27,Tulare,107,460477,51259,50324,9408,59732,854
2021-07-27,Tuolumne,109,53932,4408,4282,47,4329,64
2021-07-27,Ventura,111,848112,84350,83189,3425,86614,1043
2021-07-27,Yolo,113,214977,15058,14759,388,15147,215
2021-07-27,Yuba,115,75493,6714,6564,140,6704,51
2021-07-26,Alameda,001,1643700,96104,94436,2145,96581,1259
2021-07-26,Alpine,003,1148,90,89,0,89,0
2021-07-26,Amador,005,37829,3903,3854,33,3887,48
2021-07-26,Butte,007,227075,13387,13082,1969,15051,203
2021-07-26,Calaveras,009,45235,2318,2276,15,2291,57
2021-07-26,Colusa,011,21464,2021,1996,347,2343,16
2021-07-26,Contra Costa,013,1133247,76456,74854,1493,76347,830
2021-07-26,Del Norte,015,27424,1628,1530,14,1544,8
2021-07-26,El Dorado,017,186661,11177,10899,865,11764,116
2021-07-26,Fresno,019,978130,105804,104143,8994,113137,1742
2021-07-26,Glenn,021,27897,2492,2461,580,3041,20
2021-07-26,Humboldt,023,135768,5078,4906,73,4979,52
2021-07-26,Imperial,025,180216,29271,29034,2706,31740,743
2021-07-26,Inyo,027,18085,1447,1429,12,1441,38
2021-07-26,Kern,029,883053,99822,98633,11710,110343,1351
2021-07-26,Kings,031,150075,23840,23426,1141,24567,247
2021-07-26,Lake,033,64148,4299,4133,15,4148,65
2021-07-26,Lassen,035,31185,5337,5314,118,5432,21
2021-07-26,Los Angeles,037,10098052,1258091,1241527,44510,1286037,24647
2021-07-26,Madera,039,155013,17268,16971,994,17965,245
2021-07-26,Marin,041,260295,14905,14579,285,14864,239
2021-07-26,Mariposa,043,17540,475,467,11,478,5
2021-07-26,Mendocino,045,87422,4510,4354,93,4447,49
2021-07-26,Merced,047,269075,31952,31774,1088,32862,473
2021-07-26,Modoc,049,8938,421,413,147,560,5
2021-07-26,Mono,051,14174,1294,1286,17,1303,3
2021-07-26,Monterey,053,433212,43888,43595,1932,45527,521
2021-07-26,Napa,055,140530,10457,10332,48,10380,82
2021-07-26,Nevada,057,99092,5500,5280,202,5482,72
2021-07-26,Orange,059,3164182,265495,261803,12054,273857,5142
2021-07-26,Placer,061,380077,25440,24842,1836,26678,304
2021-07-26,Plumas,063,18699,756,750,14,764,5
2021-07-26,Riverside,065,2383286,304228,298626,14474,313100,4553
2021-07-26,Sacramento,067,1510023,115835,113986,2156,116142,1705
2021-07-26,San Benito,069,59416,6246,6222,114,6336,63
2021-07-26,San Bernardino,071,2135413,302411,299238,9324,308562,5237
2021-07-26,San Diego,073,3302833,296381,292688,16995,309683,3793
2021-07-26,San Francisco,075,870044,40912,39800,1476,41276,561
2021-07-26,San Joaquin,077,732212,77043,76033,3826,79859,1440
2021-07-26,San Luis Obispo,079,281455,22204,21752,793,22545,260
2021-07-26,San Mateo,081,765935,44884,44297,568,44865,547
2021-07-26,Santa Barbara,083,443738,35736,35311,1182,36493,467
2021-07-26,Santa Clara,085,1922200,123660,121978,830,122808,2099
2021-07-26,Santa Cruz,087,273765,16777,16493,809,17302,207
2021-07-26,Shasta,089,179085,13033,12819,1720,14539,211
2021-07-26,Sierra,091,2930,70,65,12,77,0
2021-07-26,Siskiyou,093,43540,2060,1962,420,2382,31
2021-07-26,Solano,095,438530,35739,34990,702,35692,259
2021-07-26,Sonoma,097,501317,32932,32283,381,32664,328
2021-07-26,Stanislaus,099,539301,58876,58219,6209,64428,1033
2021-07-26,Sutter,101,95872,10101,9963,98,10061,115
2021-07-26,Tehama,103,63373,5263,5183,595,5778,66
2021-07-26,Trinity,105,12862,510,351,110,461,3
2021-07-26,Tulare,107,460477,51193,50265,9379,59644,854
2021-07-26,Tuolumne,109,53932,4378,4271,46,4317,64
2021-07-26,Ventura,111,848112,84177,83072,3410,86482,1041
2021-07-26,Yolo,113,214977,14997,14727,376,15103,215
2021-07-26,Yuba,115,75493,6680,6538,138,6676,51
2021-07-25,Alameda,001,1643700,95612,94146,2139,96285,1259
2021-07-25,Alpine,003,1148,88,89,0,89,0
2021-07-25,Amador,005,37829,3888,3848,33,3881,48
2021-07-25,Butte,007,227075,13348,13074,1959,15033,203
2021-07-25,Calaveras,009,45235,2308,2275,15,2290,57
2021-07-25,Colusa,011,21464,2012,1996,343,2339,16
2021-07-25,Contra Costa,013,1133247,75971,74634,1479,76113,830
2021-07-25,Del Norte,015,27424,1607,1526,14,1540,8
2021-07-25,El Dorado,017,186661,11120,10878,861,11739,116
2021-07-25,Fresno,019,978130,105562,104019,8978,112997,1742
2021-07-25,Glenn,021,27897,2483,2461,578,3039,20
2021-07-25,Humboldt,023,135768,5019,4892,72,4964,52
2021-07-25,Imperial,025,180216,29235,29037,2706,31743,743
2021-07-25,Inyo,027,18085,1442,1427,12,1439,38
2021-07-25,Kern,029,883053,99650,98503,11639,110142,1351
2021-07-25,Kings,031,150075,23786,23396,1137,24533,247
2021-07-25,Lake,033,64148,4246,4109,14,4123,65
2021-07-25,Lassen,035,31185,5332,5314,118,5432,21
2021-07-25,Los Angeles,037,10098052,1254672,1239596,44316,1283912,24643
2021-07-25,Madera,039,155013,17231,16947,987,17934,245
2021-07-25,Marin,041,260295,14855,14558,282,14840,239
2021-07-25,Mariposa,043,17540,472,465,11,476,5
2021-07-25,Mendocino,045,87422,4481,4335,91,4426,49
2021-07-25,Merced,047,269075,31879,31760,1086,32846,473
2021-07-25,Modoc,049,8938,421,413,147,560,5
2021-07-25,Mono,051,14174,1291,1286,17,1303,3
2021-07-25,Monterey,053,433212,43850,43590,1924,45514,521
2021-07-25,Napa,055,140530,10421,10316,47,10363,82
2021-07-25,Nevada,057,99092,5435,5256,199,5455,72
2021-07-25,Orange,059,3164182,264787,261351,12031,273382,5142
2021-07-25,Placer,061,380077,25318,24755,1815,26570,304
2021-07-25,Plumas,063,18699,754,750,14,764,5
2021-07-25,Riverside,065,2383286,303464,298181,14457,312638,4553
2021-07-25,Sacramento,067,1510023,115285,113611,2141,115752,1704
2021-07-25,San Benito,069,59416,6239,6217,114,6331,63
2021-07-25,San Bernardino,071,2135413,301752,298982,9317,308299,5237
2021-07-25,San Diego,073,3302833,295319,290626,16921,307547,3793
2021-07-25,San Francisco,075,870044,40562,39663,1451,41114,561
2021-07-25,San Joaquin,077,732212,76787,75926,3807,79733,1440
2021-07-25,San Luis Obispo,079,281455,22131,21741,790,22531,260
2021-07-25,San Mateo,081,765935,44722,44189,562,44751,547
2021-07-25,Santa Barbara,083,443738,35656,35261,1179,36440,467
2021-07-25,Santa Clara,085,1922200,123330,121800,825,122625,2099
2021-07-25,Santa Cruz,087,273765,16730,16474,808,17282,207
2021-07-25,Shasta,089,179085,12986,12815,1715,14530,211
2021-07-25,Sierra,091,2930,70,65,12,77,0
2021-07-25,Siskiyou,093,43540,2052,1963,417,2380,31
2021-07-25,Solano,095,438530,35547,34863,699,35562,259
2021-07-25,Sonoma,097,501317,32807,32202,378,32580,328
2021-07-25,Stanislaus,099,539301,58710,58154,6204,64358,1033
2021-07-25,Sutter,101,95872,10048,9937,96,10033,115
2021-07-25,Tehama,103,63373,5247,5181,594,5775,66
2021-07-25,Trinity,105,12862,508,351,108,459,3
2021-07-25,Tulare,107,460477,51118,50221,9341,59562,854
2021-07-25,Tuolumne,109,53932,4327,4267,46,4313,64
2021-07-25,Ventura,111,848112,83963,82986,3387,86373,1041
2021-07-25,Yolo,113,214977,14936,14693,362,15055,215
2021-07-25,Yuba,115,75493,6647,6519,138,6657,51
2021-07-24,Alameda,001,1643700,95331,93170,2135,95305,1259
2021-07-24,Alpine,003,1148,88,89,0,89,0
2021-07-24,Amador,005,37829,3879,3816,33,3849,48
2021-07-24,Butte,007,227075,13319,12982,1957,14939,203
2021-07-24,Calaveras,009,45235,2303,2267,15,2282,57
2021-07-24,Colusa,011,21464,2011,1992,341,2333,16
2021-07-24,Contra Costa,013,1133247,75743,73682,1476,75158,830
2021-07-24,Del Norte,015,27424,1596,1497,14,1511,8
2021-07-24,El Dorado,017,186661,11086,10773,858,11631,116
2021-07-24,Fresno,019,978130,105444,103637,8968,112605,1736
2021-07-24,Glenn,021,27897,2481,2457,578,3035,20
2021-07-24,Humboldt,023,135768,4984,4780,71,4851,52
2021-07-24,Imperial,025,180216,29215,28996,2706,31702,742
2021-07-24,Inyo,027,18085,1439,1424,12,1436,38
2021-07-24,Kern,029,883053,99572,98261,11617,109878,1350
2021-07-24,Kings,031,150075,23755,23304,1134,24438,246
2021-07-24,Lake,033,64148,4223,3963,14,3977,64
2021-07-24,Lassen,035,31185,5331,5311,118,5429,21
2021-07-24,Los Angeles,037,10098052,1252896,1232164,44187,1276351,24623
2021-07-24,Madera,039,155013,17207,16885,985,17870,245
2021-07-24,Marin,041,260295,14816,14454,282,14736,238
2021-07-24,Mariposa,043,17540,472,453,11,464,5
2021-07-24,Mendocino,045,87422,4456,4293,91,4384,49
2021-07-24,Merced,047,269075,31857,31661,1085,32746,473
2021-07-24,Modoc,049,8938,421,413,147,560,5
2021-07-24,Mono,051,14174,1289,1284,17,1301,3
2021-07-24,Monterey,053,433212,43825,43525,1917,45442,521
2021-07-24,Napa,055,140530,10405,10230,47,10277,81
2021-07-24,Nevada,057,99092,5403,5183,199,5382,72
2021-07-24,Orange,059,3164182,264322,259973,12019,271992,5141
2021-07-24,Placer,061,380077,25235,24530,1810,26340,303
2021-07-24,Plumas,063,18699,753,737,14,751,4
2021-07-24,Riverside,065,2383286,302996,296912,14447,311359,4552
2021-07-24,Sacramento,067,1510023,114971,112438,2137,114575,1698
2021-07-24,San Benito,069,59416,6235,6200,113,6313,63
2021-07-24,San Bernardino,071,2135413,301360,297899,9308,307207,5236
2021-07-24,San Diego,073,3302833,294853,289368,16893,306261,3788
2021-07-24,San Francisco,075,870044,40388,38954,1435,40389,561
2021-07-24,San Joaquin,077,732212,76659,75461,3796,79257,1436
2021-07-24,San Luis Obispo,079,281455,22100,21616,788,22404,260
2021-07-24,San Mateo,081,765935,44605,43880,556,44436,542
2021-07-24,Santa Barbara,083,443738,35597,35071,1175,36246,465
2021-07-24,Santa Clara,085,1922200,123118,121092,824,121916,2099
2021-07-24,Santa Cruz,087,273765,16707,16416,808,17224,207
2021-07-24,Shasta,089,179085,12958,12759,1712,14471,211
2021-07-24,Sierra,091,2930,69,64,12,76,0
2021-07-24,Siskiyou,093,43540,2052,1951,417,2368,31
2021-07-24,Solano,095,438530,35455,34499,690,35189,259
2021-07-24,Sonoma,097,501317,32682,31928,376,32304,327
2021-07-24,Stanislaus,099,539301,58618,57879,6194,64073,1030
2021-07-24,Sutter,101,95872,10021,9890,96,9986,115
2021-07-24,Tehama,103,63373,5240,5166,592,5758,65
2021-07-24,Trinity,105,12862,508,345,108,453,3
2021-07-24,Tulare,107,460477,51075,50104,9324,59428,854
2021-07-24,Tuolumne,109,53932,4301,4216,46,4262,64
2021-07-24,Ventura,111,848112,83836,82687,3371,86058,1041
2021-07-24,Yolo,113,214977,14898,14557,358,14915,214
2021-07-24,Yuba,115,75493,6628,6449,138,6587,51
2021-07-23,Alameda,001,1643700,95078,93170,2131,95301,1259
2021-07-23,Alpine,003,1148,88,89,0,89,0
2021-07-23,Amador,005,37829,3872,3816,33,3849,48
2021-07-23,Butte,007,227075,13290,12982,1949,14931,203
2021-07-23,Calaveras,009,45235,2293,2267,15,2282,57
2021-07-23,Colusa,011,21464,2010,1992,341,2333,16
2021-07-23,Contra Costa,013,1133247,75483,73682,1467,75149,830
2021-07-23,Del Norte,015,27424,1588,1497,14,1511,8
2021-07-23,El Dorado,017,186661,11057,10773,854,11627,116
2021-07-23,Fresno,019,978130,105312,103637,8958,112595,1736
2021-07-23,Glenn,021,27897,2479,2457,575,3032,20
2021-07-23,Humboldt,023,135768,4962,4780,68,4848,52
2021-07-23,Imperial,025,180216,29203,28996,2706,31702,742
2021-07-23,Inyo,027,18085,1436,1424,12,1436,38
2021-07-23,Kern,029,883053,99490,98261,11592,109853,1350
2021-07-23,Kings,031,150075,23724,23304,1131,24435,246
2021-07-23,Lake,033,64148,4194,3963,14,3977,64
2021-07-23,Lassen,035,31185,5329,5311,118,5429,21
2021-07-23,Los Angeles,037,10098052,1250955,1232164,44078,1276242,24623
2021-07-23,Madera,039,155013,17177,16885,980,17865,245
2021-07-23,Marin,041,260295,14779,14454,280,14734,238
2021-07-23,Mariposa,043,17540,469,453,11,464,5
2021-07-23,Mendocino,045,87422,4443,4293,91,4384,49
2021-07-23,Merced,047,269075,31832,31661,1085,32746,473
2021-07-23,Modoc,049,8938,421,413,147,560,5
2021-07-23,Mono,051,14174,1288,1284,17,1301,3
2021-07-23,Monterey,053,433212,43799,43525,1917,45442,521
2021-07-23,Napa,055,140530,10384,10230,47,10277,81
2021-07-23,Nevada,057,99092,5359,5183,199,5382,72
2021-07-23,Orange,059,3164182,263872,259973,11996,271969,5141
2021-07-23,Placer,061,380077,25155,24530,1794,26324,303
2021-07-23,Plumas,063,18699,751,737,14,751,4
2021-07-23,Riverside,065,2383286,302531,296912,14435,311347,4552
2021-07-23,Sacramento,067,1510023,114617,112438,2135,114573,1698
2021-07-23,San Benito,069,59416,6229,6200,113,6313,63
2021-07-23,San Bernardino,071,2135413,300977,297899,9299,307198,5236
2021-07-23,San Diego,073,3302833,294245,289368,16845,306213,3788
2021-07-23,San Francisco,075,870044,40202,38954,1423,40377,561
2021-07-23,San Joaquin,077,732212,76555,75461,3781,79242,1436
2021-07-23,San Luis Obispo,079,281455,22061,21616,788,22404,260
2021-07-23,San Mateo,081,765935,44501,43880,552,44432,542
2021-07-23,Santa Barbara,083,443738,35532,35071,1174,36245,465
2021-07-23,Santa Clara,085,1922200,122899,121092,821,121913,2099
2021-07-23,Santa Cruz,087,273765,16682,16416,808,17224,207
2021-07-23,Shasta,089,179085,12931,12759,1709,14468,211
2021-07-23,Sierra,091,2930,69,64,12,76,0
2021-07-23,Siskiyou,093,43540,2050,1951,417,2368,31
2021-07-23,Solano,095,438530,35363,34499,686,35185,259
2021-07-23,Sonoma,097,501317,32587,31928,375,32303,327
2021-07-23,Stanislaus,099,539301,58542,57879,6185,64064,1030
2021-07-23,Sutter,101,95872,9992,9890,96,9986,115
2021-07-23,Tehama,103,63373,5231,5166,592,5758,65
2021-07-23,Trinity,105,12862,507,345,107,452,3
2021-07-23,Tulare,107,460477,51029,50104,9303,59407,854
2021-07-23,Tuolumne,109,53932,4279,4216,46,4262,64
2021-07-23,Ventura,111,848112,83674,82687,3353,86040,1041
2021-07-23,Yolo,113,214977,14861,14557,351,14908,214
2021-07-23,Yuba,115,75493,6602,6449,137,6586,51
2021-07-22,Alameda,001,1643700,94725,93170,2127,95297,1259
2021-07-22,Alpine,003,1148,88,89,0,89,0
2021-07-22,Amador,005,37829,3863,3816,33,3849,48
2021-07-22,Butte,007,227075,13256,12982,1940,14922,203
2021-07-22,Calaveras,009,45235,2283,2267,15,2282,57
2021-07-22,Colusa,011,21464,2008,1992,338,2330,16
2021-07-22,Contra Costa,013,1133247,75144,73682,1462,75144,830
2021-07-22,Del Norte,015,27424,1571,1497,14,1511,8
2021-07-22,El Dorado,017,186661,11021,10773,846,11619,116
2021-07-22,Fresno,019,978130,105183,103637,8948,112585,1736
2021-07-22,Glenn,021,27897,2475,2457,575,3032,20
2021-07-22,Humboldt,023,135768,4931,4780,66,4846,52
2021-07-22,Imperial,025,180216,29173,28996,2706,31702,742
2021-07-22,Inyo,027,18085,1434,1424,12,1436,38
2021-07-22,Kern,029,883053,99375,98261,11551,109812,1350
2021-07-22,Kings,031,150075,23685,23304,1129,24433,246
2021-07-22,Lake,033,64148,4143,3963,14,3977,64
2021-07-22,Lassen,035,31185,5326,5311,118,5429,21
2021-07-22,Los Angeles,037,10098052,1248521,1232164,43897,1276061,24623
2021-07-22,Madera,039,155013,17142,16885,978,17863,245
2021-07-22,Marin,041,260295,14738,14454,279,14733,238
2021-07-22,Mariposa,043,17540,462,453,11,464,5
2021-07-22,Mendocino,045,87422,4430,4293,90,4383,49
2021-07-22,Merced,047,269075,31790,31661,1084,32745,473
2021-07-22,Modoc,049,8938,421,413,147,560,5
2021-07-22,Mono,051,14174,1287,1284,17,1301,3
2021-07-22,Monterey,053,433212,43771,43525,1911,45436,521
2021-07-22,Napa,055,140530,10366,10230,47,10277,81
2021-07-22,Nevada,057,99092,5333,5183,198,5381,72
2021-07-22,Orange,059,3164182,263319,259973,11987,271960,5141
2021-07-22,Placer,061,380077,25061,24530,1783,26313,303
2021-07-22,Plumas,063,18699,750,737,14,751,4
2021-07-22,Riverside,065,2383286,302023,296912,14414,311326,4552
2021-07-22,Sacramento,067,1510023,114179,112438,2126,114564,1698
2021-07-22,San Benito,069,59416,6222,6200,113,6313,63
2021-07-22,San Bernardino,071,2135413,300574,297899,9284,307183,5236
2021-07-22,San Diego,073,3302833,293515,289368,16785,306153,3788
2021-07-22,San Francisco,075,870044,39989,38954,1411,40365,561
2021-07-22,San Joaquin,077,732212,76412,75461,3769,79230,1436
2021-07-22,San Luis Obispo,079,281455,22023,21616,784,22400,260
2021-07-22,San Mateo,081,765935,44389,43880,547,44427,542
2021-07-22,Santa Barbara,083,443738,35466,35071,1172,36243,465
2021-07-22,Santa Clara,085,1922200,122658,121092,818,121910,2099
2021-07-22,Santa Cruz,087,273765,16645,16416,807,17223,207
2021-07-22,Shasta,089,179085,12907,12759,1705,14464,211
2021-07-22,Sierra,091,2930,67,64,12,76,0
2021-07-22,Siskiyou,093,43540,2047,1951,417,2368,31
2021-07-22,Solano,095,438530,35217,34499,679,35178,259
2021-07-22,Sonoma,097,501317,32477,31928,373,32301,327
2021-07-22,Stanislaus,099,539301,58414,57879,6173,64052,1030
2021-07-22,Sutter,101,95872,9971,9890,96,9986,115
2021-07-22,Tehama,103,63373,5225,5166,592,5758,65
2021-07-22,Trinity,105,12862,507,345,107,452,3
2021-07-22,Tulare,107,460477,50986,50104,9275,59379,854
2021-07-22,Tuolumne,109,53932,4267,4216,46,4262,64
2021-07-22,Ventura,111,848112,83540,82687,3340,86027,1041
2021-07-22,Yolo,113,214977,14823,14557,351,14908,214
2021-07-22,Yuba,115,75493,6571,6449,134,6583,51
2021-07-21,Alameda,001,1643700,94405,92840,2124,94964,1256
2021-07-21,Alpine,003,1148,88,89,0,89,0
2021-07-21,Amador,005,37829,3850,3813,33,3846,48
2021-07-21,Butte,007,227075,13215,12939,1935,14874,203
2021-07-21,Calaveras,009,45235,2279,2257,15,2272,57
2021-07-21,Colusa,011,21464,2004,1988,337,2325,16
2021-07-21,Contra Costa,013,1133247,74880,73320,1453,74773,827
2021-07-21,Del Norte,015,27424,1561,1492,14,1506,8
2021-07-21,El Dorado,017,186661,10984,10742,842,11584,116
2021-07-21,Fresno,019,978130,105035,103504,8939,112443,1736
2021-07-21,Glenn,021,27897,2473,2455,574,3029,20
2021-07-21,Humboldt,023,135768,4899,4763,64,4827,52
2021-07-21,Imperial,025,180216,29161,28964,2703,31667,742
2021-07-21,Inyo,027,18085,1434,1423,12,1435,38
2021-07-21,Kern,029,883053,99257,98152,11510,109662,1350
2021-07-21,Kings,031,150075,23657,23270,1125,24395,246
2021-07-21,Lake,033,64148,4077,3896,14,3910,64
2021-07-21,Lassen,035,31185,5323,5310,118,5428,21
2021-07-21,Los Angeles,037,10098052,1246009,1229598,43759,1273357,24609
2021-07-21,Madera,039,155013,17118,16858,976,17834,245
2021-07-21,Marin,041,260295,14689,14427,279,14706,238
2021-07-21,Mariposa,043,17540,458,449,11,460,5
2021-07-21,Mendocino,045,87422,4412,4274,90,4364,49
2021-07-21,Merced,047,269075,31751,31607,1080,32687,473
2021-07-21,Modoc,049,8938,421,413,147,560,5
2021-07-21,Mono,051,14174,1284,1282,17,1299,3
2021-07-21,Monterey,053,433212,43741,43502,1908,45410,515
2021-07-21,Napa,055,140530,10340,10209,47,10256,81
2021-07-21,Nevada,057,99092,5298,5152,198,5350,72
2021-07-21,Orange,059,3164182,262766,259615,11957,271572,5139
2021-07-21,Placer,061,380077,24952,24441,1772,26213,303
2021-07-21,Plumas,063,18699,750,736,14,750,4
2021-07-21,Riverside,065,2383286,301510,296419,14397,310816,4552
2021-07-21,Sacramento,067,1510023,113757,112043,2115,114158,1696
2021-07-21,San Benito,069,59416,6212,6196,113,6309,63
2021-07-21,San Bernardino,071,2135413,300118,297519,9276,306795,5230
2021-07-21,San Diego,073,3302833,292666,288682,16722,305404,3787
2021-07-21,San Francisco,075,870044,39764,38699,1406,40105,559
2021-07-21,San Joaquin,077,732212,76223,75288,3757,79045,1434
2021-07-21,San Luis Obispo,079,281455,21986,21579,781,22360,260
2021-07-21,San Mateo,081,765935,44297,43755,543,44298,542
2021-07-21,Santa Barbara,083,443738,35407,34998,1156,36154,465
2021-07-21,Santa Clara,085,1922200,122449,120838,816,121654,2099
2021-07-21,Santa Cruz,087,273765,16611,16407,807,17214,207
2021-07-21,Shasta,089,179085,12874,12751,1702,14453,211
2021-07-21,Sierra,091,2930,67,64,12,76,0
2021-07-21,Siskiyou,093,43540,2045,1943,415,2358,31
2021-07-21,Solano,095,438530,35059,34374,674,35048,258
2021-07-21,Sonoma,097,501317,32361,31789,373,32162,327
2021-07-21,Stanislaus,099,539301,58312,57774,6163,63937,1028
2021-07-21,Sutter,101,95872,9947,9862,96,9958,113
2021-07-21,Tehama,103,63373,5221,5161,592,5753,65
2021-07-21,Trinity,105,12862,505,345,106,451,3
2021-07-21,Tulare,107,460477,50926,50066,9250,59316,854
2021-07-21,Tuolumne,109,53932,4230,4156,46,4202,64
2021-07-21,Ventura,111,848112,83418,82573,3328,85901,1041
2021-07-21,Yolo,113,214977,14781,14525,350,14875,213
2021-07-21,Yuba,115,75493,6543,6425,134,6559,52
2021-07-20,Alameda,001,1643700,94033,92625,2110,94735,1256
2021-07-20,Alpine,003,1148,88,89,0,89,0
2021-07-20,Amador,005,37829,3839,3807,33,3840,48
2021-07-20,Butte,007,227075,13178,12916,1930,14846,203
2021-07-20,Calaveras,009,45235,2276,2249,15,2264,57
2021-07-20,Colusa,011,21464,2004,1985,337,2322,16
2021-07-20,Contra Costa,013,1133247,74596,73143,1435,74578,825
2021-07-20,Del Norte,015,27424,1551,1490,14,1504,8
2021-07-20,El Dorado,017,186661,10944,10727,838,11565,116
2021-07-20,Fresno,019,978130,104899,103438,8920,112358,1736
2021-07-20,Glenn,021,27897,2473,2453,574,3027,20
2021-07-20,Humboldt,023,135768,4854,4735,62,4797,52
2021-07-20,Imperial,025,180216,29141,28933,2703,31636,742
2021-07-20,Inyo,027,18085,1430,1420,12,1432,36
2021-07-20,Kern,029,883053,99144,98082,11482,109564,1350
2021-07-20,Kings,031,150075,23616,23254,1120,24374,246
2021-07-20,Lake,033,64148,4052,3871,14,3885,64
2021-07-20,Lassen,035,31185,5323,5306,118,5424,21
2021-07-20,Los Angeles,037,10098052,1243213,1227404,43594,1270998,24603
2021-07-20,Madera,039,155013,17097,16856,972,17828,245
2021-07-20,Marin,041,260295,14653,14396,276,14672,234
2021-07-20,Mariposa,043,17540,456,448,11,459,5
2021-07-20,Mendocino,045,87422,4395,4259,90,4349,49
2021-07-20,Merced,047,269075,31712,31578,1073,32651,473
2021-07-20,Modoc,049,8938,421,413,147,560,5
2021-07-20,Mono,051,14174,1280,1281,17,1298,3
2021-07-20,Monterey,053,433212,43710,43481,1905,45386,515
2021-07-20,Napa,055,140530,10317,10191,47,10238,81
2021-07-20,Nevada,057,99092,5279,5148,197,5345,72
2021-07-20,Orange,059,3164182,262209,259303,11927,271230,5139
2021-07-20,Placer,061,380077,24860,24408,1750,26158,303
2021-07-20,Plumas,063,18699,748,736,14,750,4
2021-07-20,Riverside,065,2383286,300975,296118,14383,310501,4543
2021-07-20,Sacramento,067,1510023,113317,111796,2085,113881,1695
2021-07-20,San Benito,069,59416,6205,6196,113,6309,63
2021-07-20,San Bernardino,071,2135413,299708,297222,9251,306473,5231
2021-07-20,San Diego,073,3302833,291740,288209,16626,304835,3786
2021-07-20,San Francisco,075,870044,39506,38536,1395,39931,558
2021-07-20,San Joaquin,077,732212,76051,75198,3744,78942,1433
2021-07-20,San Luis Obispo,079,281455,21940,21556,780,22336,259
2021-07-20,San Mateo,081,765935,44178,43670,542,44212,542
2021-07-20,Santa Barbara,083,443738,35337,34935,1150,36085,462
2021-07-20,Santa Clara,085,1922200,122192,120704,814,121518,2098
2021-07-20,Santa Cruz,087,273765,16582,16399,807,17206,207
2021-07-20,Shasta,089,179085,12848,12734,1698,14432,211
2021-07-20,Sierra,091,2930,67,64,12,76,0
2021-07-20,Siskiyou,093,43540,2041,1931,414,2345,31
2021-07-20,Solano,095,438530,34924,34337,667,35004,258
2021-07-20,Sonoma,097,501317,32242,31763,372,32135,326
2021-07-20,Stanislaus,099,539301,58197,57706,6158,63864,1028
2021-07-20,Sutter,101,95872,9920,9854,93,9947,114
2021-07-20,Tehama,103,63373,5219,5153,592,5745,65
2021-07-20,Trinity,105,12862,503,344,105,449,3
2021-07-20,Tulare,107,460477,50884,50047,9233,59280,854
2021-07-20,Tuolumne,109,53932,4211,4156,46,4202,64
2021-07-20,Ventura,111,848112,83265,82504,3313,85817,1041
2021-07-20,Yolo,113,214977,14716,14495,347,14842,213
2021-07-20,Yuba,115,75493,6518,6393,131,6524,52
2021-07-19,Alameda,001,1643700,93659,92357,2094,94451,1256
2021-07-19,Alpine,003,1148,88,89,0,89,0
2021-07-19,Amador,005,37829,3835,3802,33,3835,48
2021-07-19,Butte,007,227075,13134,12901,1925,14826,202
2021-07-19,Calaveras,009,45235,2272,2245,15,2260,57
2021-07-19,Colusa,011,21464,2002,1981,337,2318,16
2021-07-19,Contra Costa,013,1133247,74284,72935,1415,74350,825
2021-07-19,Del Norte,015,27424,1538,1484,14,1498,8
2021-07-19,El Dorado,017,186661,10914,10703,830,11533,114
2021-07-19,Fresno,019,978130,104769,103350,8907,112257,1731
2021-07-19,Glenn,021,27897,2473,2452,573,3025,20
2021-07-19,Humboldt,023,135768,4824,4719,60,4779,52
2021-07-19,Imperial,025,180216,29114,28888,2702,31590,742
2021-07-19,Inyo,027,18085,1429,1417,12,1429,36
2021-07-19,Kern,029,883053,99030,97999,11449,109448,1349
2021-07-19,Kings,031,150075,23586,23221,1114,24335,246
2021-07-19,Lake,033,64148,4016,3848,14,3862,64
2021-07-19,Lassen,035,31185,5322,5305,118,5423,21
2021-07-19,Los Angeles,037,10098052,1240610,1225946,43405,1269351,24600
2021-07-19,Madera,039,155013,17074,16846,969,17815,244
2021-07-19,Marin,041,260295,14618,14369,273,14642,234
2021-07-19,Mariposa,043,17540,450,447,11,458,5
2021-07-19,Mendocino,045,87422,4377,4251,90,4341,49
2021-07-19,Merced,047,269075,31648,31565,1066,32631,472
2021-07-19,Modoc,049,8938,420,413,147,560,5
2021-07-19,Mono,051,14174,1278,1280,17,1297,3
2021-07-19,Monterey,053,433212,43686,43436,1904,45340,515
2021-07-19,Napa,055,140530,10292,10180,45,10225,81
2021-07-19,Nevada,057,99092,5251,5133,196,5329,72
2021-07-19,Orange,059,3164182,261686,258927,11895,270822,5138
2021-07-19,Placer,061,380077,24761,24359,1728,26087,303
2021-07-19,Plumas,063,18699,748,730,14,744,4
2021-07-19,Riverside,065,2383286,300485,295736,14345,310081,4543
2021-07-19,Sacramento,067,1510023,112953,111470,2061,113531,1696
2021-07-19,San Benito,069,59416,6202,6193,113,6306,63
2021-07-19,San Bernardino,071,2135413,299335,296929,9232,306161,5235
2021-07-19,San Diego,073,3302833,290840,287695,16521,304216,3786
2021-07-19,San Francisco,075,870044,39233,38463,1382,39845,560
2021-07-19,San Joaquin,077,732212,75886,75086,3739,78825,1431
2021-07-19,San Luis Obispo,079,281455,21895,21531,776,22307,259
2021-07-19,San Mateo,081,765935,44036,43563,533,44096,542
2021-07-19,Santa Barbara,083,443738,35265,34904,1148,36052,461
2021-07-19,Santa Clara,085,1922200,121934,120554,813,121367,2098
2021-07-19,Santa Cruz,087,273765,16566,16387,807,17194,207
2021-07-19,Shasta,089,179085,12830,12723,1696,14419,209
2021-07-19,Sierra,091,2930,66,64,12,76,0
2021-07-19,Siskiyou,093,43540,2036,1927,412,2339,31
2021-07-19,Solano,095,438530,34749,34262,656,34918,261
2021-07-19,Sonoma,097,501317,32121,31713,371,32084,325
2021-07-19,Stanislaus,099,539301,58096,57644,6148,63792,1027
2021-07-19,Sutter,101,95872,9904,9834,93,9927,114
2021-07-19,Tehama,103,63373,5213,5152,590,5742,65
2021-07-19,Trinity,105,12862,503,344,104,448,3
2021-07-19,Tulare,107,460477,50837,49994,9217,59211,855
2021-07-19,Tuolumne,109,53932,4201,4151,46,4197,64
2021-07-19,Ventura,111,848112,83169,82409,3291,85700,1041
2021-07-19,Yolo,113,214977,14684,14439,345,14784,213
2021-07-19,Yuba,115,75493,6494,6370,131,6501,52
2021-07-18,Alameda,001,1643700,93300,92162,2082,94244,1256
2021-07-18,Alpine,003,1148,88,89,0,89,0
2021-07-18,Amador,005,37829,3824,3799,33,3832,48
2021-07-18,Butte,007,227075,13091,12888,1920,14808,202
2021-07-18,Calaveras,009,45235,2269,2243,15,2258,57
2021-07-18,Colusa,011,21464,2002,1981,336,2317,16
2021-07-18,Contra Costa,013,1133247,73968,72849,1397,74246,825
2021-07-18,Del Norte,015,27424,1529,1482,14,1496,8
2021-07-18,El Dorado,017,186661,10877,10687,822,11509,114
2021-07-18,Fresno,019,978130,104615,103298,8889,112187,1731
2021-07-18,Glenn,021,27897,2472,2452,572,3024,20
2021-07-18,Humboldt,023,135768,4788,4714,60,4774,52
2021-07-18,Imperial,025,180216,29077,28877,2701,31578,742
2021-07-18,Inyo,027,18085,1425,1417,12,1429,36
2021-07-18,Kern,029,883053,98904,97963,11407,109370,1349
2021-07-18,Kings,031,150075,23565,23203,1110,24313,246
2021-07-18,Lake,033,64148,3980,3825,14,3839,64
2021-07-18,Lassen,035,31185,5322,5305,118,5423,21
2021-07-18,Los Angeles,037,10098052,1237924,1224691,43215,1267906,24598
2021-07-18,Madera,039,155013,17049,16838,965,17803,244
2021-07-18,Marin,041,260295,14582,14358,271,14629,234
2021-07-18,Mariposa,043,17540,449,447,11,458,5
2021-07-18,Mendocino,045,87422,4356,4246,90,4336,49
2021-07-18,Merced,047,269075,31617,31537,1064,32601,471
2021-07-18,Modoc,049,8938,420,413,147,560,5
2021-07-18,Mono,051,14174,1277,1280,17,1297,3
2021-07-18,Monterey,053,433212,43668,43422,1894,45316,515
2021-07-18,Napa,055,140530,10275,10174,42,10216,81
2021-07-18,Nevada,057,99092,5225,5124,196,5320,72
2021-07-18,Orange,059,3164182,261202,258724,11867,270591,5138
2021-07-18,Placer,061,380077,24694,24313,1701,26014,303
2021-07-18,Plumas,063,18699,748,730,14,744,4
2021-07-18,Riverside,065,2383286,299993,295522,14303,309825,4543
2021-07-18,Sacramento,067,1510023,112522,111255,2028,113283,1696
2021-07-18,San Benito,069,59416,6194,6191,113,6304,63
2021-07-18,San Bernardino,071,2135413,298861,296739,9217,305956,5233
2021-07-18,San Diego,073,3302833,290024,286287,16437,302724,3786
2021-07-18,San Francisco,075,870044,38997,38367,1371,39738,560
2021-07-18,San Joaquin,077,732212,75709,74997,3726,78723,1431
2021-07-18,San Luis Obispo,079,281455,21860,21527,773,22300,259
2021-07-18,San Mateo,081,765935,43923,43506,527,44033,542
2021-07-18,Santa Barbara,083,443738,35200,34880,1146,36026,461
2021-07-18,Santa Clara,085,1922200,121720,120438,806,121244,2098
2021-07-18,Santa Cruz,087,273765,16534,16372,806,17178,207
2021-07-18,Shasta,089,179085,12805,12714,1692,14406,209
2021-07-18,Sierra,091,2930,66,64,12,76,0
2021-07-18,Siskiyou,093,43540,2030,1927,407,2334,31
2021-07-18,Solano,095,438530,34621,34215,652,34867,261
2021-07-18,Sonoma,097,501317,32016,31675,370,32045,325
2021-07-18,Stanislaus,099,539301,57985,57600,6123,63723,1028
2021-07-18,Sutter,101,95872,9872,9826,93,9919,114
2021-07-18,Tehama,103,63373,5210,5150,589,5739,65
2021-07-18,Trinity,105,12862,503,344,104,448,3
2021-07-18,Tulare,107,460477,50784,49985,9194,59179,855
2021-07-18,Tuolumne,109,53932,4183,4149,46,4195,64
2021-07-18,Ventura,111,848112,83055,82361,3267,85628,1041
2021-07-18,Yolo,113,214977,14625,14425,339,14764,213
2021-07-18,Yuba,115,75493,6453,6357,131,6488,52
2021-07-17,Alameda,001,1643700,93083,91346,2070,93416,1255
2021-07-17,Alpine,003,1148,88,89,0,89,0
2021-07-17,Amador,005,37829,3815,3785,33,3818,48
2021-07-17,Butte,007,227075,13076,12824,1916,14740,202
2021-07-17,Calaveras,009,45235,2263,2237,15,2252,57
2021-07-17,Colusa,011,21464,1999,1976,336,2312,16
2021-07-17,Contra Costa,013,1133247,73786,72254,1384,73638,824
2021-07-17,Del Norte,015,27424,1521,1475,14,1489,8
2021-07-17,El Dorado,017,186661,10850,10622,818,11440,114
2021-07-17,Fresno,019,978130,104542,103055,8875,111930,1730
2021-07-17,Glenn,021,27897,2471,2451,572,3023,20
2021-07-17,Humboldt,023,135768,4775,4654,59,4713,52
2021-07-17,Imperial,025,180216,29061,28840,2701,31541,742
2021-07-17,Inyo,027,18085,1425,1416,12,1428,36
2021-07-17,Kern,029,883053,98847,97796,11371,109167,1348
2021-07-17,Kings,031,150075,23545,23163,1109,24272,246
2021-07-17,Lake,033,64148,3955,3760,14,3774,64
2021-07-17,Lassen,035,31185,5322,5302,118,5420,21
2021-07-17,Los Angeles,037,10098052,1236388,1219733,43073,1262806,24582
2021-07-17,Madera,039,155013,17041,16804,965,17769,240
2021-07-17,Marin,041,260295,14564,14297,269,14566,234
2021-07-17,Mariposa,043,17540,449,445,11,456,5
2021-07-17,Mendocino,045,87422,4344,4209,90,4299,49
2021-07-17,Merced,047,269075,31596,31451,1060,32511,471
2021-07-17,Modoc,049,8938,420,412,147,559,5
2021-07-17,Mono,051,14174,1275,1277,17,1294,3
2021-07-17,Monterey,053,433212,43645,43367,1889,45256,515
2021-07-17,Napa,055,140530,10259,10129,42,10171,81
2021-07-17,Nevada,057,99092,5210,5066,196,5262,72
2021-07-17,Orange,059,3164182,260895,257805,11828,269633,5136
2021-07-17,Placer,061,380077,24627,24169,1687,25856,303
2021-07-17,Plumas,063,18699,743,721,14,735,4
2021-07-17,Riverside,065,2383286,299687,294751,14271,309022,4542
2021-07-17,Sacramento,067,1510023,112287,110432,2008,112440,1694
2021-07-17,San Benito,069,59416,6188,6181,113,6294,63
2021-07-17,San Bernardino,071,2135413,298624,296048,9198,305246,5218
2021-07-17,San Diego,073,3302833,289617,285698,16369,302067,3786
2021-07-17,San Francisco,075,870044,38876,37978,1368,39346,560
2021-07-17,San Joaquin,077,732212,75622,74695,3720,78415,1430
2021-07-17,San Luis Obispo,079,281455,21833,21462,773,22235,258
2021-07-17,San Mateo,081,765935,43852,43324,526,43850,542
2021-07-17,Santa Barbara,083,443738,35159,34769,1143,35912,461
2021-07-17,Santa Clara,085,1922200,121548,119980,803,120783,2097
2021-07-17,Santa Cruz,087,273765,16527,16337,806,17143,207
2021-07-17,Shasta,089,179085,12790,12683,1687,14370,210
2021-07-17,Sierra,091,2930,66,62,12,74,0
2021-07-17,Siskiyou,093,43540,2025,1922,404,2326,29
2021-07-17,Solano,095,438530,34556,34015,644,34659,263
2021-07-17,Sonoma,097,501317,31948,31536,369,31905,322
2021-07-17,Stanislaus,099,539301,57908,57400,6109,63509,1028
2021-07-17,Sutter,101,95872,9862,9778,93,9871,114
2021-07-17,Tehama,103,63373,5207,5145,589,5734,64
2021-07-17,Trinity,105,12862,502,341,104,445,3
2021-07-17,Tulare,107,460477,50763,49937,9182,59119,854
2021-07-17,Tuolumne,109,53932,4173,4131,46,4177,64
2021-07-17,Ventura,111,848112,82986,82125,3256,85381,1041
2021-07-17,Yolo,113,214977,14593,14356,332,14688,213
2021-07-17,Yuba,115,75493,6442,6309,131,6440,52
2021-07-16,Alameda,001,1643700,92841,91346,2059,93405,1255
2021-07-16,Alpine,003,1148,88,89,0,89,0
2021-07-16,Amador,005,37829,3812,3785,33,3818,48
2021-07-16,Butte,007,227075,13051,12824,1913,14737,202
2021-07-16,Calaveras,009,45235,2262,2237,15,2252,57
2021-07-16,Colusa,011,21464,1997,1976,335,2311,16
2021-07-16,Contra Costa,013,1133247,73598,72254,1380,73634,824
2021-07-16,Del Norte,015,27424,1519,1475,14,1489,8
2021-07-16,El Dorado,017,186661,10831,10622,817,11439,114
2021-07-16,Fresno,019,978130,104489,103055,8855,111910,1730
2021-07-16,Glenn,021,27897,2471,2451,572,3023,20
2021-07-16,Humboldt,023,135768,4753,4654,59,4713,52
2021-07-16,Imperial,025,180216,29049,28840,2701,31541,742
2021-07-16,Inyo,027,18085,1423,1416,12,1428,36
2021-07-16,Kern,029,883053,98785,97796,11331,109127,1348
2021-07-16,Kings,031,150075,23520,23163,1108,24271,246
2021-07-16,Lake,033,64148,3928,3760,14,3774,64
2021-07-16,Lassen,035,31185,5321,5302,118,5420,21
2021-07-16,Los Angeles,037,10098052,1234886,1219733,42927,1262660,24582
2021-07-16,Madera,039,155013,17023,16804,965,17769,240
2021-07-16,Marin,041,260295,14540,14297,266,14563,234
2021-07-16,Mariposa,043,17540,449,445,11,456,5
2021-07-16,Mendocino,045,87422,4335,4209,89,4298,49
2021-07-16,Merced,047,269075,31575,31451,1058,32509,471
2021-07-16,Modoc,049,8938,420,412,147,559,5
2021-07-16,Mono,051,14174,1274,1277,17,1294,3
2021-07-16,Monterey,053,433212,43623,43367,1888,45255,515
2021-07-16,Napa,055,140530,10235,10129,41,10170,81
2021-07-16,Nevada,057,99092,5200,5066,196,5262,72
2021-07-16,Orange,059,3164182,260622,257805,11787,269592,5136
2021-07-16,Placer,061,380077,24574,24169,1682,25851,303
2021-07-16,Plumas,063,18699,742,721,14,735,4
2021-07-16,Riverside,065,2383286,299411,294751,14245,308996,4542
2021-07-16,Sacramento,067,1510023,112070,110432,1995,112427,1694
2021-07-16,San Benito,069,59416,6186,6181,113,6294,63
2021-07-16,San Bernardino,071,2135413,298348,296048,9181,305229,5218
2021-07-16,San Diego,073,3302833,289175,285698,16322,302020,3786
2021-07-16,San Francisco,075,870044,38759,37978,1363,39341,560
2021-07-16,San Joaquin,077,732212,75528,74695,3717,78412,1430
2021-07-16,San Luis Obispo,079,281455,21816,21462,773,22235,258
2021-07-16,San Mateo,081,765935,43799,43324,525,43849,542
2021-07-16,Santa Barbara,083,443738,35121,34769,1143,35912,461
2021-07-16,Santa Clara,085,1922200,121401,119980,796,120776,2097
2021-07-16,Santa Cruz,087,273765,16514,16337,806,17143,207
2021-07-16,Shasta,089,179085,12780,12683,1686,14369,210
2021-07-16,Sierra,091,2930,66,62,12,74,0
2021-07-16,Siskiyou,093,43540,2023,1922,402,2324,29
2021-07-16,Solano,095,438530,34489,34015,636,34651,263
2021-07-16,Sonoma,097,501317,31896,31536,366,31902,322
2021-07-16,Stanislaus,099,539301,57858,57400,6099,63499,1028
2021-07-16,Sutter,101,95872,9850,9778,93,9871,114
2021-07-16,Tehama,103,63373,5205,5145,589,5734,64
2021-07-16,Trinity,105,12862,502,341,103,444,3
2021-07-16,Tulare,107,460477,50738,49937,9172,59109,854
2021-07-16,Tuolumne,109,53932,4167,4131,46,4177,64
2021-07-16,Ventura,111,848112,82921,82125,3249,85374,1041
2021-07-16,Yolo,113,214977,14567,14356,329,14685,213
2021-07-16,Yuba,115,75493,6420,6309,130,6439,52
2021-07-15,Alameda,001,1643700,92544,91346,2049,93395,1255
2021-07-15,Alpine,003,1148,88,89,0,89,0
2021-07-15,Amador,005,37829,3809,3785,33,3818,48
2021-07-15,Butte,007,227075,13025,12824,1911,14735,202
2021-07-15,Calaveras,009,45235,2259,2237,15,2252,57
2021-07-15,Colusa,011,21464,1996,1976,334,2310,16
2021-07-15,Contra Costa,013,1133247,73385,72254,1373,73627,824
2021-07-15,Del Norte,015,27424,1516,1475,14,1489,8
2021-07-15,El Dorado,017,186661,10804,10622,815,11437,114
2021-07-15,Fresno,019,978130,104392,103055,8835,111890,1730
2021-07-15,Glenn,021,27897,2471,2451,572,3023,20
2021-07-15,Humboldt,023,135768,4735,4654,58,4712,52
2021-07-15,Imperial,025,180216,29026,28840,2701,31541,742
2021-07-15,Inyo,027,18085,1423,1416,12,1428,36
2021-07-15,Kern,029,883053,98715,97796,11303,109099,1348
2021-07-15,Kings,031,150075,23482,23163,1105,24268,246
2021-07-15,Lake,033,64148,3889,3760,14,3774,64
2021-07-15,Lassen,035,31185,5320,5302,118,5420,21
2021-07-15,Los Angeles,037,10098052,1232901,1219733,42769,1262502,24582
2021-07-15,Madera,039,155013,17001,16804,961,17765,240
2021-07-15,Marin,041,260295,14515,14297,266,14563,234
2021-07-15,Mariposa,043,17540,449,445,11,456,5
2021-07-15,Mendocino,045,87422,4327,4209,88,4297,49
2021-07-15,Merced,047,269075,31545,31451,1058,32509,471
2021-07-15,Modoc,049,8938,420,412,147,559,5
2021-07-15,Mono,051,14174,1274,1277,17,1294,3
2021-07-15,Monterey,053,433212,43594,43367,1885,45252,515
2021-07-15,Napa,055,140530,10210,10129,40,10169,81
2021-07-15,Nevada,057,99092,5183,5066,195,5261,72
2021-07-15,Orange,059,3164182,260271,257805,11756,269561,5136
2021-07-15,Placer,061,380077,24514,24169,1665,25834,303
2021-07-15,Plumas,063,18699,741,721,14,735,4
2021-07-15,Riverside,065,2383286,299090,294751,14230,308981,4542
2021-07-15,Sacramento,067,1510023,111766,110432,1978,112410,1694
2021-07-15,San Benito,069,59416,6184,6181,113,6294,63
2021-07-15,San Bernardino,071,2135413,298041,296048,9167,305215,5218
2021-07-15,San Diego,073,3302833,288537,285698,16244,301942,3786
2021-07-15,San Francisco,075,870044,38607,37978,1355,39333,560
2021-07-15,San Joaquin,077,732212,75411,74695,3712,78407,1430
2021-07-15,San Luis Obispo,079,281455,21784,21462,773,22235,258
2021-07-15,San Mateo,081,765935,43694,43324,520,43844,542
2021-07-15,Santa Barbara,083,443738,35065,34769,1142,35911,461
2021-07-15,Santa Clara,085,1922200,121279,119980,793,120773,2097
2021-07-15,Santa Cruz,087,273765,16501,16337,806,17143,207
2021-07-15,Shasta,089,179085,12772,12683,1682,14365,210
2021-07-15,Sierra,091,2930,66,62,12,74,0
2021-07-15,Siskiyou,093,43540,2022,1922,402,2324,29
2021-07-15,Solano,095,438530,34414,34015,630,34645,263
2021-07-15,Sonoma,097,501317,31835,31536,366,31902,322
2021-07-15,Stanislaus,099,539301,57788,57400,6086,63486,1028
2021-07-15,Sutter,101,95872,9830,9778,92,9870,114
2021-07-15,Tehama,103,63373,5199,5145,588,5733,64
2021-07-15,Trinity,105,12862,502,341,103,444,3
2021-07-15,Tulare,107,460477,50718,49937,9155,59092,854
2021-07-15,Tuolumne,109,53932,4155,4131,46,4177,64
2021-07-15,Ventura,111,848112,82845,82125,3244,85369,1041
2021-07-15,Yolo,113,214977,14540,14356,328,14684,213
2021-07-15,Yuba,115,75493,6405,6309,129,6438,52
2021-07-14,Alameda,001,1643700,92284,91092,2032,93124,1255
2021-07-14,Alpine,003,1148,88,89,0,89,0
2021-07-14,Amador,005,37829,3801,3784,33,3817,48
2021-07-14,Butte,007,227075,12998,12813,1904,14717,202
2021-07-14,Calaveras,009,45235,2252,2234,15,2249,57
2021-07-14,Colusa,011,21464,1993,1974,334,2308,16
2021-07-14,Contra Costa,013,1133247,73157,72091,1361,73452,823
2021-07-14,Del Norte,015,27424,1515,1472,14,1486,8
2021-07-14,El Dorado,017,186661,10778,10598,812,11410,114
2021-07-14,Fresno,019,978130,104312,102966,8824,111790,1728
2021-07-14,Glenn,021,27897,2471,2449,572,3021,20
2021-07-14,Humboldt,023,135768,4711,4644,56,4700,52
2021-07-14,Imperial,025,180216,28997,28822,2701,31523,742
2021-07-14,Inyo,027,18085,1422,1415,12,1427,36
2021-07-14,Kern,029,883053,98651,97736,11278,109014,1346
2021-07-14,Kings,031,150075,23469,23142,1105,24247,246
2021-07-14,Lake,033,64148,3856,3739,14,3753,63
2021-07-14,Lassen,035,31185,5319,5298,118,5416,21
2021-07-14,Los Angeles,037,10098052,1230885,1218265,42628,1260893,24578
2021-07-14,Madera,039,155013,16989,16786,959,17745,240
2021-07-14,Marin,041,260295,14481,14269,264,14533,233
2021-07-14,Mariposa,043,17540,447,445,11,456,5
2021-07-14,Mendocino,045,87422,4314,4193,88,4281,49
2021-07-14,Merced,047,269075,31508,31412,1055,32467,471
2021-07-14,Modoc,049,8938,420,412,147,559,4
2021-07-14,Mono,051,14174,1274,1278,17,1295,3
2021-07-14,Monterey,053,433212,43570,43347,1883,45230,504
2021-07-14,Napa,055,140530,10188,10121,40,10161,81
2021-07-14,Nevada,057,99092,5163,5058,195,5253,72
2021-07-14,Orange,059,3164182,259954,257558,11726,269284,5137
2021-07-14,Placer,061,380077,24461,24125,1653,25778,303
2021-07-14,Plumas,063,18699,734,719,14,733,4
2021-07-14,Riverside,065,2383286,298766,294511,14214,308725,4542
2021-07-14,Sacramento,067,1510023,111438,110193,1954,112147,1688
2021-07-14,San Benito,069,59416,6181,6177,113,6290,63
2021-07-14,San Bernardino,071,2135413,297741,295820,9152,304972,5193
2021-07-14,San Diego,073,3302833,287965,285269,16164,301433,3786
2021-07-14,San Francisco,075,870044,38468,37836,1350,39186,559
2021-07-14,San Joaquin,077,732212,75319,74599,3703,78302,1416
2021-07-14,San Luis Obispo,079,281455,21762,21444,771,22215,258
2021-07-14,San Mateo,081,765935,43595,43249,516,43765,542
2021-07-14,Santa Barbara,083,443738,35023,34719,1140,35859,461
2021-07-14,Santa Clara,085,1922200,121129,119844,790,120634,2098
2021-07-14,Santa Cruz,087,273765,16489,16326,806,17132,207
2021-07-14,Shasta,089,179085,12752,12669,1679,14348,209
2021-07-14,Sierra,091,2930,66,62,12,74,0
2021-07-14,Siskiyou,093,43540,2015,1922,399,2321,29
2021-07-14,Solano,095,438530,34341,33948,630,34578,268
2021-07-14,Sonoma,097,501317,31783,31470,366,31836,322
2021-07-14,Stanislaus,099,539301,57713,57340,6074,63414,1028
2021-07-14,Sutter,101,95872,9808,9766,92,9858,114
2021-07-14,Tehama,103,63373,5197,5142,588,5730,64
2021-07-14,Trinity,105,12862,502,341,103,444,3
2021-07-14,Tulare,107,460477,50701,49908,9141,59049,853
2021-07-14,Tuolumne,109,53932,4152,4128,45,4173,64
2021-07-14,Ventura,111,848112,82751,82041,3233,85274,1040
2021-07-14,Yolo,113,214977,14507,14332,325,14657,213
2021-07-14,Yuba,115,75493,6387,6294,129,6423,52
2021-07-13,Alameda,001,1643700,92019,90874,2022,92896,1255
2021-07-13,Alpine,003,1148,88,89,0,89,0
2021-07-13,Amador,005,37829,3794,3783,33,3816,48
2021-07-13,Butte,007,227075,12984,12802,1903,14705,202
2021-07-13,Calaveras,009,45235,2248,2230,15,2245,57
2021-07-13,Colusa,011,21464,1991,1972,331,2303,16
2021-07-13,Contra Costa,013,1133247,72932,71963,1352,73315,823
2021-07-13,Del Norte,015,27424,1511,1471,14,1485,8
2021-07-13,El Dorado,017,186661,10761,10581,810,11391,114
2021-07-13,Fresno,019,978130,104237,102909,8814,111723,1727
2021-07-13,Glenn,021,27897,2469,2448,572,3020,20
2021-07-13,Humboldt,023,135768,4696,4634,56,4690,51
2021-07-13,Imperial,025,180216,28986,28792,2701,31493,741
2021-07-13,Inyo,027,18085,1421,1415,12,1427,36
2021-07-13,Kern,029,883053,98562,97698,11239,108937,1346
2021-07-13,Kings,031,150075,23451,23132,1105,24237,246
2021-07-13,Lake,033,64148,3829,3719,13,3732,63
2021-07-13,Lassen,035,31185,5317,5292,118,5410,21
2021-07-13,Los Angeles,037,10098052,1229034,1217184,42458,1259642,24569
2021-07-13,Madera,039,155013,16979,16773,955,17728,240
2021-07-13,Marin,041,260295,14452,14254,263,14517,233
2021-07-13,Mariposa,043,17540,446,443,11,454,5
2021-07-13,Mendocino,045,87422,4307,4185,88,4273,49
2021-07-13,Merced,047,269075,31487,31379,1052,32431,471
2021-07-13,Modoc,049,8938,420,411,147,558,4
2021-07-13,Mono,051,14174,1273,1277,17,1294,3
2021-07-13,Monterey,053,433212,43552,43333,1879,45212,504
2021-07-13,Napa,055,140530,10167,10118,40,10158,81
2021-07-13,Nevada,057,99092,5138,5053,195,5248,72
2021-07-13,Orange,059,3164182,259624,257339,11698,269037,5136
2021-07-13,Placer,061,380077,24415,24091,1640,25731,303
2021-07-13,Plumas,063,18699,733,716,14,730,4
2021-07-13,Riverside,065,2383286,298443,294302,14187,308489,4541
2021-07-13,Sacramento,067,1510023,111128,109990,1931,111921,1687
2021-07-13,San Benito,069,59416,6179,6173,113,6286,63
2021-07-13,San Bernardino,071,2135413,297464,295596,9130,304726,5183
2021-07-13,San Diego,073,3302833,287417,284997,16085,301082,3785
2021-07-13,San Francisco,075,870044,38324,37725,1344,39069,559
2021-07-13,San Joaquin,077,732212,75203,74500,3700,78200,1417
2021-07-13,San Luis Obispo,079,281455,21736,21423,768,22191,258
2021-07-13,San Mateo,081,765935,43526,43180,515,43695,542
2021-07-13,Santa Barbara,083,443738,34974,34679,1137,35816,461
2021-07-13,Santa Clara,085,1922200,120976,119727,786,120513,2098
2021-07-13,Santa Cruz,087,273765,16480,16315,804,17119,207
2021-07-13,Shasta,089,179085,12739,12659,1672,14331,209
2021-07-13,Sierra,091,2930,66,62,12,74,0
2021-07-13,Siskiyou,093,43540,2014,1916,397,2313,29
2021-07-13,Solano,095,438530,34276,33918,624,34542,268
2021-07-13,Sonoma,097,501317,31724,31431,366,31797,322
2021-07-13,Stanislaus,099,539301,57643,57282,6059,63341,1028
2021-07-13,Sutter,101,95872,9790,9752,91,9843,114
2021-07-13,Tehama,103,63373,5190,5144,588,5732,64
2021-07-13,Trinity,105,12862,502,341,102,443,3
2021-07-13,Tulare,107,460477,50676,49891,9125,59016,853
2021-07-13,Tuolumne,109,53932,4144,4122,44,4166,64
2021-07-13,Ventura,111,848112,82666,81982,3208,85190,1040
2021-07-13,Yolo,113,214977,14479,14320,318,14638,213
2021-07-13,Yuba,115,75493,6370,6279,129,6408,52
2021-07-12,Alameda,001,1643700,91760,90720,2015,92735,1254
2021-07-12,Alpine,003,1148,88,89,0,89,0
2021-07-12,Amador,005,37829,3787,3781,33,3814,47
2021-07-12,Butte,007,227075,12964,12796,1901,14697,202
2021-07-12,Calaveras,009,45235,2246,2228,15,2243,57
2021-07-12,Colusa,011,21464,1987,1971,330,2301,16
2021-07-12,Contra Costa,013,1133247,72729,71833,1347,73180,823
2021-07-12,Del Norte,015,27424,1508,1469,14,1483,8
2021-07-12,El Dorado,017,186661,10732,10569,808,11377,114
2021-07-12,Fresno,019,978130,104142,102853,8802,111655,1728
2021-07-12,Glenn,021,27897,2469,2446,572,3018,20
2021-07-12,Humboldt,023,135768,4680,4621,56,4677,51
2021-07-12,Imperial,025,180216,28956,28789,2701,31490,741
2021-07-12,Inyo,027,18085,1421,1415,12,1427,36
2021-07-12,Kern,029,883053,98493,97660,11214,108874,1346
2021-07-12,Kings,031,150075,23431,23124,1103,24227,246
2021-07-12,Lake,033,64148,3808,3706,13,3719,63
2021-07-12,Lassen,035,31185,5316,5292,118,5410,21
2021-07-12,Los Angeles,037,10098052,1227237,1216230,42325,1258555,24559
2021-07-12,Madera,039,155013,16968,16772,955,17727,240
2021-07-12,Marin,041,260295,14427,14238,262,14500,233
2021-07-12,Mariposa,043,17540,446,442,11,453,5
2021-07-12,Mendocino,045,87422,4296,4175,88,4263,49
2021-07-12,Merced,047,269075,31456,31374,1051,32425,471
2021-07-12,Modoc,049,8938,419,411,147,558,4
2021-07-12,Mono,051,14174,1271,1275,17,1292,3
2021-07-12,Monterey,053,433212,43531,43315,1875,45190,504
2021-07-12,Napa,055,140530,10149,10104,39,10143,81
2021-07-12,Nevada,057,99092,5115,5046,195,5241,72
2021-07-12,Orange,059,3164182,259271,257171,11675,268846,5136
2021-07-12,Placer,061,380077,24364,24052,1634,25686,302
2021-07-12,Plumas,063,18699,733,716,14,730,4
2021-07-12,Riverside,065,2383286,298135,294108,14158,308266,4541
2021-07-12,Sacramento,067,1510023,110913,109849,1906,111755,1685
2021-07-12,San Benito,069,59416,6176,6166,113,6279,63
2021-07-12,San Bernardino,071,2135413,297192,295447,9115,304562,5171
2021-07-12,San Diego,073,3302833,286948,284648,16009,300657,3785
2021-07-12,San Francisco,075,870044,38178,37656,1341,38997,559
2021-07-12,San Joaquin,077,732212,75109,74424,3690,78114,1415
2021-07-12,San Luis Obispo,079,281455,21717,21408,767,22175,258
2021-07-12,San Mateo,081,765935,43432,43138,508,43646,542
2021-07-12,Santa Barbara,083,443738,34931,34664,1135,35799,461
2021-07-12,Santa Clara,085,1922200,120811,119634,783,120417,2098
2021-07-12,Santa Cruz,087,273765,16455,16310,803,17113,207
2021-07-12,Shasta,089,179085,12732,12648,1669,14317,208
2021-07-12,Sierra,091,2930,66,62,12,74,0
2021-07-12,Siskiyou,093,43540,2009,1916,392,2308,29
2021-07-12,Solano,095,438530,34186,33859,615,34474,268
2021-07-12,Sonoma,097,501317,31676,31377,365,31742,322
2021-07-12,Stanislaus,099,539301,57574,57243,6052,63295,1028
2021-07-12,Sutter,101,95872,9773,9736,90,9826,114
2021-07-12,Tehama,103,63373,5185,5138,587,5725,63
2021-07-12,Trinity,105,12862,498,340,100,440,3
2021-07-12,Tulare,107,460477,50648,49882,9112,58994,853
2021-07-12,Tuolumne,109,53932,4140,4116,44,4160,64
2021-07-12,Ventura,111,848112,82565,81919,3187,85106,1040
2021-07-12,Yolo,113,214977,14451,14303,314,14617,213
2021-07-12,Yuba,115,75493,6355,6266,129,6395,52
2021-07-11,Alameda,001,1643700,91430,90597,2003,92600,1254
2021-07-11,Alpine,003,1148,88,89,0,89,0
2021-07-11,Amador,005,37829,3785,3779,33,3812,47
2021-07-11,Butte,007,227075,12942,12794,1895,14689,202
2021-07-11,Calaveras,009,45235,2244,2226,14,2240,57
2021-07-11,Colusa,011,21464,1986,1971,329,2300,16
2021-07-11,Contra Costa,013,1133247,72519,71744,1340,73084,823
2021-07-11,Del Norte,015,27424,1504,1467,13,1480,8
2021-07-11,El Dorado,017,186661,10703,10554,806,11360,114
2021-07-11,Fresno,019,978130,104047,102813,8782,111595,1728
2021-07-11,Glenn,021,27897,2468,2446,572,3018,20
2021-07-11,Humboldt,023,135768,4667,4611,55,4666,51
2021-07-11,Imperial,025,180216,28938,28787,2700,31487,741
2021-07-11,Inyo,027,18085,1419,1415,12,1427,36
2021-07-11,Kern,029,883053,98420,97637,11198,108835,1346
2021-07-11,Kings,031,150075,23400,23116,1100,24216,246
2021-07-11,Lake,033,64148,3777,3699,13,3712,63
2021-07-11,Lassen,035,31185,5313,5291,118,5409,21
2021-07-11,Los Angeles,037,10098052,1225480,1215182,42169,1257351,24558
2021-07-11,Madera,039,155013,16949,16766,954,17720,240
2021-07-11,Marin,041,260295,14401,14231,262,14493,233
2021-07-11,Mariposa,043,17540,445,442,11,453,5
2021-07-11,Mendocino,045,87422,4276,4167,88,4255,49
2021-07-11,Merced,047,269075,31432,31366,1046,32412,471
2021-07-11,Modoc,049,8938,418,411,147,558,4
2021-07-11,Mono,051,14174,1271,1275,17,1292,3
2021-07-11,Monterey,053,433212,43512,43307,1871,45178,504
2021-07-11,Napa,055,140530,10145,10100,39,10139,81
2021-07-11,Nevada,057,99092,5104,5035,194,5229,72
2021-07-11,Orange,059,3164182,258958,257009,11647,268656,5136
2021-07-11,Placer,061,380077,24307,24017,1622,25639,302
2021-07-11,Plumas,063,18699,733,716,14,730,4
2021-07-11,Riverside,065,2383286,297871,293969,14140,308109,4541
2021-07-11,Sacramento,067,1510023,110634,109696,1896,111592,1685
2021-07-11,San Benito,069,59416,6171,6163,113,6276,63
2021-07-11,San Bernardino,071,2135413,296886,295342,9090,304432,5167
2021-07-11,San Diego,073,3302833,286534,283819,15923,299742,3784
2021-07-11,San Francisco,075,870044,38049,37596,1335,38931,559
2021-07-11,San Joaquin,077,732212,74992,74376,3673,78049,1415
2021-07-11,San Luis Obispo,079,281455,21684,21403,766,22169,258
2021-07-11,San Mateo,081,765935,43353,43107,502,43609,542
2021-07-11,Santa Barbara,083,443738,34884,34646,1135,35781,461
2021-07-11,Santa Clara,085,1922200,120657,119549,782,120331,2098
2021-07-11,Santa Cruz,087,273765,16439,16303,803,17106,207
2021-07-11,Shasta,089,179085,12715,12647,1667,14314,208
2021-07-11,Sierra,091,2930,66,62,12,74,0
2021-07-11,Siskiyou,093,43540,2005,1915,390,2305,29
2021-07-11,Solano,095,438530,34104,33837,611,34448,268
2021-07-11,Sonoma,097,501317,31594,31352,365,31717,322
2021-07-11,Stanislaus,099,539301,57508,57230,6041,63271,1028
2021-07-11,Sutter,101,95872,9759,9728,90,9818,114
2021-07-11,Tehama,103,63373,5182,5138,587,5725,63
2021-07-11,Trinity,105,12862,497,340,100,440,3
2021-07-11,Tulare,107,460477,50623,49877,9094,58971,853
2021-07-11,Tuolumne,109,53932,4134,4116,44,4160,64
2021-07-11,Ventura,111,848112,82492,81875,3167,85042,1040
2021-07-11,Yolo,113,214977,14426,14285,308,14593,213
2021-07-11,Yuba,115,75493,6344,6260,129,6389,52
2021-07-10,Alameda,001,1643700,91279,90090,1999,92089,1252
2021-07-10,Alpine,003,1148,88,89,0,89,0
2021-07-10,Amador,005,37829,3779,3773,33,3806,47
2021-07-10,Butte,007,227075,12932,12764,1892,14656,202
2021-07-10,Calaveras,009,45235,2243,2214,14,2228,57
2021-07-10,Colusa,011,21464,1984,1969,329,2298,16
2021-07-10,Contra Costa,013,1133247,72419,71376,1339,72715,821
2021-07-10,Del Norte,015,27424,1502,1451,13,1464,8
2021-07-10,El Dorado,017,186661,10686,10508,803,11311,114
2021-07-10,Fresno,019,978130,104014,102675,8775,111450,1730
2021-07-10,Glenn,021,27897,2465,2440,571,3011,20
2021-07-10,Humboldt,023,135768,4658,4574,55,4629,51
2021-07-10,Imperial,025,180216,28925,28729,2700,31429,741
2021-07-10,Inyo,027,18085,1418,1415,12,1427,36
2021-07-10,Kern,029,883053,98380,97538,11181,108719,1346
2021-07-10,Kings,031,150075,23393,23090,1099,24189,246
2021-07-10,Lake,033,64148,3760,3667,13,3680,63
2021-07-10,Lassen,035,31185,5313,5290,118,5408,21
2021-07-10,Los Angeles,037,10098052,1224453,1212043,42067,1254110,24542
2021-07-10,Madera,039,155013,16943,16744,951,17695,241
2021-07-10,Marin,041,260295,14387,14194,262,14456,233
2021-07-10,Mariposa,043,17540,445,442,11,453,5
2021-07-10,Mendocino,045,87422,4269,4153,87,4240,49
2021-07-10,Merced,047,269075,31419,31328,1046,32374,470
2021-07-10,Modoc,049,8938,418,410,147,557,4
2021-07-10,Mono,051,14174,1271,1275,17,1292,3
2021-07-10,Monterey,053,433212,43498,43251,1869,45120,499
2021-07-10,Napa,055,140530,10133,10077,39,10116,81
2021-07-10,Nevada,057,99092,5095,5000,194,5194,72
2021-07-10,Orange,059,3164182,258780,256438,11631,268069,5135
2021-07-10,Placer,061,380077,24278,23916,1612,25528,302
2021-07-10,Plumas,063,18699,732,717,14,731,4
2021-07-10,Riverside,065,2383286,297681,293474,14127,307601,4541
2021-07-10,Sacramento,067,1510023,110485,109091,1891,110982,1682
2021-07-10,San Benito,069,59416,6166,6141,113,6254,63
2021-07-10,San Bernardino,071,2135413,296698,294932,9078,304010,5117
2021-07-10,San Diego,073,3302833,286244,283577,15870,299447,3783
2021-07-10,San Francisco,075,870044,37966,37338,1332,38670,559
2021-07-10,San Joaquin,077,732212,74935,74150,3667,77817,1412
2021-07-10,San Luis Obispo,079,281455,21673,21375,765,22140,258
2021-07-10,San Mateo,081,765935,43301,42948,500,43448,542
2021-07-10,Santa Barbara,083,443738,34857,34595,1135,35730,460
2021-07-10,Santa Clara,085,1922200,120554,119330,779,120109,2094
2021-07-10,Santa Cruz,087,273765,16432,16286,803,17089,207
2021-07-10,Shasta,089,179085,12702,12623,1662,14285,206
2021-07-10,Sierra,091,2930,66,61,12,73,0
2021-07-10,Siskiyou,093,43540,2003,1909,387,2296,29
2021-07-10,Solano,095,438530,34062,33678,605,34283,268
2021-07-10,Sonoma,097,501317,31543,31231,365,31596,317
2021-07-10,Stanislaus,099,539301,57472,57104,6031,63135,1026
2021-07-10,Sutter,101,95872,9747,9692,90,9782,114
2021-07-10,Tehama,103,63373,5179,5131,587,5718,63
2021-07-10,Trinity,105,12862,497,341,100,441,3
2021-07-10,Tulare,107,460477,50613,49850,9088,58938,853
2021-07-10,Tuolumne,109,53932,4132,4114,44,4158,64
2021-07-10,Ventura,111,848112,82447,81713,3149,84862,1039
2021-07-10,Yolo,113,214977,14405,14250,305,14555,213
2021-07-10,Yuba,115,75493,6334,6238,129,6367,52
2021-07-09,Alameda,001,1643700,91120,90090,1994,92084,1252
2021-07-09,Alpine,003,1148,88,89,0,89,0
2021-07-09,Amador,005,37829,3778,3773,33,3806,47
2021-07-09,Butte,007,227075,12920,12764,1890,14654,202
2021-07-09,Calaveras,009,45235,2241,2214,14,2228,57
2021-07-09,Colusa,011,21464,1983,1969,329,2298,16
2021-07-09,Contra Costa,013,1133247,72293,71376,1337,72713,821
2021-07-09,Del Norte,015,27424,1497,1451,13,1464,8
2021-07-09,El Dorado,017,186661,10671,10508,802,11310,114
2021-07-09,Fresno,019,978130,103958,102675,8768,111443,1730
2021-07-09,Glenn,021,27897,2464,2440,569,3009,20
2021-07-09,Humboldt,023,135768,4639,4574,55,4629,51
2021-07-09,Imperial,025,180216,28917,28729,2699,31428,741
2021-07-09,Inyo,027,18085,1417,1415,12,1427,36
2021-07-09,Kern,029,883053,98342,97538,11169,108707,1346
2021-07-09,Kings,031,150075,23382,23090,1098,24188,246
2021-07-09,Lake,033,64148,3746,3667,13,3680,63
2021-07-09,Lassen,035,31185,5311,5290,117,5407,21
2021-07-09,Los Angeles,037,10098052,1223449,1212043,41996,1254039,24542
2021-07-09,Madera,039,155013,16933,16744,950,17694,241
2021-07-09,Marin,041,260295,14366,14194,261,14455,233
2021-07-09,Mariposa,043,17540,445,442,11,453,5
2021-07-09,Mendocino,045,87422,4262,4153,87,4240,49
2021-07-09,Merced,047,269075,31404,31328,1046,32374,470
2021-07-09,Modoc,049,8938,418,410,147,557,4
2021-07-09,Mono,051,14174,1271,1275,17,1292,3
2021-07-09,Monterey,053,433212,43489,43251,1869,45120,499
2021-07-09,Napa,055,140530,10126,10077,39,10116,81
2021-07-09,Nevada,057,99092,5086,5000,194,5194,72
2021-07-09,Orange,059,3164182,258574,256438,11617,268055,5135
2021-07-09,Placer,061,380077,24256,23916,1606,25522,302
2021-07-09,Plumas,063,18699,730,717,14,731,4
2021-07-09,Riverside,065,2383286,297495,293474,14114,307588,4541
2021-07-09,Sacramento,067,1510023,110331,109091,1882,110973,1682
2021-07-09,San Benito,069,59416,6164,6141,113,6254,63
2021-07-09,San Bernardino,071,2135413,296546,294932,9071,304003,5117
2021-07-09,San Diego,073,3302833,285955,283577,15822,299399,3783
2021-07-09,San Francisco,075,870044,37886,37338,1325,38663,559
2021-07-09,San Joaquin,077,732212,74861,74150,3660,77810,1412
2021-07-09,San Luis Obispo,079,281455,21661,21375,765,22140,258
2021-07-09,San Mateo,081,765935,43257,42948,496,43444,542
2021-07-09,Santa Barbara,083,443738,34836,34595,1134,35729,460
2021-07-09,Santa Clara,085,1922200,120443,119330,779,120109,2094
2021-07-09,Santa Cruz,087,273765,16429,16286,803,17089,207
2021-07-09,Shasta,089,179085,12696,12623,1657,14280,206
2021-07-09,Sierra,091,2930,66,61,12,73,0
2021-07-09,Siskiyou,093,43540,2001,1909,386,2295,29
2021-07-09,Solano,095,438530,34026,33678,601,34279,268
2021-07-09,Sonoma,097,501317,31507,31231,365,31596,317
2021-07-09,Stanislaus,099,539301,57443,57104,6029,63133,1026
2021-07-09,Sutter,101,95872,9738,9692,90,9782,114
2021-07-09,Tehama,103,63373,5177,5131,587,5718,63
2021-07-09,Trinity,105,12862,496,341,97,438,3
2021-07-09,Tulare,107,460477,50600,49850,9082,58932,853
2021-07-09,Tuolumne,109,53932,4128,4114,44,4158,64
2021-07-09,Ventura,111,848112,82392,81713,3140,84853,1039
2021-07-09,Yolo,113,214977,14390,14250,301,14551,213
2021-07-09,Yuba,115,75493,6321,6238,129,6367,52
2021-07-08,Alameda,001,1643700,90913,90090,1991,92081,1252
2021-07-08,Alpine,003,1148,88,89,0,89,0
2021-07-08,Amador,005,37829,3776,3773,33,3806,47
2021-07-08,Butte,007,227075,12907,12764,1887,14651,202
2021-07-08,Calaveras,009,45235,2238,2214,13,2227,57
2021-07-08,Colusa,011,21464,1983,1969,329,2298,16
2021-07-08,Contra Costa,013,1133247,72165,71376,1332,72708,821
2021-07-08,Del Norte,015,27424,1495,1451,13,1464,8
2021-07-08,El Dorado,017,186661,10654,10508,795,11303,114
2021-07-08,Fresno,019,978130,103896,102675,8757,111432,1730
2021-07-08,Glenn,021,27897,2464,2440,569,3009,20
2021-07-08,Humboldt,023,135768,4623,4574,54,4628,51
2021-07-08,Imperial,025,180216,28905,28729,2698,31427,741
2021-07-08,Inyo,027,18085,1417,1415,12,1427,36
2021-07-08,Kern,029,883053,98294,97538,11154,108692,1346
2021-07-08,Kings,031,150075,23373,23090,1098,24188,246
2021-07-08,Lake,033,64148,3732,3667,13,3680,63
2021-07-08,Lassen,035,31185,5308,5290,117,5407,21
2021-07-08,Los Angeles,037,10098052,1222236,1212043,41902,1253945,24542
2021-07-08,Madera,039,155013,16917,16744,950,17694,241
2021-07-08,Marin,041,260295,14352,14194,261,14455,233
2021-07-08,Mariposa,043,17540,444,442,11,453,5
2021-07-08,Mendocino,045,87422,4259,4153,87,4240,49
2021-07-08,Merced,047,269075,31390,31328,1044,32372,470
2021-07-08,Modoc,049,8938,418,410,147,557,4
2021-07-08,Mono,051,14174,1271,1275,17,1292,3
2021-07-08,Monterey,053,433212,43469,43251,1863,45114,499
2021-07-08,Napa,055,140530,10122,10077,39,10116,81
2021-07-08,Nevada,057,99092,5080,5000,194,5194,72
2021-07-08,Orange,059,3164182,258379,256438,11595,268033,5135
2021-07-08,Placer,061,380077,24217,23916,1598,25514,302
2021-07-08,Plumas,063,18699,729,717,14,731,4
2021-07-08,Riverside,065,2383286,297294,293474,14098,307572,4541
2021-07-08,Sacramento,067,1510023,110109,109091,1877,110968,1682
2021-07-08,San Benito,069,59416,6161,6141,113,6254,63
2021-07-08,San Bernardino,071,2135413,296371,294932,9062,303994,5117
2021-07-08,San Diego,073,3302833,285628,283577,15774,299351,3783
2021-07-08,San Francisco,075,870044,37806,37338,1321,38659,559
2021-07-08,San Joaquin,077,732212,74773,74150,3647,77797,1412
2021-07-08,San Luis Obispo,079,281455,21649,21375,762,22137,258
2021-07-08,San Mateo,081,765935,43206,42948,495,43443,542
2021-07-08,Santa Barbara,083,443738,34809,34595,1132,35727,460
2021-07-08,Santa Clara,085,1922200,120350,119330,778,120108,2094
2021-07-08,Santa Cruz,087,273765,16423,16286,803,17089,207
2021-07-08,Shasta,089,179085,12690,12623,1653,14276,206
2021-07-08,Sierra,091,2930,66,61,12,73,0
2021-07-08,Siskiyou,093,43540,1996,1909,383,2292,29
2021-07-08,Solano,095,438530,33971,33678,595,34273,268
2021-07-08,Sonoma,097,501317,31476,31231,364,31595,317
2021-07-08,Stanislaus,099,539301,57416,57104,6025,63129,1026
2021-07-08,Sutter,101,95872,9724,9692,88,9780,114
2021-07-08,Tehama,103,63373,5174,5131,586,5717,63
2021-07-08,Trinity,105,12862,496,341,97,438,3
2021-07-08,Tulare,107,460477,50582,49850,9075,58925,853
2021-07-08,Tuolumne,109,53932,4126,4114,44,4158,64
2021-07-08,Ventura,111,848112,82328,81713,3124,84837,1039
2021-07-08,Yolo,113,214977,14370,14250,299,14549,213
2021-07-08,Yuba,115,75493,6313,6238,129,6367,52
2021-07-07,Alameda,001,1643700,90727,89995,1985,91980,1253
2021-07-07,Alpine,003,1148,88,89,0,89,0
2021-07-07,Amador,005,37829,3771,3770,33,3803,47
2021-07-07,Butte,007,227075,12894,12750,1882,14632,202
2021-07-07,Calaveras,009,45235,2231,2212,13,2225,57
2021-07-07,Colusa,011,21464,1979,1969,329,2298,16
2021-07-07,Contra Costa,013,1133247,72018,71308,1330,72638,821
2021-07-07,Del Norte,015,27424,1490,1446,13,1459,8
2021-07-07,El Dorado,017,186661,10634,10494,793,11287,114
2021-07-07,Fresno,019,978130,103846,102639,8750,111389,1729
2021-07-07,Glenn,021,27897,2464,2441,569,3010,20
2021-07-07,Humboldt,023,135768,4609,4566,54,4620,51
2021-07-07,Imperial,025,180216,28898,28701,2698,31399,740
2021-07-07,Inyo,027,18085,1416,1415,12,1427,36
2021-07-07,Kern,029,883053,98250,97507,11139,108646,1348
2021-07-07,Kings,031,150075,23360,23085,1095,24180,245
2021-07-07,Lake,033,64148,3713,3660,13,3673,63
2021-07-07,Lassen,035,31185,5308,5286,117,5403,21
2021-07-07,Los Angeles,037,10098052,1221055,1211316,41798,1253114,24531
2021-07-07,Madera,039,155013,16906,16733,948,17681,241
2021-07-07,Marin,041,260295,14333,14183,260,14443,233
2021-07-07,Mariposa,043,17540,442,442,11,453,5
2021-07-07,Mendocino,045,87422,4250,4145,87,4232,49
2021-07-07,Merced,047,269075,31375,31317,1044,32361,470
2021-07-07,Modoc,049,8938,418,410,147,557,4
2021-07-07,Mono,051,14174,1270,1274,17,1291,3
2021-07-07,Monterey,053,433212,43445,43233,1861,45094,494
2021-07-07,Napa,055,140530,10111,10078,39,10117,81
2021-07-07,Nevada,057,99092,5073,4996,194,5190,72
2021-07-07,Orange,059,3164182,258153,256301,11574,267875,5132
2021-07-07,Placer,061,380077,24181,23901,1588,25489,302
2021-07-07,Plumas,063,18699,729,710,14,724,4
2021-07-07,Riverside,065,2383286,297080,293331,14088,307419,4538
2021-07-07,Sacramento,067,1510023,109919,108954,1869,110823,1682
2021-07-07,San Benito,069,59416,6156,6137,113,6250,63
2021-07-07,San Bernardino,071,2135413,296202,294787,9055,303842,5087
2021-07-07,San Diego,073,3302833,285308,283377,15734,299111,3782
2021-07-07,San Francisco,075,870044,37714,37284,1318,38602,558
2021-07-07,San Joaquin,077,732212,74697,74095,3632,77727,1410
2021-07-07,San Luis Obispo,079,281455,21640,21360,760,22120,258
2021-07-07,San Mateo,081,765935,43152,42908,492,43400,542
2021-07-07,Santa Barbara,083,443738,34783,34582,1132,35714,460
2021-07-07,Santa Clara,085,1922200,120252,119250,777,120027,2094
2021-07-07,Santa Cruz,087,273765,16414,16279,802,17081,207
2021-07-07,Shasta,089,179085,12682,12613,1650,14263,206
2021-07-07,Sierra,091,2930,66,60,12,72,0
2021-07-07,Siskiyou,093,43540,1990,1908,379,2287,29
2021-07-07,Solano,095,438530,33922,33659,588,34247,268
2021-07-07,Sonoma,097,501317,31430,31172,364,31536,316
2021-07-07,Stanislaus,099,539301,57384,57102,6020,63122,1028
2021-07-07,Sutter,101,95872,9714,9683,88,9771,114
2021-07-07,Tehama,103,63373,5173,5129,586,5715,63
2021-07-07,Trinity,105,12862,496,341,97,438,3
2021-07-07,Tulare,107,460477,50578,49835,9066,58901,853
2021-07-07,Tuolumne,109,53932,4122,4115,43,4158,64
2021-07-07,Ventura,111,848112,82284,81608,3110,84718,1036
2021-07-07,Yolo,113,214977,14359,14236,296,14532,213
2021-07-07,Yuba,115,75493,6297,6233,129,6362,51
2021-07-06,Alameda,001,1643700,90531,89918,1977,91895,1253
2021-07-06,Alpine,003,1148,88,89,0,89,0
2021-07-06,Amador,005,37829,3770,3768,32,3800,47
2021-07-06,Butte,007,227075,12881,12744,1879,14623,201
2021-07-06,Calaveras,009,45235,2231,2211,13,2224,55
2021-07-06,Colusa,011,21464,1978,1967,326,2293,16
2021-07-06,Contra Costa,013,1133247,71889,71262,1327,72589,820
2021-07-06,Del Norte,015,27424,1486,1445,13,1458,8
2021-07-06,El Dorado,017,186661,10616,10484,791,11275,113
2021-07-06,Fresno,019,978130,103794,102616,8738,111354,1727
2021-07-06,Glenn,021,27897,2463,2438,569,3007,20
2021-07-06,Humboldt,023,135768,4595,4565,53,4618,49
2021-07-06,Imperial,025,180216,28883,28693,2696,31389,739
2021-07-06,Inyo,027,18085,1416,1412,12,1424,36
2021-07-06,Kern,029,883053,98208,97491,11128,108619,1346
2021-07-06,Kings,031,150075,23352,23077,1094,24171,245
2021-07-06,Lake,033,64148,3703,3659,13,3672,63
2021-07-06,Lassen,035,31185,5307,5288,116,5404,21
2021-07-06,Los Angeles,037,10098052,1219838,1210965,41700,1252665,24525
2021-07-06,Madera,039,155013,16894,16730,948,17678,241
2021-07-06,Marin,041,260295,14319,14181,260,14441,233
2021-07-06,Mariposa,043,17540,442,442,11,453,5
2021-07-06,Mendocino,045,87422,4243,4143,87,4230,49
2021-07-06,Merced,047,269075,31358,31317,1043,32360,470
2021-07-06,Modoc,049,8938,418,411,147,558,4
2021-07-06,Mono,051,14174,1269,1274,17,1291,3
2021-07-06,Monterey,053,433212,43423,43224,1859,45083,494
2021-07-06,Napa,055,140530,10100,10081,39,10120,81
2021-07-06,Nevada,057,99092,5064,4988,194,5182,72
2021-07-06,Orange,059,3164182,257909,256227,11557,267784,5129
2021-07-06,Placer,061,380077,24140,23876,1582,25458,302
2021-07-06,Plumas,063,18699,728,708,14,722,4
2021-07-06,Riverside,065,2383286,296878,293227,14070,307297,4539
2021-07-06,Sacramento,067,1510023,109708,108850,1861,110711,1679
2021-07-06,San Benito,069,59416,6152,6137,113,6250,63
2021-07-06,San Bernardino,071,2135413,296023,294712,9042,303754,5056
2021-07-06,San Diego,073,3302833,284950,283278,15675,298953,3782
2021-07-06,San Francisco,075,870044,37599,37251,1317,38568,558
2021-07-06,San Joaquin,077,732212,74627,74019,3620,77639,1410
2021-07-06,San Luis Obispo,079,281455,21623,21354,758,22112,257
2021-07-06,San Mateo,081,765935,43077,42895,492,43387,541
2021-07-06,Santa Barbara,083,443738,34764,34572,1131,35703,460
2021-07-06,Santa Clara,085,1922200,120134,119194,774,119968,2095
2021-07-06,Santa Cruz,087,273765,16409,16274,801,17075,207
2021-07-06,Shasta,089,179085,12672,12606,1648,14254,205
2021-07-06,Sierra,091,2930,65,60,12,72,0
2021-07-06,Siskiyou,093,43540,1987,1905,375,2280,29
2021-07-06,Solano,095,438530,33871,33619,585,34204,268
2021-07-06,Sonoma,097,501317,31367,31130,363,31493,316
2021-07-06,Stanislaus,099,539301,57336,57120,6009,63129,1029
2021-07-06,Sutter,101,95872,9705,9674,87,9761,114
2021-07-06,Tehama,103,63373,5170,5126,585,5711,63
2021-07-06,Trinity,105,12862,496,341,97,438,3
2021-07-06,Tulare,107,460477,50563,49826,9056,58882,853
2021-07-06,Tuolumne,109,53932,4120,4113,43,4156,64
2021-07-06,Ventura,111,848112,82244,81534,3085,84619,1033
2021-07-06,Yolo,113,214977,14337,14227,293,14520,213
2021-07-06,Yuba,115,75493,6286,6231,129,6360,51
2021-07-05,Alameda,001,1643700,90353,89892,1972,91864,1253
2021-07-05,Alpine,003,1148,88,89,0,89,0
2021-07-05,Amador,005,37829,3768,3768,32,3800,47
2021-07-05,Butte,007,227075,12873,12740,1870,14610,201
2021-07-05,Calaveras,009,45235,2229,2211,13,2224,55
2021-07-05,Colusa,011,21464,1976,1966,325,2291,16
2021-07-05,Contra Costa,013,1133247,71761,71235,1327,72562,820
2021-07-05,Del Norte,015,27424,1482,1446,13,1459,8
2021-07-05,El Dorado,017,186661,10591,10481,791,11272,113
2021-07-05,Fresno,019,978130,103735,102592,8723,111315,1727
2021-07-05,Glenn,021,27897,2460,2438,568,3006,20
2021-07-05,Humboldt,023,135768,4581,4563,53,4616,49
2021-07-05,Imperial,025,180216,28864,28689,2696,31385,739
2021-07-05,Inyo,027,18085,1416,1412,12,1424,36
2021-07-05,Kern,029,883053,98160,97479,11107,108586,1346
2021-07-05,Kings,031,150075,23344,23065,1091,24156,245
2021-07-05,Lake,033,64148,3685,3645,13,3658,63
2021-07-05,Lassen,035,31185,5304,5288,115,5403,21
2021-07-05,Los Angeles,037,10098052,1218642,1210653,41598,1252251,24522
2021-07-05,Madera,039,155013,16883,16722,947,17669,241
2021-07-05,Marin,041,260295,14298,14178,260,14438,233
2021-07-05,Mariposa,043,17540,442,441,11,452,5
2021-07-05,Mendocino,045,87422,4238,4139,87,4226,49
2021-07-05,Merced,047,269075,31338,31312,1043,32355,470
2021-07-05,Modoc,049,8938,418,410,147,557,4
2021-07-05,Mono,051,14174,1269,1273,17,1290,3
2021-07-05,Monterey,053,433212,43403,43218,1854,45072,494
2021-07-05,Napa,055,140530,10094,10074,39,10113,81
2021-07-05,Nevada,057,99092,5046,4980,193,5173,72
2021-07-05,Orange,059,3164182,257708,256173,11539,267712,5129
2021-07-05,Placer,061,380077,24093,23867,1574,25441,302
2021-07-05,Plumas,063,18699,727,708,14,722,4
2021-07-05,Riverside,065,2383286,296687,293193,14058,307251,4539
2021-07-05,Sacramento,067,1510023,109526,108758,1852,110610,1679
2021-07-05,San Benito,069,59416,6145,6137,113,6250,63
2021-07-05,San Bernardino,071,2135413,295861,294647,9035,303682,5037
2021-07-05,San Diego,073,3302833,284587,282834,15631,298465,3782
2021-07-05,San Francisco,075,870044,37512,37237,1312,38549,558
2021-07-05,San Joaquin,077,732212,74557,73999,3615,77614,1410
2021-07-05,San Luis Obispo,079,281455,21610,21351,757,22108,257
2021-07-05,San Mateo,081,765935,43025,42876,489,43365,541
2021-07-05,Santa Barbara,083,443738,34744,34569,1131,35700,460
2021-07-05,Santa Clara,085,1922200,120028,119184,772,119956,2095
2021-07-05,Santa Cruz,087,273765,16400,16273,800,17073,208
2021-07-05,Shasta,089,179085,12663,12603,1646,14249,205
2021-07-05,Sierra,091,2930,65,60,12,72,0
2021-07-05,Siskiyou,093,43540,1985,1904,374,2278,29
2021-07-05,Solano,095,438530,33801,33612,579,34191,268
2021-07-05,Sonoma,097,501317,31314,31116,363,31479,316
2021-07-05,Stanislaus,099,539301,57306,57109,5998,63107,1029
2021-07-05,Sutter,101,95872,9693,9667,87,9754,114
2021-07-05,Tehama,103,63373,5169,5125,585,5710,63
2021-07-05,Trinity,105,12862,495,341,96,437,3
2021-07-05,Tulare,107,460477,50545,49818,9053,58871,853
2021-07-05,Tuolumne,109,53932,4116,4112,43,4155,64
2021-07-05,Ventura,111,848112,82193,81519,3066,84585,1033
2021-07-05,Yolo,113,214977,14317,14225,285,14510,213
2021-07-05,Yuba,115,75493,6278,6223,129,6352,51
2021-07-04,Alameda,001,1643700,90189,89683,1969,91652,1253
2021-07-04,Alpine,003,1148,88,89,0,89,0
2021-07-04,Amador,005,37829,3767,3758,32,3790,46
2021-07-04,Butte,007,227075,12863,12684,1870,14554,201
2021-07-04,Calaveras,009,45235,2225,2200,13,2213,55
2021-07-04,Colusa,011,21464,1976,1969,325,2294,15
2021-07-04,Contra Costa,013,1133247,71655,70941,1322,72263,818
2021-07-04,Del Norte,015,27424,1479,1439,13,1452,8
2021-07-04,El Dorado,017,186661,10582,10433,790,11223,113
2021-07-04,Fresno,019,978130,103689,102512,8708,111220,1727
2021-07-04,Glenn,021,27897,2458,2442,567,3009,20
2021-07-04,Humboldt,023,135768,4573,4530,53,4583,49
2021-07-04,Imperial,025,180216,28858,28661,2696,31357,739
2021-07-04,Inyo,027,18085,1416,1412,12,1424,35
2021-07-04,Kern,029,883053,98141,97421,11098,108519,1347
2021-07-04,Kings,031,150075,23336,23051,1091,24142,245
2021-07-04,Lake,033,64148,3675,3623,13,3636,62
2021-07-04,Lassen,035,31185,5303,5277,115,5392,20
2021-07-04,Los Angeles,037,10098052,1217781,1208705,41513,1250218,24506
2021-07-04,Madera,039,155013,16871,16696,946,17642,240
2021-07-04,Marin,041,260295,14283,14143,260,14403,233
2021-07-04,Mariposa,043,17540,442,441,11,452,5
2021-07-04,Mendocino,045,87422,4228,4122,87,4209,49
2021-07-04,Merced,047,269075,31327,31297,1043,32340,469
2021-07-04,Modoc,049,8938,418,410,147,557,4
2021-07-04,Mono,051,14174,1269,1275,17,1292,3
2021-07-04,Monterey,053,433212,43387,43212,1853,45065,492
2021-07-04,Napa,055,140530,10086,10045,38,10083,81
2021-07-04,Nevada,057,99092,5036,4966,193,5159,72
2021-07-04,Orange,059,3164182,257533,255823,11519,267342,5126
2021-07-04,Placer,061,380077,24056,23764,1568,25332,299
2021-07-04,Plumas,063,18699,727,707,14,721,4
2021-07-04,Riverside,065,2383286,296527,293260,14052,307312,4536
2021-07-04,Sacramento,067,1510023,109356,108257,1846,110103,1676
2021-07-04,San Benito,069,59416,6138,6108,113,6221,63
2021-07-04,San Bernardino,071,2135413,295693,294294,9028,303322,5003
2021-07-04,San Diego,073,3302833,284362,282692,15594,298286,3780
2021-07-04,San Francisco,075,870044,37453,37107,1306,38413,558
2021-07-04,San Joaquin,077,732212,74491,73841,3607,77448,1409
2021-07-04,San Luis Obispo,079,281455,21604,21330,756,22086,256
2021-07-04,San Mateo,081,765935,42991,42691,489,43180,541
2021-07-04,Santa Barbara,083,443738,34721,34526,1130,35656,456
2021-07-04,Santa Clara,085,1922200,119938,118966,771,119737,2090
2021-07-04,Santa Cruz,087,273765,16389,16254,800,17054,208
2021-07-04,Shasta,089,179085,12659,12582,1645,14227,204
2021-07-04,Sierra,091,2930,64,60,12,72,0
2021-07-04,Siskiyou,093,43540,1981,1899,373,2272,29
2021-07-04,Solano,095,438530,33760,33486,577,34063,268
2021-07-04,Sonoma,097,501317,31284,31000,363,31363,316
2021-07-04,Stanislaus,099,539301,57291,57018,5992,63010,1018
2021-07-04,Sutter,101,95872,9682,9644,87,9731,114
2021-07-04,Tehama,103,63373,5165,5124,585,5709,63
2021-07-04,Trinity,105,12862,494,341,96,437,3
2021-07-04,Tulare,107,460477,50535,49789,9050,58839,853
2021-07-04,Tuolumne,109,53932,4108,4113,43,4156,64
2021-07-04,Ventura,111,848112,82135,81425,3055,84480,1033
2021-07-04,Yolo,113,214977,14296,14188,282,14470,213
2021-07-04,Yuba,115,75493,6270,6197,129,6326,51
2021-07-03,Alameda,001,1643700,90102,89683,1961,91644,1253
2021-07-03,Alpine,003,1148,88,89,0,89,0
2021-07-03,Amador,005,37829,3767,3758,32,3790,46
2021-07-03,Butte,007,227075,12859,12684,1869,14553,201
2021-07-03,Calaveras,009,45235,2223,2200,13,2213,55
2021-07-03,Colusa,011,21464,1975,1969,325,2294,15
2021-07-03,Contra Costa,013,1133247,71595,70941,1319,72260,818
2021-07-03,Del Norte,015,27424,1476,1439,13,1452,8
2021-07-03,El Dorado,017,186661,10576,10433,788,11221,113
2021-07-03,Fresno,019,978130,103665,102512,8699,111211,1727
2021-07-03,Glenn,021,27897,2458,2442,567,3009,20
2021-07-03,Humboldt,023,135768,4568,4530,53,4583,49
2021-07-03,Imperial,025,180216,28848,28661,2696,31357,739
2021-07-03,Inyo,027,18085,1416,1412,12,1424,35
2021-07-03,Kern,029,883053,98121,97421,11090,108511,1347
2021-07-03,Kings,031,150075,23336,23051,1090,24141,245
2021-07-03,Lake,033,64148,3665,3623,13,3636,62
2021-07-03,Lassen,035,31185,5302,5277,115,5392,20
2021-07-03,Los Angeles,037,10098052,1217352,1208705,41482,1250187,24506
2021-07-03,Madera,039,155013,16862,16696,943,17639,240
2021-07-03,Marin,041,260295,14279,14143,260,14403,233
2021-07-03,Mariposa,043,17540,442,441,11,452,5
2021-07-03,Mendocino,045,87422,4227,4122,87,4209,49
2021-07-03,Merced,047,269075,31314,31297,1042,32339,469
2021-07-03,Modoc,049,8938,417,410,147,557,4
2021-07-03,Mono,051,14174,1268,1275,17,1292,3
2021-07-03,Monterey,053,433212,43375,43212,1851,45063,492
2021-07-03,Napa,055,140530,10081,10045,38,10083,81
2021-07-03,Nevada,057,99092,5022,4966,193,5159,72
2021-07-03,Orange,059,3164182,257449,255823,11512,267335,5126
2021-07-03,Placer,061,380077,24037,23764,1565,25329,299
2021-07-03,Plumas,063,18699,727,707,14,721,4
2021-07-03,Riverside,065,2383286,296435,293260,14048,307308,4536
2021-07-03,Sacramento,067,1510023,109282,108257,1843,110100,1676
2021-07-03,San Benito,069,59416,6131,6108,113,6221,63
2021-07-03,San Bernardino,071,2135413,295603,294294,9025,303319,5003
2021-07-03,San Diego,073,3302833,284231,282692,15575,298267,3780
2021-07-03,San Francisco,075,870044,37412,37107,1303,38410,558
2021-07-03,San Joaquin,077,732212,74455,73841,3602,77443,1409
2021-07-03,San Luis Obispo,079,281455,21592,21330,756,22086,256
2021-07-03,San Mateo,081,765935,42966,42691,488,43179,541
2021-07-03,Santa Barbara,083,443738,34712,34526,1129,35655,456
2021-07-03,Santa Clara,085,1922200,119891,118966,771,119737,2090
2021-07-03,Santa Cruz,087,273765,16382,16254,800,17054,208
2021-07-03,Shasta,089,179085,12655,12582,1643,14225,204
2021-07-03,Sierra,091,2930,64,60,12,72,0
2021-07-03,Siskiyou,093,43540,1980,1899,372,2271,29
2021-07-03,Solano,095,438530,33716,33486,577,34063,268
2021-07-03,Sonoma,097,501317,31250,31000,363,31363,316
2021-07-03,Stanislaus,099,539301,57280,57018,5985,63003,1018
2021-07-03,Sutter,101,95872,9672,9644,87,9731,114
2021-07-03,Tehama,103,63373,5163,5124,585,5709,63
2021-07-03,Trinity,105,12862,494,341,96,437,3
2021-07-03,Tulare,107,460477,50529,49789,9044,58833,853
2021-07-03,Tuolumne,109,53932,4107,4113,43,4156,64
2021-07-03,Ventura,111,848112,82105,81425,3047,84472,1033
2021-07-03,Yolo,113,214977,14286,14188,279,14467,213
2021-07-03,Yuba,115,75493,6264,6197,129,6326,51
2021-07-02,Alameda,001,1643700,90018,89683,1960,91643,1253
2021-07-02,Alpine,003,1148,88,89,0,89,0
2021-07-02,Amador,005,37829,3765,3758,32,3790,46
2021-07-02,Butte,007,227075,12852,12684,1869,14553,201
2021-07-02,Calaveras,009,45235,2221,2200,13,2213,55
2021-07-02,Colusa,011,21464,1974,1969,324,2293,15
2021-07-02,Contra Costa,013,1133247,71525,70941,1315,72256,818
2021-07-02,Del Norte,015,27424,1476,1439,13,1452,8
2021-07-02,El Dorado,017,186661,10568,10433,788,11221,113
2021-07-02,Fresno,019,978130,103637,102512,8693,111205,1727
2021-07-02,Glenn,021,27897,2457,2442,566,3008,20
2021-07-02,Humboldt,023,135768,4565,4530,52,4582,49
2021-07-02,Imperial,025,180216,28842,28661,2695,31356,739
2021-07-02,Inyo,027,18085,1416,1412,12,1424,35
2021-07-02,Kern,029,883053,98103,97421,11082,108503,1347
2021-07-02,Kings,031,150075,23326,23051,1090,24141,245
2021-07-02,Lake,033,64148,3659,3623,13,3636,62
2021-07-02,Lassen,035,31185,5302,5277,115,5392,20
2021-07-02,Los Angeles,037,10098052,1216878,1208705,41444,1250149,24506
2021-07-02,Madera,039,155013,16853,16696,942,17638,240
2021-07-02,Marin,041,260295,14275,14143,260,14403,233
2021-07-02,Mariposa,043,17540,442,441,11,452,5
2021-07-02,Mendocino,045,87422,4223,4122,86,4208,49
2021-07-02,Merced,047,269075,31305,31297,1042,32339,469
2021-07-02,Modoc,049,8938,417,410,147,557,4
2021-07-02,Mono,051,14174,1267,1275,17,1292,3
2021-07-02,Monterey,053,433212,43367,43212,1850,45062,492
2021-07-02,Napa,055,140530,10076,10045,38,10083,81
2021-07-02,Nevada,057,99092,5013,4966,193,5159,72
2021-07-02,Orange,059,3164182,257338,255823,11505,267328,5126
2021-07-02,Placer,061,380077,24020,23764,1558,25322,299
2021-07-02,Plumas,063,18699,727,707,14,721,4
2021-07-02,Riverside,065,2383286,296337,293260,14043,307303,4536
2021-07-02,Sacramento,067,1510023,109204,108257,1842,110099,1676
2021-07-02,San Benito,069,59416,6128,6108,113,6221,63
2021-07-02,San Bernardino,071,2135413,295516,294294,9023,303317,5003
2021-07-02,San Diego,073,3302833,284086,282692,15549,298241,3780
2021-07-02,San Francisco,075,870044,37364,37107,1301,38408,558
2021-07-02,San Joaquin,077,732212,74423,73841,3596,77437,1409
2021-07-02,San Luis Obispo,079,281455,21586,21330,755,22085,256
2021-07-02,San Mateo,081,765935,42930,42691,488,43179,541
2021-07-02,Santa Barbara,083,443738,34702,34526,1129,35655,456
2021-07-02,Santa Clara,085,1922200,119813,118966,771,119737,2090
2021-07-02,Santa Cruz,087,273765,16378,16254,800,17054,208
2021-07-02,Shasta,089,179085,12651,12582,1643,14225,204
2021-07-02,Sierra,091,2930,63,60,12,72,0
2021-07-02,Siskiyou,093,43540,1977,1899,371,2270,29
2021-07-02,Solano,095,438530,33691,33486,577,34063,268
2021-07-02,Sonoma,097,501317,31227,31000,363,31363,316
2021-07-02,Stanislaus,099,539301,57263,57018,5984,63002,1018
2021-07-02,Sutter,101,95872,9668,9644,87,9731,114
2021-07-02,Tehama,103,63373,5161,5124,583,5707,63
2021-07-02,Trinity,105,12862,494,341,96,437,3
2021-07-02,Tulare,107,460477,50519,49789,9036,58825,853
2021-07-02,Tuolumne,109,53932,4104,4113,43,4156,64
2021-07-02,Ventura,111,848112,82062,81425,3039,84464,1033
2021-07-02,Yolo,113,214977,14270,14188,277,14465,213
2021-07-02,Yuba,115,75493,6256,6197,129,6326,51
2021-07-01,Alameda,001,1643700,89918,89683,1958,91641,1253
2021-07-01,Alpine,003,1148,88,89,0,89,0
2021-07-01,Amador,005,37829,3764,3758,32,3790,46
2021-07-01,Butte,007,227075,12840,12684,1867,14551,201
2021-07-01,Calaveras,009,45235,2219,2200,13,2213,55
2021-07-01,Colusa,011,21464,1974,1969,322,2291,15
2021-07-01,Contra Costa,013,1133247,71453,70941,1315,72256,818
2021-07-01,Del Norte,015,27424,1475,1439,13,1452,8
2021-07-01,El Dorado,017,186661,10556,10433,788,11221,113
2021-07-01,Fresno,019,978130,103598,102512,8688,111200,1727
2021-07-01,Glenn,021,27897,2457,2442,566,3008,20
2021-07-01,Humboldt,023,135768,4563,4530,52,4582,49
2021-07-01,Imperial,025,180216,28825,28661,2695,31356,739
2021-07-01,Inyo,027,18085,1416,1412,12,1424,35
2021-07-01,Kern,029,883053,98077,97421,11072,108493,1347
2021-07-01,Kings,031,150075,23312,23051,1090,24141,245
2021-07-01,Lake,033,64148,3656,3623,13,3636,62
2021-07-01,Lassen,035,31185,5300,5277,115,5392,20
2021-07-01,Los Angeles,037,10098052,1216274,1208705,41389,1250094,24506
2021-07-01,Madera,039,155013,16844,16696,941,17637,240
2021-07-01,Marin,041,260295,14271,14143,260,14403,233
2021-07-01,Mariposa,043,17540,442,441,11,452,5
2021-07-01,Mendocino,045,87422,4219,4122,85,4207,49
2021-07-01,Merced,047,269075,31299,31297,1042,32339,469
2021-07-01,Modoc,049,8938,417,410,147,557,4
2021-07-01,Mono,051,14174,1266,1275,17,1292,3
2021-07-01,Monterey,053,433212,43359,43212,1847,45059,492
2021-07-01,Napa,055,140530,10069,10045,38,10083,81
2021-07-01,Nevada,057,99092,5008,4966,193,5159,72
2021-07-01,Orange,059,3164182,257217,255823,11486,267309,5126
2021-07-01,Placer,061,380077,24001,23764,1555,25319,299
2021-07-01,Plumas,063,18699,724,707,12,719,4
2021-07-01,Riverside,065,2383286,296228,293260,14035,307295,4536
2021-07-01,Sacramento,067,1510023,109078,108257,1835,110092,1676
2021-07-01,San Benito,069,59416,6124,6108,113,6221,63
2021-07-01,San Bernardino,071,2135413,295395,294294,9018,303312,5003
2021-07-01,San Diego,073,3302833,283908,282692,15512,298204,3780
2021-07-01,San Francisco,075,870044,37328,37107,1299,38406,558
2021-07-01,San Joaquin,077,732212,74372,73841,3592,77433,1409
2021-07-01,San Luis Obispo,079,281455,21571,21330,754,22084,256
2021-07-01,San Mateo,081,765935,42902,42691,487,43178,541
2021-07-01,Santa Barbara,083,443738,34689,34526,1129,35655,456
2021-07-01,Santa Clara,085,1922200,119764,118966,771,119737,2090
2021-07-01,Santa Cruz,087,273765,16373,16254,800,17054,208
2021-07-01,Shasta,089,179085,12643,12582,1642,14224,204
2021-07-01,Sierra,091,2930,63,60,12,72,0
2021-07-01,Siskiyou,093,43540,1977,1899,371,2270,29
2021-07-01,Solano,095,438530,33650,33486,576,34062,268
2021-07-01,Sonoma,097,501317,31183,31000,363,31363,316
2021-07-01,Stanislaus,099,539301,57245,57018,5980,62998,1018
2021-07-01,Sutter,101,95872,9659,9644,87,9731,114
2021-07-01,Tehama,103,63373,5161,5124,582,5706,63
2021-07-01,Trinity,105,12862,494,341,96,437,3
2021-07-01,Tulare,107,460477,50510,49789,9029,58818,853
2021-07-01,Tuolumne,109,53932,4097,4113,43,4156,64
2021-07-01,Ventura,111,848112,82031,81425,3029,84454,1033
2021-07-01,Yolo,113,214977,14254,14188,275,14463,213
2021-07-01,Yuba,115,75493,6249,6197,129,6326,51
2021-06-30,Alameda,001,1643700,89839,89597,1954,91551,1256
2021-06-30,Alpine,003,1148,88,89,0,89,0
2021-06-30,Amador,005,37829,3762,3756,32,3788,46
2021-06-30,Butte,007,227075,12833,12676,1858,14534,201
2021-06-30,Calaveras,009,45235,2213,2198,13,2211,55
2021-06-30,Colusa,011,21464,1972,1967,319,2286,15
2021-06-30,Contra Costa,013,1133247,71388,70869,1312,72181,818
2021-06-30,Del Norte,015,27424,1470,1435,13,1448,8
2021-06-30,El Dorado,017,186661,10536,10420,788,11208,113
2021-06-30,Fresno,019,978130,103561,102490,8685,111175,1727
2021-06-30,Glenn,021,27897,2455,2440,566,3006,20
2021-06-30,Humboldt,023,135768,4547,4522,50,4572,49
2021-06-30,Imperial,025,180216,28817,28651,2695,31346,739
2021-06-30,Inyo,027,18085,1416,1409,12,1421,35
2021-06-30,Kern,029,883053,98036,97267,11060,108327,1348
2021-06-30,Kings,031,150075,23307,23038,1089,24127,245
2021-06-30,Lake,033,64148,3643,3601,13,3614,56
2021-06-30,Lassen,035,31185,5295,5269,115,5384,20
2021-06-30,Los Angeles,037,10098052,1215600,1208246,41344,1249590,24499
2021-06-30,Madera,039,155013,16836,16688,939,17627,240
2021-06-30,Marin,041,260295,14262,14133,259,14392,232
2021-06-30,Mariposa,043,17540,441,441,11,452,5
2021-06-30,Mendocino,045,87422,4209,4115,85,4200,49
2021-06-30,Merced,047,269075,31289,31286,1042,32328,469
2021-06-30,Modoc,049,8938,417,410,147,557,4
2021-06-30,Mono,051,14174,1266,1275,17,1292,3
2021-06-30,Monterey,053,433212,43354,43209,1845,45054,492
2021-06-30,Napa,055,140530,10061,10039,38,10077,81
2021-06-30,Nevada,057,99092,4997,4958,193,5151,72
2021-06-30,Orange,059,3164182,257090,255764,11476,267240,5125
2021-06-30,Placer,061,380077,23977,23721,1552,25273,299
2021-06-30,Plumas,063,18699,724,705,12,717,4
2021-06-30,Riverside,065,2383286,296114,293280,14027,307307,4535
2021-06-30,Sacramento,067,1510023,108939,108137,1831,109968,1676
2021-06-30,San Benito,069,59416,6120,6105,113,6218,63
2021-06-30,San Bernardino,071,2135413,295235,294211,9013,303224,4975
2021-06-30,San Diego,073,3302833,283772,282583,15484,298067,3780
2021-06-30,San Francisco,075,870044,37279,37065,1294,38359,558
2021-06-30,San Joaquin,077,732212,74310,73777,3591,77368,1409
2021-06-30,San Luis Obispo,079,281455,21558,21326,753,22079,256
2021-06-30,San Mateo,081,765935,42865,42599,486,43085,537
2021-06-30,Santa Barbara,083,443738,34673,34521,1129,35650,456
2021-06-30,Santa Clara,085,1922200,119717,118930,768,119698,2090
2021-06-30,Santa Cruz,087,273765,16367,16250,800,17050,208
2021-06-30,Shasta,089,179085,12637,12564,1642,14206,204
2021-06-30,Sierra,091,2930,63,60,12,72,0
2021-06-30,Siskiyou,093,43540,1975,1900,368,2268,29
2021-06-30,Solano,095,438530,33611,33453,574,34027,268
2021-06-30,Sonoma,097,501317,31153,30947,363,31310,316
2021-06-30,Stanislaus,099,539301,57228,56997,5979,62976,1018
2021-06-30,Sutter,101,95872,9649,9638,87,9725,114
2021-06-30,Tehama,103,63373,5159,5124,582,5706,63
2021-06-30,Trinity,105,12862,494,341,96,437,3
2021-06-30,Tulare,107,460477,50499,49764,9018,58782,853
2021-06-30,Tuolumne,109,53932,4094,4112,43,4155,64
2021-06-30,Ventura,111,848112,81988,81392,3024,84416,1032
2021-06-30,Yolo,113,214977,14248,14178,272,14450,213
2021-06-30,Yuba,115,75493,6242,6191,129,6320,51
2021-06-29,Alameda,001,1643700,89733,89519,1952,91471,1257
2021-06-29,Alpine,003,1148,88,89,0,89,0
2021-06-29,Amador,005,37829,3758,3754,32,3786,46
2021-06-29,Butte,007,227075,12825,12669,1858,14527,201
2021-06-29,Calaveras,009,45235,2207,2198,13,2211,55
2021-06-29,Colusa,011,21464,1970,1967,319,2286,15
2021-06-29,Contra Costa,013,1133247,71314,70775,1311,72086,817
2021-06-29,Del Norte,015,27424,1469,1435,13,1448,8
2021-06-29,El Dorado,017,186661,10523,10403,784,11187,113
2021-06-29,Fresno,019,978130,103528,102464,8682,111146,1725
2021-06-29,Glenn,021,27897,2454,2439,566,3005,20
2021-06-29,Humboldt,023,135768,4543,4514,49,4563,49
2021-06-29,Imperial,025,180216,28808,28645,2694,31339,737
2021-06-29,Inyo,027,18085,1416,1408,12,1420,35
2021-06-29,Kern,029,883053,98015,97173,11054,108227,1347
2021-06-29,Kings,031,150075,23298,23035,1088,24123,245
2021-06-29,Lake,033,64148,3637,3594,13,3607,56
2021-06-29,Lassen,035,31185,5288,5268,115,5383,20
2021-06-29,Los Angeles,037,10098052,1214985,1207895,41316,1249211,24498
2021-06-29,Madera,039,155013,16832,16680,938,17618,240
2021-06-29,Marin,041,260295,14250,14127,259,14386,232
2021-06-29,Mariposa,043,17540,441,441,11,452,5
2021-06-29,Mendocino,045,87422,4205,4107,84,4191,49
2021-06-29,Merced,047,269075,31277,31277,1042,32319,469
2021-06-29,Modoc,049,8938,416,408,147,555,3
2021-06-29,Mono,051,14174,1266,1275,17,1292,3
2021-06-29,Monterey,053,433212,43344,43196,1843,45039,471
2021-06-29,Napa,055,140530,10055,10033,38,10071,81
2021-06-29,Nevada,057,99092,4990,4952,193,5145,72
2021-06-29,Orange,059,3164182,256990,255686,11461,267147,5124
2021-06-29,Placer,061,380077,23957,23693,1550,25243,299
2021-06-29,Plumas,063,18699,724,704,12,716,4
2021-06-29,Riverside,065,2383286,296015,292962,14020,306982,4524
2021-06-29,Sacramento,067,1510023,108786,108067,1828,109895,1677
2021-06-29,San Benito,069,59416,6109,6099,113,6212,63
2021-06-29,San Bernardino,071,2135413,295123,294118,9012,303130,4940
2021-06-29,San Diego,073,3302833,283616,282499,15457,297956,3780
2021-06-29,San Francisco,075,870044,37241,37041,1291,38332,558
2021-06-29,San Joaquin,077,732212,74262,73724,3588,77312,1409
2021-06-29,San Luis Obispo,079,281455,21548,21324,752,22076,256
2021-06-29,San Mateo,081,765935,42831,42540,486,43026,540
2021-06-29,Santa Barbara,083,443738,34663,34507,1128,35635,455
2021-06-29,Santa Clara,085,1922200,119663,118893,767,119660,2090
2021-06-29,Santa Cruz,087,273765,16361,16249,800,17049,208
2021-06-29,Shasta,089,179085,12625,12564,1641,14205,204
2021-06-29,Sierra,091,2930,63,59,12,71,0
2021-06-29,Siskiyou,093,43540,1972,1897,364,2261,29
2021-06-29,Solano,095,438530,33578,33440,572,34012,268
2021-06-29,Sonoma,097,501317,31111,30950,361,31311,316
2021-06-29,Stanislaus,099,539301,57207,56980,5972,62952,1018
2021-06-29,Sutter,101,95872,9638,9634,87,9721,114
2021-06-29,Tehama,103,63373,5159,5124,582,5706,63
2021-06-29,Trinity,105,12862,494,341,96,437,3
2021-06-29,Tulare,107,460477,50486,49751,9013,58764,852
2021-06-29,Tuolumne,109,53932,4092,4111,43,4154,64
2021-06-29,Ventura,111,848112,81950,81363,3018,84381,1032
2021-06-29,Yolo,113,214977,14236,14171,271,14442,213
2021-06-29,Yuba,115,75493,6232,6188,129,6317,51
2021-06-28,Alameda,001,1643700,89639,89638,1949,91587,1259
2021-06-28,Alpine,003,1148,88,89,0,89,0
2021-06-28,Amador,005,37829,3757,3753,32,3785,46
2021-06-28,Butte,007,227075,12816,12697,1856,14553,198
2021-06-28,Calaveras,009,45235,2204,2203,13,2216,55
2021-06-28,Colusa,011,21464,1968,1974,319,2293,15
2021-06-28,Contra Costa,013,1133247,71240,70807,1309,72116,816
2021-06-28,Del Norte,015,27424,1469,1436,13,1449,8
2021-06-28,El Dorado,017,186661,10513,10422,780,11202,115
2021-06-28,Fresno,019,978130,103497,103121,8680,111801,1727
2021-06-28,Glenn,021,27897,2454,2439,566,3005,20
2021-06-28,Humboldt,023,135768,4536,4520,48,4568,49
2021-06-28,Imperial,025,180216,28800,28981,2693,31674,741
2021-06-28,Inyo,027,18085,1413,1407,12,1419,35
2021-06-28,Kern,029,883053,97996,97252,11049,108301,1348
2021-06-28,Kings,031,150075,23292,23134,1088,24222,246
2021-06-28,Lake,033,64148,3629,3591,13,3604,56
2021-06-28,Lassen,035,31185,5286,5268,115,5383,20
2021-06-28,Los Angeles,037,10098052,1214466,1207714,41281,1248995,24496
2021-06-28,Madera,039,155013,16821,16683,937,17620,240
2021-06-28,Marin,041,260295,14235,14186,259,14445,232
2021-06-28,Mariposa,043,17540,441,440,11,451,5
2021-06-28,Mendocino,045,87422,4196,4102,83,4185,49
2021-06-28,Merced,047,269075,31265,31277,1042,32319,469
2021-06-28,Modoc,049,8938,416,411,146,557,3
2021-06-28,Mono,051,14174,1266,1276,17,1293,3
2021-06-28,Monterey,053,433212,43340,43202,1842,45044,462
2021-06-28,Napa,055,140530,10046,10050,37,10087,81
2021-06-28,Nevada,057,99092,4986,4951,193,5144,72
2021-06-28,Orange,059,3164182,256900,255755,11447,267202,5123
2021-06-28,Placer,061,380077,23937,23756,1546,25302,299
2021-06-28,Plumas,063,18699,722,704,12,716,4
2021-06-28,Riverside,065,2383286,295889,292647,14008,306655,4507
2021-06-28,Sacramento,067,1510023,108654,108342,1823,110165,1675
2021-06-28,San Benito,069,59416,6107,6101,113,6214,63
2021-06-28,San Bernardino,071,2135413,295022,294151,9007,303158,4928
2021-06-28,San Diego,073,3302833,283452,282417,15428,297845,3780
2021-06-28,San Francisco,075,870044,37205,37372,1289,38661,559
2021-06-28,San Joaquin,077,732212,74215,73973,3585,77558,1411
2021-06-28,San Luis Obispo,079,281455,21544,21340,751,22091,256
2021-06-28,San Mateo,081,765935,42797,42927,485,43412,540
2021-06-28,Santa Barbara,083,443738,34656,34534,1126,35660,455
2021-06-28,Santa Clara,085,1922200,119599,120377,766,121143,2103
2021-06-28,Santa Cruz,087,273765,16356,16245,800,17045,208
2021-06-28,Shasta,089,179085,12621,12642,1639,14281,203
2021-06-28,Sierra,091,2930,63,58,12,70,0
2021-06-28,Siskiyou,093,43540,1971,1896,364,2260,29
2021-06-28,Solano,095,438530,33542,33524,570,34094,267
2021-06-28,Sonoma,097,501317,31074,31137,360,31497,315
2021-06-28,Stanislaus,099,539301,57189,57047,5968,63015,1018
2021-06-28,Sutter,101,95872,9634,9682,87,9769,114
2021-06-28,Tehama,103,63373,5157,5122,582,5704,63
2021-06-28,Trinity,105,12862,494,341,96,437,3
2021-06-28,Tulare,107,460477,50476,49751,9009,58760,850
2021-06-28,Tuolumne,109,53932,4084,4121,43,4164,64
2021-06-28,Ventura,111,848112,81893,81393,3013,84406,1032
2021-06-28,Yolo,113,214977,14227,14199,268,14467,213
2021-06-28,Yuba,115,75493,6227,6207,129,6336,51
2021-06-27,Alameda,001,1643700,89552,89611,1945,91556,1259
2021-06-27,Alpine,003,1148,88,89,0,89,0
2021-06-27,Amador,005,37829,3756,3752,32,3784,46
2021-06-27,Butte,007,227075,12807,12696,1855,14551,198
2021-06-27,Calaveras,009,45235,2203,2203,13,2216,55
2021-06-27,Colusa,011,21464,1968,1974,319,2293,15
2021-06-27,Contra Costa,013,1133247,71154,70762,1305,72067,816
2021-06-27,Del Norte,015,27424,1466,1436,13,1449,8
2021-06-27,El Dorado,017,186661,10501,10418,777,11195,115
2021-06-27,Fresno,019,978130,103468,103110,8677,111787,1727
2021-06-27,Glenn,021,27897,2453,2439,565,3004,20
2021-06-27,Humboldt,023,135768,4524,4513,45,4558,49
2021-06-27,Imperial,025,180216,28786,28987,2693,31680,741
2021-06-27,Inyo,027,18085,1413,1407,12,1419,35
2021-06-27,Kern,029,883053,97970,97249,11042,108291,1348
2021-06-27,Kings,031,150075,23282,23132,1088,24220,246
2021-06-27,Lake,033,64148,3622,3581,13,3594,56
2021-06-27,Lassen,035,31185,5285,5265,115,5380,20
2021-06-27,Los Angeles,037,10098052,1213914,1207461,41241,1248702,24493
2021-06-27,Madera,039,155013,16813,16680,937,17617,240
2021-06-27,Marin,041,260295,14226,14182,259,14441,232
2021-06-27,Mariposa,043,17540,441,440,11,451,5
2021-06-27,Mendocino,045,87422,4189,4100,83,4183,49
2021-06-27,Merced,047,269075,31253,31266,1042,32308,469
2021-06-27,Modoc,049,8938,416,411,146,557,3
2021-06-27,Mono,051,14174,1266,1279,17,1296,3
2021-06-27,Monterey,053,433212,43327,43199,1842,45041,462
2021-06-27,Napa,055,140530,10040,10046,37,10083,81
2021-06-27,Nevada,057,99092,4980,4946,193,5139,72
2021-06-27,Orange,059,3164182,256786,255710,11436,267146,5123
2021-06-27,Placer,061,380077,23904,23731,1543,25274,299
2021-06-27,Plumas,063,18699,722,704,12,716,4
2021-06-27,Riverside,065,2383286,295787,292641,14002,306643,4507
2021-06-27,Sacramento,067,1510023,108519,108279,1819,110098,1675
2021-06-27,San Benito,069,59416,6101,6101,113,6214,63
2021-06-27,San Bernardino,071,2135413,294909,294115,9005,303120,4927
2021-06-27,San Diego,073,3302833,283312,282359,15402,297761,3780
2021-06-27,San Francisco,075,870044,37168,37360,1288,38648,559
2021-06-27,San Joaquin,077,732212,74179,73960,3583,77543,1411
2021-06-27,San Luis Obispo,079,281455,21537,21340,750,22090,256
2021-06-27,San Mateo,081,765935,42768,42925,482,43407,539
2021-06-27,Santa Barbara,083,443738,34642,34533,1124,35657,455
2021-06-27,Santa Clara,085,1922200,119548,120352,765,121117,2103
2021-06-27,Santa Cruz,087,273765,16347,16241,800,17041,208
2021-06-27,Shasta,089,179085,12615,12640,1638,14278,203
2021-06-27,Sierra,091,2930,63,58,12,70,0
2021-06-27,Siskiyou,093,43540,1969,1896,363,2259,29
2021-06-27,Solano,095,438530,33514,33516,570,34086,267
2021-06-27,Sonoma,097,501317,31036,31129,360,31489,315
2021-06-27,Stanislaus,099,539301,57149,57021,5965,62986,1018
2021-06-27,Sutter,101,95872,9628,9678,87,9765,114
2021-06-27,Tehama,103,63373,5153,5122,582,5704,63
2021-06-27,Trinity,105,12862,494,341,95,436,3
2021-06-27,Tulare,107,460477,50463,49749,9002,58751,850
2021-06-27,Tuolumne,109,53932,4082,4121,43,4164,64
2021-06-27,Ventura,111,848112,81859,81361,3004,84365,1032
2021-06-27,Yolo,113,214977,14212,14194,264,14458,213
2021-06-27,Yuba,115,75493,6221,6205,129,6334,51
2021-06-26,Alameda,001,1643700,89495,89560,1943,91503,1259
2021-06-26,Alpine,003,1148,88,89,0,89,0
2021-06-26,Amador,005,37829,3756,3748,32,3780,46
2021-06-26,Butte,007,227075,12803,12693,1852,14545,198
2021-06-26,Calaveras,009,45235,2201,2202,13,2215,55
2021-06-26,Colusa,011,21464,1968,1973,319,2292,15
2021-06-26,Contra Costa,013,1133247,71111,70712,1304,72016,816
2021-06-26,Del Norte,015,27424,1465,1432,13,1445,8
2021-06-26,El Dorado,017,186661,10493,10414,775,11189,115
2021-06-26,Fresno,019,978130,103448,103091,8675,111766,1727
2021-06-26,Glenn,021,27897,2451,2441,565,3006,20
2021-06-26,Humboldt,023,135768,4521,4509,45,4554,49
2021-06-26,Imperial,025,180216,28782,28970,2693,31663,741
2021-06-26,Inyo,027,18085,1413,1407,12,1419,35
2021-06-26,Kern,029,883053,97944,97239,11033,108272,1348
2021-06-26,Kings,031,150075,23278,23128,1087,24215,246
2021-06-26,Lake,033,64148,3611,3576,13,3589,56
2021-06-26,Lassen,035,31185,5282,5263,115,5378,20
2021-06-26,Los Angeles,037,10098052,1213609,1207198,41209,1248407,24490
2021-06-26,Madera,039,155013,16806,16679,936,17615,240
2021-06-26,Marin,041,260295,14217,14180,259,14439,232
2021-06-26,Mariposa,043,17540,441,440,11,451,5
2021-06-26,Mendocino,045,87422,4187,4096,83,4179,49
2021-06-26,Merced,047,269075,31247,31259,1041,32300,469
2021-06-26,Modoc,049,8938,416,411,146,557,3
2021-06-26,Mono,051,14174,1266,1279,17,1296,3
2021-06-26,Monterey,053,433212,43324,43192,1842,45034,462
2021-06-26,Napa,055,140530,10033,10043,37,10080,81
2021-06-26,Nevada,057,99092,4975,4939,193,5132,72
2021-06-26,Orange,059,3164182,256707,255640,11429,267069,5123
2021-06-26,Placer,061,380077,23890,23702,1541,25243,299
2021-06-26,Plumas,063,18699,722,704,12,716,4
2021-06-26,Riverside,065,2383286,295729,292480,13996,306476,4505
2021-06-26,Sacramento,067,1510023,108448,108179,1817,109996,1675
2021-06-26,San Benito,069,59416,6097,6100,113,6213,63
2021-06-26,San Bernardino,071,2135413,294815,294034,9001,303035,4928
2021-06-26,San Diego,073,3302833,283227,282263,15384,297647,3780
2021-06-26,San Francisco,075,870044,37136,37348,1287,38635,559
2021-06-26,San Joaquin,077,732212,74150,73928,3582,77510,1411
2021-06-26,San Luis Obispo,079,281455,21536,21330,749,22079,256
2021-06-26,San Mateo,081,765935,42748,42898,482,43380,539
2021-06-26,Santa Barbara,083,443738,34633,34525,1124,35649,455
2021-06-26,Santa Clara,085,1922200,119515,120321,765,121086,2103
2021-06-26,Santa Cruz,087,273765,16344,16239,800,17039,208
2021-06-26,Shasta,089,179085,12611,12635,1634,14269,203
2021-06-26,Sierra,091,2930,63,58,12,70,0
2021-06-26,Siskiyou,093,43540,1968,1896,362,2258,29
2021-06-26,Solano,095,438530,33496,33489,568,34057,267
2021-06-26,Sonoma,097,501317,31010,31088,360,31448,315
2021-06-26,Stanislaus,099,539301,57133,57006,5962,62968,1018
2021-06-26,Sutter,101,95872,9627,9669,87,9756,114
2021-06-26,Tehama,103,63373,5153,5119,582,5701,63
2021-06-26,Trinity,105,12862,494,341,95,436,3
2021-06-26,Tulare,107,460477,50457,49745,9002,58747,850
2021-06-26,Tuolumne,109,53932,4082,4121,43,4164,64
2021-06-26,Ventura,111,848112,81835,81352,3003,84355,1032
2021-06-26,Yolo,113,214977,14204,14184,264,14448,213
2021-06-26,Yuba,115,75493,6218,6200,129,6329,51
2021-06-25,Alameda,001,1643700,89427,89453,1941,91394,1271
2021-06-25,Alpine,003,1148,88,89,0,89,0
2021-06-25,Amador,005,37829,3755,3746,32,3778,46
2021-06-25,Butte,007,227075,12798,12682,1849,14531,198
2021-06-25,Calaveras,009,45235,2200,2201,13,2214,55
2021-06-25,Colusa,011,21464,1968,1972,319,2291,15
2021-06-25,Contra Costa,013,1133247,71075,70659,1304,71963,815
2021-06-25,Del Norte,015,27424,1465,1426,13,1439,8
2021-06-25,El Dorado,017,186661,10485,10406,772,11178,115
2021-06-25,Fresno,019,978130,103430,103073,8671,111744,1727
2021-06-25,Glenn,021,27897,2451,2441,565,3006,20
2021-06-25,Humboldt,023,135768,4515,4503,43,4546,49
2021-06-25,Imperial,025,180216,28779,28968,2693,31661,740
2021-06-25,Inyo,027,18085,1412,1406,12,1418,35
2021-06-25,Kern,029,883053,97925,97182,11029,108211,1347
2021-06-25,Kings,031,150075,23272,23118,1087,24205,246
2021-06-25,Lake,033,64148,3605,3571,13,3584,56
2021-06-25,Lassen,035,31185,5281,5259,115,5374,20
2021-06-25,Los Angeles,037,10098052,1213326,1206909,41192,1248101,24483
2021-06-25,Madera,039,155013,16803,16670,936,17606,240
2021-06-25,Marin,041,260295,14214,14179,259,14438,232
2021-06-25,Mariposa,043,17540,441,440,11,451,5
2021-06-25,Mendocino,045,87422,4184,4089,83,4172,49
2021-06-25,Merced,047,269075,31239,31256,1041,32297,467
2021-06-25,Modoc,049,8938,416,411,146,557,3
2021-06-25,Mono,051,14174,1266,1279,17,1296,3
2021-06-25,Monterey,053,433212,43319,43184,1841,45025,462
2021-06-25,Napa,055,140530,10028,10037,37,10074,81
2021-06-25,Nevada,057,99092,4972,4932,193,5125,72
2021-06-25,Orange,059,3164182,256636,255574,11427,267001,5119
2021-06-25,Placer,061,380077,23871,23672,1540,25212,299
2021-06-25,Plumas,063,18699,722,702,11,713,4
2021-06-25,Riverside,065,2383286,295661,291663,13989,305652,4490
2021-06-25,Sacramento,067,1510023,108376,108034,1814,109848,1673
2021-06-25,San Benito,069,59416,6093,6098,113,6211,63
2021-06-25,San Bernardino,071,2135413,294760,293941,8999,302940,4911
2021-06-25,San Diego,073,3302833,283167,282157,15371,297528,3779
2021-06-25,San Francisco,075,870044,37113,37338,1286,38624,559
2021-06-25,San Joaquin,077,732212,74117,73860,3580,77440,1410
2021-06-25,San Luis Obispo,079,281455,21533,21325,748,22073,256
2021-06-25,San Mateo,081,765935,42730,42849,482,43331,537
2021-06-25,Santa Barbara,083,443738,34624,34518,1123,35641,454
2021-06-25,Santa Clara,085,1922200,119495,120272,765,121037,2103
2021-06-25,Santa Cruz,087,273765,16341,16230,798,17028,208
2021-06-25,Shasta,089,179085,12601,12633,1633,14266,202
2021-06-25,Sierra,091,2930,63,58,12,70,0
2021-06-25,Siskiyou,093,43540,1967,1894,362,2256,29
2021-06-25,Solano,095,438530,33476,33449,568,34017,267
2021-06-25,Sonoma,097,501317,30987,31043,360,31403,314
2021-06-25,Stanislaus,099,539301,57117,56973,5955,62928,1018
2021-06-25,Sutter,101,95872,9620,9664,87,9751,114
2021-06-25,Tehama,103,63373,5152,5119,582,5701,63
2021-06-25,Trinity,105,12862,494,338,95,433,3
2021-06-25,Tulare,107,460477,50450,49731,8999,58730,850
2021-06-25,Tuolumne,109,53932,4081,4121,43,4164,64
2021-06-25,Ventura,111,848112,81806,81342,2997,84339,1032
2021-06-25,Yolo,113,214977,14198,14172,264,14436,213
2021-06-25,Yuba,115,75493,6214,6195,129,6324,51
2021-06-24,Alameda,001,1643700,89355,89358,1938,91296,1268
2021-06-24,Alpine,003,1148,88,89,0,89,0
2021-06-24,Amador,005,37829,3751,3745,32,3777,46
2021-06-24,Butte,007,227075,12792,12673,1847,14520,198
2021-06-24,Calaveras,009,45235,2197,2202,13,2215,55
2021-06-24,Colusa,011,21464,1967,1972,319,2291,15
2021-06-24,Contra Costa,013,1133247,71016,70590,1304,71894,813
2021-06-24,Del Norte,015,27424,1464,1421,13,1434,8
2021-06-24,El Dorado,017,186661,10478,10402,772,11174,115
2021-06-24,Fresno,019,978130,103410,103061,8669,111730,1727
2021-06-24,Glenn,021,27897,2450,2439,565,3004,20
2021-06-24,Humboldt,023,135768,4510,4493,43,4536,49
2021-06-24,Imperial,025,180216,28776,28981,2693,31674,740
2021-06-24,Inyo,027,18085,1411,1406,12,1418,35
2021-06-24,Kern,029,883053,97906,97129,11016,108145,1346
2021-06-24,Kings,031,150075,23268,23114,1086,24200,246
2021-06-24,Lake,033,64148,3599,3571,13,3584,56
2021-06-24,Lassen,035,31185,5280,5258,115,5373,20
2021-06-24,Los Angeles,037,10098052,1213002,1206590,41168,1247758,24480
2021-06-24,Madera,039,155013,16792,16662,935,17597,240
2021-06-24,Marin,041,260295,14210,14180,259,14439,232
2021-06-24,Mariposa,043,17540,441,440,11,451,5
2021-06-24,Mendocino,045,87422,4176,4085,83,4168,49
2021-06-24,Merced,047,269075,31229,31248,1040,32288,466
2021-06-24,Modoc,049,8938,416,411,146,557,3
2021-06-24,Mono,051,14174,1266,1276,17,1293,3
2021-06-24,Monterey,053,433212,43312,43180,1841,45021,451
2021-06-24,Napa,055,140530,10026,10036,37,10073,80
2021-06-24,Nevada,057,99092,4970,4927,193,5120,72
2021-06-24,Orange,059,3164182,256572,255520,11419,266939,5117
2021-06-24,Placer,061,380077,23846,23659,1538,25197,299
2021-06-24,Plumas,063,18699,721,702,11,713,4
2021-06-24,Riverside,065,2383286,295581,291067,13978,305045,4473
2021-06-24,Sacramento,067,1510023,108288,107965,1812,109777,1672
2021-06-24,San Benito,069,59416,6090,6098,113,6211,63
2021-06-24,San Bernardino,071,2135413,294689,293895,8994,302889,4898
2021-06-24,San Diego,073,3302833,283063,282053,15358,297411,3778
2021-06-24,San Francisco,075,870044,37091,37320,1284,38604,559
2021-06-24,San Joaquin,077,732212,74069,73814,3580,77394,1408
2021-06-24,San Luis Obispo,079,281455,21527,21326,748,22074,256
2021-06-24,San Mateo,081,765935,42704,42814,481,43295,542
2021-06-24,Santa Barbara,083,443738,34618,34512,1122,35634,454
2021-06-24,Santa Clara,085,1922200,119464,120274,764,121038,2103
2021-06-24,Santa Cruz,087,273765,16340,16227,798,17025,208
2021-06-24,Shasta,089,179085,12596,12629,1629,14258,202
2021-06-24,Sierra,091,2930,63,58,12,70,0
2021-06-24,Siskiyou,093,43540,1967,1892,362,2254,28
2021-06-24,Solano,095,438530,33453,33432,566,33998,267
2021-06-24,Sonoma,097,501317,30958,31020,360,31380,314
2021-06-24,Stanislaus,099,539301,57091,56946,5955,62901,1018
2021-06-24,Sutter,101,95872,9613,9660,87,9747,113
2021-06-24,Tehama,103,63373,5149,5115,582,5697,63
2021-06-24,Trinity,105,12862,493,338,95,433,3
2021-06-24,Tulare,107,460477,50439,49730,8997,58727,850
2021-06-24,Tuolumne,109,53932,4079,4120,43,4163,64
2021-06-24,Ventura,111,848112,81778,81332,2996,84328,1032
2021-06-24,Yolo,113,214977,14189,14169,261,14430,213
2021-06-24,Yuba,115,75493,6209,6195,129,6324,51
2021-06-23,Alameda,001,1643700,89283,89338,1937,91275,1266
2021-06-23,Alpine,003,1148,88,88,0,88,0
2021-06-23,Amador,005,37829,3749,3743,32,3775,46
2021-06-23,Butte,007,227075,12785,12666,1847,14513,198
2021-06-23,Calaveras,009,45235,2196,2199,13,2212,55
2021-06-23,Colusa,011,21464,1966,1972,319,2291,15
2021-06-23,Contra Costa,013,1133247,70951,70526,1303,71829,813
2021-06-23,Del Norte,015,27424,1460,1418,13,1431,8
2021-06-23,El Dorado,017,186661,10468,10395,769,11164,115
2021-06-23,Fresno,019,978130,103381,103020,8667,111687,1724
2021-06-23,Glenn,021,27897,2450,2437,564,3001,20
2021-06-23,Humboldt,023,135768,4501,4490,43,4533,48
2021-06-23,Imperial,025,180216,28769,28908,2693,31601,740
2021-06-23,Inyo,027,18085,1411,1406,12,1418,35
2021-06-23,Kern,029,883053,97878,97078,11003,108081,1345
2021-06-23,Kings,031,150075,23261,23105,1084,24189,245
2021-06-23,Lake,033,64148,3590,3566,13,3579,53
2021-06-23,Lassen,035,31185,5277,5257,115,5372,20
2021-06-23,Los Angeles,037,10098052,1212665,1206358,41158,1247516,24472
2021-06-23,Madera,039,155013,16785,16660,935,17595,240
2021-06-23,Marin,041,260295,14204,14177,259,14436,230
2021-06-23,Mariposa,043,17540,441,439,11,450,5
2021-06-23,Mendocino,045,87422,4172,4078,83,4161,49
2021-06-23,Merced,047,269075,31220,31260,1040,32300,465
2021-06-23,Modoc,049,8938,414,407,146,553,3
2021-06-23,Mono,051,14174,1266,1279,17,1296,3
2021-06-23,Monterey,053,433212,43303,43166,1841,45007,439
2021-06-23,Napa,055,140530,10017,10032,37,10069,80
2021-06-23,Nevada,057,99092,4967,4924,193,5117,72
2021-06-23,Orange,059,3164182,256506,255479,11411,266890,5116
2021-06-23,Placer,061,380077,23817,23630,1533,25163,299
2021-06-23,Plumas,063,18699,720,701,11,712,4
2021-06-23,Riverside,065,2383286,295498,290343,13976,304319,4462
2021-06-23,Sacramento,067,1510023,108196,107868,1807,109675,1671
2021-06-23,San Benito,069,59416,6086,6097,113,6210,63
2021-06-23,San Bernardino,071,2135413,294610,293816,8989,302805,4886
2021-06-23,San Diego,073,3302833,282963,281937,15337,297274,3777
2021-06-23,San Francisco,075,870044,37067,37304,1282,38586,559
2021-06-23,San Joaquin,077,732212,74030,73764,3578,77342,1405
2021-06-23,San Luis Obispo,079,281455,21523,21323,747,22070,257
2021-06-23,San Mateo,081,765935,42688,42756,481,43237,542
2021-06-23,Santa Barbara,083,443738,34608,34505,1122,35627,454
2021-06-23,Santa Clara,085,1922200,119435,120233,764,120997,2098
2021-06-23,Santa Cruz,087,273765,16336,16215,798,17013,209
2021-06-23,Shasta,089,179085,12589,12604,1627,14231,202
2021-06-23,Sierra,091,2930,63,57,12,69,0
2021-06-23,Siskiyou,093,43540,1965,1892,362,2254,28
2021-06-23,Solano,095,438530,33409,33408,566,33974,267
2021-06-23,Sonoma,097,501317,30918,30959,358,31317,314
2021-06-23,Stanislaus,099,539301,57061,56926,5954,62880,1017
2021-06-23,Sutter,101,95872,9607,9653,87,9740,113
2021-06-23,Tehama,103,63373,5149,5119,581,5700,63
2021-06-23,Trinity,105,12862,493,338,95,433,3
2021-06-23,Tulare,107,460477,50432,49711,8994,58705,850
2021-06-23,Tuolumne,109,53932,4076,4120,43,4163,64
2021-06-23,Ventura,111,848112,81755,81312,2993,84305,1032
2021-06-23,Yolo,113,214977,14179,14161,261,14422,212
2021-06-23,Yuba,115,75493,6206,6190,129,6319,51
2021-06-22,Alameda,001,1643700,89216,89308,1937,91245,1263
2021-06-22,Alpine,003,1148,88,88,0,88,0
2021-06-22,Amador,005,37829,3746,3743,32,3775,46
2021-06-22,Butte,007,227075,12781,12662,1844,14506,198
2021-06-22,Calaveras,009,45235,2195,2198,13,2211,55
2021-06-22,Colusa,011,21464,1965,1971,319,2290,15
2021-06-22,Contra Costa,013,1133247,70895,70480,1302,71782,813
2021-06-22,Del Norte,015,27424,1457,1417,13,1430,8
2021-06-22,El Dorado,017,186661,10463,10380,768,11148,113
2021-06-22,Fresno,019,978130,103362,102996,8663,111659,1724
2021-06-22,Glenn,021,27897,2449,2435,562,2997,19
2021-06-22,Humboldt,023,135768,4491,4483,43,4526,42
2021-06-22,Imperial,025,180216,28764,28880,2693,31573,740
2021-06-22,Inyo,027,18085,1411,1405,12,1417,35
2021-06-22,Kern,029,883053,97865,97013,10999,108012,1342
2021-06-22,Kings,031,150075,23253,23098,1083,24181,245
2021-06-22,Lake,033,64148,3588,3564,13,3577,45
2021-06-22,Lassen,035,31185,5272,5254,115,5369,20
2021-06-22,Los Angeles,037,10098052,1212349,1206146,41146,1247292,24461
2021-06-22,Madera,039,155013,16780,16652,935,17587,240
2021-06-22,Marin,041,260295,14202,14174,259,14433,230
2021-06-22,Mariposa,043,17540,441,439,11,450,5
2021-06-22,Mendocino,045,87422,4166,4072,83,4155,49
2021-06-22,Merced,047,269075,31209,31267,1040,32307,464
2021-06-22,Modoc,049,8938,412,405,145,550,3
2021-06-22,Mono,051,14174,1266,1277,17,1294,3
2021-06-22,Monterey,053,433212,43300,43162,1840,45002,427
2021-06-22,Napa,055,140530,10013,10029,37,10066,80
2021-06-22,Nevada,057,99092,4961,4923,193,5116,72
2021-06-22,Orange,059,3164182,256437,255452,11400,266852,5114
2021-06-22,Placer,061,380077,23795,23603,1533,25136,299
2021-06-22,Plumas,063,18699,720,697,11,708,4
2021-06-22,Riverside,065,2383286,295437,289839,13972,303811,4456
2021-06-22,Sacramento,067,1510023,108095,107801,1802,109603,1670
2021-06-22,San Benito,069,59416,6085,6098,113,6211,63
2021-06-22,San Bernardino,071,2135413,294535,293770,8983,302753,4873
2021-06-22,San Diego,073,3302833,282859,281867,15314,297181,3771
2021-06-22,San Francisco,075,870044,37053,37287,1282,38569,556
2021-06-22,San Joaquin,077,732212,74000,73723,3576,77299,1405
2021-06-22,San Luis Obispo,079,281455,21520,21321,746,22067,257
2021-06-22,San Mateo,081,765935,42674,42725,476,43201,542
2021-06-22,Santa Barbara,083,443738,34597,34500,1121,35621,454
2021-06-22,Santa Clara,085,1922200,119403,120194,764,120958,2095
2021-06-22,Santa Cruz,087,273765,16331,16218,798,17016,209
2021-06-22,Shasta,089,179085,12578,12616,1624,14240,202
2021-06-22,Sierra,091,2930,62,57,12,69,0
2021-06-22,Siskiyou,093,43540,1965,1892,362,2254,28
2021-06-22,Solano,095,438530,33391,33397,565,33962,267
2021-06-22,Sonoma,097,501317,30878,30933,358,31291,314
2021-06-22,Stanislaus,099,539301,57045,56915,5952,62867,1017
2021-06-22,Sutter,101,95872,9600,9649,87,9736,113
2021-06-22,Tehama,103,63373,5147,5118,580,5698,63
2021-06-22,Trinity,105,12862,491,337,95,432,3
2021-06-22,Tulare,107,460477,50423,49706,8989,58695,850
2021-06-22,Tuolumne,109,53932,4074,4119,43,4162,64
2021-06-22,Ventura,111,848112,81741,81300,2992,84292,1032
2021-06-22,Yolo,113,214977,14174,14157,259,14416,212
2021-06-22,Yuba,115,75493,6202,6181,129,6310,51
2021-06-21,Alameda,001,1643700,89160,89281,1936,91217,1262
2021-06-21,Alpine,003,1148,88,88,0,88,0
2021-06-21,Amador,005,37829,3740,3742,32,3774,46
2021-06-21,Butte,007,227075,12775,12668,1842,14510,195
2021-06-21,Calaveras,009,45235,2193,2194,13,2207,55
2021-06-21,Colusa,011,21464,1964,1970,318,2288,15
2021-06-21,Contra Costa,013,1133247,70824,70439,1301,71740,813
2021-06-21,Del Norte,015,27424,1453,1416,13,1429,8
2021-06-21,El Dorado,017,186661,10457,10375,767,11142,113
2021-06-21,Fresno,019,978130,103342,102971,8660,111631,1724
2021-06-21,Glenn,021,27897,2448,2433,562,2995,19
2021-06-21,Humboldt,023,135768,4482,4478,42,4520,42
2021-06-21,Imperial,025,180216,28760,28855,2693,31548,740
2021-06-21,Inyo,027,18085,1410,1405,12,1417,35
2021-06-21,Kern,029,883053,97836,96995,10991,107986,1342
2021-06-21,Kings,031,150075,23246,23091,1080,24171,245
2021-06-21,Lake,033,64148,3582,3563,13,3576,45
2021-06-21,Lassen,035,31185,5270,5233,115,5348,19
2021-06-21,Los Angeles,037,10098052,1212054,1205994,41124,1247118,24459
2021-06-21,Madera,039,155013,16771,16647,935,17582,240
2021-06-21,Marin,041,260295,14198,14173,259,14432,230
2021-06-21,Mariposa,043,17540,441,439,11,450,5
2021-06-21,Mendocino,045,87422,4163,4085,83,4168,49
2021-06-21,Merced,047,269075,31199,31264,1039,32303,465
2021-06-21,Modoc,049,8938,412,405,145,550,3
2021-06-21,Mono,051,14174,1266,1277,17,1294,3
2021-06-21,Monterey,053,433212,43297,43157,1840,44997,427
2021-06-21,Napa,055,140530,10008,10028,37,10065,80
2021-06-21,Nevada,057,99092,4957,4921,193,5114,72
2021-06-21,Orange,059,3164182,256364,255400,11393,266793,5113
2021-06-21,Placer,061,380077,23771,23577,1533,25110,298
2021-06-21,Plumas,063,18699,718,697,11,708,4
2021-06-21,Riverside,065,2383286,295361,289797,13967,303764,4456
2021-06-21,Sacramento,067,1510023,107984,107757,1801,109558,1669
2021-06-21,San Benito,069,59416,6081,6098,113,6211,63
2021-06-21,San Bernardino,071,2135413,294448,293736,8979,302715,4850
2021-06-21,San Diego,073,3302833,282754,281811,15294,297105,3771
2021-06-21,San Francisco,075,870044,37037,37275,1281,38556,556
2021-06-21,San Joaquin,077,732212,73959,73687,3575,77262,1405
2021-06-21,San Luis Obispo,079,281455,21511,21316,746,22062,257
2021-06-21,San Mateo,081,765935,42658,42685,475,43160,542
2021-06-21,Santa Barbara,083,443738,34592,34492,1121,35613,455
2021-06-21,Santa Clara,085,1922200,119370,120192,763,120955,2093
2021-06-21,Santa Cruz,087,273765,16329,16212,798,17010,208
2021-06-21,Shasta,089,179085,12565,12617,1621,14238,201
2021-06-21,Sierra,091,2930,62,57,12,69,0
2021-06-21,Siskiyou,093,43540,1965,1892,362,2254,27
2021-06-21,Solano,095,438530,33368,33383,564,33947,266
2021-06-21,Sonoma,097,501317,30855,30912,358,31270,314
2021-06-21,Stanislaus,099,539301,57015,56891,5947,62838,1017
2021-06-21,Sutter,101,95872,9597,9649,87,9736,113
2021-06-21,Tehama,103,63373,5147,5115,579,5694,63
2021-06-21,Trinity,105,12862,491,337,95,432,3
2021-06-21,Tulare,107,460477,50412,49689,8985,58674,849
2021-06-21,Tuolumne,109,53932,4070,4119,43,4162,63
2021-06-21,Ventura,111,848112,81713,81291,2988,84279,1031
2021-06-21,Yolo,113,214977,14168,14165,259,14424,212
2021-06-21,Yuba,115,75493,6201,6172,129,6301,51
2021-06-20,Alameda,001,1643700,89095,89255,1935,91190,1263
2021-06-20,Alpine,003,1148,88,88,0,88,0
2021-06-20,Amador,005,37829,3737,3740,32,3772,46
2021-06-20,Butte,007,227075,12768,12668,1841,14509,194
2021-06-20,Calaveras,009,45235,2192,2193,13,2206,55
2021-06-20,Colusa,011,21464,1964,1970,318,2288,15
2021-06-20,Contra Costa,013,1133247,70767,70401,1299,71700,813
2021-06-20,Del Norte,015,27424,1449,1416,13,1429,8
2021-06-20,El Dorado,017,186661,10443,10372,764,11136,113
2021-06-20,Fresno,019,978130,103301,102947,8657,111604,1724
2021-06-20,Glenn,021,27897,2448,2434,562,2996,19
2021-06-20,Humboldt,023,135768,4476,4472,42,4514,42
2021-06-20,Imperial,025,180216,28751,28855,2693,31548,740
2021-06-20,Inyo,027,18085,1409,1405,12,1417,35
2021-06-20,Kern,029,883053,97815,96985,10980,107965,1342
2021-06-20,Kings,031,150075,23241,23088,1078,24166,245
2021-06-20,Lake,033,64148,3580,3563,13,3576,45
2021-06-20,Lassen,035,31185,5267,5230,115,5345,19
2021-06-20,Los Angeles,037,10098052,1211749,1205874,41116,1246990,24456
2021-06-20,Madera,039,155013,16763,16638,933,17571,240
2021-06-20,Marin,041,260295,14195,14166,259,14425,230
2021-06-20,Mariposa,043,17540,439,439,11,450,5
2021-06-20,Mendocino,045,87422,4156,4080,83,4163,49
2021-06-20,Merced,047,269075,31186,31265,1039,32304,465
2021-06-20,Modoc,049,8938,412,405,145,550,3
2021-06-20,Mono,051,14174,1266,1275,17,1292,3
2021-06-20,Monterey,053,433212,43288,43156,1839,44995,427
2021-06-20,Napa,055,140530,10001,10026,36,10062,80
2021-06-20,Nevada,057,99092,4950,4919,193,5112,72
2021-06-20,Orange,059,3164182,256300,255377,11382,266759,5113
2021-06-20,Placer,061,380077,23737,23562,1529,25091,298
2021-06-20,Plumas,063,18699,717,697,11,708,4
2021-06-20,Riverside,065,2383286,295282,289770,13956,303726,4456
2021-06-20,Sacramento,067,1510023,107873,107700,1798,109498,1669
2021-06-20,San Benito,069,59416,6081,6098,113,6211,63
2021-06-20,San Bernardino,071,2135413,294347,293713,8975,302688,4845
2021-06-20,San Diego,073,3302833,282648,281750,15272,297022,3771
2021-06-20,San Francisco,075,870044,37014,37269,1281,38550,556
2021-06-20,San Joaquin,077,732212,73914,73676,3566,77242,1405
2021-06-20,San Luis Obispo,079,281455,21509,21313,746,22059,257
2021-06-20,San Mateo,081,765935,42629,42681,475,43156,542
2021-06-20,Santa Barbara,083,443738,34583,34487,1121,35608,455
2021-06-20,Santa Clara,085,1922200,119335,120163,763,120926,2093
2021-06-20,Santa Cruz,087,273765,16324,16210,798,17008,208
2021-06-20,Shasta,089,179085,12560,12617,1619,14236,201
2021-06-20,Sierra,091,2930,62,57,12,69,0
2021-06-20,Siskiyou,093,43540,1964,1891,362,2253,27
2021-06-20,Solano,095,438530,33346,33361,562,33923,266
2021-06-20,Sonoma,097,501317,30808,30884,355,31239,314
2021-06-20,Stanislaus,099,539301,56982,56868,5946,62814,1017
2021-06-20,Sutter,101,95872,9594,9645,87,9732,113
2021-06-20,Tehama,103,63373,5143,5115,579,5694,63
2021-06-20,Trinity,105,12862,491,337,95,432,3
2021-06-20,Tulare,107,460477,50403,49685,8983,58668,849
2021-06-20,Tuolumne,109,53932,4067,4117,43,4160,63
2021-06-20,Ventura,111,848112,81697,81282,2986,84268,1031
2021-06-20,Yolo,113,214977,14161,14160,259,14419,212
2021-06-20,Yuba,115,75493,6194,6167,129,6296,51
2021-06-19,Alameda,001,1643700,89060,89202,1935,91137,1263
2021-06-19,Alpine,003,1148,88,88,0,88,0
2021-06-19,Amador,005,37829,3735,3739,32,3771,46
2021-06-19,Butte,007,227075,12764,12659,1841,14500,194
2021-06-19,Calaveras,009,45235,2192,2192,13,2205,55
2021-06-19,Colusa,011,21464,1964,1969,318,2287,15
2021-06-19,Contra Costa,013,1133247,70736,70334,1298,71632,813
2021-06-19,Del Norte,015,27424,1448,1416,13,1429,8
2021-06-19,El Dorado,017,186661,10442,10363,763,11126,113
2021-06-19,Fresno,019,978130,103288,102922,8656,111578,1724
2021-06-19,Glenn,021,27897,2447,2434,561,2995,19
2021-06-19,Humboldt,023,135768,4465,4463,42,4505,42
2021-06-19,Imperial,025,180216,28750,28813,2693,31506,740
2021-06-19,Inyo,027,18085,1409,1405,12,1417,35
2021-06-19,Kern,029,883053,97799,96966,10976,107942,1342
2021-06-19,Kings,031,150075,23238,23086,1078,24164,245
2021-06-19,Lake,033,64148,3576,3563,13,3576,45
2021-06-19,Lassen,035,31185,5266,5225,115,5340,19
2021-06-19,Los Angeles,037,10098052,1211546,1205602,41100,1246702,24454
2021-06-19,Madera,039,155013,16761,16632,933,17565,240
2021-06-19,Marin,041,260295,14187,14152,259,14411,230
2021-06-19,Mariposa,043,17540,439,439,11,450,5
2021-06-19,Mendocino,045,87422,4151,4077,83,4160,49
2021-06-19,Merced,047,269075,31184,31256,1039,32295,465
2021-06-19,Modoc,049,8938,411,402,145,547,3
2021-06-19,Mono,051,14174,1266,1275,17,1292,3
2021-06-19,Monterey,053,433212,43282,43153,1839,44992,427
2021-06-19,Napa,055,140530,9997,10025,36,10061,80
2021-06-19,Nevada,057,99092,4945,4910,193,5103,72
2021-06-19,Orange,059,3164182,256253,255329,11379,266708,5112
2021-06-19,Placer,061,380077,23721,23537,1526,25063,298
2021-06-19,Plumas,063,18699,716,697,11,708,4
2021-06-19,Riverside,065,2383286,295236,289720,13956,303676,4456
2021-06-19,Sacramento,067,1510023,107827,107631,1795,109426,1669
2021-06-19,San Benito,069,59416,6080,6098,113,6211,63
2021-06-19,San Bernardino,071,2135413,294304,293673,8973,302646,4844
2021-06-19,San Diego,073,3302833,282588,281682,15258,296940,3771
2021-06-19,San Francisco,075,870044,37001,37256,1281,38537,556
2021-06-19,San Joaquin,077,732212,73898,73652,3562,77214,1405
2021-06-19,San Luis Obispo,079,281455,21507,21308,744,22052,257
2021-06-19,San Mateo,081,765935,42611,42646,473,43119,542
2021-06-19,Santa Barbara,083,443738,34581,34472,1121,35593,455
2021-06-19,Santa Clara,085,1922200,119312,120110,762,120872,2093
2021-06-19,Santa Cruz,087,273765,16319,16206,798,17004,208
2021-06-19,Shasta,089,179085,12558,12615,1618,14233,201
2021-06-19,Sierra,091,2930,62,57,12,69,0
2021-06-19,Siskiyou,093,43540,1964,1891,362,2253,27
2021-06-19,Solano,095,438530,33336,33341,561,33902,266
2021-06-19,Sonoma,097,501317,30767,30841,355,31196,314
2021-06-19,Stanislaus,099,539301,56963,56847,5943,62790,1017
2021-06-19,Sutter,101,95872,9591,9645,87,9732,113
2021-06-19,Tehama,103,63373,5142,5115,579,5694,63
2021-06-19,Trinity,105,12862,491,337,95,432,3
2021-06-19,Tulare,107,460477,50396,49681,8978,58659,849
2021-06-19,Tuolumne,109,53932,4067,4117,43,4160,63
2021-06-19,Ventura,111,848112,81684,81270,2985,84255,1031
2021-06-19,Yolo,113,214977,14157,14156,258,14414,212
2021-06-19,Yuba,115,75493,6193,6157,129,6286,51
2021-06-18,Alameda,001,1643700,89023,89123,1935,91058,1263
2021-06-18,Alpine,003,1148,88,88,0,88,0
2021-06-18,Amador,005,37829,3735,3739,32,3771,46
2021-06-18,Butte,007,227075,12761,12653,1838,14491,194
2021-06-18,Calaveras,009,45235,2192,2191,13,2204,55
2021-06-18,Colusa,011,21464,1963,1969,318,2287,15
2021-06-18,Contra Costa,013,1133247,70694,70271,1296,71567,813
2021-06-18,Del Norte,015,27424,1448,1415,13,1428,8
2021-06-18,El Dorado,017,186661,10439,10348,761,11109,113
2021-06-18,Fresno,019,978130,103272,102894,8654,111548,1722
2021-06-18,Glenn,021,27897,2446,2430,561,2991,19
2021-06-18,Humboldt,023,135768,4457,4450,42,4492,42
2021-06-18,Imperial,025,180216,28748,28809,2693,31502,740
2021-06-18,Inyo,027,18085,1409,1405,12,1417,35
2021-06-18,Kern,029,883053,97788,96948,10970,107918,1341
2021-06-18,Kings,031,150075,23233,23082,1078,24160,245
2021-06-18,Lake,033,64148,3572,3563,13,3576,45
2021-06-18,Lassen,035,31185,5265,5224,115,5339,19
2021-06-18,Los Angeles,037,10098052,1211380,1205472,41083,1246555,24451
2021-06-18,Madera,039,155013,16755,16625,933,17558,241
2021-06-18,Marin,041,260295,14184,14147,259,14406,230
2021-06-18,Mariposa,043,17540,439,439,11,450,5
2021-06-18,Mendocino,045,87422,4146,4068,83,4151,49
2021-06-18,Merced,047,269075,31182,31262,1039,32301,464
2021-06-18,Modoc,049,8938,411,402,145,547,3
2021-06-18,Mono,051,14174,1265,1275,16,1291,3
2021-06-18,Monterey,053,433212,43279,43148,1839,44987,427
2021-06-18,Napa,055,140530,9993,10021,36,10057,80
2021-06-18,Nevada,057,99092,4937,4903,193,5096,72
2021-06-18,Orange,059,3164182,256216,255274,11376,266650,5108
2021-06-18,Placer,061,380077,23713,23500,1523,25023,298
2021-06-18,Plumas,063,18699,716,697,11,708,4
2021-06-18,Riverside,065,2383286,295188,289676,13955,303631,4457
2021-06-18,Sacramento,067,1510023,107779,107570,1795,109365,1669
2021-06-18,San Benito,069,59416,6079,6097,113,6210,63
2021-06-18,San Bernardino,071,2135413,294259,293629,8969,302598,4826
2021-06-18,San Diego,073,3302833,282512,281608,15247,296855,3771
2021-06-18,San Francisco,075,870044,36992,37246,1281,38527,556
2021-06-18,San Joaquin,077,732212,73880,73623,3560,77183,1403
2021-06-18,San Luis Obispo,079,281455,21503,21301,742,22043,257
2021-06-18,San Mateo,081,765935,42600,42630,472,43102,542
2021-06-18,Santa Barbara,083,443738,34571,34469,1121,35590,455
2021-06-18,Santa Clara,085,1922200,119291,120081,760,120841,2093
2021-06-18,Santa Cruz,087,273765,16315,16202,798,17000,208
2021-06-18,Shasta,089,179085,12554,12607,1616,14223,201
2021-06-18,Sierra,091,2930,61,57,12,69,0
2021-06-18,Siskiyou,093,43540,1964,1890,362,2252,27
2021-06-18,Solano,095,438530,33322,33323,561,33884,266
2021-06-18,Sonoma,097,501317,30749,30816,354,31170,313
2021-06-18,Stanislaus,099,539301,56948,56803,5941,62744,1012
2021-06-18,Sutter,101,95872,9588,9643,87,9730,113
2021-06-18,Tehama,103,63373,5140,5114,579,5693,63
2021-06-18,Trinity,105,12862,491,337,94,431,3
2021-06-18,Tulare,107,460477,50394,49664,8971,58635,849
2021-06-18,Tuolumne,109,53932,4064,4116,43,4159,63
2021-06-18,Ventura,111,848112,81674,81256,2980,84236,1031
2021-06-18,Yolo,113,214977,14154,14148,256,14404,212
2021-06-18,Yuba,115,75493,6187,6150,129,6279,51
2021-06-17,Alameda,001,1643700,88976,89087,1935,91022,1262
2021-06-17,Alpine,003,1148,88,88,0,88,0
2021-06-17,Amador,005,37829,3733,3731,32,3763,46
2021-06-17,Butte,007,227075,12751,12644,1837,14481,194
2021-06-17,Calaveras,009,45235,2191,2189,13,2202,55
2021-06-17,Colusa,011,21464,1962,1969,318,2287,15
2021-06-17,Contra Costa,013,1133247,70655,70190,1292,71482,810
2021-06-17,Del Norte,015,27424,1446,1413,13,1426,8
2021-06-17,El Dorado,017,186661,10429,10341,761,11102,113
2021-06-17,Fresno,019,978130,103246,102867,8650,111517,1722
2021-06-17,Glenn,021,27897,2446,2430,561,2991,19
2021-06-17,Humboldt,023,135768,4448,4438,42,4480,42
2021-06-17,Imperial,025,180216,28740,28801,2693,31494,741
2021-06-17,Inyo,027,18085,1409,1405,12,1417,35
2021-06-17,Kern,029,883053,97773,96840,10964,107804,1340
2021-06-17,Kings,031,150075,23229,23078,1077,24155,245
2021-06-17,Lake,033,64148,3569,3563,9,3572,45
2021-06-17,Lassen,035,31185,5261,5223,115,5338,19
2021-06-17,Los Angeles,037,10098052,1211165,1205301,41056,1246357,24444
2021-06-17,Madera,039,155013,16750,16618,933,17551,241
2021-06-17,Marin,041,260295,14184,14141,259,14400,229
2021-06-17,Mariposa,043,17540,439,439,11,450,5
2021-06-17,Mendocino,045,87422,4139,4054,83,4137,49
2021-06-17,Merced,047,269075,31177,31262,1039,32301,464
2021-06-17,Modoc,049,8938,410,401,145,546,3
2021-06-17,Mono,051,14174,1264,1275,16,1291,3
2021-06-17,Monterey,053,433212,43271,43140,1839,44979,416
2021-06-17,Napa,055,140530,9993,10014,36,10050,80
2021-06-17,Nevada,057,99092,4933,4898,193,5091,72
2021-06-17,Orange,059,3164182,256170,255240,11365,266605,5109
2021-06-17,Placer,061,380077,23697,23461,1521,24982,298
2021-06-17,Plumas,063,18699,715,697,11,708,4
2021-06-17,Riverside,065,2383286,295134,289627,13953,303580,4458
2021-06-17,Sacramento,067,1510023,107715,107492,1793,109285,1666
2021-06-17,San Benito,069,59416,6079,6097,113,6210,63
2021-06-17,San Bernardino,071,2135413,294218,293560,8969,302529,4811
2021-06-17,San Diego,073,3302833,282436,281531,15233,296764,3771
2021-06-17,San Francisco,075,870044,36981,37243,1280,38523,556
2021-06-17,San Joaquin,077,732212,73857,73560,3555,77115,1403
2021-06-17,San Luis Obispo,079,281455,21501,21297,742,22039,257
2021-06-17,San Mateo,081,765935,42594,42615,472,43087,542
2021-06-17,Santa Barbara,083,443738,34565,34466,1121,35587,453
2021-06-17,Santa Clara,085,1922200,119266,120032,759,120791,2093
2021-06-17,Santa Cruz,087,273765,16311,16197,798,16995,208
2021-06-17,Shasta,089,179085,12546,12597,1616,14213,201
2021-06-17,Sierra,091,2930,61,56,12,68,0
2021-06-17,Siskiyou,093,43540,1963,1889,362,2251,27
2021-06-17,Solano,095,438530,33301,33296,560,33856,266
2021-06-17,Sonoma,097,501317,30719,30793,354,31147,323
2021-06-17,Stanislaus,099,539301,56917,56752,5936,62688,1012
2021-06-17,Sutter,101,95872,9585,9629,87,9716,113
2021-06-17,Tehama,103,63373,5139,5112,577,5689,63
2021-06-17,Trinity,105,12862,490,337,94,431,3
2021-06-17,Tulare,107,460477,50389,49649,8963,58612,849
2021-06-17,Tuolumne,109,53932,4063,4116,43,4159,63
2021-06-17,Ventura,111,848112,81665,81248,2977,84225,1030
2021-06-17,Yolo,113,214977,14146,14141,256,14397,212
2021-06-17,Yuba,115,75493,6178,6140,129,6269,51
2021-06-16,Alameda,001,1643700,88927,89045,1934,90979,1265
2021-06-16,Alpine,003,1148,88,88,0,88,0
2021-06-16,Amador,005,37829,3732,3730,32,3762,46
2021-06-16,Butte,007,227075,12749,12635,1835,14470,194
2021-06-16,Calaveras,009,45235,2189,2188,13,2201,55
2021-06-16,Colusa,011,21464,1962,1967,318,2285,15
2021-06-16,Contra Costa,013,1133247,70603,70136,1291,71427,810
2021-06-16,Del Norte,015,27424,1443,1413,13,1426,8
2021-06-16,El Dorado,017,186661,10423,10334,760,11094,113
2021-06-16,Fresno,019,978130,103215,102842,8646,111488,1722
2021-06-16,Glenn,021,27897,2446,2430,561,2991,19
2021-06-16,Humboldt,023,135768,4439,4427,41,4468,42
2021-06-16,Imperial,025,180216,28737,28796,2693,31489,741
2021-06-16,Inyo,027,18085,1408,1405,12,1417,35
2021-06-16,Kern,029,883053,97751,96789,10957,107746,1339
2021-06-16,Kings,031,150075,23228,23072,1076,24148,245
2021-06-16,Lake,033,64148,3569,3562,9,3571,45
2021-06-16,Lassen,035,31185,5258,5216,115,5331,19
2021-06-16,Los Angeles,037,10098052,1210942,1205102,41046,1246148,24439
2021-06-16,Madera,039,155013,16746,16603,933,17536,240
2021-06-16,Marin,041,260295,14182,14137,259,14396,229
2021-06-16,Mariposa,043,17540,439,437,11,448,5
2021-06-16,Mendocino,045,87422,4131,4041,83,4124,49
2021-06-16,Merced,047,269075,31169,31250,1039,32289,463
2021-06-16,Modoc,049,8938,409,383,144,527,3
2021-06-16,Mono,051,14174,1264,1275,16,1291,3
2021-06-16,Monterey,053,433212,43268,43122,1839,44961,416
2021-06-16,Napa,055,140530,9989,10011,36,10047,80
2021-06-16,Nevada,057,99092,4928,4894,193,5087,72
2021-06-16,Orange,059,3164182,256116,255188,11357,266545,5109
2021-06-16,Placer,061,380077,23687,23425,1517,24942,298
2021-06-16,Plumas,063,18699,715,697,11,708,4
2021-06-16,Riverside,065,2383286,295073,289539,13951,303490,4457
2021-06-16,Sacramento,067,1510023,107645,107422,1789,109211,1665
2021-06-16,San Benito,069,59416,6079,6090,113,6203,63
2021-06-16,San Bernardino,071,2135413,294169,293499,8967,302466,4797
2021-06-16,San Diego,073,3302833,282357,281423,15220,296643,3770
2021-06-16,San Francisco,075,870044,36968,37222,1278,38500,555
2021-06-16,San Joaquin,077,732212,73819,73530,3551,77081,1399
2021-06-16,San Luis Obispo,079,281455,21496,21294,742,22036,257
2021-06-16,San Mateo,081,765935,42578,42601,472,43073,542
2021-06-16,Santa Barbara,083,443738,34559,34459,1121,35580,460
2021-06-16,Santa Clara,085,1922200,119234,119982,759,120741,2087
2021-06-16,Santa Cruz,087,273765,16308,16187,798,16985,208
2021-06-16,Shasta,089,179085,12541,12592,1615,14207,200
2021-06-16,Sierra,091,2930,61,56,12,68,0
2021-06-16,Siskiyou,093,43540,1962,1886,362,2248,26
2021-06-16,Solano,095,438530,33273,33276,560,33836,266
2021-06-16,Sonoma,097,501317,30683,30741,354,31095,323
2021-06-16,Stanislaus,099,539301,56886,56738,5934,62672,984
2021-06-16,Sutter,101,95872,9581,9620,87,9707,113
2021-06-16,Tehama,103,63373,5137,5106,577,5683,63
2021-06-16,Trinity,105,12862,489,332,94,426,3
2021-06-16,Tulare,107,460477,50384,49578,8959,58537,849
2021-06-16,Tuolumne,109,53932,4063,4110,43,4153,63
2021-06-16,Ventura,111,848112,81651,81229,2975,84204,1029
2021-06-16,Yolo,113,214977,14137,14135,255,14390,212
2021-06-16,Yuba,115,75493,6168,6134,129,6263,51
2021-06-15,Alameda,001,1643700,88885,89008,1934,90942,1262
2021-06-15,Alpine,003,1148,88,88,0,88,0
2021-06-15,Amador,005,37829,3729,3723,32,3755,46
2021-06-15,Butte,007,227075,12741,12620,1834,14454,194
2021-06-15,Calaveras,009,45235,2188,2188,13,2201,55
2021-06-15,Colusa,011,21464,1962,1967,316,2283,15
2021-06-15,Contra Costa,013,1133247,70541,70101,1291,71392,810
2021-06-15,Del Norte,015,27424,1442,1411,13,1424,8
2021-06-15,El Dorado,017,186661,10414,10330,760,11090,113
2021-06-15,Fresno,019,978130,103183,102828,8645,111473,1722
2021-06-15,Glenn,021,27897,2445,2426,561,2987,19
2021-06-15,Humboldt,023,135768,4430,4414,40,4454,42
2021-06-15,Imperial,025,180216,28731,28789,2693,31482,741
2021-06-15,Inyo,027,18085,1408,1405,12,1417,35
2021-06-15,Kern,029,883053,97723,96782,10949,107731,1338
2021-06-15,Kings,031,150075,23222,23070,1074,24144,245
2021-06-15,Lake,033,64148,3568,3559,9,3568,45
2021-06-15,Lassen,035,31185,5257,5211,115,5326,19
2021-06-15,Los Angeles,037,10098052,1210717,1204926,41038,1245964,24435
2021-06-15,Madera,039,155013,16739,16600,932,17532,240
2021-06-15,Marin,041,260295,14174,14135,259,14394,229
2021-06-15,Mariposa,043,17540,439,437,11,448,5
2021-06-15,Mendocino,045,87422,4124,4034,83,4117,49
2021-06-15,Merced,047,269075,31163,31244,1039,32283,461
2021-06-15,Modoc,049,8938,408,383,144,527,3
2021-06-15,Mono,051,14174,1264,1275,16,1291,3
2021-06-15,Monterey,053,433212,43262,43118,1839,44957,416
2021-06-15,Napa,055,140530,9987,10010,36,10046,80
2021-06-15,Nevada,057,99092,4925,4888,193,5081,72
2021-06-15,Orange,059,3164182,256075,255127,11348,266475,5105
2021-06-15,Placer,061,380077,23665,23396,1516,24912,298
2021-06-15,Plumas,063,18699,714,697,11,708,4
2021-06-15,Riverside,065,2383286,295013,289508,13947,303455,4455
2021-06-15,Sacramento,067,1510023,107570,107370,1783,109153,1662
2021-06-15,San Benito,069,59416,6078,6089,113,6202,63
2021-06-15,San Bernardino,071,2135413,294119,293463,8961,302424,4790
2021-06-15,San Diego,073,3302833,282273,281375,15205,296580,3770
2021-06-15,San Francisco,075,870044,36959,37210,1277,38487,555
2021-06-15,San Joaquin,077,732212,73779,73494,3546,77040,1399
2021-06-15,San Luis Obispo,079,281455,21491,21293,741,22034,257
2021-06-15,San Mateo,081,765935,42565,42593,472,43065,543
2021-06-15,Santa Barbara,083,443738,34554,34451,1121,35572,460
2021-06-15,Santa Clara,085,1922200,119196,119963,759,120722,2086
2021-06-15,Santa Cruz,087,273765,16302,16180,797,16977,208
2021-06-15,Shasta,089,179085,12535,12583,1615,14198,201
2021-06-15,Sierra,091,2930,60,55,12,67,0
2021-06-15,Siskiyou,093,43540,1961,1887,362,2249,26
2021-06-15,Solano,095,438530,33254,33264,560,33824,266
2021-06-15,Sonoma,097,501317,30644,30707,353,31060,323
2021-06-15,Stanislaus,099,539301,56858,56724,5931,62655,979
2021-06-15,Sutter,101,95872,9572,9616,87,9703,113
2021-06-15,Tehama,103,63373,5135,5102,577,5679,63
2021-06-15,Trinity,105,12862,488,332,93,425,3
2021-06-15,Tulare,107,460477,50378,49561,8956,58517,848
2021-06-15,Tuolumne,109,53932,4063,4111,43,4154,63
2021-06-15,Ventura,111,848112,81640,81215,2972,84187,1029
2021-06-15,Yolo,113,214977,14133,14127,253,14380,212
2021-06-15,Yuba,115,75493,6157,6130,129,6259,51
2021-06-14,Alameda,001,1643700,88837,88966,1934,90900,1264
2021-06-14,Alpine,003,1148,88,88,0,88,0
2021-06-14,Amador,005,37829,3728,3722,32,3754,46
2021-06-14,Butte,007,227075,12730,12613,1830,14443,194
2021-06-14,Calaveras,009,45235,2187,2190,13,2203,55
2021-06-14,Colusa,011,21464,1961,1966,316,2282,15
2021-06-14,Contra Costa,013,1133247,70488,70069,1289,71358,810
2021-06-14,Del Norte,015,27424,1442,1411,13,1424,8
2021-06-14,El Dorado,017,186661,10405,10327,758,11085,113
2021-06-14,Fresno,019,978130,103161,102812,8643,111455,1719
2021-06-14,Glenn,021,27897,2445,2426,561,2987,19
2021-06-14,Humboldt,023,135768,4422,4407,39,4446,42
2021-06-14,Imperial,025,180216,28719,28836,2693,31529,741
2021-06-14,Inyo,027,18085,1407,1405,12,1417,35
2021-06-14,Kern,029,883053,97703,96760,10939,107699,1337
2021-06-14,Kings,031,150075,23219,23071,1073,24144,245
2021-06-14,Lake,033,64148,3567,3557,9,3566,45
2021-06-14,Lassen,035,31185,5254,5209,114,5323,19
2021-06-14,Los Angeles,037,10098052,1210475,1204748,41028,1245776,24434
2021-06-14,Madera,039,155013,16733,16597,931,17528,240
2021-06-14,Marin,041,260295,14172,14133,259,14392,229
2021-06-14,Mariposa,043,17540,438,437,11,448,5
2021-06-14,Mendocino,045,87422,4118,4028,83,4111,49
2021-06-14,Merced,047,269075,31154,31241,1038,32279,461
2021-06-14,Modoc,049,8938,399,382,142,524,3
2021-06-14,Mono,051,14174,1264,1275,16,1291,3
2021-06-14,Monterey,053,433212,43259,43110,1839,44949,415
2021-06-14,Napa,055,140530,9983,10000,36,10036,80
2021-06-14,Nevada,057,99092,4918,4885,193,5078,72
2021-06-14,Orange,059,3164182,256037,255069,11344,266413,5103
2021-06-14,Placer,061,380077,23640,23379,1515,24894,298
2021-06-14,Plumas,063,18699,714,696,11,707,4
2021-06-14,Riverside,065,2383286,294959,289476,13947,303423,4453
2021-06-14,Sacramento,067,1510023,107516,107334,1778,109112,1661
2021-06-14,San Benito,069,59416,6078,6087,113,6200,63
2021-06-14,San Bernardino,071,2135413,294063,293446,8957,302403,4790
2021-06-14,San Diego,073,3302833,282167,281314,15185,296499,3770
2021-06-14,San Francisco,075,870044,36946,37206,1277,38483,555
2021-06-14,San Joaquin,077,732212,73750,73453,3546,76999,1398
2021-06-14,San Luis Obispo,079,281455,21489,21302,741,22043,256
2021-06-14,San Mateo,081,765935,42552,42619,471,43090,543
2021-06-14,Santa Barbara,083,443738,34551,34449,1121,35570,460
2021-06-14,Santa Clara,085,1922200,119165,119957,758,120715,2085
2021-06-14,Santa Cruz,087,273765,16299,16175,797,16972,208
2021-06-14,Shasta,089,179085,12524,12561,1612,14173,201
2021-06-14,Sierra,091,2930,59,55,12,67,0
2021-06-14,Siskiyou,093,43540,1961,1886,362,2248,26
2021-06-14,Solano,095,438530,33237,33243,559,33802,266
2021-06-14,Sonoma,097,501317,30612,30679,352,31031,323
2021-06-14,Stanislaus,099,539301,56821,56689,5928,62617,975
2021-06-14,Sutter,101,95872,9569,9607,87,9694,112
2021-06-14,Tehama,103,63373,5133,5102,577,5679,63
2021-06-14,Trinity,105,12862,488,332,93,425,3
2021-06-14,Tulare,107,460477,50373,49538,8953,58491,848
2021-06-14,Tuolumne,109,53932,4060,4108,43,4151,63
2021-06-14,Ventura,111,848112,81630,81209,2972,84181,1028
2021-06-14,Yolo,113,214977,14125,14123,253,14376,212
2021-06-14,Yuba,115,75493,6150,6127,129,6256,50
2021-06-13,Alameda,001,1643700,88780,88947,1933,90880,1264
2021-06-13,Alpine,003,1148,87,88,0,88,0
2021-06-13,Amador,005,37829,3724,3721,32,3753,46
2021-06-13,Butte,007,227075,12719,12586,1827,14413,194
2021-06-13,Calaveras,009,45235,2187,2189,13,2202,55
2021-06-13,Colusa,011,21464,1961,1965,315,2280,15
2021-06-13,Contra Costa,013,1133247,70434,70040,1287,71327,810
2021-06-13,Del Norte,015,27424,1440,1412,13,1425,8
2021-06-13,El Dorado,017,186661,10396,10324,758,11082,113
2021-06-13,Fresno,019,978130,103131,102795,8638,111433,1719
2021-06-13,Glenn,021,27897,2444,2425,559,2984,19
2021-06-13,Humboldt,023,135768,4409,4401,39,4440,42
2021-06-13,Imperial,025,180216,28710,28800,2693,31493,741
2021-06-13,Inyo,027,18085,1407,1405,12,1417,35
2021-06-13,Kern,029,883053,97679,96743,10927,107670,1337
2021-06-13,Kings,031,150075,23214,23069,1072,24141,245
2021-06-13,Lake,033,64148,3567,3556,9,3565,45
2021-06-13,Lassen,035,31185,5249,5209,114,5323,19
2021-06-13,Los Angeles,037,10098052,1210208,1204614,41016,1245630,24433
2021-06-13,Madera,039,155013,16719,16590,931,17521,240
2021-06-13,Marin,041,260295,14166,14126,259,14385,229
2021-06-13,Mariposa,043,17540,438,434,11,445,5
2021-06-13,Mendocino,045,87422,4111,4026,83,4109,49
2021-06-13,Merced,047,269075,31148,31240,1037,32277,461
2021-06-13,Modoc,049,8938,397,382,140,522,3
2021-06-13,Mono,051,14174,1264,1275,16,1291,3
2021-06-13,Monterey,053,433212,43251,43108,1839,44947,415
2021-06-13,Napa,055,140530,9977,9995,36,10031,80
2021-06-13,Nevada,057,99092,4913,4883,193,5076,72
2021-06-13,Orange,059,3164182,255982,255043,11341,266384,5103
2021-06-13,Placer,061,380077,23614,23365,1513,24878,295
2021-06-13,Plumas,063,18699,713,696,11,707,4
2021-06-13,Riverside,065,2383286,294892,289447,13944,303391,4453
2021-06-13,Sacramento,067,1510023,107440,107289,1775,109064,1658
2021-06-13,San Benito,069,59416,6078,6086,113,6199,63
2021-06-13,San Bernardino,071,2135413,294011,293416,8952,302368,4788
2021-06-13,San Diego,073,3302833,282088,281268,15169,296437,3770
2021-06-13,San Francisco,075,870044,36934,37197,1277,38474,555
2021-06-13,San Joaquin,077,732212,73715,73438,3544,76982,1398
2021-06-13,San Luis Obispo,079,281455,21483,21298,740,22038,256
2021-06-13,San Mateo,081,765935,42539,42611,471,43082,542
2021-06-13,Santa Barbara,083,443738,34540,34449,1120,35569,460
2021-06-13,Santa Clara,085,1922200,119141,119946,758,120704,2085
2021-06-13,Santa Cruz,087,273765,16292,16172,797,16969,208
2021-06-13,Shasta,089,179085,12515,12560,1611,14171,201
2021-06-13,Sierra,091,2930,59,55,12,67,0
2021-06-13,Siskiyou,093,43540,1960,1885,362,2247,26
2021-06-13,Solano,095,438530,33216,33234,559,33793,266
2021-06-13,Sonoma,097,501317,30577,30663,350,31013,323
2021-06-13,Stanislaus,099,539301,56795,56671,5925,62596,975
2021-06-13,Sutter,101,95872,9562,9603,87,9690,112
2021-06-13,Tehama,103,63373,5131,5100,577,5677,63
2021-06-13,Trinity,105,12862,487,332,93,425,3
2021-06-13,Tulare,107,460477,50364,49537,8948,58485,848
2021-06-13,Tuolumne,109,53932,4058,4107,42,4149,63
2021-06-13,Ventura,111,848112,81616,81201,2972,84173,1028
2021-06-13,Yolo,113,214977,14116,14120,251,14371,212
2021-06-13,Yuba,115,75493,6143,6125,129,6254,50
2021-06-12,Alameda,001,1643700,88752,88901,1933,90834,1271
2021-06-12,Alpine,003,1148,87,88,0,88,0
2021-06-12,Amador,005,37829,3723,3721,32,3753,46
2021-06-12,Butte,007,227075,12715,12576,1827,14403,194
2021-06-12,Calaveras,009,45235,2187,2189,13,2202,55
2021-06-12,Colusa,011,21464,1961,1965,315,2280,15
2021-06-12,Contra Costa,013,1133247,70403,69989,1285,71274,810
2021-06-12,Del Norte,015,27424,1440,1412,13,1425,8
2021-06-12,El Dorado,017,186661,10391,10320,757,11077,113
2021-06-12,Fresno,019,978130,103121,102783,8637,111420,1720
2021-06-12,Glenn,021,27897,2442,2425,559,2984,19
2021-06-12,Humboldt,023,135768,4401,4396,39,4435,42
2021-06-12,Imperial,025,180216,28707,28799,2693,31492,741
2021-06-12,Inyo,027,18085,1407,1405,12,1417,35
2021-06-12,Kern,029,883053,97664,96731,10923,107654,1337
2021-06-12,Kings,031,150075,23212,23067,1072,24139,245
2021-06-12,Lake,033,64148,3566,3552,9,3561,45
2021-06-12,Lassen,035,31185,5249,5208,114,5322,19
2021-06-12,Los Angeles,037,10098052,1210067,1204439,41010,1245449,24434
2021-06-12,Madera,039,155013,16715,16586,931,17517,240
2021-06-12,Marin,041,260295,14163,14121,259,14380,229
2021-06-12,Mariposa,043,17540,438,434,11,445,5
2021-06-12,Mendocino,045,87422,4108,4024,83,4107,49
2021-06-12,Merced,047,269075,31145,31236,1037,32273,461
2021-06-12,Modoc,049,8938,396,382,140,522,3
2021-06-12,Mono,051,14174,1264,1275,16,1291,3
2021-06-12,Monterey,053,433212,43246,43103,1839,44942,415
2021-06-12,Napa,055,140530,9973,9986,36,10022,80
2021-06-12,Nevada,057,99092,4907,4878,193,5071,72
2021-06-12,Orange,059,3164182,255949,255004,11339,266343,5103
2021-06-12,Placer,061,380077,23595,23345,1513,24858,295
2021-06-12,Plumas,063,18699,713,696,11,707,4
2021-06-12,Riverside,065,2383286,294850,289413,13941,303354,4453
2021-06-12,Sacramento,067,1510023,107381,107199,1772,108971,1658
2021-06-12,San Benito,069,59416,6076,6083,113,6196,63
2021-06-12,San Bernardino,071,2135413,293976,293375,8950,302325,4788
2021-06-12,San Diego,073,3302833,282031,281203,15160,296363,3770
2021-06-12,San Francisco,075,870044,36924,37189,1277,38466,555
2021-06-12,San Joaquin,077,732212,73696,73413,3543,76956,1398
2021-06-12,San Luis Obispo,079,281455,21480,21293,740,22033,256
2021-06-12,San Mateo,081,765935,42533,42604,471,43075,542
2021-06-12,Santa Barbara,083,443738,34535,34450,1120,35570,460
2021-06-12,Santa Clara,085,1922200,119101,119894,758,120652,2085
2021-06-12,Santa Cruz,087,273765,16284,16170,797,16967,208
2021-06-12,Shasta,089,179085,12512,12556,1610,14166,201
2021-06-12,Sierra,091,2930,59,55,12,67,0
2021-06-12,Siskiyou,093,43540,1959,1884,362,2246,25
2021-06-12,Solano,095,438530,33207,33219,559,33778,266
2021-06-12,Sonoma,097,501317,30548,30647,350,30997,323
2021-06-12,Stanislaus,099,539301,56778,56649,5924,62573,974
2021-06-12,Sutter,101,95872,9558,9603,87,9690,112
2021-06-12,Tehama,103,63373,5131,5099,576,5675,63
2021-06-12,Trinity,105,12862,487,332,93,425,3
2021-06-12,Tulare,107,460477,50359,49533,8941,58474,848
2021-06-12,Tuolumne,109,53932,4057,4105,42,4147,63
2021-06-12,Ventura,111,848112,81604,81197,2972,84169,1028
2021-06-12,Yolo,113,214977,14113,14118,250,14368,212
2021-06-12,Yuba,115,75493,6138,6120,129,6249,50
2021-06-11,Alameda,001,1643700,88724,88844,1933,90777,1278
2021-06-11,Alpine,003,1148,87,88,0,88,0
2021-06-11,Amador,005,37829,3722,3710,32,3742,46
2021-06-11,Butte,007,227075,12711,12576,1825,14401,194
2021-06-11,Calaveras,009,45235,2187,2188,13,2201,55
2021-06-11,Colusa,011,21464,1960,1964,315,2279,15
2021-06-11,Contra Costa,013,1133247,70370,69940,1283,71223,808
2021-06-11,Del Norte,015,27424,1440,1409,13,1422,8
2021-06-11,El Dorado,017,186661,10388,10316,757,11073,113
2021-06-11,Fresno,019,978130,103102,102770,8636,111406,1720
2021-06-11,Glenn,021,27897,2442,2425,559,2984,19
2021-06-11,Humboldt,023,135768,4397,4389,39,4428,42
2021-06-11,Imperial,025,180216,28702,28793,2693,31486,741
2021-06-11,Inyo,027,18085,1407,1405,12,1417,35
2021-06-11,Kern,029,883053,97652,96718,10920,107638,1340
2021-06-11,Kings,031,150075,23208,23069,1071,24140,245
2021-06-11,Lake,033,64148,3565,3550,9,3559,45
2021-06-11,Lassen,035,31185,5248,5204,114,5318,18
2021-06-11,Los Angeles,037,10098052,1209917,1204259,40995,1245254,24434
2021-06-11,Madera,039,155013,16712,16582,931,17513,240
2021-06-11,Marin,041,260295,14160,14116,259,14375,229
2021-06-11,Mariposa,043,17540,438,434,11,445,5
2021-06-11,Mendocino,045,87422,4105,4022,83,4105,49
2021-06-11,Merced,047,269075,31140,31231,1037,32268,461
2021-06-11,Modoc,049,8938,396,382,139,521,3
2021-06-11,Mono,051,14174,1264,1274,16,1290,3
2021-06-11,Monterey,053,433212,43242,43097,1839,44936,415
2021-06-11,Napa,055,140530,9970,9977,36,10013,80
2021-06-11,Nevada,057,99092,4905,4873,193,5066,72
2021-06-11,Orange,059,3164182,255915,254975,11336,266311,5101
2021-06-11,Placer,061,380077,23590,23330,1513,24843,294
2021-06-11,Plumas,063,18699,713,696,11,707,4
2021-06-11,Riverside,065,2383286,294812,289376,13936,303312,4451
2021-06-11,Sacramento,067,1510023,107321,107119,1771,108890,1659
2021-06-11,San Benito,069,59416,6075,6082,113,6195,63
2021-06-11,San Bernardino,071,2135413,293940,293335,8946,302281,4788
2021-06-11,San Diego,073,3302833,281991,281144,15153,296297,3768
2021-06-11,San Francisco,075,870044,36919,37177,1277,38454,555
2021-06-11,San Joaquin,077,732212,73679,73347,3540,76887,1397
2021-06-11,San Luis Obispo,079,281455,21479,21288,740,22028,256
2021-06-11,San Mateo,081,765935,42519,42585,471,43056,542
2021-06-11,Santa Barbara,083,443738,34532,34438,1120,35558,460
2021-06-11,Santa Clara,085,1922200,119081,119860,758,120618,2083
2021-06-11,Santa Cruz,087,273765,16276,16164,797,16961,208
2021-06-11,Shasta,089,179085,12504,12550,1608,14158,201
2021-06-11,Sierra,091,2930,59,55,12,67,0
2021-06-11,Siskiyou,093,43540,1958,1882,362,2244,25
2021-06-11,Solano,095,438530,33187,33179,558,33737,266
2021-06-11,Sonoma,097,501317,30530,30624,350,30974,323
2021-06-11,Stanislaus,099,539301,56752,56617,5920,62537,974
2021-06-11,Sutter,101,95872,9555,9600,86,9686,112
2021-06-11,Tehama,103,63373,5130,5099,576,5675,63
2021-06-11,Trinity,105,12862,487,331,93,424,3
2021-06-11,Tulare,107,460477,50353,49516,8940,58456,848
2021-06-11,Tuolumne,109,53932,4054,4104,42,4146,63
2021-06-11,Ventura,111,848112,81594,81189,2972,84161,1026
2021-06-11,Yolo,113,214977,14106,14111,246,14357,212
2021-06-11,Yuba,115,75493,6134,6113,129,6242,50
2021-06-10,Alameda,001,1643700,88680,88806,1932,90738,1275
2021-06-10,Alpine,003,1148,87,88,0,88,0
2021-06-10,Amador,005,37829,3718,3709,32,3741,46
2021-06-10,Butte,007,227075,12694,12565,1825,14390,194
2021-06-10,Calaveras,009,45235,2186,2188,13,2201,55
2021-06-10,Colusa,011,21464,1958,1964,315,2279,15
2021-06-10,Contra Costa,013,1133247,70316,69876,1283,71159,807
2021-06-10,Del Norte,015,27424,1440,1405,13,1418,8
2021-06-10,El Dorado,017,186661,10381,10314,753,11067,113
2021-06-10,Fresno,019,978130,103076,102724,8635,111359,1717
2021-06-10,Glenn,021,27897,2442,2425,559,2984,19
2021-06-10,Humboldt,023,135768,4389,4384,39,4423,42
2021-06-10,Imperial,025,180216,28696,28779,2693,31472,739
2021-06-10,Inyo,027,18085,1407,1405,12,1417,35
2021-06-10,Kern,029,883053,97638,96706,10915,107621,1336
2021-06-10,Kings,031,150075,23207,23067,1071,24138,245
2021-06-10,Lake,033,64148,3560,3550,9,3559,45
2021-06-10,Lassen,035,31185,5246,5201,114,5315,18
2021-06-10,Los Angeles,037,10098052,1209752,1204110,40979,1245089,24440
2021-06-10,Madera,039,155013,16705,16581,930,17511,240
2021-06-10,Marin,041,260295,14157,14118,259,14377,229
2021-06-10,Mariposa,043,17540,436,434,11,445,5
2021-06-10,Mendocino,045,87422,4100,4016,83,4099,48
2021-06-10,Merced,047,269075,31132,31231,1034,32265,461
2021-06-10,Modoc,049,8938,395,381,139,520,3
2021-06-10,Mono,051,14174,1263,1274,16,1290,3
2021-06-10,Monterey,053,433212,43236,43090,1839,44929,415
2021-06-10,Napa,055,140530,9969,9974,36,10010,80
2021-06-10,Nevada,057,99092,4900,4866,193,5059,72
2021-06-10,Orange,059,3164182,255885,254950,11329,266279,5097
2021-06-10,Placer,061,380077,23577,23296,1513,24809,293
2021-06-10,Plumas,063,18699,713,696,11,707,4
2021-06-10,Riverside,065,2383286,294770,289335,13931,303266,4450
2021-06-10,Sacramento,067,1510023,107259,107049,1771,108820,1658
2021-06-10,San Benito,069,59416,6075,6079,113,6192,63
2021-06-10,San Bernardino,071,2135413,293899,293281,8943,302224,4782
2021-06-10,San Diego,073,3302833,281933,281052,15136,296188,3766
2021-06-10,San Francisco,075,870044,36909,37159,1275,38434,552
2021-06-10,San Joaquin,077,732212,73645,73276,3539,76815,1393
2021-06-10,San Luis Obispo,079,281455,21476,21280,740,22020,256
2021-06-10,San Mateo,081,765935,42512,42562,471,43033,666
2021-06-10,Santa Barbara,083,443738,34528,34434,1120,35554,460
2021-06-10,Santa Clara,085,1922200,119046,119832,757,120589,2075
2021-06-10,Santa Cruz,087,273765,16275,16159,797,16956,208
2021-06-10,Shasta,089,179085,12494,12536,1608,14144,201
2021-06-10,Sierra,091,2930,58,55,12,67,0
2021-06-10,Siskiyou,093,43540,1958,1881,362,2243,25
2021-06-10,Solano,095,438530,33170,33150,557,33707,265
2021-06-10,Sonoma,097,501317,30494,30571,348,30919,323
2021-06-10,Stanislaus,099,539301,56731,56588,5916,62504,974
2021-06-10,Sutter,101,95872,9548,9594,86,9680,112
2021-06-10,Tehama,103,63373,5130,5096,576,5672,63
2021-06-10,Trinity,105,12862,487,331,93,424,3
2021-06-10,Tulare,107,460477,50345,49503,8940,58443,848
2021-06-10,Tuolumne,109,53932,4054,4100,42,4142,63
2021-06-10,Ventura,111,848112,81583,81172,2971,84143,1026
2021-06-10,Yolo,113,214977,14103,14107,246,14353,212
2021-06-10,Yuba,115,75493,6130,6112,129,6241,50
2021-06-09,Alameda,001,1643700,88636,88762,1931,90693,1271
2021-06-09,Alpine,003,1148,87,88,0,88,0
2021-06-09,Amador,005,37829,3714,3706,32,3738,46
2021-06-09,Butte,007,227075,12688,12555,1823,14378,194
2021-06-09,Calaveras,009,45235,2184,2184,13,2197,55
2021-06-09,Colusa,011,21464,1958,1962,314,2276,15
2021-06-09,Contra Costa,013,1133247,70279,69829,1282,71111,803
2021-06-09,Del Norte,015,27424,1436,1403,13,1416,8
2021-06-09,El Dorado,017,186661,10378,10312,752,11064,113
2021-06-09,Fresno,019,978130,103056,102690,8631,111321,1717
2021-06-09,Glenn,021,27897,2441,2424,559,2983,19
2021-06-09,Humboldt,023,135768,4384,4379,38,4417,42
2021-06-09,Imperial,025,180216,28693,28754,2693,31447,739
2021-06-09,Inyo,027,18085,1407,1405,12,1417,35
2021-06-09,Kern,029,883053,97624,96697,10906,107603,1328
2021-06-09,Kings,031,150075,23205,23061,1071,24132,245
2021-06-09,Lake,033,64148,3557,3541,9,3550,45
2021-06-09,Lassen,035,31185,5245,5200,114,5314,18
2021-06-09,Los Angeles,037,10098052,1209564,1203955,40966,1244921,24432
2021-06-09,Madera,039,155013,16700,16580,930,17510,240
2021-06-09,Marin,041,260295,14152,14114,259,14373,229
2021-06-09,Mariposa,043,17540,436,434,11,445,5
2021-06-09,Mendocino,045,87422,4094,4008,83,4091,47
2021-06-09,Merced,047,269075,31128,31225,1034,32259,461
2021-06-09,Modoc,049,8938,393,377,138,515,3
2021-06-09,Mono,051,14174,1263,1274,16,1290,3
2021-06-09,Monterey,053,433212,43229,43082,1839,44921,415
2021-06-09,Napa,055,140530,9963,9971,36,10007,80
2021-06-09,Nevada,057,99092,4890,4863,192,5055,72
2021-06-09,Orange,059,3164182,255841,254893,11324,266217,5080
2021-06-09,Placer,061,380077,23558,23237,1513,24750,293
2021-06-09,Plumas,063,18699,712,697,11,708,4
2021-06-09,Riverside,065,2383286,294724,289299,13929,303228,4450
2021-06-09,Sacramento,067,1510023,107196,106971,1768,108739,1657
2021-06-09,San Benito,069,59416,6072,6078,113,6191,63
2021-06-09,San Bernardino,071,2135413,293857,293222,8943,302165,4782
2021-06-09,San Diego,073,3302833,281869,280941,15124,296065,3765
2021-06-09,San Francisco,075,870044,36896,37143,1274,38417,552
2021-06-09,San Joaquin,077,732212,73619,73232,3539,76771,1392
2021-06-09,San Luis Obispo,079,281455,21475,21259,740,21999,256
2021-06-09,San Mateo,081,765935,42496,42502,470,42972,666
2021-06-09,Santa Barbara,083,443738,34517,34422,1120,35542,460
2021-06-09,Santa Clara,085,1922200,119008,119793,756,120549,2068
2021-06-09,Santa Cruz,087,273765,16272,16155,797,16952,208
2021-06-09,Shasta,089,179085,12484,12521,1606,14127,201
2021-06-09,Sierra,091,2930,57,55,12,67,0
2021-06-09,Siskiyou,093,43540,1957,1871,362,2233,25
2021-06-09,Solano,095,438530,33154,33137,556,33693,264
2021-06-09,Sonoma,097,501317,30472,30540,348,30888,323
2021-06-09,Stanislaus,099,539301,56711,56560,5913,62473,974
2021-06-09,Sutter,101,95872,9539,9586,85,9671,111
2021-06-09,Tehama,103,63373,5129,5093,576,5669,63
2021-06-09,Trinity,105,12862,486,331,93,424,3
2021-06-09,Tulare,107,460477,50341,49496,8938,58434,847
2021-06-09,Tuolumne,109,53932,4051,4100,42,4142,63
2021-06-09,Ventura,111,848112,81573,81154,2970,84124,1026
2021-06-09,Yolo,113,214977,14101,14102,245,14347,212
2021-06-09,Yuba,115,75493,6126,6109,129,6238,50
2021-06-08,Alameda,001,1643700,88588,88731,1931,90662,1267
2021-06-08,Alpine,003,1148,87,88,0,88,0
2021-06-08,Amador,005,37829,3713,3704,32,3736,46
2021-06-08,Butte,007,227075,12682,12540,1821,14361,194
2021-06-08,Calaveras,009,45235,2183,2181,13,2194,55
2021-06-08,Colusa,011,21464,1958,1961,314,2275,15
2021-06-08,Contra Costa,013,1133247,70231,69762,1281,71043,803
2021-06-08,Del Norte,015,27424,1434,1402,13,1415,8
2021-06-08,El Dorado,017,186661,10373,10306,750,11056,113
2021-06-08,Fresno,019,978130,103031,102680,8629,111309,1717
2021-06-08,Glenn,021,27897,2440,2423,559,2982,19
2021-06-08,Humboldt,023,135768,4379,4363,38,4401,42
2021-06-08,Imperial,025,180216,28684,28752,2693,31445,738
2021-06-08,Inyo,027,18085,1407,1405,12,1417,35
2021-06-08,Kern,029,883053,97605,96671,10899,107570,1325
2021-06-08,Kings,031,150075,23204,23036,1071,24107,245
2021-06-08,Lake,033,64148,3556,3540,9,3549,45
2021-06-08,Lassen,035,31185,5245,5200,114,5314,18
2021-06-08,Los Angeles,037,10098052,1209366,1203794,40954,1244748,24426
2021-06-08,Madera,039,155013,16694,16579,929,17508,240
2021-06-08,Marin,041,260295,14150,14111,258,14369,229
2021-06-08,Mariposa,043,17540,436,434,11,445,5
2021-06-08,Mendocino,045,87422,4087,4002,83,4085,47
2021-06-08,Merced,047,269075,31120,31225,1034,32259,461
2021-06-08,Modoc,049,8938,387,377,137,514,3
2021-06-08,Mono,051,14174,1263,1274,16,1290,3
2021-06-08,Monterey,053,433212,43223,43078,1838,44916,415
2021-06-08,Napa,055,140530,9959,9962,36,9998,80
2021-06-08,Nevada,057,99092,4885,4861,192,5053,72
2021-06-08,Orange,059,3164182,255799,254852,11317,266169,5078
2021-06-08,Placer,061,380077,23540,23209,1509,24718,293
2021-06-08,Plumas,063,18699,712,692,11,703,4
2021-06-08,Riverside,065,2383286,294688,289268,13921,303189,4452
2021-06-08,Sacramento,067,1510023,107134,106901,1765,108666,1654
2021-06-08,San Benito,069,59416,6070,6076,113,6189,63
2021-06-08,San Bernardino,071,2135413,293808,293186,8939,302125,4778
2021-06-08,San Diego,073,3302833,281806,280879,15115,295994,3764
2021-06-08,San Francisco,075,870044,36881,37134,1273,38407,552
2021-06-08,San Joaquin,077,732212,73575,73186,3534,76720,1390
2021-06-08,San Luis Obispo,079,281455,21469,21251,739,21990,255
2021-06-08,San Mateo,081,765935,42483,42488,470,42958,663
2021-06-08,Santa Barbara,083,443738,34513,34418,1120,35538,459
2021-06-08,Santa Clara,085,1922200,118987,119770,755,120525,2068
2021-06-08,Santa Cruz,087,273765,16269,16160,797,16957,208
2021-06-08,Shasta,089,179085,12469,12498,1606,14104,201
2021-06-08,Sierra,091,2930,57,55,12,67,0
2021-06-08,Siskiyou,093,43540,1955,1870,360,2230,21
2021-06-08,Solano,095,438530,33133,33130,556,33686,259
2021-06-08,Sonoma,097,501317,30446,30523,346,30869,323
2021-06-08,Stanislaus,099,539301,56684,56548,5911,62459,973
2021-06-08,Sutter,101,95872,9536,9581,85,9666,111
2021-06-08,Tehama,103,63373,5126,5093,576,5669,63
2021-06-08,Trinity,105,12862,486,330,92,422,3
2021-06-08,Tulare,107,460477,50329,49485,8934,58419,847
2021-06-08,Tuolumne,109,53932,4047,4099,42,4141,63
2021-06-08,Ventura,111,848112,81557,81142,2969,84111,1026
2021-06-08,Yolo,113,214977,14096,14099,244,14343,212
2021-06-08,Yuba,115,75493,6124,6103,129,6232,50
2021-06-07,Alameda,001,1643700,88531,88688,1931,90619,1267
2021-06-07,Alpine,003,1148,87,88,0,88,0
2021-06-07,Amador,005,37829,3703,3697,32,3729,46
2021-06-07,Butte,007,227075,12675,12533,1820,14353,194
2021-06-07,Calaveras,009,45235,2182,2181,13,2194,55
2021-06-07,Colusa,011,21464,1957,1960,314,2274,15
2021-06-07,Contra Costa,013,1133247,70174,69718,1280,70998,817
2021-06-07,Del Norte,015,27424,1434,1401,13,1414,8
2021-06-07,El Dorado,017,186661,10368,10305,750,11055,113
2021-06-07,Fresno,019,978130,103000,102659,8621,111280,1717
2021-06-07,Glenn,021,27897,2440,2423,559,2982,19
2021-06-07,Humboldt,023,135768,4371,4354,38,4392,42
2021-06-07,Imperial,025,180216,28682,28754,2693,31447,738
2021-06-07,Inyo,027,18085,1407,1404,12,1416,35
2021-06-07,Kern,029,883053,97589,96645,10892,107537,1324
2021-06-07,Kings,031,150075,23200,23023,1071,24094,244
2021-06-07,Lake,033,64148,3554,3540,9,3549,45
2021-06-07,Lassen,035,31185,5240,5198,114,5312,18
2021-06-07,Los Angeles,037,10098052,1209142,1203664,40940,1244604,24413
2021-06-07,Madera,039,155013,16687,16572,929,17501,240
2021-06-07,Marin,041,260295,14146,14108,257,14365,229
2021-06-07,Mariposa,043,17540,436,434,11,445,5
2021-06-07,Mendocino,045,87422,4081,3998,83,4081,47
2021-06-07,Merced,047,269075,31108,31212,1033,32245,459
2021-06-07,Modoc,049,8938,386,375,134,509,3
2021-06-07,Mono,051,14174,1263,1275,16,1291,3
2021-06-07,Monterey,053,433212,43216,43077,1838,44915,415
2021-06-07,Napa,055,140530,9951,9962,36,9998,80
2021-06-07,Nevada,057,99092,4883,4860,192,5052,72
2021-06-07,Orange,059,3164182,255759,254808,11309,266117,5073
2021-06-07,Placer,061,380077,23521,23176,1507,24683,293
2021-06-07,Plumas,063,18699,712,692,11,703,4
2021-06-07,Riverside,065,2383286,294645,289232,13917,303149,4451
2021-06-07,Sacramento,067,1510023,107058,106841,1762,108603,1655
2021-06-07,San Benito,069,59416,6069,6074,113,6187,63
2021-06-07,San Bernardino,071,2135413,293770,293129,8938,302067,4775
2021-06-07,San Diego,073,3302833,281724,280808,15102,295910,3764
2021-06-07,San Francisco,075,870044,36865,37122,1273,38395,552
2021-06-07,San Joaquin,077,732212,73530,73130,3527,76657,1388
2021-06-07,San Luis Obispo,079,281455,21456,21252,739,21991,255
2021-06-07,San Mateo,081,765935,42467,42479,470,42949,664
2021-06-07,Santa Barbara,083,443738,34507,34407,1120,35527,459
2021-06-07,Santa Clara,085,1922200,118955,119743,755,120498,2066
2021-06-07,Santa Cruz,087,273765,16268,16159,797,16956,208
2021-06-07,Shasta,089,179085,12455,12483,1601,14084,200
2021-06-07,Sierra,091,2930,57,55,12,67,0
2021-06-07,Siskiyou,093,43540,1955,1869,360,2229,21
2021-06-07,Solano,095,438530,33111,33124,555,33679,258
2021-06-07,Sonoma,097,501317,30410,30504,345,30849,323
2021-06-07,Stanislaus,099,539301,56651,56521,5909,62430,972
2021-06-07,Sutter,101,95872,9532,9571,85,9656,111
2021-06-07,Tehama,103,63373,5122,5092,574,5666,63
2021-06-07,Trinity,105,12862,486,329,92,421,3
2021-06-07,Tulare,107,460477,50323,49471,8934,58405,847
2021-06-07,Tuolumne,109,53932,4046,4098,42,4140,63
2021-06-07,Ventura,111,848112,81540,81137,2967,84104,1025
2021-06-07,Yolo,113,214977,14091,14097,243,14340,211
2021-06-07,Yuba,115,75493,6122,6099,126,6225,49
2021-06-06,Alameda,001,1643700,88493,88636,1930,90566,1267
2021-06-06,Alpine,003,1148,87,88,0,88,0
2021-06-06,Amador,005,37829,3700,3696,32,3728,46
2021-06-06,Butte,007,227075,12664,12527,1819,14346,194
2021-06-06,Calaveras,009,45235,2181,2181,13,2194,55
2021-06-06,Colusa,011,21464,1955,1959,314,2273,15
2021-06-06,Contra Costa,013,1133247,70109,69659,1278,70937,817
2021-06-06,Del Norte,015,27424,1429,1401,13,1414,8
2021-06-06,El Dorado,017,186661,10361,10294,750,11044,113
2021-06-06,Fresno,019,978130,102967,102642,8618,111260,1717
2021-06-06,Glenn,021,27897,2439,2423,559,2982,19
2021-06-06,Humboldt,023,135768,4360,4353,38,4391,42
2021-06-06,Imperial,025,180216,28676,28762,2693,31455,738
2021-06-06,Inyo,027,18085,1406,1404,12,1416,35
2021-06-06,Kern,029,883053,97571,96623,10885,107508,1324
2021-06-06,Kings,031,150075,23194,23021,1071,24092,244
2021-06-06,Lake,033,64148,3554,3535,9,3544,45
2021-06-06,Lassen,035,31185,5238,5191,114,5305,18
2021-06-06,Los Angeles,037,10098052,1208943,1203539,40926,1244465,24410
2021-06-06,Madera,039,155013,16680,16567,929,17496,240
2021-06-06,Marin,041,260295,14140,14106,256,14362,229
2021-06-06,Mariposa,043,17540,435,435,11,446,5
2021-06-06,Mendocino,045,87422,4077,3993,83,4076,47
2021-06-06,Merced,047,269075,31102,31215,1032,32247,459
2021-06-06,Modoc,049,8938,386,375,133,508,3
2021-06-06,Mono,051,14174,1263,1275,16,1291,3
2021-06-06,Monterey,053,433212,43211,43078,1838,44916,415
2021-06-06,Napa,055,140530,9945,9963,36,9999,80
2021-06-06,Nevada,057,99092,4876,4854,191,5045,72
2021-06-06,Orange,059,3164182,255723,254782,11304,266086,5073
2021-06-06,Placer,061,380077,23496,23156,1504,24660,293
2021-06-06,Plumas,063,18699,712,692,11,703,4
2021-06-06,Riverside,065,2383286,294606,289201,13911,303112,4451
2021-06-06,Sacramento,067,1510023,106972,106749,1761,108510,1655
2021-06-06,San Benito,069,59416,6063,6074,113,6187,63
2021-06-06,San Bernardino,071,2135413,293714,293117,8929,302046,4773
2021-06-06,San Diego,073,3302833,281644,280743,15085,295828,3764
2021-06-06,San Francisco,075,870044,36852,37118,1271,38389,552
2021-06-06,San Joaquin,077,732212,73498,73105,3523,76628,1388
2021-06-06,San Luis Obispo,079,281455,21453,21246,739,21985,255
2021-06-06,San Mateo,081,765935,42450,42457,470,42927,664
2021-06-06,Santa Barbara,083,443738,34503,34403,1119,35522,459
2021-06-06,Santa Clara,085,1922200,118933,119711,755,120466,2066
2021-06-06,Santa Cruz,087,273765,16267,16158,797,16955,208
2021-06-06,Shasta,089,179085,12440,12478,1598,14076,200
2021-06-06,Sierra,091,2930,57,55,12,67,0
2021-06-06,Siskiyou,093,43540,1952,1869,360,2229,21
2021-06-06,Solano,095,438530,33084,33093,555,33648,258
2021-06-06,Sonoma,097,501317,30379,30478,344,30822,323
2021-06-06,Stanislaus,099,539301,56615,56486,5906,62392,972
2021-06-06,Sutter,101,95872,9525,9567,85,9652,111
2021-06-06,Tehama,103,63373,5112,5092,572,5664,63
2021-06-06,Trinity,105,12862,486,328,92,420,3
2021-06-06,Tulare,107,460477,50315,49466,8929,58395,847
2021-06-06,Tuolumne,109,53932,4043,4097,42,4139,63
2021-06-06,Ventura,111,848112,81529,81130,2964,84094,1025
2021-06-06,Yolo,113,214977,14083,14089,242,14331,210
2021-06-06,Yuba,115,75493,6114,6096,126,6222,49
2021-06-05,Alameda,001,1643700,88460,88612,1930,90542,1268
2021-06-05,Alpine,003,1148,87,88,0,88,0
2021-06-05,Amador,005,37829,3700,3694,32,3726,46
2021-06-05,Butte,007,227075,12658,12514,1818,14332,194
2021-06-05,Calaveras,009,45235,2181,2181,13,2194,55
2021-06-05,Colusa,011,21464,1955,1959,314,2273,15
2021-06-05,Contra Costa,013,1133247,70080,69601,1278,70879,817
2021-06-05,Del Norte,015,27424,1429,1400,13,1413,8
2021-06-05,El Dorado,017,186661,10359,10288,749,11037,113
2021-06-05,Fresno,019,978130,102958,102626,8618,111244,1717
2021-06-05,Glenn,021,27897,2438,2423,559,2982,19
2021-06-05,Humboldt,023,135768,4355,4346,38,4384,42
2021-06-05,Imperial,025,180216,28673,28764,2693,31457,738
2021-06-05,Inyo,027,18085,1406,1405,12,1417,35
2021-06-05,Kern,029,883053,97558,96597,10881,107478,1324
2021-06-05,Kings,031,150075,23191,23017,1071,24088,244
2021-06-05,Lake,033,64148,3551,3534,9,3543,45
2021-06-05,Lassen,035,31185,5237,5191,114,5305,18
2021-06-05,Los Angeles,037,10098052,1208814,1203338,40915,1244253,24411
2021-06-05,Madera,039,155013,16676,16563,929,17492,240
2021-06-05,Marin,041,260295,14138,14101,256,14357,229
2021-06-05,Mariposa,043,17540,435,435,11,446,5
2021-06-05,Mendocino,045,87422,4074,3989,83,4072,47
2021-06-05,Merced,047,269075,31100,31212,1031,32243,459
2021-06-05,Modoc,049,8938,386,375,132,507,3
2021-06-05,Mono,051,14174,1263,1274,16,1290,3
2021-06-05,Monterey,053,433212,43207,43071,1837,44908,415
2021-06-05,Napa,055,140530,9940,9960,36,9996,80
2021-06-05,Nevada,057,99092,4874,4849,191,5040,72
2021-06-05,Orange,059,3164182,255699,254752,11301,266053,5069
2021-06-05,Placer,061,380077,23480,23133,1504,24637,293
2021-06-05,Plumas,063,18699,712,692,11,703,4
2021-06-05,Riverside,065,2383286,294571,289157,13907,303064,4451
2021-06-05,Sacramento,067,1510023,106920,106688,1759,108447,1655
2021-06-05,San Benito,069,59416,6061,6074,113,6187,63
2021-06-05,San Bernardino,071,2135413,293681,293081,8928,302009,4772
2021-06-05,San Diego,073,3302833,281603,280676,15072,295748,3764
2021-06-05,San Francisco,075,870044,36843,37111,1271,38382,552
2021-06-05,San Joaquin,077,732212,73482,73078,3517,76595,1388
2021-06-05,San Luis Obispo,079,281455,21450,21236,739,21975,255
2021-06-05,San Mateo,081,765935,42440,42433,470,42903,664
2021-06-05,Santa Barbara,083,443738,34500,34399,1118,35517,459
2021-06-05,Santa Clara,085,1922200,118911,119676,753,120429,2066
2021-06-05,Santa Cruz,087,273765,16267,16154,797,16951,208
2021-06-05,Shasta,089,179085,12430,12472,1597,14069,200
2021-06-05,Sierra,091,2930,57,55,12,67,0
2021-06-05,Siskiyou,093,43540,1952,1867,360,2227,21
2021-06-05,Solano,095,438530,33069,33074,555,33629,257
2021-06-05,Sonoma,097,501317,30352,30450,342,30792,323
2021-06-05,Stanislaus,099,539301,56607,56463,5904,62367,973
2021-06-05,Sutter,101,95872,9522,9559,85,9644,111
2021-06-05,Tehama,103,63373,5111,5092,571,5663,63
2021-06-05,Trinity,105,12862,486,328,92,420,3
2021-06-05,Tulare,107,460477,50309,49463,8929,58392,847
2021-06-05,Tuolumne,109,53932,4041,4098,42,4140,63
2021-06-05,Ventura,111,848112,81520,81119,2962,84081,1025
2021-06-05,Yolo,113,214977,14081,14088,242,14330,210
2021-06-05,Yuba,115,75493,6113,6087,126,6213,49
2021-06-04,Alameda,001,1643700,88433,88585,1927,90512,1263
2021-06-04,Alpine,003,1148,87,88,0,88,0
2021-06-04,Amador,005,37829,3700,3690,32,3722,46
2021-06-04,Butte,007,227075,12647,12494,1815,14309,193
2021-06-04,Calaveras,009,45235,2181,2179,13,2192,55
2021-06-04,Colusa,011,21464,1955,1959,314,2273,15
2021-06-04,Contra Costa,013,1133247,70045,69540,1275,70815,816
2021-06-04,Del Norte,015,27424,1429,1398,13,1411,8
2021-06-04,El Dorado,017,186661,10355,10284,747,11031,112
2021-06-04,Fresno,019,978130,102942,102601,8618,111219,1712
2021-06-04,Glenn,021,27897,2438,2423,558,2981,19
2021-06-04,Humboldt,023,135768,4350,4327,38,4365,42
2021-06-04,Imperial,025,180216,28669,28753,2693,31446,738
2021-06-04,Inyo,027,18085,1406,1404,12,1416,35
2021-06-04,Kern,029,883053,97540,96573,10879,107452,1327
2021-06-04,Kings,031,150075,23190,23002,1071,24073,244
2021-06-04,Lake,033,64148,3549,3528,9,3537,45
2021-06-04,Lassen,035,31185,5237,5180,114,5294,18
2021-06-04,Los Angeles,037,10098052,1208693,1203106,40906,1244012,24400
2021-06-04,Madera,039,155013,16674,16557,929,17486,240
2021-06-04,Marin,041,260295,14137,14099,255,14354,229
2021-06-04,Mariposa,043,17540,435,435,11,446,5
2021-06-04,Mendocino,045,87422,4065,3983,83,4066,47
2021-06-04,Merced,047,269075,31095,31204,1030,32234,459
2021-06-04,Modoc,049,8938,384,375,132,507,3
2021-06-04,Mono,051,14174,1263,1275,16,1291,3
2021-06-04,Monterey,053,433212,43203,43068,1837,44905,415
2021-06-04,Napa,055,140530,9936,9958,36,9994,80
2021-06-04,Nevada,057,99092,4870,4844,191,5035,72
2021-06-04,Orange,059,3164182,255662,254730,11297,266027,5059
2021-06-04,Placer,061,380077,23464,23110,1503,24613,293
2021-06-04,Plumas,063,18699,712,691,11,702,4
2021-06-04,Riverside,065,2383286,294545,289098,13903,303001,4452
2021-06-04,Sacramento,067,1510023,106866,106616,1758,108374,1654
2021-06-04,San Benito,069,59416,6059,6073,113,6186,63
2021-06-04,San Bernardino,071,2135413,293657,293056,8926,301982,4768
2021-06-04,San Diego,073,3302833,281560,280556,15065,295621,3763
2021-06-04,San Francisco,075,870044,36838,37079,1270,38349,551
2021-06-04,San Joaquin,077,732212,73463,73039,3515,76554,1388
2021-06-04,San Luis Obispo,079,281455,21447,21234,738,21972,255
2021-06-04,San Mateo,081,765935,42428,42413,470,42883,478
2021-06-04,Santa Barbara,083,443738,34494,34402,1117,35519,459
2021-06-04,Santa Clara,085,1922200,118881,119619,753,120372,2065
2021-06-04,Santa Cruz,087,273765,16264,16150,797,16947,207
2021-06-04,Shasta,089,179085,12424,12458,1592,14050,200
2021-06-04,Sierra,091,2930,57,55,12,67,0
2021-06-04,Siskiyou,093,43540,1951,1865,360,2225,21
2021-06-04,Solano,095,438530,33058,33058,555,33613,256
2021-06-04,Sonoma,097,501317,30331,30411,342,30753,323
2021-06-04,Stanislaus,099,539301,56592,56442,5902,62344,973
2021-06-04,Sutter,101,95872,9517,9554,85,9639,111
2021-06-04,Tehama,103,63373,5106,5090,571,5661,63
2021-06-04,Trinity,105,12862,486,328,92,420,3
2021-06-04,Tulare,107,460477,50300,49452,8927,58379,847
2021-06-04,Tuolumne,109,53932,4040,4095,42,4137,63
2021-06-04,Ventura,111,848112,81513,81104,2960,84064,1023
2021-06-04,Yolo,113,214977,14079,14083,242,14325,210
2021-06-04,Yuba,115,75493,6110,6084,126,6210,49
2021-06-03,Alameda,001,1643700,88395,88555,1924,90479,1257
2021-06-03,Alpine,003,1148,87,88,0,88,0
2021-06-03,Amador,005,37829,3692,3688,32,3720,46
2021-06-03,Butte,007,227075,12643,12478,1814,14292,193
2021-06-03,Calaveras,009,45235,2181,2179,13,2192,55
2021-06-03,Colusa,011,21464,1955,1957,314,2271,15
2021-06-03,Contra Costa,013,1133247,69991,69500,1270,70770,816
2021-06-03,Del Norte,015,27424,1427,1397,13,1410,8
2021-06-03,El Dorado,017,186661,10349,10284,744,11028,112
2021-06-03,Fresno,019,978130,102925,102566,8618,111184,1709
2021-06-03,Glenn,021,27897,2438,2421,558,2979,19
2021-06-03,Humboldt,023,135768,4342,4314,38,4352,42
2021-06-03,Imperial,025,180216,28658,28737,2693,31430,738
2021-06-03,Inyo,027,18085,1406,1404,12,1416,35
2021-06-03,Kern,029,883053,97513,96507,10865,107372,1326
2021-06-03,Kings,031,150075,23186,22982,1071,24053,244
2021-06-03,Lake,033,64148,3547,3526,9,3535,45
2021-06-03,Lassen,035,31185,5228,5177,114,5291,12
2021-06-03,Los Angeles,037,10098052,1208522,1202923,40898,1243821,24386
2021-06-03,Madera,039,155013,16667,16554,929,17483,240
2021-06-03,Marin,041,260295,14132,14095,255,14350,230
2021-06-03,Mariposa,043,17540,435,435,11,446,5
2021-06-03,Mendocino,045,87422,4058,3978,83,4061,47
2021-06-03,Merced,047,269075,31092,31199,1030,32229,459
2021-06-03,Modoc,049,8938,383,376,131,507,3
2021-06-03,Mono,051,14174,1263,1275,16,1291,3
2021-06-03,Monterey,053,433212,43200,43063,1837,44900,415
2021-06-03,Napa,055,140530,9929,9957,36,9993,81
2021-06-03,Nevada,057,99092,4866,4837,191,5028,72
2021-06-03,Orange,059,3164182,255634,254676,11287,265963,5056
2021-06-03,Placer,061,380077,23455,23100,1502,24602,293
2021-06-03,Plumas,063,18699,712,691,11,702,4
2021-06-03,Riverside,065,2383286,294490,289035,13899,302934,4447
2021-06-03,Sacramento,067,1510023,106787,106526,1756,108282,1654
2021-06-03,San Benito,069,59416,6059,6073,113,6186,63
2021-06-03,San Bernardino,071,2135413,293626,293021,8926,301947,4762
2021-06-03,San Diego,073,3302833,281496,280430,15055,295485,3761
2021-06-03,San Francisco,075,870044,36832,37072,1270,38342,551
2021-06-03,San Joaquin,077,732212,73435,72989,3511,76500,1388
2021-06-03,San Luis Obispo,079,281455,21442,21224,738,21962,255
2021-06-03,San Mateo,081,765935,42415,42396,470,42866,467
2021-06-03,Santa Barbara,083,443738,34491,34391,1117,35508,459
2021-06-03,Santa Clara,085,1922200,118859,119592,751,120343,2058
2021-06-03,Santa Cruz,087,273765,16262,16144,797,16941,207
2021-06-03,Shasta,089,179085,12409,12441,1589,14030,199
2021-06-03,Sierra,091,2930,57,55,12,67,0
2021-06-03,Siskiyou,093,43540,1951,1862,359,2221,21
2021-06-03,Solano,095,438530,33044,33019,555,33574,256
2021-06-03,Sonoma,097,501317,30309,30383,341,30724,322
2021-06-03,Stanislaus,099,539301,56573,56401,5896,62297,973
2021-06-03,Sutter,101,95872,9508,9539,85,9624,111
2021-06-03,Tehama,103,63373,5106,5087,571,5658,63
2021-06-03,Trinity,105,12862,486,328,92,420,3
2021-06-03,Tulare,107,460477,50297,49442,8923,58365,848
2021-06-03,Tuolumne,109,53932,4038,4095,42,4137,63
2021-06-03,Ventura,111,848112,81501,81078,2958,84036,1023
2021-06-03,Yolo,113,214977,14075,14078,240,14318,210
2021-06-03,Yuba,115,75493,6103,6077,126,6203,49
2021-06-02,Alameda,001,1643700,88350,88525,1922,90447,1254
2021-06-02,Alpine,003,1148,87,88,0,88,0
2021-06-02,Amador,005,37829,3690,3687,32,3719,46
2021-06-02,Butte,007,227075,12623,12432,1811,14243,193
2021-06-02,Calaveras,009,45235,2178,2174,13,2187,55
2021-06-02,Colusa,011,21464,1954,1957,314,2271,15
2021-06-02,Contra Costa,013,1133247,69940,69455,1268,70723,814
2021-06-02,Del Norte,015,27424,1425,1395,13,1408,8
2021-06-02,El Dorado,017,186661,10345,10275,744,11019,110
2021-06-02,Fresno,019,978130,102901,102547,8615,111162,1707
2021-06-02,Glenn,021,27897,2438,2421,558,2979,19
2021-06-02,Humboldt,023,135768,4327,4302,38,4340,42
2021-06-02,Imperial,025,180216,28652,28737,2692,31429,738
2021-06-02,Inyo,027,18085,1405,1403,12,1415,35
2021-06-02,Kern,029,883053,97486,96481,10858,107339,1326
2021-06-02,Kings,031,150075,23184,22981,1070,24051,244
2021-06-02,Lake,033,64148,3542,3522,9,3531,45
2021-06-02,Lassen,035,31185,5227,5177,114,5291,6
2021-06-02,Los Angeles,037,10098052,1208318,1202760,40889,1243649,24375
2021-06-02,Madera,039,155013,16659,16550,929,17479,240
2021-06-02,Marin,041,260295,14130,14091,254,14345,229
2021-06-02,Mariposa,043,17540,435,434,11,445,5
2021-06-02,Mendocino,045,87422,4052,3970,83,4053,47
2021-06-02,Merced,047,269075,31079,31195,1029,32224,458
2021-06-02,Modoc,049,8938,382,375,130,505,3
2021-06-02,Mono,051,14174,1263,1275,16,1291,3
2021-06-02,Monterey,053,433212,43198,43056,1837,44893,380
2021-06-02,Napa,055,140530,9928,9953,36,9989,82
2021-06-02,Nevada,057,99092,4863,4833,191,5024,72
2021-06-02,Orange,059,3164182,255585,254637,11280,265917,5055
2021-06-02,Placer,061,380077,23434,23058,1500,24558,293
2021-06-02,Plumas,063,18699,712,690,11,701,4
2021-06-02,Riverside,065,2383286,294432,289012,13889,302901,4445
2021-06-02,Sacramento,067,1510023,106722,106435,1750,108185,1649
2021-06-02,San Benito,069,59416,6058,6073,113,6186,63
2021-06-02,San Bernardino,071,2135413,293578,293004,8921,301925,4760
2021-06-02,San Diego,073,3302833,281416,280347,15034,295381,3760
2021-06-02,San Francisco,075,870044,36812,37050,1269,38319,550
2021-06-02,San Joaquin,077,732212,73404,72893,3508,76401,1387
2021-06-02,San Luis Obispo,079,281455,21435,21214,737,21951,255
2021-06-02,San Mateo,081,765935,42405,42383,469,42852,464
2021-06-02,Santa Barbara,083,443738,34484,34381,1117,35498,456
2021-06-02,Santa Clara,085,1922200,118831,119553,750,120303,2058
2021-06-02,Santa Cruz,087,273765,16259,16144,797,16941,207
2021-06-02,Shasta,089,179085,12391,12426,1584,14010,199
2021-06-02,Sierra,091,2930,57,55,12,67,0
2021-06-02,Siskiyou,093,43540,1951,1861,357,2218,21
2021-06-02,Solano,095,438530,33032,33007,554,33561,256
2021-06-02,Sonoma,097,501317,30290,30359,336,30695,322
2021-06-02,Stanislaus,099,539301,56554,56377,5891,62268,973
2021-06-02,Sutter,101,95872,9505,9533,85,9618,111
2021-06-02,Tehama,103,63373,5103,5081,571,5652,63
2021-06-02,Trinity,105,12862,484,328,92,420,3
2021-06-02,Tulare,107,460477,50289,49434,8919,58353,846
2021-06-02,Tuolumne,109,53932,4037,4095,42,4137,63
2021-06-02,Ventura,111,848112,81476,81033,2958,83991,1020
2021-06-02,Yolo,113,214977,14072,14074,239,14313,210
2021-06-02,Yuba,115,75493,6097,6072,126,6198,48
2021-06-01,Alameda,001,1643700,88315,88472,1920,90392,1253
2021-06-01,Alpine,003,1148,87,88,0,88,0
2021-06-01,Amador,005,37829,3688,3687,32,3719,46
2021-06-01,Butte,007,227075,12609,12427,1810,14237,193
2021-06-01,Calaveras,009,45235,2176,2173,13,2186,55
2021-06-01,Colusa,011,21464,1953,1955,313,2268,15
2021-06-01,Contra Costa,013,1133247,69882,69404,1268,70672,813
2021-06-01,Del Norte,015,27424,1424,1394,13,1407,8
2021-06-01,El Dorado,017,186661,10339,10271,744,11015,110
2021-06-01,Fresno,019,978130,102877,102534,8612,111146,1706
2021-06-01,Glenn,021,27897,2438,2422,558,2980,18
2021-06-01,Humboldt,023,135768,4317,4299,38,4337,42
2021-06-01,Imperial,025,180216,28648,28722,2690,31412,736
2021-06-01,Inyo,027,18085,1405,1403,12,1415,35
2021-06-01,Kern,029,883053,97459,96477,10850,107327,1319
2021-06-01,Kings,031,150075,23180,22977,1070,24047,244
2021-06-01,Lake,033,64148,3541,3523,9,3532,45
2021-06-01,Lassen,035,31185,5220,5172,114,5286,6
2021-06-01,Los Angeles,037,10098052,1208081,1202673,40875,1243548,24367
2021-06-01,Madera,039,155013,16650,16549,928,17477,240
2021-06-01,Marin,041,260295,14128,14081,254,14335,229
2021-06-01,Mariposa,043,17540,435,431,11,442,5
2021-06-01,Mendocino,045,87422,4045,3966,83,4049,47
2021-06-01,Merced,047,269075,31069,31195,1029,32224,456
2021-06-01,Modoc,049,8938,380,375,130,505,3
2021-06-01,Mono,051,14174,1263,1275,16,1291,3
2021-06-01,Monterey,053,433212,43192,43051,1837,44888,379
2021-06-01,Napa,055,140530,9926,9949,36,9985,82
2021-06-01,Nevada,057,99092,4858,4825,191,5016,72
2021-06-01,Orange,059,3164182,255549,254603,11272,265875,5051
2021-06-01,Placer,061,380077,23404,23021,1498,24519,293
2021-06-01,Plumas,063,18699,711,690,11,701,4
2021-06-01,Riverside,065,2383286,294379,288996,13883,302879,4442
2021-06-01,Sacramento,067,1510023,106650,106330,1748,108078,1644
2021-06-01,San Benito,069,59416,6057,6073,112,6185,63
2021-06-01,San Bernardino,071,2135413,293553,292990,8920,301910,4758
2021-06-01,San Diego,073,3302833,281312,280305,15017,295322,3756
2021-06-01,San Francisco,075,870044,36796,37031,1269,38300,550
2021-06-01,San Joaquin,077,732212,73372,72858,3507,76365,1383
2021-06-01,San Luis Obispo,079,281455,21430,21217,737,21954,256
2021-06-01,San Mateo,081,765935,42389,42383,468,42851,462
2021-06-01,Santa Barbara,083,443738,34480,34374,1117,35491,456
2021-06-01,Santa Clara,085,1922200,118803,119528,750,120278,2057
2021-06-01,Santa Cruz,087,273765,16255,16143,796,16939,207
2021-06-01,Shasta,089,179085,12382,12409,1579,13988,199
2021-06-01,Sierra,091,2930,57,55,12,67,0
2021-06-01,Siskiyou,093,43540,1944,1860,356,2216,21
2021-06-01,Solano,095,438530,33007,32974,553,33527,256
2021-06-01,Sonoma,097,501317,30251,30324,335,30659,322
2021-06-01,Stanislaus,099,539301,56537,56348,5889,62237,973
2021-06-01,Sutter,101,95872,9498,9528,85,9613,111
2021-06-01,Tehama,103,63373,5101,5079,571,5650,63
2021-06-01,Trinity,105,12862,483,328,91,419,3
2021-06-01,Tulare,107,460477,50281,49419,8915,58334,845
2021-06-01,Tuolumne,109,53932,4037,4094,42,4136,63
2021-06-01,Ventura,111,848112,81460,81018,2957,83975,1021
2021-06-01,Yolo,113,214977,14066,14067,239,14306,210
2021-06-01,Yuba,115,75493,6093,6067,126,6193,48
2021-05-31,Alameda,001,1643700,88279,88458,1916,90374,1253
2021-05-31,Alpine,003,1148,87,88,0,88,0
2021-05-31,Amador,005,37829,3682,3687,32,3719,46
2021-05-31,Butte,007,227075,12596,12429,1810,14239,193
2021-05-31,Calaveras,009,45235,2175,2171,13,2184,55
2021-05-31,Colusa,011,21464,1953,1956,312,2268,15
2021-05-31,Contra Costa,013,1133247,69845,69390,1267,70657,813
2021-05-31,Del Norte,015,27424,1421,1394,13,1407,8
2021-05-31,El Dorado,017,186661,10333,10271,742,11013,110
2021-05-31,Fresno,019,978130,102840,102507,8612,111119,1706
2021-05-31,Glenn,021,27897,2437,2422,557,2979,18
2021-05-31,Humboldt,023,135768,4305,4295,38,4333,42
2021-05-31,Imperial,025,180216,28642,28732,2687,31419,736
2021-05-31,Inyo,027,18085,1404,1403,12,1415,35
2021-05-31,Kern,029,883053,97423,96457,10841,107298,1319
2021-05-31,Kings,031,150075,23176,22977,1070,24047,244
2021-05-31,Lake,033,64148,3536,3523,9,3532,45
2021-05-31,Lassen,035,31185,5218,5172,113,5285,6
2021-05-31,Los Angeles,037,10098052,1207837,1202567,40866,1243433,24364
2021-05-31,Madera,039,155013,16649,16543,927,17470,240
2021-05-31,Marin,041,260295,14126,14080,254,14334,229
2021-05-31,Mariposa,043,17540,435,430,11,441,5
2021-05-31,Mendocino,045,87422,4035,3961,83,4044,47
2021-05-31,Merced,047,269075,31064,31194,1029,32223,456
2021-05-31,Modoc,049,8938,379,374,130,504,3
2021-05-31,Mono,051,14174,1263,1275,16,1291,3
2021-05-31,Monterey,053,433212,43188,43051,1837,44888,379
2021-05-31,Napa,055,140530,9919,9948,36,9984,82
2021-05-31,Nevada,057,99092,4848,4823,190,5013,72
2021-05-31,Orange,059,3164182,255521,254572,11264,265836,5051
2021-05-31,Placer,061,380077,23377,23019,1494,24513,293
2021-05-31,Plumas,063,18699,710,690,11,701,4
2021-05-31,Riverside,065,2383286,294322,288970,13871,302841,4442
2021-05-31,Sacramento,067,1510023,106553,106278,1743,108021,1644
2021-05-31,San Benito,069,59416,6057,6072,112,6184,63
2021-05-31,San Bernardino,071,2135413,293505,292973,8919,301892,4758
2021-05-31,San Diego,073,3302833,281208,280254,15005,295259,3756
2021-05-31,San Francisco,075,870044,36781,37022,1268,38290,550
2021-05-31,San Joaquin,077,732212,73323,72856,3501,76357,1383
2021-05-31,San Luis Obispo,079,281455,21422,21215,737,21952,256
2021-05-31,San Mateo,081,765935,42373,42389,468,42857,442
2021-05-31,Santa Barbara,083,443738,34467,34369,1115,35484,456
2021-05-31,Santa Clara,085,1922200,118759,119515,750,120265,2057
2021-05-31,Santa Cruz,087,273765,16252,16139,796,16935,207
2021-05-31,Shasta,089,179085,12366,12408,1576,13984,199
2021-05-31,Sierra,091,2930,57,55,12,67,0
2021-05-31,Siskiyou,093,43540,1943,1856,355,2211,21
2021-05-31,Solano,095,438530,32957,32973,553,33526,256
2021-05-31,Sonoma,097,501317,30208,30314,335,30649,322
2021-05-31,Stanislaus,099,539301,56496,56335,5886,62221,973
2021-05-31,Sutter,101,95872,9479,9523,85,9608,111
2021-05-31,Tehama,103,63373,5098,5076,570,5646,63
2021-05-31,Trinity,105,12862,483,328,91,419,3
2021-05-31,Tulare,107,460477,50270,49404,8910,58314,845
2021-05-31,Tuolumne,109,53932,4035,4095,42,4137,63
2021-05-31,Ventura,111,848112,81445,81017,2954,83971,1021
2021-05-31,Yolo,113,214977,14062,14064,239,14303,210
2021-05-31,Yuba,115,75493,6087,6063,123,6186,48
2021-05-30,Alameda,001,1643700,88256,88429,1916,90345,1253
2021-05-30,Alpine,003,1148,87,88,0,88,0
2021-05-30,Amador,005,37829,3678,3685,32,3717,46
2021-05-30,Butte,007,227075,12586,12427,1808,14235,190
2021-05-30,Calaveras,009,45235,2171,2166,13,2179,55
2021-05-30,Colusa,011,21464,1953,1954,312,2266,15
2021-05-30,Contra Costa,013,1133247,69811,69381,1265,70646,813
2021-05-30,Del Norte,015,27424,1420,1393,13,1406,8
2021-05-30,El Dorado,017,186661,10330,10271,742,11013,110
2021-05-30,Fresno,019,978130,102823,102499,8608,111107,1706
2021-05-30,Glenn,021,27897,2437,2422,556,2978,18
2021-05-30,Humboldt,023,135768,4297,4291,38,4329,42
2021-05-30,Imperial,025,180216,28638,28732,2686,31418,736
2021-05-30,Inyo,027,18085,1404,1403,12,1415,35
2021-05-30,Kern,029,883053,97407,96443,10838,107281,1319
2021-05-30,Kings,031,150075,23175,22974,1070,24044,244
2021-05-30,Lake,033,64148,3536,3517,9,3526,45
2021-05-30,Lassen,035,31185,5216,5171,113,5284,6
2021-05-30,Los Angeles,037,10098052,1207722,1202425,40859,1243284,24360
2021-05-30,Madera,039,155013,16645,16538,927,17465,240
2021-05-30,Marin,041,260295,14122,14083,253,14336,229
2021-05-30,Mariposa,043,17540,435,430,11,441,5
2021-05-30,Mendocino,045,87422,4028,3955,83,4038,47
2021-05-30,Merced,047,269075,31060,31189,1028,32217,456
2021-05-30,Modoc,049,8938,379,374,130,504,3
2021-05-30,Mono,051,14174,1263,1275,16,1291,3
2021-05-30,Monterey,053,433212,43185,43049,1837,44886,379
2021-05-30,Napa,055,140530,9918,9948,36,9984,82
2021-05-30,Nevada,057,99092,4842,4818,190,5008,72
2021-05-30,Orange,059,3164182,255498,254559,11263,265822,5051
2021-05-30,Placer,061,380077,23371,23016,1494,24510,293
2021-05-30,Plumas,063,18699,708,690,11,701,4
2021-05-30,Riverside,065,2383286,294301,288961,13869,302830,4442
2021-05-30,Sacramento,067,1510023,106507,106252,1741,107993,1644
2021-05-30,San Benito,069,59416,6057,6072,112,6184,63
2021-05-30,San Bernardino,071,2135413,293479,292981,8918,301899,4758
2021-05-30,San Diego,073,3302833,281152,280209,15000,295209,3756
2021-05-30,San Francisco,075,870044,36762,37016,1268,38284,550
2021-05-30,San Joaquin,077,732212,73306,72853,3500,76353,1383
2021-05-30,San Luis Obispo,079,281455,21413,21211,736,21947,256
2021-05-30,San Mateo,081,765935,42365,42386,468,42854,439
2021-05-30,Santa Barbara,083,443738,34463,34369,1115,35484,456
2021-05-30,Santa Clara,085,1922200,118737,119510,746,120256,2057
2021-05-30,Santa Cruz,087,273765,16250,16140,796,16936,207
2021-05-30,Shasta,089,179085,12364,12408,1573,13981,199
2021-05-30,Sierra,091,2930,57,55,12,67,0
2021-05-30,Siskiyou,093,43540,1943,1856,355,2211,21
2021-05-30,Solano,095,438530,32946,32952,552,33504,256
2021-05-30,Sonoma,097,501317,30191,30310,334,30644,322
2021-05-30,Stanislaus,099,539301,56485,56323,5885,62208,973
2021-05-30,Sutter,101,95872,9478,9519,84,9603,111
2021-05-30,Tehama,103,63373,5098,5073,570,5643,63
2021-05-30,Trinity,105,12862,483,328,91,419,3
2021-05-30,Tulare,107,460477,50263,49397,8902,58299,845
2021-05-30,Tuolumne,109,53932,4035,4094,42,4136,63
2021-05-30,Ventura,111,848112,81441,81012,2953,83965,1021
2021-05-30,Yolo,113,214977,14057,14059,238,14297,210
2021-05-30,Yuba,115,75493,6080,6063,122,6185,48
2021-05-29,Alameda,001,1643700,88233,88433,1914,90347,1253
2021-05-29,Alpine,003,1148,87,88,0,88,0
2021-05-29,Amador,005,37829,3677,3683,32,3715,46
2021-05-29,Butte,007,227075,12580,12425,1808,14233,190
2021-05-29,Calaveras,009,45235,2170,2166,13,2179,55
2021-05-29,Colusa,011,21464,1950,1954,312,2266,15
2021-05-29,Contra Costa,013,1133247,69778,69351,1265,70616,813
2021-05-29,Del Norte,015,27424,1420,1391,13,1404,8
2021-05-29,El Dorado,017,186661,10329,10269,740,11009,110
2021-05-29,Fresno,019,978130,102811,102470,8605,111075,1706
2021-05-29,Glenn,021,27897,2437,2422,555,2977,18
2021-05-29,Humboldt,023,135768,4291,4283,38,4321,42
2021-05-29,Imperial,025,180216,28635,28729,2685,31414,736
2021-05-29,Inyo,027,18085,1404,1404,12,1416,35
2021-05-29,Kern,029,883053,97396,96424,10825,107249,1319
2021-05-29,Kings,031,150075,23174,22970,1069,24039,244
2021-05-29,Lake,033,64148,3536,3515,9,3524,45
2021-05-29,Lassen,035,31185,5216,5171,113,5284,6
2021-05-29,Los Angeles,037,10098052,1207599,1202264,40856,1243120,24359
2021-05-29,Madera,039,155013,16643,16535,927,17462,240
2021-05-29,Marin,041,260295,14118,14071,252,14323,229
2021-05-29,Mariposa,043,17540,434,428,11,439,5
2021-05-29,Mendocino,045,87422,4022,3952,83,4035,47
2021-05-29,Merced,047,269075,31048,31187,1028,32215,456
2021-05-29,Modoc,049,8938,379,374,130,504,3
2021-05-29,Mono,051,14174,1263,1275,16,1291,3
2021-05-29,Monterey,053,433212,43183,43042,1837,44879,379
2021-05-29,Napa,055,140530,9915,9948,36,9984,82
2021-05-29,Nevada,057,99092,4841,4816,190,5006,72
2021-05-29,Orange,059,3164182,255476,254537,11253,265790,5049
2021-05-29,Placer,061,380077,23356,23009,1493,24502,293
2021-05-29,Plumas,063,18699,708,689,11,700,4
2021-05-29,Riverside,065,2383286,294281,288908,13868,302776,4442
2021-05-29,Sacramento,067,1510023,106477,106218,1740,107958,1643
2021-05-29,San Benito,069,59416,6056,6072,112,6184,63
2021-05-29,San Bernardino,071,2135413,293447,292961,8917,301878,4757
2021-05-29,San Diego,073,3302833,281093,280151,14995,295146,3756
2021-05-29,San Francisco,075,870044,36753,37008,1268,38276,550
2021-05-29,San Joaquin,077,732212,73290,72827,3498,76325,1383
2021-05-29,San Luis Obispo,079,281455,21411,21201,736,21937,256
2021-05-29,San Mateo,081,765935,42357,42375,467,42842,439
2021-05-29,Santa Barbara,083,443738,34459,34367,1115,35482,456
2021-05-29,Santa Clara,085,1922200,118713,119498,745,120243,2056
2021-05-29,Santa Cruz,087,273765,16249,16137,796,16933,207
2021-05-29,Shasta,089,179085,12356,12401,1572,13973,199
2021-05-29,Sierra,091,2930,57,55,12,67,0
2021-05-29,Siskiyou,093,43540,1938,1856,355,2211,21
2021-05-29,Solano,095,438530,32937,32917,552,33469,256
2021-05-29,Sonoma,097,501317,30168,30298,333,30631,322
2021-05-29,Stanislaus,099,539301,56467,56305,5883,62188,974
2021-05-29,Sutter,101,95872,9474,9516,84,9600,111
2021-05-29,Tehama,103,63373,5097,5070,570,5640,63
2021-05-29,Trinity,105,12862,483,328,91,419,3
2021-05-29,Tulare,107,460477,50253,49392,8898,58290,845
2021-05-29,Tuolumne,109,53932,4035,4093,42,4135,63
2021-05-29,Ventura,111,848112,81433,81008,2953,83961,1021
2021-05-29,Yolo,113,214977,14056,14055,238,14293,210
2021-05-29,Yuba,115,75493,6080,6059,122,6181,48
2021-05-28,Alameda,001,1643700,88209,88391,1910,90301,1261
2021-05-28,Alpine,003,1148,87,88,0,88,0
2021-05-28,Amador,005,37829,3677,3680,32,3712,46
2021-05-28,Butte,007,227075,12577,12407,1807,14214,190
2021-05-28,Calaveras,009,45235,2169,2165,13,2178,55
2021-05-28,Colusa,011,21464,1950,1954,310,2264,15
2021-05-28,Contra Costa,013,1133247,69742,69290,1264,70554,813
2021-05-28,Del Norte,015,27424,1419,1390,13,1403,8
2021-05-28,El Dorado,017,186661,10326,10265,740,11005,110
2021-05-28,Fresno,019,978130,102796,102437,8605,111042,1705
2021-05-28,Glenn,021,27897,2437,2419,555,2974,18
2021-05-28,Humboldt,023,135768,4284,4265,38,4303,42
2021-05-28,Imperial,025,180216,28632,28722,2685,31407,736
2021-05-28,Inyo,027,18085,1404,1404,12,1416,35
2021-05-28,Kern,029,883053,97379,96396,10817,107213,1320
2021-05-28,Kings,031,150075,23172,22962,1069,24031,244
2021-05-28,Lake,033,64148,3534,3515,9,3524,45
2021-05-28,Lassen,035,31185,5216,5169,113,5282,6
2021-05-28,Los Angeles,037,10098052,1207488,1202103,40846,1242949,24357
2021-05-28,Madera,039,155013,16641,16530,927,17457,240
2021-05-28,Marin,041,260295,14117,14063,251,14314,229
2021-05-28,Mariposa,043,17540,434,428,11,439,5
2021-05-28,Mendocino,045,87422,4017,3947,83,4030,47
2021-05-28,Merced,047,269075,31045,31176,1028,32204,455
2021-05-28,Modoc,049,8938,379,374,130,504,3
2021-05-28,Mono,051,14174,1263,1274,16,1290,3
2021-05-28,Monterey,053,433212,43182,43036,1837,44873,379
2021-05-28,Napa,055,140530,9915,9941,36,9977,82
2021-05-28,Nevada,057,99092,4839,4813,190,5003,71
2021-05-28,Orange,059,3164182,255456,254494,11251,265745,5047
2021-05-28,Placer,061,380077,23346,22987,1491,24478,293
2021-05-28,Plumas,063,18699,706,688,11,699,4
2021-05-28,Riverside,065,2383286,294259,288872,13866,302738,4442
2021-05-28,Sacramento,067,1510023,106421,106131,1738,107869,1642
2021-05-28,San Benito,069,59416,6056,6074,112,6186,63
2021-05-28,San Bernardino,071,2135413,293424,292905,8917,301822,4757
2021-05-28,San Diego,073,3302833,281030,280043,14984,295027,3756
2021-05-28,San Francisco,075,870044,36747,36987,1268,38255,546
2021-05-28,San Joaquin,077,732212,73260,72793,3496,76289,1383
2021-05-28,San Luis Obispo,079,281455,21406,21190,734,21924,256
2021-05-28,San Mateo,081,765935,42351,42364,467,42831,439
2021-05-28,Santa Barbara,083,443738,34458,34371,1115,35486,455
2021-05-28,Santa Clara,085,1922200,118689,119462,745,120207,2056
2021-05-28,Santa Cruz,087,273765,16248,16129,796,16925,207
2021-05-28,Shasta,089,179085,12347,12383,1570,13953,198
2021-05-28,Sierra,091,2930,57,54,12,66,0
2021-05-28,Siskiyou,093,43540,1936,1850,355,2205,19
2021-05-28,Solano,095,438530,32922,32892,552,33444,256
2021-05-28,Sonoma,097,501317,30149,30270,333,30603,321
2021-05-28,Stanislaus,099,539301,56448,56278,5880,62158,974
2021-05-28,Sutter,101,95872,9470,9511,84,9595,111
2021-05-28,Tehama,103,63373,5091,5064,570,5634,63
2021-05-28,Trinity,105,12862,483,328,91,419,3
2021-05-28,Tulare,107,460477,50248,49375,8889,58264,846
2021-05-28,Tuolumne,109,53932,4035,4090,42,4132,63
2021-05-28,Ventura,111,848112,81422,80985,2952,83937,1021
2021-05-28,Yolo,113,214977,14053,14050,237,14287,210
2021-05-28,Yuba,115,75493,6078,6050,121,6171,48
2021-05-27,Alameda,001,1643700,88174,88342,1910,90252,1274
2021-05-27,Alpine,003,1148,87,88,0,88,0
2021-05-27,Amador,005,37829,3674,3680,32,3712,46
2021-05-27,Butte,007,227075,12572,12401,1806,14207,190
2021-05-27,Calaveras,009,45235,2168,2163,13,2176,55
2021-05-27,Colusa,011,21464,1947,1952,310,2262,15
2021-05-27,Contra Costa,013,1133247,69700,69245,1262,70507,813
2021-05-27,Del Norte,015,27424,1419,1388,13,1401,8
2021-05-27,El Dorado,017,186661,10325,10248,740,10988,112
2021-05-27,Fresno,019,978130,102780,102413,8602,111015,1704
2021-05-27,Glenn,021,27897,2437,2415,555,2970,18
2021-05-27,Humboldt,023,135768,4276,4260,38,4298,42
2021-05-27,Imperial,025,180216,28621,28728,2685,31413,736
2021-05-27,Inyo,027,18085,1404,1404,12,1416,35
2021-05-27,Kern,029,883053,97363,96364,10809,107173,1322
2021-05-27,Kings,031,150075,23169,22953,1069,24022,245
2021-05-27,Lake,033,64148,3529,3509,9,3518,45
2021-05-27,Lassen,035,31185,5215,5170,112,5282,6
2021-05-27,Los Angeles,037,10098052,1207318,1201927,40833,1242760,24348
2021-05-27,Madera,039,155013,16632,16527,927,17454,240
2021-05-27,Marin,041,260295,14113,14061,251,14312,229
2021-05-27,Mariposa,043,17540,432,427,11,438,5
2021-05-27,Mendocino,045,87422,4011,3945,83,4028,47
2021-05-27,Merced,047,269075,31033,31161,1028,32189,455
2021-05-27,Modoc,049,8938,378,374,130,504,3
2021-05-27,Mono,051,14174,1263,1276,16,1292,3
2021-05-27,Monterey,053,433212,43176,43032,1837,44869,379
2021-05-27,Napa,055,140530,9914,9934,36,9970,82
2021-05-27,Nevada,057,99092,4835,4807,188,4995,71
2021-05-27,Orange,059,3164182,255419,254438,11247,265685,5059
2021-05-27,Placer,061,380077,23337,22966,1491,24457,293
2021-05-27,Plumas,063,18699,706,687,11,698,4
2021-05-27,Riverside,065,2383286,294223,288835,13861,302696,4443
2021-05-27,Sacramento,067,1510023,106346,106015,1736,107751,1642
2021-05-27,San Benito,069,59416,6055,6074,112,6186,63
2021-05-27,San Bernardino,071,2135413,293388,292755,8915,301670,4756
2021-05-27,San Diego,073,3302833,280956,279960,14970,294930,3756
2021-05-27,San Francisco,075,870044,36741,36980,1265,38245,546
2021-05-27,San Joaquin,077,732212,73228,72714,3493,76207,1388
2021-05-27,San Luis Obispo,079,281455,21401,21171,734,21905,256
2021-05-27,San Mateo,081,765935,42342,42345,467,42812,436
2021-05-27,Santa Barbara,083,443738,34453,34355,1115,35470,456
2021-05-27,Santa Clara,085,1922200,118668,119452,745,120197,2053
2021-05-27,Santa Cruz,087,273765,16246,16134,796,16930,207
2021-05-27,Shasta,089,179085,12337,12380,1570,13950,202
2021-05-27,Sierra,091,2930,57,54,12,66,0
2021-05-27,Siskiyou,093,43540,1933,1846,355,2201,18
2021-05-27,Solano,095,438530,32881,32855,551,33406,257
2021-05-27,Sonoma,097,501317,30122,30253,329,30582,321
2021-05-27,Stanislaus,099,539301,56423,56207,5879,62086,974
2021-05-27,Sutter,101,95872,9466,9501,84,9585,111
2021-05-27,Tehama,103,63373,5088,5064,569,5633,63
2021-05-27,Trinity,105,12862,483,328,91,419,3
2021-05-27,Tulare,107,460477,50234,49366,8880,58246,840
2021-05-27,Tuolumne,109,53932,4034,4090,42,4132,66
2021-05-27,Ventura,111,848112,81409,80965,2949,83914,1023
2021-05-27,Yolo,113,214977,14050,14036,237,14273,213
2021-05-27,Yuba,115,75493,6073,6040,120,6160,48
2021-05-26,Alameda,001,1643700,88145,88297,1910,90207,1266
2021-05-26,Alpine,003,1148,87,88,0,88,0
2021-05-26,Amador,005,37829,3674,3679,32,3711,46
2021-05-26,Butte,007,227075,12563,12332,1805,14137,190
2021-05-26,Calaveras,009,45235,2167,2154,13,2167,55
2021-05-26,Colusa,011,21464,1946,1952,310,2262,15
2021-05-26,Contra Costa,013,1133247,69663,69210,1262,70472,812
2021-05-26,Del Norte,015,27424,1419,1386,12,1398,8
2021-05-26,El Dorado,017,186661,10321,10242,739,10981,112
2021-05-26,Fresno,019,978130,102747,102374,8597,110971,1702
2021-05-26,Glenn,021,27897,2436,2415,555,2970,18
2021-05-26,Humboldt,023,135768,4271,4246,38,4284,42
2021-05-26,Imperial,025,180216,28616,28712,2683,31395,734
2021-05-26,Inyo,027,18085,1404,1403,12,1415,36
2021-05-26,Kern,029,883053,97338,96343,10802,107145,1320
2021-05-26,Kings,031,150075,23165,22950,1068,24018,245
2021-05-26,Lake,033,64148,3528,3508,9,3517,45
2021-05-26,Lassen,035,31185,5214,5164,112,5276,6
2021-05-26,Los Angeles,037,10098052,1207150,1198100,40817,1238917,24221
2021-05-26,Madera,039,155013,16629,16520,927,17447,240
2021-05-26,Marin,041,260295,14110,14061,250,14311,227
2021-05-26,Mariposa,043,17540,432,427,11,438,5
2021-05-26,Mendocino,045,87422,4005,3938,83,4021,47
2021-05-26,Merced,047,269075,31024,31139,1028,32167,455
2021-05-26,Modoc,049,8938,378,371,129,500,3
2021-05-26,Mono,051,14174,1263,1274,16,1290,3
2021-05-26,Monterey,053,433212,43170,43018,1836,44854,379
2021-05-26,Napa,055,140530,9907,9932,34,9966,82
2021-05-26,Nevada,057,99092,4830,4803,188,4991,70
2021-05-26,Orange,059,3164182,255383,254368,11244,265612,5058
2021-05-26,Placer,061,380077,23313,22940,1491,24431,293
2021-05-26,Plumas,063,18699,705,685,11,696,4
2021-05-26,Riverside,065,2383286,294177,288782,13854,302636,4443
2021-05-26,Sacramento,067,1510023,106260,105919,1732,107651,1637
2021-05-26,San Benito,069,59416,6055,6074,112,6186,63
2021-05-26,San Bernardino,071,2135413,293352,292662,8914,301576,4755
2021-05-26,San Diego,073,3302833,280881,279859,14960,294819,3755
2021-05-26,San Francisco,075,870044,36729,36954,1265,38219,546
2021-05-26,San Joaquin,077,732212,73186,72681,3490,76171,1388
2021-05-26,San Luis Obispo,079,281455,21395,21163,734,21897,256
2021-05-26,San Mateo,081,765935,42334,42331,467,42798,436
2021-05-26,Santa Barbara,083,443738,34444,34348,1115,35463,459
2021-05-26,Santa Clara,085,1922200,118641,119421,744,120165,2031
2021-05-26,Santa Cruz,087,273765,16245,16139,796,16935,207
2021-05-26,Shasta,089,179085,12322,12357,1567,13924,202
2021-05-26,Sierra,091,2930,57,54,12,66,0
2021-05-26,Siskiyou,093,43540,1931,1847,353,2200,18
2021-05-26,Solano,095,438530,32845,32831,551,33382,257
2021-05-26,Sonoma,097,501317,30095,30230,329,30559,321
2021-05-26,Stanislaus,099,539301,56401,56193,5877,62070,974
2021-05-26,Sutter,101,95872,9461,9495,84,9579,112
2021-05-26,Tehama,103,63373,5087,5054,566,5620,63
2021-05-26,Trinity,105,12862,483,328,91,419,3
2021-05-26,Tulare,107,460477,50227,49352,8876,58228,839
2021-05-26,Tuolumne,109,53932,4030,4088,41,4129,66
2021-05-26,Ventura,111,848112,81386,80944,2947,83891,1023
2021-05-26,Yolo,113,214977,14047,14025,237,14262,213
2021-05-26,Yuba,115,75493,6068,6036,120,6156,49
2021-05-25,Alameda,001,1643700,88115,88237,1910,90147,1263
2021-05-25,Alpine,003,1148,87,88,0,88,0
2021-05-25,Amador,005,37829,3669,3676,32,3708,46
2021-05-25,Butte,007,227075,12552,12295,1804,14099,189
2021-05-25,Calaveras,009,45235,2165,2148,13,2161,55
2021-05-25,Colusa,011,21464,1945,1949,310,2259,15
2021-05-25,Contra Costa,013,1133247,69611,69167,1257,70424,809
2021-05-25,Del Norte,015,27424,1419,1385,12,1397,8
2021-05-25,El Dorado,017,186661,10314,10240,738,10978,112
2021-05-25,Fresno,019,978130,102726,102329,8595,110924,1701
2021-05-25,Glenn,021,27897,2435,2414,554,2968,17
2021-05-25,Humboldt,023,135768,4264,4231,36,4267,42
2021-05-25,Imperial,025,180216,28609,28586,2683,31269,735
2021-05-25,Inyo,027,18085,1404,1402,12,1414,36
2021-05-25,Kern,029,883053,97307,96319,10788,107107,1319
2021-05-25,Kings,031,150075,23158,22944,1068,24012,245
2021-05-25,Lake,033,64148,3527,3508,9,3517,44
2021-05-25,Lassen,035,31185,5210,5164,112,5276,6
2021-05-25,Los Angeles,037,10098052,1206963,1197940,40799,1238739,24212
2021-05-25,Madera,039,155013,16624,16519,926,17445,240
2021-05-25,Marin,041,260295,14104,14053,250,14303,227
2021-05-25,Mariposa,043,17540,431,427,11,438,5
2021-05-25,Mendocino,045,87422,4000,3928,83,4011,47
2021-05-25,Merced,047,269075,31003,31132,1028,32160,455
2021-05-25,Modoc,049,8938,377,367,129,496,3
2021-05-25,Mono,051,14174,1263,1274,16,1290,3
2021-05-25,Monterey,053,433212,43166,43012,1835,44847,379
2021-05-25,Napa,055,140530,9905,9926,34,9960,82
2021-05-25,Nevada,057,99092,4824,4795,188,4983,70
2021-05-25,Orange,059,3164182,255354,254321,11243,265564,5057
2021-05-25,Placer,061,380077,23302,22920,1489,24409,292
2021-05-25,Plumas,063,18699,705,684,11,695,4
2021-05-25,Riverside,065,2383286,294138,288725,13851,302576,4443
2021-05-25,Sacramento,067,1510023,106179,105828,1729,107557,1633
2021-05-25,San Benito,069,59416,6055,6073,112,6185,63
2021-05-25,San Bernardino,071,2135413,293292,292485,8913,301398,4755
2021-05-25,San Diego,073,3302833,280799,279786,14955,294741,3753
2021-05-25,San Francisco,075,870044,36706,36939,1265,38204,546
2021-05-25,San Joaquin,077,732212,73144,72628,3487,76115,1387
2021-05-25,San Luis Obispo,079,281455,21392,21153,734,21887,256
2021-05-25,San Mateo,081,765935,42324,42268,467,42735,435
2021-05-25,Santa Barbara,083,443738,34441,34337,1115,35452,459
2021-05-25,Santa Clara,085,1922200,118617,119393,743,120136,2032
2021-05-25,Santa Cruz,087,273765,16240,16141,796,16937,207
2021-05-25,Shasta,089,179085,12313,12328,1565,13893,202
2021-05-25,Sierra,091,2930,56,54,12,66,0
2021-05-25,Siskiyou,093,43540,1930,1845,352,2197,18
2021-05-25,Solano,095,438530,32826,32817,550,33367,256
2021-05-25,Sonoma,097,501317,30066,30207,328,30535,321
2021-05-25,Stanislaus,099,539301,56365,56168,5874,62042,974
2021-05-25,Sutter,101,95872,9457,9495,84,9579,112
2021-05-25,Tehama,103,63373,5085,5048,565,5613,63
2021-05-25,Trinity,105,12862,483,328,90,418,3
2021-05-25,Tulare,107,460477,50217,49326,8868,58194,838
2021-05-25,Tuolumne,109,53932,4030,4084,41,4125,66
2021-05-25,Ventura,111,848112,81368,80905,2947,83852,1022
2021-05-25,Yolo,113,214977,14039,14018,235,14253,213
2021-05-25,Yuba,115,75493,6061,6028,120,6148,49
2021-05-24,Alameda,001,1643700,88075,88182,1909,90091,1263
2021-05-24,Alpine,003,1148,87,88,0,88,0
2021-05-24,Amador,005,37829,3667,3675,32,3707,46
2021-05-24,Butte,007,227075,12539,12279,1801,14080,189
2021-05-24,Calaveras,009,45235,2163,2146,13,2159,54
2021-05-24,Colusa,011,21464,1945,1949,310,2259,15
2021-05-24,Contra Costa,013,1133247,69570,69107,1253,70360,809
2021-05-24,Del Norte,015,27424,1418,1384,12,1396,8
2021-05-24,El Dorado,017,186661,10304,10227,737,10964,112
2021-05-24,Fresno,019,978130,102684,102289,8594,110883,1698
2021-05-24,Glenn,021,27897,2435,2413,554,2967,17
2021-05-24,Humboldt,023,135768,4257,4225,36,4261,42
2021-05-24,Imperial,025,180216,28607,28575,2683,31258,735
2021-05-24,Inyo,027,18085,1404,1402,12,1414,36
2021-05-24,Kern,029,883053,97280,96296,10783,107079,1319
2021-05-24,Kings,031,150075,23154,22940,1068,24008,246
2021-05-24,Lake,033,64148,3525,3506,9,3515,43
2021-05-24,Lassen,035,31185,5206,5163,112,5275,6
2021-05-24,Los Angeles,037,10098052,1206791,1197782,40785,1238567,24201
2021-05-24,Madera,039,155013,16620,16513,925,17438,239
2021-05-24,Marin,041,260295,14102,14051,250,14301,227
2021-05-24,Mariposa,043,17540,430,427,11,438,5
2021-05-24,Mendocino,045,87422,3998,3919,83,4002,47
2021-05-24,Merced,047,269075,30993,31128,1027,32155,455
2021-05-24,Modoc,049,8938,377,366,128,494,3
2021-05-24,Mono,051,14174,1263,1270,16,1286,3
2021-05-24,Monterey,053,433212,43161,43005,1834,44839,379
2021-05-24,Napa,055,140530,9905,9924,34,9958,82
2021-05-24,Nevada,057,99092,4821,4790,188,4978,70
2021-05-24,Orange,059,3164182,255320,254287,11233,265520,5056
2021-05-24,Placer,061,380077,23283,22895,1488,24383,292
2021-05-24,Plumas,063,18699,704,683,11,694,4
2021-05-24,Riverside,065,2383286,294081,288669,13841,302510,4442
2021-05-24,Sacramento,067,1510023,106064,105716,1728,107444,1632
2021-05-24,San Benito,069,59416,6055,6072,112,6184,63
2021-05-24,San Bernardino,071,2135413,293252,292343,8912,301255,4747
2021-05-24,San Diego,073,3302833,280691,279715,14945,294660,3749
2021-05-24,San Francisco,075,870044,36686,36934,1263,38197,547
2021-05-24,San Joaquin,077,732212,73112,72586,3487,76073,1371
2021-05-24,San Luis Obispo,079,281455,21374,21146,733,21879,256
2021-05-24,San Mateo,081,765935,42314,42249,467,42716,433
2021-05-24,Santa Barbara,083,443738,34436,34322,1115,35437,459
2021-05-24,Santa Clara,085,1922200,118585,119358,743,120101,2030
2021-05-24,Santa Cruz,087,273765,16234,16135,796,16931,207
2021-05-24,Shasta,089,179085,12296,12315,1562,13877,201
2021-05-24,Sierra,091,2930,56,54,12,66,0
2021-05-24,Siskiyou,093,43540,1927,1840,352,2192,17
2021-05-24,Solano,095,438530,32801,32792,549,33341,254
2021-05-24,Sonoma,097,501317,30051,30187,328,30515,321
2021-05-24,Stanislaus,099,539301,56331,56128,5870,61998,974
2021-05-24,Sutter,101,95872,9451,9486,84,9570,113
2021-05-24,Tehama,103,63373,5082,5043,563,5606,63
2021-05-24,Trinity,105,12862,483,328,90,418,3
2021-05-24,Tulare,107,460477,50210,49318,8864,58182,838
2021-05-24,Tuolumne,109,53932,4030,4083,41,4124,65
2021-05-24,Ventura,111,848112,81355,80876,2945,83821,1022
2021-05-24,Yolo,113,214977,14022,14012,233,14245,213
2021-05-24,Yuba,115,75493,6052,6022,120,6142,49
2021-05-23,Alameda,001,1643700,88012,88157,1906,90063,1263
2021-05-23,Alpine,003,1148,87,88,0,88,0
2021-05-23,Amador,005,37829,3666,3673,32,3705,46
2021-05-23,Butte,007,227075,12525,12271,1800,14071,189
2021-05-23,Calaveras,009,45235,2155,2144,13,2157,54
2021-05-23,Colusa,011,21464,1945,1949,308,2257,15
2021-05-23,Contra Costa,013,1133247,69526,69075,1251,70326,809
2021-05-23,Del Norte,015,27424,1414,1383,12,1395,8
2021-05-23,El Dorado,017,186661,10298,10222,737,10959,112
2021-05-23,Fresno,019,978130,102639,102270,8589,110859,1698
2021-05-23,Glenn,021,27897,2433,2413,554,2967,17
2021-05-23,Humboldt,023,135768,4239,4216,36,4252,42
2021-05-23,Imperial,025,180216,28601,28569,2682,31251,735
2021-05-23,Inyo,027,18085,1404,1402,12,1414,36
2021-05-23,Kern,029,883053,97256,96282,10775,107057,1319
2021-05-23,Kings,031,150075,23141,22939,1066,24005,246
2021-05-23,Lake,033,64148,3522,3504,9,3513,43
2021-05-23,Lassen,035,31185,5202,5163,111,5274,6
2021-05-23,Los Angeles,037,10098052,1206602,1197633,40774,1238407,24197
2021-05-23,Madera,039,155013,16614,16504,925,17429,239
2021-05-23,Marin,041,260295,14093,14048,249,14297,227
2021-05-23,Mariposa,043,17540,430,427,11,438,5
2021-05-23,Mendocino,045,87422,3992,3913,82,3995,47
2021-05-23,Merced,047,269075,30984,31118,1027,32145,455
2021-05-23,Modoc,049,8938,373,366,128,494,3
2021-05-23,Mono,051,14174,1262,1270,16,1286,3
2021-05-23,Monterey,053,433212,43151,43003,1834,44837,379
2021-05-23,Napa,055,140530,9901,9923,34,9957,82
2021-05-23,Nevada,057,99092,4811,4790,188,4978,70
2021-05-23,Orange,059,3164182,255282,254277,11227,265504,5050
2021-05-23,Placer,061,380077,23263,22888,1488,24376,292
2021-05-23,Plumas,063,18699,703,683,11,694,4
2021-05-23,Riverside,065,2383286,294013,288641,13837,302478,4442
2021-05-23,Sacramento,067,1510023,105948,105663,1725,107388,1632
2021-05-23,San Benito,069,59416,6054,6072,112,6184,63
2021-05-23,San Bernardino,071,2135413,293201,292327,8911,301238,4747
2021-05-23,San Diego,073,3302833,280601,279690,14934,294624,3751
2021-05-23,San Francisco,075,870044,36675,36927,1262,38189,547
2021-05-23,San Joaquin,077,732212,73063,72571,3485,76056,1371
2021-05-23,San Luis Obispo,079,281455,21364,21141,732,21873,256
2021-05-23,San Mateo,081,765935,42297,42248,467,42715,433
2021-05-23,Santa Barbara,083,443738,34429,34319,1115,35434,459
2021-05-23,Santa Clara,085,1922200,118561,119333,743,120076,2030
2021-05-23,Santa Cruz,087,273765,16231,16130,796,16926,207
2021-05-23,Shasta,089,179085,12279,12313,1558,13871,201
2021-05-23,Sierra,091,2930,56,54,12,66,0
2021-05-23,Siskiyou,093,43540,1922,1826,345,2171,17
2021-05-23,Solano,095,438530,32783,32780,548,33328,254
2021-05-23,Sonoma,097,501317,30022,30168,327,30495,321
2021-05-23,Stanislaus,099,539301,56283,56104,5867,61971,974
2021-05-23,Sutter,101,95872,9442,9479,84,9563,113
2021-05-23,Tehama,103,63373,5075,5041,561,5602,63
2021-05-23,Trinity,105,12862,483,328,90,418,3
2021-05-23,Tulare,107,460477,50196,49310,8860,58170,838
2021-05-23,Tuolumne,109,53932,4027,4081,41,4122,65
2021-05-23,Ventura,111,848112,81325,80872,2944,83816,1022
2021-05-23,Yolo,113,214977,14010,14004,230,14234,213
2021-05-23,Yuba,115,75493,6047,6017,120,6137,49
2021-05-22,Alameda,001,1643700,87985,88101,1906,90007,1263
2021-05-22,Alpine,003,1148,87,88,0,88,0
2021-05-22,Amador,005,37829,3665,3672,32,3704,46
2021-05-22,Butte,007,227075,12513,12265,1799,14064,189
2021-05-22,Calaveras,009,45235,2151,2141,13,2154,54
2021-05-22,Colusa,011,21464,1941,1949,307,2256,15
2021-05-22,Contra Costa,013,1133247,69493,69004,1250,70254,809
2021-05-22,Del Norte,015,27424,1413,1381,12,1393,8
2021-05-22,El Dorado,017,186661,10293,10215,736,10951,112
2021-05-22,Fresno,019,978130,102625,102238,8587,110825,1698
2021-05-22,Glenn,021,27897,2433,2412,554,2966,17
2021-05-22,Humboldt,023,135768,4230,4194,35,4229,42
2021-05-22,Imperial,025,180216,28592,28574,2682,31256,735
2021-05-22,Inyo,027,18085,1404,1402,12,1414,36
2021-05-22,Kern,029,883053,97244,96260,10768,107028,1319
2021-05-22,Kings,031,150075,23141,22936,1066,24002,246
2021-05-22,Lake,033,64148,3519,3502,9,3511,43
2021-05-22,Lassen,035,31185,5202,5163,111,5274,6
2021-05-22,Los Angeles,037,10098052,1206493,1197454,40766,1238220,24192
2021-05-22,Madera,039,155013,16611,16503,925,17428,239
2021-05-22,Marin,041,260295,14090,14043,249,14292,227
2021-05-22,Mariposa,043,17540,430,427,11,438,5
2021-05-22,Mendocino,045,87422,3986,3908,82,3990,47
2021-05-22,Merced,047,269075,30974,31099,1027,32126,455
2021-05-22,Modoc,049,8938,373,366,128,494,3
2021-05-22,Mono,051,14174,1260,1270,16,1286,3
2021-05-22,Monterey,053,433212,43145,42998,1834,44832,379
2021-05-22,Napa,055,140530,9899,9918,34,9952,82
2021-05-22,Nevada,057,99092,4804,4787,187,4974,70
2021-05-22,Orange,059,3164182,255261,254238,11222,265460,5048
2021-05-22,Placer,061,380077,23249,22865,1487,24352,292
2021-05-22,Plumas,063,18699,702,683,11,694,4
2021-05-22,Riverside,065,2383286,293981,288580,13836,302416,4442
2021-05-22,Sacramento,067,1510023,105873,105551,1722,107273,1632
2021-05-22,San Benito,069,59416,6054,6071,112,6183,63
2021-05-22,San Bernardino,071,2135413,293176,292292,8911,301203,4747
2021-05-22,San Diego,073,3302833,280542,279614,14926,294540,3751
2021-05-22,San Francisco,075,870044,36665,36906,1260,38166,547
2021-05-22,San Joaquin,077,732212,73041,72528,3482,76010,1371
2021-05-22,San Luis Obispo,079,281455,21356,21134,731,21865,256
2021-05-22,San Mateo,081,765935,42287,42218,467,42685,433
2021-05-22,Santa Barbara,083,443738,34425,34313,1114,35427,459
2021-05-22,Santa Clara,085,1922200,118537,119292,743,120035,2030
2021-05-22,Santa Cruz,087,273765,16231,16125,796,16921,207
2021-05-22,Shasta,089,179085,12272,12307,1555,13862,201
2021-05-22,Sierra,091,2930,56,54,12,66,0
2021-05-22,Siskiyou,093,43540,1921,1824,344,2168,17
2021-05-22,Solano,095,438530,32770,32753,548,33301,254
2021-05-22,Sonoma,097,501317,30010,30154,327,30481,321
2021-05-22,Stanislaus,099,539301,56260,56069,5866,61935,974
2021-05-22,Sutter,101,95872,9437,9476,84,9560,113
2021-05-22,Tehama,103,63373,5074,5036,561,5597,63
2021-05-22,Trinity,105,12862,483,328,90,418,3
2021-05-22,Tulare,107,460477,50191,49299,8855,58154,838
2021-05-22,Tuolumne,109,53932,4027,4078,41,4119,65
2021-05-22,Ventura,111,848112,81321,80859,2944,83803,1022
2021-05-22,Yolo,113,214977,14008,13997,230,14227,213
2021-05-22,Yuba,115,75493,6044,6010,120,6130,49
2021-05-21,Alameda,001,1643700,87959,88041,1905,89946,1263
2021-05-21,Alpine,003,1148,87,88,0,88,0
2021-05-21,Amador,005,37829,3662,3672,32,3704,46
2021-05-21,Butte,007,227075,12507,12236,1797,14033,188
2021-05-21,Calaveras,009,45235,2149,2138,13,2151,54
2021-05-21,Colusa,011,21464,1941,1947,307,2254,15
2021-05-21,Contra Costa,013,1133247,69450,68965,1249,70214,810
2021-05-21,Del Norte,015,27424,1412,1376,12,1388,8
2021-05-21,El Dorado,017,186661,10289,10204,736,10940,112
2021-05-21,Fresno,019,978130,102597,102189,8585,110774,1698
2021-05-21,Glenn,021,27897,2432,2408,554,2962,17
2021-05-21,Humboldt,023,135768,4223,4175,35,4210,42
2021-05-21,Imperial,025,180216,28585,28572,2681,31253,732
2021-05-21,Inyo,027,18085,1404,1402,12,1414,36
2021-05-21,Kern,029,883053,97230,96233,10761,106994,1318
2021-05-21,Kings,031,150075,23141,22927,1066,23993,246
2021-05-21,Lake,033,64148,3517,3500,9,3509,43
2021-05-21,Lassen,035,31185,5201,5161,111,5272,6
2021-05-21,Los Angeles,037,10098052,1206375,1197263,40758,1238021,24180
2021-05-21,Madera,039,155013,16610,16500,924,17424,238
2021-05-21,Marin,041,260295,14085,14042,249,14291,227
2021-05-21,Mariposa,043,17540,429,427,11,438,5
2021-05-21,Mendocino,045,87422,3981,3897,82,3979,47
2021-05-21,Merced,047,269075,30966,31076,1027,32103,455
2021-05-21,Modoc,049,8938,373,365,128,493,3
2021-05-21,Mono,051,14174,1260,1269,16,1285,3
2021-05-21,Monterey,053,433212,43143,42995,1834,44829,379
2021-05-21,Napa,055,140530,9895,9913,34,9947,82
2021-05-21,Nevada,057,99092,4803,4779,187,4966,70
2021-05-21,Orange,059,3164182,255241,254171,11220,265391,5042
2021-05-21,Placer,061,380077,23240,22853,1487,24340,292
2021-05-21,Plumas,063,18699,702,683,10,693,4
2021-05-21,Riverside,065,2383286,293954,288499,13829,302328,4442
2021-05-21,Sacramento,067,1510023,105806,105476,1719,107195,1632
2021-05-21,San Benito,069,59416,6054,6068,112,6180,63
2021-05-21,San Bernardino,071,2135413,293144,292205,8909,301114,4744
2021-05-21,San Diego,073,3302833,280469,279554,14916,294470,3748
2021-05-21,San Francisco,075,870044,36660,36879,1260,38139,546
2021-05-21,San Joaquin,077,732212,73021,72467,3480,75947,1371
2021-05-21,San Luis Obispo,079,281455,21350,21128,728,21856,256
2021-05-21,San Mateo,081,765935,42274,42163,466,42629,432
2021-05-21,Santa Barbara,083,443738,34420,34302,1114,35416,459
2021-05-21,Santa Clara,085,1922200,118510,119247,743,119990,2029
2021-05-21,Santa Cruz,087,273765,16227,16120,796,16916,207
2021-05-21,Shasta,089,179085,12255,12289,1553,13842,201
2021-05-21,Sierra,091,2930,56,54,12,66,0
2021-05-21,Siskiyou,093,43540,1920,1815,344,2159,16
2021-05-21,Solano,095,438530,32755,32742,548,33290,254
2021-05-21,Sonoma,097,501317,29997,30126,327,30453,321
2021-05-21,Stanislaus,099,539301,56231,56036,5864,61900,975
2021-05-21,Sutter,101,95872,9435,9470,84,9554,113
2021-05-21,Tehama,103,63373,5068,5030,561,5591,63
2021-05-21,Trinity,105,12862,483,329,89,418,3
2021-05-21,Tulare,107,460477,50186,49271,8853,58124,838
2021-05-21,Tuolumne,109,53932,4025,4079,41,4120,65
2021-05-21,Ventura,111,848112,81313,80821,2941,83762,1021
2021-05-21,Yolo,113,214977,14002,13983,230,14213,213
2021-05-21,Yuba,115,75493,6038,6006,120,6126,49
2021-05-20,Alameda,001,1643700,87916,87975,1904,89879,1264
2021-05-20,Alpine,003,1148,87,88,0,88,0
2021-05-20,Amador,005,37829,3661,3671,32,3703,46
2021-05-20,Butte,007,227075,12500,12220,1794,14014,188
2021-05-20,Calaveras,009,45235,2145,2138,13,2151,54
2021-05-20,Colusa,011,21464,1940,1946,305,2251,15
2021-05-20,Contra Costa,013,1133247,69405,68913,1247,70160,809
2021-05-20,Del Norte,015,27424,1412,1373,12,1385,8
2021-05-20,El Dorado,017,186661,10279,10188,736,10924,112
2021-05-20,Fresno,019,978130,102575,102135,8583,110718,1696
2021-05-20,Glenn,021,27897,2429,2406,554,2960,17
2021-05-20,Humboldt,023,135768,4206,4162,34,4196,42
2021-05-20,Imperial,025,180216,28580,28551,2681,31232,732
2021-05-20,Inyo,027,18085,1404,1402,12,1414,36
2021-05-20,Kern,029,883053,97209,96204,10754,106958,1317
2021-05-20,Kings,031,150075,23139,22922,1066,23988,246
2021-05-20,Lake,033,64148,3514,3500,9,3509,43
2021-05-20,Lassen,035,31185,5199,5160,110,5270,6
2021-05-20,Los Angeles,037,10098052,1206219,1197073,40748,1237821,24168
2021-05-20,Madera,039,155013,16604,16499,922,17421,238
2021-05-20,Marin,041,260295,14081,14036,248,14284,227
2021-05-20,Mariposa,043,17540,429,426,11,437,5
2021-05-20,Mendocino,045,87422,3974,3897,82,3979,47
2021-05-20,Merced,047,269075,30953,31046,1026,32072,454
2021-05-20,Modoc,049,8938,373,365,128,493,3
2021-05-20,Mono,051,14174,1259,1269,16,1285,3
2021-05-20,Monterey,053,433212,43137,42984,1833,44817,379
2021-05-20,Napa,055,140530,9892,9913,34,9947,82
2021-05-20,Nevada,057,99092,4802,4775,187,4962,70
2021-05-20,Orange,059,3164182,255198,254127,11217,265344,5038
2021-05-20,Placer,061,380077,23227,22823,1486,24309,292
2021-05-20,Plumas,063,18699,700,682,10,692,4
2021-05-20,Riverside,065,2383286,293906,288453,13824,302277,4442
2021-05-20,Sacramento,067,1510023,105710,105414,1716,107130,1629
2021-05-20,San Benito,069,59416,6053,6067,112,6179,63
2021-05-20,San Bernardino,071,2135413,293098,292153,8908,301061,4728
2021-05-20,San Diego,073,3302833,280381,279490,14904,294394,3749
2021-05-20,San Francisco,075,870044,36651,36860,1260,38120,546
2021-05-20,San Joaquin,077,732212,72983,72388,3478,75866,1371
2021-05-20,San Luis Obispo,079,281455,21338,21095,726,21821,256
2021-05-20,San Mateo,081,765935,42260,42152,464,42616,432
2021-05-20,Santa Barbara,083,443738,34416,34293,1114,35407,459
2021-05-20,Santa Clara,085,1922200,118489,119222,743,119965,2029
2021-05-20,Santa Cruz,087,273765,16222,16119,796,16915,207
2021-05-20,Shasta,089,179085,12242,12266,1550,13816,200
2021-05-20,Sierra,091,2930,56,54,12,66,0
2021-05-20,Siskiyou,093,43540,1913,1811,343,2154,16
2021-05-20,Solano,095,438530,32740,32725,548,33273,253
2021-05-20,Sonoma,097,501317,29980,30107,326,30433,321
2021-05-20,Stanislaus,099,539301,56206,55979,5862,61841,970
2021-05-20,Sutter,101,95872,9431,9467,84,9551,113
2021-05-20,Tehama,103,63373,5066,5029,561,5590,63
2021-05-20,Trinity,105,12862,483,329,88,417,3
2021-05-20,Tulare,107,460477,50175,49217,8850,58067,837
2021-05-20,Tuolumne,109,53932,4024,4077,41,4118,65
2021-05-20,Ventura,111,848112,81302,80800,2941,83741,1019
2021-05-20,Yolo,113,214977,13997,13973,230,14203,211
2021-05-20,Yuba,115,75493,6029,6002,120,6122,49
2021-05-19,Alameda,001,1643700,87877,87889,1903,89792,1260
2021-05-19,Alpine,003,1148,87,88,0,88,0
2021-05-19,Amador,005,37829,3661,3669,32,3701,46
2021-05-19,Butte,007,227075,12489,12198,1794,13992,188
2021-05-19,Calaveras,009,45235,2141,2132,13,2145,54
2021-05-19,Colusa,011,21464,1940,1945,303,2248,15
2021-05-19,Contra Costa,013,1133247,69358,68836,1247,70083,808
2021-05-19,Del Norte,015,27424,1410,1371,12,1383,8
2021-05-19,El Dorado,017,186661,10274,10179,735,10914,112
2021-05-19,Fresno,019,978130,102545,102085,8580,110665,1693
2021-05-19,Glenn,021,27897,2429,2404,554,2958,17
2021-05-19,Humboldt,023,135768,4196,4143,34,4177,42
2021-05-19,Imperial,025,180216,28571,28550,2681,31231,732
2021-05-19,Inyo,027,18085,1404,1402,12,1414,36
2021-05-19,Kern,029,883053,97180,96173,10747,106920,1316
2021-05-19,Kings,031,150075,23133,22919,1066,23985,246
2021-05-19,Lake,033,64148,3514,3497,9,3506,43
2021-05-19,Lassen,035,31185,5198,5157,110,5267,6
2021-05-19,Los Angeles,037,10098052,1206022,1196856,40734,1237590,24143
2021-05-19,Madera,039,155013,16601,16496,922,17418,238
2021-05-19,Marin,041,260295,14077,14033,246,14279,227
2021-05-19,Mariposa,043,17540,429,425,11,436,5
2021-05-19,Mendocino,045,87422,3970,3886,82,3968,47
2021-05-19,Merced,047,269075,30937,31044,1026,32070,452
2021-05-19,Modoc,049,8938,373,364,125,489,3
2021-05-19,Mono,051,14174,1259,1266,16,1282,3
2021-05-19,Monterey,053,433212,43132,42973,1832,44805,379
2021-05-19,Napa,055,140530,9889,9906,34,9940,82
2021-05-19,Nevada,057,99092,4800,4769,187,4956,70
2021-05-19,Orange,059,3164182,255161,254087,11207,265294,5035
2021-05-19,Placer,061,380077,23208,22784,1481,24265,291
2021-05-19,Plumas,063,18699,700,682,10,692,4
2021-05-19,Riverside,065,2383286,293860,288398,13822,302220,4442
2021-05-19,Sacramento,067,1510023,105632,105225,1715,106940,1629
2021-05-19,San Benito,069,59416,6052,6064,112,6176,63
2021-05-19,San Bernardino,071,2135413,293054,292078,8905,300983,4725
2021-05-19,San Diego,073,3302833,280296,279345,14883,294228,3746
2021-05-19,San Francisco,075,870044,36638,36835,1259,38094,546
2021-05-19,San Joaquin,077,732212,72940,72338,3473,75811,1369
2021-05-19,San Luis Obispo,079,281455,21330,21085,725,21810,256
2021-05-19,San Mateo,081,765935,42253,42126,464,42590,429
2021-05-19,Santa Barbara,083,443738,34408,34292,1114,35406,459
2021-05-19,Santa Clara,085,1922200,118449,119176,742,119918,2015
2021-05-19,Santa Cruz,087,273765,16218,16121,795,16916,207
2021-05-19,Shasta,089,179085,12224,12233,1547,13780,200
2021-05-19,Sierra,091,2930,56,54,12,66,0
2021-05-19,Siskiyou,093,43540,1910,1803,342,2145,16
2021-05-19,Solano,095,438530,32713,32678,546,33224,253
2021-05-19,Sonoma,097,501317,29965,30080,326,30406,321
2021-05-19,Stanislaus,099,539301,56187,55912,5857,61769,967
2021-05-19,Sutter,101,95872,9424,9459,83,9542,113
2021-05-19,Tehama,103,63373,5057,5026,557,5583,63
2021-05-19,Trinity,105,12862,483,329,88,417,3
2021-05-19,Tulare,107,460477,50162,49163,8845,58008,837
2021-05-19,Tuolumne,109,53932,4024,4074,41,4115,64
2021-05-19,Ventura,111,848112,81287,80747,2940,83687,1019
2021-05-19,Yolo,113,214977,13990,13961,229,14190,211
2021-05-19,Yuba,115,75493,6025,5993,120,6113,49
2021-05-18,Alameda,001,1643700,87803,87816,1903,89719,1254
2021-05-18,Alpine,003,1148,87,88,0,88,0
2021-05-18,Amador,005,37829,3661,3669,32,3701,46
2021-05-18,Butte,007,227075,12476,12164,1791,13955,191
2021-05-18,Calaveras,009,45235,2137,2131,13,2144,54
2021-05-18,Colusa,011,21464,1940,1943,303,2246,14
2021-05-18,Contra Costa,013,1133247,69301,68750,1246,69996,808
2021-05-18,Del Norte,015,27424,1407,1371,12,1383,8
2021-05-18,El Dorado,017,186661,10263,10169,734,10903,112
2021-05-18,Fresno,019,978130,102509,102056,8577,110633,1690
2021-05-18,Glenn,021,27897,2423,2403,553,2956,17
2021-05-18,Humboldt,023,135768,4178,4132,34,4166,42
2021-05-18,Imperial,025,180216,28566,28538,2679,31217,730
2021-05-18,Inyo,027,18085,1404,1401,12,1413,36
2021-05-18,Kern,029,883053,97147,96128,10733,106861,1315
2021-05-18,Kings,031,150075,23127,22916,1066,23982,247
2021-05-18,Lake,033,64148,3512,3495,9,3504,43
2021-05-18,Lassen,035,31185,5197,5157,109,5266,6
2021-05-18,Los Angeles,037,10098052,1205842,1196668,40723,1237391,24133
2021-05-18,Madera,039,155013,16591,16491,921,17412,238
2021-05-18,Marin,041,260295,14074,14026,246,14272,227
2021-05-18,Mariposa,043,17540,429,424,11,435,5
2021-05-18,Mendocino,045,87422,3958,3877,81,3958,47
2021-05-18,Merced,047,269075,30918,31036,1026,32062,452
2021-05-18,Modoc,049,8938,372,364,124,488,3
2021-05-18,Mono,051,14174,1258,1265,16,1281,3
2021-05-18,Monterey,053,433212,43126,43001,1832,44833,379
2021-05-18,Napa,055,140530,9889,9905,34,9939,82
2021-05-18,Nevada,057,99092,4793,4762,187,4949,70
2021-05-18,Orange,059,3164182,255120,254041,11197,265238,5031
2021-05-18,Placer,061,380077,23175,22726,1477,24203,291
2021-05-18,Plumas,063,18699,700,682,10,692,4
2021-05-18,Riverside,065,2383286,293805,288354,13815,302169,4438
2021-05-18,Sacramento,067,1510023,105530,105083,1713,106796,1629
2021-05-18,San Benito,069,59416,6051,6065,112,6177,63
2021-05-18,San Bernardino,071,2135413,292996,292014,8900,300914,4722
2021-05-18,San Diego,073,3302833,280188,279254,14874,294128,3742
2021-05-18,San Francisco,075,870044,36618,36818,1259,38077,546
2021-05-18,San Joaquin,077,732212,72893,72282,3469,75751,1368
2021-05-18,San Luis Obispo,079,281455,21320,21080,723,21803,256
2021-05-18,San Mateo,081,765935,42241,42099,463,42562,428
2021-05-18,Santa Barbara,083,443738,34399,34278,1114,35392,459
2021-05-18,Santa Clara,085,1922200,118422,119171,742,119913,2014
2021-05-18,Santa Cruz,087,273765,16210,16137,795,16932,207
2021-05-18,Shasta,089,179085,12206,12197,1541,13738,200
2021-05-18,Sierra,091,2930,56,54,12,66,0
2021-05-18,Siskiyou,093,43540,1909,1799,342,2141,16
2021-05-18,Solano,095,438530,32688,32644,546,33190,253
2021-05-18,Sonoma,097,501317,29945,30054,325,30379,321
2021-05-18,Stanislaus,099,539301,56151,55860,5857,61717,959
2021-05-18,Sutter,101,95872,9416,9453,83,9536,113
2021-05-18,Tehama,103,63373,5051,5020,555,5575,63
2021-05-18,Trinity,105,12862,483,329,87,416,3
2021-05-18,Tulare,107,460477,50154,49142,8840,57982,836
2021-05-18,Tuolumne,109,53932,4022,4073,41,4114,64
2021-05-18,Ventura,111,848112,81271,80726,2938,83664,1017
2021-05-18,Yolo,113,214977,13983,13951,228,14179,211
2021-05-18,Yuba,115,75493,6021,5989,120,6109,49
2021-05-17,Alameda,001,1643700,87750,87766,1900,89666,1253
2021-05-17,Alpine,003,1148,87,88,0,88,0
2021-05-17,Amador,005,37829,3658,3668,32,3700,46
2021-05-17,Butte,007,227075,12468,12144,1791,13935,192
2021-05-17,Calaveras,009,45235,2137,2131,13,2144,53
2021-05-17,Colusa,011,21464,1940,1943,303,2246,14
2021-05-17,Contra Costa,013,1133247,69246,68720,1245,69965,805
2021-05-17,Del Norte,015,27424,1402,1369,12,1381,8
2021-05-17,El Dorado,017,186661,10246,10163,734,10897,112
2021-05-17,Fresno,019,978130,102465,102013,8569,110582,1690
2021-05-17,Glenn,021,27897,2423,2401,553,2954,17
2021-05-17,Humboldt,023,135768,4167,4112,34,4146,42
2021-05-17,Imperial,025,180216,28560,28533,2677,31210,729
2021-05-17,Inyo,027,18085,1404,1401,12,1413,36
2021-05-17,Kern,029,883053,97118,96095,10716,106811,1315
2021-05-17,Kings,031,150075,23124,22918,1066,23984,246
2021-05-17,Lake,033,64148,3507,3489,9,3498,43
2021-05-17,Lassen,035,31185,5194,5156,108,5264,6
2021-05-17,Los Angeles,037,10098052,1205661,1196556,40717,1237273,24123
2021-05-17,Madera,039,155013,16584,16486,921,17407,238
2021-05-17,Marin,041,260295,14068,14021,246,14267,227
2021-05-17,Mariposa,043,17540,428,423,11,434,5
2021-05-17,Mendocino,045,87422,3949,3868,81,3949,46
2021-05-17,Merced,047,269075,30903,31031,1026,32057,450
2021-05-17,Modoc,049,8938,371,362,124,486,3
2021-05-17,Mono,051,14174,1254,1265,16,1281,3
2021-05-17,Monterey,053,433212,43119,42995,1832,44827,379
2021-05-17,Napa,055,140530,9888,9894,34,9928,82
2021-05-17,Nevada,057,99092,4789,4761,186,4947,70
2021-05-17,Orange,059,3164182,255073,253993,11190,265183,5031
2021-05-17,Placer,061,380077,23152,22706,1470,24176,289
2021-05-17,Plumas,063,18699,700,682,10,692,4
2021-05-17,Riverside,065,2383286,293736,288304,13811,302115,4433
2021-05-17,Sacramento,067,1510023,105422,105035,1711,106746,1629
2021-05-17,San Benito,069,59416,6048,6067,112,6179,63
2021-05-17,San Bernardino,071,2135413,292946,291989,8892,300881,4724
2021-05-17,San Diego,073,3302833,280056,279146,14852,293998,3742
2021-05-17,San Francisco,075,870044,36606,36816,1257,38073,546
2021-05-17,San Joaquin,077,732212,72855,72234,3466,75700,1359
2021-05-17,San Luis Obispo,079,281455,21311,21079,721,21800,256
2021-05-17,San Mateo,081,765935,42213,42083,463,42546,428
2021-05-17,Santa Barbara,083,443738,34392,34275,1114,35389,459
2021-05-17,Santa Clara,085,1922200,118385,119116,740,119856,2015
2021-05-17,Santa Cruz,087,273765,16207,16151,795,16946,206
2021-05-17,Shasta,089,179085,12184,12163,1540,13703,200
2021-05-17,Sierra,091,2930,56,54,12,66,0
2021-05-17,Siskiyou,093,43540,1900,1795,339,2134,15
2021-05-17,Solano,095,438530,32670,32627,545,33172,253
2021-05-17,Sonoma,097,501317,29922,30043,324,30367,321
2021-05-17,Stanislaus,099,539301,56104,55839,5850,61689,951
2021-05-17,Sutter,101,95872,9409,9447,83,9530,113
2021-05-17,Tehama,103,63373,5047,5016,554,5570,63
2021-05-17,Trinity,105,12862,483,328,87,415,3
2021-05-17,Tulare,107,460477,50132,49107,8835,57942,836
2021-05-17,Tuolumne,109,53932,4022,4071,41,4112,64
2021-05-17,Ventura,111,848112,81251,80699,2938,83637,1017
2021-05-17,Yolo,113,214977,13976,13941,228,14169,211
2021-05-17,Yuba,115,75493,6013,5987,120,6107,49
2021-05-16,Alameda,001,1643700,87686,87743,1900,89643,1253
2021-05-16,Alpine,003,1148,87,88,0,88,0
2021-05-16,Amador,005,37829,3657,3667,32,3699,46
2021-05-16,Butte,007,227075,12454,12140,1790,13930,192
2021-05-16,Calaveras,009,45235,2135,2129,13,2142,53
2021-05-16,Colusa,011,21464,1938,1943,303,2246,14
2021-05-16,Contra Costa,013,1133247,69178,68694,1243,69937,805
2021-05-16,Del Norte,015,27424,1399,1365,12,1377,8
2021-05-16,El Dorado,017,186661,10230,10159,733,10892,112
2021-05-16,Fresno,019,978130,102421,101987,8563,110550,1690
2021-05-16,Glenn,021,27897,2423,2401,552,2953,17
2021-05-16,Humboldt,023,135768,4153,4104,34,4138,42
2021-05-16,Imperial,025,180216,28549,28516,2676,31192,729
2021-05-16,Inyo,027,18085,1404,1401,12,1413,36
2021-05-16,Kern,029,883053,97085,96083,10696,106779,1315
2021-05-16,Kings,031,150075,23120,22918,1063,23981,246
2021-05-16,Lake,033,64148,3504,3489,9,3498,43
2021-05-16,Lassen,035,31185,5193,5156,108,5264,6
2021-05-16,Los Angeles,037,10098052,1205436,1196397,40701,1237098,24120
2021-05-16,Madera,039,155013,16579,16483,918,17401,238
2021-05-16,Marin,041,260295,14065,14015,246,14261,227
2021-05-16,Mariposa,043,17540,428,423,11,434,5
2021-05-16,Mendocino,045,87422,3939,3863,81,3944,46
2021-05-16,Merced,047,269075,30882,31023,1024,32047,450
2021-05-16,Modoc,049,8938,371,362,124,486,3
2021-05-16,Mono,051,14174,1254,1265,16,1281,3
2021-05-16,Monterey,053,433212,43114,42991,1832,44823,379
2021-05-16,Napa,055,140530,9885,9891,34,9925,82
2021-05-16,Nevada,057,99092,4785,4755,186,4941,70
2021-05-16,Orange,059,3164182,255041,253962,11187,265149,5031
2021-05-16,Placer,061,380077,23120,22696,1464,24160,289
2021-05-16,Plumas,063,18699,699,682,10,692,4
2021-05-16,Riverside,065,2383286,293660,288259,13803,302062,4433
2021-05-16,Sacramento,067,1510023,105308,105013,1709,106722,1628
2021-05-16,San Benito,069,59416,6047,6067,111,6178,63
2021-05-16,San Bernardino,071,2135413,292874,291940,8890,300830,4724
2021-05-16,San Diego,073,3302833,279938,279099,14839,293938,3742
2021-05-16,San Francisco,075,870044,36583,36808,1256,38064,546
2021-05-16,San Joaquin,077,732212,72806,72218,3461,75679,1359
2021-05-16,San Luis Obispo,079,281455,21303,21072,720,21792,256
2021-05-16,San Mateo,081,765935,42202,42063,462,42525,428
2021-05-16,Santa Barbara,083,443738,34385,34270,1114,35384,459
2021-05-16,Santa Clara,085,1922200,118356,119098,739,119837,2015
2021-05-16,Santa Cruz,087,273765,16205,16143,795,16938,206
2021-05-16,Shasta,089,179085,12168,12156,1536,13692,200
2021-05-16,Sierra,091,2930,56,54,12,66,0
2021-05-16,Siskiyou,093,43540,1896,1790,338,2128,15
2021-05-16,Solano,095,438530,32637,32619,543,33162,253
2021-05-16,Sonoma,097,501317,29903,30033,324,30357,321
2021-05-16,Stanislaus,099,539301,56054,55814,5839,61653,951
2021-05-16,Sutter,101,95872,9402,9445,83,9528,113
2021-05-16,Tehama,103,63373,5043,5013,553,5566,63
2021-05-16,Trinity,105,12862,483,328,87,415,3
2021-05-16,Tulare,107,460477,50115,49091,8832,57923,837
2021-05-16,Tuolumne,109,53932,4018,4070,41,4111,64
2021-05-16,Ventura,111,848112,81220,80689,2938,83627,1017
2021-05-16,Yolo,113,214977,13961,13938,228,14166,211
2021-05-16,Yuba,115,75493,6010,5987,120,6107,49
2021-05-15,Alameda,001,1643700,87659,87677,1899,89576,1252
2021-05-15,Alpine,003,1148,87,88,0,88,0
2021-05-15,Amador,005,37829,3657,3666,32,3698,46
2021-05-15,Butte,007,227075,12447,12095,1789,13884,192
2021-05-15,Calaveras,009,45235,2134,2126,13,2139,53
2021-05-15,Colusa,011,21464,1938,1941,301,2242,14
2021-05-15,Contra Costa,013,1133247,69132,68658,1243,69901,805
2021-05-15,Del Norte,015,27424,1394,1359,12,1371,8
2021-05-15,El Dorado,017,186661,10218,10156,732,10888,112
2021-05-15,Fresno,019,978130,102384,101957,8561,110518,1690
2021-05-15,Glenn,021,27897,2423,2400,552,2952,17
2021-05-15,Humboldt,023,135768,4143,4080,34,4114,42
2021-05-15,Imperial,025,180216,28546,28504,2675,31179,729
2021-05-15,Inyo,027,18085,1404,1402,12,1414,36
2021-05-15,Kern,029,883053,97071,96061,10682,106743,1315
2021-05-15,Kings,031,150075,23119,22913,1063,23976,246
2021-05-15,Lake,033,64148,3503,3485,9,3494,43
2021-05-15,Lassen,035,31185,5190,5156,107,5263,6
2021-05-15,Los Angeles,037,10098052,1205313,1196255,40688,1236943,24115
2021-05-15,Madera,039,155013,16576,16482,918,17400,238
2021-05-15,Marin,041,260295,14061,14012,246,14258,227
2021-05-15,Mariposa,043,17540,428,423,11,434,5
2021-05-15,Mendocino,045,87422,3936,3861,81,3942,46
2021-05-15,Merced,047,269075,30861,31012,1024,32036,450
2021-05-15,Modoc,049,8938,371,362,124,486,3
2021-05-15,Mono,051,14174,1254,1265,16,1281,3
2021-05-15,Monterey,053,433212,43110,42982,1832,44814,379
2021-05-15,Napa,055,140530,9882,9887,34,9921,82
2021-05-15,Nevada,057,99092,4784,4755,186,4941,70
2021-05-15,Orange,059,3164182,255014,253919,11180,265099,5030
2021-05-15,Placer,061,380077,23099,22688,1464,24152,289
2021-05-15,Plumas,063,18699,699,681,10,691,4
2021-05-15,Riverside,065,2383286,293618,288203,13798,302001,4433
2021-05-15,Sacramento,067,1510023,105236,104929,1706,106635,1628
2021-05-15,San Benito,069,59416,6047,6066,111,6177,63
2021-05-15,San Bernardino,071,2135413,292832,291892,8888,300780,4724
2021-05-15,San Diego,073,3302833,279867,278991,14824,293815,3737
2021-05-15,San Francisco,075,870044,36567,36795,1254,38049,546
2021-05-15,San Joaquin,077,732212,72780,72197,3459,75656,1359
2021-05-15,San Luis Obispo,079,281455,21300,21061,719,21780,256
2021-05-15,San Mateo,081,765935,42186,42059,462,42521,428
2021-05-15,Santa Barbara,083,443738,34377,34259,1114,35373,459
2021-05-15,Santa Clara,085,1922200,118335,119060,739,119799,2016
2021-05-15,Santa Cruz,087,273765,16201,16137,795,16932,206
2021-05-15,Shasta,089,179085,12156,12152,1533,13685,200
2021-05-15,Sierra,091,2930,56,54,12,66,0
2021-05-15,Siskiyou,093,43540,1890,1788,336,2124,15
2021-05-15,Solano,095,438530,32628,32604,542,33146,253
2021-05-15,Sonoma,097,501317,29884,30020,324,30344,321
2021-05-15,Stanislaus,099,539301,56023,55795,5832,61627,952
2021-05-15,Sutter,101,95872,9400,9436,83,9519,113
2021-05-15,Tehama,103,63373,5039,5012,552,5564,63
2021-05-15,Trinity,105,12862,483,328,87,415,3
2021-05-15,Tulare,107,460477,50105,49080,8828,57908,837
2021-05-15,Tuolumne,109,53932,4016,4064,41,4105,63
2021-05-15,Ventura,111,848112,81209,80662,2938,83600,1017
2021-05-15,Yolo,113,214977,13954,13932,227,14159,211
2021-05-15,Yuba,115,75493,6007,5979,119,6098,49
2021-05-14,Alameda,001,1643700,87625,87621,1897,89518,1249
2021-05-14,Alpine,003,1148,87,88,0,88,0
2021-05-14,Amador,005,37829,3657,3665,32,3697,46
2021-05-14,Butte,007,227075,12438,12076,1786,13862,192
2021-05-14,Calaveras,009,45235,2130,2121,13,2134,53
2021-05-14,Colusa,011,21464,1937,1940,300,2240,14
2021-05-14,Contra Costa,013,1133247,69090,68589,1241,69830,806
2021-05-14,Del Norte,015,27424,1394,1355,12,1367,8
2021-05-14,El Dorado,017,186661,10211,10143,731,10874,113
2021-05-14,Fresno,019,978130,102355,101917,8555,110472,1688
2021-05-14,Glenn,021,27897,2422,2398,552,2950,17
2021-05-14,Humboldt,023,135768,4136,4050,34,4084,37
2021-05-14,Imperial,025,180216,28539,28485,2674,31159,728
2021-05-14,Inyo,027,18085,1404,1400,12,1412,36
2021-05-14,Kern,029,883053,97041,96033,10673,106706,1311
2021-05-14,Kings,031,150075,23118,22910,1063,23973,246
2021-05-14,Lake,033,64148,3499,3483,9,3492,43
2021-05-14,Lassen,035,31185,5190,5154,107,5261,6
2021-05-14,Los Angeles,037,10098052,1205178,1196038,40683,1236721,24101
2021-05-14,Madera,039,155013,16573,16474,918,17392,238
2021-05-14,Marin,041,260295,14057,14010,246,14256,227
2021-05-14,Mariposa,043,17540,428,422,11,433,5
2021-05-14,Mendocino,045,87422,3934,3855,81,3936,46
2021-05-14,Merced,047,269075,30851,31010,1024,32034,450
2021-05-14,Modoc,049,8938,371,362,124,486,3
2021-05-14,Mono,051,14174,1253,1265,16,1281,3
2021-05-14,Monterey,053,433212,43105,42973,1832,44805,380
2021-05-14,Napa,055,140530,9879,9883,34,9917,82
2021-05-14,Nevada,057,99092,4779,4745,186,4931,70
2021-05-14,Orange,059,3164182,254980,253855,11173,265028,5028
2021-05-14,Placer,061,380077,23080,22660,1458,24118,287
2021-05-14,Plumas,063,18699,698,680,10,690,4
2021-05-14,Riverside,065,2383286,293568,288140,13795,301935,4433
2021-05-14,Sacramento,067,1510023,105147,104828,1705,106533,1627
2021-05-14,San Benito,069,59416,6047,6064,111,6175,63
2021-05-14,San Bernardino,071,2135413,292784,291834,8888,300722,4721
2021-05-14,San Diego,073,3302833,279794,278853,14813,293666,3732
2021-05-14,San Francisco,075,870044,36558,36771,1250,38021,545
2021-05-14,San Joaquin,077,732212,72748,72160,3452,75612,1359
2021-05-14,San Luis Obispo,079,281455,21296,21051,719,21770,256
2021-05-14,San Mateo,081,765935,42176,42041,462,42503,428
2021-05-14,Santa Barbara,083,443738,34367,34243,1114,35357,456
2021-05-14,Santa Clara,085,1922200,118306,119006,739,119745,2014
2021-05-14,Santa Cruz,087,273765,16196,16130,795,16925,207
2021-05-14,Shasta,089,179085,12150,12130,1528,13658,200
2021-05-14,Sierra,091,2930,56,54,12,66,0
2021-05-14,Siskiyou,093,43540,1883,1779,335,2114,14
2021-05-14,Solano,095,438530,32608,32585,541,33126,252
2021-05-14,Sonoma,097,501317,29865,30007,324,30331,321
2021-05-14,Stanislaus,099,539301,55990,55752,5826,61578,950
2021-05-14,Sutter,101,95872,9391,9433,81,9514,113
2021-05-14,Tehama,103,63373,5032,5005,552,5557,63
2021-05-14,Trinity,105,12862,483,328,87,415,3
2021-05-14,Tulare,107,460477,50088,49060,8823,57883,836
2021-05-14,Tuolumne,109,53932,4016,4060,41,4101,63
2021-05-14,Ventura,111,848112,81195,80628,2938,83566,1014
2021-05-14,Yolo,113,214977,13949,13922,223,14145,210
2021-05-14,Yuba,115,75493,6003,5970,119,6089,47
2021-05-13,Alameda,001,1643700,87582,87557,1896,89453,1250
2021-05-13,Alpine,003,1148,87,88,0,88,0
2021-05-13,Amador,005,37829,3657,3662,32,3694,46
2021-05-13,Butte,007,227075,12423,12051,1785,13836,196
2021-05-13,Calaveras,009,45235,2128,2120,13,2133,53
2021-05-13,Colusa,011,21464,1936,1939,296,2235,14
2021-05-13,Contra Costa,013,1133247,69042,68522,1240,69762,806
2021-05-13,Del Norte,015,27424,1392,1354,12,1366,8
2021-05-13,El Dorado,017,186661,10208,10133,731,10864,112
2021-05-13,Fresno,019,978130,102326,101862,8554,110416,1687
2021-05-13,Glenn,021,27897,2421,2395,552,2947,17
2021-05-13,Humboldt,023,135768,4118,4027,34,4061,37
2021-05-13,Imperial,025,180216,28524,28468,2672,31140,729
2021-05-13,Inyo,027,18085,1404,1400,12,1412,36
2021-05-13,Kern,029,883053,97017,95996,10655,106651,1311
2021-05-13,Kings,031,150075,23117,22904,1063,23967,246
2021-05-13,Lake,033,64148,3498,3479,9,3488,43
2021-05-13,Lassen,035,31185,5190,5152,106,5258,6
2021-05-13,Los Angeles,037,10098052,1204989,1195504,40669,1236173,24083
2021-05-13,Madera,039,155013,16565,16467,918,17385,238
2021-05-13,Marin,041,260295,14052,14004,244,14248,227
2021-05-13,Mariposa,043,17540,428,422,11,433,5
2021-05-13,Mendocino,045,87422,3930,3846,81,3927,46
2021-05-13,Merced,047,269075,30844,30989,1023,32012,450
2021-05-13,Modoc,049,8938,371,362,124,486,3
2021-05-13,Mono,051,14174,1253,1265,16,1281,3
2021-05-13,Monterey,053,433212,43090,42966,1832,44798,380
2021-05-13,Napa,055,140530,9872,9877,34,9911,82
2021-05-13,Nevada,057,99092,4775,4743,185,4928,70
2021-05-13,Orange,059,3164182,254935,253778,11171,264949,5026
2021-05-13,Placer,061,380077,23053,22668,1451,24119,288
2021-05-13,Plumas,063,18699,698,680,10,690,4
2021-05-13,Riverside,065,2383286,293502,288067,13790,301857,4433
2021-05-13,Sacramento,067,1510023,105061,104711,1703,106414,1626
2021-05-13,San Benito,069,59416,6045,6062,111,6173,63
2021-05-13,San Bernardino,071,2135413,292718,291765,8888,300653,4722
2021-05-13,San Diego,073,3302833,279680,278592,14796,293388,3729
2021-05-13,San Francisco,075,870044,36534,36741,1248,37989,544
2021-05-13,San Joaquin,077,732212,72706,72096,3448,75544,1357
2021-05-13,San Luis Obispo,079,281455,21281,21043,718,21761,255
2021-05-13,San Mateo,081,765935,42159,42059,462,42521,426
2021-05-13,Santa Barbara,083,443738,34355,34242,1114,35356,456
2021-05-13,Santa Clara,085,1922200,118279,118952,739,119691,2013
2021-05-13,Santa Cruz,087,273765,16190,16129,795,16924,208
2021-05-13,Shasta,089,179085,12130,12111,1524,13635,200
2021-05-13,Sierra,091,2930,56,54,12,66,0
2021-05-13,Siskiyou,093,43540,1876,1769,332,2101,14
2021-05-13,Solano,095,438530,32595,32548,539,33087,252
2021-05-13,Sonoma,097,501317,29840,29991,324,30315,321
2021-05-13,Stanislaus,099,539301,55953,55678,5820,61498,949
2021-05-13,Sutter,101,95872,9386,9431,80,9511,112
2021-05-13,Tehama,103,63373,5027,4997,552,5549,63
2021-05-13,Trinity,105,12862,482,327,86,413,3
2021-05-13,Tulare,107,460477,50062,49032,8815,57847,837
2021-05-13,Tuolumne,109,53932,4015,4059,41,4100,63
2021-05-13,Ventura,111,848112,81165,80615,2937,83552,1012
2021-05-13,Yolo,113,214977,13940,13914,221,14135,210
2021-05-13,Yuba,115,75493,5994,5962,119,6081,47
2021-05-12,Alameda,001,1643700,87550,87482,1894,89376,1261
2021-05-12,Alpine,003,1148,87,88,0,88,0
2021-05-12,Amador,005,37829,3657,3658,32,3690,46
2021-05-12,Butte,007,227075,12413,12026,1785,13811,199
2021-05-12,Calaveras,009,45235,2125,2119,13,2132,53
2021-05-12,Colusa,011,21464,1934,1939,295,2234,14
2021-05-12,Contra Costa,013,1133247,68983,68462,1234,69696,805
2021-05-12,Del Norte,015,27424,1390,1352,12,1364,8
2021-05-12,El Dorado,017,186661,10198,10123,731,10854,112
2021-05-12,Fresno,019,978130,102277,101838,8543,110381,1688
2021-05-12,Glenn,021,27897,2418,2391,552,2943,17
2021-05-12,Humboldt,023,135768,4090,3982,34,4016,37
2021-05-12,Imperial,025,180216,28506,28443,2669,31112,726
2021-05-12,Inyo,027,18085,1404,1400,12,1412,36
2021-05-12,Kern,029,883053,96981,95955,10648,106603,1310
2021-05-12,Kings,031,150075,23115,22896,1063,23959,246
2021-05-12,Lake,033,64148,3496,3476,9,3485,43
2021-05-12,Lassen,035,31185,5188,5151,106,5257,6
2021-05-12,Los Angeles,037,10098052,1204805,1195318,40653,1235971,24067
2021-05-12,Madera,039,155013,16558,16462,917,17379,238
2021-05-12,Marin,041,260295,14047,13997,244,14241,227
2021-05-12,Mariposa,043,17540,428,422,11,433,5
2021-05-12,Mendocino,045,87422,3920,3836,81,3917,46
2021-05-12,Merced,047,269075,30828,30941,1023,31964,450
2021-05-12,Modoc,049,8938,370,362,124,486,3
2021-05-12,Mono,051,14174,1253,1265,16,1281,3
2021-05-12,Monterey,053,433212,43078,42950,1831,44781,380
2021-05-12,Napa,055,140530,9866,9870,34,9904,82
2021-05-12,Nevada,057,99092,4771,4738,185,4923,70
2021-05-12,Orange,059,3164182,254884,253587,11167,264754,5024
2021-05-12,Placer,061,380077,23035,22652,1444,24096,288
2021-05-12,Plumas,063,18699,698,681,10,691,4
2021-05-12,Riverside,065,2383286,293432,287830,13786,301616,4431
2021-05-12,Sacramento,067,1510023,104966,104592,1701,106293,1621
2021-05-12,San Benito,069,59416,6045,6062,111,6173,63
2021-05-12,San Bernardino,071,2135413,292669,291505,8883,300388,4715
2021-05-12,San Diego,073,3302833,279576,278402,14775,293177,3729
2021-05-12,San Francisco,075,870044,36514,36720,1247,37967,544
2021-05-12,San Joaquin,077,732212,72652,72043,3444,75487,1356
2021-05-12,San Luis Obispo,079,281455,21271,21021,718,21739,255
2021-05-12,San Mateo,081,765935,42150,42038,461,42499,426
2021-05-12,Santa Barbara,083,443738,34347,34218,1114,35332,456
2021-05-12,Santa Clara,085,1922200,118235,118897,739,119636,2005
2021-05-12,Santa Cruz,087,273765,16184,16123,795,16918,207
2021-05-12,Shasta,089,179085,12110,12092,1522,13614,200
2021-05-12,Sierra,091,2930,56,54,12,66,0
2021-05-12,Siskiyou,093,43540,1872,1760,331,2091,13
2021-05-12,Solano,095,438530,32571,32519,539,33058,252
2021-05-12,Sonoma,097,501317,29828,29976,324,30300,320
2021-05-12,Stanislaus,099,539301,55913,55632,5813,61445,919
2021-05-12,Sutter,101,95872,9383,9427,80,9507,112
2021-05-12,Tehama,103,63373,5022,4989,552,5541,62
2021-05-12,Trinity,105,12862,482,327,86,413,3
2021-05-12,Tulare,107,460477,50046,49001,8807,57808,838
2021-05-12,Tuolumne,109,53932,4014,4056,41,4097,63
2021-05-12,Ventura,111,848112,81146,80577,2937,83514,1010
2021-05-12,Yolo,113,214977,13932,13910,220,14130,210
2021-05-12,Yuba,115,75493,5991,5956,119,6075,47
2021-05-11,Alameda,001,1643700,87485,87413,1890,89303,1290
2021-05-11,Alpine,003,1148,87,88,0,88,0
2021-05-11,Amador,005,37829,3655,3657,32,3689,46
2021-05-11,Butte,007,227075,12398,12008,1782,13790,199
2021-05-11,Calaveras,009,45235,2125,2118,13,2131,52
2021-05-11,Colusa,011,21464,1933,1939,295,2234,14
2021-05-11,Contra Costa,013,1133247,68923,68406,1233,69639,806
2021-05-11,Del Norte,015,27424,1388,1347,12,1359,8
2021-05-11,El Dorado,017,186661,10192,10108,730,10838,112
2021-05-11,Fresno,019,978130,102231,101792,8538,110330,1686
2021-05-11,Glenn,021,27897,2417,2387,551,2938,17
2021-05-11,Humboldt,023,135768,4069,3964,33,3997,37
2021-05-11,Imperial,025,180216,28498,28413,2665,31078,722
2021-05-11,Inyo,027,18085,1403,1402,12,1414,36
2021-05-11,Kern,029,883053,96953,95938,10635,106573,1310
2021-05-11,Kings,031,150075,23107,22887,1063,23950,246
2021-05-11,Lake,033,64148,3496,3473,9,3482,43
2021-05-11,Lassen,035,31185,5186,5148,106,5254,6
2021-05-11,Los Angeles,037,10098052,1204568,1195100,40636,1235736,24048
2021-05-11,Madera,039,155013,16554,16459,916,17375,238
2021-05-11,Marin,041,260295,14040,13987,244,14231,227
2021-05-11,Mariposa,043,17540,428,421,11,432,5
2021-05-11,Mendocino,045,87422,3912,3821,81,3902,46
2021-05-11,Merced,047,269075,30819,30893,1023,31916,449
2021-05-11,Modoc,049,8938,370,362,123,485,3
2021-05-11,Mono,051,14174,1253,1265,16,1281,3
2021-05-11,Monterey,053,433212,43070,42934,1830,44764,380
2021-05-11,Napa,055,140530,9859,9870,34,9904,81
2021-05-11,Nevada,057,99092,4767,4737,185,4922,70
2021-05-11,Orange,059,3164182,254820,253545,11160,264705,5017
2021-05-11,Placer,061,380077,23013,22615,1440,24055,287
2021-05-11,Plumas,063,18699,696,679,10,689,4
2021-05-11,Riverside,065,2383286,293370,287757,13781,301538,4429
2021-05-11,Sacramento,067,1510023,104867,104496,1698,106194,1616
2021-05-11,San Benito,069,59416,6042,6058,111,6169,63
2021-05-11,San Bernardino,071,2135413,292609,291421,8881,300302,4707
2021-05-11,San Diego,073,3302833,279441,278308,14756,293064,3725
2021-05-11,San Francisco,075,870044,36494,36707,1247,37954,543
2021-05-11,San Joaquin,077,732212,72604,71999,3441,75440,1356
2021-05-11,San Luis Obispo,079,281455,21264,21008,716,21724,255
2021-05-11,San Mateo,081,765935,42131,41985,460,42445,425
2021-05-11,Santa Barbara,083,443738,34337,34207,1114,35321,456
2021-05-11,Santa Clara,085,1922200,118188,118857,738,119595,2005
2021-05-11,Santa Cruz,087,273765,16180,16113,795,16908,206
2021-05-11,Shasta,089,179085,12087,12050,1516,13566,200
2021-05-11,Sierra,091,2930,56,54,12,66,0
2021-05-11,Siskiyou,093,43540,1862,1756,329,2085,13
2021-05-11,Solano,095,438530,32553,32499,537,33036,250
2021-05-11,Sonoma,097,501317,29813,29966,324,30290,318
2021-05-11,Stanislaus,099,539301,55866,55589,5809,61398,909
2021-05-11,Sutter,101,95872,9376,9417,80,9497,112
2021-05-11,Tehama,103,63373,5018,4985,551,5536,62
2021-05-11,Trinity,105,12862,482,327,85,412,3
2021-05-11,Tulare,107,460477,50019,48974,8793,57767,837
2021-05-11,Tuolumne,109,53932,4013,4056,41,4097,63
2021-05-11,Ventura,111,848112,81122,80544,2934,83478,1008
2021-05-11,Yolo,113,214977,13919,13902,217,14119,210
2021-05-11,Yuba,115,75493,5982,5950,119,6069,46
2021-05-10,Alameda,001,1643700,87415,87366,1889,89255,1284
2021-05-10,Alpine,003,1148,87,88,0,88,0
2021-05-10,Amador,005,37829,3654,3657,32,3689,46
2021-05-10,Butte,007,227075,12382,11993,1778,13771,199
2021-05-10,Calaveras,009,45235,2118,2118,13,2131,52
2021-05-10,Colusa,011,21464,1933,1939,295,2234,14
2021-05-10,Contra Costa,013,1133247,68859,68357,1233,69590,806
2021-05-10,Del Norte,015,27424,1385,1339,12,1351,8
2021-05-10,El Dorado,017,186661,10178,10093,730,10823,113
2021-05-10,Fresno,019,978130,102199,101755,8531,110286,1682
2021-05-10,Glenn,021,27897,2416,2384,550,2934,17
2021-05-10,Humboldt,023,135768,4039,3961,33,3994,36
2021-05-10,Imperial,025,180216,28484,28397,2661,31058,722
2021-05-10,Inyo,027,18085,1403,1401,12,1413,36
2021-05-10,Kern,029,883053,96910,95920,10621,106541,1310
2021-05-10,Kings,031,150075,23096,22884,1062,23946,246
2021-05-10,Lake,033,64148,3488,3471,9,3480,43
2021-05-10,Lassen,035,31185,5182,5148,106,5254,5
2021-05-10,Los Angeles,037,10098052,1204301,1194976,40621,1235597,24030
2021-05-10,Madera,039,155013,16544,16450,916,17366,238
2021-05-10,Marin,041,260295,14037,13981,244,14225,228
2021-05-10,Mariposa,043,17540,427,420,11,431,5
2021-05-10,Mendocino,045,87422,3906,3818,81,3899,46
2021-05-10,Merced,047,269075,30809,30880,1023,31903,448
2021-05-10,Modoc,049,8938,370,361,123,484,3
2021-05-10,Mono,051,14174,1253,1265,16,1281,3
2021-05-10,Monterey,053,433212,43064,42927,1825,44752,380
2021-05-10,Napa,055,140530,9857,9860,34,9894,81
2021-05-10,Nevada,057,99092,4760,4735,185,4920,70
2021-05-10,Orange,059,3164182,254767,253484,11154,264638,5008
2021-05-10,Placer,061,380077,22991,22590,1437,24027,286
2021-05-10,Plumas,063,18699,695,679,10,689,4
2021-05-10,Riverside,065,2383286,293301,287689,13775,301464,4427
2021-05-10,Sacramento,067,1510023,104754,104378,1693,106071,1613
2021-05-10,San Benito,069,59416,6041,6058,111,6169,63
2021-05-10,San Bernardino,071,2135413,292558,291360,8880,300240,4707
2021-05-10,San Diego,073,3302833,279277,278183,14729,292912,3725
2021-05-10,San Francisco,075,870044,36475,36683,1247,37930,543
2021-05-10,San Joaquin,077,732212,72568,71954,3427,75381,1356
2021-05-10,San Luis Obispo,079,281455,21246,20993,715,21708,256
2021-05-10,San Mateo,081,765935,42114,41926,460,42386,424
2021-05-10,Santa Barbara,083,443738,34329,34201,1114,35315,456
2021-05-10,Santa Clara,085,1922200,118129,118822,738,119560,2003
2021-05-10,Santa Cruz,087,273765,16175,16114,795,16909,206
2021-05-10,Shasta,089,179085,12073,12036,1512,13548,200
2021-05-10,Sierra,091,2930,56,54,12,66,0
2021-05-10,Siskiyou,093,43540,1852,1752,327,2079,13
2021-05-10,Solano,095,438530,32533,32466,535,33001,250
2021-05-10,Sonoma,097,501317,29798,29955,323,30278,318
2021-05-10,Stanislaus,099,539301,55791,55541,5803,61344,898
2021-05-10,Sutter,101,95872,9370,9412,80,9492,111
2021-05-10,Tehama,103,63373,5014,4980,551,5531,62
2021-05-10,Trinity,105,12862,482,327,83,410,3
2021-05-10,Tulare,107,460477,49996,48956,8787,57743,837
2021-05-10,Tuolumne,109,53932,4009,4054,40,4094,63
2021-05-10,Ventura,111,848112,81106,80501,2933,83434,1008
2021-05-10,Yolo,113,214977,13907,13898,215,14113,209
2021-05-10,Yuba,115,75493,5980,5942,119,6061,46
2021-05-09,Alameda,001,1643700,87345,87292,1886,89178,1284
2021-05-09,Alpine,003,1148,87,88,0,88,0
2021-05-09,Amador,005,37829,3652,3655,32,3687,46
2021-05-09,Butte,007,227075,12364,11985,1774,13759,199
2021-05-09,Calaveras,009,45235,2117,2116,13,2129,52
2021-05-09,Colusa,011,21464,1932,1940,295,2235,14
2021-05-09,Contra Costa,013,1133247,68796,68302,1231,69533,806
2021-05-09,Del Norte,015,27424,1378,1338,12,1350,8
2021-05-09,El Dorado,017,186661,10164,10089,726,10815,113
2021-05-09,Fresno,019,978130,102161,101729,8522,110251,1682
2021-05-09,Glenn,021,27897,2409,2382,547,2929,17
2021-05-09,Humboldt,023,135768,4019,3950,33,3983,36
2021-05-09,Imperial,025,180216,28461,28388,2653,31041,722
2021-05-09,Inyo,027,18085,1403,1401,11,1412,36
2021-05-09,Kern,029,883053,96882,95903,10611,106514,1310
2021-05-09,Kings,031,150075,23087,22878,1062,23940,246
2021-05-09,Lake,033,64148,3484,3471,9,3480,43
2021-05-09,Lassen,035,31185,5180,5147,106,5253,5
2021-05-09,Los Angeles,037,10098052,1204043,1194820,40606,1235426,24026
2021-05-09,Madera,039,155013,16535,16444,910,17354,238
2021-05-09,Marin,041,260295,14026,13979,243,14222,228
2021-05-09,Mariposa,043,17540,424,420,11,431,5
2021-05-09,Mendocino,045,87422,3896,3814,81,3895,46
2021-05-09,Merced,047,269075,30786,30883,1023,31906,448
2021-05-09,Modoc,049,8938,370,360,123,483,3
2021-05-09,Mono,051,14174,1253,1264,16,1280,3
2021-05-09,Monterey,053,433212,43046,42918,1825,44743,380
2021-05-09,Napa,055,140530,9846,9857,34,9891,81
2021-05-09,Nevada,057,99092,4753,4727,185,4912,70
2021-05-09,Orange,059,3164182,254713,253451,11146,264597,5008
2021-05-09,Placer,061,380077,22965,22566,1434,24000,286
2021-05-09,Plumas,063,18699,694,679,10,689,4
2021-05-09,Riverside,065,2383286,293221,287644,13769,301413,4427
2021-05-09,Sacramento,067,1510023,104605,104309,1687,105996,1612
2021-05-09,San Benito,069,59416,6039,6056,111,6167,63
2021-05-09,San Bernardino,071,2135413,292475,291337,8874,300211,4707
2021-05-09,San Diego,073,3302833,279110,277950,14707,292657,3725
2021-05-09,San Francisco,075,870044,36449,36669,1245,37914,543
2021-05-09,San Joaquin,077,732212,72522,71927,3426,75353,1356
2021-05-09,San Luis Obispo,079,281455,21235,20999,715,21714,256
2021-05-09,San Mateo,081,765935,42084,41903,460,42363,424
2021-05-09,Santa Barbara,083,443738,34316,34196,1113,35309,456
2021-05-09,Santa Clara,085,1922200,118075,118798,737,119535,2003
2021-05-09,Santa Cruz,087,273765,16169,16094,795,16889,206
2021-05-09,Shasta,089,179085,12043,12034,1507,13541,200
2021-05-09,Sierra,091,2930,56,54,12,66,0
2021-05-09,Siskiyou,093,43540,1845,1741,324,2065,13
2021-05-09,Solano,095,438530,32494,32434,533,32967,250
2021-05-09,Sonoma,097,501317,29784,29953,322,30275,318
2021-05-09,Stanislaus,099,539301,55725,55511,5799,61310,898
2021-05-09,Sutter,101,95872,9364,9413,80,9493,111
2021-05-09,Tehama,103,63373,5009,4979,551,5530,62
2021-05-09,Trinity,105,12862,482,327,83,410,3
2021-05-09,Tulare,107,460477,49969,48948,8782,57730,837
2021-05-09,Tuolumne,109,53932,4006,4053,40,4093,63
2021-05-09,Ventura,111,848112,81091,80487,2932,83419,1008
2021-05-09,Yolo,113,214977,13897,13897,214,14111,209
2021-05-09,Yuba,115,75493,5974,5934,119,6053,46
2021-05-08,Alameda,001,1643700,87303,87213,1882,89095,1284
2021-05-08,Alpine,003,1148,87,88,0,88,0
2021-05-08,Amador,005,37829,3650,3652,32,3684,46
2021-05-08,Butte,007,227075,12352,11962,1773,13735,199
2021-05-08,Calaveras,009,45235,2116,2114,13,2127,52
2021-05-08,Colusa,011,21464,1932,1939,295,2234,14
2021-05-08,Contra Costa,013,1133247,68763,68223,1229,69452,803
2021-05-08,Del Norte,015,27424,1375,1335,12,1347,8
2021-05-08,El Dorado,017,186661,10150,10079,726,10805,113
2021-05-08,Fresno,019,978130,102125,101676,8517,110193,1682
2021-05-08,Glenn,021,27897,2407,2382,545,2927,17
2021-05-08,Humboldt,023,135768,4003,3939,33,3972,36
2021-05-08,Imperial,025,180216,28453,28373,2653,31026,721
2021-05-08,Inyo,027,18085,1403,1402,11,1413,36
2021-05-08,Kern,029,883053,96857,95880,10598,106478,1310
2021-05-08,Kings,031,150075,23084,22872,1061,23933,246
2021-05-08,Lake,033,64148,3483,3470,9,3479,43
2021-05-08,Lassen,035,31185,5179,5145,106,5251,5
2021-05-08,Los Angeles,037,10098052,1203889,1194584,40590,1235174,24022
2021-05-08,Madera,039,155013,16531,16442,910,17352,238
2021-05-08,Marin,041,260295,14023,13974,242,14216,228
2021-05-08,Mariposa,043,17540,424,420,11,431,5
2021-05-08,Mendocino,045,87422,3891,3810,80,3890,46
2021-05-08,Merced,047,269075,30777,30876,1023,31899,448
2021-05-08,Modoc,049,8938,370,360,122,482,3
2021-05-08,Mono,051,14174,1253,1262,16,1278,3
2021-05-08,Monterey,053,433212,43041,42914,1824,44738,380
2021-05-08,Napa,055,140530,9839,9853,34,9887,81
2021-05-08,Nevada,057,99092,4750,4716,185,4901,70
2021-05-08,Orange,059,3164182,254679,253412,11142,264554,5006
2021-05-08,Placer,061,380077,22947,22547,1432,23979,286
2021-05-08,Plumas,063,18699,693,679,10,689,4
2021-05-08,Riverside,065,2383286,293178,287574,13767,301341,4427
2021-05-08,Sacramento,067,1510023,104520,104208,1684,105892,1610
2021-05-08,San Benito,069,59416,6038,6048,111,6159,63
2021-05-08,San Bernardino,071,2135413,292432,291296,8874,300170,4707
2021-05-08,San Diego,073,3302833,279027,277760,14689,292449,3725
2021-05-08,San Francisco,075,870044,36426,36642,1245,37887,543
2021-05-08,San Joaquin,077,732212,72493,71869,3417,75286,1356
2021-05-08,San Luis Obispo,079,281455,21224,20992,715,21707,256
2021-05-08,San Mateo,081,765935,42073,41871,460,42331,424
2021-05-08,Santa Barbara,083,443738,34303,34185,1113,35298,456
2021-05-08,Santa Clara,085,1922200,118044,118751,737,119488,2003
2021-05-08,Santa Cruz,087,273765,16166,16089,795,16884,206
2021-05-08,Shasta,089,179085,12033,12030,1503,13533,200
2021-05-08,Sierra,091,2930,56,54,12,66,0
2021-05-08,Siskiyou,093,43540,1844,1741,320,2061,13
2021-05-08,Solano,095,438530,32470,32395,531,32926,249
2021-05-08,Sonoma,097,501317,29771,29942,322,30264,318
2021-05-08,Stanislaus,099,539301,55694,55467,5795,61262,898
2021-05-08,Sutter,101,95872,9361,9413,80,9493,111
2021-05-08,Tehama,103,63373,5007,4977,551,5528,62
2021-05-08,Trinity,105,12862,482,327,83,410,3
2021-05-08,Tulare,107,460477,49955,48929,8772,57701,837
2021-05-08,Tuolumne,109,53932,4005,4050,40,4090,63
2021-05-08,Ventura,111,848112,81080,80481,2929,83410,1008
2021-05-08,Yolo,113,214977,13894,13894,213,14107,209
2021-05-08,Yuba,115,75493,5966,5928,119,6047,46
2021-05-07,Alameda,001,1643700,87249,87128,1882,89010,1280
2021-05-07,Alpine,003,1148,87,88,0,88,0
2021-05-07,Amador,005,37829,3647,3651,32,3683,46
2021-05-07,Butte,007,227075,12331,11943,1770,13713,199
2021-05-07,Calaveras,009,45235,2114,2114,13,2127,52
2021-05-07,Colusa,011,21464,1932,1937,295,2232,14
2021-05-07,Contra Costa,013,1133247,68716,68156,1227,69383,804
2021-05-07,Del Norte,015,27424,1370,1329,12,1341,8
2021-05-07,El Dorado,017,186661,10137,10065,724,10789,112
2021-05-07,Fresno,019,978130,102092,101625,8516,110141,1684
2021-05-07,Glenn,021,27897,2404,2381,544,2925,17
2021-05-07,Humboldt,023,135768,3988,3919,33,3952,36
2021-05-07,Imperial,025,180216,28445,28352,2653,31005,721
2021-05-07,Inyo,027,18085,1403,1402,11,1413,36
2021-05-07,Kern,029,883053,96844,95839,10586,106425,1308
2021-05-07,Kings,031,150075,23083,22857,1060,23917,246
2021-05-07,Lake,033,64148,3481,3467,9,3476,43
2021-05-07,Lassen,035,31185,5178,5144,105,5249,5
2021-05-07,Los Angeles,037,10098052,1203709,1194294,40583,1234877,24008
2021-05-07,Madera,039,155013,16526,16439,910,17349,238
2021-05-07,Marin,041,260295,14019,13968,242,14210,228
2021-05-07,Mariposa,043,17540,423,419,11,430,5
2021-05-07,Mendocino,045,87422,3885,3805,80,3885,46
2021-05-07,Merced,047,269075,30774,30862,1023,31885,446
2021-05-07,Modoc,049,8938,370,360,122,482,3
2021-05-07,Mono,051,14174,1252,1261,16,1277,3
2021-05-07,Monterey,053,433212,43035,42909,1822,44731,380
2021-05-07,Napa,055,140530,9838,9849,34,9883,81
2021-05-07,Nevada,057,99092,4746,4704,185,4889,70
2021-05-07,Orange,059,3164182,254639,253338,11134,264472,5000
2021-05-07,Placer,061,380077,22927,22524,1430,23954,286
2021-05-07,Plumas,063,18699,693,678,10,688,4
2021-05-07,Riverside,065,2383286,293120,287479,13766,301245,4426
2021-05-07,Sacramento,067,1510023,104448,104068,1679,105747,1609
2021-05-07,San Benito,069,59416,6037,6048,111,6159,63
2021-05-07,San Bernardino,071,2135413,292390,291185,8869,300054,4697
2021-05-07,San Diego,073,3302833,278941,277534,14673,292207,3718
2021-05-07,San Francisco,075,870044,36413,36616,1244,37860,543
2021-05-07,San Joaquin,077,732212,72453,71804,3415,75219,1351
2021-05-07,San Luis Obispo,079,281455,21217,20979,715,21694,256
2021-05-07,San Mateo,081,765935,42058,41844,460,42304,424
2021-05-07,Santa Barbara,083,443738,34293,34166,1113,35279,453
2021-05-07,Santa Clara,085,1922200,118011,118691,736,119427,2002
2021-05-07,Santa Cruz,087,273765,16163,16074,795,16869,206
2021-05-07,Shasta,089,179085,12011,12005,1501,13506,200
2021-05-07,Sierra,091,2930,56,54,12,66,0
2021-05-07,Siskiyou,093,43540,1841,1723,320,2043,13
2021-05-07,Solano,095,438530,32442,32352,529,32881,249
2021-05-07,Sonoma,097,501317,29753,29925,320,30245,318
2021-05-07,Stanislaus,099,539301,55653,55407,5790,61197,896
2021-05-07,Sutter,101,95872,9361,9407,80,9487,111
2021-05-07,Tehama,103,63373,5000,4974,551,5525,57
2021-05-07,Trinity,105,12862,482,327,83,410,3
2021-05-07,Tulare,107,460477,49938,48913,8767,57680,837
2021-05-07,Tuolumne,109,53932,4003,4048,40,4088,63
2021-05-07,Ventura,111,848112,81056,80444,2929,83373,1008
2021-05-07,Yolo,113,214977,13888,13875,212,14087,209
2021-05-07,Yuba,115,75493,5956,5910,119,6029,46
2021-05-06,Alameda,001,1643700,87173,87028,1879,88907,1278
2021-05-06,Alpine,003,1148,87,88,0,88,0
2021-05-06,Amador,005,37829,3645,3650,32,3682,46
2021-05-06,Butte,007,227075,12311,11929,1765,13694,198
2021-05-06,Calaveras,009,45235,2114,2111,13,2124,52
2021-05-06,Colusa,011,21464,1932,1935,295,2230,14
2021-05-06,Contra Costa,013,1133247,68661,68076,1224,69300,802
2021-05-06,Del Norte,015,27424,1362,1324,12,1336,6
2021-05-06,El Dorado,017,186661,10130,10048,724,10772,112
2021-05-06,Fresno,019,978130,102048,101536,8512,110048,1680
2021-05-06,Glenn,021,27897,2403,2380,543,2923,17
2021-05-06,Humboldt,023,135768,3963,3898,33,3931,36
2021-05-06,Imperial,025,180216,28434,28311,2652,30963,720
2021-05-06,Inyo,027,18085,1403,1401,11,1412,36
2021-05-06,Kern,029,883053,96819,95801,10569,106370,1307
2021-05-06,Kings,031,150075,23076,22848,1059,23907,246
2021-05-06,Lake,033,64148,3480,3465,9,3474,43
2021-05-06,Lassen,035,31185,5177,5143,105,5248,1
2021-05-06,Los Angeles,037,10098052,1203467,1193954,40567,1234521,23991
2021-05-06,Madera,039,155013,16518,16430,910,17340,238
2021-05-06,Marin,041,260295,14015,13956,242,14198,228
2021-05-06,Mariposa,043,17540,422,419,11,430,5
2021-05-06,Mendocino,045,87422,3874,3802,80,3882,46
2021-05-06,Merced,047,269075,30759,30863,1022,31885,444
2021-05-06,Modoc,049,8938,370,360,122,482,3
2021-05-06,Mono,051,14174,1250,1261,16,1277,3
2021-05-06,Monterey,053,433212,43020,42899,1822,44721,379
2021-05-06,Napa,055,140530,9832,9843,34,9877,81
2021-05-06,Nevada,057,99092,4745,4687,185,4872,70
2021-05-06,Orange,059,3164182,254571,253286,11128,264414,4991
2021-05-06,Placer,061,380077,22905,22493,1430,23923,286
2021-05-06,Plumas,063,18699,693,678,10,688,4
2021-05-06,Riverside,065,2383286,293047,287399,13761,301160,4422
2021-05-06,Sacramento,067,1510023,104332,103956,1676,105632,1609
2021-05-06,San Benito,069,59416,6036,6045,111,6156,63
2021-05-06,San Bernardino,071,2135413,292320,291085,8868,299953,4683
2021-05-06,San Diego,073,3302833,278814,277324,14650,291974,3716
2021-05-06,San Francisco,075,870044,36398,36599,1244,37843,543
2021-05-06,San Joaquin,077,732212,72398,71729,3412,75141,1350
2021-05-06,San Luis Obispo,079,281455,21205,20965,713,21678,256
2021-05-06,San Mateo,081,765935,42039,41802,459,42261,424
2021-05-06,Santa Barbara,083,443738,34280,34152,1113,35265,453
2021-05-06,Santa Clara,085,1922200,117970,118591,736,119327,2001
2021-05-06,Santa Cruz,087,273765,16156,16050,795,16845,206
2021-05-06,Shasta,089,179085,11989,11983,1495,13478,199
2021-05-06,Sierra,091,2930,56,54,12,66,0
2021-05-06,Siskiyou,093,43540,1831,1711,319,2030,12
2021-05-06,Solano,095,438530,32416,32320,521,32841,249
2021-05-06,Sonoma,097,501317,29745,29911,320,30231,318
2021-05-06,Stanislaus,099,539301,55597,55323,5785,61108,834
2021-05-06,Sutter,101,95872,9355,9396,80,9476,111
2021-05-06,Tehama,103,63373,4995,4970,551,5521,53
2021-05-06,Trinity,105,12862,482,327,83,410,3
2021-05-06,Tulare,107,460477,49913,48890,8752,57642,836
2021-05-06,Tuolumne,109,53932,3999,4047,40,4087,63
2021-05-06,Ventura,111,848112,81025,80411,2926,83337,1005
2021-05-06,Yolo,113,214977,13880,13871,209,14080,209
2021-05-06,Yuba,115,75493,5944,5901,119,6020,46
2021-05-05,Alameda,001,1643700,87111,86950,1877,88827,1278
2021-05-05,Alpine,003,1148,87,88,0,88,0
2021-05-05,Amador,005,37829,3642,3650,32,3682,46
2021-05-05,Butte,007,227075,12293,11907,1762,13669,198
2021-05-05,Calaveras,009,45235,2110,2103,13,2116,52
2021-05-05,Colusa,011,21464,1931,1933,295,2228,14
2021-05-05,Contra Costa,013,1133247,68596,67997,1220,69217,803
2021-05-05,Del Norte,015,27424,1359,1317,12,1329,6
2021-05-05,El Dorado,017,186661,10119,10020,723,10743,111
2021-05-05,Fresno,019,978130,101998,101491,8503,109994,1680
2021-05-05,Glenn,021,27897,2400,2380,542,2922,17
2021-05-05,Humboldt,023,135768,3944,3886,32,3918,36
2021-05-05,Imperial,025,180216,28393,28295,2645,30940,720
2021-05-05,Inyo,027,18085,1402,1401,11,1412,36
2021-05-05,Kern,029,883053,96775,95753,10565,106318,1304
2021-05-05,Kings,031,150075,23070,22840,1058,23898,246
2021-05-05,Lake,033,64148,3477,3458,9,3467,43
2021-05-05,Lassen,035,31185,5177,5143,104,5247,1
2021-05-05,Los Angeles,037,10098052,1203200,1193608,40553,1234161,23977
2021-05-05,Madera,039,155013,16516,16423,910,17333,235
2021-05-05,Marin,041,260295,14007,13950,241,14191,228
2021-05-05,Mariposa,043,17540,422,418,11,429,5
2021-05-05,Mendocino,045,87422,3870,3799,80,3879,46
2021-05-05,Merced,047,269075,30738,30844,1022,31866,444
2021-05-05,Modoc,049,8938,369,361,121,482,3
2021-05-05,Mono,051,14174,1250,1260,16,1276,3
2021-05-05,Monterey,053,433212,43007,42870,1819,44689,379
2021-05-05,Napa,055,140530,9826,9833,34,9867,81
2021-05-05,Nevada,057,99092,4742,4666,185,4851,70
2021-05-05,Orange,059,3164182,254513,253237,11123,264360,4978
2021-05-05,Placer,061,380077,22873,22362,1426,23788,287
2021-05-05,Plumas,063,18699,693,677,10,687,4
2021-05-05,Riverside,065,2383286,292952,287353,13752,301105,4414
2021-05-05,Sacramento,067,1510023,104244,103476,1671,105147,1607
2021-05-05,San Benito,069,59416,6027,6046,111,6157,63
2021-05-05,San Bernardino,071,2135413,292245,291008,8864,299872,4677
2021-05-05,San Diego,073,3302833,278677,277098,14631,291729,3716
2021-05-05,San Francisco,075,870044,36384,36577,1243,37820,543
2021-05-05,San Joaquin,077,732212,72345,71638,3409,75047,1345
2021-05-05,San Luis Obispo,079,281455,21197,20958,713,21671,256
2021-05-05,San Mateo,081,765935,42010,41755,458,42213,415
2021-05-05,Santa Barbara,083,443738,34265,34139,1112,35251,453
2021-05-05,Santa Clara,085,1922200,117940,118482,733,119215,1992
2021-05-05,Santa Cruz,087,273765,16150,16013,795,16808,207
2021-05-05,Shasta,089,179085,11973,11939,1491,13430,200
2021-05-05,Sierra,091,2930,56,54,12,66,0
2021-05-05,Siskiyou,093,43540,1814,1706,311,2017,11
2021-05-05,Solano,095,438530,32381,32250,519,32769,249
2021-05-05,Sonoma,097,501317,29732,29879,320,30199,318
2021-05-05,Stanislaus,099,539301,55540,55231,5783,61014,807
2021-05-05,Sutter,101,95872,9349,9387,80,9467,111
2021-05-05,Tehama,103,63373,4991,4968,551,5519,53
2021-05-05,Trinity,105,12862,482,326,83,409,3
2021-05-05,Tulare,107,460477,49889,48875,8745,57620,835
2021-05-05,Tuolumne,109,53932,3996,4040,40,4080,63
2021-05-05,Ventura,111,848112,80997,80372,2922,83294,1005
2021-05-05,Yolo,113,214977,13876,13846,207,14053,209
2021-05-05,Yuba,115,75493,5934,5895,118,6013,44
2021-05-04,Alameda,001,1643700,87019,86894,1877,88771,1277
2021-05-04,Alpine,003,1148,87,88,0,88,0
2021-05-04,Amador,005,37829,3642,3650,32,3682,46
2021-05-04,Butte,007,227075,12269,11883,1761,13644,198
2021-05-04,Calaveras,009,45235,2106,2100,13,2113,52
2021-05-04,Colusa,011,21464,1930,1933,295,2228,14
2021-05-04,Contra Costa,013,1133247,68516,67931,1218,69149,799
2021-05-04,Del Norte,015,27424,1359,1314,12,1326,6
2021-05-04,El Dorado,017,186661,10108,10009,719,10728,110
2021-05-04,Fresno,019,978130,101943,101451,8496,109947,1677
2021-05-04,Glenn,021,27897,2397,2379,539,2918,17
2021-05-04,Humboldt,023,135768,3918,3877,32,3909,36
2021-05-04,Imperial,025,180216,28373,28276,2642,30918,720
2021-05-04,Inyo,027,18085,1402,1399,11,1410,36
2021-05-04,Kern,029,883053,96739,95720,10547,106267,1301
2021-05-04,Kings,031,150075,23056,22822,1055,23877,246
2021-05-04,Lake,033,64148,3476,3454,9,3463,43
2021-05-04,Lassen,035,31185,5176,5142,104,5246,1
2021-05-04,Los Angeles,037,10098052,1202910,1193453,40540,1233993,23957
2021-05-04,Madera,039,155013,16515,16418,910,17328,235
2021-05-04,Marin,041,260295,13999,13935,241,14176,228
2021-05-04,Mariposa,043,17540,422,418,11,429,5
2021-05-04,Mendocino,045,87422,3865,3794,80,3874,46
2021-05-04,Merced,047,269075,30721,30829,1022,31851,444
2021-05-04,Modoc,049,8938,368,360,120,480,3
2021-05-04,Mono,051,14174,1250,1260,16,1276,3
2021-05-04,Monterey,053,433212,42995,42845,1818,44663,380
2021-05-04,Napa,055,140530,9817,9824,34,9858,81
2021-05-04,Nevada,057,99092,4735,4656,185,4841,70
2021-05-04,Orange,059,3164182,254445,253177,11115,264292,4977
2021-05-04,Placer,061,380077,22845,22326,1423,23749,287
2021-05-04,Plumas,063,18699,692,675,10,685,4
2021-05-04,Riverside,065,2383286,292868,287285,13745,301030,4411
2021-05-04,Sacramento,067,1510023,104115,103383,1666,105049,1604
2021-05-04,San Benito,069,59416,6026,6039,111,6150,63
2021-05-04,San Bernardino,071,2135413,292167,290934,8857,299791,4668
2021-05-04,San Diego,073,3302833,278510,276879,14614,291493,3713
2021-05-04,San Francisco,075,870044,36366,36550,1243,37793,541
2021-05-04,San Joaquin,077,732212,72284,71582,3404,74986,1342
2021-05-04,San Luis Obispo,079,281455,21191,20923,711,21634,255
2021-05-04,San Mateo,081,765935,41984,41708,458,42166,415
2021-05-04,Santa Barbara,083,443738,34250,34131,1111,35242,453
2021-05-04,Santa Clara,085,1922200,117877,118431,732,119163,1988
2021-05-04,Santa Cruz,087,273765,16144,16005,795,16800,207
2021-05-04,Shasta,089,179085,11953,11923,1485,13408,198
2021-05-04,Sierra,091,2930,56,54,12,66,0
2021-05-04,Siskiyou,093,43540,1807,1694,309,2003,11
2021-05-04,Solano,095,438530,32340,32220,517,32737,249
2021-05-04,Sonoma,097,501317,29712,29867,319,30186,318
2021-05-04,Stanislaus,099,539301,55484,55165,5780,60945,807
2021-05-04,Sutter,101,95872,9344,9375,80,9455,111
2021-05-04,Tehama,103,63373,4988,4959,550,5509,53
2021-05-04,Trinity,105,12862,482,326,83,409,3
2021-05-04,Tulare,107,460477,49862,48857,8737,57594,835
2021-05-04,Tuolumne,109,53932,3994,4041,40,4081,61
2021-05-04,Ventura,111,848112,80968,80351,2920,83271,1005
2021-05-04,Yolo,113,214977,13863,13820,205,14025,208
2021-05-04,Yuba,115,75493,5928,5891,118,6009,44
2021-05-03,Alameda,001,1643700,86943,86845,1872,88717,1272
2021-05-03,Alpine,003,1148,87,88,0,88,0
2021-05-03,Amador,005,37829,3642,3651,32,3683,46
2021-05-03,Butte,007,227075,12259,11864,1758,13622,198
2021-05-03,Calaveras,009,45235,2104,2099,13,2112,50
2021-05-03,Colusa,011,21464,1929,1931,293,2224,14
2021-05-03,Contra Costa,013,1133247,68457,67895,1214,69109,799
2021-05-03,Del Norte,015,27424,1354,1306,11,1317,6
2021-05-03,El Dorado,017,186661,10090,9984,714,10698,110
2021-05-03,Fresno,019,978130,101887,101405,8485,109890,1678
2021-05-03,Glenn,021,27897,2397,2375,538,2913,17
2021-05-03,Humboldt,023,135768,3903,3865,32,3897,36
2021-05-03,Imperial,025,180216,28351,28280,2639,30919,720
2021-05-03,Inyo,027,18085,1401,1398,11,1409,36
2021-05-03,Kern,029,883053,96702,95693,10536,106229,1299
2021-05-03,Kings,031,150075,23047,22821,1055,23876,246
2021-05-03,Lake,033,64148,3474,3446,9,3455,43
2021-05-03,Lassen,035,31185,5175,5142,104,5246,1
2021-05-03,Los Angeles,037,10098052,1202642,1193261,40514,1233775,23942
2021-05-03,Madera,039,155013,16510,16414,909,17323,235
2021-05-03,Marin,041,260295,13993,13927,241,14168,228
2021-05-03,Mariposa,043,17540,422,418,11,429,5
2021-05-03,Mendocino,045,87422,3858,3792,80,3872,46
2021-05-03,Merced,047,269075,30710,30814,1020,31834,444
2021-05-03,Modoc,049,8938,368,360,120,480,3
2021-05-03,Mono,051,14174,1250,1259,16,1275,3
2021-05-03,Monterey,053,433212,42983,42837,1816,44653,380
2021-05-03,Napa,055,140530,9812,9815,34,9849,81
2021-05-03,Nevada,057,99092,4727,4650,185,4835,70
2021-05-03,Orange,059,3164182,254386,253107,11106,264213,4968
2021-05-03,Placer,061,380077,22814,22289,1417,23706,287
2021-05-03,Plumas,063,18699,691,675,10,685,4
2021-05-03,Riverside,065,2383286,292794,287233,13744,300977,4412
2021-05-03,Sacramento,067,1510023,103962,103303,1656,104959,1602
2021-05-03,San Benito,069,59416,6025,6038,111,6149,63
2021-05-03,San Bernardino,071,2135413,292099,290886,8854,299740,4659
2021-05-03,San Diego,073,3302833,278347,276693,14589,291282,3712
2021-05-03,San Francisco,075,870044,36340,36538,1243,37781,541
2021-05-03,San Joaquin,077,732212,72234,71504,3401,74905,1325
2021-05-03,San Luis Obispo,079,281455,21175,20915,708,21623,254
2021-05-03,San Mateo,081,765935,41961,41689,457,42146,413
2021-05-03,Santa Barbara,083,443738,34238,34119,1111,35230,453
2021-05-03,Santa Clara,085,1922200,117823,118373,731,119104,1988
2021-05-03,Santa Cruz,087,273765,16141,16000,795,16795,207
2021-05-03,Shasta,089,179085,11930,11890,1480,13370,197
2021-05-03,Sierra,091,2930,56,54,12,66,0
2021-05-03,Siskiyou,093,43540,1801,1683,303,1986,11
2021-05-03,Solano,095,438530,32299,32201,516,32717,249
2021-05-03,Sonoma,097,501317,29700,29855,316,30171,318
2021-05-03,Stanislaus,099,539301,55418,55116,5771,60887,774
2021-05-03,Sutter,101,95872,9332,9370,80,9450,111
2021-05-03,Tehama,103,63373,4980,4952,550,5502,53
2021-05-03,Trinity,105,12862,482,326,83,409,3
2021-05-03,Tulare,107,460477,49844,48844,8727,57571,835
2021-05-03,Tuolumne,109,53932,3993,4038,40,4078,61
2021-05-03,Ventura,111,848112,80946,80291,2920,83211,1005
2021-05-03,Yolo,113,214977,13850,13809,203,14012,208
2021-05-03,Yuba,115,75493,5923,5880,118,5998,44
2021-05-02,Alameda,001,1643700,86858,86784,1870,88654,1272
2021-05-02,Alpine,003,1148,87,88,0,88,0
2021-05-02,Amador,005,37829,3642,3650,32,3682,46
2021-05-02,Butte,007,227075,12235,11859,1756,13615,198
2021-05-02,Calaveras,009,45235,2100,2098,13,2111,50
2021-05-02,Colusa,011,21464,1928,1931,292,2223,14
2021-05-02,Contra Costa,013,1133247,68372,67843,1212,69055,800
2021-05-02,Del Norte,015,27424,1347,1305,11,1316,6
2021-05-02,El Dorado,017,186661,10075,9962,713,10675,110
2021-05-02,Fresno,019,978130,101815,101372,8474,109846,1678
2021-05-02,Glenn,021,27897,2396,2374,536,2910,17
2021-05-02,Humboldt,023,135768,3891,3858,31,3889,36
2021-05-02,Imperial,025,180216,28317,28275,2630,30905,721
2021-05-02,Inyo,027,18085,1399,1398,11,1409,36
2021-05-02,Kern,029,883053,96644,95668,10529,106197,1299
2021-05-02,Kings,031,150075,23029,22816,1054,23870,246
2021-05-02,Lake,033,64148,3472,3443,9,3452,43
2021-05-02,Lassen,035,31185,5174,5142,103,5245,1
2021-05-02,Los Angeles,037,10098052,1202290,1193056,40493,1233549,23943
2021-05-02,Madera,039,155013,16504,16410,909,17319,235
2021-05-02,Marin,041,260295,13983,13917,241,14158,228
2021-05-02,Mariposa,043,17540,422,419,11,430,5
2021-05-02,Mendocino,045,87422,3853,3787,80,3867,46
2021-05-02,Merced,047,269075,30690,30793,1016,31809,444
2021-05-02,Modoc,049,8938,367,360,120,480,3
2021-05-02,Mono,051,14174,1249,1259,16,1275,3
2021-05-02,Monterey,053,433212,42969,42837,1815,44652,380
2021-05-02,Napa,055,140530,9808,9805,34,9839,81
2021-05-02,Nevada,057,99092,4711,4635,185,4820,70
2021-05-02,Orange,059,3164182,254312,253025,11092,264117,4968
2021-05-02,Placer,061,380077,22785,22264,1414,23678,287
2021-05-02,Plumas,063,18699,691,675,10,685,4
2021-05-02,Riverside,065,2383286,292694,287197,13734,300931,4412
2021-05-02,Sacramento,067,1510023,103822,103153,1649,104802,1602
2021-05-02,San Benito,069,59416,6020,6037,111,6148,63
2021-05-02,San Bernardino,071,2135413,292000,290859,8852,299711,4655
2021-05-02,San Diego,073,3302833,278151,276521,14562,291083,3712
2021-05-02,San Francisco,075,870044,36314,36522,1243,37765,541
2021-05-02,San Joaquin,077,732212,72170,71447,3395,74842,1325
2021-05-02,San Luis Obispo,079,281455,21154,20910,707,21617,254
2021-05-02,San Mateo,081,765935,41945,41656,456,42112,412
2021-05-02,Santa Barbara,083,443738,34224,34106,1111,35217,453
2021-05-02,Santa Clara,085,1922200,117749,118321,731,119052,1988
2021-05-02,Santa Cruz,087,273765,16136,15995,794,16789,207
2021-05-02,Shasta,089,179085,11914,11885,1472,13357,197
2021-05-02,Sierra,091,2930,56,54,12,66,0
2021-05-02,Siskiyou,093,43540,1790,1661,302,1963,11
2021-05-02,Solano,095,438530,32260,32151,512,32663,249
2021-05-02,Sonoma,097,501317,29678,29842,316,30158,318
2021-05-02,Stanislaus,099,539301,55344,55057,5764,60821,774
2021-05-02,Sutter,101,95872,9326,9363,80,9443,111
2021-05-02,Tehama,103,63373,4975,4950,548,5498,53
2021-05-02,Trinity,105,12862,482,326,83,409,3
2021-05-02,Tulare,107,460477,49826,48834,8719,57553,835
2021-05-02,Tuolumne,109,53932,3990,4038,40,4078,61
2021-05-02,Ventura,111,848112,80908,80284,2919,83203,1005
2021-05-02,Yolo,113,214977,13838,13799,202,14001,208
2021-05-02,Yuba,115,75493,5913,5879,118,5997,44
2021-05-01,Alameda,001,1643700,86815,86704,1867,88571,1270
2021-05-01,Alpine,003,1148,87,88,0,88,0
2021-05-01,Amador,005,37829,3642,3650,32,3682,46
2021-05-01,Butte,007,227075,12221,11845,1751,13596,198
2021-05-01,Calaveras,009,45235,2098,2096,13,2109,50
2021-05-01,Colusa,011,21464,1927,1931,292,2223,14
2021-05-01,Contra Costa,013,1133247,68320,67779,1209,68988,800
2021-05-01,Del Norte,015,27424,1346,1292,11,1303,6
2021-05-01,El Dorado,017,186661,10061,9944,711,10655,110
2021-05-01,Fresno,019,978130,101770,101326,8468,109794,1678
2021-05-01,Glenn,021,27897,2393,2369,535,2904,17
2021-05-01,Humboldt,023,135768,3877,3845,31,3876,36
2021-05-01,Imperial,025,180216,28310,28262,2630,30892,721
2021-05-01,Inyo,027,18085,1399,1397,11,1408,36
2021-05-01,Kern,029,883053,96617,95645,10518,106163,1299
2021-05-01,Kings,031,150075,23026,22797,1053,23850,246
2021-05-01,Lake,033,64148,3470,3441,9,3450,43
2021-05-01,Lassen,035,31185,5172,5142,103,5245,1
2021-05-01,Los Angeles,037,10098052,1202120,1192781,40479,1233260,23946
2021-05-01,Madera,039,155013,16500,16408,909,17317,235
2021-05-01,Marin,041,260295,13976,13902,241,14143,228
2021-05-01,Mariposa,043,17540,422,418,11,429,5
2021-05-01,Mendocino,045,87422,3851,3782,80,3862,46
2021-05-01,Merced,047,269075,30673,30771,1015,31786,444
2021-05-01,Modoc,049,8938,367,361,120,481,3
2021-05-01,Mono,051,14174,1249,1258,16,1274,3
2021-05-01,Monterey,053,433212,42963,42828,1815,44643,379
2021-05-01,Napa,055,140530,9805,9800,34,9834,81
2021-05-01,Nevada,057,99092,4706,4625,185,4810,70
2021-05-01,Orange,059,3164182,254269,252969,11082,264051,4964
2021-05-01,Placer,061,380077,22759,22240,1412,23652,287
2021-05-01,Plumas,063,18699,690,675,10,685,4
2021-05-01,Riverside,065,2383286,292655,287129,13732,300861,4412
2021-05-01,Sacramento,067,1510023,103741,103043,1648,104691,1602
2021-05-01,San Benito,069,59416,6017,6030,111,6141,63
2021-05-01,San Bernardino,071,2135413,291957,290802,8851,299653,4652
2021-05-01,San Diego,073,3302833,278027,276367,14541,290908,3706
2021-05-01,San Francisco,075,870044,36299,36496,1243,37739,541
2021-05-01,San Joaquin,077,732212,72121,71389,3393,74782,1325
2021-05-01,San Luis Obispo,079,281455,21149,20896,707,21603,254
2021-05-01,San Mateo,081,765935,41916,41617,455,42072,411
2021-05-01,Santa Barbara,083,443738,34219,34085,1110,35195,453
2021-05-01,Santa Clara,085,1922200,117697,118265,729,118994,1988
2021-05-01,Santa Cruz,087,273765,16133,15984,794,16778,207
2021-05-01,Shasta,089,179085,11894,11878,1465,13343,197
2021-05-01,Sierra,091,2930,56,53,12,65,0
2021-05-01,Siskiyou,093,43540,1782,1653,301,1954,11
2021-05-01,Solano,095,438530,32230,32124,504,32628,249
2021-05-01,Sonoma,097,501317,29675,29835,316,30151,318
2021-05-01,Stanislaus,099,539301,55309,55005,5758,60763,774
2021-05-01,Sutter,101,95872,9323,9358,80,9438,110
2021-05-01,Tehama,103,63373,4974,4950,547,5497,53
2021-05-01,Trinity,105,12862,482,326,82,408,3
2021-05-01,Tulare,107,460477,49819,48818,8713,57531,835
2021-05-01,Tuolumne,109,53932,3984,4035,40,4075,61
2021-05-01,Ventura,111,848112,80890,80268,2919,83187,1005
2021-05-01,Yolo,113,214977,13831,13784,200,13984,208
2021-05-01,Yuba,115,75493,5911,5875,118,5993,44
2021-04-30,Alameda,001,1643700,86754,86602,1864,88466,1268
2021-04-30,Alpine,003,1148,87,88,0,88,0
2021-04-30,Amador,005,37829,3640,3650,32,3682,46
2021-04-30,Butte,007,227075,12202,11812,1747,13559,197
2021-04-30,Calaveras,009,45235,2097,2087,13,2100,50
2021-04-30,Colusa,011,21464,1927,1931,291,2222,14
2021-04-30,Contra Costa,013,1133247,68272,67684,1206,68890,800
2021-04-30,Del Norte,015,27424,1334,1276,11,1287,6
2021-04-30,El Dorado,017,186661,10047,9906,711,10617,110
2021-04-30,Fresno,019,978130,101724,101263,8464,109727,1670
2021-04-30,Glenn,021,27897,2392,2369,535,2904,17
2021-04-30,Humboldt,023,135768,3864,3834,31,3865,36
2021-04-30,Imperial,025,180216,28301,28244,2627,30871,721
2021-04-30,Inyo,027,18085,1399,1397,11,1408,36
2021-04-30,Kern,029,883053,96600,95605,10514,106119,1298
2021-04-30,Kings,031,150075,23023,22793,1052,23845,246
2021-04-30,Lake,033,64148,3466,3440,9,3449,43
2021-04-30,Lassen,035,31185,5171,5140,103,5243,1
2021-04-30,Los Angeles,037,10098052,1201908,1192393,40466,1232859,23919
2021-04-30,Madera,039,155013,16494,16395,909,17304,235
2021-04-30,Marin,041,260295,13968,13895,239,14134,228
2021-04-30,Mariposa,043,17540,422,417,11,428,5
2021-04-30,Mendocino,045,87422,3847,3777,80,3857,46
2021-04-30,Merced,047,269075,30660,30740,1014,31754,444
2021-04-30,Modoc,049,8938,366,360,120,480,3
2021-04-30,Mono,051,14174,1249,1258,16,1274,3
2021-04-30,Monterey,053,433212,42949,42810,1814,44624,379
2021-04-30,Napa,055,140530,9801,9792,34,9826,81
2021-04-30,Nevada,057,99092,4698,4608,185,4793,70
2021-04-30,Orange,059,3164182,254212,252883,11076,263959,4956
2021-04-30,Placer,061,380077,22740,22190,1408,23598,287
2021-04-30,Plumas,063,18699,690,677,10,687,4
2021-04-30,Riverside,065,2383286,292597,287030,13725,300755,4412
2021-04-30,Sacramento,067,1510023,103640,102864,1644,104508,1596
2021-04-30,San Benito,069,59416,6013,6024,110,6134,63
2021-04-30,San Bernardino,071,2135413,291897,290704,8850,299554,4640
2021-04-30,San Diego,073,3302833,277931,276157,14530,290687,3702
2021-04-30,San Francisco,075,870044,36288,36453,1242,37695,538
2021-04-30,San Joaquin,077,732212,72069,71311,3390,74701,1306
2021-04-30,San Luis Obispo,079,281455,21143,20884,707,21591,255
2021-04-30,San Mateo,081,765935,41902,41583,454,42037,380
2021-04-30,Santa Barbara,083,443738,34206,34061,1110,35171,451
2021-04-30,Santa Clara,085,1922200,117639,118170,725,118895,1988
2021-04-30,Santa Cruz,087,273765,16128,15975,794,16769,207
2021-04-30,Shasta,089,179085,11873,11848,1462,13310,197
2021-04-30,Sierra,091,2930,56,53,12,65,0
2021-04-30,Siskiyou,093,43540,1771,1628,298,1926,11
2021-04-30,Solano,095,438530,32198,32050,501,32551,249
2021-04-30,Sonoma,097,501317,29665,29816,314,30130,318
2021-04-30,Stanislaus,099,539301,55258,54938,5755,60693,774
2021-04-30,Sutter,101,95872,9321,9353,80,9433,110
2021-04-30,Tehama,103,63373,4971,4944,547,5491,53
2021-04-30,Trinity,105,12862,482,326,82,408,3
2021-04-30,Tulare,107,460477,49809,48797,8697,57494,836
2021-04-30,Tuolumne,109,53932,3983,4033,40,4073,61
2021-04-30,Ventura,111,848112,80850,80232,2914,83146,1004
2021-04-30,Yolo,113,214977,13819,13756,200,13956,208
2021-04-30,Yuba,115,75493,5903,5870,118,5988,44
2021-04-29,Alameda,001,1643700,86687,86490,1863,88353,1263
2021-04-29,Alpine,003,1148,87,88,0,88,0
2021-04-29,Amador,005,37829,3640,3649,32,3681,46
2021-04-29,Butte,007,227075,12187,11787,1745,13532,196
2021-04-29,Calaveras,009,45235,2094,2082,13,2095,50
2021-04-29,Colusa,011,21464,1927,1929,291,2220,14
2021-04-29,Contra Costa,013,1133247,68217,67606,1203,68809,795
2021-04-29,Del Norte,015,27424,1330,1271,11,1282,6
2021-04-29,El Dorado,017,186661,10027,9884,708,10592,107
2021-04-29,Fresno,019,978130,101670,101189,8453,109642,1667
2021-04-29,Glenn,021,27897,2389,2369,535,2904,17
2021-04-29,Humboldt,023,135768,3850,3815,31,3846,36
2021-04-29,Imperial,025,180216,28289,28235,2626,30861,720
2021-04-29,Inyo,027,18085,1399,1396,11,1407,36
2021-04-29,Kern,029,883053,96567,95547,10510,106057,1295
2021-04-29,Kings,031,150075,23013,22777,1047,23824,245
2021-04-29,Lake,033,64148,3458,3438,9,3447,43
2021-04-29,Lassen,035,31185,5171,5140,103,5243,1
2021-04-29,Los Angeles,037,10098052,1201630,1192068,40445,1232513,23899
2021-04-29,Madera,039,155013,16489,16383,908,17291,235
2021-04-29,Marin,041,260295,13964,13884,231,14115,228
2021-04-29,Mariposa,043,17540,421,416,11,427,5
2021-04-29,Mendocino,045,87422,3841,3774,80,3854,46
2021-04-29,Merced,047,269075,30641,30706,1013,31719,444
2021-04-29,Modoc,049,8938,366,360,120,480,3
2021-04-29,Mono,051,14174,1246,1259,16,1275,3
2021-04-29,Monterey,053,433212,42932,42797,1813,44610,379
2021-04-29,Napa,055,140530,9787,9789,34,9823,81
2021-04-29,Nevada,057,99092,4687,4590,185,4775,70
2021-04-29,Orange,059,3164182,254142,252823,11061,263884,4934
2021-04-29,Placer,061,380077,22715,22161,1406,23567,286
2021-04-29,Plumas,063,18699,689,676,10,686,4
2021-04-29,Riverside,065,2383286,292529,286947,13723,300670,4409
2021-04-29,Sacramento,067,1510023,103507,102686,1635,104321,1593
2021-04-29,San Benito,069,59416,6012,6023,110,6133,63
2021-04-29,San Bernardino,071,2135413,291825,290606,8845,299451,4609
2021-04-29,San Diego,073,3302833,277780,275961,14513,290474,3700
2021-04-29,San Francisco,075,870044,36263,36412,1242,37654,537
2021-04-29,San Joaquin,077,732212,72003,71225,3385,74610,1301
2021-04-29,San Luis Obispo,079,281455,21132,20876,707,21583,255
2021-04-29,San Mateo,081,765935,41874,41538,453,41991,358
2021-04-29,Santa Barbara,083,443738,34190,34039,1108,35147,448
2021-04-29,Santa Clara,085,1922200,117584,118082,722,118804,1984
2021-04-29,Santa Cruz,087,273765,16122,15961,794,16755,205
2021-04-29,Shasta,089,179085,11842,11836,1454,13290,193
2021-04-29,Sierra,091,2930,56,53,12,65,0
2021-04-29,Siskiyou,093,43540,1762,1615,295,1910,11
2021-04-29,Solano,095,438530,32157,32002,497,32499,248
2021-04-29,Sonoma,097,501317,29650,29785,311,30096,318
2021-04-29,Stanislaus,099,539301,55191,54836,5750,60586,774
2021-04-29,Sutter,101,95872,9314,9346,80,9426,110
2021-04-29,Tehama,103,63373,4963,4939,547,5486,53
2021-04-29,Trinity,105,12862,482,326,82,408,3
2021-04-29,Tulare,107,460477,49791,48785,8686,57471,832
2021-04-29,Tuolumne,109,53932,3982,4030,40,4070,58
2021-04-29,Ventura,111,848112,80816,80188,2912,83100,1002
2021-04-29,Yolo,113,214977,13799,13745,199,13944,205
2021-04-29,Yuba,115,75493,5893,5865,118,5983,44
2021-04-28,Alameda,001,1643700,86615,86390,1859,88249,1260
2021-04-28,Alpine,003,1148,87,88,0,88,0
2021-04-28,Amador,005,37829,3640,3646,32,3678,46
2021-04-28,Butte,007,227075,12167,11762,1740,13502,196
2021-04-28,Calaveras,009,45235,2090,2078,12,2090,50
2021-04-28,Colusa,011,21464,1924,1927,290,2217,14
2021-04-28,Contra Costa,013,1133247,68157,67539,1201,68740,795
2021-04-28,Del Norte,015,27424,1322,1267,11,1278,6
2021-04-28,El Dorado,017,186661,10002,9873,708,10581,107
2021-04-28,Fresno,019,978130,101623,101161,8443,109604,1666
2021-04-28,Glenn,021,27897,2386,2368,535,2903,17
2021-04-28,Humboldt,023,135768,3834,3796,31,3827,36
2021-04-28,Imperial,025,180216,28275,28177,2625,30802,720
2021-04-28,Inyo,027,18085,1399,1396,10,1406,36
2021-04-28,Kern,029,883053,96538,95494,10501,105995,1295
2021-04-28,Kings,031,150075,23001,22767,1045,23812,245
2021-04-28,Lake,033,64148,3455,3433,9,3442,43
2021-04-28,Lassen,035,31185,5171,5138,103,5241,1
2021-04-28,Los Angeles,037,10098052,1201328,1191729,40418,1232147,23858
2021-04-28,Madera,039,155013,16485,16372,908,17280,235
2021-04-28,Marin,041,260295,13953,13866,231,14097,227
2021-04-28,Mariposa,043,17540,418,415,11,426,5
2021-04-28,Mendocino,045,87422,3835,3770,78,3848,46
2021-04-28,Merced,047,269075,30623,30649,1013,31662,443
2021-04-28,Modoc,049,8938,366,360,120,480,3
2021-04-28,Mono,051,14174,1246,1258,16,1274,3
2021-04-28,Monterey,053,433212,42927,42776,1813,44589,379
2021-04-28,Napa,055,140530,9776,9777,34,9811,81
2021-04-28,Nevada,057,99092,4667,4570,185,4755,70
2021-04-28,Orange,059,3164182,254062,252747,11049,263796,4931
2021-04-28,Placer,061,380077,22688,22115,1405,23520,285
2021-04-28,Plumas,063,18699,689,676,10,686,4
2021-04-28,Riverside,065,2383286,292473,286868,13717,300585,4407
2021-04-28,Sacramento,067,1510023,103385,102613,1631,104244,1591
2021-04-28,San Benito,069,59416,6010,6021,110,6131,63
2021-04-28,San Bernardino,071,2135413,291746,290548,8835,299383,4582
2021-04-28,San Diego,073,3302833,277626,275821,14499,290320,3698
2021-04-28,San Francisco,075,870044,36233,36382,1241,37623,534
2021-04-28,San Joaquin,077,732212,71923,71171,3377,74548,1301
2021-04-28,San Luis Obispo,079,281455,21124,20851,707,21558,255
2021-04-28,San Mateo,081,765935,41849,41498,451,41949,358
2021-04-28,Santa Barbara,083,443738,34176,34003,1108,35111,448
2021-04-28,Santa Clara,085,1922200,117515,117997,720,118717,1969
2021-04-28,Santa Cruz,087,273765,16118,15943,793,16736,205
2021-04-28,Shasta,089,179085,11826,11815,1447,13262,192
2021-04-28,Sierra,091,2930,56,51,12,63,0
2021-04-28,Siskiyou,093,43540,1749,1603,292,1895,11
2021-04-28,Solano,095,438530,32125,31982,492,32474,248
2021-04-28,Sonoma,097,501317,29636,29773,307,30080,318
2021-04-28,Stanislaus,099,539301,55136,54745,5747,60492,774
2021-04-28,Sutter,101,95872,9309,9343,80,9423,110
2021-04-28,Tehama,103,63373,4958,4930,546,5476,53
2021-04-28,Trinity,105,12862,482,326,82,408,3
2021-04-28,Tulare,107,460477,49773,48754,8671,57425,832
2021-04-28,Tuolumne,109,53932,3979,4029,40,4069,58
2021-04-28,Ventura,111,848112,80781,80172,2910,83082,1000
2021-04-28,Yolo,113,214977,13785,13721,198,13919,205
2021-04-28,Yuba,115,75493,5887,5857,118,5975,44
2021-04-27,Alameda,001,1643700,86525,86301,1853,88154,1260
2021-04-27,Alpine,003,1148,87,88,0,88,0
2021-04-27,Amador,005,37829,3640,3645,32,3677,46
2021-04-27,Butte,007,227075,12142,11738,1734,13472,196
2021-04-27,Calaveras,009,45235,2088,2076,12,2088,50
2021-04-27,Colusa,011,21464,1923,1926,290,2216,14
2021-04-27,Contra Costa,013,1133247,68088,67470,1197,68667,791
2021-04-27,Del Norte,015,27424,1310,1266,11,1277,6
2021-04-27,El Dorado,017,186661,9973,9866,705,10571,106
2021-04-27,Fresno,019,978130,101558,101138,8433,109571,1663
2021-04-27,Glenn,021,27897,2386,2368,535,2903,17
2021-04-27,Humboldt,023,135768,3822,3780,31,3811,35
2021-04-27,Imperial,025,180216,28259,28149,2619,30768,720
2021-04-27,Inyo,027,18085,1399,1396,10,1406,36
2021-04-27,Kern,029,883053,96481,95466,10491,105957,1295
2021-04-27,Kings,031,150075,22986,22759,1043,23802,244
2021-04-27,Lake,033,64148,3454,3431,9,3440,43
2021-04-27,Lassen,035,31185,5171,5137,103,5240,1
2021-04-27,Los Angeles,037,10098052,1201005,1191504,40388,1231892,23825
2021-04-27,Madera,039,155013,16478,16365,908,17273,235
2021-04-27,Marin,041,260295,13931,13855,231,14086,227
2021-04-27,Mariposa,043,17540,417,413,11,424,5
2021-04-27,Mendocino,045,87422,3831,3765,78,3843,46
2021-04-27,Merced,047,269075,30582,30620,1013,31633,443
2021-04-27,Modoc,049,8938,365,360,120,480,3
2021-04-27,Mono,051,14174,1246,1257,16,1273,3
2021-04-27,Monterey,053,433212,42909,42752,1810,44562,379
2021-04-27,Napa,055,140530,9769,9774,32,9806,81
2021-04-27,Nevada,057,99092,4652,4557,185,4742,70
2021-04-27,Orange,059,3164182,253992,252667,11044,263711,4925
2021-04-27,Placer,061,380077,22659,22050,1401,23451,285
2021-04-27,Plumas,063,18699,688,675,10,685,4
2021-04-27,Riverside,065,2383286,292397,286820,13713,300533,4405
2021-04-27,Sacramento,067,1510023,103256,102595,1621,104216,1589
2021-04-27,San Benito,069,59416,6005,6016,110,6126,63
2021-04-27,San Bernardino,071,2135413,291679,290461,8830,299291,4575
2021-04-27,San Diego,073,3302833,277469,275685,14479,290164,3692
2021-04-27,San Francisco,075,870044,36205,36358,1240,37598,533
2021-04-27,San Joaquin,077,732212,71870,71104,3371,74475,1301
2021-04-27,San Luis Obispo,079,281455,21117,20841,707,21548,255
2021-04-27,San Mateo,081,765935,41814,41474,450,41924,358
2021-04-27,Santa Barbara,083,443738,34152,33973,1107,35080,448
2021-04-27,Santa Clara,085,1922200,117465,117945,719,118664,1969
2021-04-27,Santa Cruz,087,273765,16111,15905,792,16697,205
2021-04-27,Shasta,089,179085,11798,11802,1440,13242,192
2021-04-27,Sierra,091,2930,56,51,12,63,0
2021-04-27,Siskiyou,093,43540,1734,1597,291,1888,11
2021-04-27,Solano,095,438530,32077,31964,491,32455,248
2021-04-27,Sonoma,097,501317,29618,29761,306,30067,318
2021-04-27,Stanislaus,099,539301,55066,54695,5739,60434,752
2021-04-27,Sutter,101,95872,9304,9342,80,9422,110
2021-04-27,Tehama,103,63373,4955,4922,542,5464,53
2021-04-27,Trinity,105,12862,482,326,82,408,3
2021-04-27,Tulare,107,460477,49756,48744,8662,57406,832
2021-04-27,Tuolumne,109,53932,3976,4028,40,4068,58
2021-04-27,Ventura,111,848112,80752,80152,2908,83060,1000
2021-04-27,Yolo,113,214977,13772,13697,196,13893,205
2021-04-27,Yuba,115,75493,5887,5853,118,5971,44
2021-04-26,Alameda,001,1643700,86431,86230,1850,88080,1256
2021-04-26,Alpine,003,1148,87,88,0,88,0
2021-04-26,Amador,005,37829,3639,3645,32,3677,46
2021-04-26,Butte,007,227075,12118,11720,1730,13450,196
2021-04-26,Calaveras,009,45235,2082,2074,12,2086,50
2021-04-26,Colusa,011,21464,1923,1925,289,2214,14
2021-04-26,Contra Costa,013,1133247,68021,67392,1193,68585,789
2021-04-26,Del Norte,015,27424,1301,1263,11,1274,6
2021-04-26,El Dorado,017,186661,9952,9849,704,10553,106
2021-04-26,Fresno,019,978130,101503,101099,8420,109519,1662
2021-04-26,Glenn,021,27897,2384,2367,535,2902,17
2021-04-26,Humboldt,023,135768,3812,3764,30,3794,35
2021-04-26,Imperial,025,180216,28246,28148,2616,30764,720
2021-04-26,Inyo,027,18085,1398,1396,10,1406,36
2021-04-26,Kern,029,883053,96454,95429,10485,105914,1295
2021-04-26,Kings,031,150075,22983,22756,1040,23796,244
2021-04-26,Lake,033,64148,3449,3428,9,3437,43
2021-04-26,Lassen,035,31185,5171,5138,103,5241,1
2021-04-26,Los Angeles,037,10098052,1200676,1191253,40369,1231622,23802
2021-04-26,Madera,039,155013,16466,16353,907,17260,231
2021-04-26,Marin,041,260295,13916,13849,231,14080,227
2021-04-26,Mariposa,043,17540,416,410,11,421,5
2021-04-26,Mendocino,045,87422,3829,3757,77,3834,46
2021-04-26,Merced,047,269075,30565,30611,1010,31621,443
2021-04-26,Modoc,049,8938,365,360,120,480,3
2021-04-26,Mono,051,14174,1246,1258,16,1274,3
2021-04-26,Monterey,053,433212,42893,42740,1809,44549,379
2021-04-26,Napa,055,140530,9757,9769,32,9801,79
2021-04-26,Nevada,057,99092,4631,4548,185,4733,70
2021-04-26,Orange,059,3164182,253908,252592,11034,263626,4919
2021-04-26,Placer,061,380077,22631,22032,1396,23428,285
2021-04-26,Plumas,063,18699,688,670,10,680,4
2021-04-26,Riverside,065,2383286,292335,286724,13705,300429,4401
2021-04-26,Sacramento,067,1510023,103084,102459,1609,104068,1587
2021-04-26,San Benito,069,59416,6003,6013,110,6123,63
2021-04-26,San Bernardino,071,2135413,291627,290394,8829,299223,4572
2021-04-26,San Diego,073,3302833,277294,275541,14451,289992,3692
2021-04-26,San Francisco,075,870044,36177,36330,1239,37569,532
2021-04-26,San Joaquin,077,732212,71804,71050,3363,74413,1301
2021-04-26,San Luis Obispo,079,281455,21109,20830,706,21536,255
2021-04-26,San Mateo,081,765935,41784,41457,450,41907,357
2021-04-26,Santa Barbara,083,443738,34121,33948,1107,35055,448
2021-04-26,Santa Clara,085,1922200,117365,117874,716,118590,1968
2021-04-26,Santa Cruz,087,273765,16102,15877,792,16669,205
2021-04-26,Shasta,089,179085,11781,11787,1434,13221,192
2021-04-26,Sierra,091,2930,55,51,12,63,0
2021-04-26,Siskiyou,093,43540,1724,1592,288,1880,11
2021-04-26,Solano,095,438530,32032,31913,489,32402,247
2021-04-26,Sonoma,097,501317,29595,29755,304,30059,318
2021-04-26,Stanislaus,099,539301,54976,54638,5733,60371,744
2021-04-26,Sutter,101,95872,9299,9328,80,9408,110
2021-04-26,Tehama,103,63373,4950,4920,539,5459,53
2021-04-26,Trinity,105,12862,482,326,82,408,3
2021-04-26,Tulare,107,460477,49736,48735,8653,57388,831
2021-04-26,Tuolumne,109,53932,3975,4024,40,4064,58
2021-04-26,Ventura,111,848112,80727,80137,2905,83042,999
2021-04-26,Yolo,113,214977,13752,13684,193,13877,205
2021-04-26,Yuba,115,75493,5885,5851,118,5969,44
2021-04-25,Alameda,001,1643700,86330,86162,1844,88006,1256
2021-04-25,Alpine,003,1148,87,87,0,87,0
2021-04-25,Amador,005,37829,3638,3643,32,3675,46
2021-04-25,Butte,007,227075,12089,11709,1723,13432,196
2021-04-25,Calaveras,009,45235,2077,2072,11,2083,50
2021-04-25,Colusa,011,21464,1922,1924,289,2213,14
2021-04-25,Contra Costa,013,1133247,67929,67316,1192,68508,789
2021-04-25,Del Norte,015,27424,1295,1259,11,1270,6
2021-04-25,El Dorado,017,186661,9935,9837,702,10539,106
2021-04-25,Fresno,019,978130,101444,101061,8408,109469,1662
2021-04-25,Glenn,021,27897,2384,2366,535,2901,17
2021-04-25,Humboldt,023,135768,3799,3751,30,3781,35
2021-04-25,Imperial,025,180216,28220,28136,2614,30750,720
2021-04-25,Inyo,027,18085,1398,1396,10,1406,36
2021-04-25,Kern,029,883053,96388,95398,10473,105871,1295
2021-04-25,Kings,031,150075,22969,22755,1038,23793,244
2021-04-25,Lake,033,64148,3447,3427,9,3436,43
2021-04-25,Lassen,035,31185,5169,5138,103,5241,1
2021-04-25,Los Angeles,037,10098052,1200340,1190970,40349,1231319,23799
2021-04-25,Madera,039,155013,16454,16346,907,17253,231
2021-04-25,Marin,041,260295,13907,13852,231,14083,227
2021-04-25,Mariposa,043,17540,416,410,11,421,5
2021-04-25,Mendocino,045,87422,3822,3757,77,3834,46
2021-04-25,Merced,047,269075,30531,30586,1009,31595,443
2021-04-25,Modoc,049,8938,365,360,120,480,3
2021-04-25,Mono,051,14174,1246,1257,16,1273,3
2021-04-25,Monterey,053,433212,42880,42737,1807,44544,379
2021-04-25,Napa,055,140530,9752,9762,32,9794,79
2021-04-25,Nevada,057,99092,4619,4536,185,4721,70
2021-04-25,Orange,059,3164182,253832,252531,11028,263559,4919
2021-04-25,Placer,061,380077,22585,22011,1388,23399,285
2021-04-25,Plumas,063,18699,687,670,10,680,4
2021-04-25,Riverside,065,2383286,292241,286651,13699,300350,4401
2021-04-25,Sacramento,067,1510023,102916,102319,1599,103918,1587
2021-04-25,San Benito,069,59416,6001,6014,109,6123,63
2021-04-25,San Bernardino,071,2135413,291552,290357,8821,299178,4571
2021-04-25,San Diego,073,3302833,277081,275412,14418,289830,3692
2021-04-25,San Francisco,075,870044,36146,36310,1239,37549,532
2021-04-25,San Joaquin,077,732212,71709,70987,3353,74340,1301
2021-04-25,San Luis Obispo,079,281455,21090,20820,704,21524,255
2021-04-25,San Mateo,081,765935,41749,41465,449,41914,356
2021-04-25,Santa Barbara,083,443738,34095,33931,1107,35038,448
2021-04-25,Santa Clara,085,1922200,117286,117778,714,118492,1968
2021-04-25,Santa Cruz,087,273765,16096,15868,790,16658,205
2021-04-25,Shasta,089,179085,11758,11784,1429,13213,192
2021-04-25,Sierra,091,2930,55,51,12,63,0
2021-04-25,Siskiyou,093,43540,1713,1580,286,1866,11
2021-04-25,Solano,095,438530,31985,31864,481,32345,247
2021-04-25,Sonoma,097,501317,29577,29756,304,30060,318
2021-04-25,Stanislaus,099,539301,54880,54543,5725,60268,744
2021-04-25,Sutter,101,95872,9293,9326,80,9406,110
2021-04-25,Tehama,103,63373,4946,4916,537,5453,53
2021-04-25,Trinity,105,12862,482,326,82,408,3
2021-04-25,Tulare,107,460477,49720,48728,8640,57368,831
2021-04-25,Tuolumne,109,53932,3973,4022,40,4062,58
2021-04-25,Ventura,111,848112,80703,80110,2905,83015,999
2021-04-25,Yolo,113,214977,13727,13667,191,13858,205
2021-04-25,Yuba,115,75493,5882,5849,117,5966,44
2021-04-24,Alameda,001,1643700,86275,86016,1842,87858,1257
2021-04-24,Alpine,003,1148,87,86,0,86,0
2021-04-24,Amador,005,37829,3637,3640,32,3672,46
2021-04-24,Butte,007,227075,12073,11678,1721,13399,196
2021-04-24,Calaveras,009,45235,2073,2067,11,2078,50
2021-04-24,Colusa,011,21464,1921,1921,289,2210,14
2021-04-24,Contra Costa,013,1133247,67858,67222,1190,68412,789
2021-04-24,Del Norte,015,27424,1290,1255,11,1266,6
2021-04-24,El Dorado,017,186661,9924,9814,701,10515,106
2021-04-24,Fresno,019,978130,101413,100991,8402,109393,1662
2021-04-24,Glenn,021,27897,2384,2363,535,2898,17
2021-04-24,Humboldt,023,135768,3785,3722,30,3752,35
2021-04-24,Imperial,025,180216,28213,28124,2613,30737,720
2021-04-24,Inyo,027,18085,1397,1396,10,1406,36
2021-04-24,Kern,029,883053,96369,95365,10463,105828,1295
2021-04-24,Kings,031,150075,22966,22749,1038,23787,244
2021-04-24,Lake,033,64148,3446,3426,9,3435,43
2021-04-24,Lassen,035,31185,5168,5137,103,5240,1
2021-04-24,Los Angeles,037,10098052,1200108,1190603,40333,1230936,23802
2021-04-24,Madera,039,155013,16451,16338,907,17245,231
2021-04-24,Marin,041,260295,13899,13847,231,14078,227
2021-04-24,Mariposa,043,17540,416,409,11,420,5
2021-04-24,Mendocino,045,87422,3820,3754,75,3829,46
2021-04-24,Merced,047,269075,30511,30559,1009,31568,443
2021-04-24,Modoc,049,8938,365,360,120,480,3
2021-04-24,Mono,051,14174,1246,1256,16,1272,3
2021-04-24,Monterey,053,433212,42868,42727,1806,44533,379
2021-04-24,Napa,055,140530,9746,9756,32,9788,79
2021-04-24,Nevada,057,99092,4612,4522,185,4707,70
2021-04-24,Orange,059,3164182,253788,252441,11022,263463,4910
2021-04-24,Placer,061,380077,22572,21983,1387,23370,285
2021-04-24,Plumas,063,18699,686,670,10,680,4
2021-04-24,Riverside,065,2383286,292173,286552,13695,300247,4400
2021-04-24,Sacramento,067,1510023,102833,102179,1592,103771,1587
2021-04-24,San Benito,069,59416,5999,6007,109,6116,63
2021-04-24,San Bernardino,071,2135413,291503,290264,8820,299084,4568
2021-04-24,San Diego,073,3302833,276978,275252,14398,289650,3688
2021-04-24,San Francisco,075,870044,36117,36285,1235,37520,532
2021-04-24,San Joaquin,077,732212,71666,70911,3350,74261,1301
2021-04-24,San Luis Obispo,079,281455,21080,20797,703,21500,255
2021-04-24,San Mateo,081,765935,41736,41424,447,41871,355
2021-04-24,Santa Barbara,083,443738,34080,33911,1106,35017,448
2021-04-24,Santa Clara,085,1922200,117231,117674,712,118386,1968
2021-04-24,Santa Cruz,087,273765,16088,15840,790,16630,205
2021-04-24,Shasta,089,179085,11740,11770,1426,13196,192
2021-04-24,Sierra,091,2930,55,51,12,63,0
2021-04-24,Siskiyou,093,43540,1703,1574,285,1859,11
2021-04-24,Solano,095,438530,31962,31821,478,32299,247
2021-04-24,Sonoma,097,501317,29575,29739,304,30043,318
2021-04-24,Stanislaus,099,539301,54831,54455,5722,60177,744
2021-04-24,Sutter,101,95872,9290,9316,80,9396,110
2021-04-24,Tehama,103,63373,4941,4907,537,5444,53
2021-04-24,Trinity,105,12862,482,326,82,408,3
2021-04-24,Tulare,107,460477,49709,48705,8630,57335,830
2021-04-24,Tuolumne,109,53932,3969,4020,40,4060,58
2021-04-24,Ventura,111,848112,80690,80097,2903,83000,999
2021-04-24,Yolo,113,214977,13716,13653,191,13844,205
2021-04-24,Yuba,115,75493,5880,5837,117,5954,44
2021-04-23,Alameda,001,1643700,86201,85935,1839,87774,1256
2021-04-23,Alpine,003,1148,86,86,0,86,0
2021-04-23,Amador,005,37829,3636,3637,32,3669,46
2021-04-23,Butte,007,227075,12052,11672,1716,13388,196
2021-04-23,Calaveras,009,45235,2070,2064,11,2075,50
2021-04-23,Colusa,011,21464,1920,1921,289,2210,14
2021-04-23,Contra Costa,013,1133247,67804,67164,1188,68352,785
2021-04-23,Del Norte,015,27424,1289,1254,11,1265,6
2021-04-23,El Dorado,017,186661,9906,9788,698,10486,106
2021-04-23,Fresno,019,978130,101372,100928,8396,109324,1662
2021-04-23,Glenn,021,27897,2384,2361,534,2895,17
2021-04-23,Humboldt,023,135768,3775,3698,30,3728,35
2021-04-23,Imperial,025,180216,28198,28108,2612,30720,720
2021-04-23,Inyo,027,18085,1397,1395,10,1405,36
2021-04-23,Kern,029,883053,96344,95330,10457,105787,1295
2021-04-23,Kings,031,150075,22963,22735,1038,23773,244
2021-04-23,Lake,033,64148,3444,3425,9,3434,43
2021-04-23,Lassen,035,31185,5168,5141,103,5244,1
2021-04-23,Los Angeles,037,10098052,1199838,1190264,40309,1230573,23785
2021-04-23,Madera,039,155013,16442,16328,907,17235,231
2021-04-23,Marin,041,260295,13894,13838,231,14069,227
2021-04-23,Mariposa,043,17540,415,405,11,416,5
2021-04-23,Mendocino,045,87422,3818,3745,74,3819,46
2021-04-23,Merced,047,269075,30494,30530,1008,31538,443
2021-04-23,Modoc,049,8938,365,360,120,480,3
2021-04-23,Mono,051,14174,1244,1256,16,1272,3
2021-04-23,Monterey,053,433212,42862,42722,1806,44528,377
2021-04-23,Napa,055,140530,9741,9752,32,9784,79
2021-04-23,Nevada,057,99092,4603,4510,185,4695,70
2021-04-23,Orange,059,3164182,253744,252399,11015,263414,4904
2021-04-23,Placer,061,380077,22549,21959,1386,23345,282
2021-04-23,Plumas,063,18699,685,670,10,680,4
2021-04-23,Riverside,065,2383286,292114,286456,13690,300146,4399
2021-04-23,Sacramento,067,1510023,102746,102041,1589,103630,1586
2021-04-23,San Benito,069,59416,5997,6005,109,6114,63
2021-04-23,San Bernardino,071,2135413,291452,290189,8819,299008,4568
2021-04-23,San Diego,073,3302833,276839,275097,14375,289472,3684
2021-04-23,San Francisco,075,870044,36101,36252,1234,37486,532
2021-04-23,San Joaquin,077,732212,71610,70840,3347,74187,1295
2021-04-23,San Luis Obispo,079,281455,21071,20781,702,21483,255
2021-04-23,San Mateo,081,765935,41710,41386,447,41833,355
2021-04-23,Santa Barbara,083,443738,34070,33895,1104,34999,447
2021-04-23,Santa Clara,085,1922200,117169,117593,711,118304,1965
2021-04-23,Santa Cruz,087,273765,16081,15802,790,16592,205
2021-04-23,Shasta,089,179085,11733,11759,1425,13184,192
2021-04-23,Sierra,091,2930,55,51,12,63,0
2021-04-23,Siskiyou,093,43540,1691,1567,284,1851,11
2021-04-23,Solano,095,438530,31930,31784,474,32258,247
2021-04-23,Sonoma,097,501317,29561,29727,304,30031,318
2021-04-23,Stanislaus,099,539301,54769,54391,5714,60105,744
2021-04-23,Sutter,101,95872,9288,9312,80,9392,110
2021-04-23,Tehama,103,63373,4938,4906,537,5443,53
2021-04-23,Trinity,105,12862,482,326,82,408,3
2021-04-23,Tulare,107,460477,49692,48694,8623,57317,829
2021-04-23,Tuolumne,109,53932,3968,4020,40,4060,58
2021-04-23,Ventura,111,848112,80671,80095,2903,82998,996
2021-04-23,Yolo,113,214977,13705,13647,190,13837,205
2021-04-23,Yuba,115,75493,5877,5828,117,5945,44
2021-04-22,Alameda,001,1643700,86111,85829,1838,87667,1253
2021-04-22,Alpine,003,1148,86,86,0,86,0
2021-04-22,Amador,005,37829,3635,3633,32,3665,46
2021-04-22,Butte,007,227075,12038,11656,1713,13369,196
2021-04-22,Calaveras,009,45235,2068,2059,11,2070,50
2021-04-22,Colusa,011,21464,1918,1920,287,2207,14
2021-04-22,Contra Costa,013,1133247,67732,67029,1184,68213,782
2021-04-22,Del Norte,015,27424,1284,1252,11,1263,6
2021-04-22,El Dorado,017,186661,9894,9773,695,10468,106
2021-04-22,Fresno,019,978130,101327,100864,8385,109249,1657
2021-04-22,Glenn,021,27897,2383,2361,534,2895,17
2021-04-22,Humboldt,023,135768,3766,3680,30,3710,35
2021-04-22,Imperial,025,180216,28177,28096,2609,30705,720
2021-04-22,Inyo,027,18085,1396,1394,10,1404,36
2021-04-22,Kern,029,883053,96301,95292,10442,105734,1299
2021-04-22,Kings,031,150075,22953,22725,1038,23763,243
2021-04-22,Lake,033,64148,3442,3423,9,3432,43
2021-04-22,Lassen,035,31185,5168,5155,103,5258,1
2021-04-22,Los Angeles,037,10098052,1199516,1189878,40288,1230166,23762
2021-04-22,Madera,039,155013,16423,16316,907,17223,231
2021-04-22,Marin,041,260295,13886,13832,231,14063,227
2021-04-22,Mariposa,043,17540,414,403,11,414,5
2021-04-22,Mendocino,045,87422,3812,3729,74,3803,46
2021-04-22,Merced,047,269075,30459,30490,1007,31497,443
2021-04-22,Modoc,049,8938,365,360,120,480,3
2021-04-22,Mono,051,14174,1244,1254,16,1270,3
2021-04-22,Monterey,053,433212,42855,42708,1804,44512,377
2021-04-22,Napa,055,140530,9731,9734,32,9766,79
2021-04-22,Nevada,057,99092,4593,4504,183,4687,70
2021-04-22,Orange,059,3164182,253671,252307,11002,263309,4898
2021-04-22,Placer,061,380077,22518,21916,1382,23298,282
2021-04-22,Plumas,063,18699,684,670,10,680,4
2021-04-22,Riverside,065,2383286,292015,286362,13681,300043,4398
2021-04-22,Sacramento,067,1510023,102597,101870,1580,103450,1585
2021-04-22,San Benito,069,59416,5993,5998,109,6107,63
2021-04-22,San Bernardino,071,2135413,291383,290125,8810,298935,4571
2021-04-22,San Diego,073,3302833,276673,275913,14353,290266,3684
2021-04-22,San Francisco,075,870044,36078,36218,1231,37449,532
2021-04-22,San Joaquin,077,732212,71551,70751,3340,74091,1295
2021-04-22,San Luis Obispo,079,281455,21057,20761,702,21463,255
2021-04-22,San Mateo,081,765935,41684,41345,445,41790,355
2021-04-22,Santa Barbara,083,443738,34047,33870,1103,34973,446
2021-04-22,Santa Clara,085,1922200,117081,117457,707,118164,1954
2021-04-22,Santa Cruz,087,273765,16078,15737,789,16526,205
2021-04-22,Shasta,089,179085,11718,11738,1423,13161,192
2021-04-22,Sierra,091,2930,55,51,12,63,0
2021-04-22,Siskiyou,093,43540,1687,1564,283,1847,11
2021-04-22,Solano,095,438530,31884,31731,471,32202,247
2021-04-22,Sonoma,097,501317,29546,29705,300,30005,318
2021-04-22,Stanislaus,099,539301,54696,54313,5708,60021,744
2021-04-22,Sutter,101,95872,9284,9302,80,9382,110
2021-04-22,Tehama,103,63373,4932,4896,533,5429,53
2021-04-22,Trinity,105,12862,482,326,82,408,3
2021-04-22,Tulare,107,460477,49672,48669,8614,57283,828
2021-04-22,Tuolumne,109,53932,3964,4020,40,4060,58
2021-04-22,Ventura,111,848112,80645,80073,2901,82974,996
2021-04-22,Yolo,113,214977,13684,13616,190,13806,205
2021-04-22,Yuba,115,75493,5867,5825,117,5942,44
2021-04-21,Alameda,001,1643700,86032,85762,1836,87598,1249
2021-04-21,Alpine,003,1148,86,86,0,86,0
2021-04-21,Amador,005,37829,3632,3632,32,3664,46
2021-04-21,Butte,007,227075,12018,11643,1711,13354,196
2021-04-21,Calaveras,009,45235,2060,2057,11,2068,50
2021-04-21,Colusa,011,21464,1916,1920,286,2206,14
2021-04-21,Contra Costa,013,1133247,67666,66981,1183,68164,782
2021-04-21,Del Norte,015,27424,1280,1252,11,1263,6
2021-04-21,El Dorado,017,186661,9877,9760,692,10452,106
2021-04-21,Fresno,019,978130,101271,100838,8379,109217,1654
2021-04-21,Glenn,021,27897,2382,2361,534,2895,17
2021-04-21,Humboldt,023,135768,3747,3642,30,3672,35
2021-04-21,Imperial,025,180216,28165,28052,2608,30660,719
2021-04-21,Inyo,027,18085,1396,1392,10,1402,36
2021-04-21,Kern,029,883053,96255,95257,10432,105689,1297
2021-04-21,Kings,031,150075,22946,22713,1037,23750,243
2021-04-21,Lake,033,64148,3439,3421,9,3430,43
2021-04-21,Lassen,035,31185,5167,5156,103,5259,1
2021-04-21,Los Angeles,037,10098052,1199174,1189530,40269,1229799,23729
2021-04-21,Madera,039,155013,16418,16309,907,17216,231
2021-04-21,Marin,041,260295,13871,13822,231,14053,227
2021-04-21,Mariposa,043,17540,413,402,11,413,5
2021-04-21,Mendocino,045,87422,3810,3729,74,3803,46
2021-04-21,Merced,047,269075,30439,30471,1005,31476,442
2021-04-21,Modoc,049,8938,365,360,120,480,3
2021-04-21,Mono,051,14174,1244,1254,16,1270,3
2021-04-21,Monterey,053,433212,42840,42699,1802,44501,377
2021-04-21,Napa,055,140530,9725,9727,32,9759,79
2021-04-21,Nevada,057,99092,4579,4499,183,4682,70
2021-04-21,Orange,059,3164182,253595,252243,10989,263232,4889
2021-04-21,Placer,061,380077,22487,21896,1377,23273,282
2021-04-21,Plumas,063,18699,684,670,10,680,4
2021-04-21,Riverside,065,2383286,291921,286299,13674,299973,4388
2021-04-21,Sacramento,067,1510023,102468,101803,1574,103377,1579
2021-04-21,San Benito,069,59416,5990,5998,109,6107,63
2021-04-21,San Bernardino,071,2135413,291307,290049,8808,298857,4572
2021-04-21,San Diego,073,3302833,276464,275632,14315,289947,3681
2021-04-21,San Francisco,075,870044,36058,36194,1230,37424,529
2021-04-21,San Joaquin,077,732212,71496,70687,3330,74017,1295
2021-04-21,San Luis Obispo,079,281455,21042,20724,701,21425,255
2021-04-21,San Mateo,081,765935,41653,41318,444,41762,355
2021-04-21,Santa Barbara,083,443738,34028,33830,1102,34932,445
2021-04-21,Santa Clara,085,1922200,117003,117318,701,118019,1946
2021-04-21,Santa Cruz,087,273765,16069,15698,789,16487,204
2021-04-21,Shasta,089,179085,11699,11722,1421,13143,192
2021-04-21,Sierra,091,2930,55,51,12,63,0
2021-04-21,Siskiyou,093,43540,1680,1557,283,1840,11
2021-04-21,Solano,095,438530,31845,31712,470,32182,244
2021-04-21,Sonoma,097,501317,29534,29697,299,29996,318
2021-04-21,Stanislaus,099,539301,54635,54290,5702,59992,742
2021-04-21,Sutter,101,95872,9276,9297,80,9377,110
2021-04-21,Tehama,103,63373,4925,4893,532,5425,53
2021-04-21,Trinity,105,12862,482,326,82,408,3
2021-04-21,Tulare,107,460477,49657,48653,8601,57254,828
2021-04-21,Tuolumne,109,53932,3961,4019,40,4059,58
2021-04-21,Ventura,111,848112,80613,80039,2898,82937,996
2021-04-21,Yolo,113,214977,13664,13606,189,13795,200
2021-04-21,Yuba,115,75493,5860,5822,116,5938,44
2021-04-20,Alameda,001,1643700,85937,85652,1834,87486,1248
2021-04-20,Alpine,003,1148,85,85,0,85,0
2021-04-20,Amador,005,37829,3631,3631,32,3663,46
2021-04-20,Butte,007,227075,11999,11619,1709,13328,196
2021-04-20,Calaveras,009,45235,2059,2053,11,2064,50
2021-04-20,Colusa,011,21464,1916,1915,285,2200,14
2021-04-20,Contra Costa,013,1133247,67582,66889,1180,68069,782
2021-04-20,Del Norte,015,27424,1279,1250,11,1261,6
2021-04-20,El Dorado,017,186661,9849,9743,690,10433,106
2021-04-20,Fresno,019,978130,101213,100768,8369,109137,1650
2021-04-20,Glenn,021,27897,2380,2359,533,2892,17
2021-04-20,Humboldt,023,135768,3729,3612,30,3642,35
2021-04-20,Imperial,025,180216,28146,28024,2604,30628,719
2021-04-20,Inyo,027,18085,1396,1393,10,1403,36
2021-04-20,Kern,029,883053,96219,95223,10416,105639,1295
2021-04-20,Kings,031,150075,22940,22693,1034,23727,243
2021-04-20,Lake,033,64148,3437,3418,9,3427,43
2021-04-20,Lassen,035,31185,5167,5155,103,5258,1
2021-04-20,Los Angeles,037,10098052,1198826,1189256,40239,1229495,23694
2021-04-20,Madera,039,155013,16412,16301,907,17208,231
2021-04-20,Marin,041,260295,13857,13807,231,14038,227
2021-04-20,Mariposa,043,17540,412,402,11,413,5
2021-04-20,Mendocino,045,87422,3809,3726,74,3800,46
2021-04-20,Merced,047,269075,30412,30439,1004,31443,441
2021-04-20,Modoc,049,8938,365,359,120,479,3
2021-04-20,Mono,051,14174,1243,1254,16,1270,3
2021-04-20,Monterey,053,433212,42829,42663,1800,44463,363
2021-04-20,Napa,055,140530,9721,9711,32,9743,79
2021-04-20,Nevada,057,99092,4561,4485,183,4668,70
2021-04-20,Orange,059,3164182,253505,252134,10977,263111,4887
2021-04-20,Placer,061,380077,22453,21846,1373,23219,282
2021-04-20,Plumas,063,18699,683,670,10,680,4
2021-04-20,Riverside,065,2383286,291824,286194,13669,299863,4388
2021-04-20,Sacramento,067,1510023,102330,101629,1566,103195,1574
2021-04-20,San Benito,069,59416,5987,5988,109,6097,63
2021-04-20,San Bernardino,071,2135413,291226,289905,8806,298711,4569
2021-04-20,San Diego,073,3302833,276233,275369,14282,289651,3674
2021-04-20,San Francisco,075,870044,36039,36117,1229,37346,529
2021-04-20,San Joaquin,077,732212,71423,70590,3321,73911,1289
2021-04-20,San Luis Obispo,079,281455,21019,20691,693,21384,254
2021-04-20,San Mateo,081,765935,41622,41251,444,41695,355
2021-04-20,Santa Barbara,083,443738,34009,33803,1102,34905,445
2021-04-20,Santa Clara,085,1922200,116905,117228,697,117925,1944
2021-04-20,Santa Cruz,087,273765,16057,15647,789,16436,204
2021-04-20,Shasta,089,179085,11683,11677,1418,13095,189
2021-04-20,Sierra,091,2930,55,51,12,63,0
2021-04-20,Siskiyou,093,43540,1672,1551,282,1833,10
2021-04-20,Solano,095,438530,31790,31673,466,32139,243
2021-04-20,Sonoma,097,501317,29525,29676,297,29973,311
2021-04-20,Stanislaus,099,539301,54570,54236,5689,59925,735
2021-04-20,Sutter,101,95872,9272,9279,80,9359,109
2021-04-20,Tehama,103,63373,4920,4887,531,5418,52
2021-04-20,Trinity,105,12862,482,326,82,408,3
2021-04-20,Tulare,107,460477,49635,48650,8593,57243,831
2021-04-20,Tuolumne,109,53932,3961,4014,40,4054,58
2021-04-20,Ventura,111,848112,80585,80018,2896,82914,995
2021-04-20,Yolo,113,214977,13644,13581,188,13769,200
2021-04-20,Yuba,115,75493,5850,5814,116,5930,44
2021-04-19,Alameda,001,1643700,85819,85583,1830,87413,1247
2021-04-19,Alpine,003,1148,85,85,0,85,0
2021-04-19,Amador,005,37829,3630,3629,32,3661,46
2021-04-19,Butte,007,227075,11981,11601,1704,13305,196
2021-04-19,Calaveras,009,45235,2057,2050,11,2061,50
2021-04-19,Colusa,011,21464,1916,1913,284,2197,14
2021-04-19,Contra Costa,013,1133247,67504,66833,1178,68011,782
2021-04-19,Del Norte,015,27424,1277,1247,11,1258,6
2021-04-19,El Dorado,017,186661,9833,9726,685,10411,106
2021-04-19,Fresno,019,978130,101145,100702,8357,109059,1646
2021-04-19,Glenn,021,27897,2380,2358,532,2890,17
2021-04-19,Humboldt,023,135768,3709,3602,28,3630,35
2021-04-19,Imperial,025,180216,28125,27995,2604,30599,719
2021-04-19,Inyo,027,18085,1396,1392,10,1402,36
2021-04-19,Kern,029,883053,96189,95162,10401,105563,1290
2021-04-19,Kings,031,150075,22925,22688,1034,23722,243
2021-04-19,Lake,033,64148,3436,3416,9,3425,43
2021-04-19,Lassen,035,31185,5166,5156,103,5259,1
2021-04-19,Los Angeles,037,10098052,1198446,1188945,40215,1229160,23666
2021-04-19,Madera,039,155013,16401,16289,906,17195,231
2021-04-19,Marin,041,260295,13846,13804,230,14034,226
2021-04-19,Mariposa,043,17540,411,401,11,412,5
2021-04-19,Mendocino,045,87422,3807,3722,74,3796,46
2021-04-19,Merced,047,269075,30383,30422,1003,31425,441
2021-04-19,Modoc,049,8938,365,359,120,479,3
2021-04-19,Mono,051,14174,1242,1254,16,1270,3
2021-04-19,Monterey,053,433212,42816,42642,1795,44437,356
2021-04-19,Napa,055,140530,9713,9680,32,9712,79
2021-04-19,Nevada,057,99092,4545,4477,183,4660,70
2021-04-19,Orange,059,3164182,253387,252013,10962,262975,4883
2021-04-19,Placer,061,380077,22430,21814,1369,23183,282
2021-04-19,Plumas,063,18699,683,665,10,675,4
2021-04-19,Riverside,065,2383286,291729,286087,13659,299746,4371
2021-04-19,Sacramento,067,1510023,102194,101482,1556,103038,1572
2021-04-19,San Benito,069,59416,5979,5989,109,6098,63
2021-04-19,San Bernardino,071,2135413,291141,289738,8800,298538,4561
2021-04-19,San Diego,073,3302833,275985,275113,14249,289362,3674
2021-04-19,San Francisco,075,870044,36002,36094,1227,37321,529
2021-04-19,San Joaquin,077,732212,71343,70514,3315,73829,1289
2021-04-19,San Luis Obispo,079,281455,20993,20669,687,21356,254
2021-04-19,San Mateo,081,765935,41589,41226,443,41669,355
2021-04-19,Santa Barbara,083,443738,33995,33786,1102,34888,446
2021-04-19,Santa Clara,085,1922200,116794,117099,693,117792,1944
2021-04-19,Santa Cruz,087,273765,16045,15600,789,16389,204
2021-04-19,Shasta,089,179085,11668,11662,1410,13072,189
2021-04-19,Sierra,091,2930,55,51,12,63,0
2021-04-19,Siskiyou,093,43540,1662,1544,282,1826,10
2021-04-19,Solano,095,438530,31751,31643,461,32104,239
2021-04-19,Sonoma,097,501317,29506,29667,297,29964,311
2021-04-19,Stanislaus,099,539301,54494,54179,5685,59864,728
2021-04-19,Sutter,101,95872,9261,9269,80,9349,109
2021-04-19,Tehama,103,63373,4914,4878,531,5409,52
2021-04-19,Trinity,105,12862,482,326,81,407,3
2021-04-19,Tulare,107,460477,49619,48630,8580,57210,831
2021-04-19,Tuolumne,109,53932,3960,4010,40,4050,58
2021-04-19,Ventura,111,848112,80559,80000,2894,82894,996
2021-04-19,Yolo,113,214977,13632,13572,185,13757,200
2021-04-19,Yuba,115,75493,5843,5804,115,5919,44
2021-04-18,Alameda,001,1643700,85704,85481,1822,87303,1247
2021-04-18,Alpine,003,1148,85,85,0,85,0
2021-04-18,Amador,005,37829,3627,3627,32,3659,46
2021-04-18,Butte,007,227075,11963,11591,1699,13290,196
2021-04-18,Calaveras,009,45235,2051,2047,11,2058,50
2021-04-18,Colusa,011,21464,1912,1912,283,2195,14
2021-04-18,Contra Costa,013,1133247,67401,66750,1174,67924,782
2021-04-18,Del Norte,015,27424,1277,1240,11,1251,6
2021-04-18,El Dorado,017,186661,9810,9710,683,10393,106
2021-04-18,Fresno,019,978130,101087,100621,8351,108972,1646
2021-04-18,Glenn,021,27897,2375,2358,532,2890,17
2021-04-18,Humboldt,023,135768,3681,3590,28,3618,35
2021-04-18,Imperial,025,180216,28110,27991,2599,30590,719
2021-04-18,Inyo,027,18085,1395,1392,10,1402,36
2021-04-18,Kern,029,883053,96153,95129,10386,105515,1290
2021-04-18,Kings,031,150075,22916,22685,1034,23719,243
2021-04-18,Lake,033,64148,3435,3413,9,3422,43
2021-04-18,Lassen,035,31185,5163,5156,103,5259,1
2021-04-18,Los Angeles,037,10098052,1197986,1188620,40192,1228812,23648
2021-04-18,Madera,039,155013,16390,16277,905,17182,231
2021-04-18,Marin,041,260295,13839,13801,229,14030,226
2021-04-18,Mariposa,043,17540,410,400,10,410,5
2021-04-18,Mendocino,045,87422,3804,3722,74,3796,46
2021-04-18,Merced,047,269075,30346,30405,1002,31407,441
2021-04-18,Modoc,049,8938,365,359,120,479,3
2021-04-18,Mono,051,14174,1242,1254,16,1270,3
2021-04-18,Monterey,053,433212,42804,42638,1794,44432,356
2021-04-18,Napa,055,140530,9697,9674,32,9706,79
2021-04-18,Nevada,057,99092,4530,4464,183,4647,70
2021-04-18,Orange,059,3164182,253273,251940,10955,262895,4883
2021-04-18,Placer,061,380077,22387,21783,1364,23147,282
2021-04-18,Plumas,063,18699,682,665,10,675,4
2021-04-18,Riverside,065,2383286,291639,286043,13655,299698,4371
2021-04-18,Sacramento,067,1510023,102019,101354,1550,102904,1572
2021-04-18,San Benito,069,59416,5977,5989,109,6098,63
2021-04-18,San Bernardino,071,2135413,291048,289691,8791,298482,4556
2021-04-18,San Diego,073,3302833,275706,274961,14214,289175,3674
2021-04-18,San Francisco,075,870044,35965,36073,1223,37296,525
2021-04-18,San Joaquin,077,732212,71262,70466,3306,73772,1289
2021-04-18,San Luis Obispo,079,281455,20971,20656,681,21337,254
2021-04-18,San Mateo,081,765935,41560,41201,442,41643,352
2021-04-18,Santa Barbara,083,443738,33960,33769,1101,34870,446
2021-04-18,Santa Clara,085,1922200,116627,116996,688,117684,1944
2021-04-18,Santa Cruz,087,273765,16035,15580,788,16368,204
2021-04-18,Shasta,089,179085,11647,11658,1407,13065,189
2021-04-18,Sierra,091,2930,55,51,12,63,0
2021-04-18,Siskiyou,093,43540,1651,1538,281,1819,10
2021-04-18,Solano,095,438530,31701,31606,460,32066,239
2021-04-18,Sonoma,097,501317,29490,29660,295,29955,311
2021-04-18,Stanislaus,099,539301,54412,54132,5679,59811,728
2021-04-18,Sutter,101,95872,9247,9261,80,9341,109
2021-04-18,Tehama,103,63373,4905,4877,530,5407,52
2021-04-18,Trinity,105,12862,482,326,81,407,3
2021-04-18,Tulare,107,460477,49606,48618,8575,57193,829
2021-04-18,Tuolumne,109,53932,3959,4008,39,4047,58
2021-04-18,Ventura,111,848112,80528,79984,2891,82875,996
2021-04-18,Yolo,113,214977,13620,13562,183,13745,200
2021-04-18,Yuba,115,75493,5836,5804,115,5919,44
2021-04-17,Alameda,001,1643700,85629,85367,1820,87187,1247
2021-04-17,Alpine,003,1148,85,85,0,85,0
2021-04-17,Amador,005,37829,3625,3625,32,3657,46
2021-04-17,Butte,007,227075,11943,11573,1695,13268,196
2021-04-17,Calaveras,009,45235,2049,2045,11,2056,50
2021-04-17,Colusa,011,21464,1912,1912,283,2195,14
2021-04-17,Contra Costa,013,1133247,67353,66657,1166,67823,782
2021-04-17,Del Norte,015,27424,1277,1238,11,1249,6
2021-04-17,El Dorado,017,186661,9795,9692,680,10372,106
2021-04-17,Fresno,019,978130,101054,100562,8346,108908,1646
2021-04-17,Glenn,021,27897,2375,2357,532,2889,17
2021-04-17,Humboldt,023,135768,3657,3579,28,3607,35
2021-04-17,Imperial,025,180216,28099,27987,2599,30586,719
2021-04-17,Inyo,027,18085,1392,1392,10,1402,36
2021-04-17,Kern,029,883053,96135,95102,10382,105484,1290
2021-04-17,Kings,031,150075,22911,22678,1033,23711,243
2021-04-17,Lake,033,64148,3434,3409,9,3418,43
2021-04-17,Lassen,035,31185,5163,5154,103,5257,1
2021-04-17,Los Angeles,037,10098052,1197727,1188262,40161,1228423,23653
2021-04-17,Madera,039,155013,16386,16260,904,17164,231
2021-04-17,Marin,041,260295,13835,13797,229,14026,226
2021-04-17,Mariposa,043,17540,409,398,10,408,5
2021-04-17,Mendocino,045,87422,3801,3721,74,3795,46
2021-04-17,Merced,047,269075,30330,30392,1001,31393,441
2021-04-17,Modoc,049,8938,365,357,120,477,3
2021-04-17,Mono,051,14174,1242,1253,16,1269,3
2021-04-17,Monterey,053,433212,42795,42630,1792,44422,356
2021-04-17,Napa,055,140530,9693,9666,32,9698,79
2021-04-17,Nevada,057,99092,4522,4457,183,4640,70
2021-04-17,Orange,059,3164182,253204,251873,10943,262816,4878
2021-04-17,Placer,061,380077,22364,21736,1359,23095,282
2021-04-17,Plumas,063,18699,681,666,10,676,4
2021-04-17,Riverside,065,2383286,291570,285963,13647,299610,4371
2021-04-17,Sacramento,067,1510023,101909,101172,1539,102711,1572
2021-04-17,San Benito,069,59416,5971,5986,109,6095,63
2021-04-17,San Bernardino,071,2135413,290993,289624,8788,298412,4555
2021-04-17,San Diego,073,3302833,275559,274812,14180,288992,3674
2021-04-17,San Francisco,075,870044,35943,36032,1220,37252,523
2021-04-17,San Joaquin,077,732212,71222,70372,3296,73668,1288
2021-04-17,San Luis Obispo,079,281455,20958,20642,678,21320,254
2021-04-17,San Mateo,081,765935,41537,41157,442,41599,352
2021-04-17,Santa Barbara,083,443738,33929,33738,1099,34837,446
2021-04-17,Santa Clara,085,1922200,116535,116887,686,117573,1944
2021-04-17,Santa Cruz,087,273765,16029,15571,788,16359,204
2021-04-17,Shasta,089,179085,11632,11647,1406,13053,189
2021-04-17,Sierra,091,2930,55,51,12,63,0
2021-04-17,Siskiyou,093,43540,1646,1539,278,1817,10
2021-04-17,Solano,095,438530,31670,31541,457,31998,239
2021-04-17,Sonoma,097,501317,29483,29637,295,29932,311
2021-04-17,Stanislaus,099,539301,54375,54058,5674,59732,728
2021-04-17,Sutter,101,95872,9241,9252,80,9332,109
2021-04-17,Tehama,103,63373,4899,4875,529,5404,52
2021-04-17,Trinity,105,12862,482,326,81,407,3
2021-04-17,Tulare,107,460477,49594,48603,8571,57174,829
2021-04-17,Tuolumne,109,53932,3957,4005,39,4044,58
2021-04-17,Ventura,111,848112,80507,79964,2891,82855,996
2021-04-17,Yolo,113,214977,13610,13580,183,13763,200
2021-04-17,Yuba,115,75493,5831,5802,114,5916,44
2021-04-16,Alameda,001,1643700,85550,85243,1818,87061,1245
2021-04-16,Alpine,003,1148,85,85,0,85,0
2021-04-16,Amador,005,37829,3620,3621,32,3653,46
2021-04-16,Butte,007,227075,11931,11549,1693,13242,196
2021-04-16,Calaveras,009,45235,2047,2042,11,2053,50
2021-04-16,Colusa,011,21464,1910,1911,283,2194,14
2021-04-16,Contra Costa,013,1133247,67299,66569,1163,67732,782
2021-04-16,Del Norte,015,27424,1276,1237,11,1248,6
2021-04-16,El Dorado,017,186661,9775,9665,676,10341,106
2021-04-16,Fresno,019,978130,101004,100500,8340,108840,1643
2021-04-16,Glenn,021,27897,2375,2355,532,2887,17
2021-04-16,Humboldt,023,135768,3636,3570,27,3597,35
2021-04-16,Imperial,025,180216,28089,27962,2599,30561,719
2021-04-16,Inyo,027,18085,1392,1392,10,1402,36
2021-04-16,Kern,029,883053,96106,95066,10379,105445,1288
2021-04-16,Kings,031,150075,22907,22667,1032,23699,243
2021-04-16,Lake,033,64148,3428,3406,9,3415,43
2021-04-16,Lassen,035,31185,5162,5155,103,5258,1
2021-04-16,Los Angeles,037,10098052,1197426,1187818,40125,1227943,23627
2021-04-16,Madera,039,155013,16380,16250,903,17153,231
2021-04-16,Marin,041,260295,13832,13788,229,14017,226
2021-04-16,Mariposa,043,17540,408,396,9,405,5
2021-04-16,Mendocino,045,87422,3799,3719,74,3793,46
2021-04-16,Merced,047,269075,30315,30355,1001,31356,438
2021-04-16,Modoc,049,8938,365,355,120,475,3
2021-04-16,Mono,051,14174,1242,1253,16,1269,3
2021-04-16,Monterey,053,433212,42784,42620,1789,44409,351
2021-04-16,Napa,055,140530,9685,9653,32,9685,79
2021-04-16,Nevada,057,99092,4513,4443,183,4626,70
2021-04-16,Orange,059,3164182,253140,251770,10934,262704,4873
2021-04-16,Placer,061,380077,22337,21680,1355,23035,282
2021-04-16,Plumas,063,18699,680,665,10,675,4
2021-04-16,Riverside,065,2383286,291493,285818,13645,299463,4369
2021-04-16,Sacramento,067,1510023,101812,100993,1534,102527,1572
2021-04-16,San Benito,069,59416,5969,5982,109,6091,63
2021-04-16,San Bernardino,071,2135413,290946,289424,8787,298211,4550
2021-04-16,San Diego,073,3302833,275405,274567,14162,288729,3662
2021-04-16,San Francisco,075,870044,35918,35993,1217,37210,517
2021-04-16,San Joaquin,077,732212,71155,70280,3288,73568,1288
2021-04-16,San Luis Obispo,079,281455,20946,20623,677,21300,253
2021-04-16,San Mateo,081,765935,41508,41107,441,41548,352
2021-04-16,Santa Barbara,083,443738,33911,33703,1099,34802,446
2021-04-16,Santa Clara,085,1922200,116435,116693,683,117376,1941
2021-04-16,Santa Cruz,087,273765,16027,15539,788,16327,204
2021-04-16,Shasta,089,179085,11620,11623,1405,13028,189
2021-04-16,Sierra,091,2930,55,51,12,63,0
2021-04-16,Siskiyou,093,43540,1642,1530,276,1806,10
2021-04-16,Solano,095,438530,31631,31470,454,31924,239
2021-04-16,Sonoma,097,501317,29472,29617,295,29912,311
2021-04-16,Stanislaus,099,539301,54327,53983,5672,59655,728
2021-04-16,Sutter,101,95872,9235,9247,80,9327,109
2021-04-16,Tehama,103,63373,4898,4866,529,5395,52
2021-04-16,Trinity,105,12862,482,326,81,407,3
2021-04-16,Tulare,107,460477,49582,48583,8567,57150,830
2021-04-16,Tuolumne,109,53932,3954,4005,39,4044,58
2021-04-16,Ventura,111,848112,80482,79942,2886,82828,994
2021-04-16,Yolo,113,214977,13597,13559,181,13740,198
2021-04-16,Yuba,115,75493,5828,5795,113,5908,44
2021-04-15,Alameda,001,1643700,85443,85089,1816,86905,1246
2021-04-15,Alpine,003,1148,85,85,0,85,0
2021-04-15,Amador,005,37829,3619,3616,32,3648,46
2021-04-15,Butte,007,227075,11916,11529,1689,13218,196
2021-04-15,Calaveras,009,45235,2046,2039,11,2050,50
2021-04-15,Colusa,011,21464,1908,1909,282,2191,14
2021-04-15,Contra Costa,013,1133247,67226,66480,1159,67639,781
2021-04-15,Del Norte,015,27424,1269,1235,11,1246,6
2021-04-15,El Dorado,017,186661,9760,9639,674,10313,106
2021-04-15,Fresno,019,978130,100941,100431,8334,108765,1642
2021-04-15,Glenn,021,27897,2375,2354,532,2886,17
2021-04-15,Humboldt,023,135768,3615,3561,27,3588,35
2021-04-15,Imperial,025,180216,28061,27920,2596,30516,718
2021-04-15,Inyo,027,18085,1392,1393,10,1403,36
2021-04-15,Kern,029,883053,96073,94989,10366,105355,1289
2021-04-15,Kings,031,150075,22893,22648,1032,23680,242
2021-04-15,Lake,033,64148,3427,3399,9,3408,43
2021-04-15,Lassen,035,31185,5161,5152,103,5255,1
2021-04-15,Los Angeles,037,10098052,1197021,1187274,40089,1227363,23598
2021-04-15,Madera,039,155013,16365,16234,903,17137,231
2021-04-15,Marin,041,260295,13828,13783,228,14011,226
2021-04-15,Mariposa,043,17540,406,395,9,404,5
2021-04-15,Mendocino,045,87422,3798,3714,74,3788,46
2021-04-15,Merced,047,269075,30289,30325,1000,31325,437
2021-04-15,Modoc,049,8938,365,355,120,475,3
2021-04-15,Mono,051,14174,1241,1253,16,1269,3
2021-04-15,Monterey,053,433212,42774,42604,1787,44391,347
2021-04-15,Napa,055,140530,9677,9645,32,9677,79
2021-04-15,Nevada,057,99092,4501,4434,182,4616,70
2021-04-15,Orange,059,3164182,253045,251679,10922,262601,4857
2021-04-15,Placer,061,380077,22306,21614,1348,22962,281
2021-04-15,Plumas,063,18699,678,665,10,675,4
2021-04-15,Riverside,065,2383286,291389,285698,13638,299336,4363
2021-04-15,Sacramento,067,1510023,101682,100782,1520,102302,1570
2021-04-15,San Benito,069,59416,5966,5969,108,6077,63
2021-04-15,San Bernardino,071,2135413,290856,289288,8780,298068,4544
2021-04-15,San Diego,073,3302833,275158,274250,14103,288353,3653
2021-04-15,San Francisco,075,870044,35899,35947,1215,37162,510
2021-04-15,San Joaquin,077,732212,71074,70189,3280,73469,1288
2021-04-15,San Luis Obispo,079,281455,20930,20591,674,21265,253
2021-04-15,San Mateo,081,765935,41469,41050,440,41490,352
2021-04-15,Santa Barbara,083,443738,33893,33672,1095,34767,446
2021-04-15,Santa Clara,085,1922200,116329,116602,679,117281,1927
2021-04-15,Santa Cruz,087,273765,16017,15509,788,16297,203
2021-04-15,Shasta,089,179085,11606,11597,1401,12998,191
2021-04-15,Sierra,091,2930,55,51,12,63,0
2021-04-15,Siskiyou,093,43540,1636,1524,275,1799,10
2021-04-15,Solano,095,438530,31593,31394,453,31847,239
2021-04-15,Sonoma,097,501317,29458,29587,295,29882,311
2021-04-15,Stanislaus,099,539301,54273,53918,5663,59581,728
2021-04-15,Sutter,101,95872,9228,9237,80,9317,109
2021-04-15,Tehama,103,63373,4897,4854,528,5382,52
2021-04-15,Trinity,105,12862,482,326,81,407,3
2021-04-15,Tulare,107,460477,49561,48556,8567,57123,829
2021-04-15,Tuolumne,109,53932,3954,4003,39,4042,57
2021-04-15,Ventura,111,848112,80463,79917,2884,82801,989
2021-04-15,Yolo,113,214977,13578,13547,179,13726,198
2021-04-15,Yuba,115,75493,5825,5788,113,5901,44
2021-04-14,Alameda,001,1643700,85346,85009,1815,86824,1247
2021-04-14,Alpine,003,1148,85,85,0,85,0
2021-04-14,Amador,005,37829,3618,3613,32,3645,46
2021-04-14,Butte,007,227075,11903,11513,1688,13201,196
2021-04-14,Calaveras,009,45235,2045,2037,11,2048,50
2021-04-14,Colusa,011,21464,1908,1905,282,2187,14
2021-04-14,Contra Costa,013,1133247,67140,66400,1153,67553,781
2021-04-14,Del Norte,015,27424,1269,1228,11,1239,6
2021-04-14,El Dorado,017,186661,9745,9625,669,10294,106
2021-04-14,Fresno,019,978130,100884,100376,8321,108697,1640
2021-04-14,Glenn,021,27897,2375,2353,532,2885,17
2021-04-14,Humboldt,023,135768,3593,3551,26,3577,35
2021-04-14,Imperial,025,180216,28039,27907,2594,30501,718
2021-04-14,Inyo,027,18085,1392,1392,10,1402,36
2021-04-14,Kern,029,883053,96048,94947,10359,105306,1287
2021-04-14,Kings,031,150075,22884,22641,1030,23671,243
2021-04-14,Lake,033,64148,3422,3396,9,3405,43
2021-04-14,Lassen,035,31185,5160,5151,103,5254,1
2021-04-14,Los Angeles,037,10098052,1196622,1186821,40044,1226865,23579
2021-04-14,Madera,039,155013,16356,16218,903,17121,231
2021-04-14,Marin,041,260295,13826,13768,227,13995,226
2021-04-14,Mariposa,043,17540,405,394,9,403,5
2021-04-14,Mendocino,045,87422,3793,3711,74,3785,46
2021-04-14,Merced,047,269075,30273,30296,998,31294,436
2021-04-14,Modoc,049,8938,365,355,120,475,3
2021-04-14,Mono,051,14174,1240,1252,16,1268,3
2021-04-14,Monterey,053,433212,42758,42595,1783,44378,347
2021-04-14,Napa,055,140530,9666,9643,32,9675,79
2021-04-14,Nevada,057,99092,4494,4421,182,4603,70
2021-04-14,Orange,059,3164182,252940,251568,10903,262471,4849
2021-04-14,Placer,061,380077,22273,21575,1347,22922,280
2021-04-14,Plumas,063,18699,678,665,10,675,4
2021-04-14,Riverside,065,2383286,291279,285583,13632,299215,4358
2021-04-14,Sacramento,067,1510023,101507,100645,1506,102151,1570
2021-04-14,San Benito,069,59416,5964,5960,108,6068,62
2021-04-14,San Bernardino,071,2135413,290788,289078,8778,297856,4523
2021-04-14,San Diego,073,3302833,274947,273969,14074,288043,3648
2021-04-14,San Francisco,075,870044,35861,35898,1214,37112,510
2021-04-14,San Joaquin,077,732212,71004,70095,3274,73369,1288
2021-04-14,San Luis Obispo,079,281455,20907,20561,664,21225,253
2021-04-14,San Mateo,081,765935,41429,40982,437,41419,352
2021-04-14,Santa Barbara,083,443738,33864,33650,1095,34745,445
2021-04-14,Santa Clara,085,1922200,116212,116488,676,117164,1922
2021-04-14,Santa Cruz,087,273765,16007,15481,788,16269,203
2021-04-14,Shasta,089,179085,11580,11581,1399,12980,190
2021-04-14,Sierra,091,2930,55,51,12,63,0
2021-04-14,Siskiyou,093,43540,1628,1518,274,1792,10
2021-04-14,Solano,095,438530,31540,31357,446,31803,239
2021-04-14,Sonoma,097,501317,29450,29572,293,29865,311
2021-04-14,Stanislaus,099,539301,54202,53836,5654,59490,727
2021-04-14,Sutter,101,95872,9220,9230,80,9310,106
2021-04-14,Tehama,103,63373,4891,4853,527,5380,52
2021-04-14,Trinity,105,12862,482,326,81,407,3
2021-04-14,Tulare,107,460477,49535,48527,8564,57091,827
2021-04-14,Tuolumne,109,53932,3953,3997,39,4036,57
2021-04-14,Ventura,111,848112,80427,79891,2882,82773,986
2021-04-14,Yolo,113,214977,13562,13530,177,13707,198
2021-04-14,Yuba,115,75493,5823,5778,113,5891,44
2021-04-13,Alameda,001,1643700,85240,84921,1812,86733,1239
2021-04-13,Alpine,003,1148,85,85,0,85,0
2021-04-13,Amador,005,37829,3615,3609,32,3641,46
2021-04-13,Butte,007,227075,11885,11497,1685,13182,196
2021-04-13,Calaveras,009,45235,2043,2035,11,2046,50
2021-04-13,Colusa,011,21464,1906,1905,280,2185,14
2021-04-13,Contra Costa,013,1133247,67052,66304,1153,67457,778
2021-04-13,Del Norte,015,27424,1264,1221,11,1232,6
2021-04-13,El Dorado,017,186661,9719,9609,666,10275,106
2021-04-13,Fresno,019,978130,100803,100357,8315,108672,1636
2021-04-13,Glenn,021,27897,2374,2351,532,2883,17
2021-04-13,Humboldt,023,135768,3576,3540,26,3566,35
2021-04-13,Imperial,025,180216,28020,27887,2586,30473,718
2021-04-13,Inyo,027,18085,1392,1391,10,1401,36
2021-04-13,Kern,029,883053,96004,94908,10347,105255,1285
2021-04-13,Kings,031,150075,22868,22636,1029,23665,243
2021-04-13,Lake,033,64148,3419,3390,9,3399,43
2021-04-13,Lassen,035,31185,5159,5147,103,5250,1
2021-04-13,Los Angeles,037,10098052,1196168,1186482,40003,1226485,23526
2021-04-13,Madera,039,155013,16346,16207,901,17108,231
2021-04-13,Marin,041,260295,13818,13760,226,13986,224
2021-04-13,Mariposa,043,17540,404,394,6,400,5
2021-04-13,Mendocino,045,87422,3787,3702,74,3776,46
2021-04-13,Merced,047,269075,30243,30276,995,31271,435
2021-04-13,Modoc,049,8938,365,355,120,475,3
2021-04-13,Mono,051,14174,1240,1251,16,1267,3
2021-04-13,Monterey,053,433212,42747,42577,1783,44360,347
2021-04-13,Napa,055,140530,9656,9627,32,9659,79
2021-04-13,Nevada,057,99092,4482,4415,182,4597,69
2021-04-13,Orange,059,3164182,252845,251491,10886,262377,4836
2021-04-13,Placer,061,380077,22236,21534,1344,22878,280
2021-04-13,Plumas,063,18699,677,665,10,675,4
2021-04-13,Riverside,065,2383286,291160,285505,13626,299131,4348
2021-04-13,Sacramento,067,1510023,101332,100551,1501,102052,1569
2021-04-13,San Benito,069,59416,5961,5946,108,6054,62
2021-04-13,San Bernardino,071,2135413,290672,288929,8772,297701,4521
2021-04-13,San Diego,073,3302833,274693,273709,14039,287748,3623
2021-04-13,San Francisco,075,870044,35825,35869,1210,37079,506
2021-04-13,San Joaquin,077,732212,70896,70034,3266,73300,1288
2021-04-13,San Luis Obispo,079,281455,20880,20536,654,21190,253
2021-04-13,San Mateo,081,765935,41384,40955,437,41392,353
2021-04-13,Santa Barbara,083,443738,33841,33613,1092,34705,444
2021-04-13,Santa Clara,085,1922200,116083,116363,675,117038,1923
2021-04-13,Santa Cruz,087,273765,16000,15449,788,16237,203
2021-04-13,Shasta,089,179085,11560,11536,1396,12932,189
2021-04-13,Sierra,091,2930,55,51,12,63,0
2021-04-13,Siskiyou,093,43540,1620,1511,271,1782,10
2021-04-13,Solano,095,438530,31491,31335,442,31777,239
2021-04-13,Sonoma,097,501317,29442,29544,292,29836,311
2021-04-13,Stanislaus,099,539301,54130,53797,5645,59442,722
2021-04-13,Sutter,101,95872,9216,9226,80,9306,106
2021-04-13,Tehama,103,63373,4884,4850,524,5374,52
2021-04-13,Trinity,105,12862,482,326,81,407,3
2021-04-13,Tulare,107,460477,49522,48511,8561,57072,825
2021-04-13,Tuolumne,109,53932,3951,3995,39,4034,57
2021-04-13,Ventura,111,848112,80395,79854,2880,82734,986
2021-04-13,Yolo,113,214977,13550,13516,176,13692,198
2021-04-13,Yuba,115,75493,5814,5776,113,5889,44
2021-04-12,Alameda,001,1643700,85138,84817,1811,86628,1238
2021-04-12,Alpine,003,1148,85,85,0,85,0
2021-04-12,Amador,005,37829,3614,3607,32,3639,46
2021-04-12,Butte,007,227075,11870,11488,1681,13169,193
2021-04-12,Calaveras,009,45235,2039,2033,11,2044,50
2021-04-12,Colusa,011,21464,1904,1904,278,2182,14
2021-04-12,Contra Costa,013,1133247,66972,66176,1153,67329,777
2021-04-12,Del Norte,015,27424,1261,1216,11,1227,6
2021-04-12,El Dorado,017,186661,9702,9588,664,10252,106
2021-04-12,Fresno,019,978130,100742,100277,8292,108569,1633
2021-04-12,Glenn,021,27897,2373,2349,532,2881,17
2021-04-12,Humboldt,023,135768,3562,3533,25,3558,35
2021-04-12,Imperial,025,180216,27990,27851,2582,30433,717
2021-04-12,Inyo,027,18085,1392,1390,10,1400,36
2021-04-12,Kern,029,883053,95967,94861,10337,105198,1283
2021-04-12,Kings,031,150075,22860,22621,1028,23649,241
2021-04-12,Lake,033,64148,3415,3380,9,3389,43
2021-04-12,Lassen,035,31185,5158,5147,103,5250,1
2021-04-12,Los Angeles,037,10098052,1195664,1186145,39966,1226111,23505
2021-04-12,Madera,039,155013,16334,16174,899,17073,231
2021-04-12,Marin,041,260295,13805,13751,224,13975,224
2021-04-12,Mariposa,043,17540,403,394,6,400,5
2021-04-12,Mendocino,045,87422,3786,3699,74,3773,46
2021-04-12,Merced,047,269075,30212,30261,992,31253,435
2021-04-12,Modoc,049,8938,363,352,120,472,3
2021-04-12,Mono,051,14174,1240,1251,16,1267,3
2021-04-12,Monterey,053,433212,42733,42555,1781,44336,346
2021-04-12,Napa,055,140530,9642,9603,32,9635,80
2021-04-12,Nevada,057,99092,4471,4408,182,4590,69
2021-04-12,Orange,059,3164182,252759,251350,10865,262215,4826
2021-04-12,Placer,061,380077,22185,21475,1341,22816,278
2021-04-12,Plumas,063,18699,675,666,10,676,4
2021-04-12,Riverside,065,2383286,291049,285361,13620,298981,4336
2021-04-12,Sacramento,067,1510023,101158,100394,1496,101890,1566
2021-04-12,San Benito,069,59416,5953,5942,107,6049,62
2021-04-12,San Bernardino,071,2135413,290565,288736,8760,297496,4493
2021-04-12,San Diego,073,3302833,274432,273431,14010,287441,3621
2021-04-12,San Francisco,075,870044,35791,35841,1209,37050,506
2021-04-12,San Joaquin,077,732212,70824,69968,3259,73227,1288
2021-04-12,San Luis Obispo,079,281455,20835,20515,641,21156,253
2021-04-12,San Mateo,081,765935,41342,40920,433,41353,353
2021-04-12,Santa Barbara,083,443738,33809,33606,1092,34698,444
2021-04-12,Santa Clara,085,1922200,115955,116252,673,116925,1923
2021-04-12,Santa Cruz,087,273765,15980,15406,788,16194,203
2021-04-12,Shasta,089,179085,11543,11509,1392,12901,189
2021-04-12,Sierra,091,2930,55,51,12,63,0
2021-04-12,Siskiyou,093,43540,1609,1511,268,1779,7
2021-04-12,Solano,095,438530,31449,31305,439,31744,238
2021-04-12,Sonoma,097,501317,29414,29500,292,29792,310
2021-04-12,Stanislaus,099,539301,54064,53722,5638,59360,707
2021-04-12,Sutter,101,95872,9205,9221,80,9301,106
2021-04-12,Tehama,103,63373,4875,4834,520,5354,52
2021-04-12,Trinity,105,12862,482,324,81,405,3
2021-04-12,Tulare,107,460477,49502,48495,8551,57046,824
2021-04-12,Tuolumne,109,53932,3947,3993,39,4032,57
2021-04-12,Ventura,111,848112,80362,79818,2878,82696,985
2021-04-12,Yolo,113,214977,13536,13510,175,13685,198
2021-04-12,Yuba,115,75493,5808,5773,113,5886,43
2021-04-11,Alameda,001,1643700,85001,84756,1806,86562,1238
2021-04-11,Alpine,003,1148,85,85,0,85,0
2021-04-11,Amador,005,37829,3612,3605,32,3637,46
2021-04-11,Butte,007,227075,11836,11487,1677,13164,193
2021-04-11,Calaveras,009,45235,2035,2036,11,2047,50
2021-04-11,Colusa,011,21464,1903,1904,277,2181,14
2021-04-11,Contra Costa,013,1133247,66863,66107,1151,67258,777
2021-04-11,Del Norte,015,27424,1255,1214,11,1225,6
2021-04-11,El Dorado,017,186661,9688,9575,661,10236,106
2021-04-11,Fresno,019,978130,100674,100230,8282,108512,1633
2021-04-11,Glenn,021,27897,2368,2348,532,2880,17
2021-04-11,Humboldt,023,135768,3552,3523,25,3548,35
2021-04-11,Imperial,025,180216,27966,27841,2580,30421,717
2021-04-11,Inyo,027,18085,1392,1390,10,1400,36
2021-04-11,Kern,029,883053,95906,94830,10329,105159,1283
2021-04-11,Kings,031,150075,22851,22618,1025,23643,241
2021-04-11,Lake,033,64148,3411,3377,9,3386,43
2021-04-11,Lassen,035,31185,5154,5147,103,5250,1
2021-04-11,Los Angeles,037,10098052,1195152,1185757,39924,1225681,23503
2021-04-11,Madera,039,155013,16315,16166,898,17064,231
2021-04-11,Marin,041,260295,13798,13741,223,13964,226
2021-04-11,Mariposa,043,17540,403,394,6,400,5
2021-04-11,Mendocino,045,87422,3784,3696,74,3770,46
2021-04-11,Merced,047,269075,30174,30249,991,31240,435
2021-04-11,Modoc,049,8938,362,352,118,470,3
2021-04-11,Mono,051,14174,1239,1250,16,1266,3
2021-04-11,Monterey,053,433212,42727,42547,1774,44321,346
2021-04-11,Napa,055,140530,9631,9592,32,9624,80
2021-04-11,Nevada,057,99092,4457,4394,182,4576,69
2021-04-11,Orange,059,3164182,252632,251233,10854,262087,4826
2021-04-11,Placer,061,380077,22128,21458,1336,22794,278
2021-04-11,Plumas,063,18699,675,666,10,676,4
2021-04-11,Riverside,065,2383286,290915,285269,13610,298879,4336
2021-04-11,Sacramento,067,1510023,100988,100296,1484,101780,1566
2021-04-11,San Benito,069,59416,5945,5941,106,6047,62
2021-04-11,San Bernardino,071,2135413,290458,288686,8754,297440,4492
2021-04-11,San Diego,073,3302833,274134,273287,13951,287238,3621
2021-04-11,San Francisco,075,870044,35755,35815,1206,37021,498
2021-04-11,San Joaquin,077,732212,70738,69939,3248,73187,1288
2021-04-11,San Luis Obispo,079,281455,20809,20501,638,21139,253
2021-04-11,San Mateo,081,765935,41284,40901,432,41333,353
2021-04-11,Santa Barbara,083,443738,33774,33591,1091,34682,444
2021-04-11,Santa Clara,085,1922200,115819,116161,670,116831,1923
2021-04-11,Santa Cruz,087,273765,15968,15382,788,16170,203
2021-04-11,Shasta,089,179085,11499,11504,1391,12895,189
2021-04-11,Sierra,091,2930,55,51,12,63,0
2021-04-11,Siskiyou,093,43540,1602,1509,265,1774,7
2021-04-11,Solano,095,438530,31396,31268,435,31703,238
2021-04-11,Sonoma,097,501317,29388,29496,288,29784,310
2021-04-11,Stanislaus,099,539301,53981,53683,5629,59312,707
2021-04-11,Sutter,101,95872,9196,9222,80,9302,106
2021-04-11,Tehama,103,63373,4872,4832,519,5351,52
2021-04-11,Trinity,105,12862,482,324,81,405,3
2021-04-11,Tulare,107,460477,49488,48479,8544,57023,824
2021-04-11,Tuolumne,109,53932,3945,3993,39,4032,57
2021-04-11,Ventura,111,848112,80314,79800,2873,82673,985
2021-04-11,Yolo,113,214977,13516,13496,173,13669,198
2021-04-11,Yuba,115,75493,5798,5768,113,5881,43
2021-04-10,Alameda,001,1643700,84937,84626,1806,86432,1238
2021-04-10,Alpine,003,1148,85,85,0,85,0
2021-04-10,Amador,005,37829,3610,3603,32,3635,46
2021-04-10,Butte,007,227075,11825,11482,1676,13158,193
2021-04-10,Calaveras,009,45235,2033,2032,11,2043,50
2021-04-10,Colusa,011,21464,1903,1902,277,2179,14
2021-04-10,Contra Costa,013,1133247,66802,66001,1148,67149,778
2021-04-10,Del Norte,015,27424,1252,1212,11,1223,6
2021-04-10,El Dorado,017,186661,9676,9549,658,10207,106
2021-04-10,Fresno,019,978130,100641,100135,8275,108410,1633
2021-04-10,Glenn,021,27897,2368,2343,532,2875,17
2021-04-10,Humboldt,023,135768,3542,3508,25,3533,35
2021-04-10,Imperial,025,180216,27952,27816,2580,30396,717
2021-04-10,Inyo,027,18085,1392,1387,10,1397,36
2021-04-10,Kern,029,883053,95892,94802,10323,105125,1284
2021-04-10,Kings,031,150075,22847,22614,1023,23637,241
2021-04-10,Lake,033,64148,3406,3368,9,3377,43
2021-04-10,Lassen,035,31185,5154,5146,102,5248,1
2021-04-10,Los Angeles,037,10098052,1194877,1185246,39907,1225153,23493
2021-04-10,Madera,039,155013,16307,16143,897,17040,231
2021-04-10,Marin,041,260295,13793,13731,223,13954,226
2021-04-10,Mariposa,043,17540,400,393,6,399,5
2021-04-10,Mendocino,045,87422,3782,3696,74,3770,46
2021-04-10,Merced,047,269075,30154,30225,990,31215,435
2021-04-10,Modoc,049,8938,362,352,118,470,3
2021-04-10,Mono,051,14174,1239,1249,16,1265,3
2021-04-10,Monterey,053,433212,42716,42527,1773,44300,346
2021-04-10,Napa,055,140530,9624,9569,32,9601,79
2021-04-10,Nevada,057,99092,4450,4379,182,4561,69
2021-04-10,Orange,059,3164182,252539,251139,10848,261987,4818
2021-04-10,Placer,061,380077,22097,21402,1330,22732,278
2021-04-10,Plumas,063,18699,675,666,10,676,4
2021-04-10,Riverside,065,2383286,290835,285082,13602,298684,4336
2021-04-10,Sacramento,067,1510023,100885,100048,1482,101530,1566
2021-04-10,San Benito,069,59416,5934,5932,105,6037,62
2021-04-10,San Bernardino,071,2135413,290394,288590,8747,297337,4489
2021-04-10,San Diego,073,3302833,273918,273058,13931,286989,3613
2021-04-10,San Francisco,075,870044,35725,35774,1203,36977,498
2021-04-10,San Joaquin,077,732212,70703,69852,3238,73090,1288
2021-04-10,San Luis Obispo,079,281455,20793,20461,637,21098,253
2021-04-10,San Mateo,081,765935,41251,40878,432,41310,350
2021-04-10,Santa Barbara,083,443738,33746,33541,1089,34630,444
2021-04-10,Santa Clara,085,1922200,115723,116015,669,116684,1923
2021-04-10,Santa Cruz,087,273765,15962,15360,788,16148,203
2021-04-10,Shasta,089,179085,11490,11492,1388,12880,189
2021-04-10,Sierra,091,2930,55,51,12,63,0
2021-04-10,Siskiyou,093,43540,1599,1512,265,1777,7
2021-04-10,Solano,095,438530,31362,31218,431,31649,238
2021-04-10,Sonoma,097,501317,29373,29469,288,29757,310
2021-04-10,Stanislaus,099,539301,53946,53596,5623,59219,707
2021-04-10,Sutter,101,95872,9194,9214,80,9294,106
2021-04-10,Tehama,103,63373,4870,4820,517,5337,52
2021-04-10,Trinity,105,12862,482,324,81,405,3
2021-04-10,Tulare,107,460477,49479,48470,8538,57008,824
2021-04-10,Tuolumne,109,53932,3942,3991,39,4030,57
2021-04-10,Ventura,111,848112,80286,79758,2871,82629,985
2021-04-10,Yolo,113,214977,13508,13494,172,13666,198
2021-04-10,Yuba,115,75493,5795,5757,112,5869,43
2021-04-09,Alameda,001,1643700,84870,84404,1798,86202,1237
2021-04-09,Alpine,003,1148,85,85,0,85,0
2021-04-09,Amador,005,37829,3609,3600,32,3632,46
2021-04-09,Butte,007,227075,11815,11454,1675,13129,193
2021-04-09,Calaveras,009,45235,2032,2028,11,2039,50
2021-04-09,Colusa,011,21464,1903,1898,277,2175,14
2021-04-09,Contra Costa,013,1133247,66709,65857,1142,66999,777
2021-04-09,Del Norte,015,27424,1251,1207,11,1218,6
2021-04-09,El Dorado,017,186661,9654,9528,654,10182,106
2021-04-09,Fresno,019,978130,100607,100027,8270,108297,1630
2021-04-09,Glenn,021,27897,2368,2337,532,2869,17
2021-04-09,Humboldt,023,135768,3533,3496,25,3521,35
2021-04-09,Imperial,025,180216,27937,27764,2578,30342,717
2021-04-09,Inyo,027,18085,1391,1386,10,1396,36
2021-04-09,Kern,029,883053,95854,94675,10321,104996,1282
2021-04-09,Kings,031,150075,22838,22595,1020,23615,242
2021-04-09,Lake,033,64148,3402,3362,9,3371,43
2021-04-09,Lassen,035,31185,5154,5140,102,5242,1
2021-04-09,Los Angeles,037,10098052,1194508,1184501,39879,1224380,23458
2021-04-09,Madera,039,155013,16304,16118,897,17015,231
2021-04-09,Marin,041,260295,13786,13721,223,13944,226
2021-04-09,Mariposa,043,17540,400,393,6,399,5
2021-04-09,Mendocino,045,87422,3780,3693,74,3767,46
2021-04-09,Merced,047,269075,30125,30179,989,31168,435
2021-04-09,Modoc,049,8938,361,352,118,470,3
2021-04-09,Mono,051,14174,1239,1247,16,1263,3
2021-04-09,Monterey,053,433212,42707,42481,1769,44250,344
2021-04-09,Napa,055,140530,9605,9574,32,9606,80
2021-04-09,Nevada,057,99092,4442,4373,182,4555,69
2021-04-09,Orange,059,3164182,252465,250852,10843,261695,4813
2021-04-09,Placer,061,380077,22066,21327,1322,22649,278
2021-04-09,Plumas,063,18699,674,666,10,676,4
2021-04-09,Riverside,065,2383286,290752,284562,13596,298158,4325
2021-04-09,Sacramento,067,1510023,100730,99722,1476,101198,1564
2021-04-09,San Benito,069,59416,5929,5925,104,6029,62
2021-04-09,San Bernardino,071,2135413,290325,288000,8744,296744,4467
2021-04-09,San Diego,073,3302833,273720,272697,13889,286586,3600
2021-04-09,San Francisco,075,870044,35684,35716,1198,36914,497
2021-04-09,San Joaquin,077,732212,70639,69675,3226,72901,1281
2021-04-09,San Luis Obispo,079,281455,20778,20427,637,21064,252
2021-04-09,San Mateo,081,765935,41215,40800,431,41231,350
2021-04-09,Santa Barbara,083,443738,33723,33424,1086,34510,444
2021-04-09,Santa Clara,085,1922200,115639,115749,667,116416,1923
2021-04-09,Santa Cruz,087,273765,15957,15331,788,16119,203
2021-04-09,Shasta,089,179085,11480,11478,1385,12863,188
2021-04-09,Sierra,091,2930,55,51,12,63,0
2021-04-09,Siskiyou,093,43540,1596,1510,264,1774,7
2021-04-09,Solano,095,438530,31329,31166,426,31592,238
2021-04-09,Sonoma,097,501317,29360,29433,288,29721,310
2021-04-09,Stanislaus,099,539301,53891,53504,5614,59118,705
2021-04-09,Sutter,101,95872,9187,9201,80,9281,106
2021-04-09,Tehama,103,63373,4864,4806,517,5323,52
2021-04-09,Trinity,105,12862,481,324,81,405,3
2021-04-09,Tulare,107,460477,49475,48430,8532,56962,824
2021-04-09,Tuolumne,109,53932,3941,3986,39,4025,57
2021-04-09,Ventura,111,848112,80258,79698,2871,82569,987
2021-04-09,Yolo,113,214977,13496,13478,170,13648,198
2021-04-09,Yuba,115,75493,5788,5754,112,5866,43
2021-04-08,Alameda,001,1643700,84764,84213,1795,86008,1232
2021-04-08,Alpine,003,1148,85,85,0,85,0
2021-04-08,Amador,005,37829,3605,3595,32,3627,46
2021-04-08,Butte,007,227075,11804,11414,1674,13088,193
2021-04-08,Calaveras,009,45235,2030,2027,11,2038,50
2021-04-08,Colusa,011,21464,1902,1897,277,2174,14
2021-04-08,Contra Costa,013,1133247,66599,65706,1139,66845,775
2021-04-08,Del Norte,015,27424,1245,1201,11,1212,6
2021-04-08,El Dorado,017,186661,9638,9513,649,10162,106
2021-04-08,Fresno,019,978130,100544,99935,8263,108198,1627
2021-04-08,Glenn,021,27897,2367,2337,532,2869,17
2021-04-08,Humboldt,023,135768,3523,3486,25,3511,35
2021-04-08,Imperial,025,180216,27909,27744,2575,30319,713
2021-04-08,Inyo,027,18085,1390,1386,10,1396,36
2021-04-08,Kern,029,883053,95808,94493,10308,104801,1281
2021-04-08,Kings,031,150075,22831,22589,1018,23607,243
2021-04-08,Lake,033,64148,3395,3360,9,3369,43
2021-04-08,Lassen,035,31185,5153,5136,102,5238,1
2021-04-08,Los Angeles,037,10098052,1194009,1184443,39841,1224284,23416
2021-04-08,Madera,039,155013,16292,16103,897,17000,231
2021-04-08,Marin,041,260295,13779,13704,223,13927,226
2021-04-08,Mariposa,043,17540,399,393,6,399,5
2021-04-08,Mendocino,045,87422,3778,3690,74,3764,45
2021-04-08,Merced,047,269075,30103,30163,989,31152,430
2021-04-08,Modoc,049,8938,361,352,118,470,3
2021-04-08,Mono,051,14174,1237,1247,16,1263,3
2021-04-08,Monterey,053,433212,42685,42437,1764,44201,342
2021-04-08,Napa,055,140530,9588,9569,32,9601,80
2021-04-08,Nevada,057,99092,4431,4367,182,4549,69
2021-04-08,Orange,059,3164182,252355,250529,10828,261357,4797
2021-04-08,Placer,061,380077,22024,21258,1313,22571,277
2021-04-08,Plumas,063,18699,674,665,10,675,4
2021-04-08,Riverside,065,2383286,290638,283853,13591,297444,4296
2021-04-08,Sacramento,067,1510023,100590,99319,1465,100784,1561
2021-04-08,San Benito,069,59416,5926,5914,102,6016,62
2021-04-08,San Bernardino,071,2135413,290228,287190,8741,295931,4445
2021-04-08,San Diego,073,3302833,273490,272495,13853,286348,3592
2021-04-08,San Francisco,075,870044,35661,35657,1197,36854,494
2021-04-08,San Joaquin,077,732212,70567,69479,3220,72699,1279
2021-04-08,San Luis Obispo,079,281455,20759,20402,635,21037,252
2021-04-08,San Mateo,081,765935,41175,40749,431,41180,350
2021-04-08,Santa Barbara,083,443738,33699,33309,1085,34394,444
2021-04-08,Santa Clara,085,1922200,115533,115487,666,116153,1905
2021-04-08,Santa Cruz,087,273765,15950,15296,788,16084,203
2021-04-08,Shasta,089,179085,11470,11466,1381,12847,186
2021-04-08,Sierra,091,2930,55,51,12,63,0
2021-04-08,Siskiyou,093,43540,1593,1511,264,1775,7
2021-04-08,Solano,095,438530,31280,31120,426,31546,238
2021-04-08,Sonoma,097,501317,29340,29410,287,29697,310
2021-04-08,Stanislaus,099,539301,53813,53401,5604,59005,706
2021-04-08,Sutter,101,95872,9183,9195,80,9275,106
2021-04-08,Tehama,103,63373,4860,4802,517,5319,52
2021-04-08,Trinity,105,12862,481,324,81,405,3
2021-04-08,Tulare,107,460477,49462,48409,8522,56931,821
2021-04-08,Tuolumne,109,53932,3941,3986,39,4025,57
2021-04-08,Ventura,111,848112,80221,79626,2867,82493,986
2021-04-08,Yolo,113,214977,13487,13468,169,13637,198
2021-04-08,Yuba,115,75493,5784,5743,112,5855,43
2021-04-07,Alameda,001,1643700,84680,84130,1793,85923,1224
2021-04-07,Alpine,003,1148,85,85,0,85,0
2021-04-07,Amador,005,37829,3602,3590,32,3622,46
2021-04-07,Butte,007,227075,11800,11405,1671,13076,193
2021-04-07,Calaveras,009,45235,2029,2022,11,2033,50
2021-04-07,Colusa,011,21464,1898,1894,276,2170,14
2021-04-07,Contra Costa,013,1133247,66513,65619,1138,66757,775
2021-04-07,Del Norte,015,27424,1243,1198,11,1209,6
2021-04-07,El Dorado,017,186661,9617,9500,643,10143,106
2021-04-07,Fresno,019,978130,100479,99865,8252,108117,1627
2021-04-07,Glenn,021,27897,2365,2337,531,2868,17
2021-04-07,Humboldt,023,135768,3510,3484,25,3509,35
2021-04-07,Imperial,025,180216,27885,27704,2569,30273,713
2021-04-07,Inyo,027,18085,1389,1386,10,1396,36
2021-04-07,Kern,029,883053,95772,94456,10293,104749,1275
2021-04-07,Kings,031,150075,22829,22589,1018,23607,243
2021-04-07,Lake,033,64148,3393,3358,9,3367,43
2021-04-07,Lassen,035,31185,5153,5137,102,5239,1
2021-04-07,Los Angeles,037,10098052,1193568,1183862,39821,1223683,23372
2021-04-07,Madera,039,155013,16273,16090,896,16986,231
2021-04-07,Marin,041,260295,13768,13688,222,13910,225
2021-04-07,Mariposa,043,17540,398,391,6,397,5
2021-04-07,Mendocino,045,87422,3777,3691,74,3765,45
2021-04-07,Merced,047,269075,30080,30132,985,31117,430
2021-04-07,Modoc,049,8938,361,351,118,469,3
2021-04-07,Mono,051,14174,1237,1246,16,1262,3
2021-04-07,Monterey,053,433212,42667,42427,1763,44190,341
2021-04-07,Napa,055,140530,9574,9556,32,9588,80
2021-04-07,Nevada,057,99092,4425,4364,182,4546,69
2021-04-07,Orange,059,3164182,252230,250378,10806,261184,4778
2021-04-07,Placer,061,380077,21980,21227,1305,22532,276
2021-04-07,Plumas,063,18699,674,665,10,675,4
2021-04-07,Riverside,065,2383286,290518,283749,13581,297330,4285
2021-04-07,Sacramento,067,1510023,100422,99202,1459,100661,1544
2021-04-07,San Benito,069,59416,5921,5912,101,6013,62
2021-04-07,San Bernardino,071,2135413,290109,286978,8736,295714,4433
2021-04-07,San Diego,073,3302833,273264,272195,13824,286019,3588
2021-04-07,San Francisco,075,870044,35621,35618,1193,36811,493
2021-04-07,San Joaquin,077,732212,70497,69375,3215,72590,1278
2021-04-07,San Luis Obispo,079,281455,20733,20373,632,21005,252
2021-04-07,San Mateo,081,765935,41131,40693,431,41124,350
2021-04-07,Santa Barbara,083,443738,33673,33289,1082,34371,444
2021-04-07,Santa Clara,085,1922200,115401,115311,664,115975,1900
2021-04-07,Santa Cruz,087,273765,15939,15275,788,16063,203
2021-04-07,Shasta,089,179085,11458,11456,1377,12833,184
2021-04-07,Sierra,091,2930,55,51,12,63,0
2021-04-07,Siskiyou,093,43540,1587,1512,263,1775,7
2021-04-07,Solano,095,438530,31229,31097,425,31522,238
2021-04-07,Sonoma,097,501317,29322,29394,286,29680,310
2021-04-07,Stanislaus,099,539301,53745,53344,5594,58938,686
2021-04-07,Sutter,101,95872,9180,9188,80,9268,106
2021-04-07,Tehama,103,63373,4852,4802,515,5317,52
2021-04-07,Trinity,105,12862,481,322,81,403,3
2021-04-07,Tulare,107,460477,49447,48386,8512,56898,820
2021-04-07,Tuolumne,109,53932,3939,3982,39,4021,57
2021-04-07,Ventura,111,848112,80187,79595,2865,82460,986
2021-04-07,Yolo,113,214977,13472,13450,167,13617,198
2021-04-07,Yuba,115,75493,5780,5737,112,5849,43
2021-04-06,Alameda,001,1643700,84567,84091,1790,85881,1223
2021-04-06,Alpine,003,1148,85,85,0,85,0
2021-04-06,Amador,005,37829,3601,3587,32,3619,45
2021-04-06,Butte,007,227075,11785,11396,1669,13065,193
2021-04-06,Calaveras,009,45235,2025,2021,11,2032,50
2021-04-06,Colusa,011,21464,1896,1894,274,2168,14
2021-04-06,Contra Costa,013,1133247,66435,65575,1137,66712,774
2021-04-06,Del Norte,015,27424,1238,1197,11,1208,6
2021-04-06,El Dorado,017,186661,9587,9489,641,10130,106
2021-04-06,Fresno,019,978130,100415,99814,8246,108060,1626
2021-04-06,Glenn,021,27897,2364,2335,530,2865,17
2021-04-06,Humboldt,023,135768,3501,3477,25,3502,35
2021-04-06,Imperial,025,180216,27851,27661,2560,30221,713
2021-04-06,Inyo,027,18085,1389,1379,10,1389,36
2021-04-06,Kern,029,883053,95728,94422,10287,104709,1259
2021-04-06,Kings,031,150075,22823,22587,1018,23605,240
2021-04-06,Lake,033,64148,3390,3358,9,3367,43
2021-04-06,Lassen,035,31185,5151,5137,102,5239,1
2021-04-06,Los Angeles,037,10098052,1193057,1183499,39782,1223281,23323
2021-04-06,Madera,039,155013,16253,16085,891,16976,230
2021-04-06,Marin,041,260295,13759,13675,218,13893,224
2021-04-06,Mariposa,043,17540,398,390,6,396,5
2021-04-06,Mendocino,045,87422,3775,3686,74,3760,45
2021-04-06,Merced,047,269075,30051,30100,980,31080,430
2021-04-06,Modoc,049,8938,360,351,118,469,3
2021-04-06,Mono,051,14174,1237,1246,16,1262,3
2021-04-06,Monterey,053,433212,42658,42412,1762,44174,341
2021-04-06,Napa,055,140530,9555,9509,32,9541,78
2021-04-06,Nevada,057,99092,4415,4356,180,4536,69
2021-04-06,Orange,059,3164182,252121,250304,10793,261097,4771
2021-04-06,Placer,061,380077,21932,21184,1303,22487,276
2021-04-06,Plumas,063,18699,674,665,10,675,4
2021-04-06,Riverside,065,2383286,290337,283622,13570,297192,4264
2021-04-06,Sacramento,067,1510023,100214,99110,1453,100563,1537
2021-04-06,San Benito,069,59416,5912,5907,101,6008,62
2021-04-06,San Bernardino,071,2135413,289996,286792,8726,295518,4428
2021-04-06,San Diego,073,3302833,273002,271867,13796,285663,3585
2021-04-06,San Francisco,075,870044,35578,35572,1193,36765,488
2021-04-06,San Joaquin,077,732212,70414,69316,3203,72519,1278
2021-04-06,San Luis Obispo,079,281455,20711,20350,629,20979,252
2021-04-06,San Mateo,081,765935,41083,40649,430,41079,350
2021-04-06,Santa Barbara,083,443738,33655,33257,1081,34338,443
2021-04-06,Santa Clara,085,1922200,115230,115184,663,115847,1900
2021-04-06,Santa Cruz,087,273765,15929,15252,788,16040,203
2021-04-06,Shasta,089,179085,11437,11443,1375,12818,184
2021-04-06,Sierra,091,2930,55,51,12,63,0
2021-04-06,Siskiyou,093,43540,1583,1510,262,1772,7
2021-04-06,Solano,095,438530,31182,31078,424,31502,237
2021-04-06,Sonoma,097,501317,29297,29386,284,29670,311
2021-04-06,Stanislaus,099,539301,53689,53304,5588,58892,686
2021-04-06,Sutter,101,95872,9170,9179,80,9259,106
2021-04-06,Tehama,103,63373,4843,4798,515,5313,52
2021-04-06,Trinity,105,12862,481,321,81,402,3
2021-04-06,Tulare,107,460477,49404,48372,8508,56880,819
2021-04-06,Tuolumne,109,53932,3939,3981,39,4020,57
2021-04-06,Ventura,111,848112,80150,79556,2863,82419,983
2021-04-06,Yolo,113,214977,13459,13443,166,13609,198
2021-04-06,Yuba,115,75493,5776,5733,111,5844,43
2021-04-05,Alameda,001,1643700,84451,84007,1786,85793,1219
2021-04-05,Alpine,003,1148,85,85,0,85,0
2021-04-05,Amador,005,37829,3598,3584,32,3616,45
2021-04-05,Butte,007,227075,11770,11384,1669,13053,193
2021-04-05,Calaveras,009,45235,2023,2019,11,2030,50
2021-04-05,Colusa,011,21464,1896,1894,273,2167,14
2021-04-05,Contra Costa,013,1133247,66369,65457,1135,66592,774
2021-04-05,Del Norte,015,27424,1236,1189,11,1200,6
2021-04-05,El Dorado,017,186661,9572,9463,641,10104,106
2021-04-05,Fresno,019,978130,100327,99755,8238,107993,1622
2021-04-05,Glenn,021,27897,2363,2335,530,2865,17
2021-04-05,Humboldt,023,135768,3492,3475,25,3500,35
2021-04-05,Imperial,025,180216,27819,27604,2555,30159,710
2021-04-05,Inyo,027,18085,1386,1377,10,1387,36
2021-04-05,Kern,029,883053,95673,94401,10262,104663,1249
2021-04-05,Kings,031,150075,22819,22580,1018,23598,239
2021-04-05,Lake,033,64148,3382,3359,9,3368,43
2021-04-05,Lassen,035,31185,5151,5138,101,5239,1
2021-04-05,Los Angeles,037,10098052,1192522,1183200,39733,1222933,23302
2021-04-05,Madera,039,155013,16239,16065,890,16955,230
2021-04-05,Marin,041,260295,13745,13666,214,13880,221
2021-04-05,Mariposa,043,17540,398,390,6,396,5
2021-04-05,Mendocino,045,87422,3773,3687,74,3761,45
2021-04-05,Merced,047,269075,30025,30068,978,31046,427
2021-04-05,Modoc,049,8938,358,346,118,464,3
2021-04-05,Mono,051,14174,1237,1246,16,1262,3
2021-04-05,Monterey,053,433212,42645,42396,1758,44154,341
2021-04-05,Napa,055,140530,9532,9492,32,9524,78
2021-04-05,Nevada,057,99092,4404,4346,180,4526,69
2021-04-05,Orange,059,3164182,252006,250177,10769,260946,4759
2021-04-05,Placer,061,380077,21886,21133,1296,22429,276
2021-04-05,Plumas,063,18699,674,666,10,676,4
2021-04-05,Riverside,065,2383286,290200,283549,13558,297107,4237
2021-04-05,Sacramento,067,1510023,100052,98908,1445,100353,1533
2021-04-05,San Benito,069,59416,5906,5904,101,6005,61
2021-04-05,San Bernardino,071,2135413,289886,286597,8723,295320,4425
2021-04-05,San Diego,073,3302833,272753,271655,13755,285410,3583
2021-04-05,San Francisco,075,870044,35547,35538,1193,36731,488
2021-04-05,San Joaquin,077,732212,70325,69214,3194,72408,1268
2021-04-05,San Luis Obispo,079,281455,20674,20333,629,20962,252
2021-04-05,San Mateo,081,765935,41039,40609,429,41038,350
2021-04-05,Santa Barbara,083,443738,33620,33235,1081,34316,443
2021-04-05,Santa Clara,085,1922200,115063,115091,660,115751,1893
2021-04-05,Santa Cruz,087,273765,15922,15228,788,16016,201
2021-04-05,Shasta,089,179085,11416,11435,1372,12807,184
2021-04-05,Sierra,091,2930,55,50,12,62,0
2021-04-05,Siskiyou,093,43540,1580,1509,260,1769,7
2021-04-05,Solano,095,438530,31141,31026,422,31448,237
2021-04-05,Sonoma,097,501317,29265,29361,282,29643,311
2021-04-05,Stanislaus,099,539301,53609,53238,5585,58823,686
2021-04-05,Sutter,101,95872,9163,9169,80,9249,106
2021-04-05,Tehama,103,63373,4837,4794,515,5309,52
2021-04-05,Trinity,105,12862,480,321,81,402,3
2021-04-05,Tulare,107,460477,49392,48356,8501,56857,818
2021-04-05,Tuolumne,109,53932,3938,3980,39,4019,57
2021-04-05,Ventura,111,848112,80119,79549,2860,82409,983
2021-04-05,Yolo,113,214977,13445,13427,165,13592,198
2021-04-05,Yuba,115,75493,5771,5728,110,5838,43
2021-04-04,Alameda,001,1643700,84333,83951,1782,85733,1219
2021-04-04,Alpine,003,1148,85,85,0,85,0
2021-04-04,Amador,005,37829,3592,3582,32,3614,45
2021-04-04,Butte,007,227075,11755,11375,1668,13043,193
2021-04-04,Calaveras,009,45235,2019,2020,11,2031,50
2021-04-04,Colusa,011,21464,1895,1893,273,2166,14
2021-04-04,Contra Costa,013,1133247,66263,65408,1130,66538,774
2021-04-04,Del Norte,015,27424,1228,1186,11,1197,6
2021-04-04,El Dorado,017,186661,9553,9455,638,10093,106
2021-04-04,Fresno,019,978130,100253,99702,8226,107928,1622
2021-04-04,Glenn,021,27897,2360,2335,529,2864,17
2021-04-04,Humboldt,023,135768,3481,3472,25,3497,35
2021-04-04,Imperial,025,180216,27763,27588,2553,30141,710
2021-04-04,Inyo,027,18085,1382,1377,10,1387,36
2021-04-04,Kern,029,883053,95629,94388,10241,104629,1247
2021-04-04,Kings,031,150075,22817,22580,1017,23597,239
2021-04-04,Lake,033,64148,3376,3355,8,3363,43
2021-04-04,Lassen,035,31185,5149,5138,101,5239,1
2021-04-04,Los Angeles,037,10098052,1191978,1182872,39689,1222561,23301
2021-04-04,Madera,039,155013,16213,16052,886,16938,230
2021-04-04,Marin,041,260295,13732,13663,213,13876,221
2021-04-04,Mariposa,043,17540,398,390,6,396,5
2021-04-04,Mendocino,045,87422,3770,3684,74,3758,45
2021-04-04,Merced,047,269075,29982,30048,975,31023,427
2021-04-04,Modoc,049,8938,358,346,118,464,3
2021-04-04,Mono,051,14174,1236,1245,16,1261,3
2021-04-04,Monterey,053,433212,42628,42391,1757,44148,341
2021-04-04,Napa,055,140530,9520,9486,32,9518,78
2021-04-04,Nevada,057,99092,4392,4337,180,4517,69
2021-04-04,Orange,059,3164182,251872,250117,10753,260870,4759
2021-04-04,Placer,061,380077,21839,21104,1278,22382,276
2021-04-04,Plumas,063,18699,674,666,10,676,4
2021-04-04,Riverside,065,2383286,290074,283537,13554,297091,4237
2021-04-04,Sacramento,067,1510023,99853,98821,1436,100257,1531
2021-04-04,San Benito,069,59416,5896,5901,97,5998,61
2021-04-04,San Bernardino,071,2135413,289746,286561,8715,295276,4423
2021-04-04,San Diego,073,3302833,272441,271528,13714,285242,3583
2021-04-04,San Francisco,075,870044,35493,35525,1190,36715,488
2021-04-04,San Joaquin,077,732212,70224,69147,3182,72329,1268
2021-04-04,San Luis Obispo,079,281455,20642,20328,621,20949,252
2021-04-04,San Mateo,081,765935,40996,40587,427,41014,350
2021-04-04,Santa Barbara,083,443738,33584,33213,1081,34294,443
2021-04-04,Santa Clara,085,1922200,114897,114976,653,115629,1893
2021-04-04,Santa Cruz,087,273765,15913,15219,788,16007,201
2021-04-04,Shasta,089,179085,11390,11433,1371,12804,184
2021-04-04,Sierra,091,2930,55,50,12,62,0
2021-04-04,Siskiyou,093,43540,1577,1509,256,1765,7
2021-04-04,Solano,095,438530,31094,31002,420,31422,237
2021-04-04,Sonoma,097,501317,29233,29340,280,29620,311
2021-04-04,Stanislaus,099,539301,53516,53181,5577,58758,686
2021-04-04,Sutter,101,95872,9156,9164,80,9244,106
2021-04-04,Tehama,103,63373,4825,4792,514,5306,52
2021-04-04,Trinity,105,12862,478,321,81,402,3
2021-04-04,Tulare,107,460477,49378,48343,8493,56836,818
2021-04-04,Tuolumne,109,53932,3930,3980,39,4019,57
2021-04-04,Ventura,111,848112,80076,79526,2858,82384,983
2021-04-04,Yolo,113,214977,13424,13425,164,13589,198
2021-04-04,Yuba,115,75493,5764,5722,110,5832,43
2021-04-03,Alameda,001,1643700,84266,83861,1780,85641,1218
2021-04-03,Alpine,003,1148,85,85,0,85,0
2021-04-03,Amador,005,37829,3589,3577,32,3609,45
2021-04-03,Butte,007,227075,11751,11359,1664,13023,193
2021-04-03,Calaveras,009,45235,2017,2019,11,2030,50
2021-04-03,Colusa,011,21464,1895,1891,273,2164,14
2021-04-03,Contra Costa,013,1133247,66191,65338,1130,66468,774
2021-04-03,Del Norte,015,27424,1223,1183,11,1194,6
2021-04-03,El Dorado,017,186661,9544,9448,637,10085,106
2021-04-03,Fresno,019,978130,100196,99602,8220,107822,1622
2021-04-03,Glenn,021,27897,2359,2334,528,2862,17
2021-04-03,Humboldt,023,135768,3479,3467,25,3492,35
2021-04-03,Imperial,025,180216,27747,27572,2550,30122,710
2021-04-03,Inyo,027,18085,1381,1376,10,1386,36
2021-04-03,Kern,029,883053,95603,94369,10225,104594,1243
2021-04-03,Kings,031,150075,22815,22580,1017,23597,239
2021-04-03,Lake,033,64148,3375,3350,8,3358,43
2021-04-03,Lassen,035,31185,5148,5136,101,5237,1
2021-04-03,Los Angeles,037,10098052,1191671,1182402,39672,1222074,23301
2021-04-03,Madera,039,155013,16204,16051,884,16935,230
2021-04-03,Marin,041,260295,13724,13658,212,13870,221
2021-04-03,Mariposa,043,17540,398,390,5,395,5
2021-04-03,Mendocino,045,87422,3769,3684,74,3758,45
2021-04-03,Merced,047,269075,29967,30031,975,31006,427
2021-04-03,Modoc,049,8938,358,346,118,464,3
2021-04-03,Mono,051,14174,1236,1245,16,1261,3
2021-04-03,Monterey,053,433212,42615,42376,1755,44131,341
2021-04-03,Napa,055,140530,9511,9473,32,9505,78
2021-04-03,Nevada,057,99092,4388,4323,180,4503,69
2021-04-03,Orange,059,3164182,251791,249982,10735,260717,4755
2021-04-03,Placer,061,380077,21808,21060,1274,22334,276
2021-04-03,Plumas,063,18699,674,666,10,676,4
2021-04-03,Riverside,065,2383286,289996,283423,13551,296974,4237
2021-04-03,Sacramento,067,1510023,99745,98660,1430,100090,1531
2021-04-03,San Benito,069,59416,5893,5893,96,5989,61
2021-04-03,San Bernardino,071,2135413,289682,286473,8709,295182,4422
2021-04-03,San Diego,073,3302833,272272,271335,13697,285032,3571
2021-04-03,San Francisco,075,870044,35474,35488,1188,36676,489
2021-04-03,San Joaquin,077,732212,70183,69100,3166,72266,1268
2021-04-03,San Luis Obispo,079,281455,20623,20301,621,20922,252
2021-04-03,San Mateo,081,765935,40971,40560,427,40987,350
2021-04-03,Santa Barbara,083,443738,33558,33172,1080,34252,443
2021-04-03,Santa Clara,085,1922200,114789,114865,651,115516,1893
2021-04-03,Santa Cruz,087,273765,15906,15205,788,15993,201
2021-04-03,Shasta,089,179085,11382,11418,1371,12789,184
2021-04-03,Sierra,091,2930,55,50,12,62,0
2021-04-03,Siskiyou,093,43540,1576,1509,256,1765,7
2021-04-03,Solano,095,438530,31073,30970,417,31387,237
2021-04-03,Sonoma,097,501317,29217,29315,279,29594,311
2021-04-03,Stanislaus,099,539301,53481,53137,5571,58708,686
2021-04-03,Sutter,101,95872,9150,9158,80,9238,106
2021-04-03,Tehama,103,63373,4817,4788,514,5302,52
2021-04-03,Trinity,105,12862,478,321,81,402,3
2021-04-03,Tulare,107,460477,49368,48327,8489,56816,818
2021-04-03,Tuolumne,109,53932,3930,3980,39,4019,57
2021-04-03,Ventura,111,848112,80055,79489,2856,82345,983
2021-04-03,Yolo,113,214977,13418,13414,164,13578,198
2021-04-03,Yuba,115,75493,5758,5716,110,5826,43
2021-04-02,Alameda,001,1643700,84193,83776,1777,85553,1217
2021-04-02,Alpine,003,1148,85,85,0,85,0
2021-04-02,Amador,005,37829,3585,3573,31,3604,45
2021-04-02,Butte,007,227075,11742,11350,1664,13014,193
2021-04-02,Calaveras,009,45235,2015,2010,11,2021,50
2021-04-02,Colusa,011,21464,1895,1891,273,2164,14
2021-04-02,Contra Costa,013,1133247,66127,65299,1129,66428,774
2021-04-02,Del Norte,015,27424,1220,1174,11,1185,6
2021-04-02,El Dorado,017,186661,9531,9437,634,10071,106
2021-04-02,Fresno,019,978130,100142,99551,8209,107760,1620
2021-04-02,Glenn,021,27897,2359,2331,528,2859,17
2021-04-02,Humboldt,023,135768,3475,3465,25,3490,35
2021-04-02,Imperial,025,180216,27735,27553,2544,30097,710
2021-04-02,Inyo,027,18085,1381,1377,10,1387,36
2021-04-02,Kern,029,883053,95585,94348,10222,104570,1233
2021-04-02,Kings,031,150075,22815,22571,1014,23585,239
2021-04-02,Lake,033,64148,3373,3348,8,3356,43
2021-04-02,Lassen,035,31185,5148,5134,101,5235,1
2021-04-02,Los Angeles,037,10098052,1191360,1181682,39651,1221333,23264
2021-04-02,Madera,039,155013,16195,16036,883,16919,230
2021-04-02,Marin,041,260295,13716,13649,212,13861,221
2021-04-02,Mariposa,043,17540,396,390,5,395,5
2021-04-02,Mendocino,045,87422,3766,3682,74,3756,45
2021-04-02,Merced,047,269075,29942,29998,975,30973,426
2021-04-02,Modoc,049,8938,355,346,118,464,3
2021-04-02,Mono,051,14174,1236,1246,16,1262,3
2021-04-02,Monterey,053,433212,42605,42359,1752,44111,341
2021-04-02,Napa,055,140530,9496,9453,32,9485,78
2021-04-02,Nevada,057,99092,4384,4323,180,4503,69
2021-04-02,Orange,059,3164182,251695,249891,10723,260614,4748
2021-04-02,Placer,061,380077,21772,21035,1268,22303,275
2021-04-02,Plumas,063,18699,674,666,10,676,4
2021-04-02,Riverside,065,2383286,289910,283328,13542,296870,4213
2021-04-02,Sacramento,067,1510023,99638,98648,1423,100071,1527
2021-04-02,San Benito,069,59416,5891,5888,94,5982,61
2021-04-02,San Bernardino,071,2135413,289609,286308,8705,295013,4417
2021-04-02,San Diego,073,3302833,272085,271036,13671,284707,3568
2021-04-02,San Francisco,075,870044,35439,35451,1186,36637,488
2021-04-02,San Joaquin,077,732212,70118,68996,3151,72147,1268
2021-04-02,San Luis Obispo,079,281455,20606,20271,620,20891,252
2021-04-02,San Mateo,081,765935,40929,40514,427,40941,350
2021-04-02,Santa Barbara,083,443738,33530,33145,1080,34225,443
2021-04-02,Santa Clara,085,1922200,114678,114777,649,115426,1882
2021-04-02,Santa Cruz,087,273765,15898,15216,788,16004,202
2021-04-02,Shasta,089,179085,11377,11377,1364,12741,181
2021-04-02,Sierra,091,2930,55,50,12,62,0
2021-04-02,Siskiyou,093,43540,1576,1508,255,1763,7
2021-04-02,Solano,095,438530,31044,30951,414,31365,237
2021-04-02,Sonoma,097,501317,29196,29288,278,29566,311
2021-04-02,Stanislaus,099,539301,53436,53073,5565,58638,687
2021-04-02,Sutter,101,95872,9142,9131,80,9211,106
2021-04-02,Tehama,103,63373,4810,4775,513,5288,52
2021-04-02,Trinity,105,12862,478,320,81,401,3
2021-04-02,Tulare,107,460477,49362,48306,8483,56789,818
2021-04-02,Tuolumne,109,53932,3927,3980,39,4019,57
2021-04-02,Ventura,111,848112,80028,79434,2854,82288,982
2021-04-02,Yolo,113,214977,13408,13381,164,13545,197
2021-04-02,Yuba,115,75493,5754,5709,110,5819,44
2021-04-01,Alameda,001,1643700,84114,83574,1772,85346,1216
2021-04-01,Alpine,003,1148,85,85,0,85,0
2021-04-01,Amador,005,37829,3581,3558,31,3589,45
2021-04-01,Butte,007,227075,11724,11328,1662,12990,193
2021-04-01,Calaveras,009,45235,2012,2006,11,2017,50
2021-04-01,Colusa,011,21464,1892,1890,273,2163,14
2021-04-01,Contra Costa,013,1133247,66067,65176,1127,66303,771
2021-04-01,Del Norte,015,27424,1215,1138,11,1149,6
2021-04-01,El Dorado,017,186661,9522,9393,630,10023,106
2021-04-01,Fresno,019,978130,100089,99317,8201,107518,1616
2021-04-01,Glenn,021,27897,2359,2322,527,2849,17
2021-04-01,Humboldt,023,135768,3471,3464,25,3489,35
2021-04-01,Imperial,025,180216,27705,27520,2539,30059,710
2021-04-01,Inyo,027,18085,1380,1374,10,1384,36
2021-04-01,Kern,029,883053,95549,94244,10210,104454,1233
2021-04-01,Kings,031,150075,22808,22560,1013,23573,239
2021-04-01,Lake,033,64148,3368,3337,8,3345,43
2021-04-01,Lassen,035,31185,5147,5132,101,5233,1
2021-04-01,Los Angeles,037,10098052,1190866,1181101,39622,1220723,23220
2021-04-01,Madera,039,155013,16179,16023,883,16906,230
2021-04-01,Marin,041,260295,13706,13635,212,13847,221
2021-04-01,Mariposa,043,17540,394,389,5,394,5
2021-04-01,Mendocino,045,87422,3766,3680,74,3754,45
2021-04-01,Merced,047,269075,29909,29820,975,30795,425
2021-04-01,Modoc,049,8938,354,346,118,464,3
2021-04-01,Mono,051,14174,1236,1245,16,1261,3
2021-04-01,Monterey,053,433212,42597,42324,1750,44074,339
2021-04-01,Napa,055,140530,9484,9410,32,9442,78
2021-04-01,Nevada,057,99092,4374,4288,179,4467,68
2021-04-01,Orange,059,3164182,251575,249617,10706,260323,4742
2021-04-01,Placer,061,380077,21733,20909,1256,22165,274
2021-04-01,Plumas,063,18699,674,664,10,674,4
2021-04-01,Riverside,065,2383286,289805,283128,13539,296667,4193
2021-04-01,Sacramento,067,1510023,99494,97952,1410,99362,1521
2021-04-01,San Benito,069,59416,5883,5878,93,5971,61
2021-04-01,San Bernardino,071,2135413,289493,286086,8696,294782,4404
2021-04-01,San Diego,073,3302833,271862,270540,13641,284181,3555
2021-04-01,San Francisco,075,870044,35418,35386,1183,36569,488
2021-04-01,San Joaquin,077,732212,70036,68802,3143,71945,1262
2021-04-01,San Luis Obispo,079,281455,20577,20235,619,20854,252
2021-04-01,San Mateo,081,765935,40888,40454,427,40881,350
2021-04-01,Santa Barbara,083,443738,33483,33096,1075,34171,443
2021-04-01,Santa Clara,085,1922200,114565,114606,648,115254,1874
2021-04-01,Santa Cruz,087,273765,15883,15271,788,16059,202
2021-04-01,Shasta,089,179085,11362,11355,1359,12714,181
2021-04-01,Sierra,091,2930,55,50,12,62,0
2021-04-01,Siskiyou,093,43540,1574,1507,254,1761,7
2021-04-01,Solano,095,438530,31011,30850,411,31261,237
2021-04-01,Sonoma,097,501317,29165,29241,271,29512,311
2021-04-01,Stanislaus,099,539301,53374,52825,5559,58384,687
2021-04-01,Sutter,101,95872,9130,9105,80,9185,106
2021-04-01,Tehama,103,63373,4804,4764,510,5274,52
2021-04-01,Trinity,105,12862,478,319,81,400,3
2021-04-01,Tulare,107,460477,49339,48279,8473,56752,817
2021-04-01,Tuolumne,109,53932,3925,3978,39,4017,57
2021-04-01,Ventura,111,848112,80004,79369,2853,82222,977
2021-04-01,Yolo,113,214977,13395,13342,164,13506,197
2021-04-01,Yuba,115,75493,5749,5694,110,5804,44
2021-03-31,Alameda,001,1643700,84032,83475,1767,85242,1215
2021-03-31,Alpine,003,1148,85,85,0,85,0
2021-03-31,Amador,005,37829,3578,3556,31,3587,45
2021-03-31,Butte,007,227075,11714,11321,1659,12980,193
2021-03-31,Calaveras,009,45235,2010,2005,11,2016,50
2021-03-31,Colusa,011,21464,1892,1890,273,2163,14
2021-03-31,Contra Costa,013,1133247,65982,65109,1126,66235,769
2021-03-31,Del Norte,015,27424,1206,1129,11,1140,6
2021-03-31,El Dorado,017,186661,9505,9390,630,10020,106
2021-03-31,Fresno,019,978130,99996,99240,8185,107425,1616
2021-03-31,Glenn,021,27897,2355,2318,525,2843,17
2021-03-31,Humboldt,023,135768,3465,3460,25,3485,35
2021-03-31,Imperial,025,180216,27685,27506,2538,30044,710
2021-03-31,Inyo,027,18085,1377,1373,9,1382,35
2021-03-31,Kern,029,883053,95506,94205,10201,104406,1229
2021-03-31,Kings,031,150075,22805,22540,1013,23553,239
2021-03-31,Lake,033,64148,3364,3332,8,3340,43
2021-03-31,Lassen,035,31185,5143,5132,101,5233,1
2021-03-31,Los Angeles,037,10098052,1190395,1180538,39583,1220121,23171
2021-03-31,Madera,039,155013,16165,16015,882,16897,229
2021-03-31,Marin,041,260295,13695,13624,212,13836,221
2021-03-31,Mariposa,043,17540,394,389,5,394,5
2021-03-31,Mendocino,045,87422,3760,3675,74,3749,45
2021-03-31,Merced,047,269075,29880,29780,975,30755,423
2021-03-31,Modoc,049,8938,354,346,118,464,3
2021-03-31,Mono,051,14174,1236,1245,16,1261,3
2021-03-31,Monterey,053,433212,42580,42309,1748,44057,338
2021-03-31,Napa,055,140530,9466,9401,32,9433,78
2021-03-31,Nevada,057,99092,4368,4283,179,4462,68
2021-03-31,Orange,059,3164182,251464,249518,10691,260209,4731
2021-03-31,Placer,061,380077,21683,20885,1249,22134,271
2021-03-31,Plumas,063,18699,673,663,10,673,4
2021-03-31,Riverside,065,2383286,289703,283006,13529,296535,4171
2021-03-31,Sacramento,067,1510023,99319,97760,1403,99163,1519
2021-03-31,San Benito,069,59416,5873,5875,93,5968,61
2021-03-31,San Bernardino,071,2135413,289399,285916,8693,294609,4356
2021-03-31,San Diego,073,3302833,271630,270288,13606,283894,3555
2021-03-31,San Francisco,075,870044,35373,35347,1182,36529,474
2021-03-31,San Joaquin,077,732212,69947,68685,3127,71812,1259
2021-03-31,San Luis Obispo,079,281455,20555,20215,618,20833,251
2021-03-31,San Mateo,081,765935,40858,40423,427,40850,350
2021-03-31,Santa Barbara,083,443738,33451,33052,1073,34125,443
2021-03-31,Santa Clara,085,1922200,114438,114499,648,115147,1874
2021-03-31,Santa Cruz,087,273765,15870,15295,787,16082,201
2021-03-31,Shasta,089,179085,11350,11327,1351,12678,179
2021-03-31,Sierra,091,2930,55,50,12,62,0
2021-03-31,Siskiyou,093,43540,1573,1505,254,1759,7
2021-03-31,Solano,095,438530,30965,30824,410,31234,235
2021-03-31,Sonoma,097,501317,29138,29216,271,29487,311
2021-03-31,Stanislaus,099,539301,53305,52782,5547,58329,687
2021-03-31,Sutter,101,95872,9119,9111,80,9191,106
2021-03-31,Tehama,103,63373,4799,4762,508,5270,52
2021-03-31,Trinity,105,12862,478,319,81,400,3
2021-03-31,Tulare,107,460477,49319,48261,8457,56718,816
2021-03-31,Tuolumne,109,53932,3924,3976,39,4015,57
2021-03-31,Ventura,111,848112,79972,79326,2849,82175,969
2021-03-31,Yolo,113,214977,13378,13359,163,13522,197
2021-03-31,Yuba,115,75493,5742,5686,110,5796,44
2021-03-30,Alameda,001,1643700,83932,83395,1764,85159,1211
2021-03-30,Alpine,003,1148,85,85,0,85,0
2021-03-30,Amador,005,37829,3575,3551,31,3582,45
2021-03-30,Butte,007,227075,11702,11296,1656,12952,193
2021-03-30,Calaveras,009,45235,2006,1997,11,2008,50
2021-03-30,Colusa,011,21464,1891,1890,272,2162,14
2021-03-30,Contra Costa,013,1133247,65893,65041,1124,66165,767
2021-03-30,Del Norte,015,27424,1198,1118,10,1128,6
2021-03-30,El Dorado,017,186661,9486,9381,627,10008,105
2021-03-30,Fresno,019,978130,99931,99156,8172,107328,1609
2021-03-30,Glenn,021,27897,2355,2310,524,2834,17
2021-03-30,Humboldt,023,135768,3463,3461,25,3486,35
2021-03-30,Imperial,025,180216,27657,27471,2536,30007,706
2021-03-30,Inyo,027,18085,1377,1374,9,1383,35
2021-03-30,Kern,029,883053,95464,94151,10192,104343,1221
2021-03-30,Kings,031,150075,22801,22530,1011,23541,238
2021-03-30,Lake,033,64148,3358,3330,8,3338,43
2021-03-30,Lassen,035,31185,5143,5132,101,5233,1
2021-03-30,Los Angeles,037,10098052,1189899,1180044,39561,1219605,23136
2021-03-30,Madera,039,155013,16155,16003,878,16881,229
2021-03-30,Marin,041,260295,13686,13611,204,13815,221
2021-03-30,Mariposa,043,17540,394,388,5,393,5
2021-03-30,Mendocino,045,87422,3758,3670,74,3744,45
2021-03-30,Merced,047,269075,29843,29731,975,30706,423
2021-03-30,Modoc,049,8938,353,346,118,464,3
2021-03-30,Mono,051,14174,1235,1245,16,1261,3
2021-03-30,Monterey,053,433212,42554,42308,1746,44054,338
2021-03-30,Napa,055,140530,9451,9391,32,9423,78
2021-03-30,Nevada,057,99092,4356,4266,178,4444,68
2021-03-30,Orange,059,3164182,251335,249412,10664,260076,4727
2021-03-30,Placer,061,380077,21643,20866,1243,22109,271
2021-03-30,Plumas,063,18699,673,661,10,671,4
2021-03-30,Riverside,065,2383286,289578,282930,13520,296450,4154
2021-03-30,Sacramento,067,1510023,99182,97718,1400,99118,1516
2021-03-30,San Benito,069,59416,5867,5870,93,5963,61
2021-03-30,San Bernardino,071,2135413,289291,285758,8684,294442,4343
2021-03-30,San Diego,073,3302833,271391,269998,13568,283566,3555
2021-03-30,San Francisco,075,870044,35323,35325,1181,36506,474
2021-03-30,San Joaquin,077,732212,69859,68613,3117,71730,1232
2021-03-30,San Luis Obispo,079,281455,20535,20194,618,20812,251
2021-03-30,San Mateo,081,765935,40814,40377,427,40804,349
2021-03-30,Santa Barbara,083,443738,33426,33016,1073,34089,441
2021-03-30,Santa Clara,085,1922200,114316,114413,647,115060,1873
2021-03-30,Santa Cruz,087,273765,15864,15278,787,16065,201
2021-03-30,Shasta,089,179085,11342,11316,1350,12666,184
2021-03-30,Sierra,091,2930,55,50,12,62,0
2021-03-30,Siskiyou,093,43540,1572,1501,254,1755,7
2021-03-30,Solano,095,438530,30935,30802,409,31211,232
2021-03-30,Sonoma,097,501317,29106,29198,271,29469,311
2021-03-30,Stanislaus,099,539301,53227,52690,5539,58229,677
2021-03-30,Sutter,101,95872,9115,9107,79,9186,106
2021-03-30,Tehama,103,63373,4790,4748,507,5255,52
2021-03-30,Trinity,105,12862,478,316,81,397,3
2021-03-30,Tulare,107,460477,49304,48249,8448,56697,815
2021-03-30,Tuolumne,109,53932,3919,3972,39,4011,57
2021-03-30,Ventura,111,848112,79928,79282,2846,82128,958
2021-03-30,Yolo,113,214977,13365,13353,163,13516,195
2021-03-30,Yuba,115,75493,5731,5679,104,5783,42
2021-03-29,Alameda,001,1643700,83830,83338,1762,85100,1211
2021-03-29,Alpine,003,1148,85,85,0,85,0
2021-03-29,Amador,005,37829,3569,3549,31,3580,45
2021-03-29,Butte,007,227075,11694,11291,1653,12944,191
2021-03-29,Calaveras,009,45235,2004,1998,11,2009,50
2021-03-29,Colusa,011,21464,1891,1889,271,2160,14
2021-03-29,Contra Costa,013,1133247,65824,64971,1123,66094,767
2021-03-29,Del Norte,015,27424,1193,1116,9,1125,6
2021-03-29,El Dorado,017,186661,9466,9374,622,9996,105
2021-03-29,Fresno,019,978130,99848,99085,8157,107242,1606
2021-03-29,Glenn,021,27897,2348,2310,524,2834,17
2021-03-29,Humboldt,023,135768,3458,3459,25,3484,34
2021-03-29,Imperial,025,180216,27636,27442,2534,29976,704
2021-03-29,Inyo,027,18085,1377,1372,9,1381,35
2021-03-29,Kern,029,883053,95417,94098,10173,104271,1220
2021-03-29,Kings,031,150075,22789,22522,1010,23532,238
2021-03-29,Lake,033,64148,3355,3325,8,3333,43
2021-03-29,Lassen,035,31185,5143,5131,101,5232,1
2021-03-29,Los Angeles,037,10098052,1189403,1179736,39521,1219257,23108
2021-03-29,Madera,039,155013,16135,15987,876,16863,210
2021-03-29,Marin,041,260295,13674,13600,201,13801,220
2021-03-29,Mariposa,043,17540,393,388,5,393,5
2021-03-29,Mendocino,045,87422,3755,3667,74,3741,45
2021-03-29,Merced,047,269075,29819,29699,975,30674,422
2021-03-29,Modoc,049,8938,352,344,118,462,3
2021-03-29,Mono,051,14174,1234,1243,16,1259,3
2021-03-29,Monterey,053,433212,42538,42305,1741,44046,337
2021-03-29,Napa,055,140530,9435,9379,32,9411,78
2021-03-29,Nevada,057,99092,4349,4258,178,4436,68
2021-03-29,Orange,059,3164182,251223,249295,10652,259947,4713
2021-03-29,Placer,061,380077,21608,20827,1236,22063,267
2021-03-29,Plumas,063,18699,672,660,10,670,4
2021-03-29,Riverside,065,2383286,289475,282867,13519,296386,4133
2021-03-29,Sacramento,067,1510023,98988,97577,1392,98969,1514
2021-03-29,San Benito,069,59416,5860,5865,93,5958,61
2021-03-29,San Bernardino,071,2135413,289194,285615,8680,294295,4335
2021-03-29,San Diego,073,3302833,271125,269771,13542,283313,3547
2021-03-29,San Francisco,075,870044,35288,35291,1178,36469,474
2021-03-29,San Joaquin,077,732212,69773,68537,3104,71641,1211
2021-03-29,San Luis Obispo,079,281455,20500,20176,617,20793,250
2021-03-29,San Mateo,081,765935,40772,40357,426,40783,348
2021-03-29,Santa Barbara,083,443738,33392,32983,1072,34055,439
2021-03-29,Santa Clara,085,1922200,114208,114335,642,114977,1871
2021-03-29,Santa Cruz,087,273765,15853,15249,786,16035,201
2021-03-29,Shasta,089,179085,11324,11313,1348,12661,183
2021-03-29,Sierra,091,2930,55,50,12,62,0
2021-03-29,Siskiyou,093,43540,1570,1497,254,1751,6
2021-03-29,Solano,095,438530,30896,30762,407,31169,232
2021-03-29,Sonoma,097,501317,29083,29184,268,29452,310
2021-03-29,Stanislaus,099,539301,53143,52614,5532,58146,677
2021-03-29,Sutter,101,95872,9108,9105,79,9184,106
2021-03-29,Tehama,103,63373,4782,4742,506,5248,52
2021-03-29,Trinity,105,12862,478,314,81,395,3
2021-03-29,Tulare,107,460477,49276,48226,8437,56663,815
2021-03-29,Tuolumne,109,53932,3917,3969,39,4008,57
2021-03-29,Ventura,111,848112,79886,79252,2846,82098,956
2021-03-29,Yolo,113,214977,13346,13346,163,13509,195
2021-03-29,Yuba,115,75493,5724,5671,103,5774,42
2021-03-28,Alameda,001,1643700,83709,83239,1760,84999,1212
2021-03-28,Alpine,003,1148,85,85,0,85,0
2021-03-28,Amador,005,37829,3565,3541,31,3572,45
2021-03-28,Butte,007,227075,11681,11285,1651,12936,191
2021-03-28,Calaveras,009,45235,2002,1995,11,2006,50
2021-03-28,Colusa,011,21464,1890,1889,271,2160,14
2021-03-28,Contra Costa,013,1133247,65750,64878,1119,65997,767
2021-03-28,Del Norte,015,27424,1186,1107,7,1114,6
2021-03-28,El Dorado,017,186661,9451,9371,620,9991,105
2021-03-28,Fresno,019,978130,99766,99004,8145,107149,1606
2021-03-28,Glenn,021,27897,2344,2309,522,2831,17
2021-03-28,Humboldt,023,135768,3455,3452,24,3476,34
2021-03-28,Imperial,025,180216,27609,27426,2531,29957,704
2021-03-28,Inyo,027,18085,1376,1372,9,1381,35
2021-03-28,Kern,029,883053,95372,94084,10162,104246,1219
2021-03-28,Kings,031,150075,22784,22514,1007,23521,238
2021-03-28,Lake,033,64148,3350,3320,8,3328,43
2021-03-28,Lassen,035,31185,5143,5131,100,5231,1
2021-03-28,Los Angeles,037,10098052,1188850,1179316,39463,1218779,23101
2021-03-28,Madera,039,155013,16120,15973,875,16848,210
2021-03-28,Marin,041,260295,13661,13594,199,13793,221
2021-03-28,Mariposa,043,17540,393,388,5,393,5
2021-03-28,Mendocino,045,87422,3753,3666,74,3740,45
2021-03-28,Merced,047,269075,29762,29679,975,30654,422
2021-03-28,Modoc,049,8938,352,344,118,462,3
2021-03-28,Mono,051,14174,1233,1242,16,1258,3
2021-03-28,Monterey,053,433212,42515,42294,1737,44031,337
2021-03-28,Napa,055,140530,9421,9368,32,9400,78
2021-03-28,Nevada,057,99092,4335,4239,178,4417,68
2021-03-28,Orange,059,3164182,251068,249238,10642,259880,4713
2021-03-28,Placer,061,380077,21564,20796,1230,22026,267
2021-03-28,Plumas,063,18699,670,657,10,667,4
2021-03-28,Riverside,065,2383286,289361,282811,13511,296322,4132
2021-03-28,Sacramento,067,1510023,98814,97425,1386,98811,1514
2021-03-28,San Benito,069,59416,5855,5862,93,5955,61
2021-03-28,San Bernardino,071,2135413,289074,285570,8672,294242,4332
2021-03-28,San Diego,073,3302833,270849,269476,13513,282989,3547
2021-03-28,San Francisco,075,870044,35242,35286,1174,36460,474
2021-03-28,San Joaquin,077,732212,69648,68459,3085,71544,1211
2021-03-28,San Luis Obispo,079,281455,20465,20172,614,20786,250
2021-03-28,San Mateo,081,765935,40727,40305,426,40731,348
2021-03-28,Santa Barbara,083,443738,33350,32953,1071,34024,439
2021-03-28,Santa Clara,085,1922200,114108,114232,638,114870,1871
2021-03-28,Santa Cruz,087,273765,15838,15238,785,16023,201
2021-03-28,Shasta,089,179085,11298,11308,1337,12645,183
2021-03-28,Sierra,091,2930,55,50,12,62,0
2021-03-28,Siskiyou,093,43540,1570,1497,253,1750,6
2021-03-28,Solano,095,438530,30859,30719,405,31124,232
2021-03-28,Sonoma,097,501317,29047,29161,266,29427,310
2021-03-28,Stanislaus,099,539301,53055,52567,5519,58086,678
2021-03-28,Sutter,101,95872,9099,9094,79,9173,106
2021-03-28,Tehama,103,63373,4772,4740,504,5244,52
2021-03-28,Trinity,105,12862,476,314,80,394,3
2021-03-28,Tulare,107,460477,49247,48218,8431,56649,815
2021-03-28,Tuolumne,109,53932,3914,3969,38,4007,57
2021-03-28,Ventura,111,848112,79835,79222,2841,82063,956
2021-03-28,Yolo,113,214977,13329,13325,162,13487,194
2021-03-28,Yuba,115,75493,5720,5662,103,5765,42
2021-03-27,Alameda,001,1643700,83638,83169,1756,84925,1211
2021-03-27,Alpine,003,1148,85,85,0,85,0
2021-03-27,Amador,005,37829,3560,3538,31,3569,45
2021-03-27,Butte,007,227075,11674,11278,1650,12928,191
2021-03-27,Calaveras,009,45235,1999,1992,11,2003,50
2021-03-27,Colusa,011,21464,1890,1889,271,2160,14
2021-03-27,Contra Costa,013,1133247,65680,64804,1116,65920,767
2021-03-27,Del Norte,015,27424,1176,1104,7,1111,6
2021-03-27,El Dorado,017,186661,9437,9367,620,9987,105
2021-03-27,Fresno,019,978130,99713,98901,8139,107040,1606
2021-03-27,Glenn,021,27897,2343,2308,522,2830,17
2021-03-27,Humboldt,023,135768,3450,3442,24,3466,34
2021-03-27,Imperial,025,180216,27597,27406,2528,29934,704
2021-03-27,Inyo,027,18085,1374,1372,9,1381,35
2021-03-27,Kern,029,883053,95352,94041,10151,104192,1217
2021-03-27,Kings,031,150075,22781,22502,1007,23509,238
2021-03-27,Lake,033,64148,3348,3317,8,3325,43
2021-03-27,Lassen,035,31185,5143,5129,100,5229,1
2021-03-27,Los Angeles,037,10098052,1188536,1178831,39437,1218268,23103
2021-03-27,Madera,039,155013,16113,15968,873,16841,210
2021-03-27,Marin,041,260295,13656,13579,199,13778,222
2021-03-27,Mariposa,043,17540,393,386,5,391,5
2021-03-27,Mendocino,045,87422,3751,3666,74,3740,45
2021-03-27,Merced,047,269075,29729,29647,973,30620,422
2021-03-27,Modoc,049,8938,352,344,118,462,3
2021-03-27,Mono,051,14174,1231,1241,16,1257,3
2021-03-27,Monterey,053,433212,42505,42271,1737,44008,337
2021-03-27,Napa,055,140530,9409,9360,32,9392,78
2021-03-27,Nevada,057,99092,4325,4231,178,4409,68
2021-03-27,Orange,059,3164182,250975,249160,10626,259786,4698
2021-03-27,Placer,061,380077,21544,20717,1223,21940,267
2021-03-27,Plumas,063,18699,669,655,10,665,4
2021-03-27,Riverside,065,2383286,289299,282707,13503,296210,4132
2021-03-27,Sacramento,067,1510023,98724,97247,1384,98631,1513
2021-03-27,San Benito,069,59416,5853,5862,91,5953,61
2021-03-27,San Bernardino,071,2135413,289012,285480,8671,294151,4325
2021-03-27,San Diego,073,3302833,270678,269271,13491,282762,3540
2021-03-27,San Francisco,075,870044,35219,35244,1172,36416,474
2021-03-27,San Joaquin,077,732212,69588,68365,3077,71442,1211
2021-03-27,San Luis Obispo,079,281455,20454,20153,611,20764,250
2021-03-27,San Mateo,081,765935,40704,40264,426,40690,348
2021-03-27,Santa Barbara,083,443738,33327,32921,1071,33992,439
2021-03-27,Santa Clara,085,1922200,114012,114124,636,114760,1871
2021-03-27,Santa Cruz,087,273765,15832,15215,785,16000,201
2021-03-27,Shasta,089,179085,11287,11288,1335,12623,183
2021-03-27,Sierra,091,2930,55,50,12,62,0
2021-03-27,Siskiyou,093,43540,1570,1497,253,1750,6
2021-03-27,Solano,095,438530,30831,30669,404,31073,232
2021-03-27,Sonoma,097,501317,29032,29133,264,29397,310
2021-03-27,Stanislaus,099,539301,52990,52497,5511,58008,678
2021-03-27,Sutter,101,95872,9092,9093,79,9172,106
2021-03-27,Tehama,103,63373,4766,4738,502,5240,52
2021-03-27,Trinity,105,12862,476,313,80,393,3
2021-03-27,Tulare,107,460477,49231,48203,8424,56627,813
2021-03-27,Tuolumne,109,53932,3911,3968,38,4006,57
2021-03-27,Ventura,111,848112,79808,79184,2839,82023,956
2021-03-27,Yolo,113,214977,13324,13317,161,13478,194
2021-03-27,Yuba,115,75493,5718,5657,103,5760,42
2021-03-26,Alameda,001,1643700,83576,83043,1754,84797,1208
2021-03-26,Alpine,003,1148,85,85,0,85,0
2021-03-26,Amador,005,37829,3555,3532,31,3563,45
2021-03-26,Butte,007,227075,11663,11278,1650,12928,191
2021-03-26,Calaveras,009,45235,1996,1989,11,2000,50
2021-03-26,Colusa,011,21464,1890,1889,271,2160,14
2021-03-26,Contra Costa,013,1133247,65620,64699,1113,65812,761
2021-03-26,Del Norte,015,27424,1173,1101,7,1108,6
2021-03-26,El Dorado,017,186661,9432,9353,620,9973,105
2021-03-26,Fresno,019,978130,99651,98731,8129,106860,1601
2021-03-26,Glenn,021,27897,2343,2307,521,2828,17
2021-03-26,Humboldt,023,135768,3448,3431,24,3455,34
2021-03-26,Imperial,025,180216,27573,27374,2528,29902,701
2021-03-26,Inyo,027,18085,1373,1369,9,1378,35
2021-03-26,Kern,029,883053,95326,93949,10145,104094,1211
2021-03-26,Kings,031,150075,22773,22493,1005,23498,239
2021-03-26,Lake,033,64148,3347,3314,8,3322,43
2021-03-26,Lassen,035,31185,5142,5131,100,5231,1
2021-03-26,Los Angeles,037,10098052,1188200,1178213,39424,1217637,23080
2021-03-26,Madera,039,155013,16103,15952,873,16825,210
2021-03-26,Marin,041,260295,13650,13553,194,13747,221
2021-03-26,Mariposa,043,17540,393,386,5,391,5
2021-03-26,Mendocino,045,87422,3750,3664,74,3738,45
2021-03-26,Merced,047,269075,29706,29613,972,30585,419
2021-03-26,Modoc,049,8938,352,344,118,462,3
2021-03-26,Mono,051,14174,1230,1236,16,1252,3
2021-03-26,Monterey,053,433212,42492,42241,1733,43974,338
2021-03-26,Napa,055,140530,9399,9349,32,9381,78
2021-03-26,Nevada,057,99092,4305,4222,178,4400,83
2021-03-26,Orange,059,3164182,250912,248995,10612,259607,4671
2021-03-26,Placer,061,380077,21518,20679,1222,21901,259
2021-03-26,Plumas,063,18699,668,654,10,664,4
2021-03-26,Riverside,065,2383286,289221,282602,13497,296099,4109
2021-03-26,Sacramento,067,1510023,98624,97040,1379,98419,1509
2021-03-26,San Benito,069,59416,5850,5855,91,5946,61
2021-03-26,San Bernardino,071,2135413,288956,285313,8669,293982,4288
2021-03-26,San Diego,073,3302833,270500,269045,13465,282510,3525
2021-03-26,San Francisco,075,870044,35193,35186,1172,36358,472
2021-03-26,San Joaquin,077,732212,69525,68249,3073,71322,1202
2021-03-26,San Luis Obispo,079,281455,20441,20118,611,20729,250
2021-03-26,San Mateo,081,765935,40669,40199,426,40625,348
2021-03-26,Santa Barbara,083,443738,33297,32895,1070,33965,439
2021-03-26,Santa Clara,085,1922200,113914,113959,635,114594,1868
2021-03-26,Santa Cruz,087,273765,15817,15199,784,15983,201
2021-03-26,Shasta,089,179085,11278,11276,1329,12605,182
2021-03-26,Sierra,091,2930,55,50,12,62,0
2021-03-26,Siskiyou,093,43540,1570,1493,252,1745,6
2021-03-26,Solano,095,438530,30806,30640,404,31044,205
2021-03-26,Sonoma,097,501317,29016,29101,261,29362,310
2021-03-26,Stanislaus,099,539301,52922,52420,5507,57927,678
2021-03-26,Sutter,101,95872,9089,9082,79,9161,104
2021-03-26,Tehama,103,63373,4765,4722,501,5223,51
2021-03-26,Trinity,105,12862,476,311,80,391,3
2021-03-26,Tulare,107,460477,49216,48179,8417,56596,813
2021-03-26,Tuolumne,109,53932,3910,3965,38,4003,57
2021-03-26,Ventura,111,848112,79774,79122,2837,81959,953
2021-03-26,Yolo,113,214977,13317,13299,159,13458,194
2021-03-26,Yuba,115,75493,5708,5653,103,5756,42
2021-03-25,Alameda,001,1643700,83482,82945,1752,84697,1206
2021-03-25,Alpine,003,1148,85,84,0,84,0
2021-03-25,Amador,005,37829,3553,3530,31,3561,45
2021-03-25,Butte,007,227075,11653,11270,1650,12920,188
2021-03-25,Calaveras,009,45235,1995,1982,11,1993,50
2021-03-25,Colusa,011,21464,1890,1888,271,2159,14
2021-03-25,Contra Costa,013,1133247,65553,64606,1110,65716,757
2021-03-25,Del Norte,015,27424,1167,1095,7,1102,6
2021-03-25,El Dorado,017,186661,9422,9331,620,9951,105
2021-03-25,Fresno,019,978130,99533,98602,8116,106718,1593
2021-03-25,Glenn,021,27897,2342,2302,520,2822,17
2021-03-25,Humboldt,023,135768,3443,3423,24,3447,34
2021-03-25,Imperial,025,180216,27557,27352,2527,29879,699
2021-03-25,Inyo,027,18085,1373,1369,9,1378,35
2021-03-25,Kern,029,883053,95294,93857,10140,103997,1206
2021-03-25,Kings,031,150075,22763,22472,1005,23477,237
2021-03-25,Lake,033,64148,3342,3312,8,3320,43
2021-03-25,Lassen,035,31185,5142,5129,100,5229,1
2021-03-25,Los Angeles,037,10098052,1187764,1177490,39389,1216879,23051
2021-03-25,Madera,039,155013,16084,15937,871,16808,210
2021-03-25,Marin,041,260295,13640,13538,191,13729,219
2021-03-25,Mariposa,043,17540,393,386,5,391,5
2021-03-25,Mendocino,045,87422,3749,3664,74,3738,45
2021-03-25,Merced,047,269075,29672,29576,965,30541,416
2021-03-25,Modoc,049,8938,352,343,118,461,3
2021-03-25,Mono,051,14174,1230,1235,16,1251,3
2021-03-25,Monterey,053,433212,42471,42220,1728,43948,336
2021-03-25,Napa,055,140530,9380,9321,32,9353,78
2021-03-25,Nevada,057,99092,4287,4202,176,4378,84
2021-03-25,Orange,059,3164182,250796,248871,10592,259463,4655
2021-03-25,Placer,061,380077,21477,20639,1215,21854,252
2021-03-25,Plumas,063,18699,668,654,10,664,4
2021-03-25,Riverside,065,2383286,289124,282492,13486,295978,4078
2021-03-25,Sacramento,067,1510023,98479,96823,1377,98200,1505
2021-03-25,San Benito,069,59416,5847,5850,91,5941,61
2021-03-25,San Bernardino,071,2135413,288874,285134,8664,293798,4222
2021-03-25,San Diego,073,3302833,270272,268623,13434,282057,3520
2021-03-25,San Francisco,075,870044,35153,35154,1170,36324,468
2021-03-25,San Joaquin,077,732212,69428,68089,3035,71124,1196
2021-03-25,San Luis Obispo,079,281455,20423,20076,611,20687,250
2021-03-25,San Mateo,081,765935,40629,40147,426,40573,348
2021-03-25,Santa Barbara,083,443738,33270,32857,1070,33927,439
2021-03-25,Santa Clara,085,1922200,113810,113877,633,114510,1868
2021-03-25,Santa Cruz,087,273765,15796,15170,784,15954,201
2021-03-25,Shasta,089,179085,11261,11262,1326,12588,181
2021-03-25,Sierra,091,2930,55,50,12,62,0
2021-03-25,Siskiyou,093,43540,1568,1491,251,1742,6
2021-03-25,Solano,095,438530,30745,30583,402,30985,193
2021-03-25,Sonoma,097,501317,28982,29060,257,29317,310
2021-03-25,Stanislaus,099,539301,52855,52321,5500,57821,678
2021-03-25,Sutter,101,95872,9080,9069,79,9148,104
2021-03-25,Tehama,103,63373,4763,4719,500,5219,52
2021-03-25,Trinity,105,12862,476,310,80,390,3
2021-03-25,Tulare,107,460477,49189,48148,8405,56553,811
2021-03-25,Tuolumne,109,53932,3909,3962,38,4000,57
2021-03-25,Ventura,111,848112,79733,79045,2833,81878,952
2021-03-25,Yolo,113,214977,13311,13287,159,13446,194
2021-03-25,Yuba,115,75493,5702,5647,97,5744,42
2021-03-24,Alameda,001,1643700,83388,82871,1749,84620,1199
2021-03-24,Alpine,003,1148,85,84,0,84,0
2021-03-24,Amador,005,37829,3547,3529,31,3560,45
2021-03-24,Butte,007,227075,11643,11252,1646,12898,187
2021-03-24,Calaveras,009,45235,1992,1975,11,1986,50
2021-03-24,Colusa,011,21464,1890,1886,271,2157,14
2021-03-24,Contra Costa,013,1133247,65473,64539,1109,65648,755
2021-03-24,Del Norte,015,27424,1162,1087,7,1094,6
2021-03-24,El Dorado,017,186661,9416,9319,619,9938,105
2021-03-24,Fresno,019,978130,99443,98437,8101,106538,1585
2021-03-24,Glenn,021,27897,2341,2297,519,2816,17
2021-03-24,Humboldt,023,135768,3440,3414,24,3438,34
2021-03-24,Imperial,025,180216,27548,27325,2527,29852,699
2021-03-24,Inyo,027,18085,1373,1368,9,1377,35
2021-03-24,Kern,029,883053,95246,93800,10131,103931,1198
2021-03-24,Kings,031,150075,22748,22456,1003,23459,237
2021-03-24,Lake,033,64148,3338,3307,8,3315,43
2021-03-24,Lassen,035,31185,5140,5130,99,5229,1
2021-03-24,Los Angeles,037,10098052,1187278,1177015,39356,1216371,22993
2021-03-24,Madera,039,155013,16075,15918,870,16788,210
2021-03-24,Marin,041,260295,13626,13526,189,13715,219
2021-03-24,Mariposa,043,17540,393,384,5,389,5
2021-03-24,Mendocino,045,87422,3746,3660,74,3734,45
2021-03-24,Merced,047,269075,29631,29525,965,30490,415
2021-03-24,Modoc,049,8938,351,341,118,459,3
2021-03-24,Mono,051,14174,1229,1243,16,1259,3
2021-03-24,Monterey,053,433212,42449,42201,1725,43926,335
2021-03-24,Napa,055,140530,9360,9310,32,9342,78
2021-03-24,Nevada,057,99092,4272,4191,175,4366,85
2021-03-24,Orange,059,3164182,250682,248775,10574,259349,4638
2021-03-24,Placer,061,380077,21447,20606,1207,21813,250
2021-03-24,Plumas,063,18699,666,652,10,662,4
2021-03-24,Riverside,065,2383286,289040,282410,13483,295893,4058
2021-03-24,Sacramento,067,1510023,98304,96628,1366,97994,1500
2021-03-24,San Benito,069,59416,5846,5847,91,5938,61
2021-03-24,San Bernardino,071,2135413,288787,284983,8662,293645,4170
2021-03-24,San Diego,073,3302833,270058,268413,13406,281819,3509
2021-03-24,San Francisco,075,870044,35126,35103,1167,36270,462
2021-03-24,San Joaquin,077,732212,69357,67978,3023,71001,1196
2021-03-24,San Luis Obispo,079,281455,20393,20021,610,20631,250
2021-03-24,San Mateo,081,765935,40579,40083,426,40509,348
2021-03-24,Santa Barbara,083,443738,33242,32810,1070,33880,438
2021-03-24,Santa Clara,085,1922200,113694,113757,630,114387,1851
2021-03-24,Santa Cruz,087,273765,15782,15138,783,15921,202
2021-03-24,Shasta,089,179085,11242,11243,1324,12567,181
2021-03-24,Sierra,091,2930,55,50,12,62,0
2021-03-24,Siskiyou,093,43540,1566,1490,251,1741,6
2021-03-24,Solano,095,438530,30708,30552,401,30953,178
2021-03-24,Sonoma,097,501317,28962,29034,253,29287,310
2021-03-24,Stanislaus,099,539301,52779,52259,5491,57750,677
2021-03-24,Sutter,101,95872,9064,9049,79,9128,104
2021-03-24,Tehama,103,63373,4757,4719,499,5218,49
2021-03-24,Trinity,105,12862,475,310,80,390,3
2021-03-24,Tulare,107,460477,49178,48109,8392,56501,808
2021-03-24,Tuolumne,109,53932,3907,3961,38,3999,57
2021-03-24,Ventura,111,848112,79681,78993,2826,81819,944
2021-03-24,Yolo,113,214977,13299,13269,159,13428,194
2021-03-24,Yuba,115,75493,5696,5634,94,5728,42
2021-03-23,Alameda,001,1643700,83286,82799,1745,84544,1190
2021-03-23,Alpine,003,1148,85,84,0,84,0
2021-03-23,Amador,005,37829,3541,3524,31,3555,45
2021-03-23,Butte,007,227075,11631,11227,1645,12872,187
2021-03-23,Calaveras,009,45235,1990,1971,11,1982,50
2021-03-23,Colusa,011,21464,1888,1885,270,2155,14
2021-03-23,Contra Costa,013,1133247,65373,64491,1108,65599,750
2021-03-23,Del Norte,015,27424,1157,1082,7,1089,6
2021-03-23,El Dorado,017,186661,9406,9318,616,9934,105
2021-03-23,Fresno,019,978130,99329,98362,8077,106439,1575
2021-03-23,Glenn,021,27897,2336,2293,517,2810,17
2021-03-23,Humboldt,023,135768,3431,3405,24,3429,34
2021-03-23,Imperial,025,180216,27540,27320,2527,29847,699
2021-03-23,Inyo,027,18085,1371,1364,9,1373,35
2021-03-23,Kern,029,883053,95139,93728,10124,103852,1191
2021-03-23,Kings,031,150075,22737,22439,1001,23440,237
2021-03-23,Lake,033,64148,3336,3294,8,3302,43
2021-03-23,Lassen,035,31185,5140,5130,99,5229,1
2021-03-23,Los Angeles,037,10098052,1186757,1176572,39319,1215891,22904
2021-03-23,Madera,039,155013,16059,15908,869,16777,210
2021-03-23,Marin,041,260295,13603,13514,187,13701,221
2021-03-23,Mariposa,043,17540,392,384,5,389,5
2021-03-23,Mendocino,045,87422,3744,3652,74,3726,45
2021-03-23,Merced,047,269075,29598,29485,965,30450,415
2021-03-23,Modoc,049,8938,350,342,118,460,3
2021-03-23,Mono,051,14174,1228,1263,16,1279,3
2021-03-23,Monterey,053,433212,42438,42180,1723,43903,335
2021-03-23,Napa,055,140530,9335,9299,32,9331,78
2021-03-23,Nevada,057,99092,4253,4179,174,4353,89
2021-03-23,Orange,059,3164182,250556,248661,10556,259217,4626
2021-03-23,Placer,061,380077,21412,20567,1203,21770,248
2021-03-23,Plumas,063,18699,666,652,10,662,4
2021-03-23,Riverside,065,2383286,288940,282317,13477,295794,4035
2021-03-23,Sacramento,067,1510023,98112,96521,1362,97883,1496
2021-03-23,San Benito,069,59416,5841,5845,90,5935,61
2021-03-23,San Bernardino,071,2135413,288702,284875,8654,293529,4134
2021-03-23,San Diego,073,3302833,269813,268156,13374,281530,3498
2021-03-23,San Francisco,075,870044,35068,35071,1162,36233,462
2021-03-23,San Joaquin,077,732212,69261,67903,3005,70908,1182
2021-03-23,San Luis Obispo,079,281455,20353,20009,609,20618,250
2021-03-23,San Mateo,081,765935,40523,40032,425,40457,348
2021-03-23,Santa Barbara,083,443738,33204,32771,1069,33840,438
2021-03-23,Santa Clara,085,1922200,113578,113645,627,114272,1848
2021-03-23,Santa Cruz,087,273765,15767,15106,783,15889,201
2021-03-23,Shasta,089,179085,11229,11234,1323,12557,175
2021-03-23,Sierra,091,2930,55,50,12,62,0
2021-03-23,Siskiyou,093,43540,1561,1485,249,1734,6
2021-03-23,Solano,095,438530,30667,30524,400,30924,178
2021-03-23,Sonoma,097,501317,28925,29020,252,29272,310
2021-03-23,Stanislaus,099,539301,52680,52148,5484,57632,677
2021-03-23,Sutter,101,95872,9056,9039,79,9118,104
2021-03-23,Tehama,103,63373,4748,4707,498,5205,46
2021-03-23,Trinity,105,12862,475,310,80,390,3
2021-03-23,Tulare,107,460477,49151,48095,8376,56471,808
2021-03-23,Tuolumne,109,53932,3904,3957,38,3995,57
2021-03-23,Ventura,111,848112,79620,78930,2823,81753,932
2021-03-23,Yolo,113,214977,13288,13255,159,13414,194
2021-03-23,Yuba,115,75493,5691,5628,94,5722,42
2021-03-22,Alameda,001,1643700,83195,82748,1739,84487,1189
2021-03-22,Alpine,003,1148,84,83,0,83,0
2021-03-22,Amador,005,37829,3533,3522,31,3553,44
2021-03-22,Butte,007,227075,11622,11211,1643,12854,185
2021-03-22,Calaveras,009,45235,1986,1963,11,1974,49
2021-03-22,Colusa,011,21464,1886,1885,270,2155,13
2021-03-22,Contra Costa,013,1133247,65278,64432,1106,65538,740
2021-03-22,Del Norte,015,27424,1151,1082,7,1089,6
2021-03-22,El Dorado,017,186661,9390,9310,612,9922,105
2021-03-22,Fresno,019,978130,99231,98276,8065,106341,1556
2021-03-22,Glenn,021,27897,2328,2291,517,2808,17
2021-03-22,Humboldt,023,135768,3426,3403,24,3427,34
2021-03-22,Imperial,025,180216,27525,27302,2524,29826,699
2021-03-22,Inyo,027,18085,1368,1363,9,1372,35
2021-03-22,Kern,029,883053,95068,93675,10108,103783,1178
2021-03-22,Kings,031,150075,22724,22433,996,23429,236
2021-03-22,Lake,033,64148,3335,3290,8,3298,43
2021-03-22,Lassen,035,31185,5138,5129,99,5228,1
2021-03-22,Los Angeles,037,10098052,1186240,1176205,39289,1215494,22843
2021-03-22,Madera,039,155013,16044,15904,869,16773,210
2021-03-22,Marin,041,260295,13594,13501,186,13687,221
2021-03-22,Mariposa,043,17540,391,381,5,386,5
2021-03-22,Mendocino,045,87422,3742,3653,74,3727,45
2021-03-22,Merced,047,269075,29555,29468,962,30430,413
2021-03-22,Modoc,049,8938,348,342,118,460,3
2021-03-22,Mono,051,14174,1223,1263,16,1279,3
2021-03-22,Monterey,053,433212,42422,42161,1721,43882,335
2021-03-22,Napa,055,140530,9324,9288,32,9320,77
2021-03-22,Nevada,057,99092,4243,4174,170,4344,89
2021-03-22,Orange,059,3164182,250405,248517,10522,259039,4599
2021-03-22,Placer,061,380077,21377,20543,1198,21741,242
2021-03-22,Plumas,063,18699,666,652,10,662,4
2021-03-22,Riverside,065,2383286,288840,282242,13466,295708,4009
2021-03-22,Sacramento,067,1510023,97934,96385,1352,97737,1493
2021-03-22,San Benito,069,59416,5838,5844,89,5933,61
2021-03-22,San Bernardino,071,2135413,288614,284771,8642,293413,4107
2021-03-22,San Diego,073,3302833,269601,267913,13354,281267,3494
2021-03-22,San Francisco,075,870044,35026,35040,1158,36198,462
2021-03-22,San Joaquin,077,732212,69169,67815,2988,70803,1182
2021-03-22,San Luis Obispo,079,281455,20329,20000,608,20608,250
2021-03-22,San Mateo,081,765935,40472,40024,424,40448,348
2021-03-22,Santa Barbara,083,443738,33159,32756,1067,33823,437
2021-03-22,Santa Clara,085,1922200,113458,113575,627,114202,1845
2021-03-22,Santa Cruz,087,273765,15755,15077,782,15859,201
2021-03-22,Shasta,089,179085,11215,11218,1322,12540,150
2021-03-22,Sierra,091,2930,55,50,12,62,0
2021-03-22,Siskiyou,093,43540,1560,1487,248,1735,5
2021-03-22,Solano,095,438530,30627,30490,396,30886,171
2021-03-22,Sonoma,097,501317,28896,29010,248,29258,310
2021-03-22,Stanislaus,099,539301,52596,52083,5479,57562,677
2021-03-22,Sutter,101,95872,9043,9024,79,9103,104
2021-03-22,Tehama,103,63373,4740,4704,498,5202,45
2021-03-22,Trinity,105,12862,475,310,80,390,3
2021-03-22,Tulare,107,460477,49136,48074,8356,56430,807
2021-03-22,Tuolumne,109,53932,3901,3954,38,3992,57
2021-03-22,Ventura,111,848112,79574,78890,2820,81710,927
2021-03-22,Yolo,113,214977,13276,13243,158,13401,190
2021-03-22,Yuba,115,75493,5680,5627,92,5719,42
2021-03-21,Alameda,001,1643700,83108,82684,1736,84420,1187
2021-03-21,Alpine,003,1148,84,83,0,83,0
2021-03-21,Amador,005,37829,3529,3519,31,3550,44
2021-03-21,Butte,007,227075,11606,11208,1638,12846,185
2021-03-21,Calaveras,009,45235,1980,1962,11,1973,49
2021-03-21,Colusa,011,21464,1886,1885,270,2155,13
2021-03-21,Contra Costa,013,1133247,65196,64382,1102,65484,740
2021-03-21,Del Norte,015,27424,1136,1076,7,1083,6
2021-03-21,El Dorado,017,186661,9380,9302,607,9909,105
2021-03-21,Fresno,019,978130,99117,98211,8042,106253,1556
2021-03-21,Glenn,021,27897,2325,2288,516,2804,17
2021-03-21,Humboldt,023,135768,3421,3402,24,3426,34
2021-03-21,Imperial,025,180216,27508,27267,2519,29786,699
2021-03-21,Inyo,027,18085,1368,1363,9,1372,35
2021-03-21,Kern,029,883053,95002,93649,10099,103748,1170
2021-03-21,Kings,031,150075,22707,22422,996,23418,236
2021-03-21,Lake,033,64148,3331,3286,8,3294,43
2021-03-21,Lassen,035,31185,5138,5129,99,5228,1
2021-03-21,Los Angeles,037,10098052,1185704,1175684,39242,1214926,22834
2021-03-21,Madera,039,155013,16024,15895,867,16762,210
2021-03-21,Marin,041,260295,13578,13495,185,13680,220
2021-03-21,Mariposa,043,17540,391,381,5,386,5
2021-03-21,Mendocino,045,87422,3739,3651,74,3725,45
2021-03-21,Merced,047,269075,29495,29446,956,30402,413
2021-03-21,Modoc,049,8938,348,341,118,459,3
2021-03-21,Mono,051,14174,1218,1263,16,1279,3
2021-03-21,Monterey,053,433212,42397,42153,1718,43871,335
2021-03-21,Napa,055,140530,9304,9282,32,9314,77
2021-03-21,Nevada,057,99092,4230,4169,170,4339,89
2021-03-21,Orange,059,3164182,250272,248442,10495,258937,4598
2021-03-21,Placer,061,380077,21341,20520,1190,21710,242
2021-03-21,Plumas,063,18699,666,653,10,663,4
2021-03-21,Riverside,065,2383286,288733,282187,13455,295642,4009
2021-03-21,Sacramento,067,1510023,97740,96269,1345,97614,1489
2021-03-21,San Benito,069,59416,5832,5842,89,5931,61
2021-03-21,San Bernardino,071,2135413,288524,284732,8636,293368,4094
2021-03-21,San Diego,073,3302833,269341,267724,13328,281052,3494
2021-03-21,San Francisco,075,870044,34979,35012,1152,36164,460
2021-03-21,San Joaquin,077,732212,69047,67729,2970,70699,1182
2021-03-21,San Luis Obispo,079,281455,20297,19979,606,20585,250
2021-03-21,San Mateo,081,765935,40427,39988,423,40411,344
2021-03-21,Santa Barbara,083,443738,33120,32743,1066,33809,437
2021-03-21,Santa Clara,085,1922200,113328,113487,624,114111,1840
2021-03-21,Santa Cruz,087,273765,15748,15064,782,15846,199
2021-03-21,Shasta,089,179085,11195,11215,1321,12536,150
2021-03-21,Sierra,091,2930,55,50,12,62,0
2021-03-21,Siskiyou,093,43540,1560,1486,247,1733,5
2021-03-21,Solano,095,438530,30587,30474,393,30867,171
2021-03-21,Sonoma,097,501317,28867,28986,247,29233,310
2021-03-21,Stanislaus,099,539301,52506,52014,5477,57491,677
2021-03-21,Sutter,101,95872,9030,9021,79,9100,104
2021-03-21,Tehama,103,63373,4736,4701,498,5199,45
2021-03-21,Trinity,105,12862,473,310,80,390,3
2021-03-21,Tulare,107,460477,49120,48060,8344,56404,807
2021-03-21,Tuolumne,109,53932,3899,3953,38,3991,57
2021-03-21,Ventura,111,848112,79511,78863,2815,81678,927
2021-03-21,Yolo,113,214977,13254,13235,158,13393,190
2021-03-21,Yuba,115,75493,5670,5624,92,5716,42
2021-03-20,Alameda,001,1643700,83040,82614,1734,84348,1178
2021-03-20,Alpine,003,1148,84,83,0,83,0
2021-03-20,Amador,005,37829,3527,3518,31,3549,44
2021-03-20,Butte,007,227075,11600,11199,1636,12835,185
2021-03-20,Calaveras,009,45235,1976,1961,11,1972,49
2021-03-20,Colusa,011,21464,1886,1883,270,2153,12
2021-03-20,Contra Costa,013,1133247,65136,64313,1102,65415,713
2021-03-20,Del Norte,015,27424,1135,1075,7,1082,6
2021-03-20,El Dorado,017,186661,9374,9290,607,9897,105
2021-03-20,Fresno,019,978130,99057,98112,8035,106147,1532
2021-03-20,Glenn,021,27897,2324,2288,514,2802,17
2021-03-20,Humboldt,023,135768,3414,3399,24,3423,33
2021-03-20,Imperial,025,180216,27502,27239,2517,29756,695
2021-03-20,Inyo,027,18085,1368,1362,9,1371,35
2021-03-20,Kern,029,883053,94973,93606,10095,103701,1155
2021-03-20,Kings,031,150075,22702,22415,995,23410,236
2021-03-20,Lake,033,64148,3327,3280,8,3288,43
2021-03-20,Lassen,035,31185,5138,5128,99,5227,1
2021-03-20,Los Angeles,037,10098052,1185405,1175290,39218,1214508,22810
2021-03-20,Madera,039,155013,16016,15891,866,16757,210
2021-03-20,Marin,041,260295,13566,13470,181,13651,220
2021-03-20,Mariposa,043,17540,390,381,5,386,5
2021-03-20,Mendocino,045,87422,3738,3639,74,3713,43
2021-03-20,Merced,047,269075,29464,29411,953,30364,412
2021-03-20,Modoc,049,8938,347,341,118,459,3
2021-03-20,Mono,051,14174,1218,1256,16,1272,3
2021-03-20,Monterey,053,433212,42388,42146,1717,43863,334
2021-03-20,Napa,055,140530,9296,9274,32,9306,77
2021-03-20,Nevada,057,99092,4219,4164,169,4333,89
2021-03-20,Orange,059,3164182,250191,248348,10484,258832,4522
2021-03-20,Placer,061,380077,21318,20505,1188,21693,242
2021-03-20,Plumas,063,18699,663,652,10,662,4
2021-03-20,Riverside,065,2383286,288658,282081,13451,295532,4000
2021-03-20,Sacramento,067,1510023,97629,96126,1342,97468,1488
2021-03-20,San Benito,069,59416,5828,5840,89,5929,61
2021-03-20,San Bernardino,071,2135413,288458,284690,8632,293322,3965
2021-03-20,San Diego,073,3302833,269170,267532,13321,280853,3493
2021-03-20,San Francisco,075,870044,34956,34968,1145,36113,453
2021-03-20,San Joaquin,077,732212,69006,67662,2963,70625,1161
2021-03-20,San Luis Obispo,079,281455,20281,19951,600,20551,250
2021-03-20,San Mateo,081,765935,40393,39958,422,40380,344
2021-03-20,Santa Barbara,083,443738,33095,32723,1065,33788,434
2021-03-20,Santa Clara,085,1922200,113236,113384,623,114007,1799
2021-03-20,Santa Cruz,087,273765,15732,15053,782,15835,199
2021-03-20,Shasta,089,179085,11189,11211,1321,12532,147
2021-03-20,Sierra,091,2930,55,50,12,62,0
2021-03-20,Siskiyou,093,43540,1560,1483,247,1730,5
2021-03-20,Solano,095,438530,30557,30439,393,30832,170
2021-03-20,Sonoma,097,501317,28852,28962,247,29209,309
2021-03-20,Stanislaus,099,539301,52450,51925,5470,57395,673
2021-03-20,Sutter,101,95872,9022,9014,79,9093,103
2021-03-20,Tehama,103,63373,4731,4696,496,5192,33
2021-03-20,Trinity,105,12862,472,310,80,390,3
2021-03-20,Tulare,107,460477,49105,48030,8327,56357,804
2021-03-20,Tuolumne,109,53932,3896,3950,38,3988,57
2021-03-20,Ventura,111,848112,79476,78818,2813,81631,922
2021-03-20,Yolo,113,214977,13250,13226,158,13384,190
2021-03-20,Yuba,115,75493,5667,5621,91,5712,42
2021-03-19,Alameda,001,1643700,82968,82499,1733,84232,1187
2021-03-19,Alpine,003,1148,83,82,0,82,0
2021-03-19,Amador,005,37829,3524,3515,31,3546,44
2021-03-19,Butte,007,227075,11592,11191,1633,12824,185
2021-03-19,Calaveras,009,45235,1975,1957,11,1968,49
2021-03-19,Colusa,011,21464,1885,1883,270,2153,12
2021-03-19,Contra Costa,013,1133247,65077,64195,1099,65294,737
2021-03-19,Del Norte,015,27424,1129,1071,5,1076,6
2021-03-19,El Dorado,017,186661,9365,9274,607,9881,105
2021-03-19,Fresno,019,978130,98973,97969,8022,105991,1527
2021-03-19,Glenn,021,27897,2324,2282,514,2796,17
2021-03-19,Humboldt,023,135768,3405,3388,24,3412,33
2021-03-19,Imperial,025,180216,27490,27218,2514,29732,695
2021-03-19,Inyo,027,18085,1366,1356,9,1365,35
2021-03-19,Kern,029,883053,94940,93534,10082,103616,1152
2021-03-19,Kings,031,150075,22693,22369,992,23361,235
2021-03-19,Lake,033,64148,3321,3262,8,3270,43
2021-03-19,Lassen,035,31185,5138,5126,99,5225,1
2021-03-19,Los Angeles,037,10098052,1185065,1174818,39201,1214019,22752
2021-03-19,Madera,039,155013,16009,15877,865,16742,210
2021-03-19,Marin,041,260295,13554,13441,181,13622,220
2021-03-19,Mariposa,043,17540,389,380,5,385,5
2021-03-19,Mendocino,045,87422,3737,3639,74,3713,45
2021-03-19,Merced,047,269075,29437,29376,951,30327,412
2021-03-19,Modoc,049,8938,347,341,118,459,3
2021-03-19,Mono,051,14174,1216,1244,16,1260,3
2021-03-19,Monterey,053,433212,42379,42125,1715,43840,335
2021-03-19,Napa,055,140530,9284,9256,32,9288,77
2021-03-19,Nevada,057,99092,4208,4156,169,4325,88
2021-03-19,Orange,059,3164182,250091,248146,10475,258621,4501
2021-03-19,Placer,061,380077,21300,20451,1186,21637,242
2021-03-19,Plumas,063,18699,663,650,10,660,4
2021-03-19,Riverside,065,2383286,288575,281937,13446,295383,3989
2021-03-19,Sacramento,067,1510023,97526,95934,1339,97273,1486
2021-03-19,San Benito,069,59416,5828,5845,89,5934,61
2021-03-19,San Bernardino,071,2135413,288387,284501,8630,293131,4017
2021-03-19,San Diego,073,3302833,269035,267173,13311,280484,3491
2021-03-19,San Francisco,075,870044,34911,34936,1142,36078,461
2021-03-19,San Joaquin,077,732212,68936,67515,2949,70464,1180
2021-03-19,San Luis Obispo,079,281455,20261,19913,598,20511,249
2021-03-19,San Mateo,081,765935,40369,39893,422,40315,344
2021-03-19,Santa Barbara,083,443738,33065,32685,1064,33749,435
2021-03-19,Santa Clara,085,1922200,113161,113232,622,113854,1797
2021-03-19,Santa Cruz,087,273765,15725,15026,782,15808,199
2021-03-19,Shasta,089,179085,11182,11104,1319,12423,103
2021-03-19,Sierra,091,2930,54,49,12,61,0
2021-03-19,Siskiyou,093,43540,1560,1480,246,1726,5
2021-03-19,Solano,095,438530,30527,30395,391,30786,172
2021-03-19,Sonoma,097,501317,28831,28932,245,29177,292
2021-03-19,Stanislaus,099,539301,52392,51755,5467,57222,679
2021-03-19,Sutter,101,95872,9020,9005,79,9084,103
2021-03-19,Tehama,103,63373,4724,4685,496,5181,33
2021-03-19,Trinity,105,12862,472,310,80,390,3
2021-03-19,Tulare,107,460477,49082,47989,8304,56293,805
2021-03-19,Tuolumne,109,53932,3893,3946,38,3984,57
2021-03-19,Ventura,111,848112,79443,78753,2809,81562,920
2021-03-19,Yolo,113,214977,13242,13197,158,13355,189
2021-03-19,Yuba,115,75493,5664,5615,90,5705,42
2021-03-18,Alameda,001,1643700,82887,82419,1730,84149,1189
2021-03-18,Alpine,003,1148,83,82,0,82,0
2021-03-18,Amador,005,37829,3520,3513,31,3544,44
2021-03-18,Butte,007,227075,11581,11179,1631,12810,185
2021-03-18,Calaveras,009,45235,1973,1954,11,1965,49
2021-03-18,Colusa,011,21464,1885,1882,270,2152,12
2021-03-18,Contra Costa,013,1133247,65004,64103,1096,65199,739
2021-03-18,Del Norte,015,27424,1120,1059,5,1064,6
2021-03-18,El Dorado,017,186661,9352,9261,606,9867,105
2021-03-18,Fresno,019,978130,98876,97856,8007,105863,1527
2021-03-18,Glenn,021,27897,2320,2275,513,2788,17
2021-03-18,Humboldt,023,135768,3397,3381,24,3405,34
2021-03-18,Imperial,025,180216,27475,27190,2509,29699,695
2021-03-18,Inyo,027,18085,1363,1354,9,1363,35
2021-03-18,Kern,029,883053,94883,93458,10068,103526,1158
2021-03-18,Kings,031,150075,22686,22354,991,23345,235
2021-03-18,Lake,033,64148,3318,3260,8,3268,43
2021-03-18,Lassen,035,31185,5137,5126,99,5225,1
2021-03-18,Los Angeles,037,10098052,1184632,1174205,39172,1213377,22689
2021-03-18,Madera,039,155013,15997,15860,862,16722,211
2021-03-18,Marin,041,260295,13536,13435,180,13615,219
2021-03-18,Mariposa,043,17540,387,380,5,385,5
2021-03-18,Mendocino,045,87422,3727,3630,74,3704,45
2021-03-18,Merced,047,269075,29402,29317,951,30268,410
2021-03-18,Modoc,049,8938,347,341,118,459,3
2021-03-18,Mono,051,14174,1212,1215,15,1230,3
2021-03-18,Monterey,053,433212,42367,42105,1715,43820,335
2021-03-18,Napa,055,140530,9275,9243,32,9275,77
2021-03-18,Nevada,057,99092,4201,4154,169,4323,74
2021-03-18,Orange,059,3164182,249988,248050,10462,258512,4514
2021-03-18,Placer,061,380077,21268,20421,1183,21604,243
2021-03-18,Plumas,063,18699,661,648,10,658,4
2021-03-18,Riverside,065,2383286,288494,281789,13439,295228,3957
2021-03-18,Sacramento,067,1510023,97378,95819,1335,97154,1481
2021-03-18,San Benito,069,59416,5826,5842,89,5931,61
2021-03-18,San Bernardino,071,2135413,288304,284294,8600,292894,4076
2021-03-18,San Diego,073,3302833,268882,266752,13301,280053,3478
2021-03-18,San Francisco,075,870044,34872,34904,1141,36045,461
2021-03-18,San Joaquin,077,732212,68836,67301,2937,70238,1169
2021-03-18,San Luis Obispo,079,281455,20232,19894,597,20491,249
2021-03-18,San Mateo,081,765935,40328,39874,422,40296,344
2021-03-18,Santa Barbara,083,443738,33024,32640,1064,33704,434
2021-03-18,Santa Clara,085,1922200,113044,113119,618,113737,1808
2021-03-18,Santa Cruz,087,273765,15715,14998,782,15780,198
2021-03-18,Shasta,089,179085,11168,11059,1317,12376,100
2021-03-18,Sierra,091,2930,54,49,12,61,0
2021-03-18,Siskiyou,093,43540,1557,1480,245,1725,5
2021-03-18,Solano,095,438530,30485,30352,388,30740,172
2021-03-18,Sonoma,097,501317,28810,28915,243,29158,292
2021-03-18,Stanislaus,099,539301,52320,51615,5463,57078,682
2021-03-18,Sutter,101,95872,9008,8999,79,9078,103
2021-03-18,Tehama,103,63373,4718,4683,495,5178,35
2021-03-18,Trinity,105,12862,472,310,80,390,3
2021-03-18,Tulare,107,460477,49063,47964,8289,56253,805
2021-03-18,Tuolumne,109,53932,3892,3942,38,3980,57
2021-03-18,Ventura,111,848112,79383,78697,2809,81506,918
2021-03-18,Yolo,113,214977,13229,13183,158,13341,191
2021-03-18,Yuba,115,75493,5660,5612,90,5702,42
2021-03-17,Alameda,001,1643700,82811,82353,1725,84078,1185
2021-03-17,Alpine,003,1148,83,82,0,82,0
2021-03-17,Amador,005,37829,3518,3511,31,3542,44
2021-03-17,Butte,007,227075,11572,11170,1629,12799,185
2021-03-17,Calaveras,009,45235,1970,1946,11,1957,49
2021-03-17,Colusa,011,21464,1884,1882,270,2152,12
2021-03-17,Contra Costa,013,1133247,64935,64026,1095,65121,737
2021-03-17,Del Norte,015,27424,1116,1053,5,1058,6
2021-03-17,El Dorado,017,186661,9342,9252,606,9858,105
2021-03-17,Fresno,019,978130,98765,97727,7989,105716,1507
2021-03-17,Glenn,021,27897,2313,2269,512,2781,17
2021-03-17,Humboldt,023,135768,3389,3365,24,3389,33
2021-03-17,Imperial,025,180216,27458,27168,2506,29674,691
2021-03-17,Inyo,027,18085,1361,1351,9,1360,35
2021-03-17,Kern,029,883053,94827,93392,10055,103447,1149
2021-03-17,Kings,031,150075,22670,22336,990,23326,233
2021-03-17,Lake,033,64148,3311,3251,8,3259,43
2021-03-17,Lassen,035,31185,5136,5125,99,5224,1
2021-03-17,Los Angeles,037,10098052,1184178,1173416,39139,1212555,22602
2021-03-17,Madera,039,155013,15990,15835,862,16697,214
2021-03-17,Marin,041,260295,13519,13428,179,13607,218
2021-03-17,Mariposa,043,17540,387,379,5,384,5
2021-03-17,Mendocino,045,87422,3723,3625,74,3699,44
2021-03-17,Merced,047,269075,29374,29250,947,30197,408
2021-03-17,Modoc,049,8938,347,341,118,459,3
2021-03-17,Mono,051,14174,1210,1212,15,1227,3
2021-03-17,Monterey,053,433212,42349,42061,1712,43773,334
2021-03-17,Napa,055,140530,9260,9219,32,9251,76
2021-03-17,Nevada,057,99092,4191,4145,169,4314,74
2021-03-17,Orange,059,3164182,249869,247943,10434,258377,4502
2021-03-17,Placer,061,380077,21240,20369,1182,21551,243
2021-03-17,Plumas,063,18699,660,645,10,655,4
2021-03-17,Riverside,065,2383286,288379,281649,13431,295080,3925
2021-03-17,Sacramento,067,1510023,97250,95650,1330,96980,1477
2021-03-17,San Benito,069,59416,5823,5841,89,5930,61
2021-03-17,San Bernardino,071,2135413,288187,284170,8595,292765,4049
2021-03-17,San Diego,073,3302833,268671,266313,13283,279596,3470
2021-03-17,San Francisco,075,870044,34837,34873,1140,36013,457
2021-03-17,San Joaquin,077,732212,68751,67093,2921,70014,1164
2021-03-17,San Luis Obispo,079,281455,20209,19858,593,20451,249
2021-03-17,San Mateo,081,765935,40298,39838,421,40259,344
2021-03-17,Santa Barbara,083,443738,33002,32585,1063,33648,433
2021-03-17,Santa Clara,085,1922200,112951,112983,617,113600,1805
2021-03-17,Santa Cruz,087,273765,15707,14967,782,15749,199
2021-03-17,Shasta,089,179085,11163,11045,1314,12359,100
2021-03-17,Sierra,091,2930,54,49,12,61,0
2021-03-17,Siskiyou,093,43540,1556,1479,244,1723,5
2021-03-17,Solano,095,438530,30459,30320,386,30706,171
2021-03-17,Sonoma,097,501317,28786,28877,242,29119,292
2021-03-17,Stanislaus,099,539301,52245,51524,5456,56980,682
2021-03-17,Sutter,101,95872,8998,8982,79,9061,103
2021-03-17,Tehama,103,63373,4713,4670,495,5165,34
2021-03-17,Trinity,105,12862,472,308,80,388,3
2021-03-17,Tulare,107,460477,49043,47929,8279,56208,805
2021-03-17,Tuolumne,109,53932,3889,3938,38,3976,57
2021-03-17,Ventura,111,848112,79327,78648,2806,81454,916
2021-03-17,Yolo,113,214977,13212,13169,158,13327,190
2021-03-17,Yuba,115,75493,5657,5603,90,5693,42
2021-03-16,Alameda,001,1643700,82700,82259,1723,83982,1177
2021-03-16,Alpine,003,1148,83,82,0,82,0
2021-03-16,Amador,005,37829,3516,3510,31,3541,44
2021-03-16,Butte,007,227075,11560,11154,1628,12782,184
2021-03-16,Calaveras,009,45235,1965,1945,11,1956,49
2021-03-16,Colusa,011,21464,1883,1882,270,2152,12
2021-03-16,Contra Costa,013,1133247,64852,63951,1092,65043,736
2021-03-16,Del Norte,015,27424,1108,1048,5,1053,6
2021-03-16,El Dorado,017,186661,9327,9249,606,9855,105
2021-03-16,Fresno,019,978130,98627,97638,7969,105607,1498
2021-03-16,Glenn,021,27897,2305,2267,508,2775,17
2021-03-16,Humboldt,023,135768,3385,3351,24,3375,33
2021-03-16,Imperial,025,180216,27447,27143,2503,29646,689
2021-03-16,Inyo,027,18085,1360,1346,9,1355,35
2021-03-16,Kern,029,883053,94761,93340,10040,103380,1144
2021-03-16,Kings,031,150075,22634,22320,989,23309,233
2021-03-16,Lake,033,64148,3303,3246,8,3254,43
2021-03-16,Lassen,035,31185,5135,5126,99,5225,1
2021-03-16,Los Angeles,037,10098052,1183645,1172676,39101,1211777,22527
2021-03-16,Madera,039,155013,15974,15822,860,16682,214
2021-03-16,Marin,041,260295,13501,13419,179,13598,218
2021-03-16,Mariposa,043,17540,384,379,5,384,5
2021-03-16,Mendocino,045,87422,3718,3623,74,3697,44
2021-03-16,Merced,047,269075,29321,29198,946,30144,407
2021-03-16,Modoc,049,8938,347,341,118,459,3
2021-03-16,Mono,051,14174,1209,1207,15,1222,3
2021-03-16,Monterey,053,433212,42330,42023,1712,43735,334
2021-03-16,Napa,055,140530,9250,9209,32,9241,75
2021-03-16,Nevada,057,99092,4182,4132,168,4300,67
2021-03-16,Orange,059,3164182,249730,247843,10415,258258,4479
2021-03-16,Placer,061,380077,21208,20339,1178,21517,240
2021-03-16,Plumas,063,18699,659,643,10,653,4
2021-03-16,Riverside,065,2383286,288265,281540,13419,294959,3893
2021-03-16,Sacramento,067,1510023,97107,95522,1326,96848,1466
2021-03-16,San Benito,069,59416,5818,5831,89,5920,61
2021-03-16,San Bernardino,071,2135413,288057,283980,8588,292568,4032
2021-03-16,San Diego,073,3302833,268439,265903,13270,279173,3462
2021-03-16,San Francisco,075,870044,34808,34833,1135,35968,456
2021-03-16,San Joaquin,077,732212,68649,66856,2909,69765,1163
2021-03-16,San Luis Obispo,079,281455,20179,19832,591,20423,248
2021-03-16,San Mateo,081,765935,40264,39806,419,40225,344
2021-03-16,Santa Barbara,083,443738,32970,32556,1062,33618,433
2021-03-16,Santa Clara,085,1922200,112833,112845,614,113459,1797
2021-03-16,Santa Cruz,087,273765,15701,14926,782,15708,199
2021-03-16,Shasta,089,179085,11147,11035,1312,12347,100
2021-03-16,Sierra,091,2930,53,49,12,61,0
2021-03-16,Siskiyou,093,43540,1553,1477,244,1721,5
2021-03-16,Solano,095,438530,30425,30298,384,30682,171
2021-03-16,Sonoma,097,501317,28753,28850,240,29090,291
2021-03-16,Stanislaus,099,539301,52165,51410,5449,56859,683
2021-03-16,Sutter,101,95872,8990,8970,79,9049,102
2021-03-16,Tehama,103,63373,4710,4660,494,5154,34
2021-03-16,Trinity,105,12862,472,308,79,387,3
2021-03-16,Tulare,107,460477,48995,47895,8271,56166,803
2021-03-16,Tuolumne,109,53932,3886,3938,38,3976,57
2021-03-16,Ventura,111,848112,79261,78671,2799,81470,916
2021-03-16,Yolo,113,214977,13197,13162,158,13320,190
2021-03-16,Yuba,115,75493,5654,5596,89,5685,42
2021-03-15,Alameda,001,1643700,82611,82159,1723,83882,1167
2021-03-15,Alpine,003,1148,83,82,0,82,0
2021-03-15,Amador,005,37829,3515,3506,31,3537,44
2021-03-15,Butte,007,227075,11547,11141,1624,12765,185
2021-03-15,Calaveras,009,45235,1964,1941,11,1952,49
2021-03-15,Colusa,011,21464,1883,1883,270,2153,12
2021-03-15,Contra Costa,013,1133247,64790,63847,1091,64938,732
2021-03-15,Del Norte,015,27424,1105,1048,5,1053,6
2021-03-15,El Dorado,017,186661,9321,9235,606,9841,103
2021-03-15,Fresno,019,978130,98500,97520,7954,105474,1496
2021-03-15,Glenn,021,27897,2300,2261,505,2766,15
2021-03-15,Humboldt,023,135768,3379,3337,24,3361,32
2021-03-15,Imperial,025,180216,27427,27122,2500,29622,684
2021-03-15,Inyo,027,18085,1360,1346,9,1355,35
2021-03-15,Kern,029,883053,94701,93266,10033,103299,1141
2021-03-15,Kings,031,150075,22617,22294,983,23277,233
2021-03-15,Lake,033,64148,3291,3237,8,3245,43
2021-03-15,Lassen,035,31185,5135,5125,99,5224,1
2021-03-15,Los Angeles,037,10098052,1183074,1172445,39069,1211514,22477
2021-03-15,Madera,039,155013,15963,15806,858,16664,214
2021-03-15,Marin,041,260295,13495,13408,178,13586,218
2021-03-15,Mariposa,043,17540,384,376,5,381,5
2021-03-15,Mendocino,045,87422,3714,3615,74,3689,44
2021-03-15,Merced,047,269075,29283,29169,944,30113,407
2021-03-15,Modoc,049,8938,347,340,118,458,3
2021-03-15,Mono,051,14174,1208,1206,15,1221,3
2021-03-15,Monterey,053,433212,42302,42011,1709,43720,333
2021-03-15,Napa,055,140530,9239,9196,32,9228,75
2021-03-15,Nevada,057,99092,4177,4123,167,4290,66
2021-03-15,Orange,059,3164182,249617,247697,10396,258093,4481
2021-03-15,Placer,061,380077,21185,20308,1178,21486,238
2021-03-15,Plumas,063,18699,659,642,10,652,4
2021-03-15,Riverside,065,2383286,288113,281367,13409,294776,3856
2021-03-15,Sacramento,067,1510023,96954,95414,1320,96734,1463
2021-03-15,San Benito,069,59416,5815,5831,89,5920,61
2021-03-15,San Bernardino,071,2135413,287966,283815,8580,292395,4004
2021-03-15,San Diego,073,3302833,268190,265646,13254,278900,3452
2021-03-15,San Francisco,075,870044,34773,34820,1131,35951,456
2021-03-15,San Joaquin,077,732212,68545,66622,2897,69519,1140
2021-03-15,San Luis Obispo,079,281455,20148,19813,587,20400,247
2021-03-15,San Mateo,081,765935,40210,39765,419,40184,344
2021-03-15,Santa Barbara,083,443738,32947,32529,1059,33588,431
2021-03-15,Santa Clara,085,1922200,112732,112729,612,113341,1798
2021-03-15,Santa Cruz,087,273765,15695,14899,781,15680,200
2021-03-15,Shasta,089,179085,11131,11019,1307,12326,92
2021-03-15,Sierra,091,2930,53,49,12,61,0
2021-03-15,Siskiyou,093,43540,1553,1475,244,1719,5
2021-03-15,Solano,095,438530,30396,30258,383,30641,171
2021-03-15,Sonoma,097,501317,28735,28814,237,29051,285
2021-03-15,Stanislaus,099,539301,52086,51357,5442,56799,683
2021-03-15,Sutter,101,95872,8984,8962,79,9041,102
2021-03-15,Tehama,103,63373,4695,4650,493,5143,34
2021-03-15,Trinity,105,12862,472,308,79,387,3
2021-03-15,Tulare,107,460477,48965,47857,8256,56113,800
2021-03-15,Tuolumne,109,53932,3884,3937,37,3974,57
2021-03-15,Ventura,111,848112,79205,78626,2798,81424,910
2021-03-15,Yolo,113,214977,13178,13131,158,13289,190
2021-03-15,Yuba,115,75493,5649,5585,88,5673,42
2021-03-14,Alameda,001,1643700,82526,82116,1720,83836,1168
2021-03-14,Alpine,003,1148,83,82,0,82,0
2021-03-14,Amador,005,37829,3510,3504,31,3535,44
2021-03-14,Butte,007,227075,11534,11140,1620,12760,185
2021-03-14,Calaveras,009,45235,1960,1939,11,1950,49
2021-03-14,Colusa,011,21464,1883,1883,270,2153,12
2021-03-14,Contra Costa,013,1133247,64686,63808,1090,64898,731
2021-03-14,Del Norte,015,27424,1091,1048,5,1053,6
2021-03-14,El Dorado,017,186661,9311,9231,606,9837,103
2021-03-14,Fresno,019,978130,98392,97461,7936,105397,1496
2021-03-14,Glenn,021,27897,2295,2260,502,2762,15
2021-03-14,Humboldt,023,135768,3365,3335,24,3359,32
2021-03-14,Imperial,025,180216,27412,27122,2495,29617,685
2021-03-14,Inyo,027,18085,1356,1346,9,1355,35
2021-03-14,Kern,029,883053,94618,93252,10015,103267,1141
2021-03-14,Kings,031,150075,22598,22292,981,23273,232
2021-03-14,Lake,033,64148,3286,3237,8,3245,43
2021-03-14,Lassen,035,31185,5133,5125,99,5224,1
2021-03-14,Los Angeles,037,10098052,1182499,1172100,39037,1211137,22476
2021-03-14,Madera,039,155013,15938,15804,858,16662,214
2021-03-14,Marin,041,260295,13479,13405,176,13581,218
2021-03-14,Mariposa,043,17540,382,376,5,381,5
2021-03-14,Mendocino,045,87422,3709,3613,74,3687,44
2021-03-14,Merced,047,269075,29215,29149,940,30089,407
2021-03-14,Modoc,049,8938,347,340,118,458,3
2021-03-14,Mono,051,14174,1202,1206,15,1221,3
2021-03-14,Monterey,053,433212,42278,42007,1706,43713,333
2021-03-14,Napa,055,140530,9221,9194,32,9226,75
2021-03-14,Nevada,057,99092,4171,4122,165,4287,66
2021-03-14,Orange,059,3164182,249483,247656,10376,258032,4460
2021-03-14,Placer,061,380077,21150,20288,1170,21458,238
2021-03-14,Plumas,063,18699,657,642,10,652,4
2021-03-14,Riverside,065,2383286,287955,281332,13401,294733,3845
2021-03-14,Sacramento,067,1510023,96776,95343,1315,96658,1462
2021-03-14,San Benito,069,59416,5806,5829,89,5918,61
2021-03-14,San Bernardino,071,2135413,287843,283791,8569,292360,3996
2021-03-14,San Diego,073,3302833,267955,265468,13241,278709,3452
2021-03-14,San Francisco,075,870044,34734,34810,1128,35938,455
2021-03-14,San Joaquin,077,732212,68417,66563,2880,69443,1140
2021-03-14,San Luis Obispo,079,281455,20120,19806,585,20391,247
2021-03-14,San Mateo,081,765935,40171,39744,419,40163,342
2021-03-14,Santa Barbara,083,443738,32903,32514,1057,33571,431
2021-03-14,Santa Clara,085,1922200,112604,112648,611,113259,1796
2021-03-14,Santa Cruz,087,273765,15679,14887,779,15666,200
2021-03-14,Shasta,089,179085,11115,11019,1300,12319,92
2021-03-14,Sierra,091,2930,53,49,12,61,0
2021-03-14,Siskiyou,093,43540,1550,1473,244,1717,5
2021-03-14,Solano,095,438530,30364,30230,378,30608,171
2021-03-14,Sonoma,097,501317,28700,28798,233,29031,284
2021-03-14,Stanislaus,099,539301,51966,51306,5434,56740,690
2021-03-14,Sutter,101,95872,8968,8958,79,9037,102
2021-03-14,Tehama,103,63373,4688,4650,492,5142,34
2021-03-14,Trinity,105,12862,471,308,78,386,3
2021-03-14,Tulare,107,460477,48932,47845,8235,56080,800
2021-03-14,Tuolumne,109,53932,3882,3937,37,3974,57
2021-03-14,Ventura,111,848112,79157,78611,2792,81403,910
2021-03-14,Yolo,113,214977,13155,13128,155,13283,189
2021-03-14,Yuba,115,75493,5639,5583,88,5671,42
2021-03-13,Alameda,001,1643700,82466,82010,1720,83730,1168
2021-03-13,Alpine,003,1148,83,82,0,82,0
2021-03-13,Amador,005,37829,3507,3504,31,3535,44
2021-03-13,Butte,007,227075,11525,11131,1619,12750,185
2021-03-13,Calaveras,009,45235,1959,1939,11,1950,49
2021-03-13,Colusa,011,21464,1883,1882,270,2152,12
2021-03-13,Contra Costa,013,1133247,64625,63689,1090,64779,731
2021-03-13,Del Norte,015,27424,1087,1041,5,1046,6
2021-03-13,El Dorado,017,186661,9303,9221,606,9827,103
2021-03-13,Fresno,019,978130,98333,97324,7916,105240,1495
2021-03-13,Glenn,021,27897,2294,2260,501,2761,15
2021-03-13,Humboldt,023,135768,3358,3325,24,3349,32
2021-03-13,Imperial,025,180216,27406,27099,2491,29590,677
2021-03-13,Inyo,027,18085,1355,1344,9,1353,35
2021-03-13,Kern,029,883053,94579,93197,10009,103206,1140
2021-03-13,Kings,031,150075,22582,22265,980,23245,232
2021-03-13,Lake,033,64148,3279,3234,7,3241,43
2021-03-13,Lassen,035,31185,5133,5125,99,5224,1
2021-03-13,Los Angeles,037,10098052,1182181,1171505,38995,1210500,22451
2021-03-13,Madera,039,155013,15926,15780,858,16638,214
2021-03-13,Marin,041,260295,13473,13391,174,13565,218
2021-03-13,Mariposa,043,17540,381,376,5,381,5
2021-03-13,Mendocino,045,87422,3705,3611,74,3685,44
2021-03-13,Merced,047,269075,29184,29106,940,30046,406
2021-03-13,Modoc,049,8938,347,340,117,457,3
2021-03-13,Mono,051,14174,1202,1207,15,1222,3
2021-03-13,Monterey,053,433212,42268,41989,1704,43693,332
2021-03-13,Napa,055,140530,9215,9190,32,9222,75
2021-03-13,Nevada,057,99092,4164,4111,164,4275,66
2021-03-13,Orange,059,3164182,249402,247514,10360,257874,4423
2021-03-13,Placer,061,380077,21129,20238,1167,21405,239
2021-03-13,Plumas,063,18699,655,642,10,652,4
2021-03-13,Riverside,065,2383286,287863,281191,13393,294584,3848
2021-03-13,Sacramento,067,1510023,96690,95192,1313,96505,1461
2021-03-13,San Benito,069,59416,5803,5823,89,5912,61
2021-03-13,San Bernardino,071,2135413,287789,283727,8563,292290,3972
2021-03-13,San Diego,073,3302833,267800,265270,13227,278497,3444
2021-03-13,San Francisco,075,870044,34717,34784,1119,35903,455
2021-03-13,San Joaquin,077,732212,68361,66480,2858,69338,1141
2021-03-13,San Luis Obispo,079,281455,20102,19789,584,20373,247
2021-03-13,San Mateo,081,765935,40144,39689,418,40107,341
2021-03-13,Santa Barbara,083,443738,32878,32486,1056,33542,431
2021-03-13,Santa Clara,085,1922200,112519,112531,610,113141,1790
2021-03-13,Santa Cruz,087,273765,15672,14875,779,15654,199
2021-03-13,Shasta,089,179085,11107,11021,1297,12318,108
2021-03-13,Sierra,091,2930,52,49,12,61,0
2021-03-13,Siskiyou,093,43540,1548,1470,244,1714,5
2021-03-13,Solano,095,438530,30347,30198,378,30576,171
2021-03-13,Sonoma,097,501317,28680,28762,229,28991,285
2021-03-13,Stanislaus,099,539301,51915,51257,5430,56687,695
2021-03-13,Sutter,101,95872,8961,8948,79,9027,102
2021-03-13,Tehama,103,63373,4686,4647,492,5139,33
2021-03-13,Trinity,105,12862,471,306,78,384,3
2021-03-13,Tulare,107,460477,48906,47818,8227,56045,798
2021-03-13,Tuolumne,109,53932,3879,3937,37,3974,57
2021-03-13,Ventura,111,848112,79105,78693,2792,81485,906
2021-03-13,Yolo,113,214977,13146,13087,155,13242,189
2021-03-13,Yuba,115,75493,5638,5577,88,5665,42
2021-03-12,Alameda,001,1643700,82389,81898,1719,83617,1164
2021-03-12,Alpine,003,1148,83,82,0,82,0
2021-03-12,Amador,005,37829,3504,3503,31,3534,44
2021-03-12,Butte,007,227075,11515,11126,1617,12743,184
2021-03-12,Calaveras,009,45235,1959,1916,11,1927,49
2021-03-12,Colusa,011,21464,1883,1883,270,2153,12
2021-03-12,Contra Costa,013,1133247,64549,63583,1090,64673,728
2021-03-12,Del Norte,015,27424,1081,1033,5,1038,6
2021-03-12,El Dorado,017,186661,9294,9219,606,9825,103
2021-03-12,Fresno,019,978130,98236,97185,7905,105090,1489
2021-03-12,Glenn,021,27897,2293,2258,500,2758,15
2021-03-12,Humboldt,023,135768,3353,3315,24,3339,32
2021-03-12,Imperial,025,180216,27395,27071,2489,29560,677
2021-03-12,Inyo,027,18085,1353,1339,9,1348,35
2021-03-12,Kern,029,883053,94545,93142,9993,103135,1132
2021-03-12,Kings,031,150075,22563,22233,980,23213,232
2021-03-12,Lake,033,64148,3273,3226,6,3232,43
2021-03-12,Lassen,035,31185,5133,5125,98,5223,1
2021-03-12,Los Angeles,037,10098052,1181786,1170860,38978,1209838,22409
2021-03-12,Madera,039,155013,15914,15761,855,16616,214
2021-03-12,Marin,041,260295,13466,13375,174,13549,218
2021-03-12,Mariposa,043,17540,379,376,5,381,5
2021-03-12,Mendocino,045,87422,3702,3605,74,3679,43
2021-03-12,Merced,047,269075,29153,29064,940,30004,403
2021-03-12,Modoc,049,8938,347,340,117,457,3
2021-03-12,Mono,051,14174,1201,1206,15,1221,3
2021-03-12,Monterey,053,433212,42254,41964,1699,43663,329
2021-03-12,Napa,055,140530,9206,9180,32,9212,75
2021-03-12,Nevada,057,99092,4154,4101,164,4265,66
2021-03-12,Orange,059,3164182,249310,247388,10349,257737,4401
2021-03-12,Placer,061,380077,21096,20210,1162,21372,239
2021-03-12,Plumas,063,18699,654,641,10,651,4
2021-03-12,Riverside,065,2383286,287764,281037,13386,294423,3854
2021-03-12,Sacramento,067,1510023,96566,95061,1307,96368,1460
2021-03-12,San Benito,069,59416,5800,5817,89,5906,61
2021-03-12,San Bernardino,071,2135413,287733,283558,8558,292116,3917
2021-03-12,San Diego,073,3302833,267637,264886,13219,278105,3434
2021-03-12,San Francisco,075,870044,34696,34758,1116,35874,452
2021-03-12,San Joaquin,077,732212,68290,66482,2849,69331,1144
2021-03-12,San Luis Obispo,079,281455,20089,19769,582,20351,247
2021-03-12,San Mateo,081,765935,40108,39638,416,40054,341
2021-03-12,Santa Barbara,083,443738,32855,32457,1053,33510,429
2021-03-12,Santa Clara,085,1922200,112424,112396,609,113005,1766
2021-03-12,Santa Cruz,087,273765,15660,14846,777,15623,195
2021-03-12,Shasta,089,179085,11098,11143,1295,12438,153
2021-03-12,Sierra,091,2930,52,49,12,61,0
2021-03-12,Siskiyou,093,43540,1548,1468,243,1711,5
2021-03-12,Solano,095,438530,30328,30180,377,30557,171
2021-03-12,Sonoma,097,501317,28653,28714,229,28943,285
2021-03-12,Stanislaus,099,539301,51856,51146,5424,56570,701
2021-03-12,Sutter,101,95872,8955,8940,79,9019,101
2021-03-12,Tehama,103,63373,4682,4638,491,5129,33
2021-03-12,Trinity,105,12862,470,306,78,384,3
2021-03-12,Tulare,107,460477,48881,47772,8221,55993,798
2021-03-12,Tuolumne,109,53932,3878,3936,37,3973,57
2021-03-12,Ventura,111,848112,79059,78698,2788,81486,899
2021-03-12,Yolo,113,214977,13136,13061,148,13209,189
2021-03-12,Yuba,115,75493,5631,5563,87,5650,42
2021-03-11,Alameda,001,1643700,82298,81809,1714,83523,1164
2021-03-11,Alpine,003,1148,83,78,0,78,0
2021-03-11,Amador,005,37829,3503,3498,31,3529,42
2021-03-11,Butte,007,227075,11504,11110,1615,12725,185
2021-03-11,Calaveras,009,45235,1956,1915,11,1926,49
2021-03-11,Colusa,011,21464,1883,1883,270,2153,12
2021-03-11,Contra Costa,013,1133247,64476,63469,1088,64557,728
2021-03-11,Del Norte,015,27424,1076,1027,5,1032,6
2021-03-11,El Dorado,017,186661,9280,9211,606,9817,101
2021-03-11,Fresno,019,978130,98120,97026,7876,104902,1481
2021-03-11,Glenn,021,27897,2290,2255,500,2755,15
2021-03-11,Humboldt,023,135768,3336,3302,24,3326,32
2021-03-11,Imperial,025,180216,27388,27045,2486,29531,675
2021-03-11,Inyo,027,18085,1348,1335,9,1344,35
2021-03-11,Kern,029,883053,94489,93052,9954,103006,1121
2021-03-11,Kings,031,150075,22548,22183,977,23160,230
2021-03-11,Lake,033,64148,3269,3214,6,3220,42
2021-03-11,Lassen,035,31185,5132,5124,98,5222,1
2021-03-11,Los Angeles,037,10098052,1181255,1170111,38947,1209058,22316
2021-03-11,Madera,039,155013,15903,15725,853,16578,214
2021-03-11,Marin,041,260295,13454,13356,173,13529,217
2021-03-11,Mariposa,043,17540,379,376,5,381,5
2021-03-11,Mendocino,045,87422,3695,3604,74,3678,42
2021-03-11,Merced,047,269075,29105,29001,939,29940,401
2021-03-11,Modoc,049,8938,347,340,117,457,3
2021-03-11,Mono,051,14174,1200,1206,15,1221,3
2021-03-11,Monterey,053,433212,42231,41936,1693,43629,329
2021-03-11,Napa,055,140530,9193,9173,32,9205,75
2021-03-11,Nevada,057,99092,4142,4085,162,4247,66
2021-03-11,Orange,059,3164182,249172,247217,10331,257548,4373
2021-03-11,Placer,061,380077,21054,20178,1158,21336,239
2021-03-11,Plumas,063,18699,653,640,10,650,4
2021-03-11,Riverside,065,2383286,287594,280881,13373,294254,3842
2021-03-11,Sacramento,067,1510023,96425,94912,1304,96216,1455
2021-03-11,San Benito,069,59416,5797,5816,89,5905,61
2021-03-11,San Bernardino,071,2135413,287636,283312,8552,291864,3869
2021-03-11,San Diego,073,3302833,267472,264524,13203,277727,3422
2021-03-11,San Francisco,075,870044,34660,34722,1110,35832,452
2021-03-11,San Joaquin,077,732212,68178,66522,2841,69363,1157
2021-03-11,San Luis Obispo,079,281455,20064,19748,581,20329,247
2021-03-11,San Mateo,081,765935,40071,39590,415,40005,341
2021-03-11,Santa Barbara,083,443738,32827,32408,1048,33456,430
2021-03-11,Santa Clara,085,1922200,112295,112246,606,112852,1765
2021-03-11,Santa Cruz,087,273765,15648,14812,776,15588,193
2021-03-11,Shasta,089,179085,11088,11139,1290,12429,158
2021-03-11,Sierra,091,2930,52,48,12,60,0
2021-03-11,Siskiyou,093,43540,1545,1466,242,1708,5
2021-03-11,Solano,095,438530,30300,30138,376,30514,171
2021-03-11,Sonoma,097,501317,28624,28677,229,28906,285
2021-03-11,Stanislaus,099,539301,51771,51038,5416,56454,707
2021-03-11,Sutter,101,95872,8949,8933,79,9012,101
2021-03-11,Tehama,103,63373,4674,4632,491,5123,33
2021-03-11,Trinity,105,12862,469,304,77,381,3
2021-03-11,Tulare,107,460477,48844,47709,8210,55919,797
2021-03-11,Tuolumne,109,53932,3876,3934,37,3971,57
2021-03-11,Ventura,111,848112,79009,78697,2784,81481,889
2021-03-11,Yolo,113,214977,13118,13041,147,13188,190
2021-03-11,Yuba,115,75493,5627,5553,87,5640,42
2021-03-10,Alameda,001,1643700,82192,81701,1709,83410,1160
2021-03-10,Alpine,003,1148,82,78,0,78,0
2021-03-10,Amador,005,37829,3501,3496,31,3527,42
2021-03-10,Butte,007,227075,11494,11096,1615,12711,185
2021-03-10,Calaveras,009,45235,1950,1913,11,1924,48
2021-03-10,Colusa,011,21464,1883,1882,270,2152,12
2021-03-10,Contra Costa,013,1133247,64376,63372,1084,64456,725
2021-03-10,Del Norte,015,27424,1074,1020,5,1025,5
2021-03-10,El Dorado,017,186661,9267,9203,606,9809,100
2021-03-10,Fresno,019,978130,98013,96866,7860,104726,1471
2021-03-10,Glenn,021,27897,2287,2253,498,2751,15
2021-03-10,Humboldt,023,135768,3326,3296,23,3319,32
2021-03-10,Imperial,025,180216,27373,27051,2486,29537,675
2021-03-10,Inyo,027,18085,1348,1328,9,1337,35
2021-03-10,Kern,029,883053,94423,92965,9933,102898,1102
2021-03-10,Kings,031,150075,22529,22166,976,23142,226
2021-03-10,Lake,033,64148,3259,3207,6,3213,42
2021-03-10,Lassen,035,31185,5132,5120,98,5218,1
2021-03-10,Los Angeles,037,10098052,1180710,1169079,38920,1207999,22199
2021-03-10,Madera,039,155013,15882,15705,850,16555,212
2021-03-10,Marin,041,260295,13444,13348,172,13520,216
2021-03-10,Mariposa,043,17540,379,376,5,381,5
2021-03-10,Mendocino,045,87422,3690,3602,74,3676,42
2021-03-10,Merced,047,269075,29067,28927,936,29863,401
2021-03-10,Modoc,049,8938,346,338,117,455,3
2021-03-10,Mono,051,14174,1196,1204,15,1219,3
2021-03-10,Monterey,053,433212,42209,41920,1689,43609,329
2021-03-10,Napa,055,140530,9184,9165,32,9197,75
2021-03-10,Nevada,057,99092,4138,4074,162,4236,66
2021-03-10,Orange,059,3164182,249024,247075,10316,257391,4342
2021-03-10,Placer,061,380077,21020,20144,1152,21296,239
2021-03-10,Plumas,063,18699,652,639,10,649,4
2021-03-10,Riverside,065,2383286,287453,280708,13359,294067,3822
2021-03-10,Sacramento,067,1510023,96295,94796,1298,96094,1452
2021-03-10,San Benito,069,59416,5788,5811,89,5900,61
2021-03-10,San Bernardino,071,2135413,287543,283140,8546,291686,3841
2021-03-10,San Diego,073,3302833,267250,264094,13191,277285,3413
2021-03-10,San Francisco,075,870044,34625,34688,1102,35790,450
2021-03-10,San Joaquin,077,732212,68076,66483,2824,69307,1156
2021-03-10,San Luis Obispo,079,281455,20040,19710,577,20287,247
2021-03-10,San Mateo,081,765935,40047,39571,415,39986,338
2021-03-10,Santa Barbara,083,443738,32800,32356,1045,33401,429
2021-03-10,Santa Clara,085,1922200,112186,112103,602,112705,1759
2021-03-10,Santa Cruz,087,273765,15633,14790,775,15565,192
2021-03-10,Shasta,089,179085,11078,11125,1287,12412,155
2021-03-10,Sierra,091,2930,52,48,12,60,0
2021-03-10,Siskiyou,093,43540,1543,1458,242,1700,5
2021-03-10,Solano,095,438530,30270,30111,375,30486,170
2021-03-10,Sonoma,097,501317,28589,28638,228,28866,286
2021-03-10,Stanislaus,099,539301,51684,50968,5397,56365,706
2021-03-10,Sutter,101,95872,8938,8918,79,8997,101
2021-03-10,Tehama,103,63373,4663,4623,490,5113,33
2021-03-10,Trinity,105,12862,469,304,77,381,3
2021-03-10,Tulare,107,460477,48796,47659,8192,55851,793
2021-03-10,Tuolumne,109,53932,3875,3931,37,3968,57
2021-03-10,Ventura,111,848112,78932,78609,2782,81391,878
2021-03-10,Yolo,113,214977,13094,13021,147,13168,189
2021-03-10,Yuba,115,75493,5614,5545,86,5631,42
2021-03-09,Alameda,001,1643700,82106,81618,1709,83327,1151
2021-03-09,Alpine,003,1148,82,78,0,78,0
2021-03-09,Amador,005,37829,3499,3494,31,3525,42
2021-03-09,Butte,007,227075,11481,11092,1614,12706,185
2021-03-09,Calaveras,009,45235,1948,1913,11,1924,48
2021-03-09,Colusa,011,21464,1883,1880,270,2150,11
2021-03-09,Contra Costa,013,1133247,64286,63314,1082,64396,723
2021-03-09,Del Norte,015,27424,1066,1017,5,1022,5
2021-03-09,El Dorado,017,186661,9259,9198,606,9804,98
2021-03-09,Fresno,019,978130,97894,96744,7834,104578,1463
2021-03-09,Glenn,021,27897,2283,2251,496,2747,15
2021-03-09,Humboldt,023,135768,3314,3288,22,3310,32
2021-03-09,Imperial,025,180216,27363,27045,2482,29527,675
2021-03-09,Inyo,027,18085,1346,1324,9,1333,35
2021-03-09,Kern,029,883053,94344,92924,9915,102839,1088
2021-03-09,Kings,031,150075,22504,22143,974,23117,226
2021-03-09,Lake,033,64148,3253,3202,6,3208,42
2021-03-09,Lassen,035,31185,5132,5120,98,5218,1
2021-03-09,Los Angeles,037,10098052,1180113,1167967,38887,1206854,22080
2021-03-09,Madera,039,155013,15871,15701,848,16549,211
2021-03-09,Marin,041,260295,13426,13335,170,13505,214
2021-03-09,Mariposa,043,17540,379,376,5,381,5
2021-03-09,Mendocino,045,87422,3686,3595,74,3669,42
2021-03-09,Merced,047,269075,29007,28876,933,29809,399
2021-03-09,Modoc,049,8938,346,338,116,454,3
2021-03-09,Mono,051,14174,1195,1203,15,1218,3
2021-03-09,Monterey,053,433212,42190,41894,1681,43575,329
2021-03-09,Napa,055,140530,9170,9155,32,9187,75
2021-03-09,Nevada,057,99092,4130,4062,162,4224,66
2021-03-09,Orange,059,3164182,248882,246989,10297,257286,4310
2021-03-09,Placer,061,380077,20978,20122,1147,21269,239
2021-03-09,Plumas,063,18699,649,639,10,649,4
2021-03-09,Riverside,065,2383286,287318,280562,13355,293917,3821
2021-03-09,Sacramento,067,1510023,96128,94720,1292,96012,1442
2021-03-09,San Benito,069,59416,5784,5800,89,5889,61
2021-03-09,San Bernardino,071,2135413,287428,282971,8540,291511,3823
2021-03-09,San Diego,073,3302833,267018,263745,13170,276915,3405
2021-03-09,San Francisco,075,870044,34594,34654,1098,35752,450
2021-03-09,San Joaquin,077,732212,67948,66383,2814,69197,1150
2021-03-09,San Luis Obispo,079,281455,20023,19672,570,20242,245
2021-03-09,San Mateo,081,765935,40000,39535,413,39948,336
2021-03-09,Santa Barbara,083,443738,32759,32314,1043,33357,428
2021-03-09,Santa Clara,085,1922200,112075,111963,597,112560,1756
2021-03-09,Santa Cruz,087,273765,15611,14764,774,15538,188
2021-03-09,Shasta,089,179085,11071,11113,1282,12395,155
2021-03-09,Sierra,091,2930,52,48,12,60,0
2021-03-09,Siskiyou,093,43540,1539,1447,240,1687,5
2021-03-09,Solano,095,438530,30234,30090,373,30463,169
2021-03-09,Sonoma,097,501317,28539,28601,225,28826,284
2021-03-09,Stanislaus,099,539301,51586,50884,5388,56272,703
2021-03-09,Sutter,101,95872,8925,8914,79,8993,101
2021-03-09,Tehama,103,63373,4658,4620,490,5110,33
2021-03-09,Trinity,105,12862,469,304,77,381,3
2021-03-09,Tulare,107,460477,48769,47637,8173,55810,792
2021-03-09,Tuolumne,109,53932,3873,3929,37,3966,56
2021-03-09,Ventura,111,848112,78869,78526,2780,81306,863
2021-03-09,Yolo,113,214977,13082,13015,145,13160,189
2021-03-09,Yuba,115,75493,5607,5539,86,5625,42
2021-03-08,Alameda,001,1643700,81995,81543,1708,83251,1142
2021-03-08,Alpine,003,1148,82,78,0,78,0
2021-03-08,Amador,005,37829,3496,3490,31,3521,42
2021-03-08,Butte,007,227075,11468,11082,1613,12695,185
2021-03-08,Calaveras,009,45235,1944,1909,11,1920,48
2021-03-08,Colusa,011,21464,1883,1877,270,2147,11
2021-03-08,Contra Costa,013,1133247,64190,63240,1082,64322,719
2021-03-08,Del Norte,015,27424,1061,1012,5,1017,5
2021-03-08,El Dorado,017,186661,9256,9188,605,9793,97
2021-03-08,Fresno,019,978130,97796,96665,7813,104478,1442
2021-03-08,Glenn,021,27897,2282,2249,496,2745,15
2021-03-08,Humboldt,023,135768,3300,3278,22,3300,31
2021-03-08,Imperial,025,180216,27355,27033,2479,29512,663
2021-03-08,Inyo,027,18085,1344,1320,9,1329,35
2021-03-08,Kern,029,883053,94278,92857,9895,102752,1087
2021-03-08,Kings,031,150075,22483,22130,972,23102,226
2021-03-08,Lake,033,64148,3241,3195,6,3201,42
2021-03-08,Lassen,035,31185,5132,5119,98,5217,1
2021-03-08,Los Angeles,037,10098052,1179493,1163409,38855,1202264,21868
2021-03-08,Madera,039,155013,15861,15691,846,16537,211
2021-03-08,Marin,041,260295,13406,13328,168,13496,214
2021-03-08,Mariposa,043,17540,379,376,5,381,5
2021-03-08,Mendocino,045,87422,3684,3590,73,3663,42
2021-03-08,Merced,047,269075,28947,28841,932,29773,398
2021-03-08,Modoc,049,8938,346,338,116,454,3
2021-03-08,Mono,051,14174,1194,1200,15,1215,3
2021-03-08,Monterey,053,433212,42169,41863,1680,43543,328
2021-03-08,Napa,055,140530,9167,9146,32,9178,75
2021-03-08,Nevada,057,99092,4122,4059,162,4221,66
2021-03-08,Orange,059,3164182,248709,246900,10265,257165,4243
2021-03-08,Placer,061,380077,20943,20102,1136,21238,239
2021-03-08,Plumas,063,18699,648,635,10,645,4
2021-03-08,Riverside,065,2383286,287166,280463,13345,293808,3783
2021-03-08,Sacramento,067,1510023,95958,94654,1287,95941,1438
2021-03-08,San Benito,069,59416,5781,5797,89,5886,61
2021-03-08,San Bernardino,071,2135413,287317,282894,8533,291427,3811
2021-03-08,San Diego,073,3302833,266777,263272,13155,276427,3390
2021-03-08,San Francisco,075,870044,34568,34634,1094,35728,446
2021-03-08,San Joaquin,077,732212,67832,66307,2805,69112,1139
2021-03-08,San Luis Obispo,079,281455,19980,19656,567,20223,245
2021-03-08,San Mateo,081,765935,39951,39492,411,39903,335
2021-03-08,Santa Barbara,083,443738,32727,32293,1043,33336,427
2021-03-08,Santa Clara,085,1922200,111947,111882,595,112477,1756
2021-03-08,Santa Cruz,087,273765,15591,14729,774,15503,188
2021-03-08,Shasta,089,179085,11063,11088,1277,12365,155
2021-03-08,Sierra,091,2930,52,48,12,60,0
2021-03-08,Siskiyou,093,43540,1538,1440,240,1680,5
2021-03-08,Solano,095,438530,30194,30068,371,30439,169
2021-03-08,Sonoma,097,501317,28495,28571,224,28795,284
2021-03-08,Stanislaus,099,539301,51507,50825,5383,56208,690
2021-03-08,Sutter,101,95872,8922,8905,79,8984,100
2021-03-08,Tehama,103,63373,4654,4615,490,5105,33
2021-03-08,Trinity,105,12862,468,302,77,379,3
2021-03-08,Tulare,107,460477,48728,47587,8148,55735,791
2021-03-08,Tuolumne,109,53932,3872,3921,37,3958,56
2021-03-08,Ventura,111,848112,78796,78526,2772,81298,852
2021-03-08,Yolo,113,214977,13059,13000,145,13145,189
2021-03-08,Yuba,115,75493,5597,5530,86,5616,42
2021-03-07,Alameda,001,1643700,81875,81413,1707,83120,1145
2021-03-07,Alpine,003,1148,82,78,0,78,0
2021-03-07,Amador,005,37829,3493,3489,31,3520,42
2021-03-07,Butte,007,227075,11452,11075,1612,12687,185
2021-03-07,Calaveras,009,45235,1940,1906,11,1917,48
2021-03-07,Colusa,011,21464,1883,1876,270,2146,11
2021-03-07,Contra Costa,013,1133247,64091,63148,1080,64228,719
2021-03-07,Del Norte,015,27424,1056,1010,5,1015,5
2021-03-07,El Dorado,017,186661,9253,9184,604,9788,97
2021-03-07,Fresno,019,978130,97618,96549,7791,104340,1442
2021-03-07,Glenn,021,27897,2280,2244,496,2740,15
2021-03-07,Humboldt,023,135768,3290,3274,22,3296,31
2021-03-07,Imperial,025,180216,27346,27019,2477,29496,658
2021-03-07,Inyo,027,18085,1341,1320,9,1329,35
2021-03-07,Kern,029,883053,94191,92746,9865,102611,1086
2021-03-07,Kings,031,150075,22461,22103,972,23075,224
2021-03-07,Lake,033,64148,3235,3192,6,3198,42
2021-03-07,Lassen,035,31185,5131,5119,98,5217,1
2021-03-07,Los Angeles,037,10098052,1178767,1162749,38820,1201569,21857
2021-03-07,Madera,039,155013,15842,15675,846,16521,211
2021-03-07,Marin,041,260295,13398,13313,166,13479,214
2021-03-07,Mariposa,043,17540,378,376,5,381,5
2021-03-07,Mendocino,045,87422,3680,3581,73,3654,42
2021-03-07,Merced,047,269075,28873,28829,928,29757,399
2021-03-07,Modoc,049,8938,346,338,116,454,3
2021-03-07,Mono,051,14174,1192,1199,15,1214,3
2021-03-07,Monterey,053,433212,42148,41858,1677,43535,328
2021-03-07,Napa,055,140530,9157,9137,32,9169,75
2021-03-07,Nevada,057,99092,4108,4052,161,4213,66
2021-03-07,Orange,059,3164182,248517,246771,10237,257008,4218
2021-03-07,Placer,061,380077,20902,20070,1132,21202,239
2021-03-07,Plumas,063,18699,647,635,10,645,4
2021-03-07,Riverside,065,2383286,287017,280379,13336,293715,3779
2021-03-07,Sacramento,067,1510023,95781,94513,1280,95793,1437
2021-03-07,San Benito,069,59416,5774,5795,89,5884,61
2021-03-07,San Bernardino,071,2135413,287166,282860,8528,291388,3810
2021-03-07,San Diego,073,3302833,266495,262965,13131,276096,3390
2021-03-07,San Francisco,075,870044,34534,34594,1089,35683,445
2021-03-07,San Joaquin,077,732212,67696,66252,2792,69044,1139
2021-03-07,San Luis Obispo,079,281455,19943,19614,565,20179,245
2021-03-07,San Mateo,081,765935,39911,39436,408,39844,329
2021-03-07,Santa Barbara,083,443738,32681,32218,1042,33260,425
2021-03-07,Santa Clara,085,1922200,111802,111745,591,112336,1752
2021-03-07,Santa Cruz,087,273765,15569,14715,773,15488,189
2021-03-07,Shasta,089,179085,11050,11083,1269,12352,156
2021-03-07,Sierra,091,2930,51,48,12,60,0
2021-03-07,Siskiyou,093,43540,1537,1435,236,1671,5
2021-03-07,Solano,095,438530,30157,30027,371,30398,169
2021-03-07,Sonoma,097,501317,28446,28533,222,28755,284
2021-03-07,Stanislaus,099,539301,51375,50783,5367,56150,699
2021-03-07,Sutter,101,95872,8912,8900,79,8979,100
2021-03-07,Tehama,103,63373,4647,4614,489,5103,33
2021-03-07,Trinity,105,12862,468,302,77,379,3
2021-03-07,Tulare,107,460477,48669,47569,8117,55686,790
2021-03-07,Tuolumne,109,53932,3871,3922,36,3958,56
2021-03-07,Ventura,111,848112,78704,78487,2770,81257,851
2021-03-07,Yolo,113,214977,13040,12988,145,13133,189
2021-03-07,Yuba,115,75493,5592,5516,86,5602,42
2021-03-06,Alameda,001,1643700,81818,81310,1706,83016,1143
2021-03-06,Alpine,003,1148,82,78,0,78,0
2021-03-06,Amador,005,37829,3489,3487,31,3518,42
2021-03-06,Butte,007,227075,11447,11065,1611,12676,185
2021-03-06,Calaveras,009,45235,1936,1904,11,1915,48
2021-03-06,Colusa,011,21464,1881,1874,270,2144,11
2021-03-06,Contra Costa,013,1133247,64030,63040,1076,64116,719
2021-03-06,Del Norte,015,27424,1051,1000,5,1005,5
2021-03-06,El Dorado,017,186661,9249,9166,604,9770,97
2021-03-06,Fresno,019,978130,97523,96366,7780,104146,1440
2021-03-06,Glenn,021,27897,2280,2241,496,2737,15
2021-03-06,Humboldt,023,135768,3280,3260,22,3282,31
2021-03-06,Imperial,025,180216,27341,27009,2472,29481,658
2021-03-06,Inyo,027,18085,1338,1312,9,1321,35
2021-03-06,Kern,029,883053,94145,92684,9845,102529,1082
2021-03-06,Kings,031,150075,22446,22094,972,23066,224
2021-03-06,Lake,033,64148,3233,3189,6,3195,42
2021-03-06,Lassen,035,31185,5131,5119,98,5217,1
2021-03-06,Los Angeles,037,10098052,1178327,1161745,38792,1200537,21843
2021-03-06,Madera,039,155013,15833,15646,845,16491,211
2021-03-06,Marin,041,260295,13389,13289,166,13455,213
2021-03-06,Mariposa,043,17540,378,376,5,381,5
2021-03-06,Mendocino,045,87422,3678,3579,73,3652,42
2021-03-06,Merced,047,269075,28831,28771,928,29699,399
2021-03-06,Modoc,049,8938,345,338,116,454,3
2021-03-06,Mono,051,14174,1191,1198,15,1213,3
2021-03-06,Monterey,053,433212,42143,41838,1674,43512,327
2021-03-06,Napa,055,140530,9149,9129,32,9161,75
2021-03-06,Nevada,057,99092,4102,4044,161,4205,66
2021-03-06,Orange,059,3164182,248424,246634,10223,256857,4165
2021-03-06,Placer,061,380077,20879,20030,1130,21160,239
2021-03-06,Plumas,063,18699,647,634,10,644,4
2021-03-06,Riverside,065,2383286,286924,280225,13328,293553,3781
2021-03-06,Sacramento,067,1510023,95693,94332,1271,95603,1436
2021-03-06,San Benito,069,59416,5769,5793,89,5882,61
2021-03-06,San Bernardino,071,2135413,287082,282737,8526,291263,3791
2021-03-06,San Diego,073,3302833,266308,262778,13114,275892,3385
2021-03-06,San Francisco,075,870044,34503,34560,1085,35645,435
2021-03-06,San Joaquin,077,732212,67622,66162,2782,68944,1138
2021-03-06,San Luis Obispo,079,281455,19923,19592,563,20155,245
2021-03-06,San Mateo,081,765935,39886,39384,408,39792,329
2021-03-06,Santa Barbara,083,443738,32651,32176,1042,33218,424
2021-03-06,Santa Clara,085,1922200,111707,111570,588,112158,1749
2021-03-06,Santa Cruz,087,273765,15558,14701,773,15474,188
2021-03-06,Shasta,089,179085,11041,11076,1267,12343,158
2021-03-06,Sierra,091,2930,51,48,12,60,0
2021-03-06,Siskiyou,093,43540,1535,1432,236,1668,5
2021-03-06,Solano,095,438530,30128,30000,370,30370,169
2021-03-06,Sonoma,097,501317,28423,28484,220,28704,284
2021-03-06,Stanislaus,099,539301,51305,50691,5361,56052,711
2021-03-06,Sutter,101,95872,8906,8887,79,8966,100
2021-03-06,Tehama,103,63373,4645,4610,486,5096,33
2021-03-06,Trinity,105,12862,468,302,77,379,3
2021-03-06,Tulare,107,460477,48637,47515,8089,55604,789
2021-03-06,Tuolumne,109,53932,3869,3920,36,3956,56
2021-03-06,Ventura,111,848112,78648,78439,2769,81208,848
2021-03-06,Yolo,113,214977,13034,12951,144,13095,189
2021-03-06,Yuba,115,75493,5583,5504,86,5590,42
2021-03-05,Alameda,001,1643700,81731,81215,1705,82920,1141
2021-03-05,Alpine,003,1148,82,78,0,78,0
2021-03-05,Amador,005,37829,3488,3484,31,3515,42
2021-03-05,Butte,007,227075,11436,11050,1610,12660,185
2021-03-05,Calaveras,009,45235,1933,1902,11,1913,48
2021-03-05,Colusa,011,21464,1881,1874,270,2144,11
2021-03-05,Contra Costa,013,1133247,63950,62886,1073,63959,711
2021-03-05,Del Norte,015,27424,1047,995,5,1000,5
2021-03-05,El Dorado,017,186661,9244,9150,603,9753,97
2021-03-05,Fresno,019,978130,97415,96184,7761,103945,1432
2021-03-05,Glenn,021,27897,2277,2241,495,2736,15
2021-03-05,Humboldt,023,135768,3273,3234,22,3256,31
2021-03-05,Imperial,025,180216,27331,26970,2463,29433,651
2021-03-05,Inyo,027,18085,1334,1309,9,1318,35
2021-03-05,Kern,029,883053,94105,92601,9832,102433,1076
2021-03-05,Kings,031,150075,22428,22063,971,23034,224
2021-03-05,Lake,033,64148,3231,3185,6,3191,42
2021-03-05,Lassen,035,31185,5131,5117,96,5213,1
2021-03-05,Los Angeles,037,10098052,1177836,1160688,38763,1199451,21745
2021-03-05,Madera,039,155013,15823,15624,843,16467,211
2021-03-05,Marin,041,260295,13377,13275,165,13440,215
2021-03-05,Mariposa,043,17540,378,375,5,380,4
2021-03-05,Mendocino,045,87422,3675,3577,73,3650,42
2021-03-05,Merced,047,269075,28798,28734,927,29661,399
2021-03-05,Modoc,049,8938,345,337,116,453,3
2021-03-05,Mono,051,14174,1190,1197,15,1212,3
2021-03-05,Monterey,053,433212,42130,41802,1674,43476,325
2021-03-05,Napa,055,140530,9141,9109,32,9141,75
2021-03-05,Nevada,057,99092,4099,4033,161,4194,66
2021-03-05,Orange,059,3164182,248311,246489,10210,256699,4108
2021-03-05,Placer,061,380077,20853,19973,1126,21099,239
2021-03-05,Plumas,063,18699,647,635,10,645,4
2021-03-05,Riverside,065,2383286,286813,280075,13323,293398,3781
2021-03-05,Sacramento,067,1510023,95597,94182,1264,95446,1430
2021-03-05,San Benito,069,59416,5766,5790,89,5879,61
2021-03-05,San Bernardino,071,2135413,286989,282640,8522,291162,3774
2021-03-05,San Diego,073,3302833,266075,262357,13097,275454,3371
2021-03-05,San Francisco,075,870044,34463,34526,1081,35607,430
2021-03-05,San Joaquin,077,732212,67542,66041,2773,68814,1133
2021-03-05,San Luis Obispo,079,281455,19902,19557,561,20118,244
2021-03-05,San Mateo,081,765935,39854,39305,408,39713,326
2021-03-05,Santa Barbara,083,443738,32614,32139,1037,33176,424
2021-03-05,Santa Clara,085,1922200,111612,111384,588,111972,1745
2021-03-05,Santa Cruz,087,273765,15547,14694,773,15467,188
2021-03-05,Shasta,089,179085,11029,11062,1261,12323,148
2021-03-05,Sierra,091,2930,51,48,12,60,0
2021-03-05,Siskiyou,093,43540,1530,1429,235,1664,5
2021-03-05,Solano,095,438530,30111,29951,368,30319,168
2021-03-05,Sonoma,097,501317,28397,28417,220,28637,279
2021-03-05,Stanislaus,099,539301,51254,50606,5351,55957,721
2021-03-05,Sutter,101,95872,8899,8876,79,8955,100
2021-03-05,Tehama,103,63373,4636,4606,486,5092,33
2021-03-05,Trinity,105,12862,468,302,77,379,3
2021-03-05,Tulare,107,460477,48608,47469,8070,55539,789
2021-03-05,Tuolumne,109,53932,3867,3917,36,3953,56
2021-03-05,Ventura,111,848112,78581,78368,2768,81136,839
2021-03-05,Yolo,113,214977,13022,12920,143,13063,188
2021-03-05,Yuba,115,75493,5571,5496,86,5582,42
2021-03-04,Alameda,001,1643700,81622,81115,1705,82820,1136
2021-03-04,Alpine,003,1148,82,78,0,78,0
2021-03-04,Amador,005,37829,3487,3480,31,3511,42
2021-03-04,Butte,007,227075,11429,11033,1609,12642,185
2021-03-04,Calaveras,009,45235,1932,1896,11,1907,48
2021-03-04,Colusa,011,21464,1879,1873,265,2138,11
2021-03-04,Contra Costa,013,1133247,63850,62789,1071,63860,708
2021-03-04,Del Norte,015,27424,1039,989,5,994,5
2021-03-04,El Dorado,017,186661,9229,9133,603,9736,97
2021-03-04,Fresno,019,978130,97251,96023,7742,103765,1422
2021-03-04,Glenn,021,27897,2270,2236,494,2730,15
2021-03-04,Humboldt,023,135768,3259,3212,22,3234,31
2021-03-04,Imperial,025,180216,27318,26946,2460,29406,646
2021-03-04,Inyo,027,18085,1331,1300,9,1309,35
2021-03-04,Kern,029,883053,94016,92525,9813,102338,1070
2021-03-04,Kings,031,150075,22402,22025,968,22993,224
2021-03-04,Lake,033,64148,3223,3181,6,3187,42
2021-03-04,Lassen,035,31185,5131,5116,96,5212,1
2021-03-04,Los Angeles,037,10098052,1177224,1159405,38713,1198118,21610
2021-03-04,Madera,039,155013,15788,15596,840,16436,208
2021-03-04,Marin,041,260295,13361,13240,162,13402,215
2021-03-04,Mariposa,043,17540,378,376,5,381,4
2021-03-04,Mendocino,045,87422,3672,3569,73,3642,42
2021-03-04,Merced,047,269075,28747,28671,925,29596,396
2021-03-04,Modoc,049,8938,344,336,116,452,3
2021-03-04,Mono,051,14174,1190,1197,15,1212,3
2021-03-04,Monterey,053,433212,42110,41771,1672,43443,325
2021-03-04,Napa,055,140530,9133,9094,32,9126,74
2021-03-04,Nevada,057,99092,4089,4020,161,4181,66
2021-03-04,Orange,059,3164182,248154,246354,10193,256547,4096
2021-03-04,Placer,061,380077,20821,19900,1120,21020,239
2021-03-04,Plumas,063,18699,647,634,10,644,4
2021-03-04,Riverside,065,2383286,286683,279871,13310,293181,3766
2021-03-04,Sacramento,067,1510023,95462,93982,1261,95243,1426
2021-03-04,San Benito,069,59416,5766,5781,89,5870,61
2021-03-04,San Bernardino,071,2135413,286859,282407,8518,290925,3757
2021-03-04,San Diego,073,3302833,265814,261858,13053,274911,3359
2021-03-04,San Francisco,075,870044,34428,34480,1078,35558,426
2021-03-04,San Joaquin,077,732212,67448,65931,2764,68695,1129
2021-03-04,San Luis Obispo,079,281455,19865,19520,559,20079,243
2021-03-04,San Mateo,081,765935,39810,39225,407,39632,322
2021-03-04,Santa Barbara,083,443738,32577,32090,1036,33126,423
2021-03-04,Santa Clara,085,1922200,111478,111194,586,111780,1723
2021-03-04,Santa Cruz,087,273765,15528,14669,773,15442,186
2021-03-04,Shasta,089,179085,11026,11050,1252,12302,150
2021-03-04,Sierra,091,2930,51,48,12,60,0
2021-03-04,Siskiyou,093,43540,1523,1427,235,1662,5
2021-03-04,Solano,095,438530,30084,29905,367,30272,168
2021-03-04,Sonoma,097,501317,28342,28379,219,28598,279
2021-03-04,Stanislaus,099,539301,51167,50521,5343,55864,731
2021-03-04,Sutter,101,95872,8887,8849,79,8928,100
2021-03-04,Tehama,103,63373,4628,4604,486,5090,33
2021-03-04,Trinity,105,12862,468,302,77,379,3
2021-03-04,Tulare,107,460477,48563,47398,8045,55443,784
2021-03-04,Tuolumne,109,53932,3861,3916,36,3952,56
2021-03-04,Ventura,111,848112,78491,78184,2765,80949,831
2021-03-04,Yolo,113,214977,13002,12895,143,13038,189
2021-03-04,Yuba,115,75493,5559,5483,86,5569,41
2021-03-03,Alameda,001,1643700,81501,80972,1704,82676,1127
2021-03-03,Alpine,003,1148,82,77,0,77,0
2021-03-03,Amador,005,37829,3485,3478,30,3508,42
2021-03-03,Butte,007,227075,11421,11014,1608,12622,184
2021-03-03,Calaveras,009,45235,1931,1893,11,1904,48
2021-03-03,Colusa,011,21464,1878,1873,265,2138,11
2021-03-03,Contra Costa,013,1133247,63752,62668,1068,63736,708
2021-03-03,Del Norte,015,27424,1036,988,5,993,5
2021-03-03,El Dorado,017,186661,9219,9121,603,9724,97
2021-03-03,Fresno,019,978130,97107,95893,7725,103618,1415
2021-03-03,Glenn,021,27897,2270,2233,494,2727,15
2021-03-03,Humboldt,023,135768,3248,3196,22,3218,30
2021-03-03,Imperial,025,180216,27302,26939,2456,29395,640
2021-03-03,Inyo,027,18085,1323,1294,9,1303,35
2021-03-03,Kern,029,883053,93940,92434,9796,102230,1063
2021-03-03,Kings,031,150075,22386,22009,967,22976,223
2021-03-03,Lake,033,64148,3216,3175,6,3181,40
2021-03-03,Lassen,035,31185,5131,5115,96,5211,1
2021-03-03,Los Angeles,037,10098052,1176584,1157911,38674,1196585,21500
2021-03-03,Madera,039,155013,15769,15553,834,16387,203
2021-03-03,Marin,041,260295,13347,13216,162,13378,214
2021-03-03,Mariposa,043,17540,377,376,5,381,4
2021-03-03,Mendocino,045,87422,3664,3564,73,3637,42
2021-03-03,Merced,047,269075,28695,28625,925,29550,393
2021-03-03,Modoc,049,8938,344,333,115,448,3
2021-03-03,Mono,051,14174,1190,1191,15,1206,3
2021-03-03,Monterey,053,433212,42078,41731,1669,43400,325
2021-03-03,Napa,055,140530,9125,9090,32,9122,72
2021-03-03,Nevada,057,99092,4079,4009,161,4170,66
2021-03-03,Orange,059,3164182,248008,246120,10179,256299,4072
2021-03-03,Placer,061,380077,20795,19851,1117,20968,239
2021-03-03,Plumas,063,18699,646,631,10,641,4
2021-03-03,Riverside,065,2383286,286550,279626,13304,292930,3735
2021-03-03,Sacramento,067,1510023,95301,93819,1253,95072,1419
2021-03-03,San Benito,069,59416,5765,5774,89,5863,61
2021-03-03,San Bernardino,071,2135413,286718,282138,8512,290650,3664
2021-03-03,San Diego,073,3302833,265550,261350,13022,274372,3342
2021-03-03,San Francisco,075,870044,34396,34443,1075,35518,426
2021-03-03,San Joaquin,077,732212,67335,65855,2757,68612,1115
2021-03-03,San Luis Obispo,079,281455,19839,19479,556,20035,241
2021-03-03,San Mateo,081,765935,39764,39189,406,39595,319
2021-03-03,Santa Barbara,083,443738,32539,32027,1036,33063,421
2021-03-03,Santa Clara,085,1922200,111324,110991,584,111575,1720
2021-03-03,Santa Cruz,087,273765,15517,14645,773,15418,185
2021-03-03,Shasta,089,179085,11016,11023,1245,12268,150
2021-03-03,Sierra,091,2930,51,48,12,60,0
2021-03-03,Siskiyou,093,43540,1521,1424,235,1659,5
2021-03-03,Solano,095,438530,30048,29866,366,30232,167
2021-03-03,Sonoma,097,501317,28303,28307,218,28525,279
2021-03-03,Stanislaus,099,539301,51089,50438,5336,55774,730
2021-03-03,Sutter,101,95872,8879,8840,79,8919,99
2021-03-03,Tehama,103,63373,4626,4601,486,5087,32
2021-03-03,Trinity,105,12862,468,302,77,379,3
2021-03-03,Tulare,107,460477,48512,47348,8016,55364,778
2021-03-03,Tuolumne,109,53932,3859,3914,35,3949,56
2021-03-03,Ventura,111,848112,78407,78057,2760,80817,822
2021-03-03,Yolo,113,214977,12989,12890,143,13033,189
2021-03-03,Yuba,115,75493,5546,5479,86,5565,41
2021-03-02,Alameda,001,1643700,81380,80904,1702,82606,1116
2021-03-02,Alpine,003,1148,82,77,0,77,0
2021-03-02,Amador,005,37829,3483,3474,30,3504,42
2021-03-02,Butte,007,227075,11411,11007,1605,12612,182
2021-03-02,Calaveras,009,45235,1923,1890,11,1901,48
2021-03-02,Colusa,011,21464,1878,1872,264,2136,11
2021-03-02,Contra Costa,013,1133247,63641,62557,1064,63621,694
2021-03-02,Del Norte,015,27424,1029,983,5,988,5
2021-03-02,El Dorado,017,186661,9211,9116,603,9719,98
2021-03-02,Fresno,019,978130,96961,95785,7699,103484,1410
2021-03-02,Glenn,021,27897,2264,2232,493,2725,15
2021-03-02,Humboldt,023,135768,3229,3184,22,3206,30
2021-03-02,Imperial,025,180216,27292,26926,2454,29380,637
2021-03-02,Inyo,027,18085,1319,1292,9,1301,35
2021-03-02,Kern,029,883053,93834,92313,9769,102082,1046
2021-03-02,Kings,031,150075,22334,21999,964,22963,217
2021-03-02,Lake,033,64148,3210,3169,6,3175,40
2021-03-02,Lassen,035,31185,5126,5115,95,5210,1
2021-03-02,Los Angeles,037,10098052,1175945,1156826,38629,1195455,21395
2021-03-02,Madera,039,155013,15749,15523,831,16354,194
2021-03-02,Marin,041,260295,13324,13186,161,13347,214
2021-03-02,Mariposa,043,17540,377,376,5,381,4
2021-03-02,Mendocino,045,87422,3661,3562,72,3634,41
2021-03-02,Merced,047,269075,28638,28598,925,29523,389
2021-03-02,Modoc,049,8938,344,332,115,447,3
2021-03-02,Mono,051,14174,1189,1191,15,1206,3
2021-03-02,Monterey,053,433212,42051,41716,1669,43385,325
2021-03-02,Napa,055,140530,9114,9080,32,9112,71
2021-03-02,Nevada,057,99092,4070,3983,160,4143,66
2021-03-02,Orange,059,3164182,247863,246004,10161,256165,4037
2021-03-02,Placer,061,380077,20742,19828,1114,20942,239
2021-03-02,Plumas,063,18699,643,628,10,638,4
2021-03-02,Riverside,065,2383286,286377,279486,13296,292782,3721
2021-03-02,Sacramento,067,1510023,95134,93690,1252,94942,1411
2021-03-02,San Benito,069,59416,5758,5770,89,5859,60
2021-03-02,San Bernardino,071,2135413,286584,281919,8506,290425,3604
2021-03-02,San Diego,073,3302833,265306,260998,13000,273998,3317
2021-03-02,San Francisco,075,870044,34356,34387,1071,35458,424
2021-03-02,San Joaquin,077,732212,67227,65769,2740,68509,1111
2021-03-02,San Luis Obispo,079,281455,19807,19452,556,20008,241
2021-03-02,San Mateo,081,765935,39712,39148,405,39553,317
2021-03-02,Santa Barbara,083,443738,32490,31964,1032,32996,416
2021-03-02,Santa Clara,085,1922200,111145,110832,583,111415,1706
2021-03-02,Santa Cruz,087,273765,15503,14611,771,15382,185
2021-03-02,Shasta,089,179085,11002,11012,1234,12246,149
2021-03-02,Sierra,091,2930,51,48,12,60,0
2021-03-02,Siskiyou,093,43540,1517,1412,233,1645,5
2021-03-02,Solano,095,438530,30015,29827,364,30191,167
2021-03-02,Sonoma,097,501317,28248,28261,218,28479,279
2021-03-02,Stanislaus,099,539301,51002,50359,5324,55683,724
2021-03-02,Sutter,101,95872,8870,8832,79,8911,99
2021-03-02,Tehama,103,63373,4622,4597,485,5082,32
2021-03-02,Trinity,105,12862,468,301,77,378,3
2021-03-02,Tulare,107,460477,48449,47326,7996,55322,783
2021-03-02,Tuolumne,109,53932,3855,3908,35,3943,53
2021-03-02,Ventura,111,848112,78314,77952,2756,80708,780
2021-03-02,Yolo,113,214977,12973,12867,143,13010,189
2021-03-02,Yuba,115,75493,5538,5475,86,5561,41
2021-03-01,Alameda,001,1643700,81253,80805,1700,82505,1105
2021-03-01,Alpine,003,1148,80,77,0,77,0
2021-03-01,Amador,005,37829,3480,3469,30,3499,42
2021-03-01,Butte,007,227075,11396,10981,1601,12582,180
2021-03-01,Calaveras,009,45235,1918,1885,11,1896,46
2021-03-01,Colusa,011,21464,1877,1871,264,2135,11
2021-03-01,Contra Costa,013,1133247,63533,62458,1063,63521,694
2021-03-01,Del Norte,015,27424,1024,982,5,987,5
2021-03-01,El Dorado,017,186661,9187,9085,603,9688,98
2021-03-01,Fresno,019,978130,96823,95677,7676,103353,1405
2021-03-01,Glenn,021,27897,2259,2232,492,2724,15
2021-03-01,Humboldt,023,135768,3210,3179,22,3201,30
2021-03-01,Imperial,025,180216,27282,26913,2446,29359,636
2021-03-01,Inyo,027,18085,1316,1285,9,1294,35
2021-03-01,Kern,029,883053,93745,92219,9743,101962,1041
2021-03-01,Kings,031,150075,22317,21988,958,22946,217
2021-03-01,Lake,033,64148,3205,3164,6,3170,40
2021-03-01,Lassen,035,31185,5124,5111,95,5206,1
2021-03-01,Los Angeles,037,10098052,1175286,1155984,38588,1194572,21293
2021-03-01,Madera,039,155013,15720,15505,821,16326,194
2021-03-01,Marin,041,260295,13296,13161,160,13321,214
2021-03-01,Mariposa,043,17540,377,375,5,380,4
2021-03-01,Mendocino,045,87422,3654,3561,72,3633,41
2021-03-01,Merced,047,269075,28593,28575,921,29496,385
2021-03-01,Modoc,049,8938,341,331,114,445,3
2021-03-01,Mono,051,14174,1188,1192,15,1207,3
2021-03-01,Monterey,053,433212,42026,41697,1667,43364,324
2021-03-01,Napa,055,140530,9105,9056,32,9088,70
2021-03-01,Nevada,057,99092,4051,3979,160,4139,66
2021-03-01,Orange,059,3164182,247670,245852,10147,255999,3976
2021-03-01,Placer,061,380077,20703,19803,1111,20914,239
2021-03-01,Plumas,063,18699,643,628,10,638,4
2021-03-01,Riverside,065,2383286,286160,279323,13289,292612,3680
2021-03-01,Sacramento,067,1510023,94989,93546,1250,94796,1401
2021-03-01,San Benito,069,59416,5753,5772,89,5861,57
2021-03-01,San Bernardino,071,2135413,286440,281685,8502,290187,3603
2021-03-01,San Diego,073,3302833,264989,260622,12967,273589,3303
2021-03-01,San Francisco,075,870044,34312,34318,1063,35381,424
2021-03-01,San Joaquin,077,732212,67118,65699,2730,68429,1097
2021-03-01,San Luis Obispo,079,281455,19785,19429,554,19983,239
2021-03-01,San Mateo,081,765935,39660,39096,405,39501,314
2021-03-01,Santa Barbara,083,443738,32447,31909,1031,32940,413
2021-03-01,Santa Clara,085,1922200,110986,110684,580,111264,1704
2021-03-01,Santa Cruz,087,273765,15484,14575,770,15345,185
2021-03-01,Shasta,089,179085,10990,10990,1231,12221,149
2021-03-01,Sierra,091,2930,51,48,12,60,0
2021-03-01,Siskiyou,093,43540,1513,1408,231,1639,5
2021-03-01,Solano,095,438530,29972,29779,363,30142,166
2021-03-01,Sonoma,097,501317,28200,28222,216,28438,278
2021-03-01,Stanislaus,099,539301,50928,50293,5318,55611,722
2021-03-01,Sutter,101,95872,8859,8825,79,8904,99
2021-03-01,Tehama,103,63373,4616,4595,485,5080,32
2021-03-01,Trinity,105,12862,468,298,76,374,3
2021-03-01,Tulare,107,460477,48411,47275,7963,55238,781
2021-03-01,Tuolumne,109,53932,3852,3907,35,3942,53
2021-03-01,Ventura,111,848112,78233,77849,2755,80604,775
2021-03-01,Yolo,113,214977,12956,12854,141,12995,188
2021-03-01,Yuba,115,75493,5526,5466,86,5552,41
2021-02-28,Alameda,001,1643700,81132,80727,1698,82425,1105
2021-02-28,Alpine,003,1148,80,77,0,77,0
2021-02-28,Amador,005,37829,3475,3466,29,3495,42
2021-02-28,Butte,007,227075,11381,10970,1601,12571,180
2021-02-28,Calaveras,009,45235,1914,1881,11,1892,46
2021-02-28,Colusa,011,21464,1877,1871,263,2134,11
2021-02-28,Contra Costa,013,1133247,63406,62386,1058,63444,694
2021-02-28,Del Norte,015,27424,1022,981,5,986,5
2021-02-28,El Dorado,017,186661,9176,9082,603,9685,98
2021-02-28,Fresno,019,978130,96641,95548,7642,103190,1405
2021-02-28,Glenn,021,27897,2257,2230,490,2720,15
2021-02-28,Humboldt,023,135768,3187,3179,22,3201,30
2021-02-28,Imperial,025,180216,27256,26909,2442,29351,636
2021-02-28,Inyo,027,18085,1311,1282,9,1291,35
2021-02-28,Kern,029,883053,93630,92169,9723,101892,1012
2021-02-28,Kings,031,150075,22296,21967,957,22924,217
2021-02-28,Lake,033,64148,3200,3164,6,3170,40
2021-02-28,Lassen,035,31185,5123,5106,95,5201,1
2021-02-28,Los Angeles,037,10098052,1174497,1155141,38526,1193667,21261
2021-02-28,Madera,039,155013,15678,15496,818,16314,199
2021-02-28,Marin,041,260295,13273,13152,158,13310,214
2021-02-28,Mariposa,043,17540,377,374,5,379,4
2021-02-28,Mendocino,045,87422,3648,3558,72,3630,41
2021-02-28,Merced,047,269075,28530,28546,920,29466,384
2021-02-28,Modoc,049,8938,341,331,114,445,3
2021-02-28,Mono,051,14174,1185,1192,15,1207,3
2021-02-28,Monterey,053,433212,41994,41683,1665,43348,323
2021-02-28,Napa,055,140530,9086,9053,32,9085,70
2021-02-28,Nevada,057,99092,4038,3972,160,4132,66
2021-02-28,Orange,059,3164182,247472,245706,10140,255846,3970
2021-02-28,Placer,061,380077,20657,19775,1109,20884,239
2021-02-28,Plumas,063,18699,643,628,10,638,4
2021-02-28,Riverside,065,2383286,285927,279214,13278,292492,3661
2021-02-28,Sacramento,067,1510023,94805,93463,1245,94708,1398
2021-02-28,San Benito,069,59416,5742,5772,89,5861,57
2021-02-28,San Bernardino,071,2135413,286298,281620,8490,290110,3595
2021-02-28,San Diego,073,3302833,264692,260353,12933,273286,3303
2021-02-28,San Francisco,075,870044,34270,34291,1057,35348,417
2021-02-28,San Joaquin,077,732212,67010,65662,2721,68383,1097
2021-02-28,San Luis Obispo,079,281455,19749,19422,552,19974,237
2021-02-28,San Mateo,081,765935,39607,39059,404,39463,314
2021-02-28,Santa Barbara,083,443738,32395,31877,1031,32908,413
2021-02-28,Santa Clara,085,1922200,110787,110556,577,111133,1704
2021-02-28,Santa Cruz,087,273765,15455,14571,767,15338,185
2021-02-28,Shasta,089,179085,10969,10990,1227,12217,149
2021-02-28,Sierra,091,2930,51,48,12,60,0
2021-02-28,Siskiyou,093,43540,1505,1408,231,1639,5
2021-02-28,Solano,095,438530,29917,29758,357,30115,166
2021-02-28,Sonoma,097,501317,28137,28193,215,28408,279
2021-02-28,Stanislaus,099,539301,50837,50228,5306,55534,728
2021-02-28,Sutter,101,95872,8844,8825,79,8904,99
2021-02-28,Tehama,103,63373,4611,4590,485,5075,32
2021-02-28,Trinity,105,12862,468,298,76,374,3
2021-02-28,Tulare,107,460477,48349,47258,7932,55190,780
2021-02-28,Tuolumne,109,53932,3847,3905,35,3940,53
2021-02-28,Ventura,111,848112,78121,77749,2752,80501,775
2021-02-28,Yolo,113,214977,12933,12851,141,12992,188
2021-02-28,Yuba,115,75493,5516,5461,86,5547,41
2021-02-27,Alameda,001,1643700,81059,80565,1696,82261,1108
2021-02-27,Alpine,003,1148,80,77,0,77,0
2021-02-27,Amador,005,37829,3473,3463,29,3492,42
2021-02-27,Butte,007,227075,11369,10962,1601,12563,180
2021-02-27,Calaveras,009,45235,1909,1875,11,1886,46
2021-02-27,Colusa,011,21464,1876,1869,263,2132,11
2021-02-27,Contra Costa,013,1133247,63336,62248,1055,63303,693
2021-02-27,Del Norte,015,27424,1020,978,5,983,5
2021-02-27,El Dorado,017,186661,9172,9072,603,9675,98
2021-02-27,Fresno,019,978130,96564,95393,7631,103024,1400
2021-02-27,Glenn,021,27897,2256,2225,489,2714,15
2021-02-27,Humboldt,023,135768,3181,3167,22,3189,30
2021-02-27,Imperial,025,180216,27248,26903,2440,29343,633
2021-02-27,Inyo,027,18085,1308,1275,9,1284,35
2021-02-27,Kern,029,883053,93569,92053,9708,101761,996
2021-02-27,Kings,031,150075,22286,21955,954,22909,216
2021-02-27,Lake,033,64148,3197,3156,6,3162,40
2021-02-27,Lassen,035,31185,5123,5106,95,5201,1
2021-02-27,Los Angeles,037,10098052,1173995,1154275,38499,1192774,21158
2021-02-27,Madera,039,155013,15661,15467,817,16284,199
2021-02-27,Marin,041,260295,13249,13134,158,13292,214
2021-02-27,Mariposa,043,17540,377,374,5,379,4
2021-02-27,Mendocino,045,87422,3645,3555,72,3627,41
2021-02-27,Merced,047,269075,28488,28501,912,29413,384
2021-02-27,Modoc,049,8938,341,331,113,444,3
2021-02-27,Mono,051,14174,1183,1191,15,1206,3
2021-02-27,Monterey,053,433212,41985,41665,1664,43329,322
2021-02-27,Napa,055,140530,9075,9038,32,9070,71
2021-02-27,Nevada,057,99092,4032,3960,160,4120,66
2021-02-27,Orange,059,3164182,247345,245542,10129,255671,3960
2021-02-27,Placer,061,380077,20621,19726,1106,20832,239
2021-02-27,Plumas,063,18699,643,628,10,638,4
2021-02-27,Riverside,065,2383286,285817,279048,13268,292316,3663
2021-02-27,Sacramento,067,1510023,94722,93281,1235,94516,1396
2021-02-27,San Benito,069,59416,5741,5767,88,5855,57
2021-02-27,San Bernardino,071,2135413,286218,281471,8485,289956,3527
2021-02-27,San Diego,073,3302833,264502,260091,12895,272986,3284
2021-02-27,San Francisco,075,870044,34236,34260,1054,35314,413
2021-02-27,San Joaquin,077,732212,66964,65578,2719,68297,1100
2021-02-27,San Luis Obispo,079,281455,19728,19411,551,19962,237
2021-02-27,San Mateo,081,765935,39566,38998,403,39401,313
2021-02-27,Santa Barbara,083,443738,32361,31805,1030,32835,411
2021-02-27,Santa Clara,085,1922200,110639,110361,575,110936,1703
2021-02-27,Santa Cruz,087,273765,15446,14552,766,15318,185
2021-02-27,Shasta,089,179085,10963,10985,1223,12208,149
2021-02-27,Sierra,091,2930,51,48,12,60,0
2021-02-27,Siskiyou,093,43540,1503,1407,230,1637,5
2021-02-27,Solano,095,438530,29889,29718,356,30074,165
2021-02-27,Sonoma,097,501317,28093,28141,210,28351,281
2021-02-27,Stanislaus,099,539301,50782,50147,5296,55443,733
2021-02-27,Sutter,101,95872,8839,8820,79,8899,99
2021-02-27,Tehama,103,63373,4606,4584,484,5068,32
2021-02-27,Trinity,105,12862,468,298,76,374,3
2021-02-27,Tulare,107,460477,48312,47209,7906,55115,770
2021-02-27,Tuolumne,109,53932,3844,3899,35,3934,53
2021-02-27,Ventura,111,848112,78048,77623,2749,80372,771
2021-02-27,Yolo,113,214977,12921,12834,141,12975,188
2021-02-27,Yuba,115,75493,5513,5450,86,5536,39
2021-02-26,Alameda,001,1643700,80964,80387,1691,82078,1106
2021-02-26,Alpine,003,1148,80,77,0,77,0
2021-02-26,Amador,005,37829,3467,3457,29,3486,42
2021-02-26,Butte,007,227075,11359,10941,1601,12542,180
2021-02-26,Calaveras,009,45235,1907,1873,11,1884,46
2021-02-26,Colusa,011,21464,1876,1865,263,2128,11
2021-02-26,Contra Costa,013,1133247,63254,62114,1055,63169,685
2021-02-26,Del Norte,015,27424,1016,968,5,973,5
2021-02-26,El Dorado,017,186661,9167,9038,601,9639,98
2021-02-26,Fresno,019,978130,96462,95202,7623,102825,1391
2021-02-26,Glenn,021,27897,2253,2220,489,2709,15
2021-02-26,Humboldt,023,135768,3175,3152,22,3174,30
2021-02-26,Imperial,025,180216,27241,26888,2438,29326,631
2021-02-26,Inyo,027,18085,1306,1271,9,1280,34
2021-02-26,Kern,029,883053,93490,91884,9692,101576,997
2021-02-26,Kings,031,150075,22270,21917,951,22868,216
2021-02-26,Lake,033,64148,3192,3153,6,3159,40
2021-02-26,Lassen,035,31185,5123,5102,95,5197,1
2021-02-26,Los Angeles,037,10098052,1173417,1153131,38439,1191570,21070
2021-02-26,Madera,039,155013,15645,15436,815,16251,199
2021-02-26,Marin,041,260295,13236,13091,158,13249,214
2021-02-26,Mariposa,043,17540,377,375,5,380,4
2021-02-26,Mendocino,045,87422,3640,3549,72,3621,41
2021-02-26,Merced,047,269075,28454,28455,911,29366,382
2021-02-26,Modoc,049,8938,340,330,113,443,3
2021-02-26,Mono,051,14174,1181,1191,15,1206,3
2021-02-26,Monterey,053,433212,41959,41607,1663,43270,322
2021-02-26,Napa,055,140530,9069,9014,32,9046,70
2021-02-26,Nevada,057,99092,4021,3952,160,4112,66
2021-02-26,Orange,059,3164182,247206,245278,10119,255397,3918
2021-02-26,Placer,061,380077,20595,19712,1100,20812,239
2021-02-26,Plumas,063,18699,643,628,10,638,4
2021-02-26,Riverside,065,2383286,285673,278772,13262,292034,3653
2021-02-26,Sacramento,067,1510023,94599,93180,1232,94412,1390
2021-02-26,San Benito,069,59416,5740,5759,88,5847,57
2021-02-26,San Bernardino,071,2135413,286118,281132,8483,289615,3461
2021-02-26,San Diego,073,3302833,264274,259641,12874,272515,3271
2021-02-26,San Francisco,075,870044,34206,34213,1051,35264,413
2021-02-26,San Joaquin,077,732212,66883,65492,2713,68205,1070
2021-02-26,San Luis Obispo,079,281455,19712,19359,549,19908,234
2021-02-26,San Mateo,081,765935,39521,38922,403,39325,313
2021-02-26,Santa Barbara,083,443738,32317,31724,1029,32753,410
2021-02-26,Santa Clara,085,1922200,110507,110168,573,110741,1700
2021-02-26,Santa Cruz,087,273765,15434,14528,765,15293,185
2021-02-26,Shasta,089,179085,10956,10972,1214,12186,149
2021-02-26,Sierra,091,2930,51,47,12,59,0
2021-02-26,Siskiyou,093,43540,1503,1401,229,1630,5
2021-02-26,Solano,095,438530,29855,29651,355,30006,165
2021-02-26,Sonoma,097,501317,28064,28063,209,28272,280
2021-02-26,Stanislaus,099,539301,50726,50054,5288,55342,737
2021-02-26,Sutter,101,95872,8830,8806,79,8885,99
2021-02-26,Tehama,103,63373,4604,4581,484,5065,32
2021-02-26,Trinity,105,12862,467,298,76,374,3
2021-02-26,Tulare,107,460477,48277,47135,7877,55012,770
2021-02-26,Tuolumne,109,53932,3843,3896,35,3931,53
2021-02-26,Ventura,111,848112,77948,77534,2745,80279,765
2021-02-26,Yolo,113,214977,12914,12816,141,12957,188
2021-02-26,Yuba,115,75493,5508,5438,86,5524,39
2021-02-25,Alameda,001,1643700,80843,80181,1690,81871,1093
2021-02-25,Alpine,003,1148,80,77,0,77,0
2021-02-25,Amador,005,37829,3464,3448,29,3477,41
2021-02-25,Butte,007,227075,11338,10922,1596,12518,178
2021-02-25,Calaveras,009,45235,1899,1868,11,1879,46
2021-02-25,Colusa,011,21464,1873,1863,262,2125,11
2021-02-25,Contra Costa,013,1133247,63152,61910,1055,62965,686
2021-02-25,Del Norte,015,27424,1006,966,5,971,5
2021-02-25,El Dorado,017,186661,9151,9012,601,9613,98
2021-02-25,Fresno,019,978130,96318,95015,7602,102617,1377
2021-02-25,Glenn,021,27897,2250,2219,488,2707,15
2021-02-25,Humboldt,023,135768,3168,3129,22,3151,30
2021-02-25,Imperial,025,180216,27234,26855,2434,29289,628
2021-02-25,Inyo,027,18085,1300,1264,9,1273,33
2021-02-25,Kern,029,883053,93374,91735,9667,101402,992
2021-02-25,Kings,031,150075,22261,21900,948,22848,216
2021-02-25,Lake,033,64148,3183,3141,6,3147,40
2021-02-25,Lassen,035,31185,5122,5097,94,5191,1
2021-02-25,Los Angeles,037,10098052,1172670,1151846,38381,1190227,20931
2021-02-25,Madera,039,155013,15610,15414,811,16225,194
2021-02-25,Marin,041,260295,13213,13067,158,13225,214
2021-02-25,Mariposa,043,17540,377,375,5,380,4
2021-02-25,Mendocino,045,87422,3635,3542,72,3614,41
2021-02-25,Merced,047,269075,28405,28383,909,29292,382
2021-02-25,Modoc,049,8938,340,329,113,442,3
2021-02-25,Mono,051,14174,1180,1190,15,1205,3
2021-02-25,Monterey,053,433212,41934,41564,1658,43222,321
2021-02-25,Napa,055,140530,9043,8998,32,9030,70
2021-02-25,Nevada,057,99092,4004,3940,159,4099,66
2021-02-25,Orange,059,3164182,247033,245000,10109,255109,3882
2021-02-25,Placer,061,380077,20556,19661,1098,20759,239
2021-02-25,Plumas,063,18699,643,626,10,636,4
2021-02-25,Riverside,065,2383286,285485,278544,13242,291786,3646
2021-02-25,Sacramento,067,1510023,94441,92961,1220,94181,1386
2021-02-25,San Benito,069,59416,5735,5752,88,5840,58
2021-02-25,San Bernardino,071,2135413,285983,280946,8475,289421,3409
2021-02-25,San Diego,073,3302833,263980,258979,12844,271823,3260
2021-02-25,San Francisco,075,870044,34163,34138,1049,35187,408
2021-02-25,San Joaquin,077,732212,66799,65389,2701,68090,1047
2021-02-25,San Luis Obispo,079,281455,19691,19335,547,19882,234
2021-02-25,San Mateo,081,765935,39474,38872,403,39275,300
2021-02-25,Santa Barbara,083,443738,32240,31631,1028,32659,408
2021-02-25,Santa Clara,085,1922200,110342,109923,572,110495,1677
2021-02-25,Santa Cruz,087,273765,15415,14492,764,15256,185
2021-02-25,Shasta,089,179085,10944,10947,1209,12156,148
2021-02-25,Sierra,091,2930,51,47,12,59,0
2021-02-25,Siskiyou,093,43540,1498,1390,226,1616,4
2021-02-25,Solano,095,438530,29823,29616,355,29971,161
2021-02-25,Sonoma,097,501317,28010,28004,206,28210,278
2021-02-25,Stanislaus,099,539301,50635,49964,5278,55242,738
2021-02-25,Sutter,101,95872,8816,8789,78,8867,99
2021-02-25,Tehama,103,63373,4601,4578,482,5060,32
2021-02-25,Trinity,105,12862,467,297,76,373,3
2021-02-25,Tulare,107,460477,48227,47052,7851,54903,765
2021-02-25,Tuolumne,109,53932,3840,3894,35,3929,53
2021-02-25,Ventura,111,848112,77840,77395,2739,80134,751
2021-02-25,Yolo,113,214977,12897,12787,141,12928,188
2021-02-25,Yuba,115,75493,5501,5429,86,5515,39
2021-02-24,Alameda,001,1643700,80723,80070,1686,81756,1082
2021-02-24,Alpine,003,1148,79,77,0,77,0
2021-02-24,Amador,005,37829,3459,3444,29,3473,41
2021-02-24,Butte,007,227075,11325,10915,1592,12507,178
2021-02-24,Calaveras,009,45235,1895,1864,11,1875,31
2021-02-24,Colusa,011,21464,1871,1863,262,2125,11
2021-02-24,Contra Costa,013,1133247,63044,61776,1055,62831,663
2021-02-24,Del Norte,015,27424,1005,960,4,964,5
2021-02-24,El Dorado,017,186661,9138,8993,601,9594,98
2021-02-24,Fresno,019,978130,96170,94794,7586,102380,1369
2021-02-24,Glenn,021,27897,2249,2210,488,2698,14
2021-02-24,Humboldt,023,135768,3156,3123,22,3145,29
2021-02-24,Imperial,025,180216,27221,26843,2429,29272,596
2021-02-24,Inyo,027,18085,1295,1253,9,1262,32
2021-02-24,Kern,029,883053,93241,91525,9651,101176,992
2021-02-24,Kings,031,150075,22236,21871,946,22817,216
2021-02-24,Lake,033,64148,3176,3134,6,3140,40
2021-02-24,Lassen,035,31185,5118,5095,93,5188,1
2021-02-24,Los Angeles,037,10098052,1171907,1150322,38342,1188664,20817
2021-02-24,Madera,039,155013,15583,15390,811,16201,194
2021-02-24,Marin,041,260295,13190,13044,157,13201,214
2021-02-24,Mariposa,043,17540,377,374,5,379,4
2021-02-24,Mendocino,045,87422,3628,3540,72,3612,41
2021-02-24,Merced,047,269075,28367,28295,905,29200,383
2021-02-24,Modoc,049,8938,339,329,113,442,3
2021-02-24,Mono,051,14174,1178,1189,15,1204,3
2021-02-24,Monterey,053,433212,41909,41495,1656,43151,320
2021-02-24,Napa,055,140530,9026,8976,31,9007,70
2021-02-24,Nevada,057,99092,3994,3927,159,4086,66
2021-02-24,Orange,059,3164182,246815,244743,10096,254839,3835
2021-02-24,Placer,061,380077,20517,19648,1092,20740,239
2021-02-24,Plumas,063,18699,641,626,10,636,4
2021-02-24,Riverside,065,2383286,285257,278293,13233,291526,3603
2021-02-24,Sacramento,067,1510023,94287,92742,1215,93957,1375
2021-02-24,San Benito,069,59416,5734,5743,88,5831,57
2021-02-24,San Bernardino,071,2135413,285831,280583,8471,289054,3360
2021-02-24,San Diego,073,3302833,263684,258460,12828,271288,3230
2021-02-24,San Francisco,075,870044,34117,34061,1046,35107,406
2021-02-24,San Joaquin,077,732212,66689,65274,2699,67973,1019
2021-02-24,San Luis Obispo,079,281455,19668,19309,545,19854,233
2021-02-24,San Mateo,081,765935,39437,38763,403,39166,300
2021-02-24,Santa Barbara,083,443738,32188,31563,1025,32588,405
2021-02-24,Santa Clara,085,1922200,110194,109671,571,110242,1674
2021-02-24,Santa Cruz,087,273765,15394,14458,764,15222,185
2021-02-24,Shasta,089,179085,10931,10922,1206,12128,148
2021-02-24,Sierra,091,2930,51,47,12,59,0
2021-02-24,Siskiyou,093,43540,1491,1385,222,1607,4
2021-02-24,Solano,095,438530,29783,29577,353,29930,158
2021-02-24,Sonoma,097,501317,27946,27954,202,28156,278
2021-02-24,Stanislaus,099,539301,50564,49851,5271,55122,732
2021-02-24,Sutter,101,95872,8806,8778,78,8856,99
2021-02-24,Tehama,103,63373,4598,4566,482,5048,31
2021-02-24,Trinity,105,12862,467,294,75,369,3
2021-02-24,Tulare,107,460477,48171,46976,7823,54799,759
2021-02-24,Tuolumne,109,53932,3837,3887,35,3922,53
2021-02-24,Ventura,111,848112,77732,77238,2738,79976,718
2021-02-24,Yolo,113,214977,12884,12760,141,12901,188
2021-02-24,Yuba,115,75493,5490,5425,84,5509,39
2021-02-23,Alameda,001,1643700,80585,79948,1684,81632,1070
2021-02-23,Alpine,003,1148,78,77,0,77,0
2021-02-23,Amador,005,37829,3457,3440,29,3469,41
2021-02-23,Butte,007,227075,11309,10887,1589,12476,176
2021-02-23,Calaveras,009,45235,1894,1863,11,1874,21
2021-02-23,Colusa,011,21464,1868,1862,262,2124,11
2021-02-23,Contra Costa,013,1133247,62910,61613,1052,62665,661
2021-02-23,Del Norte,015,27424,1003,953,4,957,3
2021-02-23,El Dorado,017,186661,9125,8969,601,9570,96
2021-02-23,Fresno,019,978130,96009,94741,7572,102313,1356
2021-02-23,Glenn,021,27897,2247,2209,488,2697,14
2021-02-23,Humboldt,023,135768,3139,3108,22,3130,29
2021-02-23,Imperial,025,180216,27201,26816,2424,29240,591
2021-02-23,Inyo,027,18085,1291,1250,9,1259,32
2021-02-23,Kern,029,883053,93102,91390,9623,101013,982
2021-02-23,Kings,031,150075,22221,21839,942,22781,216
2021-02-23,Lake,033,64148,3168,3121,6,3127,40
2021-02-23,Lassen,035,31185,5115,5092,93,5185,1
2021-02-23,Los Angeles,037,10098052,1171033,1148965,38289,1187254,19887
2021-02-23,Madera,039,155013,15569,15352,805,16157,193
2021-02-23,Marin,041,260295,13170,13015,156,13171,214
2021-02-23,Mariposa,043,17540,377,374,5,379,4
2021-02-23,Mendocino,045,87422,3626,3540,71,3611,41
2021-02-23,Merced,047,269075,28287,28209,898,29107,381
2021-02-23,Modoc,049,8938,338,328,112,440,3
2021-02-23,Mono,051,14174,1178,1189,15,1204,3
2021-02-23,Monterey,053,433212,41870,41439,1651,43090,317
2021-02-23,Napa,055,140530,9014,8967,31,8998,70
2021-02-23,Nevada,057,99092,3986,3912,159,4071,66
2021-02-23,Orange,059,3164182,246617,244566,10078,254644,3843
2021-02-23,Placer,061,380077,20492,19608,1088,20696,238
2021-02-23,Plumas,063,18699,640,626,10,636,4
2021-02-23,Riverside,065,2383286,285020,278075,13219,291294,3599
2021-02-23,Sacramento,067,1510023,94130,92632,1209,93841,1370
2021-02-23,San Benito,069,59416,5728,5731,87,5818,57
2021-02-23,San Bernardino,071,2135413,285643,280279,8466,288745,3283
2021-02-23,San Diego,073,3302833,263307,257802,12798,270600,3218
2021-02-23,San Francisco,075,870044,34069,33994,1045,35039,405
2021-02-23,San Joaquin,077,732212,66589,65141,2692,67833,1004
2021-02-23,San Luis Obispo,079,281455,19639,19233,544,19777,230
2021-02-23,San Mateo,081,765935,39376,38662,403,39065,299
2021-02-23,Santa Barbara,083,443738,32133,31483,1024,32507,402
2021-02-23,Santa Clara,085,1922200,109997,109449,568,110017,1661
2021-02-23,Santa Cruz,087,273765,15365,14435,762,15197,178
2021-02-23,Shasta,089,179085,10919,10903,1202,12105,146
2021-02-23,Sierra,091,2930,51,47,12,59,0
2021-02-23,Siskiyou,093,43540,1486,1380,220,1600,4
2021-02-23,Solano,095,438530,29743,29545,350,29895,154
2021-02-23,Sonoma,097,501317,27903,27882,199,28081,278
2021-02-23,Stanislaus,099,539301,50486,49749,5255,55004,722
2021-02-23,Sutter,101,95872,8793,8766,78,8844,98
2021-02-23,Tehama,103,63373,4592,4556,481,5037,30
2021-02-23,Trinity,105,12862,467,292,74,366,3
2021-02-23,Tulare,107,460477,48093,46937,7790,54727,757
2021-02-23,Tuolumne,109,53932,3833,3864,35,3899,53
2021-02-23,Ventura,111,848112,77616,77093,2729,79822,689
2021-02-23,Yolo,113,214977,12855,12729,141,12870,188
2021-02-23,Yuba,115,75493,5477,5417,83,5500,38
2021-02-22,Alameda,001,1643700,80434,79796,1680,81476,1062
2021-02-22,Alpine,003,1148,78,77,0,77,0
2021-02-22,Amador,005,37829,3452,3438,29,3467,39
2021-02-22,Butte,007,227075,11296,10855,1584,12439,176
2021-02-22,Calaveras,009,45235,1892,1862,11,1873,21
2021-02-22,Colusa,011,21464,1868,1860,262,2122,11
2021-02-22,Contra Costa,013,1133247,62782,61478,1051,62529,661
2021-02-22,Del Norte,015,27424,1002,948,4,952,3
2021-02-22,El Dorado,017,186661,9108,8940,601,9541,96
2021-02-22,Fresno,019,978130,95847,94584,7555,102139,1351
2021-02-22,Glenn,021,27897,2242,2207,486,2693,14
2021-02-22,Humboldt,023,135768,3127,3095,22,3117,29
2021-02-22,Imperial,025,180216,27179,26778,2417,29195,590
2021-02-22,Inyo,027,18085,1286,1248,9,1257,32
2021-02-22,Kern,029,883053,92985,91201,9601,100802,982
2021-02-22,Kings,031,150075,22198,21801,939,22740,214
2021-02-22,Lake,033,64148,3162,3107,6,3113,40
2021-02-22,Lassen,035,31185,5115,5088,92,5180,1
2021-02-22,Los Angeles,037,10098052,1170164,1147541,38231,1185772,19730
2021-02-22,Madera,039,155013,15544,15325,801,16126,193
2021-02-22,Marin,041,260295,13145,12991,153,13144,213
2021-02-22,Mariposa,043,17540,376,374,5,379,4
2021-02-22,Mendocino,045,87422,3620,3535,71,3606,41
2021-02-22,Merced,047,269075,28224,28166,895,29061,379
2021-02-22,Modoc,049,8938,338,329,112,441,3
2021-02-22,Mono,051,14174,1174,1189,15,1204,3
2021-02-22,Monterey,053,433212,41825,41397,1645,43042,311
2021-02-22,Napa,055,140530,8987,8950,31,8981,69
2021-02-22,Nevada,057,99092,3977,3900,157,4057,66
2021-02-22,Orange,059,3164182,246381,244118,10060,254178,3843
2021-02-22,Placer,061,380077,20455,19587,1080,20667,238
2021-02-22,Plumas,063,18699,640,625,10,635,4
2021-02-22,Riverside,065,2383286,284756,277730,13211,290941,3567
2021-02-22,Sacramento,067,1510023,93963,92476,1199,93675,1359
2021-02-22,San Benito,069,59416,5726,5723,87,5810,57
2021-02-22,San Bernardino,071,2135413,285466,279984,8453,288437,3259
2021-02-22,San Diego,073,3302833,262897,257348,12765,270113,3189
2021-02-22,San Francisco,075,870044,34009,33947,1040,34987,405
2021-02-22,San Joaquin,077,732212,66493,65060,2679,67739,1001
2021-02-22,San Luis Obispo,079,281455,19602,19198,542,19740,229
2021-02-22,San Mateo,081,765935,39319,38542,400,38942,282
2021-02-22,Santa Barbara,083,443738,32067,31421,1021,32442,399
2021-02-22,Santa Clara,085,1922200,109788,109213,557,109770,1655
2021-02-22,Santa Cruz,087,273765,15339,14417,762,15179,176
2021-02-22,Shasta,089,179085,10904,10872,1197,12069,145
2021-02-22,Sierra,091,2930,51,47,12,59,0
2021-02-22,Siskiyou,093,43540,1480,1373,219,1592,4
2021-02-22,Solano,095,438530,29704,29508,349,29857,150
2021-02-22,Sonoma,097,501317,27858,27845,198,28043,278
2021-02-22,Stanislaus,099,539301,50384,49630,5237,54867,722
2021-02-22,Sutter,101,95872,8785,8698,78,8776,98
2021-02-22,Tehama,103,63373,4589,4550,480,5030,30
2021-02-22,Trinity,105,12862,467,287,73,360,3
2021-02-22,Tulare,107,460477,48031,46879,7758,54637,751
2021-02-22,Tuolumne,109,53932,3829,3856,35,3891,53
2021-02-22,Ventura,111,848112,77488,76947,2724,79671,677
2021-02-22,Yolo,113,214977,12828,12689,141,12830,183
2021-02-22,Yuba,115,75493,5474,5404,82,5486,38
2021-02-21,Alameda,001,1643700,80241,79649,1675,81324,1061
2021-02-21,Alpine,003,1148,78,77,0,77,0
2021-02-21,Amador,005,37829,3444,3435,29,3464,39
2021-02-21,Butte,007,227075,11278,10855,1582,12437,176
2021-02-21,Calaveras,009,45235,1891,1860,11,1871,21
2021-02-21,Colusa,011,21464,1867,1860,258,2118,11
2021-02-21,Contra Costa,013,1133247,62627,61364,1048,62412,661
2021-02-21,Del Norte,015,27424,996,942,4,946,3
2021-02-21,El Dorado,017,186661,9090,8927,600,9527,96
2021-02-21,Fresno,019,978130,95705,94374,7539,101913,1349
2021-02-21,Glenn,021,27897,2240,2201,484,2685,14
2021-02-21,Humboldt,023,135768,3115,3096,22,3118,29
2021-02-21,Imperial,025,180216,27165,26779,2415,29194,590
2021-02-21,Inyo,027,18085,1280,1232,9,1241,32
2021-02-21,Kern,029,883053,92860,91141,9563,100704,980
2021-02-21,Kings,031,150075,22162,21784,937,22721,213
2021-02-21,Lake,033,64148,3154,3100,6,3106,40
2021-02-21,Lassen,035,31185,5107,5077,92,5169,1
2021-02-21,Los Angeles,037,10098052,1169122,1146756,38186,1184942,19711
2021-02-21,Madera,039,155013,15511,15298,798,16096,192
2021-02-21,Marin,041,260295,13116,12968,153,13121,212
2021-02-21,Mariposa,043,17540,376,373,5,378,4
2021-02-21,Mendocino,045,87422,3615,3535,71,3606,41
2021-02-21,Merced,047,269075,28150,28106,880,28986,379
2021-02-21,Modoc,049,8938,335,329,112,441,3
2021-02-21,Mono,051,14174,1174,1189,15,1204,3
2021-02-21,Monterey,053,433212,41769,41373,1638,43011,309
2021-02-21,Napa,055,140530,8973,8929,31,8960,69
2021-02-21,Nevada,057,99092,3964,3895,157,4052,66
2021-02-21,Orange,059,3164182,246084,243985,10043,254028,3801
2021-02-21,Placer,061,380077,20419,19553,1076,20629,238
2021-02-21,Plumas,063,18699,640,625,10,635,4
2021-02-21,Riverside,065,2383286,284523,277555,13198,290753,3564
2021-02-21,Sacramento,067,1510023,93753,92288,1188,93476,1354
2021-02-21,San Benito,069,59416,5716,5716,84,5800,57
2021-02-21,San Bernardino,071,2135413,285242,279870,8439,288309,3247
2021-02-21,San Diego,073,3302833,262463,257027,12719,269746,3190
2021-02-21,San Francisco,075,870044,33945,33891,1036,34927,405
2021-02-21,San Joaquin,077,732212,66354,64997,2667,67664,1001
2021-02-21,San Luis Obispo,079,281455,19569,19178,540,19718,229
2021-02-21,San Mateo,081,765935,39257,38448,396,38844,282
2021-02-21,Santa Barbara,083,443738,32005,31374,1018,32392,399
2021-02-21,Santa Clara,085,1922200,109562,108992,549,109541,1654
2021-02-21,Santa Cruz,087,273765,15316,14401,761,15162,176
2021-02-21,Shasta,089,179085,10890,10867,1192,12059,145
2021-02-21,Sierra,091,2930,51,47,12,59,0
2021-02-21,Siskiyou,093,43540,1474,1371,219,1590,4
2021-02-21,Solano,095,438530,29649,29471,348,29819,150
2021-02-21,Sonoma,097,501317,27794,27793,191,27984,278
2021-02-21,Stanislaus,099,539301,50271,49527,5223,54750,726
2021-02-21,Sutter,101,95872,8768,8687,77,8764,97
2021-02-21,Tehama,103,63373,4580,4547,480,5027,30
2021-02-21,Trinity,105,12862,465,286,73,359,3
2021-02-21,Tulare,107,460477,47963,46830,7723,54553,749
2021-02-21,Tuolumne,109,53932,3815,3828,35,3863,53
2021-02-21,Ventura,111,848112,77339,76862,2711,79573,677
2021-02-21,Yolo,113,214977,12797,12670,140,12810,183
2021-02-21,Yuba,115,75493,5466,5396,81,5477,38
2021-02-20,Alameda,001,1643700,80150,79496,1670,81166,1055
2021-02-20,Alpine,003,1148,78,77,0,77,0
2021-02-20,Amador,005,37829,3442,3432,29,3461,39
2021-02-20,Butte,007,227075,11270,10838,1581,12419,176
2021-02-20,Calaveras,009,45235,1890,1858,11,1869,21
2021-02-20,Colusa,011,21464,1866,1858,258,2116,11
2021-02-20,Contra Costa,013,1133247,62543,61205,1046,62251,663
2021-02-20,Del Norte,015,27424,992,937,4,941,3
2021-02-20,El Dorado,017,186661,9080,8911,600,9511,96
2021-02-20,Fresno,019,978130,95621,94234,7519,101753,1341
2021-02-20,Glenn,021,27897,2236,2199,483,2682,14
2021-02-20,Humboldt,023,135768,3107,3073,22,3095,29
2021-02-20,Imperial,025,180216,27155,26771,2415,29186,590
2021-02-20,Inyo,027,18085,1276,1226,9,1235,32
2021-02-20,Kern,029,883053,92789,91025,9531,100556,968
2021-02-20,Kings,031,150075,22144,21773,936,22709,212
2021-02-20,Lake,033,64148,3147,3089,6,3095,40
2021-02-20,Lassen,035,31185,5105,5067,92,5159,1
2021-02-20,Los Angeles,037,10098052,1168552,1145594,38146,1183740,19630
2021-02-20,Madera,039,155013,15491,15274,797,16071,191
2021-02-20,Marin,041,260295,13095,12945,151,13096,211
2021-02-20,Mariposa,043,17540,376,372,5,377,4
2021-02-20,Mendocino,045,87422,3613,3533,71,3604,40
2021-02-20,Merced,047,269075,28107,28066,877,28943,379
2021-02-20,Modoc,049,8938,335,328,112,440,3
2021-02-20,Mono,051,14174,1173,1187,15,1202,3
2021-02-20,Monterey,053,433212,41747,41313,1636,42949,309
2021-02-20,Napa,055,140530,8964,8910,31,8941,69
2021-02-20,Nevada,057,99092,3954,3887,156,4043,66
2021-02-20,Orange,059,3164182,245915,243761,10029,253790,3755
2021-02-20,Placer,061,380077,20378,19509,1072,20581,236
2021-02-20,Plumas,063,18699,640,626,10,636,4
2021-02-20,Riverside,065,2383286,284369,277267,13189,290456,3559
2021-02-20,Sacramento,067,1510023,93630,92057,1186,93243,1352
2021-02-20,San Benito,069,59416,5705,5709,84,5793,57
2021-02-20,San Bernardino,071,2135413,285140,279608,8434,288042,3203
2021-02-20,San Diego,073,3302833,262221,256510,12690,269200,3188
2021-02-20,San Francisco,075,870044,33903,33820,1028,34848,399
2021-02-20,San Joaquin,077,732212,66284,64916,2662,67578,1001
2021-02-20,San Luis Obispo,079,281455,19545,19138,539,19677,229
2021-02-20,San Mateo,081,765935,39213,38371,395,38766,282
2021-02-20,Santa Barbara,083,443738,31971,31289,1017,32306,396
2021-02-20,Santa Clara,085,1922200,109384,108728,546,109274,1649
2021-02-20,Santa Cruz,087,273765,15305,14378,759,15137,176
2021-02-20,Shasta,089,179085,10876,10850,1187,12037,146
2021-02-20,Sierra,091,2930,51,47,12,59,0
2021-02-20,Siskiyou,093,43540,1471,1366,219,1585,4
2021-02-20,Solano,095,438530,29635,29440,346,29786,150
2021-02-20,Sonoma,097,501317,27765,27703,189,27892,278
2021-02-20,Stanislaus,099,539301,50220,49445,5209,54654,733
2021-02-20,Sutter,101,95872,8762,8681,77,8758,97
2021-02-20,Tehama,103,63373,4575,4545,480,5025,30
2021-02-20,Trinity,105,12862,464,285,72,357,3
2021-02-20,Tulare,107,460477,47927,46769,7701,54470,739
2021-02-20,Tuolumne,109,53932,3810,3823,35,3858,53
2021-02-20,Ventura,111,848112,77244,76757,2708,79465,671
2021-02-20,Yolo,113,214977,12783,12639,140,12779,183
2021-02-20,Yuba,115,75493,5463,5386,81,5467,38
2021-02-19,Alameda,001,1643700,80049,79318,1666,80984,1047
2021-02-19,Alpine,003,1148,78,77,0,77,0
2021-02-19,Amador,005,37829,3438,3427,29,3456,39
2021-02-19,Butte,007,227075,11256,10823,1574,12397,176
2021-02-19,Calaveras,009,45235,1889,1856,11,1867,21
2021-02-19,Colusa,011,21464,1866,1858,258,2116,11
2021-02-19,Contra Costa,013,1133247,62431,61017,1043,62060,651
2021-02-19,Del Norte,015,27424,987,932,4,936,2
2021-02-19,El Dorado,017,186661,9071,8882,599,9481,96
2021-02-19,Fresno,019,978130,95491,93973,7503,101476,1330
2021-02-19,Glenn,021,27897,2231,2199,482,2681,14
2021-02-19,Humboldt,023,135768,3095,3037,22,3059,29
2021-02-19,Imperial,025,180216,27149,26751,2412,29163,589
2021-02-19,Inyo,027,18085,1271,1212,9,1221,32
2021-02-19,Kern,029,883053,92720,90807,9491,100298,963
2021-02-19,Kings,031,150075,22130,21724,934,22658,211
2021-02-19,Lake,033,64148,3141,3078,6,3084,40
2021-02-19,Lassen,035,31185,5104,5057,92,5149,1
2021-02-19,Los Angeles,037,10098052,1167802,1143828,38106,1181934,19498
2021-02-19,Madera,039,155013,15474,15222,795,16017,188
2021-02-19,Marin,041,260295,13077,12919,150,13069,210
2021-02-19,Mariposa,043,17540,376,371,5,376,4
2021-02-19,Mendocino,045,87422,3611,3526,71,3597,39
2021-02-19,Merced,047,269075,28077,27985,874,28859,376
2021-02-19,Modoc,049,8938,335,328,112,440,3
2021-02-19,Mono,051,14174,1173,1186,15,1201,3
2021-02-19,Monterey,053,433212,41720,41209,1632,42841,309
2021-02-19,Napa,055,140530,8951,8899,31,8930,69
2021-02-19,Nevada,057,99092,3948,3863,156,4019,66
2021-02-19,Orange,059,3164182,245739,243397,10017,253414,3715
2021-02-19,Placer,061,380077,20356,19457,1072,20529,236
2021-02-19,Plumas,063,18699,638,624,10,634,4
2021-02-19,Riverside,065,2383286,284200,276941,13172,290113,3541
2021-02-19,Sacramento,067,1510023,93510,91815,1182,92997,1351
2021-02-19,San Benito,069,59416,5700,5699,84,5783,57
2021-02-19,San Bernardino,071,2135413,285004,279209,8429,287638,3117
2021-02-19,San Diego,073,3302833,261930,255799,12667,268466,3169
2021-02-19,San Francisco,075,870044,33855,33746,1022,34768,387
2021-02-19,San Joaquin,077,732212,66208,64774,2654,67428,988
2021-02-19,San Luis Obispo,079,281455,19514,19061,537,19598,230
2021-02-19,San Mateo,081,765935,39155,38256,393,38649,282
2021-02-19,Santa Barbara,083,443738,31907,31204,1016,32220,392
2021-02-19,Santa Clara,085,1922200,109172,108400,544,108944,1634
2021-02-19,Santa Cruz,087,273765,15290,14354,759,15113,176
2021-02-19,Shasta,089,179085,10865,10833,1184,12017,140
2021-02-19,Sierra,091,2930,51,47,12,59,0
2021-02-19,Siskiyou,093,43540,1467,1363,217,1580,4
2021-02-19,Solano,095,438530,29610,29383,345,29728,150
2021-02-19,Sonoma,097,501317,27718,27595,187,27782,280
2021-02-19,Stanislaus,099,539301,50158,49282,5193,54475,739
2021-02-19,Sutter,101,95872,8752,8665,77,8742,96
2021-02-19,Tehama,103,63373,4573,4535,480,5015,30
2021-02-19,Trinity,105,12862,462,282,70,352,3
2021-02-19,Tulare,107,460477,47882,46662,7676,54338,736
2021-02-19,Tuolumne,109,53932,3803,3817,35,3852,52
2021-02-19,Ventura,111,848112,77165,76582,2705,79287,667
2021-02-19,Yolo,113,214977,12767,12606,140,12746,183
2021-02-19,Yuba,115,75493,5453,5376,81,5457,38
2021-02-18,Alameda,001,1643700,79915,79111,1659,80770,1012
2021-02-18,Alpine,003,1148,78,77,0,77,0
2021-02-18,Amador,005,37829,3434,3417,28,3445,38
2021-02-18,Butte,007,227075,11238,10791,1572,12363,175
2021-02-18,Calaveras,009,45235,1884,1873,11,1884,21
2021-02-18,Colusa,011,21464,1864,1856,256,2112,11
2021-02-18,Contra Costa,013,1133247,62317,60868,1041,61909,640
2021-02-18,Del Norte,015,27424,982,929,4,933,2
2021-02-18,El Dorado,017,186661,9056,8850,598,9448,94
2021-02-18,Fresno,019,978130,95322,93734,7478,101212,1323
2021-02-18,Glenn,021,27897,2225,2195,482,2677,14
2021-02-18,Humboldt,023,135768,3083,3023,22,3045,29
2021-02-18,Imperial,025,180216,27123,26731,2405,29136,591
2021-02-18,Inyo,027,18085,1267,1213,8,1221,32
2021-02-18,Kern,029,883053,92566,90655,9461,100116,961
2021-02-18,Kings,031,150075,22106,21648,933,22581,211
2021-02-18,Lake,033,64148,3136,3066,6,3072,40
2021-02-18,Lassen,035,31185,5095,5052,92,5144,1
2021-02-18,Los Angeles,037,10098052,1166848,1141930,38043,1179973,19358
2021-02-18,Madera,039,155013,15452,15175,790,15965,188
2021-02-18,Marin,041,260295,13064,12895,149,13044,209
2021-02-18,Mariposa,043,17540,375,369,5,374,4
2021-02-18,Mendocino,045,87422,3608,3519,70,3589,39
2021-02-18,Merced,047,269075,28028,27870,868,28738,372
2021-02-18,Modoc,049,8938,333,327,111,438,3
2021-02-18,Mono,051,14174,1173,1182,15,1197,3
2021-02-18,Monterey,053,433212,41662,41091,1623,42714,307
2021-02-18,Napa,055,140530,8934,8877,31,8908,68
2021-02-18,Nevada,057,99092,3939,3836,155,3991,66
2021-02-18,Orange,059,3164182,245516,243098,10000,253098,3673
2021-02-18,Placer,061,380077,20329,19429,1071,20500,232
2021-02-18,Plumas,063,18699,638,624,10,634,4
2021-02-18,Riverside,065,2383286,283912,276595,13151,289746,3510
2021-02-18,Sacramento,067,1510023,93348,91476,1176,92652,1334
2021-02-18,San Benito,069,59416,5697,5697,83,5780,58
2021-02-18,San Bernardino,071,2135413,284795,278887,8415,287302,3066
2021-02-18,San Diego,073,3302833,261575,254987,12644,267631,3135
2021-02-18,San Francisco,075,870044,33797,33650,1019,34669,386
2021-02-18,San Joaquin,077,732212,66125,64634,2644,67278,982
2021-02-18,San Luis Obispo,079,281455,19472,18987,534,19521,230
2021-02-18,San Mateo,081,765935,39093,38185,389,38574,282
2021-02-18,Santa Barbara,083,443738,31829,31054,1009,32063,387
2021-02-18,Santa Clara,085,1922200,108947,108210,541,108751,1605
2021-02-18,Santa Cruz,087,273765,15264,14314,759,15073,176
2021-02-18,Shasta,089,179085,10847,10811,1181,11992,139
2021-02-18,Sierra,091,2930,50,47,12,59,0
2021-02-18,Siskiyou,093,43540,1462,1359,216,1575,4
2021-02-18,Solano,095,438530,29584,29349,344,29693,150
2021-02-18,Sonoma,097,501317,27651,27512,186,27698,281
2021-02-18,Stanislaus,099,539301,50058,49150,5176,54326,738
2021-02-18,Sutter,101,95872,8744,8654,77,8731,96
2021-02-18,Tehama,103,63373,4570,4528,480,5008,30
2021-02-18,Trinity,105,12862,461,282,70,352,3
2021-02-18,Tulare,107,460477,47819,46591,7637,54228,728
2021-02-18,Tuolumne,109,53932,3766,3811,35,3846,52
2021-02-18,Ventura,111,848112,77033,76442,2697,79139,659
2021-02-18,Yolo,113,214977,12741,12549,140,12689,183
2021-02-18,Yuba,115,75493,5436,5358,81,5439,38
2021-02-17,Alameda,001,1643700,79753,78895,1657,80552,1002
2021-02-17,Alpine,003,1148,78,77,0,77,0
2021-02-17,Amador,005,37829,3430,3415,28,3443,38
2021-02-17,Butte,007,227075,11220,10770,1568,12338,174
2021-02-17,Calaveras,009,45235,1884,1876,11,1887,21
2021-02-17,Colusa,011,21464,1861,1854,256,2110,10
2021-02-17,Contra Costa,013,1133247,62179,60723,1038,61761,635
2021-02-17,Del Norte,015,27424,975,920,4,924,2
2021-02-17,El Dorado,017,186661,9045,8847,598,9445,94
2021-02-17,Fresno,019,978130,95183,93555,7451,101006,1307
2021-02-17,Glenn,021,27897,2224,2189,481,2670,14
2021-02-17,Humboldt,023,135768,3068,3006,22,3028,29
2021-02-17,Imperial,025,180216,27109,26726,2401,29127,580
2021-02-17,Inyo,027,18085,1259,1197,8,1205,32
2021-02-17,Kern,029,883053,92448,90454,9417,99871,962
2021-02-17,Kings,031,150075,22068,21617,929,22546,211
2021-02-17,Lake,033,64148,3126,3057,2,3059,38
2021-02-17,Lassen,035,31185,5090,5052,91,5143,1
2021-02-17,Los Angeles,037,10098052,1165791,1139786,37981,1177767,19213
2021-02-17,Madera,039,155013,15427,15135,781,15916,177
2021-02-17,Marin,041,260295,13039,12881,149,13030,207
2021-02-17,Mariposa,043,17540,375,368,4,372,4
2021-02-17,Mendocino,045,87422,3606,3494,69,3563,39
2021-02-17,Merced,047,269075,27973,27824,859,28683,372
2021-02-17,Modoc,049,8938,333,327,111,438,3
2021-02-17,Mono,051,14174,1173,1180,15,1195,3
2021-02-17,Monterey,053,433212,41607,41014,1612,42626,304
2021-02-17,Napa,055,140530,8920,8865,31,8896,68
2021-02-17,Nevada,057,99092,3920,3822,152,3974,52
2021-02-17,Orange,059,3164182,245254,242716,9967,252683,3626
2021-02-17,Placer,061,380077,20295,19405,1067,20472,230
2021-02-17,Plumas,063,18699,637,623,10,633,4
2021-02-17,Riverside,065,2383286,283623,276289,13130,289419,3491
2021-02-17,Sacramento,067,1510023,93189,91309,1169,92478,1326
2021-02-17,San Benito,069,59416,5691,5661,83,5744,57
2021-02-17,San Bernardino,071,2135413,284592,278461,8395,286856,3020
2021-02-17,San Diego,073,3302833,261197,254177,12623,266800,3099
2021-02-17,San Francisco,075,870044,33721,33558,1014,34572,379
2021-02-17,San Joaquin,077,732212,66019,64556,2638,67194,979
2021-02-17,San Luis Obispo,079,281455,19427,18964,534,19498,230
2021-02-17,San Mateo,081,765935,39029,38124,389,38513,282
2021-02-17,Santa Barbara,083,443738,31761,30927,1008,31935,384
2021-02-17,Santa Clara,085,1922200,108715,107949,539,108488,1592
2021-02-17,Santa Cruz,087,273765,15231,14268,756,15024,174
2021-02-17,Shasta,089,179085,10827,10770,1180,11950,139
2021-02-17,Sierra,091,2930,50,47,12,59,0
2021-02-17,Siskiyou,093,43540,1456,1352,213,1565,4
2021-02-17,Solano,095,438530,29527,29288,344,29632,149
2021-02-17,Sonoma,097,501317,27579,27408,181,27589,281
2021-02-17,Stanislaus,099,539301,49945,49050,5160,54210,730
2021-02-17,Sutter,101,95872,8734,8681,77,8758,95
2021-02-17,Tehama,103,63373,4567,4511,480,4991,30
2021-02-17,Trinity,105,12862,461,277,68,345,3
2021-02-17,Tulare,107,460477,47754,46495,7612,54107,726
2021-02-17,Tuolumne,109,53932,3757,3806,35,3841,49
2021-02-17,Ventura,111,848112,76911,76234,2691,78925,646
2021-02-17,Yolo,113,214977,12722,12506,138,12644,182
2021-02-17,Yuba,115,75493,5427,5345,81,5426,38
2021-02-16,Alameda,001,1643700,79584,78756,1654,80410,997
2021-02-16,Alpine,003,1148,78,76,0,76,0
2021-02-16,Amador,005,37829,3423,3413,28,3441,39
2021-02-16,Butte,007,227075,11194,10748,1565,12313,164
2021-02-16,Calaveras,009,45235,1882,1872,11,1883,21
2021-02-16,Colusa,011,21464,1858,1852,254,2106,10
2021-02-16,Contra Costa,013,1133247,62028,60564,1033,61597,631
2021-02-16,Del Norte,015,27424,967,913,4,917,2
2021-02-16,El Dorado,017,186661,9035,8836,596,9432,94
2021-02-16,Fresno,019,978130,95018,93363,7421,100784,1293
2021-02-16,Glenn,021,27897,2220,2189,477,2666,14
2021-02-16,Humboldt,023,135768,3045,2994,21,3015,29
2021-02-16,Imperial,025,180216,27096,26711,2397,29108,580
2021-02-16,Inyo,027,18085,1251,1191,8,1199,32
2021-02-16,Kern,029,883053,92316,90267,9387,99654,959
2021-02-16,Kings,031,150075,22022,21583,925,22508,206
2021-02-16,Lake,033,64148,3119,3041,2,3043,38
2021-02-16,Lassen,035,31185,5078,5047,91,5138,1
2021-02-16,Los Angeles,037,10098052,1164537,1138262,37921,1176183,19044
2021-02-16,Madera,039,155013,15389,15120,776,15896,172
2021-02-16,Marin,041,260295,13011,12832,149,12981,205
2021-02-16,Mariposa,043,17540,375,367,4,371,4
2021-02-16,Mendocino,045,87422,3602,3489,69,3558,39
2021-02-16,Merced,047,269075,27892,27724,853,28577,368
2021-02-16,Modoc,049,8938,333,326,111,437,3
2021-02-16,Mono,051,14174,1173,1180,15,1195,3
2021-02-16,Monterey,053,433212,41531,40962,1603,42565,303
2021-02-16,Napa,055,140530,8907,8854,31,8885,66
2021-02-16,Nevada,057,99092,3907,3774,151,3925,47
2021-02-16,Orange,059,3164182,244932,242382,9951,252333,3612
2021-02-16,Placer,061,380077,20262,19367,1064,20431,230
2021-02-16,Plumas,063,18699,637,619,10,629,4
2021-02-16,Riverside,065,2383286,283318,275954,13108,289062,3471
2021-02-16,Sacramento,067,1510023,92935,91246,1163,92409,1305
2021-02-16,San Benito,069,59416,5683,5659,82,5741,56
2021-02-16,San Bernardino,071,2135413,284368,277947,8386,286333,2978
2021-02-16,San Diego,073,3302833,260732,253638,12584,266222,3042
2021-02-16,San Francisco,075,870044,33649,33491,1009,34500,373
2021-02-16,San Joaquin,077,732212,65889,64448,2635,67083,979
2021-02-16,San Luis Obispo,079,281455,19382,18925,531,19456,229
2021-02-16,San Mateo,081,765935,38970,38041,387,38428,277
2021-02-16,Santa Barbara,083,443738,31687,30865,1005,31870,378
2021-02-16,Santa Clara,085,1922200,108463,107754,536,108290,1591
2021-02-16,Santa Cruz,087,273765,15211,14256,755,15011,174
2021-02-16,Shasta,089,179085,10812,10736,1178,11914,139
2021-02-16,Sierra,091,2930,50,47,12,59,0
2021-02-16,Siskiyou,093,43540,1452,1351,213,1564,4
2021-02-16,Solano,095,438530,29489,29246,343,29589,148
2021-02-16,Sonoma,097,501317,27520,27380,175,27555,279
2021-02-16,Stanislaus,099,539301,49821,48927,5146,54073,716
2021-02-16,Sutter,101,95872,8711,8671,77,8748,95
2021-02-16,Tehama,103,63373,4558,4501,478,4979,30
2021-02-16,Trinity,105,12862,457,275,68,343,3
2021-02-16,Tulare,107,460477,47690,46444,7569,54013,716
2021-02-16,Tuolumne,109,53932,3755,3796,35,3831,49
2021-02-16,Ventura,111,848112,76769,76043,2688,78731,631
2021-02-16,Yolo,113,214977,12693,12457,138,12595,175
2021-02-16,Yuba,115,75493,5420,5332,80,5412,38
2021-02-15,Alameda,001,1643700,79388,78647,1643,80290,996
2021-02-15,Alpine,003,1148,78,76,0,76,0
2021-02-15,Amador,005,37829,3419,3409,28,3437,39
2021-02-15,Butte,007,227075,11176,10723,1561,12284,155
2021-02-15,Calaveras,009,45235,1878,1871,11,1882,21
2021-02-15,Colusa,011,21464,1858,1849,250,2099,10
2021-02-15,Contra Costa,013,1133247,61857,60444,1028,61472,631
2021-02-15,Del Norte,015,27424,963,913,4,917,2
2021-02-15,El Dorado,017,186661,9018,8816,596,9412,94
2021-02-15,Fresno,019,978130,94819,93231,7382,100613,1288
2021-02-15,Glenn,021,27897,2218,2185,476,2661,14
2021-02-15,Humboldt,023,135768,3038,2997,21,3018,29
2021-02-15,Imperial,025,180216,27076,26700,2394,29094,580
2021-02-15,Inyo,027,18085,1232,1184,8,1192,32
2021-02-15,Kern,029,883053,92172,90181,9357,99538,959
2021-02-15,Kings,031,150075,21977,21574,921,22495,205
2021-02-15,Lake,033,64148,3105,3030,1,3031,38
2021-02-15,Lassen,035,31185,5076,5047,90,5137,1
2021-02-15,Los Angeles,037,10098052,1163149,1137164,37859,1175023,18925
2021-02-15,Madera,039,155013,15358,15108,774,15882,106
2021-02-15,Marin,041,260295,12990,12810,146,12956,203
2021-02-15,Mariposa,043,17540,373,367,4,371,4
2021-02-15,Mendocino,045,87422,3590,3481,69,3550,39
2021-02-15,Merced,047,269075,27818,27656,846,28502,368
2021-02-15,Modoc,049,8938,333,326,111,437,3
2021-02-15,Mono,051,14174,1170,1178,15,1193,3
2021-02-15,Monterey,053,433212,41467,40911,1591,42502,302
2021-02-15,Napa,055,140530,8893,8837,31,8868,57
2021-02-15,Nevada,057,99092,3890,3767,150,3917,47
2021-02-15,Orange,059,3164182,244613,242176,9923,252099,3586
2021-02-15,Placer,061,380077,20236,19361,1063,20424,230
2021-02-15,Plumas,063,18699,637,620,10,630,4
2021-02-15,Riverside,065,2383286,282964,275771,13089,288860,3468
2021-02-15,Sacramento,067,1510023,92608,91091,1158,92249,1304
2021-02-15,San Benito,069,59416,5677,5649,82,5731,56
2021-02-15,San Bernardino,071,2135413,284117,277869,8378,286247,2945
2021-02-15,San Diego,073,3302833,260219,252940,12553,265493,3037
2021-02-15,San Francisco,075,870044,33576,33454,1003,34457,373
2021-02-15,San Joaquin,077,732212,65724,64382,2628,67010,979
2021-02-15,San Luis Obispo,079,281455,19329,18891,529,19420,227
2021-02-15,San Mateo,081,765935,38891,37969,384,38353,277
2021-02-15,Santa Barbara,083,443738,31584,30810,1002,31812,378
2021-02-15,Santa Clara,085,1922200,108233,107630,534,108164,1588
2021-02-15,Santa Cruz,087,273765,15179,14239,752,14991,175
2021-02-15,Shasta,089,179085,10792,10730,1173,11903,139
2021-02-15,Sierra,091,2930,50,47,12,59,0
2021-02-15,Siskiyou,093,43540,1444,1345,212,1557,4
2021-02-15,Solano,095,438530,29434,29225,343,29568,148
2021-02-15,Sonoma,097,501317,27436,27359,171,27530,276
2021-02-15,Stanislaus,099,539301,49694,48808,5133,53941,716
2021-02-15,Sutter,101,95872,8696,8652,77,8729,95
2021-02-15,Tehama,103,63373,4549,4492,477,4969,30
2021-02-15,Trinity,105,12862,456,274,68,342,3
2021-02-15,Tulare,107,460477,47619,46344,7530,53874,715
2021-02-15,Tuolumne,109,53932,3745,3794,35,3829,49
2021-02-15,Ventura,111,848112,76614,75889,2685,78574,629
2021-02-15,Yolo,113,214977,12658,12412,137,12549,175
2021-02-15,Yuba,115,75493,5403,5320,79,5399,38
2021-02-14,Alameda,001,1643700,79236,78442,1642,80084,995
2021-02-14,Alpine,003,1148,78,76,0,76,0
2021-02-14,Amador,005,37829,3414,3398,28,3426,39
2021-02-14,Butte,007,227075,11152,10717,1558,12275,155
2021-02-14,Calaveras,009,45235,1874,1866,11,1877,21
2021-02-14,Colusa,011,21464,1854,1845,247,2092,10
2021-02-14,Contra Costa,013,1133247,61707,60272,1025,61297,631
2021-02-14,Del Norte,015,27424,959,911,4,915,2
2021-02-14,El Dorado,017,186661,8986,8790,595,9385,94
2021-02-14,Fresno,019,978130,94648,93065,7359,100424,1287
2021-02-14,Glenn,021,27897,2215,2184,476,2660,14
2021-02-14,Humboldt,023,135768,3025,2992,21,3013,29
2021-02-14,Imperial,025,180216,27069,26696,2393,29089,580
2021-02-14,Inyo,027,18085,1226,1177,8,1185,32
2021-02-14,Kern,029,883053,92012,90038,9304,99342,959
2021-02-14,Kings,031,150075,21951,21538,919,22457,205
2021-02-14,Lake,033,64148,3094,3030,1,3031,38
2021-02-14,Lassen,035,31185,5072,5037,90,5127,1
2021-02-14,Los Angeles,037,10098052,1161802,1135450,37777,1173227,18898
2021-02-14,Madera,039,155013,15326,15089,770,15859,106
2021-02-14,Marin,041,260295,12966,12784,146,12930,201
2021-02-14,Mariposa,043,17540,373,365,4,369,4
2021-02-14,Mendocino,045,87422,3584,3475,69,3544,39
2021-02-14,Merced,047,269075,27736,27601,841,28442,368
2021-02-14,Modoc,049,8938,333,326,111,437,3
2021-02-14,Mono,051,14174,1169,1180,15,1195,3
2021-02-14,Monterey,053,433212,41416,40842,1586,42428,302
2021-02-14,Napa,055,140530,8873,8826,31,8857,57
2021-02-14,Nevada,057,99092,3874,3761,150,3911,47
2021-02-14,Orange,059,3164182,244300,241859,9905,251764,3564
2021-02-14,Placer,061,380077,20197,19313,1058,20371,230
2021-02-14,Plumas,063,18699,636,620,10,630,4
2021-02-14,Riverside,065,2383286,282633,275518,13070,288588,3471
2021-02-14,Sacramento,067,1510023,92401,90856,1154,92010,1304
2021-02-14,San Benito,069,59416,5668,5641,81,5722,56
2021-02-14,San Bernardino,071,2135413,283811,277664,8358,286022,2929
2021-02-14,San Diego,073,3302833,259727,252247,12506,264753,3037
2021-02-14,San Francisco,075,870044,33502,33374,995,34369,372
2021-02-14,San Joaquin,077,732212,65626,64243,2614,66857,979
2021-02-14,San Luis Obispo,079,281455,19291,18868,526,19394,225
2021-02-14,San Mateo,081,765935,38806,37859,384,38243,277
2021-02-14,Santa Barbara,083,443738,31492,30744,998,31742,377
2021-02-14,Santa Clara,085,1922200,108034,107412,530,107942,1582
2021-02-14,Santa Cruz,087,273765,15151,14225,747,14972,175
2021-02-14,Shasta,089,179085,10760,10720,1169,11889,139
2021-02-14,Sierra,091,2930,50,47,12,59,0
2021-02-14,Siskiyou,093,43540,1440,1340,212,1552,4
2021-02-14,Solano,095,438530,29392,29150,340,29490,148
2021-02-14,Sonoma,097,501317,27361,27266,169,27435,276
2021-02-14,Stanislaus,099,539301,49584,48672,5118,53790,716
2021-02-14,Sutter,101,95872,8673,8642,77,8719,95
2021-02-14,Tehama,103,63373,4543,4490,474,4964,30
2021-02-14,Trinity,105,12862,456,272,68,340,3
2021-02-14,Tulare,107,460477,47534,46263,7481,53744,715
2021-02-14,Tuolumne,109,53932,3744,3764,35,3799,49
2021-02-14,Ventura,111,848112,76445,75742,2674,78416,629
2021-02-14,Yolo,113,214977,12629,12399,136,12535,175
2021-02-14,Yuba,115,75493,5393,5314,79,5393,38
2021-02-13,Alameda,001,1643700,79114,78246,1639,79885,995
2021-02-13,Alpine,003,1148,78,76,0,76,0
2021-02-13,Amador,005,37829,3411,3387,28,3415,38
2021-02-13,Butte,007,227075,11136,10699,1556,12255,155
2021-02-13,Calaveras,009,45235,1871,1863,11,1874,21
2021-02-13,Colusa,011,21464,1854,1837,247,2084,10
2021-02-13,Contra Costa,013,1133247,61586,60100,1025,61125,629
2021-02-13,Del Norte,015,27424,957,908,4,912,2
2021-02-13,El Dorado,017,186661,8974,8758,594,9352,93
2021-02-13,Fresno,019,978130,94534,92807,7337,100144,1287
2021-02-13,Glenn,021,27897,2214,2182,474,2656,14
2021-02-13,Humboldt,023,135768,3012,2974,20,2994,29
2021-02-13,Imperial,025,180216,27062,26680,2391,29071,580
2021-02-13,Inyo,027,18085,1222,1168,8,1176,32
2021-02-13,Kern,029,883053,91923,89915,9278,99193,957
2021-02-13,Kings,031,150075,21936,21513,917,22430,205
2021-02-13,Lake,033,64148,3085,3025,1,3026,37
2021-02-13,Lassen,035,31185,5069,5028,90,5118,1
2021-02-13,Los Angeles,037,10098052,1160944,1133752,37730,1171482,18822
2021-02-13,Madera,039,155013,15317,15053,766,15819,106
2021-02-13,Marin,041,260295,12942,12757,146,12903,201
2021-02-13,Mariposa,043,17540,373,365,4,369,4
2021-02-13,Mendocino,045,87422,3574,3466,69,3535,38
2021-02-13,Merced,047,269075,27692,27541,838,28379,368
2021-02-13,Modoc,049,8938,333,325,111,436,3
2021-02-13,Mono,051,14174,1169,1176,15,1191,3
2021-02-13,Monterey,053,433212,41384,40731,1585,42316,301
2021-02-13,Napa,055,140530,8864,8809,31,8840,57
2021-02-13,Nevada,057,99092,3865,3742,149,3891,47
2021-02-13,Orange,059,3164182,244094,241545,9886,251431,3520
2021-02-13,Placer,061,380077,20177,19214,1058,20272,230
2021-02-13,Plumas,063,18699,636,616,10,626,4
2021-02-13,Riverside,065,2383286,282404,275276,13061,288337,3462
2021-02-13,Sacramento,067,1510023,92234,90401,1151,91552,1302
2021-02-13,San Benito,069,59416,5651,5633,81,5714,56
2021-02-13,San Bernardino,071,2135413,283659,277405,8345,285750,2899
2021-02-13,San Diego,073,3302833,259395,251679,12494,264173,3009
2021-02-13,San Francisco,075,870044,33452,33291,985,34276,364
2021-02-13,San Joaquin,077,732212,65557,64105,2604,66709,977
2021-02-13,San Luis Obispo,079,281455,19263,18803,520,19323,225
2021-02-13,San Mateo,081,765935,38753,37745,384,38129,277
2021-02-13,Santa Barbara,083,443738,31440,30594,997,31591,374
2021-02-13,Santa Clara,085,1922200,107845,107125,526,107651,1570
2021-02-13,Santa Cruz,087,273765,15124,14198,746,14944,173
2021-02-13,Shasta,089,179085,10747,10713,1164,11877,139
2021-02-13,Sierra,091,2930,50,47,12,59,0
2021-02-13,Siskiyou,093,43540,1437,1336,212,1548,4
2021-02-13,Solano,095,438530,29356,29084,340,29424,148
2021-02-13,Sonoma,097,501317,27313,27157,167,27324,276
2021-02-13,Stanislaus,099,539301,49513,48568,5112,53680,697
2021-02-13,Sutter,101,95872,8661,8626,77,8703,94
2021-02-13,Tehama,103,63373,4533,4484,473,4957,30
2021-02-13,Trinity,105,12862,455,272,67,339,3
2021-02-13,Tulare,107,460477,47483,46162,7450,53612,709
2021-02-13,Tuolumne,109,53932,3743,3752,35,3787,49
2021-02-13,Ventura,111,848112,76305,75481,2668,78149,618
2021-02-13,Yolo,113,214977,12616,12374,135,12509,175
2021-02-13,Yuba,115,75493,5385,5289,79,5368,38
2021-02-12,Alameda,001,1643700,78965,77958,1633,79591,974
2021-02-12,Alpine,003,1148,78,76,0,76,0
2021-02-12,Amador,005,37829,3407,3381,28,3409,38
2021-02-12,Butte,007,227075,11123,10655,1549,12204,155
2021-02-12,Calaveras,009,45235,1868,1860,11,1871,21
2021-02-12,Colusa,011,21464,1854,1836,247,2083,10
2021-02-12,Contra Costa,013,1133247,61436,59878,1021,60899,620
2021-02-12,Del Norte,015,27424,947,901,4,905,2
2021-02-12,El Dorado,017,186661,8959,8725,591,9316,92
2021-02-12,Fresno,019,978130,94380,92520,7317,99837,1273
2021-02-12,Glenn,021,27897,2211,2175,474,2649,14
2021-02-12,Humboldt,023,135768,3004,2961,20,2981,29
2021-02-12,Imperial,025,180216,27054,26646,2388,29034,585
2021-02-12,Inyo,027,18085,1216,1156,8,1164,32
2021-02-12,Kern,029,883053,91809,89532,9246,98778,949
2021-02-12,Kings,031,150075,21904,21462,912,22374,202
2021-02-12,Lake,033,64148,3080,3012,1,3013,36
2021-02-12,Lassen,035,31185,5067,5015,90,5105,1
2021-02-12,Los Angeles,037,10098052,1159733,1131185,37662,1168847,18637
2021-02-12,Madera,039,155013,15290,15022,763,15785,106
2021-02-12,Marin,041,260295,12916,12720,146,12866,200
2021-02-12,Mariposa,043,17540,372,365,4,369,4
2021-02-12,Mendocino,045,87422,3572,3447,69,3516,38
2021-02-12,Merced,047,269075,27641,27453,835,28288,367
2021-02-12,Modoc,049,8938,333,324,111,435,3
2021-02-12,Mono,051,14174,1168,1172,15,1187,3
2021-02-12,Monterey,053,433212,41336,40633,1576,42209,297
2021-02-12,Napa,055,140530,8852,8785,31,8816,55
2021-02-12,Nevada,057,99092,3860,3728,149,3877,47
2021-02-12,Orange,059,3164182,243855,241075,9871,250946,3505
2021-02-12,Placer,061,380077,20135,19174,1053,20227,230
2021-02-12,Plumas,063,18699,635,614,10,624,4
2021-02-12,Riverside,065,2383286,282126,274792,13046,287838,3438
2021-02-12,Sacramento,067,1510023,92032,90252,1150,91402,1295
2021-02-12,San Benito,069,59416,5635,5622,80,5702,56
2021-02-12,San Bernardino,071,2135413,283469,276890,8334,285224,2827
2021-02-12,San Diego,073,3302833,259007,250788,12468,263256,2979
2021-02-12,San Francisco,075,870044,33392,33179,981,34160,359
2021-02-12,San Joaquin,077,732212,65461,63966,2596,66562,975
2021-02-12,San Luis Obispo,079,281455,19222,18687,519,19206,224
2021-02-12,San Mateo,081,765935,38681,37560,384,37944,254
2021-02-12,Santa Barbara,083,443738,31369,30454,992,31446,372
2021-02-12,Santa Clara,085,1922200,107673,106759,523,107282,1543
2021-02-12,Santa Cruz,087,273765,15104,14147,746,14893,170
2021-02-12,Shasta,089,179085,10729,10693,1154,11847,142
2021-02-12,Sierra,091,2930,49,45,12,57,0
2021-02-12,Siskiyou,093,43540,1433,1324,209,1533,4
2021-02-12,Solano,095,438530,29324,28996,337,29333,147
2021-02-12,Sonoma,097,501317,27258,27064,163,27227,275
2021-02-12,Stanislaus,099,539301,49425,48418,5090,53508,697
2021-02-12,Sutter,101,95872,8648,8609,77,8686,93
2021-02-12,Tehama,103,63373,4526,4470,472,4942,27
2021-02-12,Trinity,105,12862,455,269,67,336,3
2021-02-12,Tulare,107,460477,47405,46016,7424,53440,710
2021-02-12,Tuolumne,109,53932,3740,3736,34,3770,49
2021-02-12,Ventura,111,848112,76135,75210,2662,77872,605
2021-02-12,Yolo,113,214977,12595,12340,135,12475,175
2021-02-12,Yuba,115,75493,5377,5274,79,5353,38
2021-02-11,Alameda,001,1643700,78739,77564,1628,79192,960
2021-02-11,Alpine,003,1148,77,76,0,76,0
2021-02-11,Amador,005,37829,3403,3368,28,3396,35
2021-02-11,Butte,007,227075,11100,10624,1548,12172,155
2021-02-11,Calaveras,009,45235,1865,1856,11,1867,21
2021-02-11,Colusa,011,21464,1849,1823,245,2068,10
2021-02-11,Contra Costa,013,1133247,61269,59633,1017,60650,605
2021-02-11,Del Norte,015,27424,942,894,4,898,2
2021-02-11,El Dorado,017,186661,8938,8698,591,9289,92
2021-02-11,Fresno,019,978130,94226,92168,7294,99462,1255
2021-02-11,Glenn,021,27897,2206,2166,473,2639,14
2021-02-11,Humboldt,023,135768,2991,2954,19,2973,29
2021-02-11,Imperial,025,180216,27030,26545,2386,28931,578
2021-02-11,Inyo,027,18085,1207,1144,8,1152,32
2021-02-11,Kern,029,883053,91618,89224,9203,98427,941
2021-02-11,Kings,031,150075,21874,21373,909,22282,202
2021-02-11,Lake,033,64148,3070,3002,1,3003,36
2021-02-11,Lassen,035,31185,5056,5004,87,5091,1
2021-02-11,Los Angeles,037,10098052,1158104,1128437,37593,1166030,18500
2021-02-11,Madera,039,155013,15269,14984,761,15745,106
2021-02-11,Marin,041,260295,12879,12682,146,12828,200
2021-02-11,Mariposa,043,17540,372,361,4,365,4
2021-02-11,Mendocino,045,87422,3565,3420,69,3489,38
2021-02-11,Merced,047,269075,27575,27325,831,28156,363
2021-02-11,Modoc,049,8938,332,317,111,428,3
2021-02-11,Mono,051,14174,1164,1173,15,1188,3
2021-02-11,Monterey,053,433212,41230,40469,1570,42039,295
2021-02-11,Napa,055,140530,8831,8777,31,8808,55
2021-02-11,Nevada,057,99092,3844,3720,149,3869,47
2021-02-11,Orange,059,3164182,243488,240590,9847,250437,3476
2021-02-11,Placer,061,380077,20095,19118,1052,20170,224
2021-02-11,Plumas,063,18699,634,592,10,602,4
2021-02-11,Riverside,065,2383286,281760,274313,13031,287344,3394
2021-02-11,Sacramento,067,1510023,91789,89988,1144,91132,1286
2021-02-11,San Benito,069,59416,5626,5609,80,5689,56
2021-02-11,San Bernardino,071,2135413,283171,276349,8320,284669,2774
2021-02-11,San Diego,073,3302833,258454,249971,12434,262405,2955
2021-02-11,San Francisco,075,870044,33308,33076,972,34048,356
2021-02-11,San Joaquin,077,732212,65293,63719,2586,66305,971
2021-02-11,San Luis Obispo,079,281455,19157,18615,515,19130,219
2021-02-11,San Mateo,081,765935,38590,37439,382,37821,253
2021-02-11,Santa Barbara,083,443738,31271,30375,987,31362,370
2021-02-11,Santa Clara,085,1922200,107413,106392,518,106910,1507
2021-02-11,Santa Cruz,087,273765,15081,14088,741,14829,165
2021-02-11,Shasta,089,179085,10705,10672,1150,11822,140
2021-02-11,Sierra,091,2930,49,45,12,57,0
2021-02-11,Siskiyou,093,43540,1418,1320,209,1529,4
2021-02-11,Solano,095,438530,29271,28885,337,29222,138
2021-02-11,Sonoma,097,501317,27173,26971,160,27131,272
2021-02-11,Stanislaus,099,539301,49280,48205,5078,53283,697
2021-02-11,Sutter,101,95872,8634,8590,76,8666,93
2021-02-11,Tehama,103,63373,4520,4463,472,4935,26
2021-02-11,Trinity,105,12862,455,269,67,336,3
2021-02-11,Tulare,107,460477,47310,45897,7384,53281,706
2021-02-11,Tuolumne,109,53932,3703,3716,34,3750,48
2021-02-11,Ventura,111,848112,75933,74959,2653,77612,590
2021-02-11,Yolo,113,214977,12571,12303,135,12438,173
2021-02-11,Yuba,115,75493,5363,5261,78,5339,38
2021-02-10,Alameda,001,1643700,78538,77344,1627,78971,944
2021-02-10,Alpine,003,1148,77,76,0,76,0
2021-02-10,Amador,005,37829,3391,3348,28,3376,35
2021-02-10,Butte,007,227075,11072,10594,1547,12141,155
2021-02-10,Calaveras,009,45235,1863,1850,11,1861,21
2021-02-10,Colusa,011,21464,1842,1815,243,2058,10
2021-02-10,Contra Costa,013,1133247,61094,59488,1015,60503,590
2021-02-10,Del Norte,015,27424,936,888,4,892,2
2021-02-10,El Dorado,017,186661,8907,8682,587,9269,87
2021-02-10,Fresno,019,978130,94051,91876,7269,99145,1247
2021-02-10,Glenn,021,27897,2202,2160,471,2631,14
2021-02-10,Humboldt,023,135768,2983,2924,19,2943,29
2021-02-10,Imperial,025,180216,26992,26522,2383,28905,578
2021-02-10,Inyo,027,18085,1195,1138,8,1146,30
2021-02-10,Kern,029,883053,91411,88933,9149,98082,926
2021-02-10,Kings,031,150075,21831,21294,907,22201,197
2021-02-10,Lake,033,64148,3057,2975,1,2976,36
2021-02-10,Lassen,035,31185,5052,4993,87,5080,1
2021-02-10,Los Angeles,037,10098052,1156357,1125437,37465,1162902,18338
2021-02-10,Madera,039,155013,15230,14925,759,15684,105
2021-02-10,Marin,041,260295,12842,12651,146,12797,199
2021-02-10,Mariposa,043,17540,370,360,4,364,4
2021-02-10,Mendocino,045,87422,3550,3395,69,3464,38
2021-02-10,Merced,047,269075,27492,27246,820,28066,359
2021-02-10,Modoc,049,8938,331,315,109,424,3
2021-02-10,Mono,051,14174,1159,1170,15,1185,3
2021-02-10,Monterey,053,433212,41153,40366,1556,41922,288
2021-02-10,Napa,055,140530,8812,8769,31,8800,55
2021-02-10,Nevada,057,99092,3829,3693,147,3840,47
2021-02-10,Orange,059,3164182,243071,239974,9816,249790,3439
2021-02-10,Placer,061,380077,20056,19062,1047,20109,220
2021-02-10,Plumas,063,18699,631,589,10,599,2
2021-02-10,Riverside,065,2383286,281333,273721,13021,286742,3374
2021-02-10,Sacramento,067,1510023,91538,89653,1140,90793,1275
2021-02-10,San Benito,069,59416,5612,5591,80,5671,55
2021-02-10,San Bernardino,071,2135413,282816,275616,8304,283920,2696
2021-02-10,San Diego,073,3302833,257872,248858,12396,261254,2904
2021-02-10,San Francisco,075,870044,33225,32955,969,33924,351
2021-02-10,San Joaquin,077,732212,65151,63484,2572,66056,954
2021-02-10,San Luis Obispo,079,281455,19078,18549,513,19062,216
2021-02-10,San Mateo,081,765935,38499,37323,382,37705,245
2021-02-10,Santa Barbara,083,443738,31180,30216,982,31198,359
2021-02-10,Santa Clara,085,1922200,107173,106048,515,106563,1489
2021-02-10,Santa Cruz,087,273765,15045,14007,739,14746,165
2021-02-10,Shasta,089,179085,10682,10645,1147,11792,142
2021-02-10,Sierra,091,2930,49,45,12,57,0
2021-02-10,Siskiyou,093,43540,1413,1314,208,1522,4
2021-02-10,Solano,095,438530,29196,28835,335,29170,137
2021-02-10,Sonoma,097,501317,27077,26881,158,27039,271
2021-02-10,Stanislaus,099,539301,49163,48016,5062,53078,696
2021-02-10,Sutter,101,95872,8617,8571,76,8647,93
2021-02-10,Tehama,103,63373,4512,4445,472,4917,23
2021-02-10,Trinity,105,12862,452,268,67,335,3
2021-02-10,Tulare,107,460477,47193,45782,7346,53128,696
2021-02-10,Tuolumne,109,53932,3695,3691,34,3725,48
2021-02-10,Ventura,111,848112,75705,74651,2636,77287,580
2021-02-10,Yolo,113,214977,12547,12276,135,12411,174
2021-02-10,Yuba,115,75493,5345,5241,78,5319,38
2021-02-09,Alameda,001,1643700,78276,77018,1623,78641,936
2021-02-09,Alpine,003,1148,77,76,0,76,0
2021-02-09,Amador,005,37829,3383,3347,28,3375,35
2021-02-09,Butte,007,227075,11046,10563,1544,12107,153
2021-02-09,Calaveras,009,45235,1859,1847,11,1858,21
2021-02-09,Colusa,011,21464,1833,1812,238,2050,10
2021-02-09,Contra Costa,013,1133247,60904,59307,1009,60316,583
2021-02-09,Del Norte,015,27424,930,886,4,890,2
2021-02-09,El Dorado,017,186661,8879,8663,585,9248,87
2021-02-09,Fresno,019,978130,93809,91730,7241,98971,1211
2021-02-09,Glenn,021,27897,2198,2156,471,2627,14
2021-02-09,Humboldt,023,135768,2975,2904,19,2923,29
2021-02-09,Imperial,025,180216,26961,26509,2380,28889,568
2021-02-09,Inyo,027,18085,1187,1137,8,1145,30
2021-02-09,Kern,029,883053,91159,88684,9103,97787,920
2021-02-09,Kings,031,150075,21789,21275,905,22180,196
2021-02-09,Lake,033,64148,3046,2955,1,2956,36
2021-02-09,Lassen,035,31185,5045,4983,87,5070,1
2021-02-09,Los Angeles,037,10098052,1154379,1122745,37382,1160127,18198
2021-02-09,Madera,039,155013,15210,14912,756,15668,105
2021-02-09,Marin,041,260295,12810,12623,145,12768,197
2021-02-09,Mariposa,043,17540,368,355,4,359,4
2021-02-09,Mendocino,045,87422,3532,3369,69,3438,38
2021-02-09,Merced,047,269075,27394,27166,815,27981,354
2021-02-09,Modoc,049,8938,330,316,109,425,3
2021-02-09,Mono,051,14174,1158,1167,15,1182,3
2021-02-09,Monterey,053,433212,41045,40279,1543,41822,285
2021-02-09,Napa,055,140530,8799,8749,31,8780,55
2021-02-09,Nevada,057,99092,3812,3687,147,3834,44
2021-02-09,Orange,059,3164182,242659,239169,9785,248954,3406
2021-02-09,Placer,061,380077,19991,19008,1040,20048,220
2021-02-09,Plumas,063,18699,631,584,10,594,2
2021-02-09,Riverside,065,2383286,280839,273465,13004,286469,3334
2021-02-09,Sacramento,067,1510023,91228,89378,1139,90517,1265
2021-02-09,San Benito,069,59416,5600,5566,79,5645,54
2021-02-09,San Bernardino,071,2135413,282443,274998,8291,283289,2613
2021-02-09,San Diego,073,3302833,257214,248048,12353,260401,2853
2021-02-09,San Francisco,075,870044,33146,32782,959,33741,349
2021-02-09,San Joaquin,077,732212,64976,63341,2567,65908,937
2021-02-09,San Luis Obispo,079,281455,19019,18489,512,19001,216
2021-02-09,San Mateo,081,765935,38368,37227,381,37608,235
2021-02-09,Santa Barbara,083,443738,31068,30118,976,31094,351
2021-02-09,Santa Clara,085,1922200,106867,105762,512,106274,1463
2021-02-09,Santa Cruz,087,273765,14994,13958,734,14692,162
2021-02-09,Shasta,089,179085,10654,10595,1145,11740,139
2021-02-09,Sierra,091,2930,49,44,12,56,0
2021-02-09,Siskiyou,093,43540,1405,1306,206,1512,4
2021-02-09,Solano,095,438530,29117,28769,332,29101,131
2021-02-09,Sonoma,097,501317,26987,26826,156,26982,267
2021-02-09,Stanislaus,099,539301,49003,47906,5047,52953,679
2021-02-09,Sutter,101,95872,8601,8541,76,8617,92
2021-02-09,Tehama,103,63373,4505,4416,471,4887,22
2021-02-09,Trinity,105,12862,452,266,67,333,3
2021-02-09,Tulare,107,460477,47059,45704,7294,52998,686
2021-02-09,Tuolumne,109,53932,3676,3673,34,3707,48
2021-02-09,Ventura,111,848112,75453,74333,2628,76961,567
2021-02-09,Yolo,113,214977,12505,12220,135,12355,174
2021-02-09,Yuba,115,75493,5336,5235,78,5313,35
2021-02-08,Alameda,001,1643700,78015,76735,1618,78353,924
2021-02-08,Alpine,003,1148,77,73,0,73,0
2021-02-08,Amador,005,37829,3376,3344,27,3371,33
2021-02-08,Butte,007,227075,11024,10524,1540,12064,152
2021-02-08,Calaveras,009,45235,1858,1840,11,1851,21
2021-02-08,Colusa,011,21464,1825,1802,234,2036,10
2021-02-08,Contra Costa,013,1133247,60693,59039,1007,60046,567
2021-02-08,Del Norte,015,27424,927,885,4,889,2
2021-02-08,El Dorado,017,186661,8847,8627,582,9209,86
2021-02-08,Fresno,019,978130,93596,91430,7215,98645,1207
2021-02-08,Glenn,021,27897,2194,2148,469,2617,14
2021-02-08,Humboldt,023,135768,2967,2902,19,2921,29
2021-02-08,Imperial,025,180216,26939,26526,2378,28904,567
2021-02-08,Inyo,027,18085,1174,1126,8,1134,30
2021-02-08,Kern,029,883053,90942,88380,9043,97423,920
2021-02-08,Kings,031,150075,21727,21232,902,22134,195
2021-02-08,Lake,033,64148,3027,2949,1,2950,36
2021-02-08,Lassen,035,31185,5032,4976,87,5063,1
2021-02-08,Los Angeles,037,10098052,1152281,1120179,37262,1157441,17977
2021-02-08,Madera,039,155013,15174,14887,749,15636,93
2021-02-08,Marin,041,260295,12780,12591,145,12736,194
2021-02-08,Mariposa,043,17540,368,355,4,359,4
2021-02-08,Mendocino,045,87422,3518,3355,69,3424,38
2021-02-08,Merced,047,269075,27311,27082,810,27892,346
2021-02-08,Modoc,049,8938,328,318,109,427,3
2021-02-08,Mono,051,14174,1158,1165,15,1180,3
2021-02-08,Monterey,053,433212,40925,40186,1524,41710,283
2021-02-08,Napa,055,140530,8784,8719,31,8750,55
2021-02-08,Nevada,057,99092,3800,3671,147,3818,44
2021-02-08,Orange,059,3164182,242192,238715,9762,248477,3361
2021-02-08,Placer,061,380077,19949,18944,1034,19978,211
2021-02-08,Plumas,063,18699,630,584,10,594,2
2021-02-08,Riverside,065,2383286,280270,272904,12978,285882,3301
2021-02-08,Sacramento,067,1510023,90942,89267,1136,90403,1247
2021-02-08,San Benito,069,59416,5595,5553,78,5631,52
2021-02-08,San Bernardino,071,2135413,282040,274661,8285,282946,2587
2021-02-08,San Diego,073,3302833,256471,247259,12312,259571,2821
2021-02-08,San Francisco,075,870044,33052,32679,951,33630,348
2021-02-08,San Joaquin,077,732212,64815,63148,2557,65705,929
2021-02-08,San Luis Obispo,079,281455,18962,18421,507,18928,214
2021-02-08,San Mateo,081,765935,38259,37084,381,37465,232
2021-02-08,Santa Barbara,083,443738,30953,29978,969,30947,340
2021-02-08,Santa Clara,085,1922200,106544,105413,504,105917,1456
2021-02-08,Santa Cruz,087,273765,14955,13921,728,14649,161
2021-02-08,Shasta,089,179085,10627,10574,1139,11713,137
2021-02-08,Sierra,091,2930,49,44,12,56,0
2021-02-08,Siskiyou,093,43540,1402,1303,206,1509,4
2021-02-08,Solano,095,438530,29051,28644,330,28974,130
2021-02-08,Sonoma,097,501317,26896,26760,155,26915,259
2021-02-08,Stanislaus,099,539301,48848,47704,5019,52723,679
2021-02-08,Sutter,101,95872,8582,8526,76,8602,92
2021-02-08,Tehama,103,63373,4495,4403,468,4871,22
2021-02-08,Trinity,105,12862,450,266,67,333,3
2021-02-08,Tulare,107,460477,46951,45617,7254,52871,673
2021-02-08,Tuolumne,109,53932,3668,3647,34,3681,48
2021-02-08,Ventura,111,848112,75196,74068,2623,76691,565
2021-02-08,Yolo,113,214977,12473,12169,134,12303,162
2021-02-08,Yuba,115,75493,5320,5215,78,5293,35
2021-02-07,Alameda,001,1643700,77714,76500,1610,78110,924
2021-02-07,Alpine,003,1148,74,72,0,72,0
2021-02-07,Amador,005,37829,3355,3343,27,3370,33
2021-02-07,Butte,007,227075,10992,10513,1532,12045,152
2021-02-07,Calaveras,009,45235,1854,1837,11,1848,21
2021-02-07,Colusa,011,21464,1814,1795,232,2027,10
2021-02-07,Contra Costa,013,1133247,60449,58836,1002,59838,566
2021-02-07,Del Norte,015,27424,923,881,4,885,2
2021-02-07,El Dorado,017,186661,8818,8596,580,9176,86
2021-02-07,Fresno,019,978130,93366,91184,7177,98361,1207
2021-02-07,Glenn,021,27897,2190,2141,464,2605,14
2021-02-07,Humboldt,023,135768,2946,2895,19,2914,28
2021-02-07,Imperial,025,180216,26912,26518,2373,28891,567
2021-02-07,Inyo,027,18085,1163,1124,8,1132,27
2021-02-07,Kern,029,883053,90695,88146,8985,97131,920
2021-02-07,Kings,031,150075,21666,21180,899,22079,192
2021-02-07,Lake,033,64148,3012,2940,1,2941,36
2021-02-07,Lassen,035,31185,5021,4973,87,5060,1
2021-02-07,Los Angeles,037,10098052,1149525,1117551,37135,1154686,17889
2021-02-07,Madera,039,155013,15140,14850,745,15595,93
2021-02-07,Marin,041,260295,12747,12571,143,12714,194
2021-02-07,Mariposa,043,17540,367,355,4,359,4
2021-02-07,Mendocino,045,87422,3501,3348,69,3417,38
2021-02-07,Merced,047,269075,27199,26977,798,27775,346
2021-02-07,Modoc,049,8938,328,317,105,422,3
2021-02-07,Mono,051,14174,1155,1165,15,1180,3
2021-02-07,Monterey,053,433212,40789,40113,1505,41618,283
2021-02-07,Napa,055,140530,8761,8701,31,8732,55
2021-02-07,Nevada,057,99092,3789,3643,147,3790,44
2021-02-07,Orange,059,3164182,241594,238155,9729,247884,3336
2021-02-07,Placer,061,380077,19902,18903,1021,19924,211
2021-02-07,Plumas,063,18699,630,584,10,594,2
2021-02-07,Riverside,065,2383286,279742,272301,12957,285258,3267
2021-02-07,Sacramento,067,1510023,90609,88919,1129,90048,1246
2021-02-07,San Benito,069,59416,5576,5548,77,5625,52
2021-02-07,San Bernardino,071,2135413,281447,274316,8260,282576,2587
2021-02-07,San Diego,073,3302833,255685,246561,12248,258809,2821
2021-02-07,San Francisco,075,870044,32932,32609,939,33548,348
2021-02-07,San Joaquin,077,732212,64541,63051,2543,65594,929
2021-02-07,San Luis Obispo,079,281455,18890,18349,500,18849,214
2021-02-07,San Mateo,081,765935,38125,36984,379,37363,232
2021-02-07,Santa Barbara,083,443738,30813,29815,958,30773,340
2021-02-07,Santa Clara,085,1922200,106205,105118,494,105612,1450
2021-02-07,Santa Cruz,087,273765,14901,13887,723,14610,161
2021-02-07,Shasta,089,179085,10607,10570,1131,11701,137
2021-02-07,Sierra,091,2930,49,43,12,55,0
2021-02-07,Siskiyou,093,43540,1395,1295,204,1499,4
2021-02-07,Solano,095,438530,28940,28567,329,28896,130
2021-02-07,Sonoma,097,501317,26789,26684,151,26835,257
2021-02-07,Stanislaus,099,539301,48658,47551,4987,52538,679
2021-02-07,Sutter,101,95872,8554,8515,76,8591,92
2021-02-07,Tehama,103,63373,4479,4396,467,4863,22
2021-02-07,Trinity,105,12862,447,264,65,329,3
2021-02-07,Tulare,107,460477,46829,45520,7176,52696,671
2021-02-07,Tuolumne,109,53932,3644,3619,33,3652,48
2021-02-07,Ventura,111,848112,74885,73759,2611,76370,561
2021-02-07,Yolo,113,214977,12428,12135,134,12269,162
2021-02-07,Yuba,115,75493,5305,5198,76,5274,35
2021-02-06,Alameda,001,1643700,77561,76170,1599,77769,922
2021-02-06,Alpine,003,1148,74,72,0,72,0
2021-02-06,Amador,005,37829,3349,3306,27,3333,33
2021-02-06,Butte,007,227075,10975,10480,1528,12008,150
2021-02-06,Calaveras,009,45235,1852,1832,11,1843,21
2021-02-06,Colusa,011,21464,1812,1791,231,2022,10
2021-02-06,Contra Costa,013,1133247,60302,58567,996,59563,566
2021-02-06,Del Norte,015,27424,919,879,4,883,2
2021-02-06,El Dorado,017,186661,8811,8575,576,9151,86
2021-02-06,Fresno,019,978130,93253,90944,7156,98100,1207
2021-02-06,Glenn,021,27897,2188,2136,463,2599,14
2021-02-06,Humboldt,023,135768,2935,2880,19,2899,28
2021-02-06,Imperial,025,180216,26900,26514,2372,28886,567
2021-02-06,Inyo,027,18085,1160,1113,8,1121,27
2021-02-06,Kern,029,883053,90541,87919,8939,96858,912
2021-02-06,Kings,031,150075,21636,21156,899,22055,190
2021-02-06,Lake,033,64148,3007,2920,1,2921,34
2021-02-06,Lassen,035,31185,5017,4964,86,5050,1
2021-02-06,Los Angeles,037,10098052,1148168,1114718,37038,1151756,17793
2021-02-06,Madera,039,155013,15119,14807,743,15550,93
2021-02-06,Marin,041,260295,12727,12531,143,12674,194
2021-02-06,Mariposa,043,17540,366,355,3,358,4
2021-02-06,Mendocino,045,87422,3483,3316,68,3384,38
2021-02-06,Merced,047,269075,27113,26881,790,27671,346
2021-02-06,Modoc,049,8938,328,313,105,418,3
2021-02-06,Mono,051,14174,1154,1159,15,1174,3
2021-02-06,Monterey,053,433212,40731,39995,1497,41492,282
2021-02-06,Napa,055,140530,8748,8639,31,8670,55
2021-02-06,Nevada,057,99092,3777,3624,147,3771,43
2021-02-06,Orange,059,3164182,241231,237391,9695,247086,3293
2021-02-06,Placer,061,380077,19865,18836,1018,19854,211
2021-02-06,Plumas,063,18699,630,584,10,594,2
2021-02-06,Riverside,065,2383286,279374,271741,12938,284679,3243
2021-02-06,Sacramento,067,1510023,90392,88532,1119,89651,1237
2021-02-06,San Benito,069,59416,5558,5516,77,5593,52
2021-02-06,San Bernardino,071,2135413,281138,273718,8238,281956,2564
2021-02-06,San Diego,073,3302833,255189,245331,12213,257544,2812
2021-02-06,San Francisco,075,870044,32858,32437,929,33366,346
2021-02-06,San Joaquin,077,732212,64462,62840,2532,65372,906
2021-02-06,San Luis Obispo,079,281455,18848,18284,496,18780,214
2021-02-06,San Mateo,081,765935,38057,36824,376,37200,232
2021-02-06,Santa Barbara,083,443738,30737,29645,956,30601,337
2021-02-06,Santa Clara,085,1922200,105983,104639,489,105128,1439
2021-02-06,Santa Cruz,087,273765,14870,13845,719,14564,161
2021-02-06,Shasta,089,179085,10596,10561,1129,11690,137
2021-02-06,Sierra,091,2930,49,43,12,55,0
2021-02-06,Siskiyou,093,43540,1392,1289,203,1492,4
2021-02-06,Solano,095,438530,28904,28446,328,28774,129
2021-02-06,Sonoma,097,501317,26752,26564,149,26713,257
2021-02-06,Stanislaus,099,539301,48561,47325,4972,52297,679
2021-02-06,Sutter,101,95872,8546,8485,76,8561,92
2021-02-06,Tehama,103,63373,4469,4380,466,4846,22
2021-02-06,Trinity,105,12862,447,263,65,328,3
2021-02-06,Tulare,107,460477,46761,45349,7131,52480,664
2021-02-06,Tuolumne,109,53932,3637,3612,33,3645,48
2021-02-06,Ventura,111,848112,74705,73431,2605,76036,552
2021-02-06,Yolo,113,214977,12405,12061,134,12195,161
2021-02-06,Yuba,115,75493,5295,5177,75,5252,35
2021-02-05,Alameda,001,1643700,77331,75716,1597,77313,916
2021-02-05,Alpine,003,1148,74,72,0,72,0
2021-02-05,Amador,005,37829,3344,3299,26,3325,33
2021-02-05,Butte,007,227075,10956,10421,1521,11942,150
2021-02-05,Calaveras,009,45235,1848,1818,11,1829,21
2021-02-05,Colusa,011,21464,1808,1785,231,2016,10
2021-02-05,Contra Costa,013,1133247,60141,58195,994,59189,560
2021-02-05,Del Norte,015,27424,918,874,4,878,2
2021-02-05,El Dorado,017,186661,8791,8527,574,9101,86
2021-02-05,Fresno,019,978130,93051,90513,7135,97648,1194
2021-02-05,Glenn,021,27897,2185,2122,458,2580,14
2021-02-05,Humboldt,023,135768,2925,2857,19,2876,28
2021-02-05,Imperial,025,180216,26881,26474,2371,28845,557
2021-02-05,Inyo,027,18085,1156,1104,8,1112,27
2021-02-05,Kern,029,883053,90372,87470,8873,96343,906
2021-02-05,Kings,031,150075,21598,21021,896,21917,190
2021-02-05,Lake,033,64148,2995,2906,1,2907,33
2021-02-05,Lassen,035,31185,5013,4936,86,5022,1
2021-02-05,Los Angeles,037,10098052,1146069,1110384,36906,1147290,17608
2021-02-05,Madera,039,155013,15085,14752,738,15490,95
2021-02-05,Marin,041,260295,12692,12479,143,12622,193
2021-02-05,Mariposa,043,17540,366,352,3,355,4
2021-02-05,Mendocino,045,87422,3469,3272,68,3340,38
2021-02-05,Merced,047,269075,27053,26760,789,27549,345
2021-02-05,Modoc,049,8938,328,312,105,417,3
2021-02-05,Mono,051,14174,1153,1157,15,1172,3
2021-02-05,Monterey,053,433212,40664,39840,1486,41326,281
2021-02-05,Napa,055,140530,8734,8598,31,8629,55
2021-02-05,Nevada,057,99092,3774,3607,147,3754,43
2021-02-05,Orange,059,3164182,240804,236335,9668,246003,3260
2021-02-05,Placer,061,380077,19829,18756,1016,19772,211
2021-02-05,Plumas,063,18699,628,578,10,588,2
2021-02-05,Riverside,065,2383286,278959,270666,12919,283585,3235
2021-02-05,Sacramento,067,1510023,90212,87992,1112,89104,1231
2021-02-05,San Benito,069,59416,5547,5502,77,5579,51
2021-02-05,San Bernardino,071,2135413,280792,272938,8222,281160,2495
2021-02-05,San Diego,073,3302833,254613,244066,12178,256244,2777
2021-02-05,San Francisco,075,870044,32768,32229,918,33147,337
2021-02-05,San Joaquin,077,732212,64313,62565,2524,65089,902
2021-02-05,San Luis Obispo,079,281455,18787,18152,492,18644,213
2021-02-05,San Mateo,081,765935,37974,36582,375,36957,227
2021-02-05,Santa Barbara,083,443738,30640,29455,943,30398,334
2021-02-05,Santa Clara,085,1922200,105735,104112,487,104599,1421
2021-02-05,Santa Cruz,087,273765,14849,13776,717,14493,161
2021-02-05,Shasta,089,179085,10580,10507,1122,11629,136
2021-02-05,Sierra,091,2930,49,42,12,54,0
2021-02-05,Siskiyou,093,43540,1385,1276,201,1477,4
2021-02-05,Solano,095,438530,28854,28283,328,28611,127
2021-02-05,Sonoma,097,501317,26683,26423,146,26569,252
2021-02-05,Stanislaus,099,539301,48416,47024,4954,51978,678
2021-02-05,Sutter,101,95872,8526,8443,76,8519,92
2021-02-05,Tehama,103,63373,4460,4355,465,4820,22
2021-02-05,Trinity,105,12862,446,260,65,325,3
2021-02-05,Tulare,107,460477,46685,45138,7083,52221,663
2021-02-05,Tuolumne,109,53932,3611,3595,33,3628,45
2021-02-05,Ventura,111,848112,74460,72953,2593,75546,546
2021-02-05,Yolo,113,214977,12386,12025,131,12156,162
2021-02-05,Yuba,115,75493,5278,5145,75,5220,35
2021-02-04,Alameda,001,1643700,77046,75422,1591,77013,899
2021-02-04,Alpine,003,1148,73,72,0,72,0
2021-02-04,Amador,005,37829,3341,3288,26,3314,33
2021-02-04,Butte,007,227075,10923,10386,1513,11899,147
2021-02-04,Calaveras,009,45235,1846,1808,11,1819,21
2021-02-04,Colusa,011,21464,1804,1777,229,2006,10
2021-02-04,Contra Costa,013,1133247,59954,57991,990,58981,550
2021-02-04,Del Norte,015,27424,912,870,4,874,2
2021-02-04,El Dorado,017,186661,8765,8490,571,9061,86
2021-02-04,Fresno,019,978130,92836,90126,7108,97234,1114
2021-02-04,Glenn,021,27897,2180,2102,457,2559,14
2021-02-04,Humboldt,023,135768,2915,2827,19,2846,28
2021-02-04,Imperial,025,180216,26836,26411,2369,28780,556
2021-02-04,Inyo,027,18085,1144,1084,8,1092,27
2021-02-04,Kern,029,883053,90098,87156,8797,95953,898
2021-02-04,Kings,031,150075,21548,20918,890,21808,187
2021-02-04,Lake,033,64148,2983,2882,1,2883,34
2021-02-04,Lassen,035,31185,5010,4927,86,5013,1
2021-02-04,Los Angeles,037,10098052,1143270,1106323,36782,1143105,17396
2021-02-04,Madera,039,155013,15055,14706,735,15441,95
2021-02-04,Marin,041,260295,12656,12431,143,12574,192
2021-02-04,Mariposa,043,17540,366,348,3,351,4
2021-02-04,Mendocino,045,87422,3451,3240,66,3306,38
2021-02-04,Merced,047,269075,26959,26629,786,27415,345
2021-02-04,Modoc,049,8938,328,309,105,414,3
2021-02-04,Mono,051,14174,1151,1153,15,1168,3
2021-02-04,Monterey,053,433212,40553,39619,1469,41088,279
2021-02-04,Napa,055,140530,8705,8573,31,8604,55
2021-02-04,Nevada,057,99092,3754,3590,146,3736,37
2021-02-04,Orange,059,3164182,240162,235677,9626,245303,3238
2021-02-04,Placer,061,380077,19769,18711,1007,19718,210
2021-02-04,Plumas,063,18699,625,562,10,572,2
2021-02-04,Riverside,065,2383286,278195,269851,12880,282731,3230
2021-02-04,Sacramento,067,1510023,89911,87658,1102,88760,1222
2021-02-04,San Benito,069,59416,5533,5488,76,5564,51
2021-02-04,San Bernardino,071,2135413,280243,272223,8202,280425,2409
2021-02-04,San Diego,073,3302833,253825,242613,12112,254725,2738
2021-02-04,San Francisco,075,870044,32654,32116,909,33025,326
2021-02-04,San Joaquin,077,732212,64088,62374,2516,64890,883
2021-02-04,San Luis Obispo,079,281455,18720,18058,490,18548,211
2021-02-04,San Mateo,081,765935,37853,36437,372,36809,226
2021-02-04,Santa Barbara,083,443738,30505,29344,926,30270,322
2021-02-04,Santa Clara,085,1922200,105392,103781,484,104265,1404
2021-02-04,Santa Cruz,087,273765,14816,13713,709,14422,156
2021-02-04,Shasta,089,179085,10554,10466,1117,11583,131
2021-02-04,Sierra,091,2930,49,42,12,54,0
2021-02-04,Siskiyou,093,43540,1376,1273,201,1474,4
2021-02-04,Solano,095,438530,28751,28192,327,28519,120
2021-02-04,Sonoma,097,501317,26601,26276,143,26419,249
2021-02-04,Stanislaus,099,539301,48255,46822,4935,51757,678
2021-02-04,Sutter,101,95872,8506,8401,76,8477,92
2021-02-04,Tehama,103,63373,4443,4327,464,4791,21
2021-02-04,Trinity,105,12862,445,260,64,324,3
2021-02-04,Tulare,107,460477,46558,44983,7025,52008,656
2021-02-04,Tuolumne,109,53932,3571,3585,33,3618,45
2021-02-04,Ventura,111,848112,74128,72595,2580,75175,537
2021-02-04,Yolo,113,214977,12352,11982,130,12112,161
2021-02-04,Yuba,115,75493,5252,5135,75,5210,34
2021-02-03,Alameda,001,1643700,76723,74968,1587,76555,880
2021-02-03,Alpine,003,1148,73,72,0,72,0
2021-02-03,Amador,005,37829,3337,3281,26,3307,33
2021-02-03,Butte,007,227075,10891,10355,1506,11861,144
2021-02-03,Calaveras,009,45235,1831,1799,11,1810,21
2021-02-03,Colusa,011,21464,1799,1773,228,2001,10
2021-02-03,Contra Costa,013,1133247,59713,57762,978,58740,537
2021-02-03,Del Norte,015,27424,907,869,4,873,2
2021-02-03,El Dorado,017,186661,8744,8428,570,8998,86
2021-02-03,Fresno,019,978130,92615,89748,7069,96817,1015
2021-02-03,Glenn,021,27897,2170,2098,456,2554,14
2021-02-03,Humboldt,023,135768,2905,2800,19,2819,27
2021-02-03,Imperial,025,180216,26800,26363,2363,28726,547
2021-02-03,Inyo,027,18085,1134,1071,8,1079,27
2021-02-03,Kern,029,883053,89855,86771,8756,95527,877
2021-02-03,Kings,031,150075,21487,20831,888,21719,172
2021-02-03,Lake,033,64148,2965,2869,1,2870,33
2021-02-03,Lassen,035,31185,4998,4910,86,4996,1
2021-02-03,Los Angeles,037,10098052,1140187,1101890,36661,1138551,17163
2021-02-03,Madera,039,155013,15015,14605,733,15338,94
2021-02-03,Marin,041,260295,12621,12406,143,12549,190
2021-02-03,Mariposa,043,17540,365,347,3,350,4
2021-02-03,Mendocino,045,87422,3425,3236,65,3301,38
2021-02-03,Merced,047,269075,26844,26520,782,27302,343
2021-02-03,Modoc,049,8938,327,308,105,413,3
2021-02-03,Mono,051,14174,1144,1146,15,1161,3
2021-02-03,Monterey,053,433212,40426,39500,1452,40952,279
2021-02-03,Napa,055,140530,8670,8534,31,8565,54
2021-02-03,Nevada,057,99092,3740,3572,146,3718,35
2021-02-03,Orange,059,3164182,239418,234738,9594,244332,3189
2021-02-03,Placer,061,380077,19714,18646,1005,19651,210
2021-02-03,Plumas,063,18699,625,559,10,569,2
2021-02-03,Riverside,065,2383286,277453,269019,12850,281869,3195
2021-02-03,Sacramento,067,1510023,89588,87415,1098,88513,1212
2021-02-03,San Benito,069,59416,5515,5463,73,5536,51
2021-02-03,San Bernardino,071,2135413,279757,271477,8179,279656,2308
2021-02-03,San Diego,073,3302833,252923,241015,12066,253081,2683
2021-02-03,San Francisco,075,870044,32524,31983,904,32887,325
2021-02-03,San Joaquin,077,732212,63860,61976,2506,64482,880
2021-02-03,San Luis Obispo,079,281455,18642,17922,487,18409,206
2021-02-03,San Mateo,081,765935,37715,36227,368,36595,225
2021-02-03,Santa Barbara,083,443738,30356,29121,917,30038,315
2021-02-03,Santa Clara,085,1922200,105076,103278,482,103760,1364
2021-02-03,Santa Cruz,087,273765,14761,13611,703,14314,154
2021-02-03,Shasta,089,179085,10511,10422,1112,11534,130
2021-02-03,Sierra,091,2930,49,42,12,54,0
2021-02-03,Siskiyou,093,43540,1365,1268,200,1468,4
2021-02-03,Solano,095,438530,28629,28057,327,28384,119
2021-02-03,Sonoma,097,501317,26517,26155,142,26297,248
2021-02-03,Stanislaus,099,539301,48079,46598,4916,51514,662
2021-02-03,Sutter,101,95872,8481,8379,76,8455,90
2021-02-03,Tehama,103,63373,4425,4309,461,4770,21
2021-02-03,Trinity,105,12862,445,260,63,323,3
2021-02-03,Tulare,107,460477,46387,44838,6969,51807,640
2021-02-03,Tuolumne,109,53932,3560,3568,33,3601,45
2021-02-03,Ventura,111,848112,73791,72124,2570,74694,526
2021-02-03,Yolo,113,214977,12327,11933,130,12063,161
2021-02-03,Yuba,115,75493,5234,5124,75,5199,34
2021-02-02,Alameda,001,1643700,76378,74642,1575,76217,869
2021-02-02,Alpine,003,1148,73,72,0,72,0
2021-02-02,Amador,005,37829,3306,3275,26,3301,33
2021-02-02,Butte,007,227075,10865,10307,1497,11804,141
2021-02-02,Calaveras,009,45235,1822,1786,11,1797,21
2021-02-02,Colusa,011,21464,1791,1769,223,1992,9
2021-02-02,Contra Costa,013,1133247,59433,57551,975,58526,536
2021-02-02,Del Norte,015,27424,901,868,4,872,2
2021-02-02,El Dorado,017,186661,8704,8405,570,8975,84
2021-02-02,Fresno,019,978130,92314,89542,7034,96576,1009
2021-02-02,Glenn,021,27897,2158,2090,453,2543,14
2021-02-02,Humboldt,023,135768,2893,2784,19,2803,25
2021-02-02,Imperial,025,180216,26747,26317,2357,28674,535
2021-02-02,Inyo,027,18085,1131,1074,8,1082,27
2021-02-02,Kern,029,883053,89552,86485,8680,95165,867
2021-02-02,Kings,031,150075,21409,20785,880,21665,172
2021-02-02,Lake,033,64148,2945,2857,1,2858,33
2021-02-02,Lassen,035,31185,4991,4908,86,4994,1
2021-02-02,Los Angeles,037,10098052,1136802,1097573,36499,1134072,16913
2021-02-02,Madera,039,155013,14964,14595,728,15323,94
2021-02-02,Marin,041,260295,12592,12367,143,12510,189
2021-02-02,Mariposa,043,17540,362,345,3,348,4
2021-02-02,Mendocino,045,87422,3392,3210,65,3275,38
2021-02-02,Merced,047,269075,26747,26427,776,27203,340
2021-02-02,Modoc,049,8938,322,306,105,411,3
2021-02-02,Mono,051,14174,1142,1147,15,1162,3
2021-02-02,Monterey,053,433212,40291,39371,1438,40809,278
2021-02-02,Napa,055,140530,8641,8505,31,8536,53
2021-02-02,Nevada,057,99092,3725,3548,146,3694,20
2021-02-02,Orange,059,3164182,238616,233783,9559,243342,3152
2021-02-02,Placer,061,380077,19656,18615,1001,19616,205
2021-02-02,Plumas,063,18699,625,560,10,570,2
2021-02-02,Riverside,065,2383286,276593,267901,12816,280717,3169
2021-02-02,Sacramento,067,1510023,89298,87107,1087,88194,1202
2021-02-02,San Benito,069,59416,5501,5444,72,5516,50
2021-02-02,San Bernardino,071,2135413,279079,270486,8150,278636,2244
2021-02-02,San Diego,073,3302833,251884,240047,11979,252026,2629
2021-02-02,San Francisco,075,870044,32370,31788,894,32682,324
2021-02-02,San Joaquin,077,732212,63639,61708,2493,64201,878
2021-02-02,San Luis Obispo,079,281455,18548,17811,485,18296,201
2021-02-02,San Mateo,081,765935,37551,36004,362,36366,225
2021-02-02,Santa Barbara,083,443738,30185,28951,910,29861,304
2021-02-02,Santa Clara,085,1922200,104611,102872,477,103349,1349
2021-02-02,Santa Cruz,087,273765,14702,13572,699,14271,150
2021-02-02,Shasta,089,179085,10485,10371,1102,11473,128
2021-02-02,Sierra,091,2930,49,42,12,54,0
2021-02-02,Siskiyou,093,43540,1358,1252,197,1449,4
2021-02-02,Solano,095,438530,28533,27963,323,28286,118
2021-02-02,Sonoma,097,501317,26401,26054,142,26196,247
2021-02-02,Stanislaus,099,539301,47860,46306,4884,51190,641
2021-02-02,Sutter,101,95872,8458,8340,76,8416,89
2021-02-02,Tehama,103,63373,4411,4289,460,4749,21
2021-02-02,Trinity,105,12862,445,260,63,323,3
2021-02-02,Tulare,107,460477,46231,44720,6904,51624,625
2021-02-02,Tuolumne,109,53932,3548,3548,33,3581,39
2021-02-02,Ventura,111,848112,73375,71557,2560,74117,514
2021-02-02,Yolo,113,214977,12282,11886,129,12015,158
2021-02-02,Yuba,115,75493,5216,5111,74,5185,34
2021-02-01,Alameda,001,1643700,76023,74374,1570,75944,858
2021-02-01,Alpine,003,1148,73,72,0,72,0
2021-02-01,Amador,005,37829,3295,3234,26,3260,32
2021-02-01,Butte,007,227075,10821,10263,1493,11756,141
2021-02-01,Calaveras,009,45235,1815,1785,11,1796,21
2021-02-01,Colusa,011,21464,1786,1763,214,1977,9
2021-02-01,Contra Costa,013,1133247,59190,57324,974,58298,531
2021-02-01,Del Norte,015,27424,897,865,4,869,2
2021-02-01,El Dorado,017,186661,8665,8337,570,8907,83
2021-02-01,Fresno,019,978130,91982,89272,6999,96271,994
2021-02-01,Glenn,021,27897,2142,2086,445,2531,14
2021-02-01,Humboldt,023,135768,2872,2773,18,2791,25
2021-02-01,Imperial,025,180216,26703,26224,2355,28579,530
2021-02-01,Inyo,027,18085,1121,1072,8,1080,27
2021-02-01,Kern,029,883053,89155,86170,8612,94782,862
2021-02-01,Kings,031,150075,21318,20746,872,21618,172
2021-02-01,Lake,033,64148,2929,2843,1,2844,33
2021-02-01,Lassen,035,31185,4971,4907,86,4993,1
2021-02-01,Los Angeles,037,10098052,1132975,1094341,36334,1130675,16695
2021-02-01,Madera,039,155013,14929,14572,725,15297,94
2021-02-01,Marin,041,260295,12553,12341,142,12483,188
2021-02-01,Mariposa,043,17540,360,344,3,347,4
2021-02-01,Mendocino,045,87422,3359,3192,65,3257,37
2021-02-01,Merced,047,269075,26623,26282,767,27049,337
2021-02-01,Modoc,049,8938,316,303,101,404,1
2021-02-01,Mono,051,14174,1139,1145,15,1160,3
2021-02-01,Monterey,053,433212,40107,39196,1417,40613,278
2021-02-01,Napa,055,140530,8609,8449,31,8480,52
2021-02-01,Nevada,057,99092,3708,3535,145,3680,20
2021-02-01,Orange,059,3164182,237704,233155,9514,242669,3100
2021-02-01,Placer,061,380077,19589,18574,994,19568,204
2021-02-01,Plumas,063,18699,623,554,10,564,2
2021-02-01,Riverside,065,2383286,275654,267025,12781,279806,3092
2021-02-01,Sacramento,067,1510023,88896,86856,1076,87932,1193
2021-02-01,San Benito,069,59416,5483,5432,72,5504,48
2021-02-01,San Bernardino,071,2135413,278382,270012,8111,278123,2172
2021-02-01,San Diego,073,3302833,250659,239121,11903,251024,2619
2021-02-01,San Francisco,075,870044,32235,31703,882,32585,324
2021-02-01,San Joaquin,077,732212,63433,61542,2482,64024,877
2021-02-01,San Luis Obispo,079,281455,18428,17690,478,18168,199
2021-02-01,San Mateo,081,765935,37402,35843,362,36205,220
2021-02-01,Santa Barbara,083,443738,30016,28837,902,29739,297
2021-02-01,Santa Clara,085,1922200,104194,102462,476,102938,1343
2021-02-01,Santa Cruz,087,273765,14649,13524,697,14221,149
2021-02-01,Shasta,089,179085,10460,10329,1096,11425,112
2021-02-01,Sierra,091,2930,49,42,12,54,0
2021-02-01,Siskiyou,093,43540,1351,1238,194,1432,4
2021-02-01,Solano,095,438530,28428,27844,322,28166,117
2021-02-01,Sonoma,097,501317,26313,26011,141,26152,243
2021-02-01,Stanislaus,099,539301,47603,46112,4856,50968,642
2021-02-01,Sutter,101,95872,8419,8313,76,8389,89
2021-02-01,Tehama,103,63373,4385,4263,460,4723,21
2021-02-01,Trinity,105,12862,443,260,63,323,3
2021-02-01,Tulare,107,460477,46086,44569,6824,51393,618
2021-02-01,Tuolumne,109,53932,3540,3534,33,3567,39
2021-02-01,Ventura,111,848112,72970,71104,2543,73647,502
2021-02-01,Yolo,113,214977,12234,11824,129,11953,151
2021-02-01,Yuba,115,75493,5202,5084,73,5157,33
2021-01-31,Alameda,001,1643700,75597,73979,1562,75541,857
2021-01-31,Alpine,003,1148,73,72,0,72,0
2021-01-31,Amador,005,37829,3285,3212,25,3237,32
2021-01-31,Butte,007,227075,10776,10215,1483,11698,140
2021-01-31,Calaveras,009,45235,1795,1778,11,1789,21
2021-01-31,Colusa,011,21464,1780,1754,209,1963,9
2021-01-31,Contra Costa,013,1133247,58858,57079,974,58053,531
2021-01-31,Del Norte,015,27424,895,865,4,869,2
2021-01-31,El Dorado,017,186661,8628,8317,568,8885,83
2021-01-31,Fresno,019,978130,91670,88852,6945,95797,994
2021-01-31,Glenn,021,27897,2132,2083,444,2527,14
2021-01-31,Humboldt,023,135768,2856,2767,18,2785,25
2021-01-31,Imperial,025,180216,26631,26206,2346,28552,530
2021-01-31,Inyo,027,18085,1108,1072,8,1080,27
2021-01-31,Kern,029,883053,88658,85872,8528,94400,861
2021-01-31,Kings,031,150075,21234,20709,860,21569,172
2021-01-31,Lake,033,64148,2908,2826,1,2827,33
2021-01-31,Lassen,035,31185,4955,4900,86,4986,1
2021-01-31,Los Angeles,037,10098052,1128345,1090304,36133,1126437,16609
2021-01-31,Madera,039,155013,14875,14496,717,15213,94
2021-01-31,Marin,041,260295,12506,12297,138,12435,185
2021-01-31,Mariposa,043,17540,358,344,3,347,4
2021-01-31,Mendocino,045,87422,3336,3181,64,3245,37
2021-01-31,Merced,047,269075,26479,26222,762,26984,337
2021-01-31,Modoc,049,8938,313,304,99,403,1
2021-01-31,Mono,051,14174,1136,1146,15,1161,3
2021-01-31,Monterey,053,433212,39928,39035,1390,40425,278
2021-01-31,Napa,055,140530,8567,8404,31,8435,52
2021-01-31,Nevada,057,99092,3686,3518,143,3661,20
2021-01-31,Orange,059,3164182,236686,232347,9474,241821,3053
2021-01-31,Placer,061,380077,19511,18506,983,19489,204
2021-01-31,Plumas,063,18699,622,554,10,564,2
2021-01-31,Riverside,065,2383286,274636,266145,12734,278879,3074
2021-01-31,Sacramento,067,1510023,88454,86560,1062,87622,1186
2021-01-31,San Benito,069,59416,5461,5425,70,5495,48
2021-01-31,San Bernardino,071,2135413,277380,269533,8082,277615,2156
2021-01-31,San Diego,073,3302833,249346,238039,11789,249828,2619
2021-01-31,San Francisco,075,870044,32046,31563,871,32434,323
2021-01-31,San Joaquin,077,732212,63032,61379,2473,63852,877
2021-01-31,San Luis Obispo,079,281455,18295,17615,473,18088,199
2021-01-31,San Mateo,081,765935,37212,35659,359,36018,219
2021-01-31,Santa Barbara,083,443738,29772,28570,893,29463,297
2021-01-31,Santa Clara,085,1922200,103659,101986,467,102453,1330
2021-01-31,Santa Cruz,087,273765,14554,13469,683,14152,149
2021-01-31,Shasta,089,179085,10415,10313,1088,11401,112
2021-01-31,Sierra,091,2930,48,43,12,55,0
2021-01-31,Siskiyou,093,43540,1341,1238,194,1432,4
2021-01-31,Solano,095,438530,28298,27678,322,28000,118
2021-01-31,Sonoma,097,501317,26210,25925,140,26065,243
2021-01-31,Stanislaus,099,539301,47319,45971,4826,50797,642
2021-01-31,Sutter,101,95872,8374,8289,76,8365,89
2021-01-31,Tehama,103,63373,4363,4256,459,4715,21
2021-01-31,Trinity,105,12862,441,260,63,323,3
2021-01-31,Tulare,107,460477,45919,44440,6744,51184,618
2021-01-31,Tuolumne,109,53932,3502,3519,33,3552,39
2021-01-31,Ventura,111,848112,72375,70635,2530,73165,502
2021-01-31,Yolo,113,214977,12173,11771,129,11900,151
2021-01-31,Yuba,115,75493,5182,5071,73,5144,33
2021-01-30,Alameda,001,1643700,75393,73622,1557,75179,850
2021-01-30,Alpine,003,1148,73,72,0,72,0
2021-01-30,Amador,005,37829,3281,3181,25,3206,32
2021-01-30,Butte,007,227075,10742,10177,1474,11651,139
2021-01-30,Calaveras,009,45235,1782,1763,11,1774,21
2021-01-30,Colusa,011,21464,1778,1748,209,1957,9
2021-01-30,Contra Costa,013,1133247,58679,56763,970,57733,531
2021-01-30,Del Norte,015,27424,894,865,4,869,2
2021-01-30,El Dorado,017,186661,8608,8299,567,8866,83
2021-01-30,Fresno,019,978130,91490,88476,6925,95401,964
2021-01-30,Glenn,021,27897,2129,2074,442,2516,14
2021-01-30,Humboldt,023,135768,2845,2742,18,2760,24
2021-01-30,Imperial,025,180216,26607,26160,2344,28504,530
2021-01-30,Inyo,027,18085,1104,1068,8,1076,27
2021-01-30,Kern,029,883053,88457,85572,8463,94035,848
2021-01-30,Kings,031,150075,21163,20605,855,21460,169
2021-01-30,Lake,033,64148,2902,2809,1,2810,33
2021-01-30,Lassen,035,31185,4951,4890,86,4976,1
2021-01-30,Los Angeles,037,10098052,1125946,1084763,35991,1120754,16484
2021-01-30,Madera,039,155013,14833,14443,712,15155,94
2021-01-30,Marin,041,260295,12479,12225,137,12362,185
2021-01-30,Mariposa,043,17540,356,344,3,347,4
2021-01-30,Mendocino,045,87422,3322,3153,63,3216,36
2021-01-30,Merced,047,269075,26405,26078,760,26838,335
2021-01-30,Modoc,049,8938,313,303,99,402,1
2021-01-30,Mono,051,14174,1136,1143,15,1158,3
2021-01-30,Monterey,053,433212,39868,38847,1388,40235,277
2021-01-30,Napa,055,140530,8551,8342,31,8373,52
2021-01-30,Nevada,057,99092,3667,3499,143,3642,20
2021-01-30,Orange,059,3164182,236141,231358,9437,240795,3013
2021-01-30,Placer,061,380077,19458,18430,977,19407,205
2021-01-30,Plumas,063,18699,620,554,10,564,2
2021-01-30,Riverside,065,2383286,274039,265137,12703,277840,3061
2021-01-30,Sacramento,067,1510023,88263,86388,1057,87445,1184
2021-01-30,San Benito,069,59416,5443,5401,69,5470,48
2021-01-30,San Bernardino,071,2135413,276950,268660,8063,276723,2122
2021-01-30,San Diego,073,3302833,248581,236765,11744,248509,2603
2021-01-30,San Francisco,075,870044,31945,31427,868,32295,316
2021-01-30,San Joaquin,077,732212,62900,61120,2464,63584,864
2021-01-30,San Luis Obispo,079,281455,18215,17522,472,17994,198
2021-01-30,San Mateo,081,765935,37073,35451,358,35809,219
2021-01-30,Santa Barbara,083,443738,29630,28342,891,29233,296
2021-01-30,Santa Clara,085,1922200,103330,101471,465,101936,1307
2021-01-30,Santa Cruz,087,273765,14514,13383,682,14065,149
2021-01-30,Shasta,089,179085,10396,10283,1085,11368,112
2021-01-30,Sierra,091,2930,48,43,12,55,0
2021-01-30,Siskiyou,093,43540,1338,1236,193,1429,4
2021-01-30,Solano,095,438530,28215,27511,321,27832,118
2021-01-30,Sonoma,097,501317,26162,25810,137,25947,243
2021-01-30,Stanislaus,099,539301,47189,45697,4799,50496,642
2021-01-30,Sutter,101,95872,8358,8226,76,8302,87
2021-01-30,Tehama,103,63373,4350,4229,458,4687,21
2021-01-30,Trinity,105,12862,441,259,63,322,3
2021-01-30,Tulare,107,460477,45783,44203,6708,50911,615
2021-01-30,Tuolumne,109,53932,3498,3508,33,3541,36
2021-01-30,Ventura,111,848112,72063,69931,2516,72447,493
2021-01-30,Yolo,113,214977,12159,11698,128,11826,151
2021-01-30,Yuba,115,75493,5172,5042,72,5114,33
2021-01-29,Alameda,001,1643700,75126,73210,1550,74760,841
2021-01-29,Alpine,003,1148,73,72,0,72,0
2021-01-29,Amador,005,37829,3269,3134,24,3158,32
2021-01-29,Butte,007,227075,10710,10122,1465,11587,138
2021-01-29,Calaveras,009,45235,1771,1757,11,1768,21
2021-01-29,Colusa,011,21464,1774,1734,208,1942,8
2021-01-29,Contra Costa,013,1133247,58512,56318,968,57286,529
2021-01-29,Del Norte,015,27424,893,865,4,869,2
2021-01-29,El Dorado,017,186661,8591,8231,566,8797,83
2021-01-29,Fresno,019,978130,91276,87936,6888,94824,962
2021-01-29,Glenn,021,27897,2124,2061,441,2502,14
2021-01-29,Humboldt,023,135768,2832,2707,18,2725,24
2021-01-29,Imperial,025,180216,26592,26045,2341,28386,521
2021-01-29,Inyo,027,18085,1092,1048,8,1056,27
2021-01-29,Kern,029,883053,88230,85044,8412,93456,836
2021-01-29,Kings,031,150075,21124,20466,850,21316,169
2021-01-29,Lake,033,64148,2892,2792,1,2793,32
2021-01-29,Lassen,035,31185,4948,4874,86,4960,1
2021-01-29,Los Angeles,037,10098052,1122450,1078329,35841,1114170,16190
2021-01-29,Madera,039,155013,14786,14377,712,15089,94
2021-01-29,Marin,041,260295,12434,12145,136,12281,185
2021-01-29,Mariposa,043,17540,355,342,3,345,4
2021-01-29,Mendocino,045,87422,3313,3131,62,3193,36
2021-01-29,Merced,047,269075,26331,25865,755,26620,334
2021-01-29,Modoc,049,8938,312,297,99,396,1
2021-01-29,Mono,051,14174,1134,1139,15,1154,3
2021-01-29,Monterey,053,433212,39755,38539,1380,39919,277
2021-01-29,Napa,055,140530,8520,8276,31,8307,52
2021-01-29,Nevada,057,99092,3658,3487,142,3629,20
2021-01-29,Orange,059,3164182,235465,229917,9400,239317,2967
2021-01-29,Placer,061,380077,19405,18367,973,19340,203
2021-01-29,Plumas,063,18699,619,548,10,558,2
2021-01-29,Riverside,065,2383286,273237,263504,12671,276175,3008
2021-01-29,Sacramento,067,1510023,88009,86320,1053,87373,1169
2021-01-29,San Benito,069,59416,5435,5386,69,5455,48
2021-01-29,San Bernardino,071,2135413,276434,267490,8025,275515,2095
2021-01-29,San Diego,073,3302833,247639,234637,11666,246303,2571
2021-01-29,San Francisco,075,870044,31806,31294,860,32154,307
2021-01-29,San Joaquin,077,732212,62756,60899,2450,63349,858
2021-01-29,San Luis Obispo,079,281455,18155,17440,467,17907,193
2021-01-29,San Mateo,081,765935,36940,35223,355,35578,218
2021-01-29,Santa Barbara,083,443738,29497,28105,885,28990,291
2021-01-29,Santa Clara,085,1922200,102976,101010,463,101473,1273
2021-01-29,Santa Cruz,087,273765,14461,13311,679,13990,148
2021-01-29,Shasta,089,179085,10379,10220,1081,11301,112
2021-01-29,Sierra,091,2930,48,43,12,55,0
2021-01-29,Siskiyou,093,43540,1337,1227,193,1420,4
2021-01-29,Solano,095,438530,28132,27352,319,27671,116
2021-01-29,Sonoma,097,501317,26106,25710,136,25846,243
2021-01-29,Stanislaus,099,539301,47046,45466,4777,50243,642
2021-01-29,Sutter,101,95872,8339,8181,76,8257,87
2021-01-29,Tehama,103,63373,4338,4191,456,4647,20
2021-01-29,Trinity,105,12862,441,260,63,323,3
2021-01-29,Tulare,107,460477,45676,43925,6669,50594,606
2021-01-29,Tuolumne,109,53932,3488,3483,33,3516,36
2021-01-29,Ventura,111,848112,71641,69511,2503,72014,484
2021-01-29,Yolo,113,214977,12121,11612,128,11740,151
2021-01-29,Yuba,115,75493,5156,5018,72,5090,32
2021-01-28,Alameda,001,1643700,74703,72758,1542,74300,833
2021-01-28,Alpine,003,1148,73,72,0,72,0
2021-01-28,Amador,005,37829,3232,3124,24,3148,31
2021-01-28,Butte,007,227075,10669,10037,1455,11492,138
2021-01-28,Calaveras,009,45235,1758,1747,10,1757,21
2021-01-28,Colusa,011,21464,1767,1731,204,1935,8
2021-01-28,Contra Costa,013,1133247,58269,55999,958,56957,525
2021-01-28,Del Norte,015,27424,892,862,4,866,2
2021-01-28,El Dorado,017,186661,8576,8198,561,8759,79
2021-01-28,Fresno,019,978130,90990,87401,6841,94242,949
2021-01-28,Glenn,021,27897,2119,2043,434,2477,14
2021-01-28,Humboldt,023,135768,2815,2686,18,2704,24
2021-01-28,Imperial,025,180216,26548,25984,2334,28318,517
2021-01-28,Inyo,027,18085,1087,1039,8,1047,27
2021-01-28,Kern,029,883053,87901,84708,8329,93037,817
2021-01-28,Kings,031,150075,21064,20328,847,21175,167
2021-01-28,Lake,033,64148,2877,2772,1,2773,32
2021-01-28,Lassen,035,31185,4942,4865,86,4951,1
2021-01-28,Los Angeles,037,10098052,1118535,1072412,35655,1108067,15967
2021-01-28,Madera,039,155013,14731,14301,708,15009,94
2021-01-28,Marin,041,260295,12385,12079,135,12214,183
2021-01-28,Mariposa,043,17540,355,334,3,337,4
2021-01-28,Mendocino,045,87422,3296,3110,62,3172,36
2021-01-28,Merced,047,269075,26209,25620,743,26363,328
2021-01-28,Modoc,049,8938,311,297,99,396,0
2021-01-28,Mono,051,14174,1132,1131,15,1146,3
2021-01-28,Monterey,053,433212,39561,38312,1361,39673,274
2021-01-28,Napa,055,140530,8473,8233,31,8264,50
2021-01-28,Nevada,057,99092,3643,3452,141,3593,19
2021-01-28,Orange,059,3164182,234488,228636,9370,238006,2860
2021-01-28,Placer,061,380077,19345,18246,970,19216,198
2021-01-28,Plumas,063,18699,618,547,10,557,2
2021-01-28,Riverside,065,2383286,272456,262342,12623,274965,2981
2021-01-28,Sacramento,067,1510023,87646,85698,1042,86740,1149
2021-01-28,San Benito,069,59416,5417,5344,68,5412,47
2021-01-28,San Bernardino,071,2135413,275733,266456,8004,274460,2057
2021-01-28,San Diego,073,3302833,246486,232967,11577,244544,2534
2021-01-28,San Francisco,075,870044,31669,31193,844,32037,290
2021-01-28,San Joaquin,077,732212,62492,60627,2436,63063,854
2021-01-28,San Luis Obispo,079,281455,18055,17279,465,17744,189
2021-01-28,San Mateo,081,765935,36771,34931,339,35270,218
2021-01-28,Santa Barbara,083,443738,29274,27674,872,28546,284
2021-01-28,Santa Clara,085,1922200,102520,100470,461,100931,1219
2021-01-28,Santa Cruz,087,273765,14371,13188,673,13861,145
2021-01-28,Shasta,089,179085,10345,10176,1073,11249,110
2021-01-28,Sierra,091,2930,48,43,12,55,0
2021-01-28,Siskiyou,093,43540,1330,1218,191,1409,4
2021-01-28,Solano,095,438530,27972,27163,318,27481,114
2021-01-28,Sonoma,097,501317,26015,25564,136,25700,236
2021-01-28,Stanislaus,099,539301,46838,45162,4758,49920,640
2021-01-28,Sutter,101,95872,8292,8136,76,8212,85
2021-01-28,Tehama,103,63373,4315,4163,453,4616,20
2021-01-28,Trinity,105,12862,439,260,63,323,3
2021-01-28,Tulare,107,460477,45520,43742,6594,50336,595
2021-01-28,Tuolumne,109,53932,3474,3472,33,3505,32
2021-01-28,Ventura,111,848112,71129,68896,2487,71383,475
2021-01-28,Yolo,113,214977,12078,11500,124,11624,151
2021-01-28,Yuba,115,75493,5140,4994,71,5065,32
2021-01-27,Alameda,001,1643700,74284,72188,1535,73723,815
2021-01-27,Alpine,003,1148,73,72,0,72,0
2021-01-27,Amador,005,37829,3216,3116,24,3140,31
2021-01-27,Butte,007,227075,10630,9988,1443,11431,138
2021-01-27,Calaveras,009,45235,1749,1737,10,1747,21
2021-01-27,Colusa,011,21464,1761,1724,202,1926,8
2021-01-27,Contra Costa,013,1133247,57974,55578,955,56533,507
2021-01-27,Del Norte,015,27424,891,859,4,863,2
2021-01-27,El Dorado,017,186661,8550,8141,560,8701,76
2021-01-27,Fresno,019,978130,90698,86886,6799,93685,938
2021-01-27,Glenn,021,27897,2115,2042,433,2475,14
2021-01-27,Humboldt,023,135768,2793,2630,18,2648,24
2021-01-27,Imperial,025,180216,26494,25861,2320,28181,504
2021-01-27,Inyo,027,18085,1083,1023,8,1031,27
2021-01-27,Kern,029,883053,87591,84244,8259,92503,809
2021-01-27,Kings,031,150075,20958,20211,839,21050,167
2021-01-27,Lake,033,64148,2857,2750,1,2751,32
2021-01-27,Lassen,035,31185,4936,4851,86,4937,1
2021-01-27,Los Angeles,037,10098052,1113726,1066569,35449,1102018,15757
2021-01-27,Madera,039,155013,14689,14194,703,14897,86
2021-01-27,Marin,041,260295,12347,12028,134,12162,180
2021-01-27,Mariposa,043,17540,355,333,3,336,4
2021-01-27,Mendocino,045,87422,3276,3095,62,3157,36
2021-01-27,Merced,047,269075,26050,25439,732,26171,315
2021-01-27,Modoc,049,8938,311,297,96,393,0
2021-01-27,Mono,051,14174,1130,1131,15,1146,3
2021-01-27,Monterey,053,433212,39354,38139,1342,39481,268
2021-01-27,Napa,055,140530,8400,8187,31,8218,46
2021-01-27,Nevada,057,99092,3621,3431,141,3572,18
2021-01-27,Orange,059,3164182,233372,227110,9318,236428,2832
2021-01-27,Placer,061,380077,19275,18106,959,19065,198
2021-01-27,Plumas,063,18699,618,544,10,554,2
2021-01-27,Riverside,065,2383286,271260,260796,12572,273368,2931
2021-01-27,Sacramento,067,1510023,87286,85428,1031,86459,1142
2021-01-27,San Benito,069,59416,5402,5284,68,5352,47
2021-01-27,San Bernardino,071,2135413,274878,265153,7971,273124,2019
2021-01-27,San Diego,073,3302833,245157,231478,11472,242950,2465
2021-01-27,San Francisco,075,870044,31525,31082,837,31919,287
2021-01-27,San Joaquin,077,732212,62222,60131,2417,62548,853
2021-01-27,San Luis Obispo,079,281455,17947,17119,461,17580,188
2021-01-27,San Mateo,081,765935,36616,34619,336,34955,216
2021-01-27,Santa Barbara,083,443738,29097,27435,866,28301,282
2021-01-27,Santa Clara,085,1922200,102104,99732,457,100189,1184
2021-01-27,Santa Cruz,087,273765,14301,13111,670,13781,143
2021-01-27,Shasta,089,179085,10311,10106,1067,11173,105
2021-01-27,Sierra,091,2930,48,44,12,56,0
2021-01-27,Siskiyou,093,43540,1325,1214,188,1402,4
2021-01-27,Solano,095,438530,27795,26982,311,27293,112
2021-01-27,Sonoma,097,501317,25916,25361,132,25493,237
2021-01-27,Stanislaus,099,539301,46654,44874,4733,49607,624
2021-01-27,Sutter,101,95872,8249,8093,76,8169,83
2021-01-27,Tehama,103,63373,4295,4133,449,4582,20
2021-01-27,Trinity,105,12862,439,260,63,323,3
2021-01-27,Tulare,107,460477,45333,43462,6524,49986,583
2021-01-27,Tuolumne,109,53932,3464,3464,33,3497,32
2021-01-27,Ventura,111,848112,70655,68291,2462,70753,468
2021-01-27,Yolo,113,214977,12030,11427,122,11549,151
2021-01-27,Yuba,115,75493,5124,4968,71,5039,32
2021-01-26,Alameda,001,1643700,73909,71851,1518,73369,789
2021-01-26,Alpine,003,1148,73,72,0,72,0
2021-01-26,Amador,005,37829,3205,3113,24,3137,31
2021-01-26,Butte,007,227075,10588,9943,1437,11380,136
2021-01-26,Calaveras,009,45235,1739,1723,10,1733,21
2021-01-26,Colusa,011,21464,1754,1719,199,1918,8
2021-01-26,Contra Costa,013,1133247,57701,55337,947,56284,491
2021-01-26,Del Norte,015,27424,890,856,4,860,2
2021-01-26,El Dorado,017,186661,8525,8115,558,8673,71
2021-01-26,Fresno,019,978130,90340,86673,6756,93429,923
2021-01-26,Glenn,021,27897,2105,2034,428,2462,13
2021-01-26,Humboldt,023,135768,2772,2612,17,2629,24
2021-01-26,Imperial,025,180216,26422,25812,2308,28120,498
2021-01-26,Inyo,027,18085,1077,1018,8,1026,27
2021-01-26,Kern,029,883053,87168,83868,8184,92052,790
2021-01-26,Kings,031,150075,20900,20156,834,20990,159
2021-01-26,Lake,033,64148,2849,2748,1,2749,32
2021-01-26,Lassen,035,31185,4930,4844,86,4930,1
2021-01-26,Los Angeles,037,10098052,1108438,1060492,35248,1095740,15458
2021-01-26,Madera,039,155013,14632,14130,697,14827,86
2021-01-26,Marin,041,260295,12303,11993,132,12125,179
2021-01-26,Mariposa,043,17540,353,332,3,335,3
2021-01-26,Mendocino,045,87422,3250,3076,61,3137,36
2021-01-26,Merced,047,269075,25910,25359,724,26083,309
2021-01-26,Modoc,049,8938,304,291,95,386,0
2021-01-26,Mono,051,14174,1128,1120,15,1135,3
2021-01-26,Monterey,053,433212,39160,37963,1322,39285,255
2021-01-26,Napa,055,140530,8343,8145,31,8176,43
2021-01-26,Nevada,057,99092,3614,3410,140,3550,18
2021-01-26,Orange,059,3164182,232249,225987,9272,235259,2760
2021-01-26,Placer,061,380077,19199,18016,957,18973,193
2021-01-26,Plumas,063,18699,616,536,10,546,2
2021-01-26,Riverside,065,2383286,269891,259399,12509,271908,2898
2021-01-26,Sacramento,067,1510023,86928,85062,1024,86086,1127
2021-01-26,San Benito,069,59416,5388,5251,67,5318,45
2021-01-26,San Bernardino,071,2135413,273884,263736,7929,271665,1970
2021-01-26,San Diego,073,3302833,243662,230063,11370,241433,2421
2021-01-26,San Francisco,075,870044,31393,30874,818,31692,286
2021-01-26,San Joaquin,077,732212,61970,59889,2401,62290,847
2021-01-26,San Luis Obispo,079,281455,17866,17016,458,17474,186
2021-01-26,San Mateo,081,765935,36422,34441,325,34766,213
2021-01-26,Santa Barbara,083,443738,28921,27321,854,28175,273
2021-01-26,Santa Clara,085,1922200,101625,99215,454,99669,1171
2021-01-26,Santa Cruz,087,273765,14235,13045,664,13709,134
2021-01-26,Shasta,089,179085,10276,10036,1059,11095,103
2021-01-26,Sierra,091,2930,48,43,12,55,0
2021-01-26,Siskiyou,093,43540,1310,1208,186,1394,4
2021-01-26,Solano,095,438530,27639,26858,304,27162,110
2021-01-26,Sonoma,097,501317,25797,25273,130,25403,236
2021-01-26,Stanislaus,099,539301,46472,44703,4693,49396,599
2021-01-26,Sutter,101,95872,8206,8067,76,8143,83
2021-01-26,Tehama,103,63373,4262,4115,449,4564,20
2021-01-26,Trinity,105,12862,439,260,63,323,3
2021-01-26,Tulare,107,460477,45130,43394,6456,49850,579
2021-01-26,Tuolumne,109,53932,3454,3451,33,3484,30
2021-01-26,Ventura,111,848112,70123,67526,2436,69962,448
2021-01-26,Yolo,113,214977,11985,11361,119,11480,148
2021-01-26,Yuba,115,75493,5099,4944,69,5013,31
2021-01-25,Alameda,001,1643700,73483,71255,1508,72763,780
2021-01-25,Alpine,003,1148,73,72,0,72,0
2021-01-25,Amador,005,37829,3165,3074,24,3098,30
2021-01-25,Butte,007,227075,10521,9865,1429,11294,133
2021-01-25,Calaveras,009,45235,1724,1713,10,1723,21
2021-01-25,Colusa,011,21464,1742,1709,195,1904,8
2021-01-25,Contra Costa,013,1133247,57349,54989,940,55929,488
2021-01-25,Del Norte,015,27424,890,855,4,859,2
2021-01-25,El Dorado,017,186661,8500,8060,558,8618,66
2021-01-25,Fresno,019,978130,89969,86336,6725,93061,913
2021-01-25,Glenn,021,27897,2096,2028,428,2456,13
2021-01-25,Humboldt,023,135768,2738,2587,17,2604,24
2021-01-25,Imperial,025,180216,26375,25745,2301,28046,491
2021-01-25,Inyo,027,18085,1071,1015,8,1023,27
2021-01-25,Kern,029,883053,86782,83401,8099,91500,787
2021-01-25,Kings,031,150075,20780,20067,830,20897,159
2021-01-25,Lake,033,64148,2831,2729,1,2730,32
2021-01-25,Lassen,035,31185,4903,4835,86,4921,1
2021-01-25,Los Angeles,037,10098052,1102473,1055181,35025,1090206,15163
2021-01-25,Madera,039,155013,14577,14068,692,14760,86
2021-01-25,Marin,041,260295,12254,11923,128,12051,177
2021-01-25,Mariposa,043,17540,350,331,3,334,3
2021-01-25,Mendocino,045,87422,3239,3054,61,3115,35
2021-01-25,Merced,047,269075,25771,25181,715,25896,305
2021-01-25,Modoc,049,8938,303,288,91,379,0
2021-01-25,Mono,051,14174,1125,1114,14,1128,3
2021-01-25,Monterey,053,433212,38908,37726,1303,39029,255
2021-01-25,Napa,055,140530,8309,8057,30,8087,43
2021-01-25,Nevada,057,99092,3600,3365,140,3505,18
2021-01-25,Orange,059,3164182,231041,225105,9227,234332,2696
2021-01-25,Placer,061,380077,19111,17936,942,18878,193
2021-01-25,Plumas,063,18699,613,533,10,543,2
2021-01-25,Riverside,065,2383286,268152,258082,12456,270538,2789
2021-01-25,Sacramento,067,1510023,86486,84653,1016,85669,1118
2021-01-25,San Benito,069,59416,5353,5238,66,5304,43
2021-01-25,San Bernardino,071,2135413,272961,263174,7893,271067,1947
2021-01-25,San Diego,073,3302833,242049,228630,11298,239928,2375
2021-01-25,San Francisco,075,870044,31246,30734,795,31529,288
2021-01-25,San Joaquin,077,732212,61679,59291,2376,61667,838
2021-01-25,San Luis Obispo,079,281455,17732,16868,453,17321,179
2021-01-25,San Mateo,081,765935,36189,34187,319,34506,213
2021-01-25,Santa Barbara,083,443738,28687,27065,844,27909,269
2021-01-25,Santa Clara,085,1922200,101101,98647,446,99093,1143
2021-01-25,Santa Cruz,087,273765,14148,12973,660,13633,133
2021-01-25,Shasta,089,179085,10235,9991,1048,11039,103
2021-01-25,Sierra,091,2930,48,42,12,54,0
2021-01-25,Siskiyou,093,43540,1302,1205,183,1388,4
2021-01-25,Solano,095,438530,27471,26648,303,26951,109
2021-01-25,Sonoma,097,501317,25690,25160,128,25288,233
2021-01-25,Stanislaus,099,539301,46226,44293,4651,48944,599
2021-01-25,Sutter,101,95872,8163,8023,76,8099,83
2021-01-25,Tehama,103,63373,4235,4082,445,4527,20
2021-01-25,Trinity,105,12862,439,262,63,325,3
2021-01-25,Tulare,107,460477,44913,43124,6354,49478,578
2021-01-25,Tuolumne,109,53932,3445,3422,33,3455,29
2021-01-25,Ventura,111,848112,69502,66910,2420,69330,439
2021-01-25,Yolo,113,214977,11900,11276,118,11394,140
2021-01-25,Yuba,115,75493,5077,4900,67,4967,31
2021-01-24,Alameda,001,1643700,72980,70823,1497,72320,780
2021-01-24,Alpine,003,1148,73,72,0,72,0
2021-01-24,Amador,005,37829,3132,3054,24,3078,30
2021-01-24,Butte,007,227075,10437,9820,1413,11233,133
2021-01-24,Calaveras,009,45235,1711,1704,10,1714,21
2021-01-24,Colusa,011,21464,1731,1689,189,1878,8
2021-01-24,Contra Costa,013,1133247,56964,54694,928,55622,488
2021-01-24,Del Norte,015,27424,886,855,4,859,2
2021-01-24,El Dorado,017,186661,8465,8003,554,8557,66
2021-01-24,Fresno,019,978130,89531,85808,6686,92494,911
2021-01-24,Glenn,021,27897,2088,2026,427,2453,13
2021-01-24,Humboldt,023,135768,2699,2562,17,2579,24
2021-01-24,Imperial,025,180216,26279,25707,2280,27987,488
2021-01-24,Inyo,027,18085,1055,1007,8,1015,27
2021-01-24,Kern,029,883053,86347,83125,7992,91117,785
2021-01-24,Kings,031,150075,20652,19988,814,20802,159
2021-01-24,Lake,033,64148,2814,2724,0,2724,32
2021-01-24,Lassen,035,31185,4892,4828,83,4911,1
2021-01-24,Los Angeles,037,10098052,1096057,1048757,34720,1083477,15119
2021-01-24,Madera,039,155013,14494,14000,686,14686,86
2021-01-24,Marin,041,260295,12190,11872,127,11999,177
2021-01-24,Mariposa,043,17540,346,322,3,325,3
2021-01-24,Mendocino,045,87422,3218,3037,60,3097,33
2021-01-24,Merced,047,269075,25560,25047,706,25753,305
2021-01-24,Modoc,049,8938,303,285,91,376,0
2021-01-24,Mono,051,14174,1118,1113,14,1127,3
2021-01-24,Monterey,053,433212,38636,37527,1269,38796,254
2021-01-24,Napa,055,140530,8267,8005,30,8035,43
2021-01-24,Nevada,057,99092,3558,3349,138,3487,18
2021-01-24,Orange,059,3164182,229608,223853,9159,233012,2632
2021-01-24,Placer,061,380077,18998,17839,922,18761,193
2021-01-24,Plumas,063,18699,610,532,10,542,2
2021-01-24,Riverside,065,2383286,266510,256767,12380,269147,2761
2021-01-24,Sacramento,067,1510023,85932,84110,1008,85118,1112
2021-01-24,San Benito,069,59416,5311,5223,63,5286,43
2021-01-24,San Bernardino,071,2135413,271648,262370,7841,270211,1935
2021-01-24,San Diego,073,3302833,240356,227193,11167,238360,2375
2021-01-24,San Francisco,075,870044,31057,30559,774,31333,275
2021-01-24,San Joaquin,077,732212,61254,59021,2362,61383,838
2021-01-24,San Luis Obispo,079,281455,17608,16758,451,17209,179
2021-01-24,San Mateo,081,765935,35944,33956,314,34270,213
2021-01-24,Santa Barbara,083,443738,28372,26735,834,27569,269
2021-01-24,Santa Clara,085,1922200,100466,98103,441,98544,1109
2021-01-24,Santa Cruz,087,273765,14062,12905,652,13557,133
2021-01-24,Shasta,089,179085,10164,9978,1039,11017,103
2021-01-24,Sierra,091,2930,47,42,12,54,0
2021-01-24,Siskiyou,093,43540,1295,1195,183,1378,4
2021-01-24,Solano,095,438530,27285,26515,299,26814,109
2021-01-24,Sonoma,097,501317,25528,25045,127,25172,233
2021-01-24,Stanislaus,099,539301,45917,44031,4592,48623,599
2021-01-24,Sutter,101,95872,8099,7980,76,8056,83
2021-01-24,Tehama,103,63373,4195,4062,440,4502,20
2021-01-24,Trinity,105,12862,439,262,63,325,3
2021-01-24,Tulare,107,460477,44693,43006,6265,49271,577
2021-01-24,Tuolumne,109,53932,3434,3416,33,3449,29
2021-01-24,Ventura,111,848112,68812,66347,2398,68745,439
2021-01-24,Yolo,113,214977,11817,11210,114,11324,140
2021-01-24,Yuba,115,75493,5037,4875,66,4941,31
2021-01-23,Alameda,001,1643700,72732,70080,1491,71571,780
2021-01-23,Alpine,003,1148,73,72,0,72,0
2021-01-23,Amador,005,37829,3129,3049,24,3073,30
2021-01-23,Butte,007,227075,10408,9757,1410,11167,133
2021-01-23,Calaveras,009,45235,1708,1695,10,1705,21
2021-01-23,Colusa,011,21464,1727,1672,188,1860,8
2021-01-23,Contra Costa,013,1133247,56750,54162,922,55084,487
2021-01-23,Del Norte,015,27424,884,855,4,859,2
2021-01-23,El Dorado,017,186661,8449,7984,552,8536,66
2021-01-23,Fresno,019,978130,89345,85274,6658,91932,910
2021-01-23,Glenn,021,27897,2085,2015,423,2438,13
2021-01-23,Humboldt,023,135768,2680,2493,16,2509,23
2021-01-23,Imperial,025,180216,26245,25581,2268,27849,487
2021-01-23,Inyo,027,18085,1046,987,8,995,27
2021-01-23,Kern,029,883053,86104,82602,7924,90526,783
2021-01-23,Kings,031,150075,20608,19904,812,20716,159
2021-01-23,Lake,033,64148,2805,2673,0,2673,32
2021-01-23,Lassen,035,31185,4891,4816,80,4896,1
2021-01-23,Los Angeles,037,10098052,1092822,1040961,34560,1075521,15034
2021-01-23,Madera,039,155013,14457,13858,683,14541,86
2021-01-23,Marin,041,260295,12134,11796,125,11921,177
2021-01-23,Mariposa,043,17540,346,323,3,326,3
2021-01-23,Mendocino,045,87422,3204,2991,60,3051,32
2021-01-23,Merced,047,269075,25468,24787,692,25479,303
2021-01-23,Modoc,049,8938,303,285,91,376,0
2021-01-23,Mono,051,14174,1116,1111,14,1125,3
2021-01-23,Monterey,053,433212,38553,37165,1264,38429,253
2021-01-23,Napa,055,140530,8242,7893,30,7923,43
2021-01-23,Nevada,057,99092,3547,3332,137,3469,18
2021-01-23,Orange,059,3164182,228839,221722,9119,230841,2618
2021-01-23,Placer,061,380077,18947,17617,917,18534,193
2021-01-23,Plumas,063,18699,609,528,10,538,2
2021-01-23,Riverside,065,2383286,265610,253636,12330,265966,2733
2021-01-23,Sacramento,067,1510023,85704,83408,1005,84413,1108
2021-01-23,San Benito,069,59416,5287,5166,62,5228,43
2021-01-23,San Bernardino,071,2135413,271091,260381,7811,268192,1922
2021-01-23,San Diego,073,3302833,239295,225556,11095,236651,2344
2021-01-23,San Francisco,075,870044,30952,30308,745,31053,268
2021-01-23,San Joaquin,077,732212,61126,58164,2352,60516,836
2021-01-23,San Luis Obispo,079,281455,17544,16652,448,17100,176
2021-01-23,San Mateo,081,765935,35768,33696,303,33999,213
2021-01-23,Santa Barbara,083,443738,28187,26234,825,27059,264
2021-01-23,Santa Clara,085,1922200,100107,97189,440,97629,1086
2021-01-23,Santa Cruz,087,273765,14004,12771,649,13420,127
2021-01-23,Shasta,089,179085,10135,9951,1038,10989,103
2021-01-23,Sierra,091,2930,47,41,12,53,0
2021-01-23,Siskiyou,093,43540,1285,1190,182,1372,4
2021-01-23,Solano,095,438530,27192,26261,297,26558,107
2021-01-23,Sonoma,097,501317,25448,24790,127,24917,232
2021-01-23,Stanislaus,099,539301,45750,43723,4561,48284,599
2021-01-23,Sutter,101,95872,8081,7943,75,8018,80
2021-01-23,Tehama,103,63373,4176,4006,439,4445,20
2021-01-23,Trinity,105,12862,439,262,63,325,3
2021-01-23,Tulare,107,460477,44540,42661,6205,48866,575
2021-01-23,Tuolumne,109,53932,3427,3407,33,3440,29
2021-01-23,Ventura,111,848112,68356,65581,2375,67956,438
2021-01-23,Yolo,113,214977,11776,11087,113,11200,141
2021-01-23,Yuba,115,75493,5025,4831,65,4896,30
2021-01-22,Alameda,001,1643700,72414,69693,1484,71177,751
2021-01-22,Alpine,003,1148,73,71,0,71,0
2021-01-22,Amador,005,37829,3124,3042,24,3066,30
2021-01-22,Butte,007,227075,10364,9711,1397,11108,133
2021-01-22,Calaveras,009,45235,1699,1672,10,1682,21
2021-01-22,Colusa,011,21464,1725,1668,188,1856,7
2021-01-22,Contra Costa,013,1133247,56512,53887,916,54803,485
2021-01-22,Del Norte,015,27424,883,852,4,856,2
2021-01-22,El Dorado,017,186661,8416,7877,549,8426,64
2021-01-22,Fresno,019,978130,89004,84744,6630,91374,892
2021-01-22,Glenn,021,27897,2080,1985,417,2402,13
2021-01-22,Humboldt,023,135768,2656,2452,16,2468,23
2021-01-22,Imperial,025,180216,26209,25562,2253,27815,474
2021-01-22,Inyo,027,18085,1035,961,8,969,26
2021-01-22,Kern,029,883053,85807,82101,7848,89949,771
2021-01-22,Kings,031,150075,20532,19760,808,20568,159
2021-01-22,Lake,033,64148,2793,2681,0,2681,32
2021-01-22,Lassen,035,31185,4882,4765,79,4844,1
2021-01-22,Los Angeles,037,10098052,1088354,1031177,34372,1065549,14777
2021-01-22,Madera,039,155013,14397,13781,682,14463,86
2021-01-22,Marin,041,260295,12097,11769,123,11892,177
2021-01-22,Mariposa,043,17540,346,323,3,326,3
2021-01-22,Mendocino,045,87422,3179,2994,59,3053,32
2021-01-22,Merced,047,269075,25345,24616,685,25301,290
2021-01-22,Modoc,049,8938,303,285,91,376,0
2021-01-22,Mono,051,14174,1116,1108,14,1122,3
2021-01-22,Monterey,053,433212,38400,36909,1259,38168,253
2021-01-22,Napa,055,140530,8196,7828,30,7858,40
2021-01-22,Nevada,057,99092,3522,3296,136,3432,18
2021-01-22,Orange,059,3164182,227887,220384,9072,229456,2542
2021-01-22,Placer,061,380077,18890,17636,902,18538,193
2021-01-22,Plumas,063,18699,607,522,10,532,2
2021-01-22,Riverside,065,2383286,264466,252440,12264,264704,2710
2021-01-22,Sacramento,067,1510023,85374,82861,997,83858,1094
2021-01-22,San Benito,069,59416,5261,5143,62,5205,43
2021-01-22,San Bernardino,071,2135413,270287,259121,7781,266902,1849
2021-01-22,San Diego,073,3302833,238055,222576,11030,233606,2301
2021-01-22,San Francisco,075,870044,30839,30027,728,30755,266
2021-01-22,San Joaquin,077,732212,60942,58485,2340,60825,812
2021-01-22,San Luis Obispo,079,281455,17455,16336,445,16781,172
2021-01-22,San Mateo,081,765935,35546,33401,300,33701,211
2021-01-22,Santa Barbara,083,443738,27987,25989,814,26803,256
2021-01-22,Santa Clara,085,1922200,99662,96435,437,96872,1062
2021-01-22,Santa Cruz,087,273765,13946,12687,645,13332,123
2021-01-22,Shasta,089,179085,10115,9866,1036,10902,103
2021-01-22,Sierra,091,2930,47,40,12,52,0
2021-01-22,Siskiyou,093,43540,1281,1182,180,1362,4
2021-01-22,Solano,095,438530,27102,26048,295,26343,107
2021-01-22,Sonoma,097,501317,25363,24659,127,24786,232
2021-01-22,Stanislaus,099,539301,45584,43489,4535,48024,599
2021-01-22,Sutter,101,95872,8056,7878,75,7953,80
2021-01-22,Tehama,103,63373,4162,3993,437,4430,19
2021-01-22,Trinity,105,12862,438,263,63,326,3
2021-01-22,Tulare,107,460477,44361,42307,6138,48445,573
2021-01-22,Tuolumne,109,53932,3399,3379,33,3412,29
2021-01-22,Ventura,111,848112,67843,64404,2356,66760,426
2021-01-22,Yolo,113,214977,11743,11014,111,11125,141
2021-01-22,Yuba,115,75493,5001,4789,63,4852,29
2021-01-21,Alameda,001,1643700,71978,69314,1467,70781,739
2021-01-21,Alpine,003,1148,73,71,0,71,0
2021-01-21,Amador,005,37829,3102,3038,24,3062,29
2021-01-21,Butte,007,227075,10300,9643,1390,11033,130
2021-01-21,Calaveras,009,45235,1690,1647,10,1657,21
2021-01-21,Colusa,011,21464,1718,1662,186,1848,7
2021-01-21,Contra Costa,013,1133247,56123,53595,904,54499,478
2021-01-21,Del Norte,015,27424,881,850,3,853,2
2021-01-21,El Dorado,017,186661,8366,7823,546,8369,58
2021-01-21,Fresno,019,978130,88600,84137,6590,90727,889
2021-01-21,Glenn,021,27897,2072,1964,412,2376,13
2021-01-21,Humboldt,023,135768,2633,2423,16,2439,23
2021-01-21,Imperial,025,180216,26122,25509,2241,27750,463
2021-01-21,Inyo,027,18085,1026,946,8,954,26
2021-01-21,Kern,029,883053,85394,81328,7733,89061,769
2021-01-21,Kings,031,150075,20461,19633,791,20424,158
2021-01-21,Lake,033,64148,2779,2669,0,2669,32
2021-01-21,Lassen,035,31185,4875,4763,79,4842,1
2021-01-21,Los Angeles,037,10098052,1081688,1023055,34057,1057112,14537
2021-01-21,Madera,039,155013,14333,13664,674,14338,86
2021-01-21,Marin,041,260295,12042,11732,121,11853,173
2021-01-21,Mariposa,043,17540,342,322,3,325,3
2021-01-21,Mendocino,045,87422,3156,2967,57,3024,32
2021-01-21,Merced,047,269075,25190,24426,678,25104,245
2021-01-21,Modoc,049,8938,300,284,90,374,0
2021-01-21,Mono,051,14174,1111,1104,14,1118,3
2021-01-21,Monterey,053,433212,38119,36149,1250,37399,253
2021-01-21,Napa,055,140530,8132,7774,30,7804,40
2021-01-21,Nevada,057,99092,3493,3274,135,3409,18
2021-01-21,Orange,059,3164182,226511,218867,9018,227885,2540
2021-01-21,Placer,061,380077,18811,17553,898,18451,190
2021-01-21,Plumas,063,18699,603,518,10,528,2
2021-01-21,Riverside,065,2383286,262744,251007,12186,263193,2676
2021-01-21,Sacramento,067,1510023,84895,82303,977,83280,1084
2021-01-21,San Benito,069,59416,5231,5100,57,5157,43
2021-01-21,San Bernardino,071,2135413,268964,257754,7716,265470,1832
2021-01-21,San Diego,073,3302833,236280,219729,10923,230652,2222
2021-01-21,San Francisco,075,870044,30667,29801,694,30495,266
2021-01-21,San Joaquin,077,732212,60636,58270,2322,60592,806
2021-01-21,San Luis Obispo,079,281455,17369,16153,437,16590,169
2021-01-21,San Mateo,081,765935,35300,33156,287,33443,210
2021-01-21,Santa Barbara,083,443738,27699,25654,801,26455,253
2021-01-21,Santa Clara,085,1922200,99074,96028,432,96460,1062
2021-01-21,Santa Cruz,087,273765,13862,12548,635,13183,119
2021-01-21,Shasta,089,179085,10072,9795,1021,10816,98
2021-01-21,Sierra,091,2930,47,40,12,52,0
2021-01-21,Siskiyou,093,43540,1278,1178,178,1356,4
2021-01-21,Solano,095,438530,26922,25885,291,26176,106
2021-01-21,Sonoma,097,501317,25223,24440,125,24565,230
2021-01-21,Stanislaus,099,539301,45286,43223,4491,47714,599
2021-01-21,Sutter,101,95872,8022,7822,75,7897,80
2021-01-21,Tehama,103,63373,4123,3938,437,4375,19
2021-01-21,Trinity,105,12862,438,261,63,324,3
2021-01-21,Tulare,107,460477,44150,42082,6064,48146,569
2021-01-21,Tuolumne,109,53932,3389,3365,32,3397,29
2021-01-21,Ventura,111,848112,67144,63995,2336,66331,420
2021-01-21,Yolo,113,214977,11652,10940,103,11043,141
2021-01-21,Yuba,115,75493,4969,4757,62,4819,29
2021-01-20,Alameda,001,1643700,71504,68785,1451,70236,702
2021-01-20,Alpine,003,1148,73,71,0,71,0
2021-01-20,Amador,005,37829,3071,3036,24,3060,29
2021-01-20,Butte,007,227075,10244,9582,1380,10962,130
2021-01-20,Calaveras,009,45235,1668,1637,9,1646,21
2021-01-20,Colusa,011,21464,1701,1630,181,1811,7
2021-01-20,Contra Costa,013,1133247,55698,53108,895,54003,461
2021-01-20,Del Norte,015,27424,880,848,3,851,2
2021-01-20,El Dorado,017,186661,8316,7785,543,8328,53
2021-01-20,Fresno,019,978130,88182,83591,6537,90128,872
2021-01-20,Glenn,021,27897,2053,1955,410,2365,13
2021-01-20,Humboldt,023,135768,2590,2390,16,2406,22
2021-01-20,Imperial,025,180216,26049,25380,2207,27587,461
2021-01-20,Inyo,027,18085,1016,901,8,909,26
2021-01-20,Kern,029,883053,84943,80701,7626,88327,754
2021-01-20,Kings,031,150075,20371,19522,783,20305,146
2021-01-20,Lake,033,64148,2759,2646,0,2646,31
2021-01-20,Lassen,035,31185,4867,4758,77,4835,1
2021-01-20,Los Angeles,037,10098052,1074186,1015608,33776,1049384,14299
2021-01-20,Madera,039,155013,14268,13585,670,14255,86
2021-01-20,Marin,041,260295,11986,11684,119,11803,171
2021-01-20,Mariposa,043,17540,340,322,3,325,3
2021-01-20,Mendocino,045,87422,3141,2957,57,3014,32
2021-01-20,Merced,047,269075,25017,24220,656,24876,243
2021-01-20,Modoc,049,8938,299,282,90,372,0
2021-01-20,Mono,051,14174,1104,1105,13,1118,3
2021-01-20,Monterey,053,433212,37807,35960,1230,37190,249
2021-01-20,Napa,055,140530,8063,7731,30,7761,40
2021-01-20,Nevada,057,99092,3461,3238,135,3373,18
2021-01-20,Orange,059,3164182,224976,216893,8957,225850,2500
2021-01-20,Placer,061,380077,18717,17455,880,18335,186
2021-01-20,Plumas,063,18699,601,512,10,522,2
2021-01-20,Riverside,065,2383286,260700,248686,12103,260789,2615
2021-01-20,Sacramento,067,1510023,84335,81687,967,82654,1072
2021-01-20,San Benito,069,59416,5200,5036,56,5092,35
2021-01-20,San Bernardino,071,2135413,267639,255921,7669,263590,1801
2021-01-20,San Diego,073,3302833,234425,218553,10819,229372,2174
2021-01-20,San Francisco,075,870044,30480,29665,673,30338,262
2021-01-20,San Joaquin,077,732212,60232,58025,2313,60338,783
2021-01-20,San Luis Obispo,079,281455,17187,15936,428,16364,164
2021-01-20,San Mateo,081,765935,35073,32929,286,33215,210
2021-01-20,Santa Barbara,083,443738,27381,25312,789,26101,248
2021-01-20,Santa Clara,085,1922200,98428,94995,430,95425,1040
2021-01-20,Santa Cruz,087,273765,13755,12460,622,13082,107
2021-01-20,Shasta,089,179085,10020,9697,1011,10708,98
2021-01-20,Sierra,091,2930,47,40,12,52,0
2021-01-20,Siskiyou,093,43540,1271,1163,177,1340,4
2021-01-20,Solano,095,438530,26729,25659,287,25946,106
2021-01-20,Sonoma,097,501317,25086,24262,123,24385,223
2021-01-20,Stanislaus,099,539301,45006,42955,4453,47408,585
2021-01-20,Sutter,101,95872,7971,7772,73,7845,80
2021-01-20,Tehama,103,63373,4096,3892,435,4327,19
2021-01-20,Trinity,105,12862,438,260,63,323,3
2021-01-20,Tulare,107,460477,43893,41799,5974,47773,559
2021-01-20,Tuolumne,109,53932,3375,3355,31,3386,29
2021-01-20,Ventura,111,848112,66183,63413,2307,65720,395
2021-01-20,Yolo,113,214977,11586,10852,100,10952,141
2021-01-20,Yuba,115,75493,4943,4729,62,4791,29
2021-01-19,Alameda,001,1643700,70863,68434,1442,69876,680
2021-01-19,Alpine,003,1148,73,71,0,71,0
2021-01-19,Amador,005,37829,3062,3024,24,3048,28
2021-01-19,Butte,007,227075,10181,9528,1366,10894,129
2021-01-19,Calaveras,009,45235,1653,1621,8,1629,21
2021-01-19,Colusa,011,21464,1679,1617,178,1795,7
2021-01-19,Contra Costa,013,1133247,55233,52730,885,53615,448
2021-01-19,Del Norte,015,27424,878,843,3,846,2
2021-01-19,El Dorado,017,186661,8255,7743,535,8278,47
2021-01-19,Fresno,019,978130,87660,83200,6487,89687,857
2021-01-19,Glenn,021,27897,2041,1948,405,2353,13
2021-01-19,Humboldt,023,135768,2566,2359,13,2372,22
2021-01-19,Imperial,025,180216,25968,25333,2190,27523,452
2021-01-19,Inyo,027,18085,1008,891,8,899,26
2021-01-19,Kern,029,883053,84355,80272,7521,87793,742
2021-01-19,Kings,031,150075,20232,19375,773,20148,143
2021-01-19,Lake,033,64148,2746,2625,0,2625,31
2021-01-19,Lassen,035,31185,4860,4753,77,4830,1
2021-01-19,Los Angeles,037,10098052,1065508,1010375,33509,1043884,14014
2021-01-19,Madera,039,155013,14157,13528,665,14193,86
2021-01-19,Marin,041,260295,11931,11654,115,11769,169
2021-01-19,Mariposa,043,17540,340,322,3,325,3
2021-01-19,Mendocino,045,87422,3124,2930,57,2987,32
2021-01-19,Merced,047,269075,24805,24108,647,24755,242
2021-01-19,Modoc,049,8938,298,281,90,371,0
2021-01-19,Mono,051,14174,1103,1106,13,1119,3
2021-01-19,Monterey,053,433212,37506,35840,1209,37049,248
2021-01-19,Napa,055,140530,8004,7672,30,7702,38
2021-01-19,Nevada,057,99092,3442,3216,133,3349,18
2021-01-19,Orange,059,3164182,223244,215244,8890,224134,2468
2021-01-19,Placer,061,380077,18620,17348,870,18218,182
2021-01-19,Plumas,063,18699,594,509,10,519,2
2021-01-19,Riverside,065,2383286,258613,246248,12025,258273,2585
2021-01-19,Sacramento,067,1510023,83798,81183,947,82130,1053
2021-01-19,San Benito,069,59416,5154,4988,55,5043,35
2021-01-19,San Bernardino,071,2135413,265931,253651,7615,261266,1777
2021-01-19,San Diego,073,3302833,232002,216833,10721,227554,2109
2021-01-19,San Francisco,075,870044,30261,29502,642,30144,261
2021-01-19,San Joaquin,077,732212,59851,57655,2302,59957,782
2021-01-19,San Luis Obispo,079,281455,16924,15855,425,16280,161
2021-01-19,San Mateo,081,765935,34788,32730,275,33005,208
2021-01-19,Santa Barbara,083,443738,26997,24991,773,25764,236
2021-01-19,Santa Clara,085,1922200,97693,94483,429,94912,1010
2021-01-19,Santa Cruz,087,273765,13638,12410,614,13024,106
2021-01-19,Shasta,089,179085,9984,9614,1001,10615,93
2021-01-19,Sierra,091,2930,47,40,10,50,0
2021-01-19,Siskiyou,093,43540,1263,1149,175,1324,4
2021-01-19,Solano,095,438530,26481,25520,286,25806,106
2021-01-19,Sonoma,097,501317,24906,24133,121,24254,223
2021-01-19,Stanislaus,099,539301,44658,42723,4408,47131,561
2021-01-19,Sutter,101,95872,7921,7709,67,7776,80
2021-01-19,Tehama,103,63373,4066,3876,433,4309,19
2021-01-19,Trinity,105,12862,437,260,63,323,3
2021-01-19,Tulare,107,460477,43616,41559,5879,47438,549
2021-01-19,Tuolumne,109,53932,3348,3328,31,3359,29
2021-01-19,Ventura,111,848112,65499,62656,2280,64936,383
2021-01-19,Yolo,113,214977,11501,10789,100,10889,134
2021-01-19,Yuba,115,75493,4909,4695,61,4756,29
2021-01-18,Alameda,001,1643700,70231,67938,1424,69362,680
2021-01-18,Alpine,003,1148,73,71,0,71,0
2021-01-18,Amador,005,37829,3048,3016,24,3040,28
2021-01-18,Butte,007,227075,10096,9474,1354,10828,129
2021-01-18,Calaveras,009,45235,1632,1617,7,1624,21
2021-01-18,Colusa,011,21464,1663,1608,176,1784,7
2021-01-18,Contra Costa,013,1133247,54725,52323,877,53200,448
2021-01-18,Del Norte,015,27424,877,840,3,843,2
2021-01-18,El Dorado,017,186661,8189,7707,533,8240,47
2021-01-18,Fresno,019,978130,87049,82485,6421,88906,857
2021-01-18,Glenn,021,27897,2024,1935,401,2336,13
2021-01-18,Humboldt,023,135768,2528,2343,13,2356,22
2021-01-18,Imperial,025,180216,25901,25317,2166,27483,452
2021-01-18,Inyo,027,18085,996,872,8,880,26
2021-01-18,Kern,029,883053,83718,79930,7430,87360,740
2021-01-18,Kings,031,150075,20062,19267,761,20028,141
2021-01-18,Lake,033,64148,2729,2591,0,2591,30
2021-01-18,Lassen,035,31185,4824,4749,76,4825,1
2021-01-18,Los Angeles,037,10098052,1056004,1002614,33222,1035836,13828
2021-01-18,Madera,039,155013,14055,13443,656,14099,85
2021-01-18,Marin,041,260295,11884,11607,113,11720,165
2021-01-18,Mariposa,043,17540,337,320,2,322,3
2021-01-18,Mendocino,045,87422,3101,2919,57,2976,31
2021-01-18,Merced,047,269075,24560,23927,631,24558,242
2021-01-18,Modoc,049,8938,295,281,87,368,0
2021-01-18,Mono,051,14174,1100,1101,13,1114,3
2021-01-18,Monterey,053,433212,37065,35549,1195,36744,247
2021-01-18,Napa,055,140530,7931,7601,30,7631,38
2021-01-18,Nevada,057,99092,3404,3199,133,3332,17
2021-01-18,Orange,059,3164182,221352,213866,8836,222702,2405
2021-01-18,Placer,061,380077,18504,17263,861,18124,182
2021-01-18,Plumas,063,18699,591,506,10,516,2
2021-01-18,Riverside,065,2383286,256301,244151,11932,256083,2568
2021-01-18,Sacramento,067,1510023,83128,80546,931,81477,1046
2021-01-18,San Benito,069,59416,5106,4963,53,5016,35
2021-01-18,San Bernardino,071,2135413,264207,252808,7560,260368,1775
2021-01-18,San Diego,073,3302833,229354,214335,10592,224927,2103
2021-01-18,San Francisco,075,870044,30055,29321,618,29939,259
2021-01-18,San Joaquin,077,732212,59338,57405,2281,59686,782
2021-01-18,San Luis Obispo,079,281455,16737,15742,415,16157,158
2021-01-18,San Mateo,081,765935,34475,32515,256,32771,208
2021-01-18,Santa Barbara,083,443738,26618,24638,760,25398,235
2021-01-18,Santa Clara,085,1922200,96904,93688,425,94113,992
2021-01-18,Santa Cruz,087,273765,13505,12298,601,12899,106
2021-01-18,Shasta,089,179085,9945,9600,991,10591,92
2021-01-18,Sierra,091,2930,46,40,10,50,0
2021-01-18,Siskiyou,093,43540,1251,1144,174,1318,4
2021-01-18,Solano,095,438530,26203,25344,282,25626,105
2021-01-18,Sonoma,097,501317,24638,24068,120,24188,223
2021-01-18,Stanislaus,099,539301,44301,42413,4352,46765,562
2021-01-18,Sutter,101,95872,7864,7680,65,7745,78
2021-01-18,Tehama,103,63373,4022,3854,426,4280,19
2021-01-18,Trinity,105,12862,437,260,63,323,3
2021-01-18,Tulare,107,460477,43326,41196,5773,46969,549
2021-01-18,Tuolumne,109,53932,3324,3318,30,3348,28
2021-01-18,Ventura,111,848112,65066,61859,2258,64117,379
2021-01-18,Yolo,113,214977,11379,10620,97,10717,134
2021-01-18,Yuba,115,75493,4882,4671,59,4730,29
2021-01-17,Alameda,001,1643700,69667,67375,1406,68781,676
2021-01-17,Alpine,003,1148,73,71,0,71,0
2021-01-17,Amador,005,37829,3041,3001,24,3025,28
2021-01-17,Butte,007,227075,10021,9411,1330,10741,129
2021-01-17,Calaveras,009,45235,1619,1608,7,1615,21
2021-01-17,Colusa,011,21464,1650,1588,172,1760,7
2021-01-17,Contra Costa,013,1133247,54218,51932,866,52798,447
2021-01-17,Del Norte,015,27424,877,838,3,841,2
2021-01-17,El Dorado,017,186661,8134,7659,522,8181,47
2021-01-17,Fresno,019,978130,86496,82039,6345,88384,857
2021-01-17,Glenn,021,27897,2013,1924,396,2320,9
2021-01-17,Humboldt,023,135768,2492,2322,11,2333,22
2021-01-17,Imperial,025,180216,25832,25253,2125,27378,451
2021-01-17,Inyo,027,18085,990,864,8,872,26
2021-01-17,Kern,029,883053,83169,79489,7345,86834,738
2021-01-17,Kings,031,150075,19926,19201,747,19948,131
2021-01-17,Lake,033,64148,2715,2572,0,2572,30
2021-01-17,Lassen,035,31185,4816,4740,75,4815,1
2021-01-17,Los Angeles,037,10098052,1049348,993028,32830,1025858,13741
2021-01-17,Madera,039,155013,13965,13328,652,13980,85
2021-01-17,Marin,041,260295,11832,11552,111,11663,164
2021-01-17,Mariposa,043,17540,337,319,2,321,3
2021-01-17,Mendocino,045,87422,3073,2912,56,2968,31
2021-01-17,Merced,047,269075,24348,23800,613,24413,242
2021-01-17,Modoc,049,8938,294,279,87,366,0
2021-01-17,Mono,051,14174,1093,1091,12,1103,3
2021-01-17,Monterey,053,433212,36820,35340,1169,36509,244
2021-01-17,Napa,055,140530,7875,7521,30,7551,38
2021-01-17,Nevada,057,99092,3379,3176,131,3307,17
2021-01-17,Orange,059,3164182,219351,212389,8761,221150,2359
2021-01-17,Placer,061,380077,18398,17194,846,18040,181
2021-01-17,Plumas,063,18699,589,505,9,514,2
2021-01-17,Riverside,065,2383286,254191,242206,11816,254022,2534
2021-01-17,Sacramento,067,1510023,82528,80154,919,81073,1045
2021-01-17,San Benito,069,59416,5068,4941,53,4994,35
2021-01-17,San Bernardino,071,2135413,262103,251487,7473,258960,1775
2021-01-17,San Diego,073,3302833,227160,211785,10485,222270,2103
2021-01-17,San Francisco,075,870044,29867,29139,581,29720,255
2021-01-17,San Joaquin,077,732212,58981,57094,2267,59361,780
2021-01-17,San Luis Obispo,079,281455,16615,15658,406,16064,157
2021-01-17,San Mateo,081,765935,34223,32186,233,32419,208
2021-01-17,Santa Barbara,083,443738,26157,24401,748,25149,235
2021-01-17,Santa Clara,085,1922200,96145,92752,422,93174,976
2021-01-17,Santa Cruz,087,273765,13393,12196,598,12794,106
2021-01-17,Shasta,089,179085,9887,9588,983,10571,92
2021-01-17,Sierra,091,2930,46,38,9,47,0
2021-01-17,Siskiyou,093,43540,1244,1136,171,1307,4
2021-01-17,Solano,095,438530,25977,25216,280,25496,105
2021-01-17,Sonoma,097,501317,24464,23871,120,23991,223
2021-01-17,Stanislaus,099,539301,43982,42221,4289,46510,562
2021-01-17,Sutter,101,95872,7801,7604,64,7668,77
2021-01-17,Tehama,103,63373,3991,3837,422,4259,18
2021-01-17,Trinity,105,12862,437,261,63,324,3
2021-01-17,Tulare,107,460477,43038,41016,5657,46673,549
2021-01-17,Tuolumne,109,53932,3307,3287,30,3317,27
2021-01-17,Ventura,111,848112,64214,61257,2211,63468,376
2021-01-17,Yolo,113,214977,11280,10519,95,10614,134
2021-01-17,Yuba,115,75493,4835,4640,56,4696,28
2021-01-16,Alameda,001,1643700,69345,66583,1394,67977,673
2021-01-16,Alpine,003,1148,73,71,0,71,0
2021-01-16,Amador,005,37829,3038,2986,24,3010,28
2021-01-16,Butte,007,227075,9990,9359,1310,10669,129
2021-01-16,Calaveras,009,45235,1606,1596,7,1603,21
2021-01-16,Colusa,011,21464,1639,1578,172,1750,7
2021-01-16,Contra Costa,013,1133247,53939,51363,859,52222,443
2021-01-16,Del Norte,015,27424,872,833,3,836,2
2021-01-16,El Dorado,017,186661,8112,7575,521,8096,47
2021-01-16,Fresno,019,978130,86222,81294,6291,87585,846
2021-01-16,Glenn,021,27897,2009,1894,393,2287,9
2021-01-16,Humboldt,023,135768,2472,2294,9,2303,22
2021-01-16,Imperial,025,180216,25794,25140,2118,27258,451
2021-01-16,Inyo,027,18085,986,845,8,853,25
2021-01-16,Kern,029,883053,82802,78865,7291,86156,733
2021-01-16,Kings,031,150075,19870,19072,744,19816,131
2021-01-16,Lake,033,64148,2703,2504,0,2504,30
2021-01-16,Lassen,035,31185,4804,4719,75,4794,1
2021-01-16,Los Angeles,037,10098052,1045265,982684,32592,1015276,13654
2021-01-16,Madera,039,155013,13899,13193,647,13840,85
2021-01-16,Marin,041,260295,11790,11482,111,11593,164
2021-01-16,Mariposa,043,17540,336,317,2,319,3
2021-01-16,Mendocino,045,87422,3059,2890,53,2943,31
2021-01-16,Merced,047,269075,24260,23478,599,24077,242
2021-01-16,Modoc,049,8938,294,278,87,365,0
2021-01-16,Mono,051,14174,1091,1079,12,1091,3
2021-01-16,Monterey,053,433212,36709,34972,1153,36125,243
2021-01-16,Napa,055,140530,7836,7356,30,7386,39
2021-01-16,Nevada,057,99092,3346,3144,131,3275,17
2021-01-16,Orange,059,3164182,218319,210111,8705,218816,2312
2021-01-16,Placer,061,380077,18334,16995,844,17839,177
2021-01-16,Plumas,063,18699,587,502,9,511,2
2021-01-16,Riverside,065,2383286,252834,239412,11701,251113,2506
2021-01-16,Sacramento,067,1510023,82154,79122,902,80024,1033
2021-01-16,San Benito,069,59416,5035,4875,53,4928,35
2021-01-16,San Bernardino,071,2135413,261281,249401,7406,256807,1755
2021-01-16,San Diego,073,3302833,225862,209895,10388,220283,2065
2021-01-16,San Francisco,075,870044,29739,28853,550,29403,244
2021-01-16,San Joaquin,077,732212,58738,56642,2234,58876,776
2021-01-16,San Luis Obispo,079,281455,16514,15466,404,15870,152
2021-01-16,San Mateo,081,765935,34059,31805,227,32032,208
2021-01-16,Santa Barbara,083,443738,25956,24088,744,24832,229
2021-01-16,Santa Clara,085,1922200,95648,91584,415,91999,954
2021-01-16,Santa Cruz,087,273765,13334,12026,596,12622,106
2021-01-16,Shasta,089,179085,9854,9547,979,10526,92
2021-01-16,Sierra,091,2930,45,38,9,47,0
2021-01-16,Siskiyou,093,43540,1239,1124,171,1295,4
2021-01-16,Solano,095,438530,25868,24732,276,25008,103
2021-01-16,Sonoma,097,501317,24373,23607,119,23726,223
2021-01-16,Stanislaus,099,539301,43794,41809,4239,46048,562
2021-01-16,Sutter,101,95872,7769,7560,64,7624,76
2021-01-16,Tehama,103,63373,3977,3783,422,4205,18
2021-01-16,Trinity,105,12862,437,261,63,324,3
2021-01-16,Tulare,107,460477,42859,40655,5584,46239,542
2021-01-16,Tuolumne,109,53932,3299,3269,30,3299,27
2021-01-16,Ventura,111,848112,63661,60368,2181,62549,369
2021-01-16,Yolo,113,214977,11229,10406,94,10500,134
2021-01-16,Yuba,115,75493,4807,4602,56,4658,27
2021-01-15,Alameda,001,1643700,68920,65416,1383,66799,672
2021-01-15,Alpine,003,1148,73,71,0,71,0
2021-01-15,Amador,005,37829,3031,2953,24,2977,28
2021-01-15,Butte,007,227075,9948,9233,1295,10528,129
2021-01-15,Calaveras,009,45235,1599,1538,7,1545,21
2021-01-15,Colusa,011,21464,1628,1541,167,1708,7
2021-01-15,Contra Costa,013,1133247,53605,50408,852,51260,428
2021-01-15,Del Norte,015,27424,868,828,2,830,2
2021-01-15,El Dorado,017,186661,8062,7439,513,7952,47
2021-01-15,Fresno,019,978130,85685,79950,6255,86205,832
2021-01-15,Glenn,021,27897,2005,1824,390,2214,9
2021-01-15,Humboldt,023,135768,2445,2218,8,2226,22
2021-01-15,Imperial,025,180216,25758,24944,2112,27056,446
2021-01-15,Inyo,027,18085,969,814,8,822,25
2021-01-15,Kern,029,883053,82386,77873,7226,85099,719
2021-01-15,Kings,031,150075,19761,18661,738,19399,131
2021-01-15,Lake,033,64148,2677,2434,0,2434,28
2021-01-15,Lassen,035,31185,4793,4693,73,4766,1
2021-01-15,Los Angeles,037,10098052,1038213,968979,32309,1001288,13404
2021-01-15,Madera,039,155013,13809,12883,643,13526,85
2021-01-15,Marin,041,260295,11738,11310,111,11421,160
2021-01-15,Mariposa,043,17540,334,307,2,309,3
2021-01-15,Mendocino,045,87422,3048,2835,53,2888,31
2021-01-15,Merced,047,269075,24147,23060,595,23655,239
2021-01-15,Modoc,049,8938,294,278,85,363,0
2021-01-15,Mono,051,14174,1088,1057,12,1069,3
2021-01-15,Monterey,053,433212,36492,34460,1096,35556,243
2021-01-15,Napa,055,140530,7774,7231,30,7261,38
2021-01-15,Nevada,057,99092,3333,3099,128,3227,17
2021-01-15,Orange,059,3164182,216965,207129,8653,215782,2254
2021-01-15,Placer,061,380077,18230,16712,835,17547,173
2021-01-15,Plumas,063,18699,584,499,9,508,2
2021-01-15,Riverside,065,2383286,250971,235235,11622,246857,2458
2021-01-15,Sacramento,067,1510023,81731,80279,894,81173,1023
2021-01-15,San Benito,069,59416,4996,4766,51,4817,35
2021-01-15,San Bernardino,071,2135413,260101,246182,7344,253526,1726
2021-01-15,San Diego,073,3302833,224113,206868,10323,217191,2037
2021-01-15,San Francisco,075,870044,29564,28574,530,29104,242
2021-01-15,San Joaquin,077,732212,58510,55885,2220,58105,748
2021-01-15,San Luis Obispo,079,281455,16381,15129,399,15528,148
2021-01-15,San Mateo,081,765935,33814,31291,223,31514,208
2021-01-15,Santa Barbara,083,443738,25673,23487,740,24227,226
2021-01-15,Santa Clara,085,1922200,94987,90103,410,90513,942
2021-01-15,Santa Cruz,087,273765,13225,11776,583,12359,105
2021-01-15,Shasta,089,179085,9815,9459,972,10431,91
2021-01-15,Sierra,091,2930,44,36,7,43,0
2021-01-15,Siskiyou,093,43540,1235,1119,171,1290,4
2021-01-15,Solano,095,438530,25720,24222,274,24496,103
2021-01-15,Sonoma,097,501317,24242,23204,118,23322,222
2021-01-15,Stanislaus,099,539301,43544,41178,4197,45375,562
2021-01-15,Sutter,101,95872,7722,7484,63,7547,75
2021-01-15,Tehama,103,63373,3955,3714,421,4135,17
2021-01-15,Trinity,105,12862,437,262,63,325,3
2021-01-15,Tulare,107,460477,42615,39951,5501,45452,535
2021-01-15,Tuolumne,109,53932,3283,3231,30,3261,27
2021-01-15,Ventura,111,848112,62918,59061,2148,61209,353
2021-01-15,Yolo,113,214977,11171,10240,93,10333,134
2021-01-15,Yuba,115,75493,4787,4549,56,4605,27
2021-01-14,Alameda,001,1643700,68292,64364,1367,65731,686
2021-01-14,Alpine,003,1148,73,71,0,71,0
2021-01-14,Amador,005,37829,3025,2940,24,2964,28
2021-01-14,Butte,007,227075,9860,9127,1273,10400,129
2021-01-14,Calaveras,009,45235,1582,1513,7,1520,21
2021-01-14,Colusa,011,21464,1613,1535,161,1696,7
2021-01-14,Contra Costa,013,1133247,53063,49545,840,50385,415
2021-01-14,Del Norte,015,27424,862,821,2,823,2
2021-01-14,El Dorado,017,186661,7988,7321,506,7827,45
2021-01-14,Fresno,019,978130,85052,79033,6175,85208,814
2021-01-14,Glenn,021,27897,1993,1798,385,2183,9
2021-01-14,Humboldt,023,135768,2402,2169,8,2177,22
2021-01-14,Imperial,025,180216,25652,24882,2082,26964,447
2021-01-14,Inyo,027,18085,962,790,8,798,25
2021-01-14,Kern,029,883053,81715,77070,7125,84195,705
2021-01-14,Kings,031,150075,19631,18405,734,19139,108
2021-01-14,Lake,033,64148,2638,2378,0,2378,27
2021-01-14,Lassen,035,31185,4783,4673,71,4744,1
2021-01-14,Los Angeles,037,10098052,1028185,954652,31941,986593,13147
2021-01-14,Madera,039,155013,13694,12742,634,13376,85
2021-01-14,Marin,041,260295,11663,11155,110,11265,159
2021-01-14,Mariposa,043,17540,331,302,2,304,3
2021-01-14,Mendocino,045,87422,3034,2801,51,2852,31
2021-01-14,Merced,047,269075,23920,22780,585,23365,239
2021-01-14,Modoc,049,8938,294,273,85,358,0
2021-01-14,Mono,051,14174,1080,1020,12,1032,3
2021-01-14,Monterey,053,433212,36071,34105,1074,35179,242
2021-01-14,Napa,055,140530,7688,7117,30,7147,38
2021-01-14,Nevada,057,99092,3306,3075,126,3201,17
2021-01-14,Orange,059,3164182,215036,204442,8569,213011,2162
2021-01-14,Placer,061,380077,18069,16488,828,17316,169
2021-01-14,Plumas,063,18699,576,496,9,505,2
2021-01-14,Riverside,065,2383286,248325,231684,11521,243205,2357
2021-01-14,Sacramento,067,1510023,81092,79137,871,80008,1007
2021-01-14,San Benito,069,59416,4960,4678,50,4728,35
2021-01-14,San Bernardino,071,2135413,258119,243379,7273,250652,1750
2021-01-14,San Diego,073,3302833,221718,204173,10203,214376,2005
2021-01-14,San Francisco,075,870044,29318,28200,484,28684,238
2021-01-14,San Joaquin,077,732212,57993,55058,2207,57265,739
2021-01-14,San Luis Obispo,079,281455,16219,14851,390,15241,146
2021-01-14,San Mateo,081,765935,33445,30694,214,30908,208
2021-01-14,Santa Barbara,083,443738,25252,23126,723,23849,219
2021-01-14,Santa Clara,085,1922200,94076,88505,404,88909,910
2021-01-14,Santa Cruz,087,273765,13078,11583,568,12151,109
2021-01-14,Shasta,089,179085,9766,9334,956,10290,90
2021-01-14,Sierra,091,2930,44,35,6,41,0
2021-01-14,Siskiyou,093,43540,1223,1108,168,1276,3
2021-01-14,Solano,095,438530,25459,23782,270,24052,103
2021-01-14,Sonoma,097,501317,24002,22910,118,23028,202
2021-01-14,Stanislaus,099,539301,43217,40597,4156,44753,574
2021-01-14,Sutter,101,95872,7663,7416,60,7476,74
2021-01-14,Tehama,103,63373,3926,3664,417,4081,17
2021-01-14,Trinity,105,12862,437,261,62,323,3
2021-01-14,Tulare,107,460477,42230,39565,5392,44957,533
2021-01-14,Tuolumne,109,53932,3262,3215,30,3245,28
2021-01-14,Ventura,111,848112,62044,57941,2111,60052,347
2021-01-14,Yolo,113,214977,11067,10097,87,10184,135
2021-01-14,Yuba,115,75493,4755,4496,56,4552,27
2021-01-13,Alameda,001,1643700,67542,63568,1351,64919,690
2021-01-13,Alpine,003,1148,73,71,0,71,0
2021-01-13,Amador,005,37829,3011,2914,24,2938,26
2021-01-13,Butte,007,227075,9778,9013,1258,10271,126
2021-01-13,Calaveras,009,45235,1560,1493,7,1500,21
2021-01-13,Colusa,011,21464,1603,1524,153,1677,7
2021-01-13,Contra Costa,013,1133247,52490,48877,829,49706,403
2021-01-13,Del Norte,015,27424,858,820,2,822,2
2021-01-13,El Dorado,017,186661,7894,7247,498,7745,43
2021-01-13,Fresno,019,978130,84333,78278,6134,84412,804
2021-01-13,Glenn,021,27897,1977,1792,376,2168,9
2021-01-13,Humboldt,023,135768,2369,2114,8,2122,22
2021-01-13,Imperial,025,180216,25528,24717,2050,26767,463
2021-01-13,Inyo,027,18085,950,785,8,793,25
2021-01-13,Kern,029,883053,81056,76049,7035,83084,704
2021-01-13,Kings,031,150075,19464,18121,713,18834,108
2021-01-13,Lake,033,64148,2597,2305,0,2305,27
2021-01-13,Lassen,035,31185,4776,4663,70,4733,1
2021-01-13,Los Angeles,037,10098052,1017393,937985,31541,969526,12873
2021-01-13,Madera,039,155013,13578,12570,629,13199,85
2021-01-13,Marin,041,260295,11610,11039,110,11149,161
2021-01-13,Mariposa,043,17540,329,304,2,306,3
2021-01-13,Mendocino,045,87422,3014,2790,51,2841,31
2021-01-13,Merced,047,269075,23682,22497,571,23068,241
2021-01-13,Modoc,049,8938,293,274,82,356,0
2021-01-13,Mono,051,14174,1076,1017,12,1029,3
2021-01-13,Monterey,053,433212,35646,33748,1050,34798,241
2021-01-13,Napa,055,140530,7574,7028,30,7058,36
2021-01-13,Nevada,057,99092,3282,3037,123,3160,17
2021-01-13,Orange,059,3164182,212951,201158,8500,209658,2172
2021-01-13,Placer,061,380077,17944,16272,814,17086,172
2021-01-13,Plumas,063,18699,574,490,9,499,2
2021-01-13,Riverside,065,2383286,245180,228192,11408,239600,2278
2021-01-13,Sacramento,067,1510023,80431,78268,864,79132,996
2021-01-13,San Benito,069,59416,4904,4583,49,4632,35
2021-01-13,San Bernardino,071,2135413,255730,240191,7199,247390,1759
2021-01-13,San Diego,073,3302833,219104,201578,10100,211678,1952
2021-01-13,San Francisco,075,870044,29080,27863,464,28327,238
2021-01-13,San Joaquin,077,732212,57369,54373,2179,56552,738
2021-01-13,San Luis Obispo,079,281455,16064,14625,379,15004,140
2021-01-13,San Mateo,081,765935,33106,30195,212,30407,207
2021-01-13,Santa Barbara,083,443738,24810,22714,707,23421,216
2021-01-13,Santa Clara,085,1922200,93103,87187,400,87587,911
2021-01-13,Santa Cruz,087,273765,12905,11423,554,11977,110
2021-01-13,Shasta,089,179085,9702,9180,942,10122,93
2021-01-13,Sierra,091,2930,44,33,6,39,0
2021-01-13,Siskiyou,093,43540,1217,1102,164,1266,3
2021-01-13,Solano,095,438530,25181,23503,267,23770,105
2021-01-13,Sonoma,097,501317,23752,22610,117,22727,206
2021-01-13,Stanislaus,099,539301,42825,40167,4103,44270,574
2021-01-13,Sutter,101,95872,7617,7350,59,7409,73
2021-01-13,Tehama,103,63373,3875,3589,412,4001,17
2021-01-13,Trinity,105,12862,437,260,62,322,3
2021-01-13,Tulare,107,460477,41826,39129,5292,44421,522
2021-01-13,Tuolumne,109,53932,3248,3196,30,3226,28
2021-01-13,Ventura,111,848112,61032,56453,2071,58524,338
2021-01-13,Yolo,113,214977,10967,9933,85,10018,135
2021-01-13,Yuba,115,75493,4710,4448,53,4501,27
2021-01-12,Alameda,001,1643700,66717,62642,1333,63975,677
2021-01-12,Alpine,003,1148,73,71,0,71,0
2021-01-12,Amador,005,37829,2994,2897,24,2921,26
2021-01-12,Butte,007,227075,9690,8883,1243,10126,124
2021-01-12,Calaveras,009,45235,1524,1475,7,1482,21
2021-01-12,Colusa,011,21464,1591,1510,149,1659,7
2021-01-12,Contra Costa,013,1133247,51847,48242,815,49057,399
2021-01-12,Del Norte,015,27424,853,816,2,818,2
2021-01-12,El Dorado,017,186661,7810,7156,487,7643,41
2021-01-12,Fresno,019,978130,83462,77651,6066,83717,796
2021-01-12,Glenn,021,27897,1952,1781,372,2153,9
2021-01-12,Humboldt,023,135768,2315,2077,7,2084,22
2021-01-12,Imperial,025,180216,25437,24566,2009,26575,457
2021-01-12,Inyo,027,18085,932,773,8,781,25
2021-01-12,Kern,029,883053,80350,75320,6940,82260,689
2021-01-12,Kings,031,150075,19252,18072,703,18775,108
2021-01-12,Lake,033,64148,2549,2260,0,2260,27
2021-01-12,Lassen,035,31185,4754,4659,68,4727,1
2021-01-12,Los Angeles,037,10098052,1005730,926295,31143,957438,12610
2021-01-12,Madera,039,155013,13430,12485,620,13105,85
2021-01-12,Marin,041,260295,11503,10960,110,11070,157
2021-01-12,Mariposa,043,17540,326,302,2,304,3
2021-01-12,Mendocino,045,87422,2994,2762,47,2809,31
2021-01-12,Merced,047,269075,23431,22172,549,22721,239
2021-01-12,Modoc,049,8938,291,274,82,356,0
2021-01-12,Mono,051,14174,1066,1008,12,1020,3
2021-01-12,Monterey,053,433212,35155,33381,1033,34414,240
2021-01-12,Napa,055,140530,7491,6936,30,6966,36
2021-01-12,Nevada,057,99092,3254,3014,121,3135,17
2021-01-12,Orange,059,3164182,210662,198260,8414,206674,2142
2021-01-12,Placer,061,380077,17774,16087,808,16895,163
2021-01-12,Plumas,063,18699,568,483,9,492,2
2021-01-12,Riverside,065,2383286,242048,225580,11269,236849,2266
2021-01-12,Sacramento,067,1510023,79703,77201,856,78057,985
2021-01-12,San Benito,069,59416,4835,4515,49,4564,35
2021-01-12,San Bernardino,071,2135413,253149,237008,7130,244138,1739
2021-01-12,San Diego,073,3302833,216190,198317,9983,208300,1898
2021-01-12,San Francisco,075,870044,28803,27531,431,27962,238
2021-01-12,San Joaquin,077,732212,56729,53630,2151,55781,725
2021-01-12,San Luis Obispo,079,281455,15819,14367,371,14738,132
2021-01-12,San Mateo,081,765935,32715,29747,200,29947,206
2021-01-12,Santa Barbara,083,443738,24388,22182,687,22869,209
2021-01-12,Santa Clara,085,1922200,91988,86075,392,86467,904
2021-01-12,Santa Cruz,087,273765,12690,11267,539,11806,110
2021-01-12,Shasta,089,179085,9629,9086,929,10015,84
2021-01-12,Sierra,091,2930,43,33,6,39,0
2021-01-12,Siskiyou,093,43540,1207,1091,157,1248,3
2021-01-12,Solano,095,438530,24880,23160,263,23423,102
2021-01-12,Sonoma,097,501317,23447,22403,117,22520,205
2021-01-12,Stanislaus,099,539301,42386,39615,4068,43683,571
2021-01-12,Sutter,101,95872,7554,7276,58,7334,73
2021-01-12,Tehama,103,63373,3837,3567,407,3974,17
2021-01-12,Trinity,105,12862,437,258,62,320,3
2021-01-12,Tulare,107,460477,41365,38797,5176,43973,509
2021-01-12,Tuolumne,109,53932,3215,3178,30,3208,28
2021-01-12,Ventura,111,848112,60058,55342,2039,57381,324
2021-01-12,Yolo,113,214977,10830,9857,83,9940,133
2021-01-12,Yuba,115,75493,4665,4389,53,4442,27
2021-01-11,Alameda,001,1643700,65863,61949,1315,63264,652
2021-01-11,Alpine,003,1148,73,70,0,70,0
2021-01-11,Amador,005,37829,2980,2867,24,2891,24
2021-01-11,Butte,007,227075,9577,8757,1225,9982,119
2021-01-11,Calaveras,009,45235,1505,1460,7,1467,21
2021-01-11,Colusa,011,21464,1572,1494,144,1638,7
2021-01-11,Contra Costa,013,1133247,51165,47728,804,48532,398
2021-01-11,Del Norte,015,27424,849,810,2,812,2
2021-01-11,El Dorado,017,186661,7716,6987,480,7467,36
2021-01-11,Fresno,019,978130,82583,76581,5990,82571,775
2021-01-11,Glenn,021,27897,1925,1763,366,2129,9
2021-01-11,Humboldt,023,135768,2276,2069,7,2076,22
2021-01-11,Imperial,025,180216,25326,24418,1972,26390,453
2021-01-11,Inyo,027,18085,913,763,8,771,25
2021-01-11,Kern,029,883053,79490,74489,6841,81330,682
2021-01-11,Kings,031,150075,18990,17909,695,18604,108
2021-01-11,Lake,033,64148,2498,2205,0,2205,26
2021-01-11,Lassen,035,31185,4731,4647,68,4715,1
2021-01-11,Los Angeles,037,10098052,992504,914434,30680,945114,12304
2021-01-11,Madera,039,155013,13293,12366,609,12975,85
2021-01-11,Marin,041,260295,11404,10814,109,10923,156
2021-01-11,Mariposa,043,17540,319,296,2,298,3
2021-01-11,Mendocino,045,87422,2966,2728,47,2775,31
2021-01-11,Merced,047,269075,23108,21884,535,22419,238
2021-01-11,Modoc,049,8938,290,271,81,352,0
2021-01-11,Mono,051,14174,1060,1006,12,1018,3
2021-01-11,Monterey,053,433212,34616,32858,971,33829,239
2021-01-11,Napa,055,140530,7389,6822,30,6852,36
2021-01-11,Nevada,057,99092,3226,2980,121,3101,17
2021-01-11,Orange,059,3164182,208077,196340,8315,204655,2113
2021-01-11,Placer,061,380077,17594,15919,799,16718,163
2021-01-11,Plumas,063,18699,564,477,9,486,2
2021-01-11,Riverside,065,2383286,238542,222907,11125,234032,2222
2021-01-11,Sacramento,067,1510023,78771,76009,840,76849,974
2021-01-11,San Benito,069,59416,4763,4482,42,4524,34
2021-01-11,San Bernardino,071,2135413,250350,235543,7032,242575,1739
2021-01-11,San Diego,073,3302833,212921,194793,9823,204616,1857
2021-01-11,San Francisco,075,870044,28524,27264,411,27675,238
2021-01-11,San Joaquin,077,732212,56121,53002,2122,55124,725
2021-01-11,San Luis Obispo,079,281455,15448,14213,364,14577,126
2021-01-11,San Mateo,081,765935,32271,29355,188,29543,206
2021-01-11,Santa Barbara,083,443738,23937,21740,675,22415,200
2021-01-11,Santa Clara,085,1922200,90744,84851,384,85235,877
2021-01-11,Santa Cruz,087,273765,12510,11093,516,11609,106
2021-01-11,Shasta,089,179085,9531,8977,916,9893,81
2021-01-11,Sierra,091,2930,41,33,6,39,0
2021-01-11,Siskiyou,093,43540,1198,1087,155,1242,3
2021-01-11,Solano,095,438530,24559,22893,257,23150,101
2021-01-11,Sonoma,097,501317,23200,22191,117,22308,205
2021-01-11,Stanislaus,099,539301,41895,39149,4019,43168,571
2021-01-11,Sutter,101,95872,7495,7204,57,7261,71
2021-01-11,Tehama,103,63373,3775,3524,386,3910,17
2021-01-11,Trinity,105,12862,437,256,62,318,2
2021-01-11,Tulare,107,460477,40951,38380,5096,43476,497
2021-01-11,Tuolumne,109,53932,3204,3165,30,3195,27
2021-01-11,Ventura,111,848112,58921,54202,2015,56217,320
2021-01-11,Yolo,113,214977,10623,9699,82,9781,129
2021-01-11,Yuba,115,75493,4627,4349,46,4395,27
2021-01-10,Alameda,001,1643700,64882,61111,1287,62398,650
2021-01-10,Alpine,003,1148,73,70,0,70,0
2021-01-10,Amador,005,37829,2956,2861,24,2885,24
2021-01-10,Butte,007,227075,9456,8665,1199,9864,119
2021-01-10,Calaveras,009,45235,1482,1449,7,1456,21
2021-01-10,Colusa,011,21464,1550,1478,142,1620,7
2021-01-10,Contra Costa,013,1133247,50369,47109,785,47894,398
2021-01-10,Del Norte,015,27424,847,809,2,811,2
2021-01-10,El Dorado,017,186661,7628,6904,463,7367,36
2021-01-10,Fresno,019,978130,81772,75621,5868,81489,775
2021-01-10,Glenn,021,27897,1906,1746,358,2104,9
2021-01-10,Humboldt,023,135768,2215,2049,7,2056,22
2021-01-10,Imperial,025,180216,25168,24233,1922,26155,453
2021-01-10,Inyo,027,18085,886,748,8,756,25
2021-01-10,Kern,029,883053,78659,73712,6711,80423,679
2021-01-10,Kings,031,150075,18771,17812,688,18500,108
2021-01-10,Lake,033,64148,2443,2174,0,2174,26
2021-01-10,Lassen,035,31185,4709,4642,68,4710,1
2021-01-10,Los Angeles,037,10098052,977892,901783,30061,931844,12170
2021-01-10,Madera,039,155013,13102,12179,592,12771,85
2021-01-10,Marin,041,260295,11281,10737,108,10845,155
2021-01-10,Mariposa,043,17540,319,291,2,293,3
2021-01-10,Mendocino,045,87422,2935,2706,43,2749,31
2021-01-10,Merced,047,269075,22836,21691,524,22215,238
2021-01-10,Modoc,049,8938,290,271,79,350,0
2021-01-10,Mono,051,14174,1042,965,12,977,3
2021-01-10,Monterey,053,433212,34176,32571,939,33510,237
2021-01-10,Napa,055,140530,7285,6687,28,6715,36
2021-01-10,Nevada,057,99092,3207,2959,117,3076,17
2021-01-10,Orange,059,3164182,205307,193766,8193,201959,2104
2021-01-10,Placer,061,380077,17405,15779,779,16558,163
2021-01-10,Plumas,063,18699,554,477,9,486,2
2021-01-10,Riverside,065,2383286,235180,219486,10936,230422,2216
2021-01-10,Sacramento,067,1510023,77810,75394,813,76207,965
2021-01-10,San Benito,069,59416,4661,4434,41,4475,34
2021-01-10,San Bernardino,071,2135413,246932,232171,6929,239100,1736
2021-01-10,San Diego,073,3302833,209253,191886,9656,201542,1857
2021-01-10,San Francisco,075,870044,28143,27054,380,27434,238
2021-01-10,San Joaquin,077,732212,55311,52535,2089,54624,725
2021-01-10,San Luis Obispo,079,281455,15119,13968,352,14320,122
2021-01-10,San Mateo,081,765935,31781,28972,174,29146,206
2021-01-10,Santa Barbara,083,443738,23378,21290,660,21950,200
2021-01-10,Santa Clara,085,1922200,89562,83779,375,84154,858
2021-01-10,Santa Cruz,087,273765,12297,10951,498,11449,106
2021-01-10,Shasta,089,179085,9419,8936,901,9837,81
2021-01-10,Sierra,091,2930,40,32,6,38,0
2021-01-10,Siskiyou,093,43540,1192,1075,152,1227,3
2021-01-10,Solano,095,438530,24158,22621,254,22875,101
2021-01-10,Sonoma,097,501317,22924,21925,116,22041,204
2021-01-10,Stanislaus,099,539301,41321,38809,3942,42751,571
2021-01-10,Sutter,101,95872,7434,7133,54,7187,71
2021-01-10,Tehama,103,63373,3702,3504,374,3878,17
2021-01-10,Trinity,105,12862,437,253,60,313,2
2021-01-10,Tulare,107,460477,40536,38012,4979,42991,497
2021-01-10,Tuolumne,109,53932,3170,3143,29,3172,27
2021-01-10,Ventura,111,848112,57652,53095,1972,55067,319
2021-01-10,Yolo,113,214977,10470,9610,82,9692,129
2021-01-10,Yuba,115,75493,4574,4300,43,4343,27
2021-01-09,Alameda,001,1643700,64338,60125,1271,61396,649
2021-01-09,Alpine,003,1148,73,70,0,70,0
2021-01-09,Amador,005,37829,2949,2809,24,2833,24
2021-01-09,Butte,007,227075,9377,8552,1175,9727,118
2021-01-09,Calaveras,009,45235,1472,1425,7,1432,21
2021-01-09,Colusa,011,21464,1543,1468,141,1609,7
2021-01-09,Contra Costa,013,1133247,50014,46406,770,47176,393
2021-01-09,Del Norte,015,27424,845,802,2,804,2
2021-01-09,El Dorado,017,186661,7595,6800,460,7260,36
2021-01-09,Fresno,019,978130,81363,74816,5828,80644,773
2021-01-09,Glenn,021,27897,1891,1707,355,2062,9
2021-01-09,Humboldt,023,135768,2197,2026,7,2033,22
2021-01-09,Imperial,025,180216,25099,24028,1909,25937,448
2021-01-09,Inyo,027,18085,877,734,8,742,25
2021-01-09,Kern,029,883053,78190,73015,6634,79649,677
2021-01-09,Kings,031,150075,18676,17679,684,18363,108
2021-01-09,Lake,033,64148,2407,2144,0,2144,26
2021-01-09,Lassen,035,31185,4697,4613,68,4681,1
2021-01-09,Los Angeles,037,10098052,972316,887949,29629,917578,12011
2021-01-09,Madera,039,155013,13007,12063,586,12649,85
2021-01-09,Marin,041,260295,11220,10634,107,10741,154
2021-01-09,Mariposa,043,17540,316,287,2,289,3
2021-01-09,Mendocino,045,87422,2917,2664,43,2707,31
2021-01-09,Merced,047,269075,22694,21357,515,21872,237
2021-01-09,Modoc,049,8938,290,271,78,349,0
2021-01-09,Mono,051,14174,1037,964,12,976,3
2021-01-09,Monterey,053,433212,34025,31948,929,32877,235
2021-01-09,Napa,055,140530,7215,6594,25,6619,36
2021-01-09,Nevada,057,99092,3185,2932,114,3046,17
2021-01-09,Orange,059,3164182,203793,191004,8101,199105,2034
2021-01-09,Placer,061,380077,17298,15609,777,16386,162
2021-01-09,Plumas,063,18699,552,477,9,486,2
2021-01-09,Riverside,065,2383286,233425,216076,10800,226876,2201
2021-01-09,Sacramento,067,1510023,77278,74482,808,75290,953
2021-01-09,San Benito,069,59416,4609,4335,41,4376,34
2021-01-09,San Bernardino,071,2135413,245715,228857,6862,235719,1714
2021-01-09,San Diego,073,3302833,207559,188598,9536,198134,1824
2021-01-09,San Francisco,075,870044,27973,26708,339,27047,235
2021-01-09,San Joaquin,077,732212,54983,51927,2070,53997,724
2021-01-09,San Luis Obispo,079,281455,14995,13647,341,13988,121
2021-01-09,San Mateo,081,765935,31482,28512,167,28679,205
2021-01-09,Santa Barbara,083,443738,23166,20971,655,21626,197
2021-01-09,Santa Clara,085,1922200,88722,82269,363,82632,808
2021-01-09,Santa Cruz,087,273765,12201,10717,492,11209,107
2021-01-09,Shasta,089,179085,9386,8893,897,9790,81
2021-01-09,Sierra,091,2930,38,32,6,38,0
2021-01-09,Siskiyou,093,43540,1188,1062,147,1209,3
2021-01-09,Solano,095,438530,23999,22226,252,22478,101
2021-01-09,Sonoma,097,501317,22802,21393,116,21509,202
2021-01-09,Stanislaus,099,539301,41030,38403,3908,42311,567
2021-01-09,Sutter,101,95872,7398,7072,53,7125,69
2021-01-09,Tehama,103,63373,3670,3451,363,3814,15
2021-01-09,Trinity,105,12862,437,252,60,312,2
2021-01-09,Tulare,107,460477,40286,37684,4915,42599,496
2021-01-09,Tuolumne,109,53932,3162,3117,28,3145,26
2021-01-09,Ventura,111,848112,56824,51988,1946,53934,306
2021-01-09,Yolo,113,214977,10399,9524,81,9605,129
2021-01-09,Yuba,115,75493,4543,4265,43,4308,27
2021-01-08,Alameda,001,1643700,63776,59172,1262,60434,646
2021-01-08,Alpine,003,1148,73,70,0,70,0
2021-01-08,Amador,005,37829,2942,2792,24,2816,24
2021-01-08,Butte,007,227075,9317,8430,1161,9591,115
2021-01-08,Calaveras,009,45235,1458,1385,7,1392,21
2021-01-08,Colusa,011,21464,1531,1448,140,1588,7
2021-01-08,Contra Costa,013,1133247,49478,45667,766,46433,381
2021-01-08,Del Norte,015,27424,843,795,2,797,2
2021-01-08,El Dorado,017,186661,7525,6690,448,7138,36
2021-01-08,Fresno,019,978130,80549,73689,5770,79459,771
2021-01-08,Glenn,021,27897,1876,1680,350,2030,9
2021-01-08,Humboldt,023,135768,2173,1988,7,1995,22
2021-01-08,Imperial,025,180216,25034,23751,1894,25645,446
2021-01-08,Inyo,027,18085,862,682,8,690,24
2021-01-08,Kern,029,883053,77626,71978,6561,78539,674
2021-01-08,Kings,031,150075,18548,17441,679,18120,108
2021-01-08,Lake,033,64148,2379,2098,0,2098,26
2021-01-08,Lassen,035,31185,4689,4598,66,4664,1
2021-01-08,Los Angeles,037,10098052,961503,871188,29206,900394,11796
2021-01-08,Madera,039,155013,12857,11846,577,12423,85
2021-01-08,Marin,041,260295,11128,10531,107,10638,153
2021-01-08,Mariposa,043,17540,315,273,2,275,3
2021-01-08,Mendocino,045,87422,2898,2634,40,2674,31
2021-01-08,Merced,047,269075,22499,20862,510,21372,236
2021-01-08,Modoc,049,8938,290,266,78,344,0
2021-01-08,Mono,051,14174,1027,951,12,963,3
2021-01-08,Monterey,053,433212,33773,31543,919,32462,224
2021-01-08,Napa,055,140530,7145,6544,25,6569,32
2021-01-08,Nevada,057,99092,3163,2888,114,3002,17
2021-01-08,Orange,059,3164182,201795,186608,8015,194623,1991
2021-01-08,Placer,061,380077,17167,15401,770,16171,161
2021-01-08,Plumas,063,18699,546,465,9,474,2
2021-01-08,Riverside,065,2383286,231021,212122,10677,222799,2184
2021-01-08,Sacramento,067,1510023,76705,73245,802,74047,939
2021-01-08,San Benito,069,59416,4572,4225,40,4265,33
2021-01-08,San Bernardino,071,2135413,243837,224267,6792,231059,1703
2021-01-08,San Diego,073,3302833,205021,185060,9442,194502,1771
2021-01-08,San Francisco,075,870044,27722,26378,317,26695,207
2021-01-08,San Joaquin,077,732212,54658,50990,2042,53032,710
2021-01-08,San Luis Obispo,079,281455,14862,13286,329,13615,119
2021-01-08,San Mateo,081,765935,31132,28072,165,28237,204
2021-01-08,Santa Barbara,083,443738,22880,20461,650,21111,189
2021-01-08,Santa Clara,085,1922200,87778,80561,360,80921,789
2021-01-08,Santa Cruz,087,273765,12060,10486,484,10970,106
2021-01-08,Shasta,089,179085,9336,8772,882,9654,81
2021-01-08,Sierra,091,2930,38,31,6,37,0
2021-01-08,Siskiyou,093,43540,1185,1027,146,1173,3
2021-01-08,Solano,095,438530,23827,21832,249,22081,100
2021-01-08,Sonoma,097,501317,22660,21178,116,21294,201
2021-01-08,Stanislaus,099,539301,40731,37858,3874,41732,566
2021-01-08,Sutter,101,95872,7348,6982,53,7035,68
2021-01-08,Tehama,103,63373,3646,3406,360,3766,15
2021-01-08,Trinity,105,12862,437,247,60,307,2
2021-01-08,Tulare,107,460477,40018,36946,4820,41766,491
2021-01-08,Tuolumne,109,53932,3154,3099,28,3127,19
2021-01-08,Ventura,111,848112,55958,50553,1922,52475,294
2021-01-08,Yolo,113,214977,10310,9391,81,9472,129
2021-01-08,Yuba,115,75493,4501,4195,42,4237,26
2021-01-07,Alameda,001,1643700,62920,57921,1236,59157,632
2021-01-07,Alpine,003,1148,71,70,0,70,0
2021-01-07,Amador,005,37829,2929,2740,23,2763,24
2021-01-07,Butte,007,227075,9220,8278,1140,9418,112
2021-01-07,Calaveras,009,45235,1441,1342,6,1348,21
2021-01-07,Colusa,011,21464,1519,1420,133,1553,7
2021-01-07,Contra Costa,013,1133247,48701,44756,752,45508,376
2021-01-07,Del Norte,015,27424,841,791,2,793,2
2021-01-07,El Dorado,017,186661,7424,6545,438,6983,36
2021-01-07,Fresno,019,978130,79594,72557,5670,78227,765
2021-01-07,Glenn,021,27897,1858,1639,340,1979,9
2021-01-07,Humboldt,023,135768,2146,1954,7,1961,22
2021-01-07,Imperial,025,180216,24853,23608,1843,25451,431
2021-01-07,Inyo,027,18085,850,656,8,664,20
2021-01-07,Kern,029,883053,76764,70953,6413,77366,660
2021-01-07,Kings,031,150075,18422,17238,670,17908,108
2021-01-07,Lake,033,64148,2326,2054,0,2054,26
2021-01-07,Lassen,035,31185,4684,4581,64,4645,1
2021-01-07,Los Angeles,037,10098052,946584,853187,28675,881862,11480
2021-01-07,Madera,039,155013,12702,11644,567,12211,76
2021-01-07,Marin,041,260295,11039,10364,105,10469,153
2021-01-07,Mariposa,043,17540,313,264,2,266,3
2021-01-07,Mendocino,045,87422,2844,2585,35,2620,30
2021-01-07,Merced,047,269075,22178,20510,494,21004,234
2021-01-07,Modoc,049,8938,290,265,78,343,0
2021-01-07,Mono,051,14174,1016,905,12,917,3
2021-01-07,Monterey,053,433212,33269,30903,896,31799,222
2021-01-07,Napa,055,140530,7035,6408,25,6433,32
2021-01-07,Nevada,057,99092,3129,2847,109,2956,17
2021-01-07,Orange,059,3164182,198956,181922,7916,189838,1974
2021-01-07,Placer,061,380077,16989,15155,742,15897,144
2021-01-07,Plumas,063,18699,544,454,9,463,2
2021-01-07,Riverside,065,2383286,227563,208177,10527,218704,2156
2021-01-07,Sacramento,067,1510023,75800,72342,781,73123,919
2021-01-07,San Benito,069,59416,4511,4112,38,4150,33
2021-01-07,San Bernardino,071,2135413,240399,219691,6708,226399,1666
2021-01-07,San Diego,073,3302833,201715,180510,9264,189774,1738
2021-01-07,San Francisco,075,870044,27396,25885,304,26189,202
2021-01-07,San Joaquin,077,732212,53988,50156,2013,52169,689
2021-01-07,San Luis Obispo,079,281455,14624,12810,316,13126,118
2021-01-07,San Mateo,081,765935,30623,27494,162,27656,201
2021-01-07,Santa Barbara,083,443738,22453,19931,639,20570,187
2021-01-07,Santa Clara,085,1922200,86658,78808,356,79164,775
2021-01-07,Santa Cruz,087,273765,11851,10228,476,10704,104
2021-01-07,Shasta,089,179085,9248,8612,874,9486,81
2021-01-07,Sierra,091,2930,38,31,6,37,0
2021-01-07,Siskiyou,093,43540,1180,1010,145,1155,3
2021-01-07,Solano,095,438530,23437,21384,245,21629,100
2021-01-07,Sonoma,097,501317,22399,20857,115,20972,200
2021-01-07,Stanislaus,099,539301,40314,37296,3822,41118,553
2021-01-07,Sutter,101,95872,7289,6890,52,6942,65
2021-01-07,Tehama,103,63373,3622,3330,352,3682,15
2021-01-07,Trinity,105,12862,437,247,60,307,2
2021-01-07,Tulare,107,460477,39631,36397,4690,41087,482
2021-01-07,Tuolumne,109,53932,3134,3068,27,3095,14
2021-01-07,Ventura,111,848112,54797,49083,1894,50977,288
2021-01-07,Yolo,113,214977,10168,9207,79,9286,128
2021-01-07,Yuba,115,75493,4461,4128,42,4170,25
2021-01-06,Alameda,001,1643700,62066,57081,1209,58290,616
2021-01-06,Alpine,003,1148,71,70,0,70,0
2021-01-06,Amador,005,37829,2908,2717,22,2739,24
2021-01-06,Butte,007,227075,9105,8147,1121,9268,110
2021-01-06,Calaveras,009,45235,1418,1321,6,1327,21
2021-01-06,Colusa,011,21464,1499,1385,128,1513,7
2021-01-06,Contra Costa,013,1133247,47905,44054,736,44790,358
2021-01-06,Del Norte,015,27424,835,780,2,782,2
2021-01-06,El Dorado,017,186661,7312,6397,424,6821,35
2021-01-06,Fresno,019,978130,78751,71404,5568,76972,752
2021-01-06,Glenn,021,27897,1832,1622,336,1958,9
2021-01-06,Humboldt,023,135768,2120,1912,7,1919,22
2021-01-06,Imperial,025,180216,24606,23400,1801,25201,431
2021-01-06,Inyo,027,18085,834,630,8,638,20
2021-01-06,Kern,029,883053,75821,69893,6287,76180,646
2021-01-06,Kings,031,150075,18224,17019,651,17670,108
2021-01-06,Lake,033,64148,2292,2033,0,2033,26
2021-01-06,Lassen,035,31185,4672,4560,60,4620,1
2021-01-06,Los Angeles,037,10098052,930623,835052,27990,863042,11285
2021-01-06,Madera,039,155013,12568,11407,560,11967,67
2021-01-06,Marin,041,260295,10916,10282,104,10386,153
2021-01-06,Mariposa,043,17540,310,259,2,261,3
2021-01-06,Mendocino,045,87422,2814,2561,35,2596,30
2021-01-06,Merced,047,269075,21842,20258,479,20737,232
2021-01-06,Modoc,049,8938,290,263,78,341,0
2021-01-06,Mono,051,14174,985,905,12,917,3
2021-01-06,Monterey,053,433212,32668,30387,865,31252,222
2021-01-06,Napa,055,140530,6905,6342,25,6367,32
2021-01-06,Nevada,057,99092,3109,2805,108,2913,15
2021-01-06,Orange,059,3164182,195511,177686,7775,185461,1935
2021-01-06,Placer,061,380077,16800,14940,724,15664,134
2021-01-06,Plumas,063,18699,536,445,9,454,2
2021-01-06,Riverside,065,2383286,223547,203714,10341,214055,2121
2021-01-06,Sacramento,067,1510023,74776,71572,764,72336,909
2021-01-06,San Benito,069,59416,4435,4031,37,4068,32
2021-01-06,San Bernardino,071,2135413,236706,215286,6605,221891,1634
2021-01-06,San Diego,073,3302833,198215,176660,9093,185753,1691
2021-01-06,San Francisco,075,870044,27031,25424,296,25720,199
2021-01-06,San Joaquin,077,732212,53255,49286,1971,51257,673
2021-01-06,San Luis Obispo,079,281455,14231,12305,309,12614,115
2021-01-06,San Mateo,081,765935,30198,27050,159,27209,200
2021-01-06,Santa Barbara,083,443738,21964,19453,630,20083,177
2021-01-06,Santa Clara,085,1922200,85338,77485,349,77834,746
2021-01-06,Santa Cruz,087,273765,11632,9954,458,10412,97
2021-01-06,Shasta,089,179085,9178,8482,867,9349,78
2021-01-06,Sierra,091,2930,37,31,6,37,0
2021-01-06,Siskiyou,093,43540,1168,998,141,1139,3
2021-01-06,Solano,095,438530,23059,21102,242,21344,99
2021-01-06,Sonoma,097,501317,22092,20558,115,20673,196
2021-01-06,Stanislaus,099,539301,39747,36751,3762,40513,553
2021-01-06,Sutter,101,95872,7208,6839,51,6890,59
2021-01-06,Tehama,103,63373,3593,3306,346,3652,15
2021-01-06,Trinity,105,12862,437,246,60,306,2
2021-01-06,Tulare,107,460477,39139,35882,4595,40477,465
2021-01-06,Tuolumne,109,53932,3113,3008,27,3035,14
2021-01-06,Ventura,111,848112,53553,47428,1870,49298,280
2021-01-06,Yolo,113,214977,10004,9083,76,9159,127
2021-01-06,Yuba,115,75493,4411,4097,42,4139,25
2021-01-05,Alameda,001,1643700,60953,56432,1179,57611,602
2021-01-05,Alpine,003,1148,71,70,0,70,0
2021-01-05,Amador,005,37829,2868,2695,22,2717,24
2021-01-05,Butte,007,227075,8964,8008,1094,9102,107
2021-01-05,Calaveras,009,45235,1371,1292,6,1298,21
2021-01-05,Colusa,011,21464,1476,1376,122,1498,7
2021-01-05,Contra Costa,013,1133247,47045,43442,724,44166,353
2021-01-05,Del Norte,015,27424,828,770,2,772,2
2021-01-05,El Dorado,017,186661,7194,6270,403,6673,32
2021-01-05,Fresno,019,978130,77530,70971,5477,76448,741
2021-01-05,Glenn,021,27897,1809,1608,320,1928,9
2021-01-05,Humboldt,023,135768,2084,1884,7,1891,22
2021-01-05,Imperial,025,180216,24435,23165,1759,24924,421
2021-01-05,Inyo,027,18085,820,627,8,635,20
2021-01-05,Kern,029,883053,74744,68257,6152,74409,624
2021-01-05,Kings,031,150075,18026,16860,629,17489,108
2021-01-05,Lake,033,64148,2246,2015,0,2015,25
2021-01-05,Lassen,035,31185,4657,4554,56,4610,1
2021-01-05,Los Angeles,037,10098052,911886,823783,27327,851110,11028
2021-01-05,Madera,039,155013,12398,11359,548,11907,67
2021-01-05,Marin,041,260295,10767,10214,103,10317,151
2021-01-05,Mariposa,043,17540,304,257,2,259,3
2021-01-05,Mendocino,045,87422,2778,2501,35,2536,30
2021-01-05,Merced,047,269075,21491,20051,467,20518,230
2021-01-05,Modoc,049,8938,290,254,78,332,0
2021-01-05,Mono,051,14174,979,896,12,908,3
2021-01-05,Monterey,053,433212,32121,30045,832,30877,213
2021-01-05,Napa,055,140530,6818,6264,25,6289,29
2021-01-05,Nevada,057,99092,3081,2781,106,2887,15
2021-01-05,Orange,059,3164182,191877,174869,7584,182453,1918
2021-01-05,Placer,061,380077,16577,14723,701,15424,133
2021-01-05,Plumas,063,18699,529,428,9,437,2
2021-01-05,Riverside,065,2383286,219423,200439,10172,210611,2069
2021-01-05,Sacramento,067,1510023,73847,70677,738,71415,888
2021-01-05,San Benito,069,59416,4334,3961,35,3996,28
2021-01-05,San Bernardino,071,2135413,232742,212522,6489,219011,1615
2021-01-05,San Diego,073,3302833,194075,172845,8879,181724,1654
2021-01-05,San Francisco,075,870044,26660,24989,280,25269,196
2021-01-05,San Joaquin,077,732212,52396,48969,1927,50896,663
2021-01-05,San Luis Obispo,079,281455,13833,12027,299,12326,106
2021-01-05,San Mateo,081,765935,29717,26486,157,26643,198
2021-01-05,Santa Barbara,083,443738,21518,19063,622,19685,172
2021-01-05,Santa Clara,085,1922200,83789,76355,337,76692,729
2021-01-05,Santa Cruz,087,273765,11359,9753,434,10187,93
2021-01-05,Shasta,089,179085,9071,8345,849,9194,73
2021-01-05,Sierra,091,2930,37,31,6,37,0
2021-01-05,Siskiyou,093,43540,1156,985,139,1124,3
2021-01-05,Solano,095,438530,22650,20860,237,21097,97
2021-01-05,Sonoma,097,501317,21733,20247,114,20361,194
2021-01-05,Stanislaus,099,539301,39203,36363,3711,40074,553
2021-01-05,Sutter,101,95872,7111,6769,50,6819,59
2021-01-05,Tehama,103,63373,3539,3255,342,3597,9
2021-01-05,Trinity,105,12862,437,246,60,306,2
2021-01-05,Tulare,107,460477,38563,35585,4454,40039,455
2021-01-05,Tuolumne,109,53932,3089,2996,22,3018,13
2021-01-05,Ventura,111,848112,52309,46456,1848,48304,264
2021-01-05,Yolo,113,214977,9825,8980,75,9055,127
2021-01-05,Yuba,115,75493,4352,4053,41,4094,21
2021-01-04,Alameda,001,1643700,59737,55899,1146,57045,583
2021-01-04,Alpine,003,1148,71,68,0,68,0
2021-01-04,Amador,005,37829,2828,2596,22,2618,24
2021-01-04,Butte,007,227075,8805,7893,1073,8966,105
2021-01-04,Calaveras,009,45235,1330,1276,5,1281,21
2021-01-04,Colusa,011,21464,1451,1368,108,1476,7
2021-01-04,Contra Costa,013,1133247,46184,43019,700,43719,353
2021-01-04,Del Norte,015,27424,817,770,2,772,2
2021-01-04,El Dorado,017,186661,7060,6152,388,6540,27
2021-01-04,Fresno,019,978130,76262,69871,5379,75250,726
2021-01-04,Glenn,021,27897,1776,1590,315,1905,9
2021-01-04,Humboldt,023,135768,2047,1845,7,1852,22
2021-01-04,Imperial,025,180216,24287,23035,1708,24743,420
2021-01-04,Inyo,027,18085,794,623,8,631,20
2021-01-04,Kern,029,883053,73661,67418,5958,73376,623
2021-01-04,Kings,031,150075,17750,16801,605,17406,108
2021-01-04,Lake,033,64148,2210,1984,0,1984,25
2021-01-04,Lassen,035,31185,4635,4550,55,4605,1
2021-01-04,Los Angeles,037,10098052,891753,813022,26479,839501,10790
2021-01-04,Madera,039,155013,12182,11204,527,11731,67
2021-01-04,Marin,041,260295,10628,10115,101,10216,151
2021-01-04,Mariposa,043,17540,298,253,2,255,3
2021-01-04,Mendocino,045,87422,2738,2460,31,2491,28
2021-01-04,Merced,047,269075,21077,19804,448,20252,230
2021-01-04,Modoc,049,8938,274,250,76,326,0
2021-01-04,Mono,051,14174,968,895,12,907,3
2021-01-04,Monterey,053,433212,31507,29659,811,30470,212
2021-01-04,Napa,055,140530,6677,6187,25,6212,29
2021-01-04,Nevada,057,99092,3043,2765,103,2868,15
2021-01-04,Orange,059,3164182,187987,172458,7462,179920,1918
2021-01-04,Placer,061,380077,16318,14622,688,15310,133
2021-01-04,Plumas,063,18699,519,419,9,428,1
2021-01-04,Riverside,065,2383286,214874,196809,9986,206795,2066
2021-01-04,Sacramento,067,1510023,72794,70164,729,70893,870
2021-01-04,San Benito,069,59416,4221,3914,35,3949,28
2021-01-04,San Bernardino,071,2135413,228472,210868,6341,217209,1615
2021-01-04,San Diego,073,3302833,189501,171031,8683,179714,1598
2021-01-04,San Francisco,075,870044,26274,24753,274,25027,191
2021-01-04,San Joaquin,077,732212,51506,48644,1886,50530,661
2021-01-04,San Luis Obispo,079,281455,13347,11945,292,12237,96
2021-01-04,San Mateo,081,765935,29153,26150,152,26302,198
2021-01-04,Santa Barbara,083,443738,20995,18735,593,19328,165
2021-01-04,Santa Clara,085,1922200,82034,75297,330,75627,727
2021-01-04,Santa Cruz,087,273765,11071,9680,417,10097,85
2021-01-04,Shasta,089,179085,8966,8224,832,9056,72
2021-01-04,Sierra,091,2930,36,30,6,36,0
2021-01-04,Siskiyou,093,43540,1139,980,136,1116,3
2021-01-04,Solano,095,438530,22149,20588,229,20817,97
2021-01-04,Sonoma,097,501317,21395,20210,113,20323,194
2021-01-04,Stanislaus,099,539301,38640,36141,3656,39797,553
2021-01-04,Sutter,101,95872,7015,6712,49,6761,56
2021-01-04,Tehama,103,63373,3470,3190,337,3527,9
2021-01-04,Trinity,105,12862,434,245,60,305,2
2021-01-04,Tulare,107,460477,38023,35060,4354,39414,455
2021-01-04,Tuolumne,109,53932,3064,2987,22,3009,13
2021-01-04,Ventura,111,848112,50806,45014,1828,46842,255
2021-01-04,Yolo,113,214977,9630,8834,75,8909,121
2021-01-04,Yuba,115,75493,4297,4023,41,4064,21
2021-01-03,Alameda,001,1643700,58484,55082,1118,56200,580
2021-01-03,Alpine,003,1148,69,68,0,68,0
2021-01-03,Amador,005,37829,2771,2565,22,2587,24
2021-01-03,Butte,007,227075,8611,7837,1027,8864,105
2021-01-03,Calaveras,009,45235,1293,1249,3,1252,21
2021-01-03,Colusa,011,21464,1423,1337,102,1439,7
2021-01-03,Contra Costa,013,1133247,45299,42432,679,43111,352
2021-01-03,Del Norte,015,27424,806,768,2,770,2
2021-01-03,El Dorado,017,186661,6932,6034,371,6405,27
2021-01-03,Fresno,019,978130,75116,69326,5263,74589,719
2021-01-03,Glenn,021,27897,1751,1581,309,1890,9
2021-01-03,Humboldt,023,135768,2010,1833,7,1840,21
2021-01-03,Imperial,025,180216,24046,22951,1630,24581,419
2021-01-03,Inyo,027,18085,775,615,8,623,20
2021-01-03,Kern,029,883053,72399,66895,5783,72678,609
2021-01-03,Kings,031,150075,17474,16593,576,17169,108
2021-01-03,Lake,033,64148,2164,1976,0,1976,24
2021-01-03,Lassen,035,31185,4602,4531,54,4585,1
2021-01-03,Los Angeles,037,10098052,869694,792168,25433,817601,10633
2021-01-03,Madera,039,155013,11954,11152,504,11656,67
2021-01-03,Marin,041,260295,10477,10034,97,10131,150
2021-01-03,Mariposa,043,17540,291,248,2,250,3
2021-01-03,Mendocino,045,87422,2698,2445,29,2474,24
2021-01-03,Merced,047,269075,20610,19600,422,20022,230
2021-01-03,Modoc,049,8938,270,245,75,320,0
2021-01-03,Mono,051,14174,943,893,12,905,3
2021-01-03,Monterey,053,433212,30917,29357,776,30133,191
2021-01-03,Napa,055,140530,6576,6094,25,6119,29
2021-01-03,Nevada,057,99092,2982,2742,100,2842,15
2021-01-03,Orange,059,3164182,183802,169881,7273,177154,1919
2021-01-03,Placer,061,380077,16068,14319,665,14984,133
2021-01-03,Plumas,063,18699,506,416,9,425,1
2021-01-03,Riverside,065,2383286,209999,195048,9738,204786,2005
2021-01-03,Sacramento,067,1510023,71587,68558,708,69266,859
2021-01-03,San Benito,069,59416,4125,3882,34,3916,28
2021-01-03,San Bernardino,071,2135413,223190,208294,6172,214466,1592
2021-01-03,San Diego,073,3302833,184241,168018,8454,176472,1592
2021-01-03,San Francisco,075,870044,25784,24588,256,24844,193
2021-01-03,San Joaquin,077,732212,50396,47899,1831,49730,661
2021-01-03,San Luis Obispo,079,281455,12879,11636,284,11920,95
2021-01-03,San Mateo,081,765935,28559,25770,145,25915,196
2021-01-03,Santa Barbara,083,443738,20262,18267,578,18845,164
2021-01-03,Santa Clara,085,1922200,80446,74534,324,74858,720
2021-01-03,Santa Cruz,087,273765,10766,9528,402,9930,84
2021-01-03,Shasta,089,179085,8839,8192,792,8984,72
2021-01-03,Sierra,091,2930,36,30,6,36,0
2021-01-03,Siskiyou,093,43540,1106,976,127,1103,3
2021-01-03,Solano,095,438530,21616,20105,223,20328,97
2021-01-03,Sonoma,097,501317,21008,19982,111,20093,193
2021-01-03,Stanislaus,099,539301,37933,35762,3573,39335,553
2021-01-03,Sutter,101,95872,6918,6664,48,6712,53
2021-01-03,Tehama,103,63373,3416,3176,329,3505,9
2021-01-03,Trinity,105,12862,429,243,58,301,2
2021-01-03,Tulare,107,460477,37447,34747,4209,38956,455
2021-01-03,Tuolumne,109,53932,3003,2978,19,2997,13
2021-01-03,Ventura,111,848112,48980,43748,1811,45559,254
2021-01-03,Yolo,113,214977,9468,8674,74,8748,121
2021-01-03,Yuba,115,75493,4246,3966,40,4006,20
2021-01-02,Alameda,001,1643700,57862,54518,1087,55605,581
2021-01-02,Alpine,003,1148,69,68,0,68,0
2021-01-02,Amador,005,37829,2752,2540,22,2562,24
2021-01-02,Butte,007,227075,8505,7750,1006,8756,105
2021-01-02,Calaveras,009,45235,1273,1230,3,1233,21
2021-01-02,Colusa,011,21464,1412,1332,101,1433,7
2021-01-02,Contra Costa,013,1133247,44753,41993,671,42664,352
2021-01-02,Del Norte,015,27424,804,764,2,766,2
2021-01-02,El Dorado,017,186661,6877,5959,367,6326,27
2021-01-02,Fresno,019,978130,74573,68740,5152,73892,717
2021-01-02,Glenn,021,27897,1734,1546,308,1854,9
2021-01-02,Humboldt,023,135768,1983,1815,7,1822,21
2021-01-02,Imperial,025,180216,23958,22867,1599,24466,420
2021-01-02,Inyo,027,18085,764,609,8,617,20
2021-01-02,Kern,029,883053,71679,66457,5671,72128,610
2021-01-02,Kings,031,150075,17380,16515,572,17087,108
2021-01-02,Lake,033,64148,2127,1925,0,1925,24
2021-01-02,Lassen,035,31185,4591,4457,53,4510,1
2021-01-02,Los Angeles,037,10098052,861331,791892,24745,816637,10633
2021-01-02,Madera,039,155013,11839,11039,492,11531,67
2021-01-02,Marin,041,260295,10430,9924,94,10018,151
2021-01-02,Mariposa,043,17540,284,243,2,245,3
2021-01-02,Mendocino,045,87422,2655,2428,28,2456,24
2021-01-02,Merced,047,269075,20468,19395,405,19800,230
2021-01-02,Modoc,049,8938,269,245,75,320,0
2021-01-02,Mono,051,14174,932,884,12,896,3
2021-01-02,Monterey,053,433212,30701,28991,764,29755,191
2021-01-02,Napa,055,140530,6517,5994,25,6019,29
2021-01-02,Nevada,057,99092,2953,2706,96,2802,15
2021-01-02,Orange,059,3164182,181586,168457,7125,175582,1918
2021-01-02,Placer,061,380077,15895,14182,656,14838,133
2021-01-02,Plumas,063,18699,503,413,9,422,1
2021-01-02,Riverside,065,2383286,207354,192069,9511,201580,2008
2021-01-02,Sacramento,067,1510023,70952,67810,691,68501,858
2021-01-02,San Benito,069,59416,4042,3829,34,3863,28
2021-01-02,San Bernardino,071,2135413,221528,206939,6050,212989,1597
2021-01-02,San Diego,073,3302833,181642,164498,8257,172755,1592
2021-01-02,San Francisco,075,870044,25530,24414,248,24662,194
2021-01-02,San Joaquin,077,732212,49993,47310,1803,49113,662
2021-01-02,San Luis Obispo,079,281455,12745,11467,278,11745,95
2021-01-02,San Mateo,081,765935,28224,25483,137,25620,196
2021-01-02,Santa Barbara,083,443738,19973,18135,575,18710,164
2021-01-02,Santa Clara,085,1922200,79268,73662,318,73980,720
2021-01-02,Santa Cruz,087,273765,10611,9340,394,9734,85
2021-01-02,Shasta,089,179085,8773,8154,781,8935,72
2021-01-02,Sierra,091,2930,36,28,6,34,0
2021-01-02,Siskiyou,093,43540,1095,949,125,1074,3
2021-01-02,Solano,095,438530,21414,19805,214,20019,97
2021-01-02,Sonoma,097,501317,20839,19761,111,19872,194
2021-01-02,Stanislaus,099,539301,37600,35431,3509,38940,553
2021-01-02,Sutter,101,95872,6866,6621,48,6669,53
2021-01-02,Tehama,103,63373,3388,3146,325,3471,9
2021-01-02,Trinity,105,12862,426,243,58,301,2
2021-01-02,Tulare,107,460477,37119,34479,4135,38614,455
2021-01-02,Tuolumne,109,53932,2989,2942,17,2959,13
2021-01-02,Ventura,111,848112,47825,43397,1778,45175,254
2021-01-02,Yolo,113,214977,9369,8571,72,8643,122
2021-01-02,Yuba,115,75493,4208,3930,40,3970,21
2021-01-01,Alameda,001,1643700,57215,53518,1073,54591,579
2021-01-01,Alpine,003,1148,69,68,0,68,0
2021-01-01,Amador,005,37829,2726,2513,20,2533,24
2021-01-01,Butte,007,227075,8403,7589,984,8573,105
2021-01-01,Calaveras,009,45235,1258,1186,3,1189,21
2021-01-01,Colusa,011,21464,1402,1314,99,1413,7
2021-01-01,Contra Costa,013,1133247,44278,41412,651,42063,351
2021-01-01,Del Norte,015,27424,799,758,2,760,2
2021-01-01,El Dorado,017,186661,6784,5832,359,6191,27
2021-01-01,Fresno,019,978130,73500,67484,5068,72552,717
2021-01-01,Glenn,021,27897,1717,1520,299,1819,9
2021-01-01,Humboldt,023,135768,1944,1783,7,1790,21
2021-01-01,Imperial,025,180216,23862,22715,1548,24263,418
2021-01-01,Inyo,027,18085,739,606,8,614,20
2021-01-01,Kern,029,883053,70852,65571,5564,71135,609
2021-01-01,Kings,031,150075,17197,16358,565,16923,108
2021-01-01,Lake,033,64148,2089,1888,0,1888,24
2021-01-01,Lassen,035,31185,4585,4377,53,4430,1
2021-01-01,Los Angeles,037,10098052,847120,775578,24065,799643,10515
2021-01-01,Madera,039,155013,11684,10752,483,11235,66
2021-01-01,Marin,041,260295,10330,9821,93,9914,148
2021-01-01,Mariposa,043,17540,276,236,2,238,3
2021-01-01,Mendocino,045,87422,2601,2400,28,2428,24
2021-01-01,Merced,047,269075,20284,19118,389,19507,229
2021-01-01,Modoc,049,8938,269,241,75,316,0
2021-01-01,Mono,051,14174,914,884,11,895,3
2021-01-01,Monterey,053,433212,30463,28465,755,29220,191
2021-01-01,Napa,055,140530,6431,5899,25,5924,28
2021-01-01,Nevada,057,99092,2929,2663,96,2759,15
2021-01-01,Orange,059,3164182,178791,165440,6983,172423,1893
2021-01-01,Placer,061,380077,15705,13987,641,14628,133
2021-01-01,Plumas,063,18699,498,412,9,421,1
2021-01-01,Riverside,065,2383286,204166,188674,9258,197932,1990
2021-01-01,Sacramento,067,1510023,70356,66956,674,67630,848
2021-01-01,San Benito,069,59416,4004,3773,34,3807,28
2021-01-01,San Bernardino,071,2135413,218756,203651,5920,209571,1590
2021-01-01,San Diego,073,3302833,178569,160071,8078,168149,1592
2021-01-01,San Francisco,075,870044,25252,24145,237,24382,187
2021-01-01,San Joaquin,077,732212,49669,46640,1759,48399,657
2021-01-01,San Luis Obispo,079,281455,12518,11160,270,11430,94
2021-01-01,San Mateo,081,765935,27775,25041,133,25174,194
2021-01-01,Santa Barbara,083,443738,19653,17759,565,18324,164
2021-01-01,Santa Clara,085,1922200,78046,71904,314,72218,680
2021-01-01,Santa Cruz,087,273765,10431,9146,384,9530,84
2021-01-01,Shasta,089,179085,8692,8102,764,8866,72
2021-01-01,Sierra,091,2930,36,26,6,32,0
2021-01-01,Siskiyou,093,43540,1081,944,120,1064,3
2021-01-01,Solano,095,438530,21200,19393,212,19605,97
2021-01-01,Sonoma,097,501317,20643,19513,111,19624,189
2021-01-01,Stanislaus,099,539301,37312,34978,3447,38425,553
2021-01-01,Sutter,101,95872,6809,6553,47,6600,52
2021-01-01,Tehama,103,63373,3331,3079,318,3397,9
2021-01-01,Trinity,105,12862,426,243,58,301,2
2021-01-01,Tulare,107,460477,36712,33994,4047,38041,454
2021-01-01,Tuolumne,109,53932,2973,2909,17,2926,13
2021-01-01,Ventura,111,848112,46332,42026,1752,43778,253
2021-01-01,Yolo,113,214977,9256,8461,69,8530,120
2021-01-01,Yuba,115,75493,4154,3845,39,3884,19
2020-12-31,Alameda,001,1643700,56666,52475,1041,53516,579
2020-12-31,Alpine,003,1148,69,66,0,66,0
2020-12-31,Amador,005,37829,2712,2493,20,2513,24
2020-12-31,Butte,007,227075,8328,7405,964,8369,105
2020-12-31,Calaveras,009,45235,1247,1161,3,1164,21
2020-12-31,Colusa,011,21464,1390,1301,96,1397,7
2020-12-31,Contra Costa,013,1133247,43874,40512,635,41147,336
2020-12-31,Del Norte,015,27424,798,748,2,750,2
2020-12-31,El Dorado,017,186661,6732,5662,350,6012,26
2020-12-31,Fresno,019,978130,73068,66442,5006,71448,711
2020-12-31,Glenn,021,27897,1689,1484,291,1775,9
2020-12-31,Humboldt,023,135768,1927,1713,7,1720,21
2020-12-31,Imperial,025,180216,23792,22494,1532,24026,417
2020-12-31,Inyo,027,18085,731,591,8,599,20
2020-12-31,Kern,029,883053,70378,64904,5476,70380,609
2020-12-31,Kings,031,150075,17122,16077,557,16634,108
2020-12-31,Lake,033,64148,2068,1848,0,1848,23
2020-12-31,Lassen,035,31185,4579,4340,52,4392,1
2020-12-31,Los Angeles,037,10098052,841777,755844,23611,779455,10320
2020-12-31,Madera,039,155013,11599,10609,475,11084,64
2020-12-31,Marin,041,260295,10278,9731,91,9822,148
2020-12-31,Mariposa,043,17540,274,217,2,219,3
2020-12-31,Mendocino,045,87422,2586,2367,24,2391,24
2020-12-31,Merced,047,269075,20194,18808,379,19187,226
2020-12-31,Modoc,049,8938,269,238,75,313,0
2020-12-31,Mono,051,14174,906,868,11,879,3
2020-12-31,Monterey,053,433212,30233,27720,743,28463,188
2020-12-31,Napa,055,140530,6368,5801,25,5826,28
2020-12-31,Nevada,057,99092,2906,2619,95,2714,15
2020-12-31,Orange,059,3164182,176899,161586,6854,168440,1866
2020-12-31,Placer,061,380077,15549,13708,638,14346,126
2020-12-31,Plumas,063,18699,494,401,8,409,1
2020-12-31,Riverside,065,2383286,202484,184193,9130,193323,1958
2020-12-31,Sacramento,067,1510023,69826,65817,664,66481,830
2020-12-31,San Benito,069,59416,3980,3673,34,3707,28
2020-12-31,San Bernardino,071,2135413,217068,199115,5847,204962,1586
2020-12-31,San Diego,073,3302833,176806,155593,7979,163572,1534
2020-12-31,San Francisco,075,870044,25017,23740,230,23970,183
2020-12-31,San Joaquin,077,732212,49318,45764,1721,47485,646
2020-12-31,San Luis Obispo,079,281455,12404,10846,270,11116,89
2020-12-31,San Mateo,081,765935,27445,24570,127,24697,192
2020-12-31,Santa Barbara,083,443738,19409,17434,558,17992,161
2020-12-31,Santa Clara,085,1922200,77170,70032,309,70341,665
2020-12-31,Santa Cruz,087,273765,10313,8909,372,9281,84
2020-12-31,Shasta,089,179085,8626,7996,754,8750,69
2020-12-31,Sierra,091,2930,36,26,6,32,0
2020-12-31,Siskiyou,093,43540,1065,940,117,1057,3
2020-12-31,Solano,095,438530,20970,18942,211,19153,97
2020-12-31,Sonoma,097,501317,20522,19129,110,19239,188
2020-12-31,Stanislaus,099,539301,37004,34398,3400,37798,552
2020-12-31,Sutter,101,95872,6778,6432,47,6479,51
2020-12-31,Tehama,103,63373,3293,3036,317,3353,9
2020-12-31,Trinity,105,12862,425,241,58,299,2
2020-12-31,Tulare,107,460477,36510,33412,3986,37398,446
2020-12-31,Tuolumne,109,53932,2964,2902,17,2919,12
2020-12-31,Ventura,111,848112,45821,40854,1735,42589,251
2020-12-31,Yolo,113,214977,9167,8295,68,8363,117
2020-12-31,Yuba,115,75493,4117,3799,38,3837,18
2020-12-30,Alameda,001,1643700,55881,50158,988,51146,573
2020-12-30,Alpine,003,1148,69,66,0,66,0
2020-12-30,Amador,005,37829,2692,2418,19,2437,24
2020-12-30,Butte,007,227075,8167,7140,944,8084,103
2020-12-30,Calaveras,009,45235,1222,1135,3,1138,21
2020-12-30,Colusa,011,21464,1372,1289,90,1379,7
2020-12-30,Contra Costa,013,1133247,43324,39601,622,40223,337
2020-12-30,Del Norte,015,27424,793,726,2,728,2
2020-12-30,El Dorado,017,186661,6631,5595,340,5935,27
2020-12-30,Fresno,019,978130,72222,65566,4857,70423,711
2020-12-30,Glenn,021,27897,1658,1471,279,1750,9
2020-12-30,Humboldt,023,135768,1893,1654,7,1661,22
2020-12-30,Imperial,025,180216,23625,22098,1456,23554,412
2020-12-30,Inyo,027,18085,725,572,8,580,20
2020-12-30,Kern,029,883053,69650,63292,5332,68624,604
2020-12-30,Kings,031,150075,17003,15862,549,16411,108
2020-12-30,Lake,033,64148,2049,1731,0,1731,23
2020-12-30,Lassen,035,31185,4570,4300,52,4352,1
2020-12-30,Los Angeles,037,10098052,830860,741907,22937,764844,10046
2020-12-30,Madera,039,155013,11489,10249,464,10713,65
2020-12-30,Marin,041,260295,10186,9569,84,9653,148
2020-12-30,Mariposa,043,17540,270,214,2,216,3
2020-12-30,Mendocino,045,87422,2568,2291,21,2312,24
2020-12-30,Merced,047,269075,19904,18519,369,18888,225
2020-12-30,Modoc,049,8938,266,234,75,309,0
2020-12-30,Mono,051,14174,903,868,11,879,3
2020-12-30,Monterey,053,433212,29603,26977,721,27698,186
2020-12-30,Napa,055,140530,6262,5754,25,5779,28
2020-12-30,Nevada,057,99092,2871,2595,93,2688,15
2020-12-30,Orange,059,3164182,174240,153951,6667,160618,1863
2020-12-30,Placer,061,380077,15317,13540,626,14166,127
2020-12-30,Plumas,063,18699,489,397,8,405,1
2020-12-30,Riverside,065,2383286,199537,176402,8946,185348,1919
2020-12-30,Sacramento,067,1510023,68953,64119,647,64766,847
2020-12-30,San Benito,069,59416,3898,3464,30,3494,29
2020-12-30,San Bernardino,071,2135413,214498,192648,5762,198410,1591
2020-12-30,San Diego,073,3302833,173173,152510,7804,160314,1472
2020-12-30,San Francisco,075,870044,24743,23099,225,23324,182
2020-12-30,San Joaquin,077,732212,48597,44465,1680,46145,634
2020-12-30,San Luis Obispo,079,281455,12135,10542,262,10804,89
2020-12-30,San Mateo,081,765935,27016,24150,123,24273,190
2020-12-30,Santa Barbara,083,443738,19007,16895,537,17432,161
2020-12-30,Santa Clara,085,1922200,75963,67218,305,67523,661
2020-12-30,Santa Cruz,087,273765,10139,8787,363,9150,86
2020-12-30,Shasta,089,179085,8512,7818,740,8558,69
2020-12-30,Sierra,091,2930,36,25,6,31,0
2020-12-30,Siskiyou,093,43540,1058,913,109,1022,3
2020-12-30,Solano,095,438530,20581,18300,208,18508,96
2020-12-30,Sonoma,097,501317,20266,18947,110,19057,191
2020-12-30,Stanislaus,099,539301,36541,33730,3325,37055,526
2020-12-30,Sutter,101,95872,6718,6328,45,6373,51
2020-12-30,Tehama,103,63373,3249,2969,313,3282,9
2020-12-30,Trinity,105,12862,424,231,57,288,2
2020-12-30,Tulare,107,460477,35979,32413,3927,36340,430
2020-12-30,Tuolumne,109,53932,2954,2772,15,2787,12
2020-12-30,Ventura,111,848112,44534,39039,1711,40750,251
2020-12-30,Yolo,113,214977,9059,8067,66,8133,117
2020-12-30,Yuba,115,75493,4049,3612,38,3650,18
2020-12-29,Alameda,001,1643700,54815,50946,953,51899,552
2020-12-29,Alpine,003,1148,69,65,0,65,0
2020-12-29,Amador,005,37829,2640,2388,18,2406,23
2020-12-29,Butte,007,227075,7994,7178,920,8098,98
2020-12-29,Calaveras,009,45235,1178,1111,2,1113,21
2020-12-29,Colusa,011,21464,1351,1272,85,1357,7
2020-12-29,Contra Costa,013,1133247,42553,39225,596,39821,325
2020-12-29,Del Norte,015,27424,786,724,2,726,2
2020-12-29,El Dorado,017,186661,6501,5551,327,5878,22
2020-12-29,Fresno,019,978130,70847,65149,4707,69856,688
2020-12-29,Glenn,021,27897,1624,1454,272,1726,9
2020-12-29,Humboldt,023,135768,1845,1616,7,1623,19
2020-12-29,Imperial,025,180216,23411,22105,1374,23479,407
2020-12-29,Inyo,027,18085,707,571,8,579,19
2020-12-29,Kern,029,883053,68485,63096,5164,68260,589
2020-12-29,Kings,031,150075,16834,15777,537,16314,108
2020-12-29,Lake,033,64148,2018,1805,0,1805,22
2020-12-29,Lassen,035,31185,4555,4288,52,4340,1
2020-12-29,Los Angeles,037,10098052,810654,731907,22099,754006,9786
2020-12-29,Madera,039,155013,11187,10251,451,10702,64
2020-12-29,Marin,041,260295,10043,9595,80,9675,146
2020-12-29,Mariposa,043,17540,262,212,2,214,3
2020-12-29,Mendocino,045,87422,2525,2249,20,2269,24
2020-12-29,Merced,047,269075,19554,18464,353,18817,221
2020-12-29,Modoc,049,8938,263,232,75,307,0
2020-12-29,Mono,051,14174,894,868,11,879,3
2020-12-29,Monterey,053,433212,28952,26894,696,27590,185
2020-12-29,Napa,055,140530,6144,5663,25,5688,28
2020-12-29,Nevada,057,99092,2823,2550,92,2642,15
2020-12-29,Orange,059,3164182,170452,154411,6503,160914,1839
2020-12-29,Placer,061,380077,15104,13392,605,13997,126
2020-12-29,Plumas,063,18699,480,395,8,403,1
2020-12-29,Riverside,065,2383286,194938,177624,8696,186320,1904
2020-12-29,Sacramento,067,1510023,67901,65078,635,65713,820
2020-12-29,San Benito,069,59416,3779,3474,29,3503,25
2020-12-29,San Bernardino,071,2135413,209666,190476,5626,196102,1557
2020-12-29,San Diego,073,3302833,168950,150062,7573,157635,1435
2020-12-29,San Francisco,075,870044,24404,22996,218,23214,178
2020-12-29,San Joaquin,077,732212,47658,44699,1627,46326,622
2020-12-29,San Luis Obispo,079,281455,11839,10387,254,10641,80
2020-12-29,San Mateo,081,765935,26474,23773,111,23884,189
2020-12-29,Santa Barbara,083,443738,18538,16797,511,17308,155
2020-12-29,Santa Clara,085,1922200,74462,67581,301,67882,621
2020-12-29,Santa Cruz,087,273765,9873,8492,354,8846,84
2020-12-29,Shasta,089,179085,8408,7782,725,8507,65
2020-12-29,Sierra,091,2930,34,24,5,29,0
2020-12-29,Siskiyou,093,43540,1043,926,107,1033,3
2020-12-29,Solano,095,438530,20205,18412,203,18615,96
2020-12-29,Sonoma,097,501317,19934,18790,108,18898,187
2020-12-29,Stanislaus,099,539301,36064,33775,3255,37030,508
2020-12-29,Sutter,101,95872,6651,6302,45,6347,50
2020-12-29,Tehama,103,63373,3179,2962,301,3263,9
2020-12-29,Trinity,105,12862,423,241,57,298,2
2020-12-29,Tulare,107,460477,35352,32545,3805,36350,419
2020-12-29,Tuolumne,109,53932,2912,2797,15,2812,12
2020-12-29,Ventura,111,848112,43279,38669,1685,40354,235
2020-12-29,Yolo,113,214977,8929,8124,64,8188,111
2020-12-29,Yuba,115,75493,3970,3723,38,3761,18
2020-12-28,Alameda,001,1643700,53770,50405,933,51338,551
2020-12-28,Alpine,003,1148,68,65,0,65,0
2020-12-28,Amador,005,37829,2570,2255,18,2273,23
2020-12-28,Butte,007,227075,7827,7053,890,7943,86
2020-12-28,Calaveras,009,45235,1155,1102,2,1104,21
2020-12-28,Colusa,011,21464,1325,1255,74,1329,7
2020-12-28,Contra Costa,013,1133247,41612,38872,567,39439,324
2020-12-28,Del Norte,015,27424,777,718,2,720,2
2020-12-28,El Dorado,017,186661,6345,5441,315,5756,18
2020-12-28,Fresno,019,978130,69578,64274,4558,68832,679
2020-12-28,Glenn,021,27897,1590,1435,260,1695,9
2020-12-28,Humboldt,023,135768,1810,1579,7,1586,19
2020-12-28,Imperial,025,180216,23156,22003,1300,23303,405
2020-12-28,Inyo,027,18085,701,569,8,577,19
2020-12-28,Kern,029,883053,67418,62392,4964,67356,579
2020-12-28,Kings,031,150075,16617,15733,520,16253,108
2020-12-28,Lake,033,64148,1978,1785,0,1785,22
2020-12-28,Lassen,035,31185,4448,4284,51,4335,1
2020-12-28,Los Angeles,037,10098052,788299,720699,21306,742005,9544
2020-12-28,Madera,039,155013,11014,10123,431,10554,64
2020-12-28,Marin,041,260295,9936,9546,74,9620,145
2020-12-28,Mariposa,043,17540,238,211,2,213,3
2020-12-28,Mendocino,045,87422,2490,2214,20,2234,23
2020-12-28,Merced,047,269075,19234,18245,335,18580,213
2020-12-28,Modoc,049,8938,258,220,74,294,0
2020-12-28,Mono,051,14174,890,848,11,859,3
2020-12-28,Monterey,053,433212,28104,26529,687,27216,182
2020-12-28,Napa,055,140530,6035,5576,25,5601,26
2020-12-28,Nevada,057,99092,2775,2532,88,2620,15
2020-12-28,Orange,059,3164182,166346,152089,6328,158417,1839
2020-12-28,Placer,061,380077,14764,13234,578,13812,126
2020-12-28,Plumas,063,18699,476,391,8,399,0
2020-12-28,Riverside,065,2383286,190040,174029,8409,182438,1855
2020-12-28,Sacramento,067,1510023,66667,64322,611,64933,813
2020-12-28,San Benito,069,59416,3710,3429,29,3458,24
2020-12-28,San Bernardino,071,2135413,204576,188919,5513,194432,1552
2020-12-28,San Diego,073,3302833,164206,147528,7391,154919,1404
2020-12-28,San Francisco,075,870044,24044,22726,213,22939,178
2020-12-28,San Joaquin,077,732212,46719,44172,1595,45767,618
2020-12-28,San Luis Obispo,079,281455,11489,10260,250,10510,76
2020-12-28,San Mateo,081,765935,26000,23467,107,23574,189
2020-12-28,Santa Barbara,083,443738,18070,16579,499,17078,155
2020-12-28,Santa Clara,085,1922200,72982,66418,294,66712,619
2020-12-28,Santa Cruz,087,273765,9615,8310,344,8654,81
2020-12-28,Shasta,089,179085,8291,7688,712,8400,65
2020-12-28,Sierra,091,2930,32,24,4,28,0
2020-12-28,Siskiyou,093,43540,1027,915,102,1017,3
2020-12-28,Solano,095,438530,19645,18171,196,18367,96
2020-12-28,Sonoma,097,501317,19587,18667,106,18773,185
2020-12-28,Stanislaus,099,539301,35518,33473,3196,36669,507
2020-12-28,Sutter,101,95872,6571,6253,45,6298,49
2020-12-28,Tehama,103,63373,3126,2934,294,3228,9
2020-12-28,Trinity,105,12862,421,240,57,297,2
2020-12-28,Tulare,107,460477,34703,32010,3704,35714,404
2020-12-28,Tuolumne,109,53932,2895,2777,15,2792,12
2020-12-28,Ventura,111,848112,41610,37151,1640,38791,230
2020-12-28,Yolo,113,214977,8775,8031,63,8094,111
2020-12-28,Yuba,115,75493,3915,3679,37,3716,18
2020-12-27,Alameda,001,1643700,52532,49764,906,50670,551
2020-12-27,Alpine,003,1148,66,65,0,65,0
2020-12-27,Amador,005,37829,2450,2218,18,2236,23
2020-12-27,Butte,007,227075,7672,7016,851,7867,86
2020-12-27,Calaveras,009,45235,1109,1097,2,1099,21
2020-12-27,Colusa,011,21464,1300,1253,71,1324,7
2020-12-27,Contra Costa,013,1133247,40665,38428,543,38971,324
2020-12-27,Del Norte,015,27424,753,712,2,714,2
2020-12-27,El Dorado,017,186661,6131,5388,292,5680,18
2020-12-27,Fresno,019,978130,68332,63811,4355,68166,679
2020-12-27,Glenn,021,27897,1562,1434,246,1680,9
2020-12-27,Humboldt,023,135768,1766,1575,7,1582,17
2020-12-27,Imperial,025,180216,22877,21934,1193,23127,405
2020-12-27,Inyo,027,18085,681,565,7,572,18
2020-12-27,Kern,029,883053,66137,61914,4798,66712,568
2020-12-27,Kings,031,150075,16381,15593,486,16079,108
2020-12-27,Lake,033,64148,1929,1769,0,1769,22
2020-12-27,Lassen,035,31185,4371,4230,44,4274,1
2020-12-27,Los Angeles,037,10098052,766780,707260,20430,727690,9476
2020-12-27,Madera,039,155013,10757,10005,421,10426,64
2020-12-27,Marin,041,260295,9816,9477,72,9549,144
2020-12-27,Mariposa,043,17540,231,208,2,210,3
2020-12-27,Mendocino,045,87422,2443,2209,20,2229,23
2020-12-27,Merced,047,269075,18867,18075,319,18394,213
2020-12-27,Modoc,049,8938,249,221,70,291,0
2020-12-27,Mono,051,14174,878,849,11,860,3
2020-12-27,Monterey,053,433212,27541,26322,670,26992,181
2020-12-27,Napa,055,140530,5901,5496,25,5521,26
2020-12-27,Nevada,057,99092,2739,2519,88,2607,15
2020-12-27,Orange,059,3164182,161948,149276,6140,155416,1839
2020-12-27,Placer,061,380077,14469,13017,546,13563,126
2020-12-27,Plumas,063,18699,470,390,8,398,0
2020-12-27,Riverside,065,2383286,185126,171995,8109,180104,1836
2020-12-27,Sacramento,067,1510023,65458,63416,589,64005,811
2020-12-27,San Benito,069,59416,3625,3394,29,3423,24
2020-12-27,San Bernardino,071,2135413,199481,186776,5376,192152,1551
2020-12-27,San Diego,073,3302833,159799,145777,7204,152981,1402
2020-12-27,San Francisco,075,870044,23689,22514,205,22719,178
2020-12-27,San Joaquin,077,732212,45669,43529,1546,45075,618
2020-12-27,San Luis Obispo,079,281455,11081,10154,245,10399,76
2020-12-27,San Mateo,081,765935,25436,23136,104,23240,187
2020-12-27,Santa Barbara,083,443738,17541,16364,472,16836,155
2020-12-27,Santa Clara,085,1922200,71284,65288,288,65576,619
2020-12-27,Santa Cruz,087,273765,9357,8234,336,8570,81
2020-12-27,Shasta,089,179085,8164,7671,690,8361,65
2020-12-27,Sierra,091,2930,32,24,3,27,0
2020-12-27,Siskiyou,093,43540,1017,914,97,1011,3
2020-12-27,Solano,095,438530,19163,17840,191,18031,96
2020-12-27,Sonoma,097,501317,19296,18487,105,18592,185
2020-12-27,Stanislaus,099,539301,34906,33076,3113,36189,506
2020-12-27,Sutter,101,95872,6490,6218,43,6261,48
2020-12-27,Tehama,103,63373,3055,2922,278,3200,9
2020-12-27,Trinity,105,12862,414,240,55,295,2
2020-12-27,Tulare,107,460477,34099,31864,3586,35450,400
2020-12-27,Tuolumne,109,53932,2789,2750,13,2763,12
2020-12-27,Ventura,111,848112,40547,36661,1589,38250,230
2020-12-27,Yolo,113,214977,8586,7919,59,7978,111
2020-12-27,Yuba,115,75493,3852,3665,35,3700,18
2020-12-26,Alameda,001,1643700,51908,49084,893,49977,551
2020-12-26,Alpine,003,1148,66,65,0,65,0
2020-12-26,Amador,005,37829,2436,2189,18,2207,23
2020-12-26,Butte,007,227075,7576,6968,827,7795,86
2020-12-26,Calaveras,009,45235,1103,1084,2,1086,21
2020-12-26,Colusa,011,21464,1290,1240,71,1311,7
2020-12-26,Contra Costa,013,1133247,40186,38008,526,38534,324
2020-12-26,Del Norte,015,27424,748,709,2,711,2
2020-12-26,El Dorado,017,186661,6076,5279,288,5567,18
2020-12-26,Fresno,019,978130,67862,63080,4292,67372,679
2020-12-26,Glenn,021,27897,1541,1413,241,1654,9
2020-12-26,Humboldt,023,135768,1728,1545,7,1552,17
2020-12-26,Imperial,025,180216,22782,21734,1140,22874,405
2020-12-26,Inyo,027,18085,666,554,7,561,18
2020-12-26,Kern,029,883053,65467,61174,4651,65825,564
2020-12-26,Kings,031,150075,16263,15517,482,15999,108
2020-12-26,Lake,033,64148,1889,1710,0,1710,22
2020-12-26,Lassen,035,31185,4350,3981,44,4025,1
2020-12-26,Los Angeles,037,10098052,758213,694149,19936,714085,9424
2020-12-26,Madera,039,155013,10681,9908,409,10317,64
2020-12-26,Marin,041,260295,9776,9413,69,9482,143
2020-12-26,Mariposa,043,17540,230,206,2,208,3
2020-12-26,Mendocino,045,87422,2397,2194,20,2214,23
2020-12-26,Merced,047,269075,18708,17890,314,18204,213
2020-12-26,Modoc,049,8938,246,222,70,292,0
2020-12-26,Mono,051,14174,872,850,11,861,3
2020-12-26,Monterey,053,433212,27403,26010,661,26671,182
2020-12-26,Napa,055,140530,5843,5427,25,5452,26
2020-12-26,Nevada,057,99092,2711,2480,88,2568,15
2020-12-26,Orange,059,3164182,159740,147304,6049,153353,1838
2020-12-26,Placer,061,380077,14298,12816,531,13347,122
2020-12-26,Plumas,063,18699,467,381,8,389,0
2020-12-26,Riverside,065,2383286,182641,169360,7951,177311,1834
2020-12-26,Sacramento,067,1510023,64833,62435,579,63014,807
2020-12-26,San Benito,069,59416,3552,3330,29,3359,24
2020-12-26,San Bernardino,071,2135413,197804,185111,5294,190405,1551
2020-12-26,San Diego,073,3302833,157274,142644,7057,149701,1402
2020-12-26,San Francisco,075,870044,23448,22319,205,22524,177
2020-12-26,San Joaquin,077,732212,45280,42887,1500,44387,618
2020-12-26,San Luis Obispo,079,281455,10994,9945,240,10185,76
2020-12-26,San Mateo,081,765935,25098,22908,99,23007,187
2020-12-26,Santa Barbara,083,443738,17302,16159,466,16625,155
2020-12-26,Santa Clara,085,1922200,70170,64185,286,64471,618
2020-12-26,Santa Cruz,087,273765,9226,8113,327,8440,81
2020-12-26,Shasta,089,179085,8104,7641,678,8319,65
2020-12-26,Sierra,091,2930,32,24,3,27,0
2020-12-26,Siskiyou,093,43540,1010,909,94,1003,2
2020-12-26,Solano,095,438530,18922,17528,191,17719,96
2020-12-26,Sonoma,097,501317,19093,18261,103,18364,184
2020-12-26,Stanislaus,099,539301,34607,32678,3060,35738,505
2020-12-26,Sutter,101,95872,6432,6121,43,6164,48
2020-12-26,Tehama,103,63373,3026,2884,272,3156,9
2020-12-26,Trinity,105,12862,412,237,54,291,2
2020-12-26,Tulare,107,460477,33789,31665,3523,35188,398
2020-12-26,Tuolumne,109,53932,2778,2703,13,2716,12
2020-12-26,Ventura,111,848112,39582,36064,1559,37623,230
2020-12-26,Yolo,113,214977,8484,7785,57,7842,111
2020-12-26,Yuba,115,75493,3820,3599,35,3634,18
2020-12-25,Alameda,001,1643700,51336,48365,878,49243,542
2020-12-25,Alpine,003,1148,66,64,0,64,0
2020-12-25,Amador,005,37829,2393,2172,18,2190,23
2020-12-25,Butte,007,227075,7477,6873,809,7682,85
2020-12-25,Calaveras,009,45235,1100,1062,2,1064,21
2020-12-25,Colusa,011,21464,1277,1219,70,1289,7
2020-12-25,Contra Costa,013,1133247,39701,37480,502,37982,324
2020-12-25,Del Norte,015,27424,746,692,2,694,2
2020-12-25,El Dorado,017,186661,6011,5170,275,5445,16
2020-12-25,Fresno,019,978130,66998,62251,4212,66463,679
2020-12-25,Glenn,021,27897,1525,1390,234,1624,9
2020-12-25,Humboldt,023,135768,1688,1532,7,1539,16
2020-12-25,Imperial,025,180216,22680,21646,1128,22774,405
2020-12-25,Inyo,027,18085,656,546,7,553,18
2020-12-25,Kern,029,883053,64736,60417,4505,64922,562
2020-12-25,Kings,031,150075,16152,15460,478,15938,108
2020-12-25,Lake,033,64148,1870,1669,0,1669,20
2020-12-25,Lassen,035,31185,4335,3926,44,3970,1
2020-12-25,Los Angeles,037,10098052,744547,665600,19277,684877,9292
2020-12-25,Madera,039,155013,10517,9770,403,10173,64
2020-12-25,Marin,041,260295,9723,9375,67,9442,143
2020-12-25,Mariposa,043,17540,224,203,2,205,3
2020-12-25,Mendocino,045,87422,2354,2176,20,2196,23
2020-12-25,Merced,047,269075,18547,17726,306,18032,213
2020-12-25,Modoc,049,8938,245,221,70,291,0
2020-12-25,Mono,051,14174,870,843,11,854,3
2020-12-25,Monterey,053,433212,27126,25788,652,26440,182
2020-12-25,Napa,055,140530,5766,5351,25,5376,26
2020-12-25,Nevada,057,99092,2685,2458,86,2544,15
2020-12-25,Orange,059,3164182,157058,144542,5858,150400,1814
2020-12-25,Placer,061,380077,14112,12660,509,13169,122
2020-12-25,Plumas,063,18699,460,381,8,389,0
2020-12-25,Riverside,065,2383286,179360,166690,7640,174330,1825
2020-12-25,Sacramento,067,1510023,64141,61630,554,62184,796
2020-12-25,San Benito,069,59416,3511,3281,27,3308,24
2020-12-25,San Bernardino,071,2135413,195194,181812,5179,186991,1546
2020-12-25,San Diego,073,3302833,154794,139958,6879,146837,1402
2020-12-25,San Francisco,075,870044,23166,22130,200,22330,175
2020-12-25,San Joaquin,077,732212,44979,42089,1447,43536,614
2020-12-25,San Luis Obispo,079,281455,10811,9749,233,9982,76
2020-12-25,San Mateo,081,765935,24776,22568,97,22665,187
2020-12-25,Santa Barbara,083,443738,17078,15936,459,16395,155
2020-12-25,Santa Clara,085,1922200,69034,63173,277,63450,612
2020-12-25,Santa Cruz,087,273765,9076,8018,306,8324,81
2020-12-25,Shasta,089,179085,8030,7612,655,8267,65
2020-12-25,Sierra,091,2930,32,24,3,27,0
2020-12-25,Siskiyou,093,43540,1004,905,92,997,2
2020-12-25,Solano,095,438530,18743,17280,189,17469,96
2020-12-25,Sonoma,097,501317,18918,18035,101,18136,184
2020-12-25,Stanislaus,099,539301,34325,32290,3005,35295,498
2020-12-25,Sutter,101,95872,6373,6051,42,6093,47
2020-12-25,Tehama,103,63373,2977,2839,259,3098,9
2020-12-25,Trinity,105,12862,408,236,54,290,2
2020-12-25,Tulare,107,460477,33377,31323,3455,34778,398
2020-12-25,Tuolumne,109,53932,2759,2674,13,2687,12
2020-12-25,Ventura,111,848112,38426,35514,1511,37025,230
2020-12-25,Yolo,113,214977,8392,7700,55,7755,111
2020-12-25,Yuba,115,75493,3780,3549,34,3583,17
2020-12-24,Alameda,001,1643700,50979,47527,860,48387,541
2020-12-24,Alpine,003,1148,66,64,0,64,0
2020-12-24,Amador,005,37829,2381,2145,18,2163,23
2020-12-24,Butte,007,227075,7438,6716,794,7510,84
2020-12-24,Calaveras,009,45235,1097,1032,2,1034,21
2020-12-24,Colusa,011,21464,1272,1188,68,1256,7
2020-12-24,Contra Costa,013,1133247,39449,36623,489,37112,311
2020-12-24,Del Norte,015,27424,745,678,2,680,2
2020-12-24,El Dorado,017,186661,5985,5042,267,5309,16
2020-12-24,Fresno,019,978130,66775,61435,4198,65633,663
2020-12-24,Glenn,021,27897,1514,1363,226,1589,9
2020-12-24,Humboldt,023,135768,1665,1516,7,1523,16
2020-12-24,Imperial,025,180216,22618,21545,1118,22663,402
2020-12-24,Inyo,027,18085,654,532,7,539,17
2020-12-24,Kern,029,883053,64449,59601,4492,64093,556
2020-12-24,Kings,031,150075,16112,15211,477,15688,108
2020-12-24,Lake,033,64148,1848,1629,0,1629,20
2020-12-24,Lassen,035,31185,4322,3894,44,3938,1
2020-12-24,Los Angeles,037,10098052,740360,664840,19031,683871,9288
2020-12-24,Madera,039,155013,10468,9547,395,9942,63
2020-12-24,Marin,041,260295,9684,9287,67,9354,143
2020-12-24,Mariposa,043,17540,220,197,2,199,3
2020-12-24,Mendocino,045,87422,2343,2150,20,2170,23
2020-12-24,Merced,047,269075,18477,17485,302,17787,212
2020-12-24,Modoc,049,8938,245,220,69,289,0
2020-12-24,Mono,051,14174,868,817,11,828,3
2020-12-24,Monterey,053,433212,27013,25131,645,25776,180
2020-12-24,Napa,055,140530,5711,5265,25,5290,26
2020-12-24,Nevada,057,99092,2661,2429,86,2515,15
2020-12-24,Orange,059,3164182,155571,141205,5807,147012,1775
2020-12-24,Placer,061,380077,14022,12457,502,12959,121
2020-12-24,Plumas,063,18699,457,376,8,384,0
2020-12-24,Riverside,065,2383286,178425,162435,7600,170035,1816
2020-12-24,Sacramento,067,1510023,63866,60596,552,61148,788
2020-12-24,San Benito,069,59416,3480,3183,27,3210,24
2020-12-24,San Bernardino,071,2135413,194109,176866,5145,182011,1533
2020-12-24,San Diego,073,3302833,153710,136952,6847,143799,1382
2020-12-24,San Francisco,075,870044,22994,21830,197,22027,175
2020-12-24,San Joaquin,077,732212,44813,41324,1429,42753,611
2020-12-24,San Luis Obispo,079,281455,10742,9504,231,9735,77
2020-12-24,San Mateo,081,765935,24581,22093,97,22190,186
2020-12-24,Santa Barbara,083,443738,16973,15644,451,16095,153
2020-12-24,Santa Clara,085,1922200,68346,61742,270,62012,591
2020-12-24,Santa Cruz,087,273765,8997,7856,294,8150,82
2020-12-24,Shasta,089,179085,7989,7540,638,8178,65
2020-12-24,Sierra,091,2930,29,23,1,24,0
2020-12-24,Siskiyou,093,43540,999,900,86,986,2
2020-12-24,Solano,095,438530,18602,16872,184,17056,96
2020-12-24,Sonoma,097,501317,18817,17710,101,17811,183
2020-12-24,Stanislaus,099,539301,34123,31848,2978,34826,498
2020-12-24,Sutter,101,95872,6332,5960,41,6001,47
2020-12-24,Tehama,103,63373,2959,2779,257,3036,9
2020-12-24,Trinity,105,12862,407,235,54,289,2
2020-12-24,Tulare,107,460477,33230,30827,3429,34256,390
2020-12-24,Tuolumne,109,53932,2751,2653,13,2666,12
2020-12-24,Ventura,111,848112,38146,34400,1504,35904,224
2020-12-24,Yolo,113,214977,8350,7566,54,7620,113
2020-12-24,Yuba,115,75493,3749,3483,34,3517,16
2020-12-23,Alameda,001,1643700,50401,46753,833,47586,537
2020-12-23,Alpine,003,1148,66,64,0,64,0
2020-12-23,Amador,005,37829,2312,2108,17,2125,23
2020-12-23,Butte,007,227075,7349,6588,767,7355,84
2020-12-23,Calaveras,009,45235,1089,1002,1,1003,21
2020-12-23,Colusa,011,21464,1261,1167,67,1234,7
2020-12-23,Contra Costa,013,1133247,39052,36190,475,36665,311
2020-12-23,Del Norte,015,27424,737,670,2,672,2
2020-12-23,El Dorado,017,186661,5910,4967,259,5226,14
2020-12-23,Fresno,019,978130,66165,60488,4133,64621,654
2020-12-23,Glenn,021,27897,1500,1349,222,1571,9
2020-12-23,Humboldt,023,135768,1640,1458,7,1465,16
2020-12-23,Imperial,025,180216,22523,21323,1089,22412,399
2020-12-23,Inyo,027,18085,641,517,7,524,17
2020-12-23,Kern,029,883053,63931,58656,4401,63057,549
2020-12-23,Kings,031,150075,16035,14923,474,15397,105
2020-12-23,Lake,033,64148,1831,1595,0,1595,20
2020-12-23,Lassen,035,31185,4312,3865,41,3906,1
2020-12-23,Los Angeles,037,10098052,731290,651958,18510,670468,9146
2020-12-23,Madera,039,155013,10311,9371,380,9751,63
2020-12-23,Marin,041,260295,9625,9199,64,9263,142
2020-12-23,Mariposa,043,17540,218,194,2,196,3
2020-12-23,Mendocino,045,87422,2331,2121,20,2141,23
2020-12-23,Merced,047,269075,18321,17250,294,17544,203
2020-12-23,Modoc,049,8938,241,197,68,265,0
2020-12-23,Mono,051,14174,865,814,11,825,3
2020-12-23,Monterey,053,433212,26713,24856,640,25496,176
2020-12-23,Napa,055,140530,5643,5172,25,5197,25
2020-12-23,Nevada,057,99092,2616,2406,85,2491,15
2020-12-23,Orange,059,3164182,153120,138050,5646,143696,1771
2020-12-23,Placer,061,380077,13812,12213,494,12707,111
2020-12-23,Plumas,063,18699,450,369,8,377,0
2020-12-23,Riverside,065,2383286,176153,158110,7446,165556,1790
2020-12-23,Sacramento,067,1510023,63217,59661,539,60200,779
2020-12-23,San Benito,069,59416,3426,3073,25,3098,24
2020-12-23,San Bernardino,071,2135413,192042,172888,5077,177965,1509
2020-12-23,San Diego,073,3302833,151284,134695,6710,141405,1350
2020-12-23,San Francisco,075,870044,22774,21498,194,21692,174
2020-12-23,San Joaquin,077,732212,44286,35664,1387,37051,602
2020-12-23,San Luis Obispo,079,281455,10600,9267,226,9493,74
2020-12-23,San Mateo,081,765935,24279,21780,95,21875,186
2020-12-23,Santa Barbara,083,443738,16765,15399,426,15825,152
2020-12-23,Santa Clara,085,1922200,67399,60455,265,60720,579
2020-12-23,Santa Cruz,087,273765,8838,7637,276,7913,75
2020-12-23,Shasta,089,179085,7917,7487,632,8119,66
2020-12-23,Sierra,091,2930,27,23,1,24,0
2020-12-23,Siskiyou,093,43540,978,891,85,976,2
2020-12-23,Solano,095,438530,18389,16626,179,16805,95
2020-12-23,Sonoma,097,501317,18613,17397,101,17498,182
2020-12-23,Stanislaus,099,539301,33771,31492,2926,34418,499
2020-12-23,Sutter,101,95872,6265,5871,41,5912,46
2020-12-23,Tehama,103,63373,2941,2737,250,2987,9
2020-12-23,Trinity,105,12862,407,234,53,287,2
2020-12-23,Tulare,107,460477,32918,30315,3389,33704,385
2020-12-23,Tuolumne,109,53932,2712,2540,13,2553,12
2020-12-23,Ventura,111,848112,37749,33377,1475,34852,216
2020-12-23,Yolo,113,214977,8271,7508,54,7562,112
2020-12-23,Yuba,115,75493,3689,3438,34,3472,14
2020-12-22,Alameda,001,1643700,49511,45751,803,46554,534
2020-12-22,Alpine,003,1148,66,64,0,64,0
2020-12-22,Amador,005,37829,2301,1839,17,1856,23
2020-12-22,Butte,007,227075,7221,6467,753,7220,85
2020-12-22,Calaveras,009,45235,1062,988,0,988,21
2020-12-22,Colusa,011,21464,1238,1150,64,1214,7
2020-12-22,Contra Costa,013,1133247,38429,35681,461,36142,301
2020-12-22,Del Norte,015,27424,727,666,2,668,2
2020-12-22,El Dorado,017,186661,5787,4885,247,5132,12
2020-12-22,Fresno,019,978130,65133,59640,4031,63671,640
2020-12-22,Glenn,021,27897,1477,1337,211,1548,9
2020-12-22,Humboldt,023,135768,1607,1440,7,1447,16
2020-12-22,Imperial,025,180216,22333,21128,1048,22176,398
2020-12-22,Inyo,027,18085,620,506,7,513,17
2020-12-22,Kern,029,883053,62978,57816,4266,62082,547
2020-12-22,Kings,031,150075,15893,14855,468,15323,102
2020-12-22,Lake,033,64148,1807,1569,0,1569,20
2020-12-22,Lassen,035,31185,4170,3848,39,3887,1
2020-12-22,Los Angeles,037,10098052,714018,635931,17847,653778,9013
2020-12-22,Madera,039,155013,10197,9187,365,9552,63
2020-12-22,Marin,041,260295,9559,9115,63,9178,142
2020-12-22,Mariposa,043,17540,215,194,2,196,3
2020-12-22,Mendocino,045,87422,2298,2092,19,2111,23
2020-12-22,Merced,047,269075,18075,17012,289,17301,201
2020-12-22,Modoc,049,8938,233,182,67,249,0
2020-12-22,Mono,051,14174,859,786,11,797,3
2020-12-22,Monterey,053,433212,26042,24152,619,24771,176
2020-12-22,Napa,055,140530,5554,5059,25,5084,23
2020-12-22,Nevada,057,99092,2588,2367,84,2451,14
2020-12-22,Orange,059,3164182,149783,134850,5478,140328,1774
2020-12-22,Placer,061,380077,13568,11943,474,12417,105
2020-12-22,Plumas,063,18699,444,360,8,368,0
2020-12-22,Riverside,065,2383286,172343,155059,7180,162239,1777
2020-12-22,Sacramento,067,1510023,62289,57966,520,58486,772
2020-12-22,San Benito,069,59416,3348,2998,25,3023,24
2020-12-22,San Bernardino,071,2135413,187436,169266,4933,174199,1500
2020-12-22,San Diego,073,3302833,147925,132097,6548,138645,1311
2020-12-22,San Francisco,075,870044,22502,21232,190,21422,174
2020-12-22,San Joaquin,077,732212,43523,39423,1339,40762,592
2020-12-22,San Luis Obispo,079,281455,10254,9174,221,9395,69
2020-12-22,San Mateo,081,765935,23953,21382,79,21461,186
2020-12-22,Santa Barbara,083,443738,16499,15189,416,15605,150
2020-12-22,Santa Clara,085,1922200,66220,59192,258,59450,569
2020-12-22,Santa Cruz,087,273765,8655,7471,250,7721,72
2020-12-22,Shasta,089,179085,7838,7371,615,7986,64
2020-12-22,Sierra,091,2930,27,23,0,23,0
2020-12-22,Siskiyou,093,43540,972,880,84,964,2
2020-12-22,Solano,095,438530,17985,16229,176,16405,95
2020-12-22,Sonoma,097,501317,18292,17216,101,17317,180
2020-12-22,Stanislaus,099,539301,33387,30914,2852,33766,499
2020-12-22,Sutter,101,95872,6206,5791,40,5831,46
2020-12-22,Tehama,103,63373,2891,2688,244,2932,9
2020-12-22,Trinity,105,12862,406,231,53,284,2
2020-12-22,Tulare,107,460477,32451,30025,3325,33350,377
2020-12-22,Tuolumne,109,53932,2661,2526,13,2539,12
2020-12-22,Ventura,111,848112,36983,32488,1432,33920,213
2020-12-22,Yolo,113,214977,8159,7388,53,7441,113
2020-12-22,Yuba,115,75493,3641,3379,34,3413,14
2020-12-21,Alameda,001,1643700,48613,44756,777,45533,518
2020-12-21,Alpine,003,1148,65,64,0,64,0
2020-12-21,Amador,005,37829,2224,1815,17,1832,23
2020-12-21,Butte,007,227075,7066,6335,730,7065,81
2020-12-21,Calaveras,009,45235,1032,963,0,963,21
2020-12-21,Colusa,011,21464,1211,1135,59,1194,7
2020-12-21,Contra Costa,013,1133247,37679,35207,425,35632,300
2020-12-21,Del Norte,015,27424,712,660,2,662,2
2020-12-21,El Dorado,017,186661,5641,4805,235,5040,10
2020-12-21,Fresno,019,978130,63983,58568,3889,62457,634
2020-12-21,Glenn,021,27897,1445,1323,203,1526,9
2020-12-21,Humboldt,023,135768,1584,1419,7,1426,16
2020-12-21,Imperial,025,180216,22069,20994,1006,22000,395
2020-12-21,Inyo,027,18085,600,482,7,489,17
2020-12-21,Kern,029,883053,62089,56836,4133,60969,541
2020-12-21,Kings,031,150075,15643,14760,453,15213,100
2020-12-21,Lake,033,64148,1759,1538,0,1538,20
2020-12-21,Lassen,035,31185,4010,3798,37,3835,1
2020-12-21,Los Angeles,037,10098052,694917,624129,17180,641309,8918
2020-12-21,Madera,039,155013,10008,9069,344,9413,63
2020-12-21,Marin,041,260295,9489,9035,63,9098,142
2020-12-21,Mariposa,043,17540,210,186,2,188,3
2020-12-21,Mendocino,045,87422,2267,2066,19,2085,23
2020-12-21,Merced,047,269075,17825,16710,274,16984,198
2020-12-21,Modoc,049,8938,219,181,66,247,0
2020-12-21,Mono,051,14174,847,781,11,792,3
2020-12-21,Monterey,053,433212,25510,23673,605,24278,174
2020-12-21,Napa,055,140530,5467,4952,25,4977,23
2020-12-21,Nevada,057,99092,2555,2337,84,2421,13
2020-12-21,Orange,059,3164182,146375,130444,5327,135771,1772
2020-12-21,Placer,061,380077,13336,11715,455,12170,105
2020-12-21,Plumas,063,18699,440,353,8,361,0
2020-12-21,Riverside,065,2383286,168119,151713,6861,158574,1743
2020-12-21,Sacramento,067,1510023,61272,57064,503,57567,759
2020-12-21,San Benito,069,59416,3280,2921,25,2946,22
2020-12-21,San Bernardino,071,2135413,182625,165086,4767,169853,1476
2020-12-21,San Diego,073,3302833,144474,129716,6384,136100,1284
2020-12-21,San Francisco,075,870044,22212,21086,188,21274,174
2020-12-21,San Joaquin,077,732212,42726,38811,1289,40100,586
2020-12-21,San Luis Obispo,079,281455,10065,9006,216,9222,64
2020-12-21,San Mateo,081,765935,23549,21035,76,21111,185
2020-12-21,Santa Barbara,083,443738,16225,14988,411,15399,149
2020-12-21,Santa Clara,085,1922200,65030,57699,246,57945,570
2020-12-21,Santa Cruz,087,273765,8448,7315,237,7552,69
2020-12-21,Shasta,089,179085,7773,7299,605,7904,64
2020-12-21,Sierra,091,2930,24,23,0,23,0
2020-12-21,Siskiyou,093,43540,965,878,83,961,2
2020-12-21,Solano,095,438530,17526,15878,171,16049,95
2020-12-21,Sonoma,097,501317,18019,17075,98,17173,176
2020-12-21,Stanislaus,099,539301,32930,30437,2776,33213,499
2020-12-21,Sutter,101,95872,6111,5708,40,5748,46
2020-12-21,Tehama,103,63373,2826,2656,235,2891,9
2020-12-21,Trinity,105,12862,404,226,51,277,2
2020-12-21,Tulare,107,460477,31966,29482,3234,32716,373
2020-12-21,Tuolumne,109,53932,2636,2423,11,2434,12
2020-12-21,Ventura,111,848112,35903,31759,1395,33154,212
2020-12-21,Yolo,113,214977,8020,7266,49,7315,109
2020-12-21,Yuba,115,75493,3583,3329,34,3363,14
2020-12-20,Alameda,001,1643700,47732,44004,756,44760,516
2020-12-20,Alpine,003,1148,65,64,0,64,0
2020-12-20,Amador,005,37829,2166,1771,17,1788,23
2020-12-20,Butte,007,227075,6919,6228,694,6922,81
2020-12-20,Calaveras,009,45235,1008,926,0,926,21
2020-12-20,Colusa,011,21464,1183,1121,53,1174,7
2020-12-20,Contra Costa,013,1133247,37078,34798,407,35205,301
2020-12-20,Del Norte,015,27424,690,652,2,654,2
2020-12-20,El Dorado,017,186661,5517,4697,226,4923,10
2020-12-20,Fresno,019,978130,62994,57616,3754,61370,634
2020-12-20,Glenn,021,27897,1436,1295,196,1491,9
2020-12-20,Humboldt,023,135768,1547,1386,6,1392,15
2020-12-20,Imperial,025,180216,21829,20882,904,21786,395
2020-12-20,Inyo,027,18085,584,476,7,483,17
2020-12-20,Kern,029,883053,60991,55983,3979,59962,540
2020-12-20,Kings,031,150075,15423,14629,437,15066,100
2020-12-20,Lake,033,64148,1717,1463,0,1463,20
2020-12-20,Lassen,035,31185,3956,3669,35,3704,1
2020-12-20,Los Angeles,037,10098052,676814,612975,16460,629435,8862
2020-12-20,Madera,039,155013,9799,8871,337,9208,63
2020-12-20,Marin,041,260295,9387,8948,60,9008,142
2020-12-20,Mariposa,043,17540,209,179,2,181,3
2020-12-20,Mendocino,045,87422,2242,2033,19,2052,23
2020-12-20,Merced,047,269075,17508,16435,267,16702,198
2020-12-20,Modoc,049,8938,219,181,64,245,0
2020-12-20,Mono,051,14174,829,774,11,785,3
2020-12-20,Monterey,053,433212,25027,23250,567,23817,173
2020-12-20,Napa,055,140530,5346,4865,23,4888,23
2020-12-20,Nevada,057,99092,2509,2289,78,2367,13
2020-12-20,Orange,059,3164182,142878,128780,5179,133959,1763
2020-12-20,Placer,061,380077,13111,11496,437,11933,105
2020-12-20,Plumas,063,18699,432,347,8,355,0
2020-12-20,Riverside,065,2383286,163912,148714,6574,155288,1742
2020-12-20,Sacramento,067,1510023,60273,56017,483,56500,755
2020-12-20,San Benito,069,59416,3208,2885,24,2909,21
2020-12-20,San Bernardino,071,2135413,177619,162810,4611,167421,1458
2020-12-20,San Diego,073,3302833,140756,126465,6214,132679,1280
2020-12-20,San Francisco,075,870044,21895,20937,185,21122,174
2020-12-20,San Joaquin,077,732212,41877,38268,1229,39497,587
2020-12-20,San Luis Obispo,079,281455,9773,8881,210,9091,63
2020-12-20,San Mateo,081,765935,23115,20764,72,20836,185
2020-12-20,Santa Barbara,083,443738,15903,14817,393,15210,148
2020-12-20,Santa Clara,085,1922200,63633,56860,240,57100,566
2020-12-20,Santa Cruz,087,273765,8238,7178,224,7402,69
2020-12-20,Shasta,089,179085,7659,7256,591,7847,64
2020-12-20,Sierra,091,2930,24,22,0,22,0
2020-12-20,Siskiyou,093,43540,956,870,82,952,2
2020-12-20,Solano,095,438530,17143,15533,160,15693,95
2020-12-20,Sonoma,097,501317,17743,16802,97,16899,175
2020-12-20,Stanislaus,099,539301,32400,29995,2676,32671,498
2020-12-20,Sutter,101,95872,6024,5601,40,5641,43
2020-12-20,Tehama,103,63373,2778,2602,216,2818,9
2020-12-20,Trinity,105,12862,396,221,50,271,2
2020-12-20,Tulare,107,460477,31450,29078,3142,32220,373
2020-12-20,Tuolumne,109,53932,2528,2152,10,2162,12
2020-12-20,Ventura,111,848112,35202,31335,1363,32698,210
2020-12-20,Yolo,113,214977,7867,7121,46,7167,109
2020-12-20,Yuba,115,75493,3533,3254,32,3286,12
2020-12-19,Alameda,001,1643700,47286,43109,749,43858,516
2020-12-19,Alpine,003,1148,65,64,0,64,0
2020-12-19,Amador,005,37829,2142,1754,17,1771,23
2020-12-19,Butte,007,227075,6819,6118,672,6790,81
2020-12-19,Calaveras,009,45235,991,900,0,900,21
2020-12-19,Colusa,011,21464,1175,1096,50,1146,7
2020-12-19,Contra Costa,013,1133247,36749,34321,393,34714,301
2020-12-19,Del Norte,015,27424,688,641,1,642,2
2020-12-19,El Dorado,017,186661,5450,4588,218,4806,10
2020-12-19,Fresno,019,978130,62669,55428,3688,59116,634
2020-12-19,Glenn,021,27897,1401,1286,195,1481,9
2020-12-19,Humboldt,023,135768,1530,1357,6,1363,15
2020-12-19,Imperial,025,180216,21735,20711,858,21569,395
2020-12-19,Inyo,027,18085,577,475,7,482,17
2020-12-19,Kern,029,883053,60506,55118,3873,58991,540
2020-12-19,Kings,031,150075,15344,14474,435,14909,100
2020-12-19,Lake,033,64148,1677,1438,0,1438,20
2020-12-19,Lassen,035,31185,3928,3595,35,3630,1
2020-12-19,Los Angeles,037,10098052,669693,599888,15935,615823,8804
2020-12-19,Madera,039,155013,9698,8717,325,9042,63
2020-12-19,Marin,041,260295,9347,8864,60,8924,142
2020-12-19,Mariposa,043,17540,207,177,2,179,3
2020-12-19,Mendocino,045,87422,2217,2008,19,2027,23
2020-12-19,Merced,047,269075,17369,16230,259,16489,198
2020-12-19,Modoc,049,8938,216,181,64,245,0
2020-12-19,Mono,051,14174,822,766,11,777,3
2020-12-19,Monterey,053,433212,24913,22799,562,23361,172
2020-12-19,Napa,055,140530,5284,4772,23,4795,23
2020-12-19,Nevada,057,99092,2487,2260,78,2338,13
2020-12-19,Orange,059,3164182,140956,125574,5031,130605,1733
2020-12-19,Placer,061,380077,12956,11246,431,11677,105
2020-12-19,Plumas,063,18699,429,343,8,351,0
2020-12-19,Riverside,065,2383286,161925,146703,6343,153046,1737
2020-12-19,Sacramento,067,1510023,59739,55169,469,55638,746
2020-12-19,San Benito,069,59416,3162,2820,23,2843,21
2020-12-19,San Bernardino,071,2135413,176038,159883,4502,164385,1433
2020-12-19,San Diego,073,3302833,138989,122972,6075,129047,1280
2020-12-19,San Francisco,075,870044,21740,20643,185,20828,174
2020-12-19,San Joaquin,077,732212,41474,37340,1181,38521,586
2020-12-19,San Luis Obispo,079,281455,9702,8788,207,8995,63
2020-12-19,San Mateo,081,765935,22906,20393,65,20458,182
2020-12-19,Santa Barbara,083,443738,15747,14667,387,15054,148
2020-12-19,Santa Clara,085,1922200,62783,55540,236,55776,558
2020-12-19,Santa Cruz,087,273765,8132,7054,220,7274,68
2020-12-19,Shasta,089,179085,7607,7221,579,7800,63
2020-12-19,Sierra,091,2930,24,23,0,23,0
2020-12-19,Siskiyou,093,43540,952,853,81,934,2
2020-12-19,Solano,095,438530,16965,15204,157,15361,95
2020-12-19,Sonoma,097,501317,17634,16553,97,16650,175
2020-12-19,Stanislaus,099,539301,32073,29555,2604,32159,498
2020-12-19,Sutter,101,95872,5968,5506,40,5546,41
2020-12-19,Tehama,103,63373,2729,2574,214,2788,9
2020-12-19,Trinity,105,12862,395,219,50,269,2
2020-12-19,Tulare,107,460477,31211,28734,3076,31810,375
2020-12-19,Tuolumne,109,53932,2515,2107,10,2117,12
2020-12-19,Ventura,111,848112,34921,30843,1333,32176,209
2020-12-19,Yolo,113,214977,7792,7025,45,7070,109
2020-12-19,Yuba,115,75493,3503,3168,32,3200,11
2020-12-18,Alameda,001,1643700,46751,42196,733,42929,515
2020-12-18,Alpine,003,1148,65,64,0,64,0
2020-12-18,Amador,005,37829,2125,1727,15,1742,20
2020-12-18,Butte,007,227075,6734,5891,646,6537,81
2020-12-18,Calaveras,009,45235,981,870,0,870,21
2020-12-18,Colusa,011,21464,1166,1068,50,1118,7
2020-12-18,Contra Costa,013,1133247,36457,33610,382,33992,300
2020-12-18,Del Norte,015,27424,683,627,0,627,2
2020-12-18,El Dorado,017,186661,5388,4494,209,4703,10
2020-12-18,Fresno,019,978130,61842,52643,3627,56270,613
2020-12-18,Glenn,021,27897,1384,1264,190,1454,9
2020-12-18,Humboldt,023,135768,1515,1331,6,1337,15
2020-12-18,Imperial,025,180216,21652,20430,812,21242,393
2020-12-18,Inyo,027,18085,558,454,7,461,17
2020-12-18,Kern,029,883053,59846,54220,3788,58008,533
2020-12-18,Kings,031,150075,15218,14284,429,14713,98
2020-12-18,Lake,033,64148,1661,1397,0,1397,20
2020-12-18,Lassen,035,31185,3920,3486,35,3521,1
2020-12-18,Los Angeles,037,10098052,657541,586413,15450,601863,8744
2020-12-18,Madera,039,155013,9594,8609,319,8928,63
2020-12-18,Marin,041,260295,9263,8799,60,8859,142
2020-12-18,Mariposa,043,17540,204,176,2,178,3
2020-12-18,Mendocino,045,87422,2199,1977,19,1996,24
2020-12-18,Merced,047,269075,17288,15956,257,16213,195
2020-12-18,Modoc,049,8938,216,179,64,243,0
2020-12-18,Mono,051,14174,814,731,11,742,3
2020-12-18,Monterey,053,433212,24620,22336,557,22893,165
2020-12-18,Napa,055,140530,5235,4688,23,4711,23
2020-12-18,Nevada,057,99092,2470,2220,77,2297,13
2020-12-18,Orange,059,3164182,138517,121681,4882,126563,1725
2020-12-18,Placer,061,380077,12785,10995,423,11418,104
2020-12-18,Plumas,063,18699,423,336,8,344,0
2020-12-18,Riverside,065,2383286,159087,142375,6081,148456,1733
2020-12-18,Sacramento,067,1510023,59113,53980,453,54433,736
2020-12-18,San Benito,069,59416,3113,2744,23,2767,21
2020-12-18,San Bernardino,071,2135413,173736,154272,4368,158640,1430
2020-12-18,San Diego,073,3302833,136811,120463,5936,126399,1253
2020-12-18,San Francisco,075,870044,21573,20315,179,20494,173
2020-12-18,San Joaquin,077,732212,41118,36484,1152,37636,559
2020-12-18,San Luis Obispo,079,281455,9604,8598,202,8800,62
2020-12-18,San Mateo,081,765935,22593,19971,61,20032,182
2020-12-18,Santa Barbara,083,443738,15606,14361,374,14735,148
2020-12-18,Santa Clara,085,1922200,61887,53992,227,54219,539
2020-12-18,Santa Cruz,087,273765,8013,6838,212,7050,68
2020-12-18,Shasta,089,179085,7569,7114,568,7682,62
2020-12-18,Sierra,091,2930,24,23,0,23,0
2020-12-18,Siskiyou,093,43540,950,840,81,921,2
2020-12-18,Solano,095,438530,16808,14667,153,14820,95
2020-12-18,Sonoma,097,501317,17514,16261,97,16358,173
2020-12-18,Stanislaus,099,539301,31797,28967,2567,31534,490
2020-12-18,Sutter,101,95872,5884,5399,40,5439,39
2020-12-18,Tehama,103,63373,2714,2523,204,2727,9
2020-12-18,Trinity,105,12862,394,215,50,265,2
2020-12-18,Tulare,107,460477,30921,28322,2998,31320,370
2020-12-18,Tuolumne,109,53932,2504,2067,10,2077,12
2020-12-18,Ventura,111,848112,34417,29907,1290,31197,209
2020-12-18,Yolo,113,214977,7723,6901,44,6945,109
2020-12-18,Yuba,115,75493,3443,3097,32,3129,11
2020-12-17,Alameda,001,1643700,45943,41548,708,42256,508
2020-12-17,Alpine,003,1148,65,64,0,64,0
2020-12-17,Amador,005,37829,2077,1703,13,1716,19
2020-12-17,Butte,007,227075,6608,5746,628,6374,78
2020-12-17,Calaveras,009,45235,958,848,0,848,21
2020-12-17,Colusa,011,21464,1155,1053,48,1101,7
2020-12-17,Contra Costa,013,1133247,35924,33006,352,33358,293
2020-12-17,Del Norte,015,27424,678,583,0,583,1
2020-12-17,El Dorado,017,186661,5242,4327,196,4523,9
2020-12-17,Fresno,019,978130,60982,49918,3501,53419,597
2020-12-17,Glenn,021,27897,1360,1244,183,1427,9
2020-12-17,Humboldt,023,135768,1482,1322,6,1328,14
2020-12-17,Imperial,025,180216,21490,20208,746,20954,391
2020-12-17,Inyo,027,18085,540,450,6,456,16
2020-12-17,Kern,029,883053,58889,53683,3653,57336,526
2020-12-17,Kings,031,150075,15115,14057,414,14471,98
2020-12-17,Lake,033,64148,1632,1374,0,1374,20
2020-12-17,Lassen,035,31185,3884,3417,35,3452,1
2020-12-17,Los Angeles,037,10098052,641873,571093,14908,586001,8657
2020-12-17,Madera,039,155013,9473,8465,315,8780,62
2020-12-17,Marin,041,260295,9201,8721,58,8779,142
2020-12-17,Mariposa,043,17540,200,172,2,174,3
2020-12-17,Mendocino,045,87422,2165,1942,19,1961,23
2020-12-17,Merced,047,269075,17026,15648,249,15897,192
2020-12-17,Modoc,049,8938,213,179,64,243,0
2020-12-17,Mono,051,14174,800,718,11,729,3
2020-12-17,Monterey,053,433212,24101,21951,542,22493,163
2020-12-17,Napa,055,140530,5123,4612,23,4635,23
2020-12-17,Nevada,057,99092,2429,2173,74,2247,13
2020-12-17,Orange,059,3164182,135146,118367,4750,123117,1725
2020-12-17,Placer,061,380077,12511,10756,409,11165,99
2020-12-17,Plumas,063,18699,414,324,8,332,0
2020-12-17,Riverside,065,2383286,155209,139325,5867,145192,1696
2020-12-17,Sacramento,067,1510023,58206,53189,431,53620,721
2020-12-17,San Benito,069,59416,3044,2645,22,2667,20
2020-12-17,San Bernardino,071,2135413,169794,149838,4253,154091,1425
2020-12-17,San Diego,073,3302833,134010,116852,5780,122632,1239
2020-12-17,San Francisco,075,870044,21284,19939,174,20113,170
2020-12-17,San Joaquin,077,732212,40390,35894,1118,37012,554
2020-12-17,San Luis Obispo,079,281455,9485,8365,201,8566,59
2020-12-17,San Mateo,081,765935,22223,19647,61,19708,181
2020-12-17,Santa Barbara,083,443738,15373,14207,367,14574,147
2020-12-17,Santa Clara,085,1922200,60697,52559,221,52780,527
2020-12-17,Santa Cruz,087,273765,7857,6687,199,6886,64
2020-12-17,Shasta,089,179085,7492,7000,549,7549,62
2020-12-17,Sierra,091,2930,23,23,0,23,0
2020-12-17,Siskiyou,093,43540,942,827,80,907,2
2020-12-17,Solano,095,438530,16495,14361,150,14511,96
2020-12-17,Sonoma,097,501317,17242,15993,96,16089,171
2020-12-17,Stanislaus,099,539301,31377,28582,2507,31089,489
2020-12-17,Sutter,101,95872,5786,5309,38,5347,39
2020-12-17,Tehama,103,63373,2665,2480,198,2678,9
2020-12-17,Trinity,105,12862,389,213,50,263,2
2020-12-17,Tulare,107,460477,30522,27852,2919,30771,358
2020-12-17,Tuolumne,109,53932,2212,1992,10,2002,11
2020-12-17,Ventura,111,848112,33807,29404,1254,30658,208
2020-12-17,Yolo,113,214977,7602,6800,43,6843,105
2020-12-17,Yuba,115,75493,3383,3035,31,3066,12
2020-12-16,Alameda,001,1643700,45090,40751,684,41435,497
2020-12-16,Alpine,003,1148,65,64,0,64,0
2020-12-16,Amador,005,37829,2030,1693,12,1705,19
2020-12-16,Butte,007,227075,6419,5659,600,6259,76
2020-12-16,Calaveras,009,45235,923,821,0,821,21
2020-12-16,Colusa,011,21464,1142,1038,45,1083,7
2020-12-16,Contra Costa,013,1133247,35366,32429,333,32762,293
2020-12-16,Del Norte,015,27424,676,575,0,575,1
2020-12-16,El Dorado,017,186661,5121,4237,187,4424,9
2020-12-16,Fresno,019,978130,60025,49173,3405,52578,584
2020-12-16,Glenn,021,27897,1342,1236,172,1408,9
2020-12-16,Humboldt,023,135768,1450,1308,5,1313,12
2020-12-16,Imperial,025,180216,21308,19980,682,20662,388
2020-12-16,Inyo,027,18085,527,444,6,450,16
2020-12-16,Kern,029,883053,58012,52896,3524,56420,522
2020-12-16,Kings,031,150075,14935,13734,398,14132,99
2020-12-16,Lake,033,64148,1593,1363,0,1363,20
2020-12-16,Lassen,035,31185,3851,3396,34,3430,1
2020-12-16,Los Angeles,037,10098052,625330,557907,14239,572146,8561
2020-12-16,Madera,039,155013,9347,8278,307,8585,62
2020-12-16,Marin,041,260295,9130,8641,58,8699,142
2020-12-16,Mariposa,043,17540,197,175,2,177,3
2020-12-16,Mendocino,045,87422,2130,1929,19,1948,23
2020-12-16,Merced,047,269075,16741,15443,246,15689,190
2020-12-16,Modoc,049,8938,210,178,64,242,0
2020-12-16,Mono,051,14174,781,702,11,713,3
2020-12-16,Monterey,053,433212,23541,21107,531,21638,163
2020-12-16,Napa,055,140530,5026,4544,23,4567,23
2020-12-16,Nevada,057,99092,2393,2149,72,2221,13
2020-12-16,Orange,059,3164182,131673,115260,4585,119845,1712
2020-12-16,Placer,061,380077,12274,10554,388,10942,96
2020-12-16,Plumas,063,18699,405,319,8,327,0
2020-12-16,Riverside,065,2383286,151091,135751,5622,141373,1664
2020-12-16,Sacramento,067,1510023,57234,52166,406,52572,715
2020-12-16,San Benito,069,59416,2954,2582,22,2604,20
2020-12-16,San Bernardino,071,2135413,165185,143565,4119,147684,1403
2020-12-16,San Diego,073,3302833,130906,114248,5626,119874,1217
2020-12-16,San Francisco,075,870044,21026,19624,174,19798,170
2020-12-16,San Joaquin,077,732212,39568,35010,1078,36088,547
2020-12-16,San Luis Obispo,079,281455,9290,8252,192,8444,58
2020-12-16,San Mateo,081,765935,21898,19292,57,19349,179
2020-12-16,Santa Barbara,083,443738,15122,13966,355,14321,144
2020-12-16,Santa Clara,085,1922200,59446,51502,218,51720,523
2020-12-16,Santa Cruz,087,273765,7669,6536,188,6724,63
2020-12-16,Shasta,089,179085,7419,6914,526,7440,62
2020-12-16,Sierra,091,2930,23,23,0,23,0
2020-12-16,Siskiyou,093,43540,934,818,80,898,2
2020-12-16,Solano,095,438530,16024,14157,146,14303,96
2020-12-16,Sonoma,097,501317,16987,15768,96,15864,170
2020-12-16,Stanislaus,099,539301,30884,28279,2436,30715,489
2020-12-16,Sutter,101,95872,5707,5223,38,5261,39
2020-12-16,Tehama,103,63373,2631,2441,174,2615,9
2020-12-16,Trinity,105,12862,383,212,50,262,2
2020-12-16,Tulare,107,460477,30095,27500,2829,30329,352
2020-12-16,Tuolumne,109,53932,2169,1941,10,1951,11
2020-12-16,Ventura,111,848112,33034,28566,1212,29778,203
2020-12-16,Yolo,113,214977,7475,6649,42,6691,103
2020-12-16,Yuba,115,75493,3296,2980,30,3010,11
2020-12-15,Alameda,001,1643700,44235,40026,663,40689,492
2020-12-15,Alpine,003,1148,65,64,0,64,0
2020-12-15,Amador,005,37829,1917,1669,10,1679,19
2020-12-15,Butte,007,227075,6280,5565,572,6137,75
2020-12-15,Calaveras,009,45235,891,799,0,799,21
2020-12-15,Colusa,011,21464,1129,1026,44,1070,7
2020-12-15,Contra Costa,013,1133247,34712,31423,319,31742,281
2020-12-15,Del Norte,015,27424,669,564,0,564,1
2020-12-15,El Dorado,017,186661,5013,4113,173,4286,9
2020-12-15,Fresno,019,978130,58653,47316,3271,50587,574
2020-12-15,Glenn,021,27897,1329,1207,156,1363,9
2020-12-15,Humboldt,023,135768,1430,1276,5,1281,12
2020-12-15,Imperial,025,180216,21083,19756,604,20360,380
2020-12-15,Inyo,027,18085,515,394,6,400,16
2020-12-15,Kern,029,883053,57001,52002,3418,55420,511
2020-12-15,Kings,031,150075,14771,13652,379,14031,97
2020-12-15,Lake,033,64148,1567,1341,0,1341,21
2020-12-15,Lassen,035,31185,3679,3378,33,3411,1
2020-12-15,Los Angeles,037,10098052,608932,536258,13608,549866,8429
2020-12-15,Madera,039,155013,9190,8118,300,8418,60
2020-12-15,Marin,041,260295,9025,8528,57,8585,141
2020-12-15,Mariposa,043,17540,193,171,2,173,3
2020-12-15,Mendocino,045,87422,2103,1883,19,1902,24
2020-12-15,Merced,047,269075,16445,15120,242,15362,190
2020-12-15,Modoc,049,8938,208,179,64,243,0
2020-12-15,Mono,051,14174,765,702,11,713,3
2020-12-15,Monterey,053,433212,22943,19905,470,20375,161
2020-12-15,Napa,055,140530,4923,4440,23,4463,23
2020-12-15,Nevada,057,99092,2360,2117,70,2187,11
2020-12-15,Orange,059,3164182,128031,112893,4436,117329,1689
2020-12-15,Placer,061,380077,12040,10301,366,10667,95
2020-12-15,Plumas,063,18699,400,313,8,321,0
2020-12-15,Riverside,065,2383286,147041,131822,5347,137169,1624
2020-12-15,Sacramento,067,1510023,56218,51076,393,51469,703
2020-12-15,San Benito,069,59416,2875,2520,21,2541,19
2020-12-15,San Bernardino,071,2135413,160724,137548,3969,141517,1351
2020-12-15,San Diego,073,3302833,127339,111441,5463,116904,1194
2020-12-15,San Francisco,075,870044,20717,19283,171,19454,171
2020-12-15,San Joaquin,077,732212,38646,33849,1044,34893,537
2020-12-15,San Luis Obispo,079,281455,9181,8074,189,8263,55
2020-12-15,San Mateo,081,765935,21489,18907,55,18962,178
2020-12-15,Santa Barbara,083,443738,14896,13782,347,14129,144
2020-12-15,Santa Clara,085,1922200,58017,50311,215,50526,505
2020-12-15,Santa Cruz,087,273765,7482,6361,175,6536,59
2020-12-15,Shasta,089,179085,7360,6794,501,7295,54
2020-12-15,Sierra,091,2930,23,23,0,23,0
2020-12-15,Siskiyou,093,43540,926,812,79,891,2
2020-12-15,Solano,095,438530,15670,13796,146,13942,95
2020-12-15,Sonoma,097,501317,16766,15406,96,15502,167
2020-12-15,Stanislaus,099,539301,30387,27823,2357,30180,485
2020-12-15,Sutter,101,95872,5609,5080,37,5117,36
2020-12-15,Tehama,103,63373,2593,2392,168,2560,9
2020-12-15,Trinity,105,12862,375,213,48,261,1
2020-12-15,Tulare,107,460477,29597,27026,2741,29767,342
2020-12-15,Tuolumne,109,53932,2139,1874,10,1884,8
2020-12-15,Ventura,111,848112,32412,27936,1165,29101,201
2020-12-15,Yolo,113,214977,7350,6531,40,6571,104
2020-12-15,Yuba,115,75493,3201,2891,29,2920,11
2020-12-14,Alameda,001,1643700,43334,39252,644,39896,487
2020-12-14,Alpine,003,1148,65,63,0,63,0
2020-12-14,Amador,005,37829,1845,1609,10,1619,19
2020-12-14,Butte,007,227075,6112,5202,555,5757,75
2020-12-14,Calaveras,009,45235,853,718,0,718,21
2020-12-14,Colusa,011,21464,1105,949,43,992,7
2020-12-14,Contra Costa,013,1133247,34023,30594,305,30899,281
2020-12-14,Del Norte,015,27424,663,560,0,560,1
2020-12-14,El Dorado,017,186661,4857,4018,157,4175,9
2020-12-14,Fresno,019,978130,57632,44726,3097,47823,560
2020-12-14,Glenn,021,27897,1303,1186,148,1334,9
2020-12-14,Humboldt,023,135768,1417,1256,5,1261,9
2020-12-14,Imperial,025,180216,20844,19608,530,20138,379
2020-12-14,Inyo,027,18085,502,382,6,388,16
2020-12-14,Kern,029,883053,55964,50538,3297,53835,510
2020-12-14,Kings,031,150075,14586,13491,352,13843,97
2020-12-14,Lake,033,64148,1515,1301,0,1301,21
2020-12-14,Lassen,035,31185,3581,2905,30,2935,1
2020-12-14,Los Angeles,037,10098052,591301,524668,12979,537647,8340
2020-12-14,Madera,039,155013,8925,8011,291,8302,60
2020-12-14,Marin,041,260295,8938,8475,56,8531,141
2020-12-14,Mariposa,043,17540,192,171,2,173,3
2020-12-14,Mendocino,045,87422,2082,1845,19,1864,24
2020-12-14,Merced,047,269075,16039,14572,228,14800,189
2020-12-14,Modoc,049,8938,202,180,62,242,0
2020-12-14,Mono,051,14174,757,685,11,696,3
2020-12-14,Monterey,053,433212,22421,19154,464,19618,155
2020-12-14,Napa,055,140530,4830,4289,23,4312,22
2020-12-14,Nevada,057,99092,2323,2070,67,2137,11
2020-12-14,Orange,059,3164182,124147,108602,4300,112902,1688
2020-12-14,Placer,061,380077,11759,9551,355,9906,95
2020-12-14,Plumas,063,18699,388,309,8,317,0
2020-12-14,Riverside,065,2383286,142919,123715,5085,128800,1588
2020-12-14,Sacramento,067,1510023,55111,50304,368,50672,691
2020-12-14,San Benito,069,59416,2809,2467,20,2487,19
2020-12-14,San Bernardino,071,2135413,156275,129151,3841,132992,1347
2020-12-14,San Diego,073,3302833,123603,109578,5278,114856,1162
2020-12-14,San Francisco,075,870044,20347,18904,169,19073,171
2020-12-14,San Joaquin,077,732212,37810,32522,998,33520,534
2020-12-14,San Luis Obispo,079,281455,8935,7791,185,7976,52
2020-12-14,San Mateo,081,765935,20992,18361,52,18413,178
2020-12-14,Santa Barbara,083,443738,14623,13587,339,13926,144
2020-12-14,Santa Clara,085,1922200,56501,49180,204,49384,502
2020-12-14,Santa Cruz,087,273765,7300,6049,160,6209,54
2020-12-14,Shasta,089,179085,7271,6665,483,7148,54
2020-12-14,Sierra,091,2930,23,21,0,21,0
2020-12-14,Siskiyou,093,43540,903,764,73,837,2
2020-12-14,Solano,095,438530,15314,13352,145,13497,93
2020-12-14,Sonoma,097,501317,16459,14807,95,14902,167
2020-12-14,Stanislaus,099,539301,29858,27311,2309,29620,485
2020-12-14,Sutter,101,95872,5505,5001,30,5031,35
2020-12-14,Tehama,103,63373,2551,2344,165,2509,9
2020-12-14,Trinity,105,12862,371,205,46,251,1
2020-12-14,Tulare,107,460477,29118,25735,2649,28384,341
2020-12-14,Tuolumne,109,53932,2086,1647,10,1657,8
2020-12-14,Ventura,111,848112,31489,27436,1107,28543,202
2020-12-14,Yolo,113,214977,7192,6389,39,6428,95
2020-12-14,Yuba,115,75493,3138,2851,29,2880,11
2020-12-13,Alameda,001,1643700,42132,38064,620,38684,486
2020-12-13,Alpine,003,1148,65,63,0,63,0
2020-12-13,Amador,005,37829,1789,1457,9,1466,19
2020-12-13,Butte,007,227075,5964,5103,517,5620,75
2020-12-13,Calaveras,009,45235,819,710,0,710,21
2020-12-13,Colusa,011,21464,1089,945,40,985,7
2020-12-13,Contra Costa,013,1133247,33294,29667,299,29966,281
2020-12-13,Del Norte,015,27424,611,542,0,542,1
2020-12-13,El Dorado,017,186661,4756,3770,148,3918,9
2020-12-13,Fresno,019,978130,56525,44114,2942,47056,559
2020-12-13,Glenn,021,27897,1290,1171,137,1308,9
2020-12-13,Humboldt,023,135768,1394,1238,4,1242,9
2020-12-13,Imperial,025,180216,20560,19472,410,19882,379
2020-12-13,Inyo,027,18085,481,380,6,386,16
2020-12-13,Kern,029,883053,54935,49051,3143,52194,510
2020-12-13,Kings,031,150075,14306,13357,334,13691,97
2020-12-13,Lake,033,64148,1474,1271,0,1271,21
2020-12-13,Lassen,035,31185,3474,2867,25,2892,1
2020-12-13,Los Angeles,037,10098052,573670,517472,12289,529761,8294
2020-12-13,Madera,039,155013,8738,7909,278,8187,60
2020-12-13,Marin,041,260295,8818,8409,56,8465,141
2020-12-13,Mariposa,043,17540,188,167,2,169,3
2020-12-13,Mendocino,045,87422,2048,1793,19,1812,24
2020-12-13,Merced,047,269075,15687,14384,225,14609,189
2020-12-13,Modoc,049,8938,192,179,57,236,0
2020-12-13,Mono,051,14174,741,675,11,686,3
2020-12-13,Monterey,053,433212,22000,18913,450,19363,153
2020-12-13,Napa,055,140530,4724,4194,23,4217,22
2020-12-13,Nevada,057,99092,2276,2030,65,2095,11
2020-12-13,Orange,059,3164182,120218,104768,4127,108895,1688
2020-12-13,Placer,061,380077,11445,9405,337,9742,95
2020-12-13,Plumas,063,18699,382,291,8,299,0
2020-12-13,Riverside,065,2383286,138793,119691,4825,124516,1581
2020-12-13,Sacramento,067,1510023,53842,49480,340,49820,682
2020-12-13,San Benito,069,59416,2740,2408,19,2427,19
2020-12-13,San Bernardino,071,2135413,151375,126718,3686,130404,1333
2020-12-13,San Diego,073,3302833,120003,107372,5109,112481,1162
2020-12-13,San Francisco,075,870044,20007,18686,160,18846,167
2020-12-13,San Joaquin,077,732212,37006,32170,958,33128,534
2020-12-13,San Luis Obispo,079,281455,8744,7625,177,7802,52
2020-12-13,San Mateo,081,765935,20501,18090,46,18136,177
2020-12-13,Santa Barbara,083,443738,14354,13249,325,13574,144
2020-12-13,Santa Clara,085,1922200,55081,47920,196,48116,499
2020-12-13,Santa Cruz,087,273765,7052,5986,150,6136,54
2020-12-13,Shasta,089,179085,7197,6647,457,7104,54
2020-12-13,Sierra,091,2930,23,21,0,21,0
2020-12-13,Siskiyou,093,43540,890,762,68,830,2
2020-12-13,Solano,095,438530,14878,13276,142,13418,93
2020-12-13,Sonoma,097,501317,16145,14495,94,14589,167
2020-12-13,Stanislaus,099,539301,29298,26569,2249,28818,485
2020-12-13,Sutter,101,95872,5378,4798,26,4824,34
2020-12-13,Tehama,103,63373,2506,2325,150,2475,9
2020-12-13,Trinity,105,12862,365,204,46,250,1
2020-12-13,Tulare,107,460477,28630,25496,2564,28060,340
2020-12-13,Tuolumne,109,53932,2024,1611,10,1621,8
2020-12-13,Ventura,111,848112,30489,26588,1047,27635,202
2020-12-13,Yolo,113,214977,7006,6265,33,6298,95
2020-12-13,Yuba,115,75493,3075,2754,26,2780,11
2020-12-12,Alameda,001,1643700,41689,37027,601,37628,486
2020-12-12,Alpine,003,1148,65,63,0,63,0
2020-12-12,Amador,005,37829,1761,1236,8,1244,19
2020-12-12,Butte,007,227075,5891,4972,503,5475,73
2020-12-12,Calaveras,009,45235,809,708,0,708,21
2020-12-12,Colusa,011,21464,1069,945,39,984,7
2020-12-12,Contra Costa,013,1133247,32945,29506,290,29796,281
2020-12-12,Del Norte,015,27424,602,529,0,529,1
2020-12-12,El Dorado,017,186661,4681,3706,132,3838,9
2020-12-12,Fresno,019,978130,56174,43756,2883,46639,559
2020-12-12,Glenn,021,27897,1282,1143,133,1276,8
2020-12-12,Humboldt,023,135768,1375,1208,4,1212,9
2020-12-12,Imperial,025,180216,20471,18947,355,19302,379
2020-12-12,Inyo,027,18085,475,380,6,386,16
2020-12-12,Kern,029,883053,54415,48194,3056,51250,507
2020-12-12,Kings,031,150075,14217,13205,330,13535,96
2020-12-12,Lake,033,64148,1458,1232,0,1232,21
2020-12-12,Lassen,035,31185,3451,2866,22,2888,1
2020-12-12,Los Angeles,037,10098052,566858,504317,11793,516110,8269
2020-12-12,Madera,039,155013,8611,7765,275,8040,59
2020-12-12,Marin,041,260295,8763,8363,55,8418,141
2020-12-12,Mariposa,043,17540,187,164,2,166,3
2020-12-12,Mendocino,045,87422,2012,1771,19,1790,24
2020-12-12,Merced,047,269075,15595,14181,221,14402,188
2020-12-12,Modoc,049,8938,191,169,54,223,0
2020-12-12,Mono,051,14174,734,640,11,651,3
2020-12-12,Monterey,053,433212,21887,18596,421,19017,151
2020-12-12,Napa,055,140530,4679,4113,23,4136,22
2020-12-12,Nevada,057,99092,2258,1981,63,2044,10
2020-12-12,Orange,059,3164182,118329,100468,3982,104450,1674
2020-12-12,Placer,061,380077,11280,9390,332,9722,95
2020-12-12,Plumas,063,18699,376,291,8,299,0
2020-12-12,Riverside,065,2383286,136734,118335,4624,122959,1579
2020-12-12,Sacramento,067,1510023,53260,48319,327,48646,673
2020-12-12,San Benito,069,59416,2685,2355,19,2374,19
2020-12-12,San Bernardino,071,2135413,149741,125741,3584,129325,1321
2020-12-12,San Diego,073,3302833,118382,104958,5012,109970,1151
2020-12-12,San Francisco,075,870044,19812,18413,156,18569,167
2020-12-12,San Joaquin,077,732212,36677,32200,928,33128,534
2020-12-12,San Luis Obispo,079,281455,8645,7462,171,7633,50
2020-12-12,San Mateo,081,765935,20280,17574,45,17619,177
2020-12-12,Santa Barbara,083,443738,14202,13174,317,13491,144
2020-12-12,Santa Clara,085,1922200,54140,45892,193,46085,498
2020-12-12,Santa Cruz,087,273765,6953,5905,141,6046,54
2020-12-12,Shasta,089,179085,7164,6551,439,6990,54
2020-12-12,Sierra,091,2930,23,21,0,21,0
2020-12-12,Siskiyou,093,43540,888,762,65,827,2
2020-12-12,Solano,095,438530,14680,12748,135,12883,93
2020-12-12,Sonoma,097,501317,16024,14466,94,14560,166
2020-12-12,Stanislaus,099,539301,28989,26246,2200,28446,483
2020-12-12,Sutter,101,95872,5316,4717,26,4743,32
2020-12-12,Tehama,103,63373,2488,2252,145,2397,9
2020-12-12,Trinity,105,12862,363,204,44,248,1
2020-12-12,Tulare,107,460477,28365,25333,2507,27840,341
2020-12-12,Tuolumne,109,53932,1980,1536,10,1546,8
2020-12-12,Ventura,111,848112,30045,25955,1014,26969,202
2020-12-12,Yolo,113,214977,6923,6116,31,6147,95
2020-12-12,Yuba,115,75493,3048,2692,25,2717,10
2020-12-11,Alameda,001,1643700,41122,36281,589,36870,482
2020-12-11,Alpine,003,1148,65,63,0,63,0
2020-12-11,Amador,005,37829,1745,1213,8,1221,19
2020-12-11,Butte,007,227075,5818,4941,485,5426,73
2020-12-11,Calaveras,009,45235,793,697,0,697,21
2020-12-11,Colusa,011,21464,1059,923,37,960,7
2020-12-11,Contra Costa,013,1133247,32513,29036,286,29322,282
2020-12-11,Del Norte,015,27424,594,505,0,505,1
2020-12-11,El Dorado,017,186661,4600,3669,117,3786,9
2020-12-11,Fresno,019,978130,55161,43071,2817,45888,550
2020-12-11,Glenn,021,27897,1266,1135,129,1264,8
2020-12-11,Humboldt,023,135768,1357,1190,4,1194,9
2020-12-11,Imperial,025,180216,20379,18599,311,18910,377
2020-12-11,Inyo,027,18085,464,372,6,378,16
2020-12-11,Kern,029,883053,53737,47664,2993,50657,502
2020-12-11,Kings,031,150075,14073,13118,326,13444,94
2020-12-11,Lake,033,64148,1441,1205,0,1205,21
2020-12-11,Lassen,035,31185,3439,2790,21,2811,1
2020-12-11,Los Angeles,037,10098052,555047,493592,11383,504975,8198
2020-12-11,Madera,039,155013,8516,7648,265,7913,59
2020-12-11,Marin,041,260295,8670,8317,54,8371,141
2020-12-11,Mariposa,043,17540,186,164,2,166,3
2020-12-11,Mendocino,045,87422,1988,1769,19,1788,24
2020-12-11,Merced,047,269075,15475,14038,213,14251,186
2020-12-11,Modoc,049,8938,191,168,53,221,0
2020-12-11,Mono,051,14174,724,631,11,642,3
2020-12-11,Monterey,053,433212,21586,18421,416,18837,150
2020-12-11,Napa,055,140530,4624,4054,23,4077,22
2020-12-11,Nevada,057,99092,2241,1959,60,2019,10
2020-12-11,Orange,059,3164182,116013,98357,3881,102238,1656
2020-12-11,Placer,061,380077,11118,8904,316,9220,93
2020-12-11,Plumas,063,18699,368,286,8,294,0
2020-12-11,Riverside,065,2383286,133657,115329,4406,119735,1573
2020-12-11,Sacramento,067,1510023,52597,47468,319,47787,669
2020-12-11,San Benito,069,59416,2634,2319,19,2338,19
2020-12-11,San Bernardino,071,2135413,147043,123092,3471,126563,1313
2020-12-11,San Diego,073,3302833,116422,102468,4929,107397,1137
2020-12-11,San Francisco,075,870044,19580,18246,155,18401,165
2020-12-11,San Joaquin,077,732212,36326,32044,901,32945,534
2020-12-11,San Luis Obispo,079,281455,8484,7415,169,7584,49
2020-12-11,San Mateo,081,765935,20010,17240,34,17274,177
2020-12-11,Santa Barbara,083,443738,14059,12997,309,13306,144
2020-12-11,Santa Clara,085,1922200,53122,45101,184,45285,494
2020-12-11,Santa Cruz,087,273765,6833,5764,132,5896,50
2020-12-11,Shasta,089,179085,7119,6459,432,6891,54
2020-12-11,Sierra,091,2930,23,19,0,19,0
2020-12-11,Siskiyou,093,43540,881,753,62,815,2
2020-12-11,Solano,095,438530,14491,12554,131,12685,92
2020-12-11,Sonoma,097,501317,15857,14298,92,14390,166
2020-12-11,Stanislaus,099,539301,28712,25928,2155,28083,464
2020-12-11,Sutter,101,95872,5253,4600,25,4625,30
2020-12-11,Tehama,103,63373,2458,2232,141,2373,9
2020-12-11,Trinity,105,12862,360,204,44,248,1
2020-12-11,Tulare,107,460477,28002,24953,2457,27410,338
2020-12-11,Tuolumne,109,53932,1965,1510,10,1520,8
2020-12-11,Ventura,111,848112,29438,24999,992,25991,202
2020-12-11,Yolo,113,214977,6819,6006,30,6036,95
2020-12-11,Yuba,115,75493,2987,2649,23,2672,10
2020-12-10,Alameda,001,1643700,40353,35686,569,36255,477
2020-12-10,Alpine,003,1148,65,63,0,63,0
2020-12-10,Amador,005,37829,1688,1191,8,1199,18
2020-12-10,Butte,007,227075,5703,4863,460,5323,72
2020-12-10,Calaveras,009,45235,775,684,0,684,21
2020-12-10,Colusa,011,21464,1036,909,34,943,7
2020-12-10,Contra Costa,013,1133247,31831,28413,280,28693,276
2020-12-10,Del Norte,015,27424,583,501,0,501,1
2020-12-10,El Dorado,017,186661,4482,3557,112,3669,9
2020-12-10,Fresno,019,978130,54184,42461,2677,45138,540
2020-12-10,Glenn,021,27897,1246,1126,120,1246,8
2020-12-10,Humboldt,023,135768,1337,1140,4,1144,9
2020-12-10,Imperial,025,180216,20166,18333,236,18569,370
2020-12-10,Inyo,027,18085,443,365,6,371,15
2020-12-10,Kern,029,883053,52756,47176,2830,50006,499
2020-12-10,Kings,031,150075,13915,12993,320,13313,92
2020-12-10,Lake,033,64148,1400,1167,0,1167,21
2020-12-10,Lassen,035,31185,3417,2764,17,2781,0
2020-12-10,Los Angeles,037,10098052,541065,480354,10858,491212,8149
2020-12-10,Madera,039,155013,8406,7445,250,7695,59
2020-12-10,Marin,041,260295,8617,8245,53,8298,140
2020-12-10,Mariposa,043,17540,185,160,2,162,3
2020-12-10,Mendocino,045,87422,1962,1748,16,1764,24
2020-12-10,Merced,047,269075,15229,13756,210,13966,186
2020-12-10,Modoc,049,8938,186,165,51,216,0
2020-12-10,Mono,051,14174,719,601,11,612,3
2020-12-10,Monterey,053,433212,21104,18266,406,18672,145
2020-12-10,Napa,055,140530,4538,3974,22,3996,22
2020-12-10,Nevada,057,99092,2205,1919,60,1979,10
2020-12-10,Orange,059,3164182,112909,95297,3721,99018,1651
2020-12-10,Placer,061,380077,10865,8906,299,9205,90
2020-12-10,Plumas,063,18699,357,281,8,289,0
2020-12-10,Riverside,065,2383286,129966,112794,4139,116933,1552
2020-12-10,Sacramento,067,1510023,51696,46471,298,46769,664
2020-12-10,San Benito,069,59416,2573,2268,18,2286,19
2020-12-10,San Bernardino,071,2135413,142803,120186,3298,123484,1306
2020-12-10,San Diego,073,3302833,113897,99601,4780,104381,1114
2020-12-10,San Francisco,075,870044,19268,17945,148,18093,164
2020-12-10,San Joaquin,077,732212,35690,31228,872,32100,534
2020-12-10,San Luis Obispo,079,281455,8321,7245,158,7403,49
2020-12-10,San Mateo,081,765935,19568,16701,24,16725,177
2020-12-10,Santa Barbara,083,443738,13880,12788,301,13089,143
2020-12-10,Santa Clara,085,1922200,51955,43939,170,44109,491
2020-12-10,Santa Cruz,087,273765,6665,5645,120,5765,48
2020-12-10,Shasta,089,179085,7052,6312,407,6719,53
2020-12-10,Sierra,091,2930,23,18,0,18,0
2020-12-10,Siskiyou,093,43540,871,712,61,773,2
2020-12-10,Solano,095,438530,14123,12017,125,12142,90
2020-12-10,Sonoma,097,501317,15602,14282,90,14372,167
2020-12-10,Stanislaus,099,539301,28240,25582,2085,27667,464
2020-12-10,Sutter,101,95872,5123,4528,23,4551,27
2020-12-10,Tehama,103,63373,2414,2190,133,2323,9
2020-12-10,Trinity,105,12862,356,202,42,244,1
2020-12-10,Tulare,107,460477,27535,24506,2394,26900,337
2020-12-10,Tuolumne,109,53932,1723,1451,10,1461,8
2020-12-10,Ventura,111,848112,28588,24075,948,25023,202
2020-12-10,Yolo,113,214977,6697,5896,29,5925,95
2020-12-10,Yuba,115,75493,2923,2604,22,2626,10
2020-12-09,Alameda,001,1643700,39517,35047,548,35595,470
2020-12-09,Alpine,003,1148,65,58,0,58,0
2020-12-09,Amador,005,37829,1645,1121,8,1129,19
2020-12-09,Butte,007,227075,5560,4733,440,5173,70
2020-12-09,Calaveras,009,45235,746,670,0,670,21
2020-12-09,Colusa,011,21464,1021,896,33,929,7
2020-12-09,Contra Costa,013,1133247,31124,28308,269,28577,273
2020-12-09,Del Norte,015,27424,570,481,0,481,2
2020-12-09,El Dorado,017,186661,4347,3449,104,3553,8
2020-12-09,Fresno,019,978130,53184,41954,2524,44478,533
2020-12-09,Glenn,021,27897,1232,1107,114,1221,8
2020-12-09,Humboldt,023,135768,1305,1086,4,1090,10
2020-12-09,Imperial,025,180216,19909,17757,200,17957,368
2020-12-09,Inyo,027,18085,430,356,6,362,15
2020-12-09,Kern,029,883053,51599,46379,2688,49067,494
2020-12-09,Kings,031,150075,13770,12716,312,13028,92
2020-12-09,Lake,033,64148,1371,1158,0,1158,20
2020-12-09,Lassen,035,31185,3348,2331,15,2346,0
2020-12-09,Los Angeles,037,10098052,527563,467971,10321,478292,8075
2020-12-09,Madera,039,155013,8290,7216,247,7463,59
2020-12-09,Marin,041,260295,8553,8182,52,8234,138
2020-12-09,Mariposa,043,17540,183,154,2,156,3
2020-12-09,Mendocino,045,87422,1936,1703,15,1718,24
2020-12-09,Merced,047,269075,14988,13588,204,13792,183
2020-12-09,Modoc,049,8938,181,146,42,188,0
2020-12-09,Mono,051,14174,707,601,11,612,3
2020-12-09,Monterey,053,433212,20703,17891,398,18289,143
2020-12-09,Napa,055,140530,4452,3858,21,3879,21
2020-12-09,Nevada,057,99092,2152,1864,60,1924,10
2020-12-09,Orange,059,3164182,109819,93763,3553,97316,1629
2020-12-09,Placer,061,380077,10604,8588,285,8873,85
2020-12-09,Plumas,063,18699,349,271,8,279,0
2020-12-09,Riverside,065,2383286,126265,110376,3938,114314,1543
2020-12-09,Sacramento,067,1510023,50632,45284,273,45557,659
2020-12-09,San Benito,069,59416,2501,2217,16,2233,19
2020-12-09,San Bernardino,071,2135413,138522,114516,3102,117618,1305
2020-12-09,San Diego,073,3302833,110917,97551,4641,102192,1103
2020-12-09,San Francisco,075,870044,18964,17628,147,17775,163
2020-12-09,San Joaquin,077,732212,34872,30539,847,31386,531
2020-12-09,San Luis Obispo,079,281455,8103,7105,150,7255,47
2020-12-09,San Mateo,081,765935,19119,16422,23,16445,175
2020-12-09,Santa Barbara,083,443738,13680,12630,291,12921,142
2020-12-09,Santa Clara,085,1922200,50767,42912,155,43067,489
2020-12-09,Santa Cruz,087,273765,6504,5527,105,5632,47
2020-12-09,Shasta,089,179085,6987,6105,393,6498,52
2020-12-09,Sierra,091,2930,23,18,0,18,0
2020-12-09,Siskiyou,093,43540,860,713,60,773,2
2020-12-09,Solano,095,438530,13773,11862,117,11979,90
2020-12-09,Sonoma,097,501317,15346,13994,87,14081,164
2020-12-09,Stanislaus,099,539301,27741,25157,2024,27181,463
2020-12-09,Sutter,101,95872,5005,4418,19,4437,24
2020-12-09,Tehama,103,63373,2378,2102,129,2231,9
2020-12-09,Trinity,105,12862,348,199,39,238,0
2020-12-09,Tulare,107,460477,26929,24124,2317,26441,334
2020-12-09,Tuolumne,109,53932,1690,1319,10,1329,8
2020-12-09,Ventura,111,848112,27724,23830,906,24736,201
2020-12-09,Yolo,113,214977,6571,5760,27,5787,95
2020-12-09,Yuba,115,75493,2855,2513,21,2534,10
2020-12-08,Alameda,001,1643700,38615,34373,532,34905,469
2020-12-08,Alpine,003,1148,64,53,0,53,0
2020-12-08,Amador,005,37829,1359,1043,8,1051,17
2020-12-08,Butte,007,227075,5402,4651,401,5052,70
2020-12-08,Calaveras,009,45235,722,657,0,657,21
2020-12-08,Colusa,011,21464,1005,875,32,907,6
2020-12-08,Contra Costa,013,1133247,30419,27926,252,28178,270
2020-12-08,Del Norte,015,27424,554,465,0,465,2
2020-12-08,El Dorado,017,186661,4223,3296,91,3387,8
2020-12-08,Fresno,019,978130,51918,41574,2370,43944,529
2020-12-08,Glenn,021,27897,1212,1094,106,1200,8
2020-12-08,Humboldt,023,135768,1279,1059,4,1063,10
2020-12-08,Imperial,025,180216,19392,17568,193,17761,363
2020-12-08,Inyo,027,18085,406,333,6,339,15
2020-12-08,Kern,029,883053,50304,45116,2536,47652,487
2020-12-08,Kings,031,150075,13616,12623,303,12926,90
2020-12-08,Lake,033,64148,1327,1127,0,1127,20
2020-12-08,Lassen,035,31185,3192,2165,15,2180,0
2020-12-08,Los Angeles,037,10098052,514858,459738,9848,469586,8004
2020-12-08,Madera,039,155013,8158,7082,234,7316,59
2020-12-08,Marin,041,260295,8473,8099,51,8150,137
2020-12-08,Mariposa,043,17540,179,150,2,152,2
2020-12-08,Mendocino,045,87422,1894,1666,15,1681,23
2020-12-08,Merced,047,269075,14676,13380,203,13583,181
2020-12-08,Modoc,049,8938,173,138,39,177,0
2020-12-08,Mono,051,14174,693,597,11,608,3
2020-12-08,Monterey,053,433212,20132,17752,391,18143,134
2020-12-08,Napa,055,140530,4365,3778,19,3797,22
2020-12-08,Nevada,057,99092,2098,1809,57,1866,11
2020-12-08,Orange,059,3164182,106598,91406,3389,94795,1629
2020-12-08,Placer,061,380077,10336,8224,280,8504,82
2020-12-08,Plumas,063,18699,339,258,8,266,0
2020-12-08,Riverside,065,2383286,122898,107620,3761,111381,1514
2020-12-08,Sacramento,067,1510023,49567,44635,258,44893,649
2020-12-08,San Benito,069,59416,2447,2180,16,2196,18
2020-12-08,San Bernardino,071,2135413,134176,110676,2980,113656,1301
2020-12-08,San Diego,073,3302833,107546,95447,4484,99931,1088
2020-12-08,San Francisco,075,870044,18655,17384,145,17529,162
2020-12-08,San Joaquin,077,732212,33980,30225,814,31039,530
2020-12-08,San Luis Obispo,079,281455,7974,6903,139,7042,45
2020-12-08,San Mateo,081,765935,18720,16305,23,16328,175
2020-12-08,Santa Barbara,083,443738,13496,12516,282,12798,141
2020-12-08,Santa Clara,085,1922200,49439,41309,147,41456,484
2020-12-08,Santa Cruz,087,273765,6323,5374,103,5477,45
2020-12-08,Shasta,089,179085,6877,5946,385,6331,50
2020-12-08,Sierra,091,2930,22,18,0,18,0
2020-12-08,Siskiyou,093,43540,846,704,58,762,2
2020-12-08,Solano,095,438530,13367,11669,115,11784,89
2020-12-08,Sonoma,097,501317,15087,13601,86,13687,164
2020-12-08,Stanislaus,099,539301,27250,24793,1959,26752,461
2020-12-08,Sutter,101,95872,4909,4342,18,4360,24
2020-12-08,Tehama,103,63373,2304,2057,121,2178,9
2020-12-08,Trinity,105,12862,339,198,38,236,0
2020-12-08,Tulare,107,460477,26320,23607,2254,25861,330
2020-12-08,Tuolumne,109,53932,1666,1264,10,1274,7
2020-12-08,Ventura,111,848112,27061,23665,864,24529,195
2020-12-08,Yolo,113,214977,6439,5560,27,5587,90
2020-12-08,Yuba,115,75493,2777,2477,21,2498,10
2020-12-07,Alameda,001,1643700,37747,33887,498,34385,466
2020-12-07,Alpine,003,1148,63,53,0,53,0
2020-12-07,Amador,005,37829,1284,993,7,1000,17
2020-12-07,Butte,007,227075,5266,4604,380,4984,67
2020-12-07,Calaveras,009,45235,692,606,0,606,21
2020-12-07,Colusa,011,21464,980,825,27,852,6
2020-12-07,Contra Costa,013,1133247,29803,27307,239,27546,270
2020-12-07,Del Norte,015,27424,542,424,0,424,2
2020-12-07,El Dorado,017,186661,4044,3275,84,3359,8
2020-12-07,Fresno,019,978130,50444,41098,2249,43347,526
2020-12-07,Glenn,021,27897,1193,1085,100,1185,8
2020-12-07,Humboldt,023,135768,1244,1023,4,1027,9
2020-12-07,Imperial,025,180216,18971,17234,183,17417,364
2020-12-07,Inyo,027,18085,390,333,6,339,15
2020-12-07,Kern,029,883053,49279,44409,2402,46811,486
2020-12-07,Kings,031,150075,13473,12412,295,12707,90
2020-12-07,Lake,033,64148,1300,1090,0,1090,20
2020-12-07,Lassen,035,31185,3095,2167,15,2182,0
2020-12-07,Los Angeles,037,10098052,501186,451052,9418,460470,7937
2020-12-07,Madera,039,155013,7892,6935,229,7164,59
2020-12-07,Marin,041,260295,8413,8049,50,8099,136
2020-12-07,Mariposa,043,17540,176,146,2,148,2
2020-12-07,Mendocino,045,87422,1858,1638,14,1652,23
2020-12-07,Merced,047,269075,14317,13250,194,13444,179
2020-12-07,Modoc,049,8938,166,128,36,164,0
2020-12-07,Mono,051,14174,680,590,11,601,3
2020-12-07,Monterey,053,433212,19651,17746,380,18126,132
2020-12-07,Napa,055,140530,4274,3684,19,3703,21
2020-12-07,Nevada,057,99092,2049,1777,56,1833,11
2020-12-07,Orange,059,3164182,103333,89793,3270,93063,1628
2020-12-07,Placer,061,380077,10011,7911,266,8177,82
2020-12-07,Plumas,063,18699,327,256,5,261,0
2020-12-07,Riverside,065,2383286,119698,102363,3580,105943,1491
2020-12-07,Sacramento,067,1510023,48472,43419,241,43660,638
2020-12-07,San Benito,069,59416,2396,2165,15,2180,18
2020-12-07,San Bernardino,071,2135413,130226,108161,2865,111026,1295
2020-12-07,San Diego,073,3302833,104757,94171,4303,98474,1062
2020-12-07,San Francisco,075,870044,18363,17220,138,17358,161
2020-12-07,San Joaquin,077,732212,33104,28188,788,28976,530
2020-12-07,San Luis Obispo,079,281455,7792,6782,132,6914,45
2020-12-07,San Mateo,081,765935,18281,16029,22,16051,175
2020-12-07,Santa Barbara,083,443738,13255,12362,272,12634,141
2020-12-07,Santa Clara,085,1922200,48045,40621,138,40759,484
2020-12-07,Santa Cruz,087,273765,6158,5152,96,5248,41
2020-12-07,Shasta,089,179085,6754,5742,370,6112,50
2020-12-07,Sierra,091,2930,20,18,0,18,0
2020-12-07,Siskiyou,093,43540,819,652,58,710,2
2020-12-07,Solano,095,438530,13027,11354,111,11465,89
2020-12-07,Sonoma,097,501317,14803,13376,86,13462,164
2020-12-07,Stanislaus,099,539301,26681,24479,1907,26386,454
2020-12-07,Sutter,101,95872,4768,4106,18,4124,24
2020-12-07,Tehama,103,63373,2253,2030,116,2146,9
2020-12-07,Trinity,105,12862,335,194,38,232,0
2020-12-07,Tulare,107,460477,25781,22760,2197,24957,328
2020-12-07,Tuolumne,109,53932,1581,1256,9,1265,7
2020-12-07,Ventura,111,848112,26472,23354,828,24182,191
2020-12-07,Yolo,113,214977,6276,5537,26,5563,90
2020-12-07,Yuba,115,75493,2710,2428,19,2447,10
2020-12-06,Alameda,001,1643700,36755,33477,478,33955,465
2020-12-06,Alpine,003,1148,59,53,0,53,0
2020-12-06,Amador,005,37829,1221,952,6,958,17
2020-12-06,Butte,007,227075,5113,4527,346,4873,67
2020-12-06,Calaveras,009,45235,672,606,0,606,21
2020-12-06,Colusa,011,21464,963,824,23,847,6
2020-12-06,Contra Costa,013,1133247,29197,26566,233,26799,270
2020-12-06,Del Norte,015,27424,486,414,0,414,2
2020-12-06,El Dorado,017,186661,3907,3086,79,3165,8
2020-12-06,Fresno,019,978130,49490,40869,2134,43003,526
2020-12-06,Glenn,021,27897,1183,1067,96,1163,8
2020-12-06,Humboldt,023,135768,1219,1004,4,1008,9
2020-12-06,Imperial,025,180216,18655,16922,174,17096,364
2020-12-06,Inyo,027,18085,377,333,6,339,15
2020-12-06,Kern,029,883053,48289,43899,2235,46134,486
2020-12-06,Kings,031,150075,13201,12056,278,12334,90
2020-12-06,Lake,033,64148,1262,1075,0,1075,20
2020-12-06,Lassen,035,31185,2991,2168,13,2181,0
2020-12-06,Los Angeles,037,10098052,487588,443230,8985,452215,7910
2020-12-06,Madera,039,155013,7718,6826,220,7046,59
2020-12-06,Marin,041,260295,8332,8013,47,8060,136
2020-12-06,Mariposa,043,17540,175,144,2,146,2
2020-12-06,Mendocino,045,87422,1818,1614,14,1628,23
2020-12-06,Merced,047,269075,13981,12928,185,13113,179
2020-12-06,Modoc,049,8938,153,125,29,154,0
2020-12-06,Mono,051,14174,658,586,10,596,3
2020-12-06,Monterey,053,433212,19033,17426,370,17796,130
2020-12-06,Napa,055,140530,4162,3644,19,3663,21
2020-12-06,Nevada,057,99092,1990,1710,53,1763,10
2020-12-06,Orange,059,3164182,100267,87737,3140,90877,1627
2020-12-06,Placer,061,380077,9729,7837,247,8084,82
2020-12-06,Plumas,063,18699,314,254,4,258,0
2020-12-06,Riverside,065,2383286,116602,100088,3359,103447,1482
2020-12-06,Sacramento,067,1510023,47232,42808,227,43035,638
2020-12-06,San Benito,069,59416,2359,2135,15,2150,18
2020-12-06,San Bernardino,071,2135413,126076,106927,2711,109638,1286
2020-12-06,San Diego,073,3302833,101724,92173,4149,96322,1062
2020-12-06,San Francisco,075,870044,18040,17107,131,17238,161
2020-12-06,San Joaquin,077,732212,32264,28188,760,28948,530
2020-12-06,San Luis Obispo,079,281455,7627,6723,127,6850,45
2020-12-06,San Mateo,081,765935,17777,15855,20,15875,175
2020-12-06,Santa Barbara,083,443738,13023,12252,263,12515,141
2020-12-06,Santa Clara,085,1922200,46663,39112,133,39245,482
2020-12-06,Santa Cruz,087,273765,5984,5069,90,5159,40
2020-12-06,Shasta,089,179085,6613,5743,349,6092,49
2020-12-06,Sierra,091,2930,20,17,0,17,0
2020-12-06,Siskiyou,093,43540,801,652,56,708,2
2020-12-06,Solano,095,438530,12741,11354,101,11455,88
2020-12-06,Sonoma,097,501317,14514,13238,85,13323,164
2020-12-06,Stanislaus,099,539301,26126,24036,1844,25880,454
2020-12-06,Sutter,101,95872,4652,4009,17,4026,21
2020-12-06,Tehama,103,63373,2194,1982,107,2089,9
2020-12-06,Trinity,105,12862,328,181,36,217,0
2020-12-06,Tulare,107,460477,25253,22756,2132,24888,327
2020-12-06,Tuolumne,109,53932,1485,1210,9,1219,7
2020-12-06,Ventura,111,848112,25931,23035,803,23838,191
2020-12-06,Yolo,113,214977,6114,5465,22,5487,90
2020-12-06,Yuba,115,75493,2666,2340,18,2358,10
2020-12-05,Alameda,001,1643700,36398,32781,467,33248,465
2020-12-05,Alpine,003,1148,58,53,0,53,0
2020-12-05,Amador,005,37829,1197,847,6,853,17
2020-12-05,Butte,007,227075,5045,4455,327,4782,66
2020-12-05,Calaveras,009,45235,660,606,0,606,21
2020-12-05,Colusa,011,21464,945,825,20,845,6
2020-12-05,Contra Costa,013,1133247,28902,26217,226,26443,270
2020-12-05,Del Norte,015,27424,480,408,0,408,2
2020-12-05,El Dorado,017,186661,3842,3061,74,3135,8
2020-12-05,Fresno,019,978130,49171,40568,2080,42648,525
2020-12-05,Glenn,021,27897,1170,1056,90,1146,8
2020-12-05,Humboldt,023,135768,1186,979,4,983,9
2020-12-05,Imperial,025,180216,18487,16544,173,16717,362
2020-12-05,Inyo,027,18085,372,332,6,338,15
2020-12-05,Kern,029,883053,47826,43332,2150,45482,484
2020-12-05,Kings,031,150075,13120,11898,275,12173,90
2020-12-05,Lake,033,64148,1235,1069,0,1069,20
2020-12-05,Lassen,035,31185,2800,2168,11,2179,0
2020-12-05,Los Angeles,037,10098052,481788,433120,8669,441789,7888
2020-12-05,Madera,039,155013,7625,6619,213,6832,59
2020-12-05,Marin,041,260295,8305,7961,47,8008,136
2020-12-05,Mariposa,043,17540,170,143,2,145,2
2020-12-05,Mendocino,045,87422,1779,1585,14,1599,23
2020-12-05,Merced,047,269075,13874,12747,174,12921,180
2020-12-05,Modoc,049,8938,153,118,28,146,0
2020-12-05,Mono,051,14174,653,554,10,564,3
2020-12-05,Monterey,053,433212,18887,17077,366,17443,127
2020-12-05,Napa,055,140530,4091,3565,19,3584,21
2020-12-05,Nevada,057,99092,1975,1642,51,1693,10
2020-12-05,Orange,059,3164182,98800,85735,3045,88780,1612
2020-12-05,Placer,061,380077,9609,7811,238,8049,78
2020-12-05,Plumas,063,18699,307,246,1,247,0
2020-12-05,Riverside,065,2383286,114990,98612,3185,101797,1477
2020-12-05,Sacramento,067,1510023,46567,41878,213,42091,625
2020-12-05,San Benito,069,59416,2315,2073,15,2088,18
2020-12-05,San Bernardino,071,2135413,124549,105382,2583,107965,1283
2020-12-05,San Diego,073,3302833,100372,90470,4068,94538,1055
2020-12-05,San Francisco,075,870044,17856,16786,127,16913,161
2020-12-05,San Joaquin,077,732212,31996,28105,727,28832,523
2020-12-05,San Luis Obispo,079,281455,7560,6623,124,6747,44
2020-12-05,San Mateo,081,765935,17520,15512,20,15532,175
2020-12-05,Santa Barbara,083,443738,12923,12107,257,12364,141
2020-12-05,Santa Clara,085,1922200,45913,38339,128,38467,474
2020-12-05,Santa Cruz,087,273765,5911,4997,89,5086,40
2020-12-05,Shasta,089,179085,6552,5653,338,5991,49
2020-12-05,Sierra,091,2930,20,17,0,17,0
2020-12-05,Siskiyou,093,43540,793,649,55,704,2
2020-12-05,Solano,095,438530,12572,11351,99,11450,87
2020-12-05,Sonoma,097,501317,14418,13137,85,13222,164
2020-12-05,Stanislaus,099,539301,25812,23662,1810,25472,454
2020-12-05,Sutter,101,95872,4587,3937,17,3954,20
2020-12-05,Tehama,103,63373,2178,1926,105,2031,9
2020-12-05,Trinity,105,12862,327,177,36,213,0
2020-12-05,Tulare,107,460477,25039,22660,2075,24735,324
2020-12-05,Tuolumne,109,53932,1428,1180,9,1189,7
2020-12-05,Ventura,111,848112,25559,22710,789,23499,191
2020-12-05,Yolo,113,214977,6036,5351,21,5372,90
2020-12-05,Yuba,115,75493,2629,2275,18,2293,10
2020-12-04,Alameda,001,1643700,35849,31871,454,32325,465
2020-12-04,Alpine,003,1148,58,53,0,53,0
2020-12-04,Amador,005,37829,1183,766,3,769,16
2020-12-04,Butte,007,227075,4973,4336,307,4643,65
2020-12-04,Calaveras,009,45235,655,585,0,585,21
2020-12-04,Colusa,011,21464,931,790,18,808,6
2020-12-04,Contra Costa,013,1133247,28557,25705,214,25919,264
2020-12-04,Del Norte,015,27424,469,401,0,401,2
2020-12-04,El Dorado,017,186661,3754,2933,71,3004,7
2020-12-04,Fresno,019,978130,48462,40108,2012,42120,522
2020-12-04,Glenn,021,27897,1164,1017,82,1099,8
2020-12-04,Humboldt,023,135768,1168,960,4,964,9
2020-12-04,Imperial,025,180216,18242,16484,173,16657,362
2020-12-04,Inyo,027,18085,364,324,6,330,15
2020-12-04,Kern,029,883053,47275,42497,2048,44545,485
2020-12-04,Kings,031,150075,13027,11767,269,12036,88
2020-12-04,Lake,033,64148,1207,1018,0,1018,20
2020-12-04,Lassen,035,31185,2793,2167,10,2177,0
2020-12-04,Los Angeles,037,10098052,473164,424164,8378,432542,7845
2020-12-04,Madera,039,155013,7533,6479,210,6689,58
2020-12-04,Marin,041,260295,8253,7896,44,7940,136
2020-12-04,Mariposa,043,17540,170,136,2,138,2
2020-12-04,Mendocino,045,87422,1760,1563,13,1576,23
2020-12-04,Merced,047,269075,13759,12474,166,12640,177
2020-12-04,Modoc,049,8938,153,115,28,143,0
2020-12-04,Mono,051,14174,648,549,10,559,3
2020-12-04,Monterey,053,433212,18675,16737,357,17094,127
2020-12-04,Napa,055,140530,4037,3432,19,3451,19
2020-12-04,Nevada,057,99092,1950,1560,48,1608,10
2020-12-04,Orange,059,3164182,96875,83738,2981,86719,1597
2020-12-04,Placer,061,380077,9485,7461,225,7686,76
2020-12-04,Plumas,063,18699,300,232,0,232,0
2020-12-04,Riverside,065,2383286,112793,95255,3028,98283,1475
2020-12-04,Sacramento,067,1510023,45803,41061,196,41257,618
2020-12-04,San Benito,069,59416,2282,2006,15,2021,17
2020-12-04,San Bernardino,071,2135413,122277,102418,2475,104893,1290
2020-12-04,San Diego,073,3302833,98888,88183,3981,92164,1047
2020-12-04,San Francisco,075,870044,17665,16499,127,16626,161
2020-12-04,San Joaquin,077,732212,31560,27806,690,28496,522
2020-12-04,San Luis Obispo,079,281455,7476,6473,121,6594,42
2020-12-04,San Mateo,081,765935,17232,15112,19,15131,173
2020-12-04,Santa Barbara,083,443738,12816,11947,251,12198,141
2020-12-04,Santa Clara,085,1922200,44992,37465,122,37587,468
2020-12-04,Santa Cruz,087,273765,5822,4985,87,5072,32
2020-12-04,Shasta,089,179085,6464,5439,329,5768,49
2020-12-04,Sierra,091,2930,19,17,0,17,0
2020-12-04,Siskiyou,093,43540,786,639,52,691,2
2020-12-04,Solano,095,438530,12426,11037,96,11133,87
2020-12-04,Sonoma,097,501317,14270,12962,84,13046,164
2020-12-04,Stanislaus,099,539301,25538,23206,1766,24972,448
2020-12-04,Sutter,101,95872,4515,3791,12,3803,20
2020-12-04,Tehama,103,63373,2138,1876,100,1976,9
2020-12-04,Trinity,105,12862,325,172,36,208,0
2020-12-04,Tulare,107,460477,24751,22273,2003,24276,322
2020-12-04,Tuolumne,109,53932,1397,1134,9,1143,7
2020-12-04,Ventura,111,848112,25182,22024,773,22797,189
2020-12-04,Yolo,113,214977,5962,5294,20,5314,87
2020-12-04,Yuba,115,75493,2585,2225,17,2242,10
2020-12-03,Alameda,001,1643700,35085,31184,437,31621,465
2020-12-03,Alpine,003,1148,57,53,0,53,0
2020-12-03,Amador,005,37829,1132,653,3,656,16
2020-12-03,Butte,007,227075,4878,4305,288,4593,65
2020-12-03,Calaveras,009,45235,635,572,0,572,21
2020-12-03,Colusa,011,21464,918,774,17,791,6
2020-12-03,Contra Costa,013,1133247,28053,25464,207,25671,265
2020-12-03,Del Norte,015,27424,465,388,0,388,2
2020-12-03,El Dorado,017,186661,3628,2740,69,2809,6
2020-12-03,Fresno,019,978130,47708,39680,1940,41620,516
2020-12-03,Glenn,021,27897,1146,997,74,1071,8
2020-12-03,Humboldt,023,135768,1138,923,4,927,9
2020-12-03,Imperial,025,180216,18034,16436,161,16597,359
2020-12-03,Inyo,027,18085,361,321,6,327,15
2020-12-03,Kern,029,883053,46429,42062,1947,44009,483
2020-12-03,Kings,031,150075,12928,11658,258,11916,87
2020-12-03,Lake,033,64148,1192,991,0,991,20
2020-12-03,Lassen,035,31185,2753,2128,9,2137,0
2020-12-03,Los Angeles,037,10098052,463061,415805,8018,423823,7787
2020-12-03,Madera,039,155013,7410,6398,205,6603,58
2020-12-03,Marin,041,260295,8193,7861,40,7901,136
2020-12-03,Mariposa,043,17540,166,132,2,134,2
2020-12-03,Mendocino,045,87422,1743,1547,10,1557,23
2020-12-03,Merced,047,269075,13514,12310,159,12469,177
2020-12-03,Modoc,049,8938,151,114,28,142,0
2020-12-03,Mono,051,14174,626,527,10,537,3
2020-12-03,Monterey,053,433212,18214,16218,348,16566,125
2020-12-03,Napa,055,140530,3923,3360,19,3379,19
2020-12-03,Nevada,057,99092,1872,1472,47,1519,10
2020-12-03,Orange,059,3164182,94343,82187,2912,85099,1591
2020-12-03,Placer,061,380077,9283,7270,209,7479,73
2020-12-03,Plumas,063,18699,285,223,0,223,0
2020-12-03,Riverside,065,2383286,110031,92489,2869,95358,1461
2020-12-03,Sacramento,067,1510023,44744,40280,183,40463,614
2020-12-03,San Benito,069,59416,2236,1967,15,1982,16
2020-12-03,San Bernardino,071,2135413,118949,100787,2392,103179,1283
2020-12-03,San Diego,073,3302833,97073,86144,3863,90007,1040
2020-12-03,San Francisco,075,870044,17443,16236,126,16362,161
2020-12-03,San Joaquin,077,732212,30839,27239,648,27887,522
2020-12-03,San Luis Obispo,079,281455,7308,6388,120,6508,42
2020-12-03,San Mateo,081,765935,16879,14909,19,14928,173
2020-12-03,Santa Barbara,083,443738,12687,11829,245,12074,141
2020-12-03,Santa Clara,085,1922200,43790,36621,116,36737,465
2020-12-03,Santa Cruz,087,273765,5678,4850,83,4933,28
2020-12-03,Shasta,089,179085,6355,5330,322,5652,48
2020-12-03,Sierra,091,2930,19,17,0,17,0
2020-12-03,Siskiyou,093,43540,771,629,49,678,2
2020-12-03,Solano,095,438530,12212,10857,93,10950,87
2020-12-03,Sonoma,097,501317,14027,12772,83,12855,164
2020-12-03,Stanislaus,099,539301,25125,22821,1718,24539,447
2020-12-03,Sutter,101,95872,4431,3727,12,3739,20
2020-12-03,Tehama,103,63373,2086,1832,93,1925,9
2020-12-03,Trinity,105,12862,322,166,36,202,0
2020-12-03,Tulare,107,460477,24351,21993,1913,23906,321
2020-12-03,Tuolumne,109,53932,1355,1105,9,1114,7
2020-12-03,Ventura,111,848112,24479,21555,760,22315,187
2020-12-03,Yolo,113,214977,5824,5069,20,5089,87
2020-12-03,Yuba,115,75493,2514,2182,16,2198,10
2020-12-02,Alameda,001,1643700,34460,30697,428,31125,463
2020-12-02,Alpine,003,1148,56,52,0,52,0
2020-12-02,Amador,005,37829,1060,585,3,588,16
2020-12-02,Butte,007,227075,4756,4243,278,4521,65
2020-12-02,Calaveras,009,45235,619,553,0,553,21
2020-12-02,Colusa,011,21464,902,756,16,772,6
2020-12-02,Contra Costa,013,1133247,27594,25147,195,25342,264
2020-12-02,Del Norte,015,27424,451,384,0,384,2
2020-12-02,El Dorado,017,186661,3527,2638,64,2702,5
2020-12-02,Fresno,019,978130,46952,39324,1842,41166,507
2020-12-02,Glenn,021,27897,1129,995,66,1061,7
2020-12-02,Humboldt,023,135768,1112,899,4,903,9
2020-12-02,Imperial,025,180216,17612,16360,154,16514,356
2020-12-02,Inyo,027,18085,354,314,6,320,15
2020-12-02,Kern,029,883053,45532,41660,1852,43512,479
2020-12-02,Kings,031,150075,12575,11531,244,11775,86
2020-12-02,Lake,033,64148,1161,971,0,971,20
2020-12-02,Lassen,035,31185,2694,2115,9,2124,0
2020-12-02,Los Angeles,037,10098052,453008,408289,7688,415977,7739
2020-12-02,Madera,039,155013,7286,6370,199,6569,57
2020-12-02,Marin,041,260295,8146,7819,38,7857,136
2020-12-02,Mariposa,043,17540,163,131,2,133,2
2020-12-02,Mendocino,045,87422,1710,1524,10,1534,23
2020-12-02,Merced,047,269075,13270,12168,151,12319,173
2020-12-02,Modoc,049,8938,148,113,28,141,0
2020-12-02,Mono,051,14174,617,520,10,530,3
2020-12-02,Monterey,053,433212,17734,16064,309,16373,121
2020-12-02,Napa,055,140530,3820,3298,18,3316,19
2020-12-02,Nevada,057,99092,1810,1430,46,1476,9
2020-12-02,Orange,059,3164182,92142,81046,2833,83879,1569
2020-12-02,Placer,061,380077,9049,6941,196,7137,73
2020-12-02,Plumas,063,18699,272,218,0,218,0
2020-12-02,Riverside,065,2383286,107314,90089,2690,92779,1451
2020-12-02,Sacramento,067,1510023,43705,39334,172,39506,597
2020-12-02,San Benito,069,59416,2171,1921,15,1936,16
2020-12-02,San Bernardino,071,2135413,115379,98567,2287,100854,1240
2020-12-02,San Diego,073,3302833,95157,84640,3748,88388,1035
2020-12-02,San Francisco,075,870044,17206,16058,124,16182,157
2020-12-02,San Joaquin,077,732212,30220,26740,625,27365,519
2020-12-02,San Luis Obispo,079,281455,7209,6324,118,6442,42
2020-12-02,San Mateo,081,765935,16516,14757,18,14775,170
2020-12-02,Santa Barbara,083,443738,12536,11705,233,11938,140
2020-12-02,Santa Clara,085,1922200,42672,35878,116,35994,458
2020-12-02,Santa Cruz,087,273765,5546,4766,80,4846,27
2020-12-02,Shasta,089,179085,6232,5188,305,5493,47
2020-12-02,Sierra,091,2930,19,17,0,17,0
2020-12-02,Siskiyou,093,43540,755,624,47,671,1
2020-12-02,Solano,095,438530,11966,10701,89,10790,87
2020-12-02,Sonoma,097,501317,13788,12635,82,12717,163
2020-12-02,Stanislaus,099,539301,24623,22615,1663,24278,448
2020-12-02,Sutter,101,95872,4272,3604,12,3616,18
2020-12-02,Tehama,103,63373,2041,1800,78,1878,9
2020-12-02,Trinity,105,12862,312,165,35,200,0
2020-12-02,Tulare,107,460477,23969,21789,1836,23625,321
2020-12-02,Tuolumne,109,53932,1314,1076,9,1085,7
2020-12-02,Ventura,111,848112,24067,21208,742,21950,186
2020-12-02,Yolo,113,214977,5713,5053,19,5072,87
2020-12-02,Yuba,115,75493,2436,2119,15,2134,10
2020-12-01,Alameda,001,1643700,33768,30252,418,30670,460
2020-12-01,Alpine,003,1148,56,41,0,41,0
2020-12-01,Amador,005,37829,913,575,2,577,16
2020-12-01,Butte,007,227075,4650,4177,264,4441,65
2020-12-01,Calaveras,009,45235,601,544,0,544,21
2020-12-01,Colusa,011,21464,885,747,16,763,6
2020-12-01,Contra Costa,013,1133247,27023,24788,187,24975,264
2020-12-01,Del Norte,015,27424,423,357,0,357,2
2020-12-01,El Dorado,017,186661,3383,2542,59,2601,4
2020-12-01,Fresno,019,978130,46050,39004,1766,40770,505
2020-12-01,Glenn,021,27897,1108,989,62,1051,7
2020-12-01,Humboldt,023,135768,1082,886,4,890,9
2020-12-01,Imperial,025,180216,17295,16278,151,16429,356
2020-12-01,Inyo,027,18085,347,304,6,310,15
2020-12-01,Kern,029,883053,44730,41345,1725,43070,478
2020-12-01,Kings,031,150075,12260,11415,230,11645,86
2020-12-01,Lake,033,64148,1141,969,0,969,19
2020-12-01,Lassen,035,31185,2528,2047,8,2055,0
2020-12-01,Los Angeles,037,10098052,442634,403266,7374,410640,7704
2020-12-01,Madera,039,155013,7169,6270,189,6459,57
2020-12-01,Marin,041,260295,8076,7787,37,7824,136
2020-12-01,Mariposa,043,17540,158,128,2,130,2
2020-12-01,Mendocino,045,87422,1676,1497,10,1507,23
2020-12-01,Merced,047,269075,13027,12032,142,12174,172
2020-12-01,Modoc,049,8938,143,113,24,137,0
2020-12-01,Mono,051,14174,604,520,10,530,3
2020-12-01,Monterey,053,433212,17227,15835,298,16133,121
2020-12-01,Napa,055,140530,3736,3124,17,3141,19
2020-12-01,Nevada,057,99092,1748,1411,45,1456,9
2020-12-01,Orange,059,3164182,90040,79468,2744,82212,1567
2020-12-01,Placer,061,380077,8725,6794,189,6983,72
2020-12-01,Plumas,063,18699,260,201,0,201,0
2020-12-01,Riverside,065,2383286,104505,88530,2530,91060,1448
2020-12-01,Sacramento,067,1510023,42656,38966,169,39135,589
2020-12-01,San Benito,069,59416,2116,1888,15,1903,15
2020-12-01,San Bernardino,071,2135413,111909,95854,2164,98018,1220
2020-12-01,San Diego,073,3302833,92900,83423,3638,87061,1019
2020-12-01,San Francisco,075,870044,16922,15797,121,15918,157
2020-12-01,San Joaquin,077,732212,29419,26432,604,27036,514
2020-12-01,San Luis Obispo,079,281455,7067,6264,113,6377,40
2020-12-01,San Mateo,081,765935,16191,14495,18,14513,170
2020-12-01,Santa Barbara,083,443738,12397,11611,223,11834,140
2020-12-01,Santa Clara,085,1922200,41415,35397,110,35507,452
2020-12-01,Santa Cruz,087,273765,5388,4638,72,4710,27
2020-12-01,Shasta,089,179085,6107,5077,285,5362,47
2020-12-01,Sierra,091,2930,19,17,0,17,0
2020-12-01,Siskiyou,093,43540,741,608,43,651,1
2020-12-01,Solano,095,438530,11705,10604,84,10688,87
2020-12-01,Sonoma,097,501317,13584,12491,79,12570,163
2020-12-01,Stanislaus,099,539301,24167,22351,1605,23956,447
2020-12-01,Sutter,101,95872,4130,3538,12,3550,17
2020-12-01,Tehama,103,63373,1975,1773,68,1841,9
2020-12-01,Trinity,105,12862,298,165,29,194,0
2020-12-01,Tulare,107,460477,23514,21645,1768,23413,319
2020-12-01,Tuolumne,109,53932,1278,1052,7,1059,7
2020-12-01,Ventura,111,848112,23454,20604,720,21324,186
2020-12-01,Yolo,113,214977,5573,4928,19,4947,86
2020-12-01,Yuba,115,75493,2371,2088,14,2102,10
2020-11-30,Alameda,001,1643700,32948,29972,401,30373,457
2020-11-30,Alpine,003,1148,54,41,0,41,0
2020-11-30,Amador,005,37829,872,559,2,561,16
2020-11-30,Butte,007,227075,4532,4148,248,4396,65
2020-11-30,Calaveras,009,45235,580,478,0,478,21
2020-11-30,Colusa,011,21464,858,737,12,749,6
2020-11-30,Contra Costa,013,1133247,26438,24365,183,24548,264
2020-11-30,Del Norte,015,27424,400,339,0,339,2
2020-11-30,El Dorado,017,186661,3209,2488,53,2541,4
2020-11-30,Fresno,019,978130,44939,38712,1655,40367,500
2020-11-30,Glenn,021,27897,1085,954,57,1011,5
2020-11-30,Humboldt,023,135768,1035,870,4,874,9
2020-11-30,Imperial,025,180216,17041,16212,130,16342,356
2020-11-30,Inyo,027,18085,342,304,5,309,15
2020-11-30,Kern,029,883053,43971,40941,1593,42534,473
2020-11-30,Kings,031,150075,12112,11346,215,11561,85
2020-11-30,Lake,033,64148,1109,939,0,939,18
2020-11-30,Lassen,035,31185,2436,1793,8,1801,0
2020-11-30,Los Angeles,037,10098052,431953,396202,7050,403252,7658
2020-11-30,Madera,039,155013,7003,6210,175,6385,57
2020-11-30,Marin,041,260295,8033,7764,36,7800,136
2020-11-30,Mariposa,043,17540,151,123,2,125,2
2020-11-30,Mendocino,045,87422,1648,1482,10,1492,23
2020-11-30,Merced,047,269075,12752,11913,131,12044,172
2020-11-30,Modoc,049,8938,133,113,24,137,0
2020-11-30,Mono,051,14174,582,519,10,529,3
2020-11-30,Monterey,053,433212,16797,15837,290,16127,119
2020-11-30,Napa,055,140530,3636,3091,17,3108,18
2020-11-30,Nevada,057,99092,1662,1347,42,1389,9
2020-11-30,Orange,059,3164182,87931,78711,2648,81359,1568
2020-11-30,Placer,061,380077,8429,6575,176,6751,72
2020-11-30,Plumas,063,18699,249,192,0,192,0
2020-11-30,Riverside,065,2383286,101511,87722,2385,90107,1446
2020-11-30,Sacramento,067,1510023,41576,37834,160,37994,586
2020-11-30,San Benito,069,59416,2069,1875,14,1889,15
2020-11-30,San Bernardino,071,2135413,108178,92704,2052,94756,1220
2020-11-30,San Diego,073,3302833,90537,82045,3511,85556,997
2020-11-30,San Francisco,075,870044,16624,15638,117,15755,157
2020-11-30,San Joaquin,077,732212,28711,25742,578,26320,509
2020-11-30,San Luis Obispo,079,281455,6933,6224,111,6335,36
2020-11-30,San Mateo,081,765935,15832,14276,18,14294,170
2020-11-30,Santa Barbara,083,443738,12219,11572,215,11787,140
2020-11-30,Santa Clara,085,1922200,40205,35019,109,35128,451
2020-11-30,Santa Cruz,087,273765,5249,4558,69,4627,26
2020-11-30,Shasta,089,179085,5962,4933,257,5190,44
2020-11-30,Sierra,091,2930,19,16,0,16,0
2020-11-30,Siskiyou,093,43540,732,605,39,644,1
2020-11-30,Solano,095,438530,11443,10392,79,10471,87
2020-11-30,Sonoma,097,501317,13339,12232,75,12307,163
2020-11-30,Stanislaus,099,539301,23704,22110,1563,23673,446
2020-11-30,Sutter,101,95872,3974,3430,12,3442,16
2020-11-30,Tehama,103,63373,1926,1724,61,1785,9
2020-11-30,Trinity,105,12862,292,162,29,191,0
2020-11-30,Tulare,107,460477,23127,20833,1675,22508,319
2020-11-30,Tuolumne,109,53932,1234,1027,7,1034,7
2020-11-30,Ventura,111,848112,22698,20308,704,21012,180
2020-11-30,Yolo,113,214977,5460,4894,19,4913,81
2020-11-30,Yuba,115,75493,2312,2028,12,2040,10
2020-11-29,Alameda,001,1643700,32160,29918,379,30297,457
2020-11-29,Alpine,003,1148,51,41,0,41,0
2020-11-29,Amador,005,37829,721,548,2,550,16
2020-11-29,Butte,007,227075,4431,4008,232,4240,65
2020-11-29,Calaveras,009,45235,549,478,0,478,21
2020-11-29,Colusa,011,21464,829,723,8,731,6
2020-11-29,Contra Costa,013,1133247,25935,24165,177,24342,264
2020-11-29,Del Norte,015,27424,394,339,0,339,2
2020-11-29,El Dorado,017,186661,3078,2447,51,2498,4
2020-11-29,Fresno,019,978130,43988,38568,1584,40152,500
2020-11-29,Glenn,021,27897,1062,951,55,1006,4
2020-11-29,Humboldt,023,135768,1006,856,4,860,9
2020-11-29,Imperial,025,180216,16810,16138,105,16243,356
2020-11-29,Inyo,027,18085,327,289,5,294,15
2020-11-29,Kern,029,883053,43208,40596,1445,42041,473
2020-11-29,Kings,031,150075,11961,11247,197,11444,85
2020-11-29,Lake,033,64148,1085,927,0,927,18
2020-11-29,Lassen,035,31185,2333,1793,8,1801,0
2020-11-29,Los Angeles,037,10098052,421548,391162,6756,397918,7642
2020-11-29,Madera,039,155013,6860,6184,169,6353,57
2020-11-29,Marin,041,260295,7967,7739,33,7772,135
2020-11-29,Mariposa,043,17540,147,123,2,125,2
2020-11-29,Mendocino,045,87422,1614,1473,10,1483,23
2020-11-29,Merced,047,269075,12513,11773,122,11895,172
2020-11-29,Modoc,049,8938,129,105,22,127,0
2020-11-29,Mono,051,14174,559,515,9,524,3
2020-11-29,Monterey,053,433212,16484,15621,283,15904,119
2020-11-29,Napa,055,140530,3531,3090,16,3106,18
2020-11-29,Nevada,057,99092,1582,1311,40,1351,9
2020-11-29,Orange,059,3164182,85912,78057,2602,80659,1567
2020-11-29,Placer,061,380077,8131,6535,164,6699,72
2020-11-29,Plumas,063,18699,244,191,0,191,0
2020-11-29,Riverside,065,2383286,99117,87383,2233,89616,1442
2020-11-29,Sacramento,067,1510023,40498,37415,151,37566,585
2020-11-29,San Benito,069,59416,2025,1860,14,1874,15
2020-11-29,San Bernardino,071,2135413,104829,92052,1936,93988,1223
2020-11-29,San Diego,073,3302833,88126,81086,3358,84444,997
2020-11-29,San Francisco,075,870044,16342,15571,112,15683,153
2020-11-29,San Joaquin,077,732212,27965,25740,572,26312,509
2020-11-29,San Luis Obispo,079,281455,6810,6145,111,6256,36
2020-11-29,San Mateo,081,765935,15500,14177,18,14195,169
2020-11-29,Santa Barbara,083,443738,12064,11520,211,11731,140
2020-11-29,Santa Clara,085,1922200,38999,34234,103,34337,451
2020-11-29,Santa Cruz,087,273765,5090,4490,67,4557,26
2020-11-29,Shasta,089,179085,5790,4935,229,5164,43
2020-11-29,Sierra,091,2930,19,16,0,16,0
2020-11-29,Siskiyou,093,43540,709,590,37,627,1
2020-11-29,Solano,095,438530,11211,10393,75,10468,87
2020-11-29,Sonoma,097,501317,13087,12052,71,12123,163
2020-11-29,Stanislaus,099,539301,23208,21701,1529,23230,446
2020-11-29,Sutter,101,95872,3859,3297,12,3309,16
2020-11-29,Tehama,103,63373,1875,1710,47,1757,9
2020-11-29,Trinity,105,12862,289,159,27,186,0
2020-11-29,Tulare,107,460477,22758,20793,1600,22393,319
2020-11-29,Tuolumne,109,53932,1197,988,7,995,7
2020-11-29,Ventura,111,848112,22014,19952,692,20644,179
2020-11-29,Yolo,113,214977,5322,4830,18,4848,80
2020-11-29,Yuba,115,75493,2255,1959,12,1971,10
2020-11-28,Alameda,001,1643700,31850,29368,374,29742,456
2020-11-28,Alpine,003,1148,51,41,0,41,0
2020-11-28,Amador,005,37829,644,536,2,538,16
2020-11-28,Butte,007,227075,4373,3894,228,4122,65
2020-11-28,Calaveras,009,45235,543,478,0,478,21
2020-11-28,Colusa,011,21464,820,711,6,717,6
2020-11-28,Contra Costa,013,1133247,25603,23798,173,23971,264
2020-11-28,Del Norte,015,27424,384,328,0,328,2
2020-11-28,El Dorado,017,186661,3010,2415,45,2460,4
2020-11-28,Fresno,019,978130,43641,38288,1546,39834,500
2020-11-28,Glenn,021,27897,1051,925,51,976,4
2020-11-28,Humboldt,023,135768,971,844,4,848,9
2020-11-28,Imperial,025,180216,16743,16019,103,16122,356
2020-11-28,Inyo,027,18085,319,289,5,294,15
2020-11-28,Kern,029,883053,42845,40255,1357,41612,473
2020-11-28,Kings,031,150075,11896,11070,190,11260,85
2020-11-28,Lake,033,64148,1070,920,0,920,18
2020-11-28,Lassen,035,31185,2266,1714,8,1722,0
2020-11-28,Los Angeles,037,10098052,416626,386194,6600,392794,7625
2020-11-28,Madera,039,155013,6758,6119,162,6281,57
2020-11-28,Marin,041,260295,7937,7696,29,7725,135
2020-11-28,Mariposa,043,17540,144,120,2,122,2
2020-11-28,Mendocino,045,87422,1583,1458,10,1468,22
2020-11-28,Merced,047,269075,12415,11688,116,11804,172
2020-11-28,Modoc,049,8938,126,103,22,125,0
2020-11-28,Mono,051,14174,553,505,9,514,3
2020-11-28,Monterey,053,433212,16318,15328,279,15607,118
2020-11-28,Napa,055,140530,3479,3033,16,3049,18
2020-11-28,Nevada,057,99092,1553,1272,38,1310,9
2020-11-28,Orange,059,3164182,84815,76882,2556,79438,1568
2020-11-28,Placer,061,380077,7970,6497,161,6658,70
2020-11-28,Plumas,063,18699,237,188,0,188,0
2020-11-28,Riverside,065,2383286,97708,86854,2132,88986,1440
2020-11-28,Sacramento,067,1510023,39920,36905,147,37052,580
2020-11-28,San Benito,069,59416,1980,1835,14,1849,15
2020-11-28,San Bernardino,071,2135413,103427,91183,1834,93017,1224
2020-11-28,San Diego,073,3302833,86872,80020,3274,83294,997
2020-11-28,San Francisco,075,870044,16166,15450,105,15555,153
2020-11-28,San Joaquin,077,732212,27764,25742,557,26299,509
2020-11-28,San Luis Obispo,079,281455,6740,6106,107,6213,36
2020-11-28,San Mateo,081,765935,15310,14040,18,14058,169
2020-11-28,Santa Barbara,083,443738,11962,11481,206,11687,140
2020-11-28,Santa Clara,085,1922200,38253,33701,101,33802,449
2020-11-28,Santa Cruz,087,273765,5013,4426,67,4493,26
2020-11-28,Shasta,089,179085,5713,4882,222,5104,43
2020-11-28,Sierra,091,2930,19,16,0,16,0
2020-11-28,Siskiyou,093,43540,699,558,34,592,1
2020-11-28,Solano,095,438530,11092,10252,73,10325,87
2020-11-28,Sonoma,097,501317,12983,12008,62,12070,162
2020-11-28,Stanislaus,099,539301,22969,21574,1495,23069,446
2020-11-28,Sutter,101,95872,3775,3244,12,3256,15
2020-11-28,Tehama,103,63373,1856,1678,43,1721,9
2020-11-28,Trinity,105,12862,286,157,25,182,0
2020-11-28,Tulare,107,460477,22560,20701,1558,22259,319
2020-11-28,Tuolumne,109,53932,1175,976,7,983,7
2020-11-28,Ventura,111,848112,21716,19510,682,20192,179
2020-11-28,Yolo,113,214977,5248,4739,16,4755,80
2020-11-28,Yuba,115,75493,2200,1912,12,1924,10
2020-11-27,Alameda,001,1643700,31409,29064,364,29428,450
2020-11-27,Alpine,003,1148,51,41,0,41,0
2020-11-27,Amador,005,37829,597,498,1,499,16
2020-11-27,Butte,007,227075,4332,3894,222,4116,65
2020-11-27,Calaveras,009,45235,534,478,0,478,21
2020-11-27,Colusa,011,21464,803,694,4,698,6
2020-11-27,Contra Costa,013,1133247,25343,23463,167,23630,264
2020-11-27,Del Norte,015,27424,378,307,0,307,2
2020-11-27,El Dorado,017,186661,2939,2238,42,2280,4
2020-11-27,Fresno,019,978130,43235,37994,1490,39484,500
2020-11-27,Glenn,021,27897,1038,891,46,937,4
2020-11-27,Humboldt,023,135768,952,795,3,798,9
2020-11-27,Imperial,025,180216,16676,15960,95,16055,356
2020-11-27,Inyo,027,18085,313,289,5,294,15
2020-11-27,Kern,029,883053,42422,39707,1287,40994,473
2020-11-27,Kings,031,150075,11811,10667,172,10839,85
2020-11-27,Lake,033,64148,1034,909,0,909,18
2020-11-27,Lassen,035,31185,2254,1714,8,1722,0
2020-11-27,Los Angeles,037,10098052,410110,382740,6450,389190,7606
2020-11-27,Madera,039,155013,6686,6050,157,6207,57
2020-11-27,Marin,041,260295,7894,7660,29,7689,135
2020-11-27,Mariposa,043,17540,142,118,2,120,2
2020-11-27,Mendocino,045,87422,1569,1387,9,1396,22
2020-11-27,Merced,047,269075,12309,11550,109,11659,172
2020-11-27,Modoc,049,8938,125,100,22,122,0
2020-11-27,Mono,051,14174,549,498,9,507,3
2020-11-27,Monterey,053,433212,16150,14753,279,15032,113
2020-11-27,Napa,055,140530,3439,2988,16,3004,18
2020-11-27,Nevada,057,99092,1523,1184,36,1220,9
2020-11-27,Orange,059,3164182,83527,75151,2517,77668,1568
2020-11-27,Placer,061,380077,7810,6283,151,6434,68
2020-11-27,Plumas,063,18699,234,188,0,188,0
2020-11-27,Riverside,065,2383286,96098,85769,1980,87749,1440
2020-11-27,Sacramento,067,1510023,39299,36579,143,36722,579
2020-11-27,San Benito,069,59416,1946,1805,13,1818,15
2020-11-27,San Bernardino,071,2135413,101909,90254,1753,92007,1224
2020-11-27,San Diego,073,3302833,85678,78161,3185,81346,996
2020-11-27,San Francisco,075,870044,16010,15377,103,15480,153
2020-11-27,San Joaquin,077,732212,27543,25741,537,26278,509
2020-11-27,San Luis Obispo,079,281455,6657,6039,104,6143,36
2020-11-27,San Mateo,081,765935,15108,13872,17,13889,169
2020-11-27,Santa Barbara,083,443738,11869,11340,203,11543,140
2020-11-27,Santa Clara,085,1922200,37576,32935,94,33029,449
2020-11-27,Santa Cruz,087,273765,4942,4358,65,4423,26
2020-11-27,Shasta,089,179085,5636,4710,209,4919,43
2020-11-27,Sierra,091,2930,18,16,0,16,0
2020-11-27,Siskiyou,093,43540,684,554,31,585,1
2020-11-27,Solano,095,438530,10973,10044,70,10114,87
2020-11-27,Sonoma,097,501317,12850,11924,60,11984,162
2020-11-27,Stanislaus,099,539301,22741,21185,1466,22651,446
2020-11-27,Sutter,101,95872,3707,3101,12,3113,15
2020-11-27,Tehama,103,63373,1828,1649,39,1688,9
2020-11-27,Trinity,105,12862,282,151,25,176,0
2020-11-27,Tulare,107,460477,22372,20634,1501,22135,319
2020-11-27,Tuolumne,109,53932,1143,881,7,888,7
2020-11-27,Ventura,111,848112,21392,19379,660,20039,179
2020-11-27,Yolo,113,214977,5198,4737,16,4753,79
2020-11-27,Yuba,115,75493,2171,1864,11,1875,10
2020-11-26,Alameda,001,1643700,30996,28797,346,29143,447
2020-11-26,Alpine,003,1148,51,41,0,41,0
2020-11-26,Amador,005,37829,589,488,1,489,16
2020-11-26,Butte,007,227075,4269,3894,216,4110,65
2020-11-26,Calaveras,009,45235,507,478,0,478,21
2020-11-26,Colusa,011,21464,789,694,4,698,6
2020-11-26,Contra Costa,013,1133247,25010,23468,161,23629,264
2020-11-26,Del Norte,015,27424,367,307,0,307,2
2020-11-26,El Dorado,017,186661,2858,2217,40,2257,4
2020-11-26,Fresno,019,978130,42830,37724,1445,39169,500
2020-11-26,Glenn,021,27897,1022,892,44,936,4
2020-11-26,Humboldt,023,135768,929,795,2,797,9
2020-11-26,Imperial,025,180216,16565,15722,92,15814,355
2020-11-26,Inyo,027,18085,312,289,5,294,15
2020-11-26,Kern,029,883053,41972,39123,1227,40350,471
2020-11-26,Kings,031,150075,11756,10475,160,10635,85
2020-11-26,Lake,033,64148,1021,890,0,890,18
2020-11-26,Lassen,035,31185,2239,1714,8,1722,0
2020-11-26,Los Angeles,037,10098052,404950,378340,6214,384554,7581
2020-11-26,Madera,039,155013,6611,6003,152,6155,57
2020-11-26,Marin,041,260295,7857,7610,29,7639,135
2020-11-26,Mariposa,043,17540,137,116,2,118,2
2020-11-26,Mendocino,045,87422,1555,1387,7,1394,22
2020-11-26,Merced,047,269075,12162,11440,107,11547,172
2020-11-26,Modoc,049,8938,123,100,22,122,0
2020-11-26,Mono,051,14174,541,485,9,494,2
2020-11-26,Monterey,053,433212,15914,14750,271,15021,113
2020-11-26,Napa,055,140530,3375,2988,16,3004,18
2020-11-26,Nevada,057,99092,1478,1184,36,1220,9
2020-11-26,Orange,059,3164182,82140,74264,2457,76721,1563
2020-11-26,Placer,061,380077,7648,6278,142,6420,68
2020-11-26,Plumas,063,18699,226,188,0,188,0
2020-11-26,Riverside,065,2383286,94495,85774,1856,87630,1440
2020-11-26,Sacramento,067,1510023,38657,35854,135,35989,580
2020-11-26,San Benito,069,59416,1919,1769,13,1782,15
2020-11-26,San Bernardino,071,2135413,100255,89727,1660,91387,1223
2020-11-26,San Diego,073,3302833,84068,76359,3081,79440,996
2020-11-26,San Francisco,075,870044,15875,15156,99,15255,153
2020-11-26,San Joaquin,077,732212,27286,25738,525,26263,509
2020-11-26,San Luis Obispo,079,281455,6564,5964,101,6065,36
2020-11-26,San Mateo,081,765935,14919,13715,16,13731,169
2020-11-26,Santa Barbara,083,443738,11788,11277,202,11479,139
2020-11-26,Santa Clara,085,1922200,36930,32411,87,32498,446
2020-11-26,Santa Cruz,087,273765,4811,4269,59,4328,26
2020-11-26,Shasta,089,179085,5553,4712,198,4910,43
2020-11-26,Sierra,091,2930,18,15,0,15,0
2020-11-26,Siskiyou,093,43540,674,526,31,557,1
2020-11-26,Solano,095,438530,10830,9941,68,10009,87
2020-11-26,Sonoma,097,501317,12702,11922,58,11980,162
2020-11-26,Stanislaus,099,539301,22509,21186,1426,22612,445
2020-11-26,Sutter,101,95872,3613,3101,11,3112,15
2020-11-26,Tehama,103,63373,1785,1612,36,1648,9
2020-11-26,Trinity,105,12862,278,139,25,164,0
2020-11-26,Tulare,107,460477,22133,20649,1440,22089,319
2020-11-26,Tuolumne,109,53932,1115,871,7,878,7
2020-11-26,Ventura,111,848112,20896,19058,646,19704,179
2020-11-26,Yolo,113,214977,5112,4566,16,4582,76
2020-11-26,Yuba,115,75493,2111,1865,9,1874,10
2020-11-25,Alameda,001,1643700,30781,28378,338,28716,447
2020-11-25,Alpine,003,1148,51,41,0,41,0
2020-11-25,Amador,005,37829,579,484,1,485,16
2020-11-25,Butte,007,227075,4238,3848,213,4061,64
2020-11-25,Calaveras,009,45235,504,475,0,475,21
2020-11-25,Colusa,011,21464,772,693,4,697,6
2020-11-25,Contra Costa,013,1133247,24855,23307,160,23467,263
2020-11-25,Del Norte,015,27424,366,304,0,304,2
2020-11-25,El Dorado,017,186661,2822,2154,40,2194,4
2020-11-25,Fresno,019,978130,42597,37349,1423,38772,494
2020-11-25,Glenn,021,27897,1005,891,42,933,4
2020-11-25,Humboldt,023,135768,921,777,2,779,9
2020-11-25,Imperial,025,180216,16493,15640,91,15731,355
2020-11-25,Inyo,027,18085,310,289,5,294,15
2020-11-25,Kern,029,883053,41816,38878,1210,40088,467
2020-11-25,Kings,031,150075,11721,10417,156,10573,85
2020-11-25,Lake,033,64148,1004,878,0,878,18
2020-11-25,Lassen,035,31185,2196,1701,8,1709,0
2020-11-25,Los Angeles,037,10098052,401922,373919,6112,380031,7545
2020-11-25,Madera,039,155013,6589,5989,149,6138,57
2020-11-25,Marin,041,260295,7830,7601,28,7629,135
2020-11-25,Mariposa,043,17540,136,114,2,116,2
2020-11-25,Mendocino,045,87422,1536,1373,7,1380,22
2020-11-25,Merced,047,269075,12104,11346,107,11453,172
2020-11-25,Modoc,049,8938,123,96,22,118,0
2020-11-25,Mono,051,14174,536,487,9,496,2
2020-11-25,Monterey,053,433212,15799,14695,269,14964,113
2020-11-25,Napa,055,140530,3342,2945,16,2961,17
2020-11-25,Nevada,057,99092,1460,1170,34,1204,9
2020-11-25,Orange,059,3164182,81385,73014,2437,75451,1551
2020-11-25,Placer,061,380077,7571,6221,141,6362,68
2020-11-25,Plumas,063,18699,221,183,0,183,0
2020-11-25,Riverside,065,2383286,93952,85077,1838,86915,1438
2020-11-25,Sacramento,067,1510023,38321,35687,132,35819,574
2020-11-25,San Benito,069,59416,1896,1764,13,1777,15
2020-11-25,San Bernardino,071,2135413,99414,88469,1631,90100,1225
2020-11-25,San Diego,073,3302833,83411,75307,3045,78352,988
2020-11-25,San Francisco,075,870044,15770,15053,97,15150,153
2020-11-25,San Joaquin,077,732212,27159,25556,513,26069,515
2020-11-25,San Luis Obispo,079,281455,6521,5913,101,6014,34
2020-11-25,San Mateo,081,765935,14804,13614,16,13630,170
2020-11-25,Santa Barbara,083,443738,11738,11183,202,11385,138
2020-11-25,Santa Clara,085,1922200,36482,32032,86,32118,442
2020-11-25,Santa Cruz,087,273765,4758,4202,58,4260,25
2020-11-25,Shasta,089,179085,5507,4588,191,4779,43
2020-11-25,Sierra,091,2930,18,15,0,15,0
2020-11-25,Siskiyou,093,43540,667,499,31,530,1
2020-11-25,Solano,095,438530,10725,9832,67,9899,87
2020-11-25,Sonoma,097,501317,12639,11775,57,11832,162
2020-11-25,Stanislaus,099,539301,22377,21022,1399,22421,445
2020-11-25,Sutter,101,95872,3569,3064,11,3075,14
2020-11-25,Tehama,103,63373,1773,1587,30,1617,9
2020-11-25,Trinity,105,12862,276,135,25,160,0
2020-11-25,Tulare,107,460477,22043,20528,1410,21938,318
2020-11-25,Tuolumne,109,53932,1098,842,7,849,7
2020-11-25,Ventura,111,848112,20801,18914,640,19554,179
2020-11-25,Yolo,113,214977,5075,4527,16,4543,76
2020-11-25,Yuba,115,75493,2085,1840,9,1849,10
2020-11-24,Alameda,001,1643700,30303,28030,327,28357,444
2020-11-24,Alpine,003,1148,51,41,0,41,0
2020-11-24,Amador,005,37829,554,470,1,471,16
2020-11-24,Butte,007,227075,4152,3798,205,4003,63
2020-11-24,Calaveras,009,45235,498,466,0,466,21
2020-11-24,Colusa,011,21464,754,682,4,686,6
2020-11-24,Contra Costa,013,1133247,24503,23072,154,23226,259
2020-11-24,Del Norte,015,27424,357,298,0,298,2
2020-11-24,El Dorado,017,186661,2717,2005,39,2044,4
2020-11-24,Fresno,019,978130,42195,37021,1348,38369,493
2020-11-24,Glenn,021,27897,987,883,38,921,4
2020-11-24,Humboldt,023,135768,902,774,2,776,9
2020-11-24,Imperial,025,180216,16390,15600,86,15686,355
2020-11-24,Inyo,027,18085,309,282,5,287,15
2020-11-24,Kern,029,883053,41342,38551,1134,39685,465
2020-11-24,Kings,031,150075,11454,10338,143,10481,85
2020-11-24,Lake,033,64148,988,872,0,872,18
2020-11-24,Lassen,035,31185,2173,1657,8,1665,0
2020-11-24,Los Angeles,037,10098052,395613,370008,5880,375888,7501
2020-11-24,Madera,039,155013,6505,5881,142,6023,57
2020-11-24,Marin,041,260295,7783,7591,28,7619,135
2020-11-24,Mariposa,043,17540,126,114,1,115,2
2020-11-24,Mendocino,045,87422,1514,1346,6,1352,22
2020-11-24,Merced,047,269075,11916,11268,101,11369,171
2020-11-24,Modoc,049,8938,119,91,22,113,0
2020-11-24,Mono,051,14174,532,483,9,492,2
2020-11-24,Monterey,053,433212,15537,14354,260,14614,113
2020-11-24,Napa,055,140530,3276,2904,16,2920,17
2020-11-24,Nevada,057,99092,1396,1156,32,1188,9
2020-11-24,Orange,059,3164182,79945,71975,2360,74335,1547
2020-11-24,Placer,061,380077,7390,6147,134,6281,67
2020-11-24,Plumas,063,18699,218,180,0,180,0
2020-11-24,Riverside,065,2383286,92193,83685,1712,85397,1420
2020-11-24,Sacramento,067,1510023,37640,35097,125,35222,568
2020-11-24,San Benito,069,59416,1865,1740,12,1752,15
2020-11-24,San Bernardino,071,2135413,97073,86645,1530,88175,1226
2020-11-24,San Diego,073,3302833,82001,74363,2974,77337,984
2020-11-24,San Francisco,075,870044,15575,14874,93,14967,153
2020-11-24,San Joaquin,077,732212,26844,25318,486,25804,517
2020-11-24,San Luis Obispo,079,281455,6458,5805,100,5905,34
2020-11-24,San Mateo,081,765935,14595,13558,15,13573,170
2020-11-24,Santa Barbara,083,443738,11632,11154,201,11355,138
2020-11-24,Santa Clara,085,1922200,35694,31564,82,31646,438
2020-11-24,Santa Cruz,087,273765,4644,4132,57,4189,25
2020-11-24,Shasta,089,179085,5407,4410,172,4582,43
2020-11-24,Sierra,091,2930,18,15,0,15,0
2020-11-24,Siskiyou,093,43540,649,473,28,501,1
2020-11-24,Solano,095,438530,10554,9716,66,9782,86
2020-11-24,Sonoma,097,501317,12459,11644,54,11698,162
2020-11-24,Stanislaus,099,539301,22135,20830,1356,22186,438
2020-11-24,Sutter,101,95872,3463,2974,11,2985,14
2020-11-24,Tehama,103,63373,1724,1565,25,1590,9
2020-11-24,Trinity,105,12862,269,129,24,153,0
2020-11-24,Tulare,107,460477,21793,20319,1349,21668,315
2020-11-24,Tuolumne,109,53932,1069,832,7,839,7
2020-11-24,Ventura,111,848112,20420,18637,630,19267,179
2020-11-24,Yolo,113,214977,4990,4420,16,4436,76
2020-11-24,Yuba,115,75493,2034,1804,7,1811,10
2020-11-23,Alameda,001,1643700,29888,27718,315,28033,444
2020-11-23,Alpine,003,1148,49,41,0,41,0
2020-11-23,Amador,005,37829,513,457,1,458,16
2020-11-23,Butte,007,227075,4088,3765,199,3964,61
2020-11-23,Calaveras,009,45235,481,434,0,434,21
2020-11-23,Colusa,011,21464,740,662,4,666,6
2020-11-23,Contra Costa,013,1133247,24233,22674,149,22823,260
2020-11-23,Del Norte,015,27424,335,296,0,296,2
2020-11-23,El Dorado,017,186661,2597,2005,38,2043,4
2020-11-23,Fresno,019,978130,41747,36688,1287,37975,488
2020-11-23,Glenn,021,27897,961,853,38,891,4
2020-11-23,Humboldt,023,135768,889,746,2,748,9
2020-11-23,Imperial,025,180216,16221,15104,81,15185,355
2020-11-23,Inyo,027,18085,301,279,5,284,15
2020-11-23,Kern,029,883053,40828,38245,1071,39316,463
2020-11-23,Kings,031,150075,11034,10204,137,10341,85
2020-11-23,Lake,033,64148,965,840,0,840,18
2020-11-23,Lassen,035,31185,2093,1271,7,1278,0
2020-11-23,Los Angeles,037,10098052,389511,366374,5634,372008,7447
2020-11-23,Madera,039,155013,6379,5787,138,5925,56
2020-11-23,Marin,041,260295,7740,7543,28,7571,135
2020-11-23,Mariposa,043,17540,125,97,1,98,2
2020-11-23,Mendocino,045,87422,1484,1330,6,1336,22
2020-11-23,Merced,047,269075,11728,11148,98,11246,169
2020-11-23,Modoc,049,8938,105,91,21,112,0
2020-11-23,Mono,051,14174,519,480,9,489,2
2020-11-23,Monterey,053,433212,15258,14265,254,14519,112
2020-11-23,Napa,055,140530,3210,2811,16,2827,17
2020-11-23,Nevada,057,99092,1307,1087,32,1119,9
2020-11-23,Orange,059,3164182,78541,71074,2316,73390,1546
2020-11-23,Placer,061,380077,7188,5999,133,6132,66
2020-11-23,Plumas,063,18699,214,172,0,172,0
2020-11-23,Riverside,065,2383286,90415,82175,1648,83823,1415
2020-11-23,Sacramento,067,1510023,37070,34141,119,34260,556
2020-11-23,San Benito,069,59416,1838,1729,11,1740,15
2020-11-23,San Bernardino,071,2135413,94964,84387,1466,85853,1224
2020-11-23,San Diego,073,3302833,80538,72817,2886,75703,968
2020-11-23,San Francisco,075,870044,15418,14646,91,14737,153
2020-11-23,San Joaquin,077,732212,26495,24622,482,25104,517
2020-11-23,San Luis Obispo,079,281455,6376,5772,98,5870,34
2020-11-23,San Mateo,081,765935,14405,13364,15,13379,170
2020-11-23,Santa Barbara,083,443738,11525,10944,197,11141,137
2020-11-23,Santa Clara,085,1922200,35043,31064,79,31143,435
2020-11-23,Santa Cruz,087,273765,4534,4003,53,4056,25
2020-11-23,Shasta,089,179085,5289,4100,160,4260,43
2020-11-23,Sierra,091,2930,17,15,0,15,0
2020-11-23,Siskiyou,093,43540,622,460,28,488,0
2020-11-23,Solano,095,438530,10397,9394,63,9457,86
2020-11-23,Sonoma,097,501317,12286,11507,50,11557,160
2020-11-23,Stanislaus,099,539301,21842,20487,1323,21810,436
2020-11-23,Sutter,101,95872,3326,2840,10,2850,14
2020-11-23,Tehama,103,63373,1674,1526,21,1547,9
2020-11-23,Trinity,105,12862,260,120,22,142,0
2020-11-23,Tulare,107,460477,21499,19818,1284,21102,315
2020-11-23,Tuolumne,109,53932,1029,774,7,781,7
2020-11-23,Ventura,111,848112,20045,18480,617,19097,179
2020-11-23,Yolo,113,214977,4909,4265,15,4280,75
2020-11-23,Yuba,115,75493,1967,1702,7,1709,10
2020-11-22,Alameda,001,1643700,29452,27472,304,27776,444
2020-11-22,Alpine,003,1148,46,41,0,41,0
2020-11-22,Amador,005,37829,501,450,1,451,16
2020-11-22,Butte,007,227075,4037,3712,192,3904,61
2020-11-22,Calaveras,009,45235,473,434,0,434,21
2020-11-22,Colusa,011,21464,722,642,3,645,6
2020-11-22,Contra Costa,013,1133247,23929,22407,144,22551,260
2020-11-22,Del Norte,015,27424,311,271,0,271,2
2020-11-22,El Dorado,017,186661,2487,1917,34,1951,4
2020-11-22,Fresno,019,978130,41265,36315,1232,37547,488
2020-11-22,Glenn,021,27897,939,832,34,866,4
2020-11-22,Humboldt,023,135768,873,729,2,731,9
2020-11-22,Imperial,025,180216,16015,15109,36,15145,355
2020-11-22,Inyo,027,18085,295,279,5,284,15
2020-11-22,Kern,029,883053,40249,37904,1038,38942,463
2020-11-22,Kings,031,150075,10935,10035,128,10163,85
2020-11-22,Lake,033,64148,943,834,0,834,18
2020-11-22,Lassen,035,31185,1928,1211,6,1217,0
2020-11-22,Los Angeles,037,10098052,383229,360341,5391,365732,7438
2020-11-22,Madera,039,155013,6299,5745,127,5872,56
2020-11-22,Marin,041,260295,7705,7506,27,7533,135
2020-11-22,Mariposa,043,17540,124,95,1,96,2
2020-11-22,Mendocino,045,87422,1460,1285,5,1290,22
2020-11-22,Merced,047,269075,11579,10939,98,11037,169
2020-11-22,Modoc,049,8938,104,87,19,106,0
2020-11-22,Mono,051,14174,504,481,9,490,2
2020-11-22,Monterey,053,433212,15017,13887,249,14136,111
2020-11-22,Napa,055,140530,3129,2778,16,2794,17
2020-11-22,Nevada,057,99092,1249,1052,32,1084,9
2020-11-22,Orange,059,3164182,77129,69913,2278,72191,1546
2020-11-22,Placer,061,380077,6961,5880,123,6003,66
2020-11-22,Plumas,063,18699,201,172,0,172,0
2020-11-22,Riverside,065,2383286,88820,81565,1589,83154,1409
2020-11-22,Sacramento,067,1510023,36337,33421,106,33527,555
2020-11-22,San Benito,069,59416,1809,1704,11,1715,15
2020-11-22,San Bernardino,071,2135413,92623,83505,1396,84901,1224
2020-11-22,San Diego,073,3302833,78801,71649,2811,74460,968
2020-11-22,San Francisco,075,870044,15247,14515,90,14605,153
2020-11-22,San Joaquin,077,732212,26196,24619,470,25089,517
2020-11-22,San Luis Obispo,079,281455,6269,5664,97,5761,34
2020-11-22,San Mateo,081,765935,14200,13228,15,13243,170
2020-11-22,Santa Barbara,083,443738,11390,10946,192,11138,137
2020-11-22,Santa Clara,085,1922200,34365,30633,77,30710,434
2020-11-22,Santa Cruz,087,273765,4452,3896,46,3942,25
2020-11-22,Shasta,089,179085,5133,4100,142,4242,43
2020-11-22,Sierra,091,2930,17,13,0,13,0
2020-11-22,Siskiyou,093,43540,591,411,28,439,0
2020-11-22,Solano,095,438530,10225,9363,59,9422,86
2020-11-22,Sonoma,097,501317,12128,11415,48,11463,159
2020-11-22,Stanislaus,099,539301,21515,20223,1293,21516,436
2020-11-22,Sutter,101,95872,3209,2677,10,2687,13
2020-11-22,Tehama,103,63373,1640,1457,17,1474,9
2020-11-22,Trinity,105,12862,254,114,22,136,0
2020-11-22,Tulare,107,460477,21246,19818,1218,21036,314
2020-11-22,Tuolumne,109,53932,1003,689,7,696,7
2020-11-22,Ventura,111,848112,19684,18105,604,18709,179
2020-11-22,Yolo,113,214977,4809,4206,15,4221,75
2020-11-22,Yuba,115,75493,1914,1672,7,1679,10
2020-11-21,Alameda,001,1643700,29265,27424,302,27726,444
2020-11-21,Alpine,003,1148,46,41,0,41,0
2020-11-21,Amador,005,37829,487,450,1,451,16
2020-11-21,Butte,007,227075,3989,3664,189,3853,61
2020-11-21,Calaveras,009,45235,465,434,0,434,21
2020-11-21,Colusa,011,21464,713,642,3,645,6
2020-11-21,Contra Costa,013,1133247,23776,22338,142,22480,260
2020-11-21,Del Norte,015,27424,306,271,0,271,2
2020-11-21,El Dorado,017,186661,2438,1900,33,1933,4
2020-11-21,Fresno,019,978130,41009,35973,1198,37171,482
2020-11-21,Glenn,021,27897,934,829,32,861,4
2020-11-21,Humboldt,023,135768,863,728,2,730,9
2020-11-21,Imperial,025,180216,15938,15053,36,15089,355
2020-11-21,Inyo,027,18085,293,283,5,288,15
2020-11-21,Kern,029,883053,39993,37403,1003,38406,463
2020-11-21,Kings,031,150075,10887,10019,124,10143,85
2020-11-21,Lake,033,64148,930,832,0,832,18
2020-11-21,Lassen,035,31185,1861,1211,6,1217,0
2020-11-21,Los Angeles,037,10098052,380044,357754,5251,363005,7428
2020-11-21,Madera,039,155013,6262,5706,127,5833,56
2020-11-21,Marin,041,260295,7682,7488,26,7514,134
2020-11-21,Mariposa,043,17540,124,92,1,93,2
2020-11-21,Mendocino,045,87422,1429,1282,5,1287,22
2020-11-21,Merced,047,269075,11518,10849,97,10946,169
2020-11-21,Modoc,049,8938,100,87,18,105,0
2020-11-21,Mono,051,14174,499,469,9,478,2
2020-11-21,Monterey,053,433212,14919,13886,244,14130,110
2020-11-21,Napa,055,140530,3095,2757,16,2773,17
2020-11-21,Nevada,057,99092,1237,1018,31,1049,9
2020-11-21,Orange,059,3164182,76327,69021,2248,71269,1543
2020-11-21,Placer,061,380077,6847,5778,120,5898,65
2020-11-21,Plumas,063,18699,196,172,0,172,0
2020-11-21,Riverside,065,2383286,88044,80676,1543,82219,1407
2020-11-21,Sacramento,067,1510023,35941,33133,98,33231,548
2020-11-21,San Benito,069,59416,1790,1691,11,1702,15
2020-11-21,San Bernardino,071,2135413,91746,83206,1320,84526,1222
2020-11-21,San Diego,073,3302833,78022,70711,2756,73467,966
2020-11-21,San Francisco,075,870044,15144,14445,89,14534,153
2020-11-21,San Joaquin,077,732212,26063,24620,455,25075,517
2020-11-21,San Luis Obispo,079,281455,6216,5618,94,5712,34
2020-11-21,San Mateo,081,765935,14099,13138,15,13153,170
2020-11-21,Santa Barbara,083,443738,11338,10922,189,11111,137
2020-11-21,Santa Clara,085,1922200,33981,30377,74,30451,433
2020-11-21,Santa Cruz,087,273765,4395,3898,46,3944,25
2020-11-21,Shasta,089,179085,5060,4095,139,4234,42
2020-11-21,Sierra,091,2930,17,13,0,13,0
2020-11-21,Siskiyou,093,43540,575,403,28,431,0
2020-11-21,Solano,095,438530,10135,9290,56,9346,86
2020-11-21,Sonoma,097,501317,12053,11394,47,11441,158
2020-11-21,Stanislaus,099,539301,21371,20111,1269,21380,435
2020-11-21,Sutter,101,95872,3149,2615,9,2624,13
2020-11-21,Tehama,103,63373,1620,1435,16,1451,9
2020-11-21,Trinity,105,12862,251,110,22,132,0
2020-11-21,Tulare,107,460477,21120,19752,1184,20936,313
2020-11-21,Tuolumne,109,53932,984,690,7,697,7
2020-11-21,Ventura,111,848112,19521,18040,594,18634,177
2020-11-21,Yolo,113,214977,4735,4147,14,4161,75
2020-11-21,Yuba,115,75493,1882,1643,7,1650,10
2020-11-20,Alameda,001,1643700,29051,27221,295,27516,444
2020-11-20,Alpine,003,1148,46,20,0,20,0
2020-11-20,Amador,005,37829,483,446,1,447,16
2020-11-20,Butte,007,227075,3957,3618,185,3803,60
2020-11-20,Calaveras,009,45235,455,424,0,424,21
2020-11-20,Colusa,011,21464,705,631,2,633,6
2020-11-20,Contra Costa,013,1133247,23589,22116,138,22254,260
2020-11-20,Del Norte,015,27424,302,264,0,264,2
2020-11-20,El Dorado,017,186661,2342,1868,31,1899,4
2020-11-20,Fresno,019,978130,40715,35635,1169,36804,480
2020-11-20,Glenn,021,27897,922,826,30,856,4
2020-11-20,Humboldt,023,135768,854,714,1,715,9
2020-11-20,Imperial,025,180216,15876,14864,32,14896,353
2020-11-20,Inyo,027,18085,291,262,5,267,15
2020-11-20,Kern,029,883053,39699,37143,978,38121,462
2020-11-20,Kings,031,150075,10839,9903,123,10026,85
2020-11-20,Lake,033,64148,921,820,0,820,18
2020-11-20,Lassen,035,31185,1776,1212,5,1217,0
2020-11-20,Los Angeles,037,10098052,376147,353554,5089,358643,7398
2020-11-20,Madera,039,155013,6168,5635,126,5761,54
2020-11-20,Marin,041,260295,7658,7467,25,7492,134
2020-11-20,Mariposa,043,17540,116,89,1,90,2
2020-11-20,Mendocino,045,87422,1409,1269,5,1274,22
2020-11-20,Merced,047,269075,11432,10729,97,10826,167
2020-11-20,Modoc,049,8938,100,83,18,101,0
2020-11-20,Mono,051,14174,497,469,9,478,2
2020-11-20,Monterey,053,433212,14794,13738,235,13973,110
2020-11-20,Napa,055,140530,3065,2718,16,2734,17
2020-11-20,Nevada,057,99092,1219,990,30,1020,9
2020-11-20,Orange,059,3164182,75491,68212,2211,70423,1532
2020-11-20,Placer,061,380077,6712,5687,105,5792,66
2020-11-20,Plumas,063,18699,194,163,0,163,0
2020-11-20,Riverside,065,2383286,87033,79613,1483,81096,1405
2020-11-20,Sacramento,067,1510023,35565,32832,91,32923,549
2020-11-20,San Benito,069,59416,1778,1668,11,1679,15
2020-11-20,San Bernardino,071,2135413,90377,81203,1238,82441,1220
2020-11-20,San Diego,073,3302833,77024,69233,2674,71907,960
2020-11-20,San Francisco,075,870044,15041,14327,88,14415,153
2020-11-20,San Joaquin,077,732212,25909,24460,442,24902,515
2020-11-20,San Luis Obispo,079,281455,6161,5524,91,5615,34
2020-11-20,San Mateo,081,765935,13966,12980,14,12994,169
2020-11-20,Santa Barbara,083,443738,11282,10825,183,11008,136
2020-11-20,Santa Clara,085,1922200,33560,30002,69,30071,431
2020-11-20,Santa Cruz,087,273765,4329,3815,46,3861,25
2020-11-20,Shasta,089,179085,4987,3861,134,3995,42
2020-11-20,Sierra,091,2930,17,12,0,12,0
2020-11-20,Siskiyou,093,43540,561,387,27,414,0
2020-11-20,Solano,095,438530,10043,9216,54,9270,85
2020-11-20,Sonoma,097,501317,11969,11316,46,11362,158
2020-11-20,Stanislaus,099,539301,21216,19889,1243,21132,433
2020-11-20,Sutter,101,95872,3099,2580,9,2589,13
2020-11-20,Tehama,103,63373,1604,1410,13,1423,9
2020-11-20,Trinity,105,12862,250,102,22,124,0
2020-11-20,Tulare,107,460477,20987,19568,1146,20714,311
2020-11-20,Tuolumne,109,53932,945,662,7,669,7
2020-11-20,Ventura,111,848112,19353,17741,567,18308,175
2020-11-20,Yolo,113,214977,4657,4081,13,4094,74
2020-11-20,Yuba,115,75493,1854,1611,7,1618,10
2020-11-19,Alameda,001,1643700,28706,26971,287,27258,441
2020-11-19,Alpine,003,1148,43,20,0,20,0
2020-11-19,Amador,005,37829,479,436,1,437,16
2020-11-19,Butte,007,227075,3908,3576,178,3754,60
2020-11-19,Calaveras,009,45235,444,417,0,417,21
2020-11-19,Colusa,011,21464,687,621,2,623,6
2020-11-19,Contra Costa,013,1133247,23318,21886,135,22021,259
2020-11-19,Del Norte,015,27424,294,251,0,251,2
2020-11-19,El Dorado,017,186661,2268,1825,27,1852,4
2020-11-19,Fresno,019,978130,40265,35278,1113,36391,478
2020-11-19,Glenn,021,27897,900,806,29,835,4
2020-11-19,Humboldt,023,135768,834,693,1,694,9
2020-11-19,Imperial,025,180216,15667,14507,32,14539,349
2020-11-19,Inyo,027,18085,289,262,5,267,15
2020-11-19,Kern,029,883053,39279,36779,936,37715,459
2020-11-19,Kings,031,150075,10691,9763,116,9879,85
2020-11-19,Lake,033,64148,907,809,0,809,18
2020-11-19,Lassen,035,31185,1659,1201,3,1204,0
2020-11-19,Los Angeles,037,10098052,371120,349493,4925,354418,7365
2020-11-19,Madera,039,155013,6097,5540,118,5658,54
2020-11-19,Marin,041,260295,7627,7451,25,7476,134
2020-11-19,Mariposa,043,17540,109,88,0,88,2
2020-11-19,Mendocino,045,87422,1388,1237,5,1242,23
2020-11-19,Merced,047,269075,11291,10634,91,10725,167
2020-11-19,Modoc,049,8938,97,82,18,100,0
2020-11-19,Mono,051,14174,489,468,9,477,2
2020-11-19,Monterey,053,433212,14580,13369,224,13593,108
2020-11-19,Napa,055,140530,3011,2641,16,2657,17
2020-11-19,Nevada,057,99092,1178,945,29,974,9
2020-11-19,Orange,059,3164182,74227,66998,2168,69166,1530
2020-11-19,Placer,061,380077,6521,5612,104,5716,65
2020-11-19,Plumas,063,18699,189,158,0,158,0
2020-11-19,Riverside,065,2383286,85550,78535,1412,79947,1402
2020-11-19,Sacramento,067,1510023,35051,32367,89,32456,546
2020-11-19,San Benito,069,59416,1755,1643,11,1654,15
2020-11-19,San Bernardino,071,2135413,88479,79244,1160,80404,1215
2020-11-19,San Diego,073,3302833,75774,68142,2570,70712,952
2020-11-19,San Francisco,075,870044,14884,14178,82,14260,153
2020-11-19,San Joaquin,077,732212,25590,24270,432,24702,516
2020-11-19,San Luis Obispo,079,281455,6084,5410,87,5497,34
2020-11-19,San Mateo,081,765935,13828,12714,14,12728,169
2020-11-19,Santa Barbara,083,443738,11202,10741,180,10921,136
2020-11-19,Santa Clara,085,1922200,33003,29630,68,29698,424
2020-11-19,Santa Cruz,087,273765,4239,3679,44,3723,25
2020-11-19,Shasta,089,179085,4849,3685,124,3809,42
2020-11-19,Sierra,091,2930,17,11,0,11,0
2020-11-19,Siskiyou,093,43540,536,360,26,386,0
2020-11-19,Solano,095,438530,9906,9093,50,9143,84
2020-11-19,Sonoma,097,501317,11799,11205,44,11249,156
2020-11-19,Stanislaus,099,539301,20975,19736,1201,20937,433
2020-11-19,Sutter,101,95872,3000,2509,9,2518,13
2020-11-19,Tehama,103,63373,1570,1373,10,1383,9
2020-11-19,Trinity,105,12862,244,97,22,119,0
2020-11-19,Tulare,107,460477,20765,19384,1083,20467,304
2020-11-19,Tuolumne,109,53932,913,602,7,609,7
2020-11-19,Ventura,111,848112,19000,17300,554,17854,174
2020-11-19,Yolo,113,214977,4563,3973,13,3986,72
2020-11-19,Yuba,115,75493,1814,1568,7,1575,10
2020-11-18,Alameda,001,1643700,28442,26610,282,26892,440
2020-11-18,Alpine,003,1148,42,16,0,16,0
2020-11-18,Amador,005,37829,474,430,1,431,16
2020-11-18,Butte,007,227075,3855,3537,165,3702,59
2020-11-18,Calaveras,009,45235,438,409,0,409,21
2020-11-18,Colusa,011,21464,674,611,2,613,6
2020-11-18,Contra Costa,013,1133247,23053,21685,132,21817,258
2020-11-18,Del Norte,015,27424,281,240,0,240,2
2020-11-18,El Dorado,017,186661,2180,1799,26,1825,4
2020-11-18,Fresno,019,978130,39826,34997,1064,36061,474
2020-11-18,Glenn,021,27897,883,803,27,830,4
2020-11-18,Humboldt,023,135768,820,690,1,691,9
2020-11-18,Imperial,025,180216,15444,14428,32,14460,348
2020-11-18,Inyo,027,18085,287,262,5,267,15
2020-11-18,Kern,029,883053,38890,36537,887,37424,456
2020-11-18,Kings,031,150075,10543,9696,113,9809,85
2020-11-18,Lake,033,64148,894,802,0,802,18
2020-11-18,Lassen,035,31185,1559,1124,3,1127,0
2020-11-18,Los Angeles,037,10098052,366245,344675,4745,349420,7338
2020-11-18,Madera,039,155013,6010,5519,106,5625,54
2020-11-18,Marin,041,260295,7603,7435,25,7460,134
2020-11-18,Mariposa,043,17540,106,88,0,88,2
2020-11-18,Mendocino,045,87422,1368,1237,5,1242,23
2020-11-18,Merced,047,269075,11175,10536,90,10626,166
2020-11-18,Modoc,049,8938,94,77,18,95,0
2020-11-18,Mono,051,14174,484,468,9,477,2
2020-11-18,Monterey,053,433212,14385,13340,210,13550,108
2020-11-18,Napa,055,140530,2965,2607,16,2623,17
2020-11-18,Nevada,057,99092,1138,933,27,960,9
2020-11-18,Orange,059,3164182,73133,66381,2143,68524,1521
2020-11-18,Placer,061,380077,6343,5543,99,5642,64
2020-11-18,Plumas,063,18699,184,143,0,143,0
2020-11-18,Riverside,065,2383286,84086,77739,1311,79050,1387
2020-11-18,Sacramento,067,1510023,34426,31816,81,31897,541
2020-11-18,San Benito,069,59416,1730,1632,10,1642,15
2020-11-18,San Bernardino,071,2135413,86718,77400,1081,78481,1206
2020-11-18,San Diego,073,3302833,74480,67243,2510,69753,945
2020-11-18,San Francisco,075,870044,14740,14057,80,14137,153
2020-11-18,San Joaquin,077,732212,25327,24146,418,24564,517
2020-11-18,San Luis Obispo,079,281455,6008,5322,86,5408,34
2020-11-18,San Mateo,081,765935,13675,12631,13,12644,169
2020-11-18,Santa Barbara,083,443738,11123,10684,173,10857,136
2020-11-18,Santa Clara,085,1922200,32537,29285,64,29349,421
2020-11-18,Santa Cruz,087,273765,4149,3618,42,3660,25
2020-11-18,Shasta,089,179085,4715,3547,120,3667,42
2020-11-18,Sierra,091,2930,17,11,0,11,0
2020-11-18,Siskiyou,093,43540,504,351,25,376,0
2020-11-18,Solano,095,438530,9774,8994,48,9042,84
2020-11-18,Sonoma,097,501317,11692,11129,41,11170,155
2020-11-18,Stanislaus,099,539301,20733,19609,1177,20786,431
2020-11-18,Sutter,101,95872,2882,2442,9,2451,13
2020-11-18,Tehama,103,63373,1531,1338,10,1348,8
2020-11-18,Trinity,105,12862,230,95,21,116,0
2020-11-18,Tulare,107,460477,20554,19286,1032,20318,306
2020-11-18,Tuolumne,109,53932,878,590,7,597,7
2020-11-18,Ventura,111,848112,18675,17169,539,17708,173
2020-11-18,Yolo,113,214977,4489,3929,13,3942,71
2020-11-18,Yuba,115,75493,1760,1540,7,1547,10
2020-11-17,Alameda,001,1643700,28116,26425,272,26697,439
2020-11-17,Alpine,003,1148,40,12,0,12,0
2020-11-17,Amador,005,37829,463,423,1,424,16
2020-11-17,Butte,007,227075,3813,3500,155,3655,59
2020-11-17,Calaveras,009,45235,421,405,0,405,21
2020-11-17,Colusa,011,21464,663,606,1,607,6
2020-11-17,Contra Costa,013,1133247,22781,21557,127,21684,256
2020-11-17,Del Norte,015,27424,275,233,0,233,2
2020-11-17,El Dorado,017,186661,2121,1758,26,1784,4
2020-11-17,Fresno,019,978130,39228,34765,1005,35770,472
2020-11-17,Glenn,021,27897,872,795,26,821,4
2020-11-17,Humboldt,023,135768,798,685,1,686,9
2020-11-17,Imperial,025,180216,15207,14204,30,14234,346
2020-11-17,Inyo,027,18085,286,263,5,268,15
2020-11-17,Kern,029,883053,38441,36164,834,36998,455
2020-11-17,Kings,031,150075,10470,9653,106,9759,85
2020-11-17,Lake,033,64148,874,792,0,792,18
2020-11-17,Lassen,035,31185,1480,1124,3,1127,0
2020-11-17,Los Angeles,037,10098052,361293,340933,4587,345520,7302
2020-11-17,Madera,039,155013,5921,5485,99,5584,54
2020-11-17,Marin,041,260295,7571,7404,24,7428,134
2020-11-17,Mariposa,043,17540,103,87,0,87,2
2020-11-17,Mendocino,045,87422,1347,1216,5,1221,23
2020-11-17,Merced,047,269075,11031,10457,84,10541,162
2020-11-17,Modoc,049,8938,88,71,17,88,0
2020-11-17,Mono,051,14174,479,459,9,468,2
2020-11-17,Monterey,053,433212,14156,13220,200,13420,108
2020-11-17,Napa,055,140530,2911,2568,16,2584,17
2020-11-17,Nevada,057,99092,1097,918,26,944,9
2020-11-17,Orange,059,3164182,71982,65757,2116,67873,1519
2020-11-17,Placer,061,380077,6181,5435,93,5528,63
2020-11-17,Plumas,063,18699,176,142,0,142,0
2020-11-17,Riverside,065,2383286,82700,77079,1220,78299,1379
2020-11-17,Sacramento,067,1510023,33827,31341,77,31418,538
2020-11-17,San Benito,069,59416,1714,1611,4,1615,15
2020-11-17,San Bernardino,071,2135413,84908,76134,992,77126,1188
2020-11-17,San Diego,073,3302833,73227,66321,2454,68775,933
2020-11-17,San Francisco,075,870044,14574,13952,79,14031,153
2020-11-17,San Joaquin,077,732212,25054,23997,398,24395,516
2020-11-17,San Luis Obispo,079,281455,5912,5235,86,5321,34
2020-11-17,San Mateo,081,765935,13514,12491,12,12503,169
2020-11-17,Santa Barbara,083,443738,11038,10597,168,10765,136
2020-11-17,Santa Clara,085,1922200,31990,29013,63,29076,419
2020-11-17,Santa Cruz,087,273765,4063,3548,39,3587,25
2020-11-17,Shasta,089,179085,4557,3457,108,3565,40
2020-11-17,Sierra,091,2930,15,11,0,11,0
2020-11-17,Siskiyou,093,43540,456,333,24,357,0
2020-11-17,Solano,095,438530,9629,8905,47,8952,84
2020-11-17,Sonoma,097,501317,11558,11084,40,11124,155
2020-11-17,Stanislaus,099,539301,20509,19466,1150,20616,425
2020-11-17,Sutter,101,95872,2799,2370,8,2378,12
2020-11-17,Tehama,103,63373,1481,1290,10,1300,7
2020-11-17,Trinity,105,12862,213,83,21,104,0
2020-11-17,Tulare,107,460477,20324,19176,971,20147,305
2020-11-17,Tuolumne,109,53932,840,568,7,575,7
2020-11-17,Ventura,111,848112,18403,16797,521,17318,173
2020-11-17,Yolo,113,214977,4313,3887,12,3899,70
2020-11-17,Yuba,115,75493,1712,1519,7,1526,10
2020-11-16,Alameda,001,1643700,27769,26063,267,26330,436
2020-11-16,Alpine,003,1148,37,12,0,12,0
2020-11-16,Amador,005,37829,455,414,1,415,16
2020-11-16,Butte,007,227075,3774,3490,147,3637,58
2020-11-16,Calaveras,009,45235,413,402,0,402,21
2020-11-16,Colusa,011,21464,654,601,1,602,6
2020-11-16,Contra Costa,013,1133247,22513,21386,122,21508,256
2020-11-16,Del Norte,015,27424,268,225,0,225,2
2020-11-16,El Dorado,017,186661,2061,1694,24,1718,4
2020-11-16,Fresno,019,978130,38739,34593,953,35546,471
2020-11-16,Glenn,021,27897,860,786,25,811,4
2020-11-16,Humboldt,023,135768,782,660,1,661,9
2020-11-16,Imperial,025,180216,14959,14111,30,14141,346
2020-11-16,Inyo,027,18085,283,263,5,268,15
2020-11-16,Kern,029,883053,38047,36049,792,36841,455
2020-11-16,Kings,031,150075,10203,9569,102,9671,85
2020-11-16,Lake,033,64148,862,784,0,784,18
2020-11-16,Lassen,035,31185,1299,1124,3,1127,0
2020-11-16,Los Angeles,037,10098052,356539,338778,4418,343196,7277
2020-11-16,Madera,039,155013,5834,5433,93,5526,54
2020-11-16,Marin,041,260295,7541,7359,24,7383,134
2020-11-16,Mariposa,043,17540,100,86,0,86,2
2020-11-16,Mendocino,045,87422,1322,1209,5,1214,23
2020-11-16,Merced,047,269075,10893,10399,81,10480,162
2020-11-16,Modoc,049,8938,86,71,17,88,0
2020-11-16,Mono,051,14174,477,453,9,462,2
2020-11-16,Monterey,053,433212,13910,13089,190,13279,107
2020-11-16,Napa,055,140530,2835,2536,16,2552,17
2020-11-16,Nevada,057,99092,1054,889,24,913,9
2020-11-16,Orange,059,3164182,70886,65396,2102,67498,1519
2020-11-16,Placer,061,380077,6062,5387,85,5472,63
2020-11-16,Plumas,063,18699,169,127,0,127,0
2020-11-16,Riverside,065,2383286,81327,76449,1156,77605,1379
2020-11-16,Sacramento,067,1510023,33189,30954,70,31024,534
2020-11-16,San Benito,069,59416,1696,1603,3,1606,15
2020-11-16,San Bernardino,071,2135413,83082,74401,926,75327,1186
2020-11-16,San Diego,073,3302833,71916,65603,2382,67985,926
2020-11-16,San Francisco,075,870044,14415,13847,76,13923,153
2020-11-16,San Joaquin,077,732212,24766,23515,388,23903,513
2020-11-16,San Luis Obispo,079,281455,5809,5161,82,5243,34
2020-11-16,San Mateo,081,765935,13354,12398,12,12410,169
2020-11-16,Santa Barbara,083,443738,10973,10565,164,10729,135
2020-11-16,Santa Clara,085,1922200,31425,28673,62,28735,419
2020-11-16,Santa Cruz,087,273765,3990,3520,39,3559,25
2020-11-16,Shasta,089,179085,4409,3284,103,3387,37
2020-11-16,Sierra,091,2930,15,11,0,11,0
2020-11-16,Siskiyou,093,43540,429,294,24,318,0
2020-11-16,Solano,095,438530,9430,8827,47,8874,84
2020-11-16,Sonoma,097,501317,11467,10961,39,11000,155
2020-11-16,Stanislaus,099,539301,20273,19333,1123,20456,425
2020-11-16,Sutter,101,95872,2693,2322,8,2330,12
2020-11-16,Tehama,103,63373,1435,1261,7,1268,7
2020-11-16,Trinity,105,12862,201,67,21,88,0
2020-11-16,Tulare,107,460477,20145,18891,918,19809,305
2020-11-16,Tuolumne,109,53932,804,543,7,550,7
2020-11-16,Ventura,111,848112,18065,16691,513,17204,172
2020-11-16,Yolo,113,214977,4218,3858,12,3870,70
2020-11-16,Yuba,115,75493,1676,1500,6,1506,10
2020-11-15,Alameda,001,1643700,27451,25879,262,26141,436
2020-11-15,Alpine,003,1148,35,12,0,12,0
2020-11-15,Amador,005,37829,443,409,1,410,16
2020-11-15,Butte,007,227075,3720,3452,138,3590,58
2020-11-15,Calaveras,009,45235,398,386,0,386,21
2020-11-15,Colusa,011,21464,645,601,1,602,6
2020-11-15,Contra Costa,013,1133247,22214,21179,121,21300,256
2020-11-15,Del Norte,015,27424,254,224,0,224,2
2020-11-15,El Dorado,017,186661,1999,1683,23,1706,4
2020-11-15,Fresno,019,978130,38226,34297,915,35212,471
2020-11-15,Glenn,021,27897,848,783,24,807,4
2020-11-15,Humboldt,023,135768,754,653,1,654,9
2020-11-15,Imperial,025,180216,14722,13940,30,13970,346
2020-11-15,Inyo,027,18085,273,263,5,268,15
2020-11-15,Kern,029,883053,37641,35911,757,36668,455
2020-11-15,Kings,031,150075,10010,9533,99,9632,85
2020-11-15,Lake,033,64148,853,777,0,777,17
2020-11-15,Lassen,035,31185,1252,1124,3,1127,0
2020-11-15,Los Angeles,037,10098052,351492,336035,4250,340285,7271
2020-11-15,Madera,039,155013,5737,5391,87,5478,54
2020-11-15,Marin,041,260295,7515,7347,24,7371,133
2020-11-15,Mariposa,043,17540,97,86,0,86,2
2020-11-15,Mendocino,045,87422,1303,1197,5,1202,22
2020-11-15,Merced,047,269075,10760,10350,81,10431,162
2020-11-15,Modoc,049,8938,85,68,17,85,0
2020-11-15,Mono,051,14174,475,453,9,462,2
2020-11-15,Monterey,053,433212,13714,12999,177,13176,107
2020-11-15,Napa,055,140530,2776,2509,14,2523,17
2020-11-15,Nevada,057,99092,999,859,24,883,9
2020-11-15,Orange,059,3164182,69842,65008,2086,67094,1519
2020-11-15,Placer,061,380077,5907,5330,77,5407,63
2020-11-15,Plumas,063,18699,163,127,0,127,0
2020-11-15,Riverside,065,2383286,80006,75531,1098,76629,1374
2020-11-15,Sacramento,067,1510023,32563,30601,65,30666,534
2020-11-15,San Benito,069,59416,1671,1589,2,1591,15
2020-11-15,San Bernardino,071,2135413,80933,73769,851,74620,1185
2020-11-15,San Diego,073,3302833,70415,64770,2325,67095,926
2020-11-15,San Francisco,075,870044,14240,13757,75,13832,153
2020-11-15,San Joaquin,077,732212,24557,23516,373,23889,513
2020-11-15,San Luis Obispo,079,281455,5688,5120,80,5200,34
2020-11-15,San Mateo,081,765935,13177,12348,12,12360,169
2020-11-15,Santa Barbara,083,443738,10878,10516,162,10678,135
2020-11-15,Santa Clara,085,1922200,30971,28289,61,28350,418
2020-11-15,Santa Cruz,087,273765,3851,3439,38,3477,25
2020-11-15,Shasta,089,179085,4236,3290,94,3384,37
2020-11-15,Sierra,091,2930,15,11,0,11,0
2020-11-15,Siskiyou,093,43540,410,294,24,318,0
2020-11-15,Solano,095,438530,9269,8713,44,8757,84
2020-11-15,Sonoma,097,501317,11349,10833,38,10871,154
2020-11-15,Stanislaus,099,539301,20001,19228,1098,20326,425
2020-11-15,Sutter,101,95872,2603,2230,8,2238,12
2020-11-15,Tehama,103,63373,1384,1222,6,1228,7
2020-11-15,Trinity,105,12862,191,67,19,86,0
2020-11-15,Tulare,107,460477,19928,18891,866,19757,305
2020-11-15,Tuolumne,109,53932,762,486,7,493,7
2020-11-15,Ventura,111,848112,17791,16564,505,17069,172
2020-11-15,Yolo,113,214977,4115,3819,12,3831,67
2020-11-15,Yuba,115,75493,1635,1470,5,1475,10
2020-11-14,Alameda,001,1643700,27184,25714,260,25974,435
2020-11-14,Alpine,003,1148,35,12,0,12,0
2020-11-14,Amador,005,37829,434,404,0,404,16
2020-11-14,Butte,007,227075,3684,3434,124,3558,58
2020-11-14,Calaveras,009,45235,397,386,0,386,21
2020-11-14,Colusa,011,21464,633,601,1,602,6
2020-11-14,Contra Costa,013,1133247,22074,20975,114,21089,256
2020-11-14,Del Norte,015,27424,247,219,0,219,2
2020-11-14,El Dorado,017,186661,1955,1648,23,1671,4
2020-11-14,Fresno,019,978130,37976,33969,879,34848,471
2020-11-14,Glenn,021,27897,839,772,21,793,3
2020-11-14,Humboldt,023,135768,739,643,1,644,9
2020-11-14,Imperial,025,180216,14629,13932,29,13961,346
2020-11-14,Inyo,027,18085,272,263,5,268,15
2020-11-14,Kern,029,883053,37431,35626,738,36364,454
2020-11-14,Kings,031,150075,9975,9490,96,9586,85
2020-11-14,Lake,033,64148,844,773,0,773,17
2020-11-14,Lassen,035,31185,1238,833,3,836,0
2020-11-14,Los Angeles,037,10098052,348786,333021,4141,337162,7269
2020-11-14,Madera,039,155013,5707,5371,85,5456,54
2020-11-14,Marin,041,260295,7499,7325,24,7349,133
2020-11-14,Mariposa,043,17540,96,86,0,86,2
2020-11-14,Mendocino,045,87422,1287,1181,5,1186,22
2020-11-14,Merced,047,269075,10704,10286,79,10365,161
2020-11-14,Modoc,049,8938,84,64,16,80,0
2020-11-14,Mono,051,14174,475,453,9,462,2
2020-11-14,Monterey,053,433212,13618,12854,167,13021,105
2020-11-14,Napa,055,140530,2742,2473,14,2487,17
2020-11-14,Nevada,057,99092,983,835,24,859,9
2020-11-14,Orange,059,3164182,69221,64340,2075,66415,1517
2020-11-14,Placer,061,380077,5831,5215,71,5286,63
2020-11-14,Plumas,063,18699,158,128,0,128,0
2020-11-14,Riverside,065,2383286,79266,74910,1059,75969,1373
2020-11-14,Sacramento,067,1510023,32237,30298,65,30363,532
2020-11-14,San Benito,069,59416,1656,1573,2,1575,15
2020-11-14,San Bernardino,071,2135413,79999,72868,820,73688,1184
2020-11-14,San Diego,073,3302833,69650,63715,2273,65988,926
2020-11-14,San Francisco,075,870044,14153,13661,74,13735,153
2020-11-14,San Joaquin,077,732212,24465,23516,366,23882,511
2020-11-14,San Luis Obispo,079,281455,5625,5073,75,5148,34
2020-11-14,San Mateo,081,765935,13069,12293,12,12305,169
2020-11-14,Santa Barbara,083,443738,10824,10482,160,10642,135
2020-11-14,Santa Clara,085,1922200,30686,27962,59,28021,416
2020-11-14,Santa Cruz,087,273765,3796,3402,38,3440,25
2020-11-14,Shasta,089,179085,4155,3195,92,3287,37
2020-11-14,Sierra,091,2930,15,11,0,11,0
2020-11-14,Siskiyou,093,43540,397,292,24,316,0
2020-11-14,Solano,095,438530,9190,8655,44,8699,84
2020-11-14,Sonoma,097,501317,11296,10769,38,10807,154
2020-11-14,Stanislaus,099,539301,19858,19068,1076,20144,424
2020-11-14,Sutter,101,95872,2558,2182,8,2190,12
2020-11-14,Tehama,103,63373,1363,1206,5,1211,7
2020-11-14,Trinity,105,12862,186,67,19,86,0
2020-11-14,Tulare,107,460477,19834,18853,838,19691,305
2020-11-14,Tuolumne,109,53932,734,448,7,455,7
2020-11-14,Ventura,111,848112,17645,16297,494,16791,172
2020-11-14,Yolo,113,214977,4072,3765,10,3775,65
2020-11-14,Yuba,115,75493,1606,1453,5,1458,10
2020-11-13,Alameda,001,1643700,26968,25515,255,25770,434
2020-11-13,Alpine,003,1148,35,12,0,12,0
2020-11-13,Amador,005,37829,431,397,0,397,16
2020-11-13,Butte,007,227075,3660,3402,115,3517,58
2020-11-13,Calaveras,009,45235,393,378,0,378,21
2020-11-13,Colusa,011,21464,625,598,1,599,6
2020-11-13,Contra Costa,013,1133247,21901,20799,114,20913,256
2020-11-13,Del Norte,015,27424,244,208,0,208,2
2020-11-13,El Dorado,017,186661,1910,1611,22,1633,4
2020-11-13,Fresno,019,978130,37730,33693,865,34558,470
2020-11-13,Glenn,021,27897,825,755,17,772,3
2020-11-13,Humboldt,023,135768,724,638,1,639,9
2020-11-13,Imperial,025,180216,14559,13790,28,13818,341
2020-11-13,Inyo,027,18085,271,262,5,267,15
2020-11-13,Kern,029,883053,37229,35431,721,36152,453
2020-11-13,Kings,031,150075,9916,9428,95,9523,85
2020-11-13,Lake,033,64148,838,770,0,770,17
2020-11-13,Lassen,035,31185,1229,832,3,835,0
2020-11-13,Los Angeles,037,10098052,345658,329364,4037,333401,7248
2020-11-13,Madera,039,155013,5667,5340,84,5424,54
2020-11-13,Marin,041,260295,7486,7307,23,7330,133
2020-11-13,Mariposa,043,17540,94,86,0,86,2
2020-11-13,Mendocino,045,87422,1275,1173,5,1178,22
2020-11-13,Merced,047,269075,10648,10185,76,10261,159
2020-11-13,Modoc,049,8938,84,63,14,77,0
2020-11-13,Mono,051,14174,475,448,8,456,2
2020-11-13,Monterey,053,433212,13423,12681,155,12836,104
2020-11-13,Napa,055,140530,2703,2440,14,2454,17
2020-11-13,Nevada,057,99092,964,798,24,822,9
2020-11-13,Orange,059,3164182,68623,63804,2055,65859,1514
2020-11-13,Placer,061,380077,5726,5122,65,5187,63
2020-11-13,Plumas,063,18699,152,125,0,125,0
2020-11-13,Riverside,065,2383286,78528,74138,1030,75168,1372
2020-11-13,Sacramento,067,1510023,31919,29787,60,29847,524
2020-11-13,San Benito,069,59416,1644,1553,1,1554,15
2020-11-13,San Bernardino,071,2135413,78950,71895,799,72694,1184
2020-11-13,San Diego,073,3302833,68803,62978,2235,65213,921
2020-11-13,San Francisco,075,870044,14060,13516,72,13588,146
2020-11-13,San Joaquin,077,732212,24370,23314,360,23674,510
2020-11-13,San Luis Obispo,079,281455,5558,4960,72,5032,34
2020-11-13,San Mateo,081,765935,12976,12182,12,12194,169
2020-11-13,Santa Barbara,083,443738,10772,10405,158,10563,134
2020-11-13,Santa Clara,085,1922200,30358,27609,57,27666,415
2020-11-13,Santa Cruz,087,273765,3722,3343,38,3381,25
2020-11-13,Shasta,089,179085,4071,2983,88,3071,37
2020-11-13,Sierra,091,2930,15,11,0,11,0
2020-11-13,Siskiyou,093,43540,392,280,23,303,0
2020-11-13,Solano,095,438530,9099,8525,44,8569,84
2020-11-13,Sonoma,097,501317,11235,10685,36,10721,151
2020-11-13,Stanislaus,099,539301,19733,18936,1049,19985,422
2020-11-13,Sutter,101,95872,2512,2121,7,2128,12
2020-11-13,Tehama,103,63373,1336,1167,5,1172,7
2020-11-13,Trinity,105,12862,184,64,19,83,0
2020-11-13,Tulare,107,460477,19710,18714,798,19512,305
2020-11-13,Tuolumne,109,53932,701,427,7,434,7
2020-11-13,Ventura,111,848112,17499,16172,480,16652,171
2020-11-13,Yolo,113,214977,4021,3716,10,3726,65
2020-11-13,Yuba,115,75493,1579,1435,5,1440,10
2020-11-12,Alameda,001,1643700,26701,25345,255,25600,432
2020-11-12,Alpine,003,1148,34,12,0,12,0
2020-11-12,Amador,005,37829,430,392,0,392,16
2020-11-12,Butte,007,227075,3611,3347,112,3459,58
2020-11-12,Calaveras,009,45235,388,373,0,373,21
2020-11-12,Colusa,011,21464,620,591,1,592,6
2020-11-12,Contra Costa,013,1133247,21694,20619,112,20731,255
2020-11-12,Del Norte,015,27424,237,203,0,203,2
2020-11-12,El Dorado,017,186661,1864,1573,18,1591,4
2020-11-12,Fresno,019,978130,37380,33459,824,34283,468
2020-11-12,Glenn,021,27897,806,727,17,744,3
2020-11-12,Humboldt,023,135768,711,625,1,626,9
2020-11-12,Imperial,025,180216,14394,13619,28,13647,341
2020-11-12,Inyo,027,18085,270,255,5,260,15
2020-11-12,Kern,029,883053,36965,35207,707,35914,451
2020-11-12,Kings,031,150075,9849,9335,94,9429,85
2020-11-12,Lake,033,64148,829,764,0,764,17
2020-11-12,Lassen,035,31185,1160,832,2,834,0
2020-11-12,Los Angeles,037,10098052,341915,327001,3938,330939,7223
2020-11-12,Madera,039,155013,5632,5273,80,5353,54
2020-11-12,Marin,041,260295,7457,7268,23,7291,133
2020-11-12,Mariposa,043,17540,92,84,0,84,2
2020-11-12,Mendocino,045,87422,1256,1142,5,1147,22
2020-11-12,Merced,047,269075,10534,10107,73,10180,158
2020-11-12,Modoc,049,8938,84,63,14,77,0
2020-11-12,Mono,051,14174,474,442,8,450,2
2020-11-12,Monterey,053,433212,13302,12489,141,12630,100
2020-11-12,Napa,055,140530,2641,2398,14,2412,16
2020-11-12,Nevada,057,99092,942,780,23,803,9
2020-11-12,Orange,059,3164182,67878,63232,2036,65268,1514
2020-11-12,Placer,061,380077,5616,5044,56,5100,62
2020-11-12,Plumas,063,18699,148,121,0,121,0
2020-11-12,Riverside,065,2383286,77597,73381,987,74368,1362
2020-11-12,Sacramento,067,1510023,31428,29459,52,29511,520
2020-11-12,San Benito,069,59416,1624,1525,1,1526,15
2020-11-12,San Bernardino,071,2135413,77584,70758,760,71518,1183
2020-11-12,San Diego,073,3302833,67823,62336,2184,64520,918
2020-11-12,San Francisco,075,870044,13962,13289,71,13360,146
2020-11-12,San Joaquin,077,732212,24177,23002,339,23341,509
2020-11-12,San Luis Obispo,079,281455,5494,4898,71,4969,33
2020-11-12,San Mateo,081,765935,12851,12086,11,12097,169
2020-11-12,Santa Barbara,083,443738,10710,10325,153,10478,134
2020-11-12,Santa Clara,085,1922200,29982,27261,56,27317,414
2020-11-12,Santa Cruz,087,273765,3639,3317,36,3353,25
2020-11-12,Shasta,089,179085,3934,2825,77,2902,37
2020-11-12,Sierra,091,2930,15,11,0,11,0
2020-11-12,Siskiyou,093,43540,375,275,19,294,0
2020-11-12,Solano,095,438530,8999,8417,43,8460,85
2020-11-12,Sonoma,097,501317,11133,10602,35,10637,151
2020-11-12,Stanislaus,099,539301,19564,18787,1020,19807,422
2020-11-12,Sutter,101,95872,2429,2075,6,2081,12
2020-11-12,Tehama,103,63373,1309,1117,5,1122,7
2020-11-12,Trinity,105,12862,176,62,18,80,0
2020-11-12,Tulare,107,460477,19598,18545,760,19305,305
2020-11-12,Tuolumne,109,53932,662,353,7,360,7
2020-11-12,Ventura,111,848112,17249,16013,474,16487,158
2020-11-12,Yolo,113,214977,3978,3646,10,3656,63
2020-11-12,Yuba,115,75493,1544,1410,5,1415,10
2020-11-11,Alameda,001,1643700,26457,25140,253,25393,429
2020-11-11,Alpine,003,1148,29,12,0,12,0
2020-11-11,Amador,005,37829,423,389,0,389,16
2020-11-11,Butte,007,227075,3585,3348,99,3447,58
2020-11-11,Calaveras,009,45235,378,373,0,373,21
2020-11-11,Colusa,011,21464,614,591,1,592,6
2020-11-11,Contra Costa,013,1133247,21477,20452,110,20562,255
2020-11-11,Del Norte,015,27424,230,203,0,203,2
2020-11-11,El Dorado,017,186661,1818,1564,17,1581,4
2020-11-11,Fresno,019,978130,37061,33287,789,34076,468
2020-11-11,Glenn,021,27897,790,722,16,738,3
2020-11-11,Humboldt,023,135768,697,623,1,624,9
2020-11-11,Imperial,025,180216,14224,13623,26,13649,340
2020-11-11,Inyo,027,18085,268,255,5,260,15
2020-11-11,Kern,029,883053,36690,35014,690,35704,449
2020-11-11,Kings,031,150075,9743,9263,91,9354,85
2020-11-11,Lake,033,64148,819,763,0,763,17
2020-11-11,Lassen,035,31185,1135,831,2,833,0
2020-11-11,Los Angeles,037,10098052,338548,324567,3855,328422,7220
2020-11-11,Madera,039,155013,5597,5248,79,5327,54
2020-11-11,Marin,041,260295,7434,7268,23,7291,133
2020-11-11,Mariposa,043,17540,92,84,0,84,2
2020-11-11,Mendocino,045,87422,1244,1142,5,1147,22
2020-11-11,Merced,047,269075,10463,10074,71,10145,157
2020-11-11,Modoc,049,8938,80,62,13,75,0
2020-11-11,Mono,051,14174,472,443,8,451,2
2020-11-11,Monterey,053,433212,13159,12417,137,12554,100
2020-11-11,Napa,055,140530,2592,2365,12,2377,15
2020-11-11,Nevada,057,99092,900,741,23,764,9
2020-11-11,Orange,059,3164182,67238,62929,2012,64941,1506
2020-11-11,Placer,061,380077,5532,4981,48,5029,60
2020-11-11,Plumas,063,18699,146,111,0,111,0
2020-11-11,Riverside,065,2383286,76695,72953,941,73894,1361
2020-11-11,Sacramento,067,1510023,30971,28968,50,29018,520
2020-11-11,San Benito,069,59416,1610,1512,1,1513,15
2020-11-11,San Bernardino,071,2135413,76298,70374,734,71108,1182
2020-11-11,San Diego,073,3302833,66888,61746,2123,63869,918
2020-11-11,San Francisco,075,870044,13855,13287,70,13357,146
2020-11-11,San Joaquin,077,732212,24017,23001,334,23335,509
2020-11-11,San Luis Obispo,079,281455,5419,4832,68,4900,33
2020-11-11,San Mateo,081,765935,12737,12008,11,12019,169
2020-11-11,Santa Barbara,083,443738,10644,10278,153,10431,134
2020-11-11,Santa Clara,085,1922200,29630,27075,55,27130,413
2020-11-11,Santa Cruz,087,273765,3571,3247,36,3283,25
2020-11-11,Shasta,089,179085,3810,2766,67,2833,36
2020-11-11,Sierra,091,2930,13,11,0,11,0
2020-11-11,Siskiyou,093,43540,344,261,16,277,0
2020-11-11,Solano,095,438530,8881,8353,41,8394,85
2020-11-11,Sonoma,097,501317,11059,10498,35,10533,150
2020-11-11,Stanislaus,099,539301,19427,18671,990,19661,422
2020-11-11,Sutter,101,95872,2381,2049,5,2054,12
2020-11-11,Tehama,103,63373,1267,1105,4,1109,7
2020-11-11,Trinity,105,12862,165,62,18,80,0
2020-11-11,Tulare,107,460477,19467,18500,730,19230,305
2020-11-11,Tuolumne,109,53932,606,354,6,360,7
2020-11-11,Ventura,111,848112,17034,15801,461,16262,158
2020-11-11,Yolo,113,214977,3927,3606,10,3616,63
2020-11-11,Yuba,115,75493,1529,1400,5,1405,10
2020-11-10,Alameda,001,1643700,26227,25008,250,25258,424
2020-11-10,Alpine,003,1148,29,9,0,9,0
2020-11-10,Amador,005,37829,417,384,0,384,16
2020-11-10,Butte,007,227075,3549,3327,95,3422,58
2020-11-10,Calaveras,009,45235,374,367,0,367,21
2020-11-10,Colusa,011,21464,606,590,1,591,6
2020-11-10,Contra Costa,013,1133247,21271,20326,108,20434,255
2020-11-10,Del Norte,015,27424,224,196,0,196,2
2020-11-10,El Dorado,017,186661,1758,1551,17,1568,4
2020-11-10,Fresno,019,978130,36791,33024,753,33777,465
2020-11-10,Glenn,021,27897,782,719,12,731,3
2020-11-10,Humboldt,023,135768,680,610,1,611,9
2020-11-10,Imperial,025,180216,14094,13570,26,13596,338
2020-11-10,Inyo,027,18085,267,252,5,257,14
2020-11-10,Kern,029,883053,36414,34858,671,35529,448
2020-11-10,Kings,031,150075,9696,9236,84,9320,85
2020-11-10,Lake,033,64148,809,762,0,762,16
2020-11-10,Lassen,035,31185,1120,830,2,832,0
2020-11-10,Los Angeles,037,10098052,335299,322569,3741,326310,7205
2020-11-10,Madera,039,155013,5555,5229,73,5302,54
2020-11-10,Marin,041,260295,7415,7259,23,7282,133
2020-11-10,Mariposa,043,17540,90,84,0,84,2
2020-11-10,Mendocino,045,87422,1236,1137,5,1142,22
2020-11-10,Merced,047,269075,10401,9992,65,10057,157
2020-11-10,Modoc,049,8938,78,61,13,74,0
2020-11-10,Mono,051,14174,470,443,8,451,2
2020-11-10,Monterey,053,433212,13024,12335,129,12464,100
2020-11-10,Napa,055,140530,2554,2341,10,2351,15
2020-11-10,Nevada,057,99092,884,734,23,757,9
2020-11-10,Orange,059,3164182,66687,62597,2002,64599,1504
2020-11-10,Placer,061,380077,5452,4902,47,4949,60
2020-11-10,Plumas,063,18699,142,108,0,108,0
2020-11-10,Riverside,065,2383286,76053,72316,916,73232,1359
2020-11-10,Sacramento,067,1510023,30564,28677,47,28724,519
2020-11-10,San Benito,069,59416,1595,1508,1,1509,15
2020-11-10,San Bernardino,071,2135413,75129,69666,701,70367,1182
2020-11-10,San Diego,073,3302833,65997,61085,2086,63171,915
2020-11-10,San Francisco,075,870044,13738,13210,70,13280,146
2020-11-10,San Joaquin,077,732212,23852,22865,327,23192,508
2020-11-10,San Luis Obispo,079,281455,5356,4780,65,4845,33
2020-11-10,San Mateo,081,765935,12637,11939,11,11950,169
2020-11-10,Santa Barbara,083,443738,10577,10252,149,10401,134
2020-11-10,Santa Clara,085,1922200,29285,26917,54,26971,409
2020-11-10,Santa Cruz,087,273765,3509,3221,36,3257,25
2020-11-10,Shasta,089,179085,3667,2686,59,2745,36
2020-11-10,Sierra,091,2930,12,10,0,10,0
2020-11-10,Siskiyou,093,43540,327,263,15,278,0
2020-11-10,Solano,095,438530,8783,8299,41,8340,85
2020-11-10,Sonoma,097,501317,10972,10414,35,10449,150
2020-11-10,Stanislaus,099,539301,19293,18592,966,19558,420
2020-11-10,Sutter,101,95872,2286,2035,4,2039,12
2020-11-10,Tehama,103,63373,1243,1099,3,1102,7
2020-11-10,Trinity,105,12862,156,62,16,78,0
2020-11-10,Tulare,107,460477,19352,18430,707,19137,305
2020-11-10,Tuolumne,109,53932,557,353,6,359,7
2020-11-10,Ventura,111,848112,16851,15625,459,16084,158
2020-11-10,Yolo,113,214977,3866,3573,10,3583,63
2020-11-10,Yuba,115,75493,1506,1392,5,1397,10
2020-11-09,Alameda,001,1643700,25981,24899,246,25145,424
2020-11-09,Alpine,003,1148,27,6,0,6,0
2020-11-09,Amador,005,37829,408,380,0,380,16
2020-11-09,Butte,007,227075,3504,3301,86,3387,57
2020-11-09,Calaveras,009,45235,370,360,0,360,21
2020-11-09,Colusa,011,21464,600,583,1,584,6
2020-11-09,Contra Costa,013,1133247,21098,20193,106,20299,255
2020-11-09,Del Norte,015,27424,218,195,0,195,2
2020-11-09,El Dorado,017,186661,1717,1515,17,1532,4
2020-11-09,Fresno,019,978130,36480,32755,713,33468,465
2020-11-09,Glenn,021,27897,776,714,9,723,3
2020-11-09,Humboldt,023,135768,667,607,1,608,9
2020-11-09,Imperial,025,180216,13975,13508,25,13533,338
2020-11-09,Inyo,027,18085,267,252,5,257,14
2020-11-09,Kern,029,883053,36184,34764,635,35399,448
2020-11-09,Kings,031,150075,9626,9141,82,9223,84
2020-11-09,Lake,033,64148,800,755,0,755,16
2020-11-09,Lassen,035,31185,1024,799,2,801,0
2020-11-09,Los Angeles,037,10098052,332202,320370,3666,324036,7180
2020-11-09,Madera,039,155013,5509,5209,70,5279,54
2020-11-09,Marin,041,260295,7389,7237,22,7259,131
2020-11-09,Mariposa,043,17540,90,84,0,84,2
2020-11-09,Mendocino,045,87422,1224,1132,5,1137,22
2020-11-09,Merced,047,269075,10298,9922,62,9984,157
2020-11-09,Modoc,049,8938,74,54,12,66,0
2020-11-09,Mono,051,14174,467,352,8,360,2
2020-11-09,Monterey,053,433212,12877,12148,121,12269,98
2020-11-09,Napa,055,140530,2511,2309,10,2319,15
2020-11-09,Nevada,057,99092,847,729,22,751,9
2020-11-09,Orange,059,3164182,66046,62335,1989,64324,1501
2020-11-09,Placer,061,380077,5367,4843,36,4879,60
2020-11-09,Plumas,063,18699,135,102,0,102,0
2020-11-09,Riverside,065,2383286,75271,72059,882,72941,1346
2020-11-09,Sacramento,067,1510023,30092,28200,46,28246,516
2020-11-09,San Benito,069,59416,1586,1506,1,1507,15
2020-11-09,San Bernardino,071,2135413,74075,69015,658,69673,1182
2020-11-09,San Diego,073,3302833,65142,60572,2046,62618,908
2020-11-09,San Francisco,075,870044,13618,12984,67,13051,146
2020-11-09,San Joaquin,077,732212,23687,22512,322,22834,505
2020-11-09,San Luis Obispo,079,281455,5269,4746,63,4809,32
2020-11-09,San Mateo,081,765935,12530,11857,11,11868,169
2020-11-09,Santa Barbara,083,443738,10520,10214,144,10358,134
2020-11-09,Santa Clara,085,1922200,28889,26693,54,26747,409
2020-11-09,Santa Cruz,087,273765,3451,3194,36,3230,25
2020-11-09,Shasta,089,179085,3513,2581,50,2631,36
2020-11-09,Sierra,091,2930,10,10,0,10,0
2020-11-09,Siskiyou,093,43540,316,257,13,270,0
2020-11-09,Solano,095,438530,8667,8254,40,8294,85
2020-11-09,Sonoma,097,501317,10864,10310,35,10345,150
2020-11-09,Stanislaus,099,539301,19140,18482,951,19433,418
2020-11-09,Sutter,101,95872,2219,2010,3,2013,12
2020-11-09,Tehama,103,63373,1206,1071,2,1073,7
2020-11-09,Trinity,105,12862,149,46,16,62,0
2020-11-09,Tulare,107,460477,19232,18272,676,18948,304
2020-11-09,Tuolumne,109,53932,502,346,5,351,7
2020-11-09,Ventura,111,848112,16649,15568,456,16024,156
2020-11-09,Yolo,113,214977,3805,3522,10,3532,62
2020-11-09,Yuba,115,75493,1473,1380,5,1385,10
2020-11-08,Alameda,001,1643700,25751,24731,246,24977,424
2020-11-08,Alpine,003,1148,24,6,0,6,0
2020-11-08,Amador,005,37829,401,376,0,376,16
2020-11-08,Butte,007,227075,3466,3285,79,3364,57
2020-11-08,Calaveras,009,45235,368,360,0,360,21
2020-11-08,Colusa,011,21464,597,583,1,584,6
2020-11-08,Contra Costa,013,1133247,20928,20031,104,20135,254
2020-11-08,Del Norte,015,27424,210,195,0,195,2
2020-11-08,El Dorado,017,186661,1680,1502,17,1519,4
2020-11-08,Fresno,019,978130,36145,32619,675,33294,465
2020-11-08,Glenn,021,27897,770,707,8,715,3
2020-11-08,Humboldt,023,135768,651,605,1,606,9
2020-11-08,Imperial,025,180216,13859,13428,25,13453,338
2020-11-08,Inyo,027,18085,263,252,5,257,14
2020-11-08,Kern,029,883053,35965,34644,617,35261,448
2020-11-08,Kings,031,150075,9493,9026,79,9105,84
2020-11-08,Lake,033,64148,792,754,0,754,16
2020-11-08,Lassen,035,31185,876,799,2,801,0
2020-11-08,Los Angeles,037,10098052,329075,318960,3600,322560,7176
2020-11-08,Madera,039,155013,5440,5196,67,5263,54
2020-11-08,Marin,041,260295,7369,7227,22,7249,131
2020-11-08,Mariposa,043,17540,90,83,0,83,2
2020-11-08,Mendocino,045,87422,1215,1129,5,1134,22
2020-11-08,Merced,047,269075,10223,9885,60,9945,157
2020-11-08,Modoc,049,8938,70,54,12,66,0
2020-11-08,Mono,051,14174,461,352,8,360,2
2020-11-08,Monterey,053,433212,12732,12122,111,12233,98
2020-11-08,Napa,055,140530,2472,2274,10,2284,15
2020-11-08,Nevada,057,99092,831,715,22,737,9
2020-11-08,Orange,059,3164182,65457,62034,1975,64009,1501
2020-11-08,Placer,061,380077,5264,4800,31,4831,60
2020-11-08,Plumas,063,18699,130,102,0,102,0
2020-11-08,Riverside,065,2383286,74617,71442,841,72283,1345
2020-11-08,Sacramento,067,1510023,29533,28059,43,28102,515
2020-11-08,San Benito,069,59416,1571,1496,1,1497,15
2020-11-08,San Bernardino,071,2135413,72821,68412,619,69031,1182
2020-11-08,San Diego,073,3302833,64297,60199,2002,62201,908
2020-11-08,San Francisco,075,870044,13487,12985,63,13048,146
2020-11-08,San Joaquin,077,732212,23493,22514,318,22832,505
2020-11-08,San Luis Obispo,079,281455,5203,4698,58,4756,32
2020-11-08,San Mateo,081,765935,12412,11783,11,11794,169
2020-11-08,Santa Barbara,083,443738,10450,10180,142,10322,134
2020-11-08,Santa Clara,085,1922200,28515,26442,53,26495,410
2020-11-08,Santa Cruz,087,273765,3394,3134,36,3170,25
2020-11-08,Shasta,089,179085,3377,2582,44,2626,36
2020-11-08,Sierra,091,2930,10,7,0,7,0
2020-11-08,Siskiyou,093,43540,304,246,12,258,0
2020-11-08,Solano,095,438530,8546,8132,39,8171,85
2020-11-08,Sonoma,097,501317,10757,10229,35,10264,149
2020-11-08,Stanislaus,099,539301,18966,18413,930,19343,418
2020-11-08,Sutter,101,95872,2161,1980,3,1983,12
2020-11-08,Tehama,103,63373,1181,1054,2,1056,7
2020-11-08,Trinity,105,12862,146,46,15,61,0
2020-11-08,Tulare,107,460477,19090,18272,647,18919,304
2020-11-08,Tuolumne,109,53932,475,341,5,346,7
2020-11-08,Ventura,111,848112,16454,15504,448,15952,156
2020-11-08,Yolo,113,214977,3743,3492,10,3502,61
2020-11-08,Yuba,115,75493,1452,1369,5,1374,10
2020-11-07,Alameda,001,1643700,25641,24578,244,24822,424
2020-11-07,Alpine,003,1148,24,6,0,6,0
2020-11-07,Amador,005,37829,398,375,0,375,16
2020-11-07,Butte,007,227075,3454,3277,74,3351,57
2020-11-07,Calaveras,009,45235,366,360,0,360,21
2020-11-07,Colusa,011,21464,597,583,1,584,6
2020-11-07,Contra Costa,013,1133247,20827,19943,103,20046,254
2020-11-07,Del Norte,015,27424,206,194,0,194,2
2020-11-07,El Dorado,017,186661,1655,1495,16,1511,4
2020-11-07,Fresno,019,978130,35991,32497,652,33149,465
2020-11-07,Glenn,021,27897,762,707,8,715,3
2020-11-07,Humboldt,023,135768,640,590,1,591,9
2020-11-07,Imperial,025,180216,13801,13388,24,13412,338
2020-11-07,Inyo,027,18085,261,252,5,257,14
2020-11-07,Kern,029,883053,35810,34513,607,35120,448
2020-11-07,Kings,031,150075,9460,9005,73,9078,84
2020-11-07,Lake,033,64148,788,751,0,751,16
2020-11-07,Lassen,035,31185,860,799,2,801,0
2020-11-07,Los Angeles,037,10098052,327561,316756,3533,320289,7174
2020-11-07,Madera,039,155013,5418,5177,65,5242,54
2020-11-07,Marin,041,260295,7358,7215,22,7237,131
2020-11-07,Mariposa,043,17540,90,81,0,81,2
2020-11-07,Mendocino,045,87422,1204,1118,5,1123,22
2020-11-07,Merced,047,269075,10191,9855,56,9911,157
2020-11-07,Modoc,049,8938,70,51,12,63,0
2020-11-07,Mono,051,14174,458,352,8,360,2
2020-11-07,Monterey,053,433212,12662,12030,107,12137,98
2020-11-07,Napa,055,140530,2442,2260,9,2269,15
2020-11-07,Nevada,057,99092,814,710,22,732,9
2020-11-07,Orange,059,3164182,65170,62038,1969,64007,1505
2020-11-07,Placer,061,380077,5201,4745,31,4776,60
2020-11-07,Plumas,063,18699,127,94,0,94,0
2020-11-07,Riverside,065,2383286,74222,71153,814,71967,1345
2020-11-07,Sacramento,067,1510023,29283,27773,43,27816,515
2020-11-07,San Benito,069,59416,1559,1489,1,1490,15
2020-11-07,San Bernardino,071,2135413,72304,67935,608,68543,1182
2020-11-07,San Diego,073,3302833,63785,59682,1970,61652,909
2020-11-07,San Francisco,075,870044,13426,12980,62,13042,146
2020-11-07,San Joaquin,077,732212,23385,22517,312,22829,505
2020-11-07,San Luis Obispo,079,281455,5154,4668,55,4723,32
2020-11-07,San Mateo,081,765935,12349,11711,11,11722,169
2020-11-07,Santa Barbara,083,443738,10408,10157,140,10297,134
2020-11-07,Santa Clara,085,1922200,28311,26244,52,26296,410
2020-11-07,Santa Cruz,087,273765,3356,3130,36,3166,25
2020-11-07,Shasta,089,179085,3310,2547,42,2589,36
2020-11-07,Sierra,091,2930,10,7,0,7,0
2020-11-07,Siskiyou,093,43540,300,241,12,253,0
2020-11-07,Solano,095,438530,8494,8066,39,8105,85
2020-11-07,Sonoma,097,501317,10711,10200,35,10235,149
2020-11-07,Stanislaus,099,539301,18857,18386,914,19300,418
2020-11-07,Sutter,101,95872,2121,1973,3,1976,12
2020-11-07,Tehama,103,63373,1157,1043,2,1045,7
2020-11-07,Trinity,105,12862,146,42,14,56,0
2020-11-07,Tulare,107,460477,19034,18229,630,18859,304
2020-11-07,Tuolumne,109,53932,464,327,5,332,7
2020-11-07,Ventura,111,848112,16394,15364,443,15807,156
2020-11-07,Yolo,113,214977,3712,3486,10,3496,61
2020-11-07,Yuba,115,75493,1437,1349,5,1354,10
2020-11-06,Alameda,001,1643700,25509,24389,242,24631,420
2020-11-06,Alpine,003,1148,24,6,0,6,0
2020-11-06,Amador,005,37829,396,369,0,369,16
2020-11-06,Butte,007,227075,3429,3254,66,3320,57
2020-11-06,Calaveras,009,45235,365,359,0,359,21
2020-11-06,Colusa,011,21464,595,580,1,581,6
2020-11-06,Contra Costa,013,1133247,20678,19744,103,19847,252
2020-11-06,Del Norte,015,27424,203,194,0,194,2
2020-11-06,El Dorado,017,186661,1629,1475,16,1491,4
2020-11-06,Fresno,019,978130,35803,32278,636,32914,460
2020-11-06,Glenn,021,27897,756,707,7,714,3
2020-11-06,Humboldt,023,135768,637,587,1,588,9
2020-11-06,Imperial,025,180216,13748,13230,24,13254,338
2020-11-06,Inyo,027,18085,259,246,5,251,14
2020-11-06,Kern,029,883053,35646,34360,590,34950,443
2020-11-06,Kings,031,150075,9436,8883,71,8954,83
2020-11-06,Lake,033,64148,787,741,0,741,16
2020-11-06,Lassen,035,31185,852,794,2,796,0
2020-11-06,Los Angeles,037,10098052,325591,314356,3481,317837,7160
2020-11-06,Madera,039,155013,5402,5136,64,5200,54
2020-11-06,Marin,041,260295,7337,7184,22,7206,131
2020-11-06,Mariposa,043,17540,89,79,0,79,2
2020-11-06,Mendocino,045,87422,1199,1113,5,1118,22
2020-11-06,Merced,047,269075,10151,9778,53,9831,157
2020-11-06,Modoc,049,8938,70,48,12,60,0
2020-11-06,Mono,051,14174,452,308,8,316,1
2020-11-06,Monterey,053,433212,12545,11914,106,12020,96
2020-11-06,Napa,055,140530,2417,2189,9,2198,15
2020-11-06,Nevada,057,99092,801,692,21,713,9
2020-11-06,Orange,059,3164182,64867,61049,1959,63008,1494
2020-11-06,Placer,061,380077,5128,4680,31,4711,60
2020-11-06,Plumas,063,18699,122,90,0,90,0
2020-11-06,Riverside,065,2383286,73773,70409,773,71182,1341
2020-11-06,Sacramento,067,1510023,28991,27489,41,27530,514
2020-11-06,San Benito,069,59416,1550,1479,1,1480,15
2020-11-06,San Bernardino,071,2135413,71706,66740,588,67328,1179
2020-11-06,San Diego,073,3302833,63261,59143,1938,61081,907
2020-11-06,San Francisco,075,870044,13356,12825,61,12886,146
2020-11-06,San Joaquin,077,732212,23300,22424,302,22726,502
2020-11-06,San Luis Obispo,079,281455,5089,4531,49,4580,32
2020-11-06,San Mateo,081,765935,12274,11587,11,11598,168
2020-11-06,Santa Barbara,083,443738,10372,10118,136,10254,133
2020-11-06,Santa Clara,085,1922200,28069,25831,52,25883,402
2020-11-06,Santa Cruz,087,273765,3318,3063,36,3099,25
2020-11-06,Shasta,089,179085,3237,2475,41,2516,35
2020-11-06,Sierra,091,2930,9,7,0,7,0
2020-11-06,Siskiyou,093,43540,287,237,11,248,0
2020-11-06,Solano,095,438530,8429,7959,39,7998,85
2020-11-06,Sonoma,097,501317,10661,10142,35,10177,149
2020-11-06,Stanislaus,099,539301,18770,18250,906,19156,417
2020-11-06,Sutter,101,95872,2094,1937,2,1939,12
2020-11-06,Tehama,103,63373,1136,1024,2,1026,6
2020-11-06,Trinity,105,12862,143,41,14,55,0
2020-11-06,Tulare,107,460477,18970,18136,605,18741,300
2020-11-06,Tuolumne,109,53932,443,316,5,321,5
2020-11-06,Ventura,111,848112,16308,15222,440,15662,154
2020-11-06,Yolo,113,214977,3683,3420,10,3430,62
2020-11-06,Yuba,115,75493,1424,1335,5,1340,10
2020-11-05,Alameda,001,1643700,25333,24270,242,24512,420
2020-11-05,Alpine,003,1148,24,6,0,6,0
2020-11-05,Amador,005,37829,393,363,0,363,16
2020-11-05,Butte,007,227075,3406,3239,60,3299,57
2020-11-05,Calaveras,009,45235,357,333,0,333,19
2020-11-05,Colusa,011,21464,591,574,1,575,6
2020-11-05,Contra Costa,013,1133247,20496,19656,101,19757,252
2020-11-05,Del Norte,015,27424,201,192,0,192,2
2020-11-05,El Dorado,017,186661,1605,1466,16,1482,4
2020-11-05,Fresno,019,978130,35560,32056,612,32668,460
2020-11-05,Glenn,021,27897,736,702,7,709,3
2020-11-05,Humboldt,023,135768,627,581,1,582,9
2020-11-05,Imperial,025,180216,13656,13178,23,13201,337
2020-11-05,Inyo,027,18085,259,247,5,252,14
2020-11-05,Kern,029,883053,35445,34232,577,34809,443
2020-11-05,Kings,031,150075,9281,8846,68,8914,83
2020-11-05,Lake,033,64148,783,739,0,739,16
2020-11-05,Lassen,035,31185,821,782,2,784,0
2020-11-05,Los Angeles,037,10098052,323235,312381,3428,315809,7146
2020-11-05,Madera,039,155013,5363,5129,61,5190,54
2020-11-05,Marin,041,260295,7315,7171,22,7193,131
2020-11-05,Mariposa,043,17540,88,79,0,79,2
2020-11-05,Mendocino,045,87422,1187,1112,5,1117,22
2020-11-05,Merced,047,269075,10092,9753,48,9801,155
2020-11-05,Modoc,049,8938,69,47,11,58,0
2020-11-05,Mono,051,14174,450,307,8,315,1
2020-11-05,Monterey,053,433212,12435,11784,102,11886,96
2020-11-05,Napa,055,140530,2390,2158,9,2167,15
2020-11-05,Nevada,057,99092,779,687,20,707,9
2020-11-05,Orange,059,3164182,64420,60740,1949,62689,1484
2020-11-05,Placer,061,380077,5059,4627,26,4653,60
2020-11-05,Plumas,063,18699,114,90,0,90,0
2020-11-05,Riverside,065,2383286,73062,70094,717,70811,1338
2020-11-05,Sacramento,067,1510023,28610,27232,40,27272,512
2020-11-05,San Benito,069,59416,1535,1477,1,1478,15
2020-11-05,San Bernardino,071,2135413,70879,66407,576,66983,1174
2020-11-05,San Diego,073,3302833,62635,58659,1912,60571,904
2020-11-05,San Francisco,075,870044,13244,12726,60,12786,146
2020-11-05,San Joaquin,077,732212,23136,22318,298,22616,502
2020-11-05,San Luis Obispo,079,281455,5022,4459,47,4506,32
2020-11-05,San Mateo,081,765935,12180,11535,11,11546,168
2020-11-05,Santa Barbara,083,443738,10328,10080,133,10213,133
2020-11-05,Santa Clara,085,1922200,27802,25651,52,25703,402
2020-11-05,Santa Cruz,087,273765,3280,3023,36,3059,25
2020-11-05,Shasta,089,179085,3147,2401,40,2441,34
2020-11-05,Sierra,091,2930,9,6,0,6,0
2020-11-05,Siskiyou,093,43540,276,228,11,239,0
2020-11-05,Solano,095,438530,8346,7842,39,7881,85
2020-11-05,Sonoma,097,501317,10549,10064,34,10098,145
2020-11-05,Stanislaus,099,539301,18657,18194,893,19087,417
2020-11-05,Sutter,101,95872,2062,1925,2,1927,12
2020-11-05,Tehama,103,63373,1114,1015,2,1017,6
2020-11-05,Trinity,105,12862,127,41,14,55,0
2020-11-05,Tulare,107,460477,18881,18049,579,18628,301
2020-11-05,Tuolumne,109,53932,414,312,5,317,5
2020-11-05,Ventura,111,848112,16142,15113,429,15542,155
2020-11-05,Yolo,113,214977,3633,3391,10,3401,61
2020-11-05,Yuba,115,75493,1406,1322,5,1327,10
2020-11-04,Alameda,001,1643700,25156,24172,240,24412,418
2020-11-04,Alpine,003,1148,20,5,0,5,0
2020-11-04,Amador,005,37829,390,362,0,362,16
2020-11-04,Butte,007,227075,3381,3218,57,3275,57
2020-11-04,Calaveras,009,45235,354,290,0,290,19
2020-11-04,Colusa,011,21464,589,571,1,572,6
2020-11-04,Contra Costa,013,1133247,20329,19472,98,19570,251
2020-11-04,Del Norte,015,27424,197,188,0,188,2
2020-11-04,El Dorado,017,186661,1590,1448,13,1461,4
2020-11-04,Fresno,019,978130,35328,31952,584,32536,457
2020-11-04,Glenn,021,27897,732,701,6,707,3
2020-11-04,Humboldt,023,135768,618,571,1,572,9
2020-11-04,Imperial,025,180216,13558,13087,23,13110,335
2020-11-04,Inyo,027,18085,258,247,5,252,14
2020-11-04,Kern,029,883053,35290,34027,566,34593,439
2020-11-04,Kings,031,150075,9247,8817,66,8883,83
2020-11-04,Lake,033,64148,776,735,0,735,16
2020-11-04,Lassen,035,31185,816,781,2,783,0
2020-11-04,Los Angeles,037,10098052,320924,310456,3349,313805,7124
2020-11-04,Madera,039,155013,5343,5083,57,5140,54
2020-11-04,Marin,041,260295,7303,7157,22,7179,131
2020-11-04,Mariposa,043,17540,88,79,0,79,2
2020-11-04,Mendocino,045,87422,1169,1089,5,1094,22
2020-11-04,Merced,047,269075,10043,9717,46,9763,153
2020-11-04,Modoc,049,8938,59,47,11,58,0
2020-11-04,Mono,051,14174,447,237,7,244,1
2020-11-04,Monterey,053,433212,12231,11743,96,11839,96
2020-11-04,Napa,055,140530,2336,2133,9,2142,15
2020-11-04,Nevada,057,99092,760,675,20,695,9
2020-11-04,Orange,059,3164182,63986,60463,1928,62391,1483
2020-11-04,Placer,061,380077,4981,4526,23,4549,60
2020-11-04,Plumas,063,18699,112,88,0,88,0
2020-11-04,Riverside,065,2383286,72445,69562,658,70220,1335
2020-11-04,Sacramento,067,1510023,28260,27005,39,27044,510
2020-11-04,San Benito,069,59416,1520,1464,1,1465,15
2020-11-04,San Bernardino,071,2135413,70083,65891,553,66444,1169
2020-11-04,San Diego,073,3302833,61989,58126,1886,60012,904
2020-11-04,San Francisco,075,870044,13161,12649,57,12706,146
2020-11-04,San Joaquin,077,732212,22999,22197,285,22482,500
2020-11-04,San Luis Obispo,079,281455,4955,4389,45,4434,32
2020-11-04,San Mateo,081,765935,12086,11456,11,11467,168
2020-11-04,Santa Barbara,083,443738,10290,10026,132,10158,132
2020-11-04,Santa Clara,085,1922200,27540,25487,52,25539,393
2020-11-04,Santa Cruz,087,273765,3243,2997,36,3033,25
2020-11-04,Shasta,089,179085,3016,2321,35,2356,34
2020-11-04,Sierra,091,2930,9,6,0,6,0
2020-11-04,Siskiyou,093,43540,267,222,11,233,0
2020-11-04,Solano,095,438530,8247,7733,39,7772,85
2020-11-04,Sonoma,097,501317,10455,9965,34,9999,142
2020-11-04,Stanislaus,099,539301,18540,18114,878,18992,416
2020-11-04,Sutter,101,95872,2028,1916,2,1918,12
2020-11-04,Tehama,103,63373,1088,997,2,999,6
2020-11-04,Trinity,105,12862,123,37,14,51,0
2020-11-04,Tulare,107,460477,18771,17952,551,18503,298
2020-11-04,Tuolumne,109,53932,390,310,5,315,5
2020-11-04,Ventura,111,848112,16002,14936,426,15362,155
2020-11-04,Yolo,113,214977,3592,3361,10,3371,62
2020-11-04,Yuba,115,75493,1385,1312,5,1317,10
2020-11-03,Alameda,001,1643700,24972,24055,238,24293,418
2020-11-03,Alpine,003,1148,19,4,0,4,0
2020-11-03,Amador,005,37829,385,361,0,361,16
2020-11-03,Butte,007,227075,3357,3211,52,3263,57
2020-11-03,Calaveras,009,45235,350,287,0,287,19
2020-11-03,Colusa,011,21464,584,572,1,573,6
2020-11-03,Contra Costa,013,1133247,20174,19416,98,19514,250
2020-11-03,Del Norte,015,27424,196,187,0,187,2
2020-11-03,El Dorado,017,186661,1568,1445,12,1457,4
2020-11-03,Fresno,019,978130,35063,31856,561,32417,457
2020-11-03,Glenn,021,27897,726,698,6,704,3
2020-11-03,Humboldt,023,135768,612,570,1,571,8
2020-11-03,Imperial,025,180216,13469,13044,22,13066,335
2020-11-03,Inyo,027,18085,257,244,5,249,14
2020-11-03,Kern,029,883053,35099,33957,555,34512,439
2020-11-03,Kings,031,150075,9084,8783,61,8844,83
2020-11-03,Lake,033,64148,766,732,0,732,16
2020-11-03,Lassen,035,31185,807,782,2,784,0
2020-11-03,Los Angeles,037,10098052,318468,308812,3282,312094,7104
2020-11-03,Madera,039,155013,5306,5058,56,5114,54
2020-11-03,Marin,041,260295,7283,7147,21,7168,131
2020-11-03,Mariposa,043,17540,87,79,0,79,2
2020-11-03,Mendocino,045,87422,1154,1084,5,1089,22
2020-11-03,Merced,047,269075,9990,9713,45,9758,153
2020-11-03,Modoc,049,8938,57,47,9,56,0
2020-11-03,Mono,051,14174,443,210,7,217,1
2020-11-03,Monterey,053,433212,12162,11703,91,11794,94
2020-11-03,Napa,055,140530,2300,2130,9,2139,15
2020-11-03,Nevada,057,99092,740,670,19,689,9
2020-11-03,Orange,059,3164182,63556,60283,1916,62199,1477
2020-11-03,Placer,061,380077,4907,4514,23,4537,60
2020-11-03,Plumas,063,18699,109,86,0,86,0
2020-11-03,Riverside,065,2383286,71826,69300,633,69933,1325
2020-11-03,Sacramento,067,1510023,27880,26841,38,26879,510
2020-11-03,San Benito,069,59416,1510,1463,1,1464,15
2020-11-03,San Bernardino,071,2135413,69272,65320,546,65866,1159
2020-11-03,San Diego,073,3302833,61313,57722,1842,59564,901
2020-11-03,San Francisco,075,870044,13039,12585,57,12642,146
2020-11-03,San Joaquin,077,732212,22865,22109,279,22388,500
2020-11-03,San Luis Obispo,079,281455,4871,4371,43,4414,32
2020-11-03,San Mateo,081,765935,11991,11406,11,11417,162
2020-11-03,Santa Barbara,083,443738,10236,10008,128,10136,132
2020-11-03,Santa Clara,085,1922200,27268,25386,51,25437,393
2020-11-03,Santa Cruz,087,273765,3193,2980,35,3015,25
2020-11-03,Shasta,089,179085,2922,2288,28,2316,33
2020-11-03,Sierra,091,2930,7,6,0,6,0
2020-11-03,Siskiyou,093,43540,263,219,11,230,0
2020-11-03,Solano,095,438530,8164,7691,39,7730,85
2020-11-03,Sonoma,097,501317,10353,9906,34,9940,142
2020-11-03,Stanislaus,099,539301,18419,18080,867,18947,416
2020-11-03,Sutter,101,95872,1995,1914,2,1916,12
2020-11-03,Tehama,103,63373,1067,988,2,990,6
2020-11-03,Trinity,105,12862,116,36,13,49,0
2020-11-03,Tulare,107,460477,18665,17890,526,18416,297
2020-11-03,Tuolumne,109,53932,367,302,5,307,5
2020-11-03,Ventura,111,848112,15875,14816,419,15235,155
2020-11-03,Yolo,113,214977,3541,3343,10,3353,61
2020-11-03,Yuba,115,75493,1372,1295,5,1300,10
2020-11-02,Alameda,001,1643700,24776,23991,236,24227,419
2020-11-02,Alpine,003,1148,16,4,0,4,0
2020-11-02,Amador,005,37829,377,357,0,357,16
2020-11-02,Butte,007,227075,3337,3198,49,3247,57
2020-11-02,Calaveras,009,45235,350,282,0,282,18
2020-11-02,Colusa,011,21464,579,571,1,572,6
2020-11-02,Contra Costa,013,1133247,20021,19339,97,19436,250
2020-11-02,Del Norte,015,27424,193,175,0,175,2
2020-11-02,El Dorado,017,186661,1544,1405,12,1417,4
2020-11-02,Fresno,019,978130,34793,31738,544,32282,451
2020-11-02,Glenn,021,27897,720,692,5,697,3
2020-11-02,Humboldt,023,135768,603,569,1,570,8
2020-11-02,Imperial,025,180216,13389,13004,21,13025,334
2020-11-02,Inyo,027,18085,254,243,5,248,14
2020-11-02,Kern,029,883053,34941,33834,545,34379,437
2020-11-02,Kings,031,150075,9054,8654,58,8712,82
2020-11-02,Lake,033,64148,760,728,0,728,17
2020-11-02,Lassen,035,31185,799,782,2,784,0
2020-11-02,Los Angeles,037,10098052,316120,307620,3208,310828,7079
2020-11-02,Madera,039,155013,5275,5033,55,5088,54
2020-11-02,Marin,041,260295,7265,7132,20,7152,125
2020-11-02,Mariposa,043,17540,87,79,0,79,2
2020-11-02,Mendocino,045,87422,1140,1076,5,1081,21
2020-11-02,Merced,047,269075,9928,9664,39,9703,152
2020-11-02,Modoc,049,8938,54,45,5,50,0
2020-11-02,Mono,051,14174,441,211,7,218,1
2020-11-02,Monterey,053,433212,12055,11602,88,11690,93
2020-11-02,Napa,055,140530,2258,2081,9,2090,15
2020-11-02,Nevada,057,99092,724,656,19,675,9
2020-11-02,Orange,059,3164182,63151,59996,1901,61897,1474
2020-11-02,Placer,061,380077,4839,4461,21,4482,60
2020-11-02,Plumas,063,18699,101,86,0,86,0
2020-11-02,Riverside,065,2383286,71195,68833,592,69425,1321
2020-11-02,Sacramento,067,1510023,27538,26676,36,26712,508
2020-11-02,San Benito,069,59416,1498,1459,1,1460,15
2020-11-02,San Bernardino,071,2135413,68417,64629,535,65164,1157
2020-11-02,San Diego,073,3302833,60590,57429,1797,59226,891
2020-11-02,San Francisco,075,870044,12942,12436,56,12492,145
2020-11-02,San Joaquin,077,732212,22725,21919,271,22190,500
2020-11-02,San Luis Obispo,079,281455,4771,4303,40,4343,31
2020-11-02,San Mateo,081,765935,11882,11328,11,11339,161
2020-11-02,Santa Barbara,083,443738,10195,9985,123,10108,130
2020-11-02,Santa Clara,085,1922200,26979,25222,51,25273,387
2020-11-02,Santa Cruz,087,273765,3151,2943,35,2978,25
2020-11-02,Shasta,089,179085,2819,2174,24,2198,33
2020-11-02,Sierra,091,2930,7,6,0,6,0
2020-11-02,Siskiyou,093,43540,253,216,11,227,0
2020-11-02,Solano,095,438530,8046,7665,39,7704,84
2020-11-02,Sonoma,097,501317,10271,9796,33,9829,140
2020-11-02,Stanislaus,099,539301,18323,18005,858,18863,412
2020-11-02,Sutter,101,95872,1971,1895,2,1897,12
2020-11-02,Tehama,103,63373,1044,971,2,973,6
2020-11-02,Trinity,105,12862,110,30,13,43,0
2020-11-02,Tulare,107,460477,18572,17774,506,18280,299
2020-11-02,Tuolumne,109,53932,346,302,5,307,5
2020-11-02,Ventura,111,848112,15734,14767,405,15172,156
2020-11-02,Yolo,113,214977,3493,3318,10,3328,61
2020-11-02,Yuba,115,75493,1359,1280,5,1285,10
2020-11-01,Alameda,001,1643700,24613,23892,234,24126,419
2020-11-01,Alpine,003,1148,10,4,0,4,0
2020-11-01,Amador,005,37829,374,352,0,352,16
2020-11-01,Butte,007,227075,3314,3185,48,3233,57
2020-11-01,Calaveras,009,45235,349,282,0,282,18
2020-11-01,Colusa,011,21464,577,567,1,568,6
2020-11-01,Contra Costa,013,1133247,19848,19246,96,19342,250
2020-11-01,Del Norte,015,27424,189,175,0,175,2
2020-11-01,El Dorado,017,186661,1528,1394,12,1406,4
2020-11-01,Fresno,019,978130,34535,31613,524,32137,451
2020-11-01,Glenn,021,27897,711,688,3,691,3
2020-11-01,Humboldt,023,135768,595,568,1,569,8
2020-11-01,Imperial,025,180216,13298,12969,19,12988,334
2020-11-01,Inyo,027,18085,252,241,5,246,14
2020-11-01,Kern,029,883053,34760,33760,465,34225,437
2020-11-01,Kings,031,150075,9016,8641,57,8698,82
2020-11-01,Lake,033,64148,754,727,0,727,17
2020-11-01,Lassen,035,31185,799,782,2,784,0
2020-11-01,Los Angeles,037,10098052,313550,306217,3117,309334,7077
2020-11-01,Madera,039,155013,5227,5019,53,5072,54
2020-11-01,Marin,041,260295,7248,7124,20,7144,125
2020-11-01,Mariposa,043,17540,83,79,0,79,2
2020-11-01,Mendocino,045,87422,1126,1074,5,1079,21
2020-11-01,Merced,047,269075,9867,9626,39,9665,152
2020-11-01,Modoc,049,8938,53,45,5,50,0
2020-11-01,Mono,051,14174,412,211,6,217,1
2020-11-01,Monterey,053,433212,11948,11587,85,11672,93
2020-11-01,Napa,055,140530,2224,2067,9,2076,15
2020-11-01,Nevada,057,99092,708,646,18,664,9
2020-11-01,Orange,059,3164182,62749,59733,1875,61608,1475
2020-11-01,Placer,061,380077,4773,4422,20,4442,58
2020-11-01,Plumas,063,18699,96,86,0,86,0
2020-11-01,Riverside,065,2383286,70565,68493,557,69050,1319
2020-11-01,Sacramento,067,1510023,27217,26442,36,26478,508
2020-11-01,San Benito,069,59416,1483,1451,1,1452,15
2020-11-01,San Bernardino,071,2135413,67575,64339,514,64853,1157
2020-11-01,San Diego,073,3302833,59902,57122,1757,58879,891
2020-11-01,San Francisco,075,870044,12819,12436,51,12487,145
2020-11-01,San Joaquin,077,732212,22597,21919,265,22184,500
2020-11-01,San Luis Obispo,079,281455,4691,4303,39,4342,31
2020-11-01,San Mateo,081,765935,11801,11280,11,11291,160
2020-11-01,Santa Barbara,083,443738,10144,9969,107,10076,130
2020-11-01,Santa Clara,085,1922200,26700,25090,51,25141,386
2020-11-01,Santa Cruz,087,273765,3098,2921,35,2956,25
2020-11-01,Shasta,089,179085,2684,2172,23,2195,33
2020-11-01,Sierra,091,2930,7,6,0,6,0
2020-11-01,Siskiyou,093,43540,248,205,11,216,0
2020-11-01,Solano,095,438530,7956,7591,39,7630,84
2020-11-01,Sonoma,097,501317,10179,9688,33,9721,140
2020-11-01,Stanislaus,099,539301,18222,17961,839,18800,412
2020-11-01,Sutter,101,95872,1945,1888,1,1889,12
2020-11-01,Tehama,103,63373,1027,965,2,967,5
2020-11-01,Trinity,105,12862,108,30,12,42,0
2020-11-01,Tulare,107,460477,18460,17774,475,18249,299
2020-11-01,Tuolumne,109,53932,324,295,5,300,5
2020-11-01,Ventura,111,848112,15586,14686,377,15063,156
2020-11-01,Yolo,113,214977,3445,3303,10,3313,60
2020-11-01,Yuba,115,75493,1342,1273,5,1278,10
2020-10-31,Alameda,001,1643700,24497,23780,230,24010,416
2020-10-31,Alpine,003,1148,10,4,0,4,0
2020-10-31,Amador,005,37829,370,347,0,347,16
2020-10-31,Butte,007,227075,3301,3172,46,3218,57
2020-10-31,Calaveras,009,45235,349,280,0,280,18
2020-10-31,Colusa,011,21464,575,555,1,556,6
2020-10-31,Contra Costa,013,1133247,19743,19161,96,19257,249
2020-10-31,Del Norte,015,27424,188,175,0,175,2
2020-10-31,El Dorado,017,186661,1519,1390,12,1402,4
2020-10-31,Fresno,019,978130,34398,31558,521,32079,451
2020-10-31,Glenn,021,27897,709,678,3,681,3
2020-10-31,Humboldt,023,135768,592,561,1,562,8
2020-10-31,Imperial,025,180216,13256,12912,19,12931,334
2020-10-31,Inyo,027,18085,251,241,5,246,14
2020-10-31,Kern,029,883053,34657,33666,456,34122,437
2020-10-31,Kings,031,150075,8995,8612,56,8668,82
2020-10-31,Lake,033,64148,750,724,0,724,16
2020-10-31,Lassen,035,31185,794,782,2,784,0
2020-10-31,Los Angeles,037,10098052,312175,304704,3076,307780,7073
2020-10-31,Madera,039,155013,5209,5013,50,5063,54
2020-10-31,Marin,041,260295,7232,7112,20,7132,125
2020-10-31,Mariposa,043,17540,83,79,0,79,2
2020-10-31,Mendocino,045,87422,1118,1066,5,1071,21
2020-10-31,Merced,047,269075,9834,9597,38,9635,151
2020-10-31,Modoc,049,8938,52,34,4,38,0
2020-10-31,Mono,051,14174,263,194,5,199,1
2020-10-31,Monterey,053,433212,11880,11539,81,11620,93
2020-10-31,Napa,055,140530,2205,2040,9,2049,15
2020-10-31,Nevada,057,99092,690,644,18,662,9
2020-10-31,Orange,059,3164182,62490,59488,1857,61345,1473
2020-10-31,Placer,061,380077,4723,4374,19,4393,58
2020-10-31,Plumas,063,18699,95,85,0,85,0
2020-10-31,Riverside,065,2383286,70208,68178,534,68712,1319
2020-10-31,Sacramento,067,1510023,27018,26316,34,26350,507
2020-10-31,San Benito,069,59416,1476,1448,1,1449,15
2020-10-31,San Bernardino,071,2135413,67150,64016,504,64520,1157
2020-10-31,San Diego,073,3302833,59449,56769,1729,58498,891
2020-10-31,San Francisco,075,870044,12745,12438,50,12488,145
2020-10-31,San Joaquin,077,732212,22522,21918,256,22174,500
2020-10-31,San Luis Obispo,079,281455,4622,4285,36,4321,31
2020-10-31,San Mateo,081,765935,11750,11253,11,11264,160
2020-10-31,Santa Barbara,083,443738,10115,9957,99,10056,130
2020-10-31,Santa Clara,085,1922200,26532,24957,51,25008,379
2020-10-31,Santa Cruz,087,273765,3063,2895,34,2929,25
2020-10-31,Shasta,089,179085,2630,2122,22,2144,33
2020-10-31,Sierra,091,2930,7,6,0,6,0
2020-10-31,Siskiyou,093,43540,246,200,11,211,0
2020-10-31,Solano,095,438530,7892,7545,39,7584,84
2020-10-31,Sonoma,097,501317,10126,9648,33,9681,140
2020-10-31,Stanislaus,099,539301,18159,17920,823,18743,412
2020-10-31,Sutter,101,95872,1936,1876,1,1877,12
2020-10-31,Tehama,103,63373,1017,953,2,955,5
2020-10-31,Trinity,105,12862,105,30,12,42,0
2020-10-31,Tulare,107,460477,18411,17758,468,18226,299
2020-10-31,Tuolumne,109,53932,317,290,5,295,5
2020-10-31,Ventura,111,848112,15502,14635,359,14994,155
2020-10-31,Yolo,113,214977,3410,3290,10,3300,60
2020-10-31,Yuba,115,75493,1326,1260,4,1264,10
2020-10-30,Alameda,001,1643700,24418,23676,228,23904,401
2020-10-30,Alpine,003,1148,10,4,0,4,0
2020-10-30,Amador,005,37829,370,344,0,344,16
2020-10-30,Butte,007,227075,3296,3160,46,3206,57
2020-10-30,Calaveras,009,45235,348,279,0,279,18
2020-10-30,Colusa,011,21464,573,554,1,555,6
2020-10-30,Contra Costa,013,1133247,19671,19074,96,19170,249
2020-10-30,Del Norte,015,27424,187,175,0,175,2
2020-10-30,El Dorado,017,186661,1506,1386,12,1398,4
2020-10-30,Fresno,019,978130,34276,31409,513,31922,446
2020-10-30,Glenn,021,27897,703,674,2,676,3
2020-10-30,Humboldt,023,135768,591,561,1,562,7
2020-10-30,Imperial,025,180216,13215,12853,19,12872,334
2020-10-30,Inyo,027,18085,250,241,5,246,14
2020-10-30,Kern,029,883053,34564,33583,455,34038,437
2020-10-30,Kings,031,150075,8985,8564,54,8618,82
2020-10-30,Lake,033,64148,750,720,0,720,16
2020-10-30,Lassen,035,31185,788,777,2,779,0
2020-10-30,Los Angeles,037,10098052,310739,303425,3041,306466,7060
2020-10-30,Madera,039,155013,5197,4991,48,5039,54
2020-10-30,Marin,041,260295,7212,7097,20,7117,125
2020-10-30,Mariposa,043,17540,83,78,0,78,2
2020-10-30,Mendocino,045,87422,1116,1062,5,1067,21
2020-10-30,Merced,047,269075,9802,9539,38,9577,150
2020-10-30,Modoc,049,8938,51,34,3,37,0
2020-10-30,Mono,051,14174,262,193,5,198,1
2020-10-30,Monterey,053,433212,11817,11491,76,11567,92
2020-10-30,Napa,055,140530,2187,2028,9,2037,15
2020-10-30,Nevada,057,99092,684,634,18,652,9
2020-10-30,Orange,059,3164182,62249,59334,1845,61179,1469
2020-10-30,Placer,061,380077,4676,4335,19,4354,58
2020-10-30,Plumas,063,18699,92,80,0,80,0
2020-10-30,Riverside,065,2383286,69870,67752,514,68266,1317
2020-10-30,Sacramento,067,1510023,26870,26147,34,26181,505
2020-10-30,San Benito,069,59416,1470,1440,1,1441,15
2020-10-30,San Bernardino,071,2135413,66734,63512,501,64013,1156
2020-10-30,San Diego,073,3302833,59044,56387,1707,58094,888
2020-10-30,San Francisco,075,870044,12690,12384,50,12434,145
2020-10-30,San Joaquin,077,732212,22455,21849,250,22099,500
2020-10-30,San Luis Obispo,079,281455,4580,4256,36,4292,31
2020-10-30,San Mateo,081,765935,11691,11207,11,11218,159
2020-10-30,Santa Barbara,083,443738,10092,9937,99,10036,128
2020-10-30,Santa Clara,085,1922200,26384,24811,51,24862,378
2020-10-30,Santa Cruz,087,273765,3045,2874,34,2908,25
2020-10-30,Shasta,089,179085,2586,2048,21,2069,32
2020-10-30,Sierra,091,2930,7,6,0,6,0
2020-10-30,Siskiyou,093,43540,246,192,11,203,0
2020-10-30,Solano,095,438530,7831,7497,39,7536,84
2020-10-30,Sonoma,097,501317,10051,9602,33,9635,140
2020-10-30,Stanislaus,099,539301,18111,17861,808,18669,410
2020-10-30,Sutter,101,95872,1923,1860,1,1861,12
2020-10-30,Tehama,103,63373,1013,932,2,934,5
2020-10-30,Trinity,105,12862,105,29,12,41,0
2020-10-30,Tulare,107,460477,18367,17682,453,18135,299
2020-10-30,Tuolumne,109,53932,310,286,5,291,4
2020-10-30,Ventura,111,848112,15429,14578,348,14926,154
2020-10-30,Yolo,113,214977,3393,3263,10,3273,60
2020-10-30,Yuba,115,75493,1318,1256,4,1260,10
2020-10-29,Alameda,001,1643700,24255,23530,227,23757,401
2020-10-29,Alpine,003,1148,7,4,0,4,0
2020-10-29,Amador,005,37829,366,338,0,338,16
2020-10-29,Butte,007,227075,3278,3143,45,3188,57
2020-10-29,Calaveras,009,45235,346,278,0,278,13
2020-10-29,Colusa,011,21464,569,552,1,553,6
2020-10-29,Contra Costa,013,1133247,19574,18933,95,19028,249
2020-10-29,Del Norte,015,27424,185,174,0,174,2
2020-10-29,El Dorado,017,186661,1484,1370,12,1382,4
2020-10-29,Fresno,019,978130,34119,31321,506,31827,445
2020-10-29,Glenn,021,27897,701,673,2,675,3
2020-10-29,Humboldt,023,135768,586,559,1,560,7
2020-10-29,Imperial,025,180216,13171,12769,19,12788,334
2020-10-29,Inyo,027,18085,248,238,5,243,14
2020-10-29,Kern,029,883053,34463,33460,451,33911,437
2020-10-29,Kings,031,150075,8831,8502,53,8555,82
2020-10-29,Lake,033,64148,747,702,0,702,16
2020-10-29,Lassen,035,31185,787,772,2,774,0
2020-10-29,Los Angeles,037,10098052,309111,302246,2995,305241,7046
2020-10-29,Madera,039,155013,5167,4970,46,5016,53
2020-10-29,Marin,041,260295,7198,7083,20,7103,125
2020-10-29,Mariposa,043,17540,81,78,0,78,2
2020-10-29,Mendocino,045,87422,1110,1058,5,1063,21
2020-10-29,Merced,047,269075,9750,9496,38,9534,150
2020-10-29,Modoc,049,8938,49,31,3,34,0
2020-10-29,Mono,051,14174,255,176,5,181,1
2020-10-29,Monterey,053,433212,11736,11425,74,11499,92
2020-10-29,Napa,055,140530,2163,2009,9,2018,15
2020-10-29,Nevada,057,99092,677,632,18,650,9
2020-10-29,Orange,059,3164182,61981,59046,1825,60871,1464
2020-10-29,Placer,061,380077,4631,4270,18,4288,58
2020-10-29,Plumas,063,18699,90,69,0,69,0
2020-10-29,Riverside,065,2383286,69494,67268,484,67752,1304
2020-10-29,Sacramento,067,1510023,26657,25978,33,26011,507
2020-10-29,San Benito,069,59416,1465,1431,1,1432,15
2020-10-29,San Bernardino,071,2135413,66166,62968,491,63459,1150
2020-10-29,San Diego,073,3302833,58578,55916,1678,57594,885
2020-10-29,San Francisco,075,870044,12612,12312,50,12362,145
2020-10-29,San Joaquin,077,732212,22371,21736,238,21974,498
2020-10-29,San Luis Obispo,079,281455,4549,4223,35,4258,31
2020-10-29,San Mateo,081,765935,11646,11145,11,11156,157
2020-10-29,Santa Barbara,083,443738,10059,9902,97,9999,128
2020-10-29,Santa Clara,085,1922200,26233,24614,51,24665,377
2020-10-29,Santa Cruz,087,273765,3020,2850,34,2884,24
2020-10-29,Shasta,089,179085,2523,2008,21,2029,32
2020-10-29,Sierra,091,2930,6,6,0,6,0
2020-10-29,Siskiyou,093,43540,230,185,11,196,0
2020-10-29,Solano,095,438530,7769,7453,39,7492,78
2020-10-29,Sonoma,097,501317,9986,9533,33,9566,140
2020-10-29,Stanislaus,099,539301,18058,17790,787,18577,410
2020-10-29,Sutter,101,95872,1916,1852,1,1853,12
2020-10-29,Tehama,103,63373,995,925,2,927,5
2020-10-29,Trinity,105,12862,100,28,11,39,0
2020-10-29,Tulare,107,460477,18289,17627,435,18062,299
2020-10-29,Tuolumne,109,53932,305,279,5,284,4
2020-10-29,Ventura,111,848112,15338,14486,344,14830,154
2020-10-29,Yolo,113,214977,3364,3246,10,3256,60
2020-10-29,Yuba,115,75493,1307,1248,4,1252,10
2020-10-28,Alameda,001,1643700,24155,23468,226,23694,400
2020-10-28,Alpine,003,1148,6,4,0,4,0
2020-10-28,Amador,005,37829,363,337,0,337,16
2020-10-28,Butte,007,227075,3262,3134,42,3176,56
2020-10-28,Calaveras,009,45235,345,278,0,278,13
2020-10-28,Colusa,011,21464,566,551,1,552,6
2020-10-28,Contra Costa,013,1133247,19487,18828,94,18922,246
2020-10-28,Del Norte,015,27424,182,173,0,173,2
2020-10-28,El Dorado,017,186661,1472,1363,12,1375,4
2020-10-28,Fresno,019,978130,33998,31195,500,31695,444
2020-10-28,Glenn,021,27897,697,673,2,675,3
2020-10-28,Humboldt,023,135768,582,559,1,560,7
2020-10-28,Imperial,025,180216,13122,12730,19,12749,333
2020-10-28,Inyo,027,18085,248,238,5,243,14
2020-10-28,Kern,029,883053,34361,33424,433,33857,436
2020-10-28,Kings,031,150075,8809,8486,53,8539,82
2020-10-28,Lake,033,64148,744,700,0,700,15
2020-10-28,Lassen,035,31185,783,771,2,773,0
2020-10-28,Los Angeles,037,10098052,307655,300726,2953,303679,7031
2020-10-28,Madera,039,155013,5150,4954,45,4999,53
2020-10-28,Marin,041,260295,7187,7079,20,7099,126
2020-10-28,Mariposa,043,17540,81,78,0,78,2
2020-10-28,Mendocino,045,87422,1109,1037,5,1042,20
2020-10-28,Merced,047,269075,9724,9480,37,9517,150
2020-10-28,Modoc,049,8938,48,31,2,33,0
2020-10-28,Mono,051,14174,237,176,5,181,1
2020-10-28,Monterey,053,433212,11678,11330,72,11402,89
2020-10-28,Napa,055,140530,2137,1998,8,2006,15
2020-10-28,Nevada,057,99092,669,629,18,647,9
2020-10-28,Orange,059,3164182,61717,58801,1809,60610,1459
2020-10-28,Placer,061,380077,4575,4236,18,4254,57
2020-10-28,Plumas,063,18699,89,67,0,67,0
2020-10-28,Riverside,065,2383286,69096,67003,460,67463,1302
2020-10-28,Sacramento,067,1510023,26461,25838,32,25870,506
2020-10-28,San Benito,069,59416,1457,1429,1,1430,15
2020-10-28,San Bernardino,071,2135413,65707,62778,482,63260,1154
2020-10-28,San Diego,073,3302833,58195,55556,1649,57205,881
2020-10-28,San Francisco,075,870044,12554,12261,49,12310,145
2020-10-28,San Joaquin,077,732212,22287,21707,227,21934,498
2020-10-28,San Luis Obispo,079,281455,4505,4197,32,4229,31
2020-10-28,San Mateo,081,765935,11579,11101,11,11112,157
2020-10-28,Santa Barbara,083,443738,10036,9872,95,9967,127
2020-10-28,Santa Clara,085,1922200,26089,24503,51,24554,375
2020-10-28,Santa Cruz,087,273765,2989,2836,34,2870,24
2020-10-28,Shasta,089,179085,2443,1996,20,2016,31
2020-10-28,Sierra,091,2930,6,6,0,6,0
2020-10-28,Siskiyou,093,43540,227,182,10,192,0
2020-10-28,Solano,095,438530,7710,7362,39,7401,77
2020-10-28,Sonoma,097,501317,9896,9457,28,9485,140
2020-10-28,Stanislaus,099,539301,17993,17765,778,18543,409
2020-10-28,Sutter,101,95872,1907,1840,1,1841,12
2020-10-28,Tehama,103,63373,984,921,2,923,5
2020-10-28,Trinity,105,12862,93,28,10,38,0
2020-10-28,Tulare,107,460477,18232,17569,420,17989,297
2020-10-28,Tuolumne,109,53932,302,277,5,282,4
2020-10-28,Ventura,111,848112,15265,14409,335,14744,153
2020-10-28,Yolo,113,214977,3339,3230,10,3240,60
2020-10-28,Yuba,115,75493,1295,1245,4,1249,10
2020-10-27,Alameda,001,1643700,24040,23365,224,23589,400
2020-10-27,Alpine,003,1148,6,3,0,3,0
2020-10-27,Amador,005,37829,360,335,0,335,16
2020-10-27,Butte,007,227075,3246,3107,39,3146,56
2020-10-27,Calaveras,009,45235,343,277,0,277,13
2020-10-27,Colusa,011,21464,561,549,1,550,6
2020-10-27,Contra Costa,013,1133247,19381,18766,94,18860,246
2020-10-27,Del Norte,015,27424,179,173,0,173,2
2020-10-27,El Dorado,017,186661,1459,1351,12,1363,4
2020-10-27,Fresno,019,978130,33879,31096,495,31591,442
2020-10-27,Glenn,021,27897,695,667,1,668,3
2020-10-27,Humboldt,023,135768,579,559,1,560,7
2020-10-27,Imperial,025,180216,13073,12680,19,12699,333
2020-10-27,Inyo,027,18085,248,231,5,236,14
2020-10-27,Kern,029,883053,34244,33328,429,33757,436
2020-10-27,Kings,031,150075,8778,8411,53,8464,83
2020-10-27,Lake,033,64148,741,700,0,700,15
2020-10-27,Lassen,035,31185,781,764,2,766,0
2020-10-27,Los Angeles,037,10098052,306267,299438,2924,302362,7008
2020-10-27,Madera,039,155013,5120,4942,44,4986,53
2020-10-27,Marin,041,260295,7171,7070,20,7090,126
2020-10-27,Mariposa,043,17540,80,78,0,78,2
2020-10-27,Mendocino,045,87422,1103,1033,4,1037,20
2020-10-27,Merced,047,269075,9683,9449,37,9486,150
2020-10-27,Modoc,049,8938,46,31,2,33,0
2020-10-27,Mono,051,14174,223,169,5,174,1
2020-10-27,Monterey,053,433212,11622,11261,70,11331,88
2020-10-27,Napa,055,140530,2121,1979,8,1987,15
2020-10-27,Nevada,057,99092,663,622,18,640,8
2020-10-27,Orange,059,3164182,61446,58550,1793,60343,1448
2020-10-27,Placer,061,380077,4526,4197,16,4213,57
2020-10-27,Plumas,063,18699,86,63,0,63,0
2020-10-27,Riverside,065,2383286,68743,66699,415,67114,1299
2020-10-27,Sacramento,067,1510023,26274,25701,31,25732,501
2020-10-27,San Benito,069,59416,1452,1428,1,1429,15
2020-10-27,San Bernardino,071,2135413,65245,62357,469,62826,1154
2020-10-27,San Diego,073,3302833,57722,55226,1626,56852,877
2020-10-27,San Francisco,075,870044,12479,12218,48,12266,140
2020-10-27,San Joaquin,077,732212,22196,21637,218,21855,496
2020-10-27,San Luis Obispo,079,281455,4478,4148,28,4176,31
2020-10-27,San Mateo,081,765935,11531,11074,11,11085,156
2020-10-27,Santa Barbara,083,443738,10006,9874,94,9968,125
2020-10-27,Santa Clara,085,1922200,25947,24368,51,24419,367
2020-10-27,Santa Cruz,087,273765,2959,2815,33,2848,24
2020-10-27,Shasta,089,179085,2357,1962,20,1982,29
2020-10-27,Sierra,091,2930,6,6,0,6,0
2020-10-27,Siskiyou,093,43540,218,181,10,191,0
2020-10-27,Solano,095,438530,7641,7298,39,7337,77
2020-10-27,Sonoma,097,501317,9829,9389,28,9417,140
2020-10-27,Stanislaus,099,539301,17925,17720,771,18491,408
2020-10-27,Sutter,101,95872,1894,1832,1,1833,12
2020-10-27,Tehama,103,63373,970,913,2,915,5
2020-10-27,Trinity,105,12862,90,28,10,38,0
2020-10-27,Tulare,107,460477,18169,17520,397,17917,296
2020-10-27,Tuolumne,109,53932,298,275,5,280,4
2020-10-27,Ventura,111,848112,15182,14347,328,14675,153
2020-10-27,Yolo,113,214977,3326,3216,10,3226,58
2020-10-27,Yuba,115,75493,1282,1235,4,1239,10
2020-10-26,Alameda,001,1643700,23927,23284,223,23507,398
2020-10-26,Alpine,003,1148,4,3,0,3,0
2020-10-26,Amador,005,37829,356,331,0,331,16
2020-10-26,Butte,007,227075,3235,3095,37,3132,56
2020-10-26,Calaveras,009,45235,340,274,0,274,13
2020-10-26,Colusa,011,21464,559,548,1,549,6
2020-10-26,Contra Costa,013,1133247,19286,18718,93,18811,245
2020-10-26,Del Norte,015,27424,179,171,0,171,2
2020-10-26,El Dorado,017,186661,1445,1336,12,1348,4
2020-10-26,Fresno,019,978130,33766,30969,488,31457,441
2020-10-26,Glenn,021,27897,688,660,1,661,3
2020-10-26,Humboldt,023,135768,571,554,1,555,7
2020-10-26,Imperial,025,180216,13019,12654,16,12670,333
2020-10-26,Inyo,027,18085,248,226,5,231,14
2020-10-26,Kern,029,883053,34160,33233,424,33657,432
2020-10-26,Kings,031,150075,8757,8264,51,8315,82
2020-10-26,Lake,033,64148,739,697,0,697,15
2020-10-26,Lassen,035,31185,778,764,2,766,0
2020-10-26,Los Angeles,037,10098052,304840,297961,2883,300844,6979
2020-10-26,Madera,039,155013,5099,4922,43,4965,53
2020-10-26,Marin,041,260295,7165,7064,19,7083,104
2020-10-26,Mariposa,043,17540,80,77,0,77,2
2020-10-26,Mendocino,045,87422,1095,1026,4,1030,20
2020-10-26,Merced,047,269075,9636,9375,36,9411,150
2020-10-26,Modoc,049,8938,44,28,0,28,0
2020-10-26,Mono,051,14174,217,167,5,172,1
2020-10-26,Monterey,053,433212,11571,11207,66,11273,87
2020-10-26,Napa,055,140530,2089,1966,8,1974,14
2020-10-26,Nevada,057,99092,656,618,18,636,8
2020-10-26,Orange,059,3164182,61242,58377,1775,60152,1442
2020-10-26,Placer,061,380077,4484,4161,15,4176,57
2020-10-26,Plumas,063,18699,84,63,0,63,0
2020-10-26,Riverside,065,2383286,68292,66475,389,66864,1294
2020-10-26,Sacramento,067,1510023,26093,25555,29,25584,496
2020-10-26,San Benito,069,59416,1444,1424,1,1425,15
2020-10-26,San Bernardino,071,2135413,64774,61871,466,62337,1153
2020-10-26,San Diego,073,3302833,57329,54957,1588,56545,870
2020-10-26,San Francisco,075,870044,12419,12072,48,12120,138
2020-10-26,San Joaquin,077,732212,22113,21459,212,21671,495
2020-10-26,San Luis Obispo,079,281455,4452,4133,28,4161,31
2020-10-26,San Mateo,081,765935,11487,11037,11,11048,156
2020-10-26,Santa Barbara,083,443738,9983,9827,94,9921,122
2020-10-26,Santa Clara,085,1922200,25757,24258,50,24308,365
2020-10-26,Santa Cruz,087,273765,2933,2808,33,2841,24
2020-10-26,Shasta,089,179085,2303,1889,20,1909,29
2020-10-26,Sierra,091,2930,6,6,0,6,0
2020-10-26,Siskiyou,093,43540,210,179,10,189,0
2020-10-26,Solano,095,438530,7561,7271,39,7310,62
2020-10-26,Sonoma,097,501317,9752,9315,28,9343,140
2020-10-26,Stanislaus,099,539301,17875,17666,761,18427,400
2020-10-26,Sutter,101,95872,1886,1817,1,1818,12
2020-10-26,Tehama,103,63373,950,892,2,894,5
2020-10-26,Trinity,105,12862,89,26,10,36,0
2020-10-26,Tulare,107,460477,18092,17432,374,17806,296
2020-10-26,Tuolumne,109,53932,289,271,5,276,4
2020-10-26,Ventura,111,848112,15113,14330,325,14655,154
2020-10-26,Yolo,113,214977,3307,3206,10,3216,58
2020-10-26,Yuba,115,75493,1266,1226,4,1230,10
2020-10-25,Alameda,001,1643700,23820,23192,223,23415,398
2020-10-25,Alpine,003,1148,3,3,0,3,0
2020-10-25,Amador,005,37829,345,330,0,330,16
2020-10-25,Butte,007,227075,3215,3087,37,3124,56
2020-10-25,Calaveras,009,45235,339,274,0,274,13
2020-10-25,Colusa,011,21464,555,548,1,549,6
2020-10-25,Contra Costa,013,1133247,19183,18640,93,18733,245
2020-10-25,Del Norte,015,27424,175,171,0,171,2
2020-10-25,El Dorado,017,186661,1430,1328,12,1340,4
2020-10-25,Fresno,019,978130,33632,30858,475,31333,441
2020-10-25,Glenn,021,27897,685,652,1,653,3
2020-10-25,Humboldt,023,135768,568,554,1,555,7
2020-10-25,Imperial,025,180216,12970,12572,16,12588,333
2020-10-25,Inyo,027,18085,245,226,5,231,14
2020-10-25,Kern,029,883053,34053,33185,420,33605,432
2020-10-25,Kings,031,150075,8724,8246,49,8295,82
2020-10-25,Lake,033,64148,722,695,0,695,15
2020-10-25,Lassen,035,31185,776,764,2,766,0
2020-10-25,Los Angeles,037,10098052,303275,297110,2847,299957,6973
2020-10-25,Madera,039,155013,5069,4909,38,4947,53
2020-10-25,Marin,041,260295,7155,7052,19,7071,102
2020-10-25,Mariposa,043,17540,80,77,0,77,2
2020-10-25,Mendocino,045,87422,1088,1024,4,1028,20
2020-10-25,Merced,047,269075,9571,9352,34,9386,150
2020-10-25,Modoc,049,8938,39,28,0,28,0
2020-10-25,Mono,051,14174,209,167,5,172,1
2020-10-25,Monterey,053,433212,11488,11182,61,11243,87
2020-10-25,Napa,055,140530,2059,1962,8,1970,14
2020-10-25,Nevada,057,99092,648,616,18,634,8
2020-10-25,Orange,059,3164182,60954,58185,1766,59951,1443
2020-10-25,Placer,061,380077,4432,4140,15,4155,57
2020-10-25,Plumas,063,18699,84,63,0,63,0
2020-10-25,Riverside,065,2383286,67841,66192,373,66565,1289
2020-10-25,Sacramento,067,1510023,25878,25445,27,25472,496
2020-10-25,San Benito,069,59416,1437,1423,1,1424,15
2020-10-25,San Bernardino,071,2135413,64234,61551,454,62005,1153
2020-10-25,San Diego,073,3302833,56866,54599,1556,56155,870
2020-10-25,San Francisco,075,870044,12346,12072,48,12120,137
2020-10-25,San Joaquin,077,732212,22005,21459,204,21663,495
2020-10-25,San Luis Obispo,079,281455,4410,4126,26,4152,31
2020-10-25,San Mateo,081,765935,11442,10987,11,10998,156
2020-10-25,Santa Barbara,083,443738,9964,9814,94,9908,122
2020-10-25,Santa Clara,085,1922200,25569,24087,50,24137,365
2020-10-25,Santa Cruz,087,273765,2906,2789,33,2822,24
2020-10-25,Shasta,089,179085,2239,1889,20,1909,29
2020-10-25,Sierra,091,2930,6,6,0,6,0
2020-10-25,Siskiyou,093,43540,207,176,10,186,0
2020-10-25,Solano,095,438530,7483,7197,39,7236,60
2020-10-25,Sonoma,097,501317,9659,9235,27,9262,140
2020-10-25,Stanislaus,099,539301,17818,17641,752,18393,400
2020-10-25,Sutter,101,95872,1868,1811,1,1812,12
2020-10-25,Tehama,103,63373,933,880,2,882,5
2020-10-25,Trinity,105,12862,85,26,10,36,0
2020-10-25,Tulare,107,460477,18018,17431,364,17795,296
2020-10-25,Tuolumne,109,53932,284,271,5,276,4
2020-10-25,Ventura,111,848112,15020,14300,319,14619,154
2020-10-25,Yolo,113,214977,3286,3190,10,3200,58
2020-10-25,Yuba,115,75493,1258,1219,4,1223,10
2020-10-24,Alameda,001,1643700,23749,23099,220,23319,398
2020-10-24,Alpine,003,1148,3,3,0,3,0
2020-10-24,Amador,005,37829,344,328,0,328,16
2020-10-24,Butte,007,227075,3206,3078,37,3115,56
2020-10-24,Calaveras,009,45235,337,274,0,274,13
2020-10-24,Colusa,011,21464,550,548,1,549,6
2020-10-24,Contra Costa,013,1133247,19116,18567,93,18660,244
2020-10-24,Del Norte,015,27424,174,171,0,171,2
2020-10-24,El Dorado,017,186661,1414,1317,12,1329,4
2020-10-24,Fresno,019,978130,33571,30752,470,31222,441
2020-10-24,Glenn,021,27897,682,650,1,651,3
2020-10-24,Humboldt,023,135768,566,553,1,554,7
2020-10-24,Imperial,025,180216,12943,12469,16,12485,333
2020-10-24,Inyo,027,18085,245,226,5,231,14
2020-10-24,Kern,029,883053,33995,33105,415,33520,432
2020-10-24,Kings,031,150075,8714,8228,48,8276,82
2020-10-24,Lake,033,64148,717,696,0,696,15
2020-10-24,Lassen,035,31185,775,764,2,766,0
2020-10-24,Los Angeles,037,10098052,302457,296323,2825,299148,6969
2020-10-24,Madera,039,155013,5056,4898,37,4935,53
2020-10-24,Marin,041,260295,7146,7042,19,7061,102
2020-10-24,Mariposa,043,17540,80,77,0,77,2
2020-10-24,Mendocino,045,87422,1076,1022,4,1026,20
2020-10-24,Merced,047,269075,9547,9351,34,9385,150
2020-10-24,Modoc,049,8938,38,28,0,28,0
2020-10-24,Mono,051,14174,195,167,5,172,1
2020-10-24,Monterey,053,433212,11419,11153,60,11213,87
2020-10-24,Napa,055,140530,2042,1957,8,1965,14
2020-10-24,Nevada,057,99092,644,608,18,626,8
2020-10-24,Orange,059,3164182,60799,57928,1756,59684,1441
2020-10-24,Placer,061,380077,4401,4093,15,4108,57
2020-10-24,Plumas,063,18699,78,63,0,63,0
2020-10-24,Riverside,065,2383286,67633,65902,359,66261,1288
2020-10-24,Sacramento,067,1510023,25797,25372,27,25399,496
2020-10-24,San Benito,069,59416,1432,1417,1,1418,15
2020-10-24,San Bernardino,071,2135413,63995,61351,446,61797,1153
2020-10-24,San Diego,073,3302833,56589,54330,1543,55873,868
2020-10-24,San Francisco,075,870044,12288,12073,47,12120,137
2020-10-24,San Joaquin,077,732212,21952,21458,199,21657,495
2020-10-24,San Luis Obispo,079,281455,4387,4119,25,4144,31
2020-10-24,San Mateo,081,765935,11403,10942,11,10953,155
2020-10-24,Santa Barbara,083,443738,9947,9781,94,9875,122
2020-10-24,Santa Clara,085,1922200,25482,23978,50,24028,365
2020-10-24,Santa Cruz,087,273765,2887,2775,33,2808,24
2020-10-24,Shasta,089,179085,2194,1878,20,1898,29
2020-10-24,Sierra,091,2930,6,6,0,6,0
2020-10-24,Siskiyou,093,43540,206,174,10,184,0
2020-10-24,Solano,095,438530,7430,7189,39,7228,60
2020-10-24,Sonoma,097,501317,9625,9179,27,9206,140
2020-10-24,Stanislaus,099,539301,17775,17574,737,18311,400
2020-10-24,Sutter,101,95872,1859,1804,1,1805,12
2020-10-24,Tehama,103,63373,925,872,2,874,5
2020-10-24,Trinity,105,12862,85,25,10,35,0
2020-10-24,Tulare,107,460477,17995,17406,353,17759,295
2020-10-24,Tuolumne,109,53932,281,269,5,274,4
2020-10-24,Ventura,111,848112,14967,14240,318,14558,154
2020-10-24,Yolo,113,214977,3274,3164,10,3174,57
2020-10-24,Yuba,115,75493,1255,1210,4,1214,10
2020-10-23,Alameda,001,1643700,23676,23047,218,23265,393
2020-10-23,Alpine,003,1148,3,3,0,3,0
2020-10-23,Amador,005,37829,343,324,0,324,16
2020-10-23,Butte,007,227075,3197,3059,37,3096,55
2020-10-23,Calaveras,009,45235,336,273,0,273,13
2020-10-23,Colusa,011,21464,550,547,1,548,6
2020-10-23,Contra Costa,013,1133247,19046,18483,92,18575,244
2020-10-23,Del Norte,015,27424,174,171,0,171,2
2020-10-23,El Dorado,017,186661,1405,1310,12,1322,4
2020-10-23,Fresno,019,978130,33504,30590,467,31057,441
2020-10-23,Glenn,021,27897,679,644,1,645,3
2020-10-23,Humboldt,023,135768,564,553,1,554,7
2020-10-23,Imperial,025,180216,12912,12398,15,12413,333
2020-10-23,Inyo,027,18085,244,226,5,231,14
2020-10-23,Kern,029,883053,33927,33077,410,33487,431
2020-10-23,Kings,031,150075,8705,8218,48,8266,82
2020-10-23,Lake,033,64148,715,689,0,689,15
2020-10-23,Lassen,035,31185,774,764,2,766,0
2020-10-23,Los Angeles,037,10098052,301373,294287,2797,297084,6956
2020-10-23,Madera,039,155013,5051,4888,37,4925,53
2020-10-23,Marin,041,260295,7133,7029,19,7048,102
2020-10-23,Mariposa,043,17540,80,77,0,77,2
2020-10-23,Mendocino,045,87422,1073,1019,4,1023,20
2020-10-23,Merced,047,269075,9533,9327,34,9361,149
2020-10-23,Modoc,049,8938,38,28,0,28,0
2020-10-23,Mono,051,14174,194,159,5,164,1
2020-10-23,Monterey,053,433212,11372,11099,56,11155,86
2020-10-23,Napa,055,140530,2034,1942,8,1950,14
2020-10-23,Nevada,057,99092,641,604,18,622,8
2020-10-23,Orange,059,3164182,60629,57595,1741,59336,1430
2020-10-23,Placer,061,380077,4354,4073,15,4088,57
2020-10-23,Plumas,063,18699,75,63,0,63,0
2020-10-23,Riverside,065,2383286,67394,65512,351,65863,1279
2020-10-23,Sacramento,067,1510023,25692,25224,27,25251,496
2020-10-23,San Benito,069,59416,1430,1412,1,1413,15
2020-10-23,San Bernardino,071,2135413,63709,60854,432,61286,1150
2020-10-23,San Diego,073,3302833,56283,53944,1516,55460,867
2020-10-23,San Francisco,075,870044,12257,12015,47,12062,137
2020-10-23,San Joaquin,077,732212,21896,21361,193,21554,495
2020-10-23,San Luis Obispo,079,281455,4362,4102,25,4127,31
2020-10-23,San Mateo,081,765935,11354,10872,11,10883,155
2020-10-23,Santa Barbara,083,443738,9931,9751,94,9845,121
2020-10-23,Santa Clara,085,1922200,25380,23822,50,23872,364
2020-10-23,Santa Cruz,087,273765,2873,2757,33,2790,24
2020-10-23,Shasta,089,179085,2157,1846,19,1865,29
2020-10-23,Sierra,091,2930,6,6,0,6,0
2020-10-23,Siskiyou,093,43540,202,172,10,182,0
2020-10-23,Solano,095,438530,7399,7174,39,7213,59
2020-10-23,Sonoma,097,501317,9568,9112,27,9139,139
2020-10-23,Stanislaus,099,539301,17738,17496,730,18226,395
2020-10-23,Sutter,101,95872,1852,1797,1,1798,12
2020-10-23,Tehama,103,63373,916,862,2,864,5
2020-10-23,Trinity,105,12862,85,26,10,36,0
2020-10-23,Tulare,107,460477,17950,17334,342,17676,295
2020-10-23,Tuolumne,109,53932,279,254,5,259,4
2020-10-23,Ventura,111,848112,14938,14192,318,14510,155
2020-10-23,Yolo,113,214977,3262,3140,10,3150,57
2020-10-23,Yuba,115,75493,1251,1206,4,1210,10
2020-10-22,Alameda,001,1643700,23575,22915,218,23133,393
2020-10-22,Alpine,003,1148,3,3,0,3,0
2020-10-22,Amador,005,37829,339,317,0,317,16
2020-10-22,Butte,007,227075,3187,3046,35,3081,55
2020-10-22,Calaveras,009,45235,333,273,0,273,13
2020-10-22,Colusa,011,21464,550,547,1,548,6
2020-10-22,Contra Costa,013,1133247,18975,18393,92,18485,243
2020-10-22,Del Norte,015,27424,173,168,0,168,2
2020-10-22,El Dorado,017,186661,1395,1308,12,1320,4
2020-10-22,Fresno,019,978130,33394,30471,459,30930,438
2020-10-22,Glenn,021,27897,672,643,1,644,3
2020-10-22,Humboldt,023,135768,562,548,1,549,7
2020-10-22,Imperial,025,180216,12859,12311,15,12326,333
2020-10-22,Inyo,027,18085,241,220,5,225,14
2020-10-22,Kern,029,883053,33846,32991,407,33398,431
2020-10-22,Kings,031,150075,8454,8201,48,8249,82
2020-10-22,Lake,033,64148,711,678,0,678,15
2020-10-22,Lassen,035,31185,771,764,2,766,0
2020-10-22,Los Angeles,037,10098052,299995,291599,2741,294340,6935
2020-10-22,Madera,039,155013,5030,4847,37,4884,52
2020-10-22,Marin,041,260295,7126,7014,19,7033,102
2020-10-22,Mariposa,043,17540,80,77,0,77,2
2020-10-22,Mendocino,045,87422,1068,1016,4,1020,20
2020-10-22,Merced,047,269075,9505,9323,34,9357,149
2020-10-22,Modoc,049,8938,34,26,0,26,0
2020-10-22,Mono,051,14174,189,156,5,161,1
2020-10-22,Monterey,053,433212,11313,11059,53,11112,84
2020-10-22,Napa,055,140530,2019,1928,8,1936,14
2020-10-22,Nevada,057,99092,635,600,18,618,8
2020-10-22,Orange,059,3164182,60414,57418,1724,59142,1422
2020-10-22,Placer,061,380077,4305,4036,15,4051,57
2020-10-22,Plumas,063,18699,72,62,0,62,0
2020-10-22,Riverside,065,2383286,67059,65104,333,65437,1279
2020-10-22,Sacramento,067,1510023,25552,25054,27,25081,492
2020-10-22,San Benito,069,59416,1426,1403,1,1404,15
2020-10-22,San Bernardino,071,2135413,63307,60402,417,60819,1149
2020-10-22,San Diego,073,3302833,55896,53514,1497,55011,866
2020-10-22,San Francisco,075,870044,12199,11991,45,12036,137
2020-10-22,San Joaquin,077,732212,21823,21282,187,21469,495
2020-10-22,San Luis Obispo,079,281455,4346,4081,25,4106,31
2020-10-22,San Mateo,081,765935,11298,10796,11,10807,155
2020-10-22,Santa Barbara,083,443738,9897,9710,92,9802,120
2020-10-22,Santa Clara,085,1922200,25226,23621,50,23671,363
2020-10-22,Santa Cruz,087,273765,2855,2738,32,2770,24
2020-10-22,Shasta,089,179085,2111,1799,19,1818,29
2020-10-22,Sierra,091,2930,6,6,0,6,0
2020-10-22,Siskiyou,093,43540,201,169,10,179,0
2020-10-22,Solano,095,438530,7353,7116,39,7155,59
2020-10-22,Sonoma,097,501317,9502,9052,26,9078,139
2020-10-22,Stanislaus,099,539301,17684,17440,718,18158,395
2020-10-22,Sutter,101,95872,1838,1794,1,1795,12
2020-10-22,Tehama,103,63373,905,852,2,854,5
2020-10-22,Trinity,105,12862,84,26,10,36,0
2020-10-22,Tulare,107,460477,17884,17265,329,17594,293
2020-10-22,Tuolumne,109,53932,277,252,5,257,4
2020-10-22,Ventura,111,848112,14891,14124,316,14440,154
2020-10-22,Yolo,113,214977,3250,3116,10,3126,58
2020-10-22,Yuba,115,75493,1244,1199,3,1202,10
2020-10-21,Alameda,001,1643700,23487,22853,216,23069,392
2020-10-21,Alpine,003,1148,3,3,0,3,0
2020-10-21,Amador,005,37829,334,313,0,313,16
2020-10-21,Butte,007,227075,3175,3041,35,3076,55
2020-10-21,Calaveras,009,45235,332,272,0,272,13
2020-10-21,Colusa,011,21464,550,546,1,547,6
2020-10-21,Contra Costa,013,1133247,18901,18299,92,18391,243
2020-10-21,Del Norte,015,27424,173,169,0,169,2
2020-10-21,El Dorado,017,186661,1383,1305,11,1316,4
2020-10-21,Fresno,019,978130,33299,30328,454,30782,433
2020-10-21,Glenn,021,27897,667,640,1,641,3
2020-10-21,Humboldt,023,135768,561,548,1,549,7
2020-10-21,Imperial,025,180216,12802,12210,15,12225,331
2020-10-21,Inyo,027,18085,237,220,5,225,14
2020-10-21,Kern,029,883053,33771,32956,405,33361,430
2020-10-21,Kings,031,150075,8427,8186,48,8234,80
2020-10-21,Lake,033,64148,710,676,0,676,15
2020-10-21,Lassen,035,31185,770,764,2,766,0
2020-10-21,Los Angeles,037,10098052,298654,288096,2699,290795,6923
2020-10-21,Madera,039,155013,5005,4831,37,4868,52
2020-10-21,Marin,041,260295,7117,7002,19,7021,102
2020-10-21,Mariposa,043,17540,80,77,0,77,2
2020-10-21,Mendocino,045,87422,1066,1011,4,1015,21
2020-10-21,Merced,047,269075,9481,9319,32,9351,149
2020-10-21,Modoc,049,8938,33,26,0,26,0
2020-10-21,Mono,051,14174,187,156,5,161,1
2020-10-21,Monterey,053,433212,11275,11005,52,11057,83
2020-10-21,Napa,055,140530,2004,1918,8,1926,13
2020-10-21,Nevada,057,99092,629,597,18,615,8
2020-10-21,Orange,059,3164182,60202,57189,1715,58904,1409
2020-10-21,Placer,061,380077,4268,4007,15,4022,56
2020-10-21,Plumas,063,18699,69,58,0,58,0
2020-10-21,Riverside,065,2383286,66763,64778,309,65087,1278
2020-10-21,Sacramento,067,1510023,25359,24908,27,24935,490
2020-10-21,San Benito,069,59416,1425,1401,1,1402,14
2020-10-21,San Bernardino,071,2135413,62897,59948,410,60358,1141
2020-10-21,San Diego,073,3302833,55544,53279,1469,54748,863
2020-10-21,San Francisco,075,870044,12150,11976,44,12020,137
2020-10-21,San Joaquin,077,732212,21747,21201,181,21382,495
2020-10-21,San Luis Obispo,079,281455,4319,4055,23,4078,31
2020-10-21,San Mateo,081,765935,11249,10730,11,10741,155
2020-10-21,Santa Barbara,083,443738,9880,9681,91,9772,121
2020-10-21,Santa Clara,085,1922200,25100,23537,50,23587,361
2020-10-21,Santa Cruz,087,273765,2832,2729,32,2761,24
2020-10-21,Shasta,089,179085,2075,1777,19,1796,27
2020-10-21,Sierra,091,2930,6,6,0,6,0
2020-10-21,Siskiyou,093,43540,197,169,10,179,0
2020-10-21,Solano,095,438530,7307,7088,39,7127,59
2020-10-21,Sonoma,097,501317,9422,8987,26,9013,138
2020-10-21,Stanislaus,099,539301,17634,17419,710,18129,392
2020-10-21,Sutter,101,95872,1824,1786,1,1787,12
2020-10-21,Tehama,103,63373,889,824,2,826,5
2020-10-21,Trinity,105,12862,78,25,9,34,0
2020-10-21,Tulare,107,460477,17846,17204,315,17519,292
2020-10-21,Tuolumne,109,53932,276,251,5,256,4
2020-10-21,Ventura,111,848112,14828,14050,313,14363,153
2020-10-21,Yolo,113,214977,3231,3095,10,3105,58
2020-10-21,Yuba,115,75493,1236,1194,3,1197,10
2020-10-20,Alameda,001,1643700,23384,22750,212,22962,391
2020-10-20,Alpine,003,1148,3,3,0,3,0
2020-10-20,Amador,005,37829,333,313,0,313,16
2020-10-20,Butte,007,227075,3163,3027,35,3062,56
2020-10-20,Calaveras,009,45235,330,273,0,273,13
2020-10-20,Colusa,011,21464,547,546,1,547,6
2020-10-20,Contra Costa,013,1133247,18808,18246,92,18338,241
2020-10-20,Del Norte,015,27424,172,169,0,169,2
2020-10-20,El Dorado,017,186661,1377,1295,11,1306,4
2020-10-20,Fresno,019,978130,33196,30220,448,30668,431
2020-10-20,Glenn,021,27897,662,638,1,639,3
2020-10-20,Humboldt,023,135768,557,545,1,546,7
2020-10-20,Imperial,025,180216,12734,12114,15,12129,330
2020-10-20,Inyo,027,18085,237,218,5,223,14
2020-10-20,Kern,029,883053,33696,32889,392,33281,429
2020-10-20,Kings,031,150075,8409,8178,47,8225,80
2020-10-20,Lake,033,64148,708,675,0,675,15
2020-10-20,Lassen,035,31185,769,757,2,759,0
2020-10-20,Los Angeles,037,10098052,297160,287727,2650,290377,6891
2020-10-20,Madera,039,155013,4988,4823,37,4860,52
2020-10-20,Marin,041,260295,7102,6994,19,7013,101
2020-10-20,Mariposa,043,17540,79,77,0,77,2
2020-10-20,Mendocino,045,87422,1064,1004,4,1008,21
2020-10-20,Merced,047,269075,9459,9323,32,9355,149
2020-10-20,Modoc,049,8938,32,26,0,26,0
2020-10-20,Mono,051,14174,187,156,5,161,1
2020-10-20,Monterey,053,433212,11232,10942,49,10991,81
2020-10-20,Napa,055,140530,1985,1912,8,1920,13
2020-10-20,Nevada,057,99092,619,596,18,614,8
2020-10-20,Orange,059,3164182,59938,56914,1705,58619,1397
2020-10-20,Placer,061,380077,4230,3997,15,4012,56
2020-10-20,Plumas,063,18699,66,53,0,53,0
2020-10-20,Riverside,065,2383286,66384,64452,297,64749,1275
2020-10-20,Sacramento,067,1510023,25231,24767,26,24793,485
2020-10-20,San Benito,069,59416,1422,1398,1,1399,14
2020-10-20,San Bernardino,071,2135413,62513,59571,408,59979,1109
2020-10-20,San Diego,073,3302833,55208,53004,1449,54453,857
2020-10-20,San Francisco,075,870044,12103,12013,43,12056,126
2020-10-20,San Joaquin,077,732212,21668,21173,172,21345,490
2020-10-20,San Luis Obispo,079,281455,4301,4043,22,4065,31
2020-10-20,San Mateo,081,765935,11202,10659,11,10670,155
2020-10-20,Santa Barbara,083,443738,9851,9664,89,9753,121
2020-10-20,Santa Clara,085,1922200,24962,23406,50,23456,358
2020-10-20,Santa Cruz,087,273765,2809,2710,32,2742,23
2020-10-20,Shasta,089,179085,2052,1747,19,1766,20
2020-10-20,Sierra,091,2930,6,6,0,6,0
2020-10-20,Siskiyou,093,43540,189,168,10,178,0
2020-10-20,Solano,095,438530,7258,7044,39,7083,57
2020-10-20,Sonoma,097,501317,9359,8904,24,8928,135
2020-10-20,Stanislaus,099,539301,17580,17367,706,18073,393
2020-10-20,Sutter,101,95872,1815,1783,1,1784,12
2020-10-20,Tehama,103,63373,874,813,2,815,5
2020-10-20,Trinity,105,12862,77,25,9,34,0
2020-10-20,Tulare,107,460477,17779,17156,310,17466,289
2020-10-20,Tuolumne,109,53932,274,250,5,255,4
2020-10-20,Ventura,111,848112,14764,13980,311,14291,152
2020-10-20,Yolo,113,214977,3208,3083,10,3093,56
2020-10-20,Yuba,115,75493,1226,1191,3,1194,10
2020-10-19,Alameda,001,1643700,23274,22647,211,22858,392
2020-10-19,Alpine,003,1148,3,3,0,3,0
2020-10-19,Amador,005,37829,327,313,0,313,16
2020-10-19,Butte,007,227075,3152,3026,35,3061,55
2020-10-19,Calaveras,009,45235,329,268,0,268,13
2020-10-19,Colusa,011,21464,547,544,1,545,6
2020-10-19,Contra Costa,013,1133247,18710,18173,92,18265,239
2020-10-19,Del Norte,015,27424,169,167,0,167,2
2020-10-19,El Dorado,017,186661,1356,1287,11,1298,4
2020-10-19,Fresno,019,978130,33087,30152,442,30594,431
2020-10-19,Glenn,021,27897,657,635,0,635,3
2020-10-19,Humboldt,023,135768,557,543,1,544,7
2020-10-19,Imperial,025,180216,12680,12036,14,12050,330
2020-10-19,Inyo,027,18085,236,218,5,223,14
2020-10-19,Kern,029,883053,33620,32840,389,33229,428
2020-10-19,Kings,031,150075,8391,8173,47,8220,80
2020-10-19,Lake,033,64148,705,673,0,673,15
2020-10-19,Lassen,035,31185,768,757,2,759,0
2020-10-19,Los Angeles,037,10098052,295676,287119,2612,289731,6858
2020-10-19,Madera,039,155013,4973,4787,37,4824,52
2020-10-19,Marin,041,260295,7084,6981,19,7000,100
2020-10-19,Mariposa,043,17540,79,77,0,77,2
2020-10-19,Mendocino,045,87422,1059,1001,4,1005,21
2020-10-19,Merced,047,269075,9434,9305,29,9334,148
2020-10-19,Modoc,049,8938,31,26,0,26,0
2020-10-19,Mono,051,14174,182,156,5,161,1
2020-10-19,Monterey,053,433212,11171,10907,49,10956,80
2020-10-19,Napa,055,140530,1973,1892,8,1900,12
2020-10-19,Nevada,057,99092,616,590,18,608,8
2020-10-19,Orange,059,3164182,59655,56652,1690,58342,1396
2020-10-19,Placer,061,380077,4181,3962,15,3977,49
2020-10-19,Plumas,063,18699,64,52,0,52,0
2020-10-19,Riverside,065,2383286,65953,64016,281,64297,1272
2020-10-19,Sacramento,067,1510023,25092,24542,26,24568,483
2020-10-19,San Benito,069,59416,1415,1395,1,1396,14
2020-10-19,San Bernardino,071,2135413,62061,59265,396,59661,1100
2020-10-19,San Diego,073,3302833,54822,52739,1424,54163,853
2020-10-19,San Francisco,075,870044,12059,11879,43,11922,126
2020-10-19,San Joaquin,077,732212,21593,20930,164,21094,489
2020-10-19,San Luis Obispo,079,281455,4285,4016,22,4038,31
2020-10-19,San Mateo,081,765935,11156,10568,11,10579,154
2020-10-19,Santa Barbara,083,443738,9815,9632,89,9721,121
2020-10-19,Santa Clara,085,1922200,24812,23301,50,23351,352
2020-10-19,Santa Cruz,087,273765,2792,2705,32,2737,19
2020-10-19,Shasta,089,179085,2008,1709,18,1727,20
2020-10-19,Sierra,091,2930,6,6,0,6,0
2020-10-19,Siskiyou,093,43540,182,167,10,177,0
2020-10-19,Solano,095,438530,7217,7003,39,7042,57
2020-10-19,Sonoma,097,501317,9272,8830,24,8854,135
2020-10-19,Stanislaus,099,539301,17529,17342,696,18038,390
2020-10-19,Sutter,101,95872,1810,1773,1,1774,12
2020-10-19,Tehama,103,63373,871,793,2,795,5
2020-10-19,Trinity,105,12862,75,23,9,32,0
2020-10-19,Tulare,107,460477,17729,17047,303,17350,291
2020-10-19,Tuolumne,109,53932,272,247,5,252,4
2020-10-19,Ventura,111,848112,14699,13930,308,14238,152
2020-10-19,Yolo,113,214977,3195,3069,10,3079,56
2020-10-19,Yuba,115,75493,1219,1183,3,1186,10
2020-10-18,Alameda,001,1643700,23170,22546,210,22756,392
2020-10-18,Alpine,003,1148,3,3,0,3,0
2020-10-18,Amador,005,37829,316,313,0,313,16
2020-10-18,Butte,007,227075,3139,3019,35,3054,55
2020-10-18,Calaveras,009,45235,328,267,0,267,13
2020-10-18,Colusa,011,21464,545,544,1,545,6
2020-10-18,Contra Costa,013,1133247,18612,18120,92,18212,237
2020-10-18,Del Norte,015,27424,169,167,0,167,2
2020-10-18,El Dorado,017,186661,1347,1283,11,1294,4
2020-10-18,Fresno,019,978130,32958,30051,434,30485,430
2020-10-18,Glenn,021,27897,655,634,0,634,3
2020-10-18,Humboldt,023,135768,554,540,1,541,7
2020-10-18,Imperial,025,180216,12617,11987,13,12000,330
2020-10-18,Inyo,027,18085,233,215,5,220,14
2020-10-18,Kern,029,883053,33547,32799,382,33181,428
2020-10-18,Kings,031,150075,8376,8159,47,8206,80
2020-10-18,Lake,033,64148,698,670,0,670,15
2020-10-18,Lassen,035,31185,768,757,2,759,0
2020-10-18,Los Angeles,037,10098052,293967,286187,2570,288757,6857
2020-10-18,Madera,039,155013,4948,4770,36,4806,52
2020-10-18,Marin,041,260295,7063,6969,19,6988,99
2020-10-18,Mariposa,043,17540,79,77,0,77,2
2020-10-18,Mendocino,045,87422,1057,988,4,992,21
2020-10-18,Merced,047,269075,9399,9292,29,9321,148
2020-10-18,Modoc,049,8938,30,26,0,26,0
2020-10-18,Mono,051,14174,177,155,5,160,1
2020-10-18,Monterey,053,433212,11118,10872,49,10921,80
2020-10-18,Napa,055,140530,1960,1882,8,1890,12
2020-10-18,Nevada,057,99092,610,582,18,600,8
2020-10-18,Orange,059,3164182,59358,56394,1673,58067,1396
2020-10-18,Placer,061,380077,4133,3938,15,3953,49
2020-10-18,Plumas,063,18699,62,52,0,52,0
2020-10-18,Riverside,065,2383286,65640,63765,260,64025,1270
2020-10-18,Sacramento,067,1510023,24936,24425,26,24451,482
2020-10-18,San Benito,069,59416,1408,1395,1,1396,14
2020-10-18,San Bernardino,071,2135413,61562,58893,388,59281,1098
2020-10-18,San Diego,073,3302833,54433,52359,1403,53762,853
2020-10-18,San Francisco,075,870044,12020,11878,43,11921,126
2020-10-18,San Joaquin,077,732212,21510,20931,151,21082,489
2020-10-18,San Luis Obispo,079,281455,4254,4009,20,4029,31
2020-10-18,San Mateo,081,765935,11097,10503,11,10514,154
2020-10-18,Santa Barbara,083,443738,9776,9608,88,9696,121
2020-10-18,Santa Clara,085,1922200,24639,23169,50,23219,352
2020-10-18,Santa Cruz,087,273765,2778,2692,32,2724,19
2020-10-18,Shasta,089,179085,1983,1708,18,1726,20
2020-10-18,Sierra,091,2930,6,6,0,6,0
2020-10-18,Siskiyou,093,43540,182,167,10,177,0
2020-10-18,Solano,095,438530,7170,6962,39,7001,57
2020-10-18,Sonoma,097,501317,9195,8781,23,8804,134
2020-10-18,Stanislaus,099,539301,17473,17290,687,17977,390
2020-10-18,Sutter,101,95872,1801,1764,1,1765,12
2020-10-18,Tehama,103,63373,839,774,2,776,5
2020-10-18,Trinity,105,12862,75,20,9,29,0
2020-10-18,Tulare,107,460477,17635,17048,294,17342,290
2020-10-18,Tuolumne,109,53932,266,245,5,250,4
2020-10-18,Ventura,111,848112,14619,13901,307,14208,151
2020-10-18,Yolo,113,214977,3156,3059,10,3069,55
2020-10-18,Yuba,115,75493,1208,1176,3,1179,10
2020-10-17,Alameda,001,1643700,23125,22394,208,22602,398
2020-10-17,Alpine,003,1148,3,3,0,3,0
2020-10-17,Amador,005,37829,314,309,0,309,16
2020-10-17,Butte,007,227075,3131,3012,33,3045,55
2020-10-17,Calaveras,009,45235,328,267,0,267,13
2020-10-17,Colusa,011,21464,544,544,1,545,6
2020-10-17,Contra Costa,013,1133247,18558,18005,92,18097,237
2020-10-17,Del Norte,015,27424,169,167,0,167,2
2020-10-17,El Dorado,017,186661,1343,1277,11,1288,4
2020-10-17,Fresno,019,978130,32904,29911,432,30343,430
2020-10-17,Glenn,021,27897,652,633,0,633,3
2020-10-17,Humboldt,023,135768,551,535,1,536,7
2020-10-17,Imperial,025,180216,12589,11962,13,11975,330
2020-10-17,Inyo,027,18085,228,212,5,217,14
2020-10-17,Kern,029,883053,33496,32710,379,33089,428
2020-10-17,Kings,031,150075,8370,8151,46,8197,80
2020-10-17,Lake,033,64148,695,663,0,663,15
2020-10-17,Lassen,035,31185,768,757,2,759,0
2020-10-17,Los Angeles,037,10098052,293213,285858,2543,288401,6844
2020-10-17,Madera,039,155013,4942,4759,36,4795,53
2020-10-17,Marin,041,260295,7060,6958,19,6977,99
2020-10-17,Mariposa,043,17540,78,77,0,77,2
2020-10-17,Mendocino,045,87422,1050,977,4,981,21
2020-10-17,Merced,047,269075,9385,9275,29,9304,148
2020-10-17,Modoc,049,8938,30,26,0,26,0
2020-10-17,Mono,051,14174,176,155,5,160,1
2020-10-17,Monterey,053,433212,11079,10807,48,10855,80
2020-10-17,Napa,055,140530,1951,1866,8,1874,12
2020-10-17,Nevada,057,99092,609,580,18,598,8
2020-10-17,Orange,059,3164182,59216,56197,1667,57864,1396
2020-10-17,Placer,061,380077,4106,3898,15,3913,49
2020-10-17,Plumas,063,18699,62,52,0,52,0
2020-10-17,Riverside,065,2383286,65442,63171,251,63422,1270
2020-10-17,Sacramento,067,1510023,24852,24304,26,24330,482
2020-10-17,San Benito,069,59416,1404,1389,1,1390,14
2020-10-17,San Bernardino,071,2135413,61290,58415,381,58796,1097
2020-10-17,San Diego,073,3302833,54208,51986,1392,53378,853
2020-10-17,San Francisco,075,870044,11993,11877,42,11919,126
2020-10-17,San Joaquin,077,732212,21456,20932,145,21077,489
2020-10-17,San Luis Obispo,079,281455,4239,3979,20,3999,31
2020-10-17,San Mateo,081,765935,11069,10423,11,10434,153
2020-10-17,Santa Barbara,083,443738,9757,9588,86,9674,121
2020-10-17,Santa Clara,085,1922200,24549,22997,50,23047,349
2020-10-17,Santa Cruz,087,273765,2764,2680,32,2712,19
2020-10-17,Shasta,089,179085,1957,1679,18,1697,20
2020-10-17,Sierra,091,2930,6,6,0,6,0
2020-10-17,Siskiyou,093,43540,181,167,10,177,0
2020-10-17,Solano,095,438530,7144,6929,39,6968,57
2020-10-17,Sonoma,097,501317,9152,8725,23,8748,134
2020-10-17,Stanislaus,099,539301,17433,17232,678,17910,390
2020-10-17,Sutter,101,95872,1799,1762,1,1763,12
2020-10-17,Tehama,103,63373,823,764,2,766,5
2020-10-17,Trinity,105,12862,75,20,9,29,0
2020-10-17,Tulare,107,460477,17605,16995,285,17280,290
2020-10-17,Tuolumne,109,53932,266,241,5,246,4
2020-10-17,Ventura,111,848112,14574,13845,304,14149,151
2020-10-17,Yolo,113,214977,3141,3045,9,3054,55
2020-10-17,Yuba,115,75493,1203,1164,3,1167,10
2020-10-16,Alameda,001,1643700,23071,22315,208,22523,397
2020-10-16,Alpine,003,1148,3,3,0,3,0
2020-10-16,Amador,005,37829,314,309,0,309,16
2020-10-16,Butte,007,227075,3120,3004,33,3037,54
2020-10-16,Calaveras,009,45235,328,267,0,267,13
2020-10-16,Colusa,011,21464,543,544,1,545,6
2020-10-16,Contra Costa,013,1133247,18505,17956,92,18048,237
2020-10-16,Del Norte,015,27424,169,166,0,166,2
2020-10-16,El Dorado,017,186661,1337,1273,11,1284,4
2020-10-16,Fresno,019,978130,32829,29796,431,30227,427
2020-10-16,Glenn,021,27897,647,632,0,632,3
2020-10-16,Humboldt,023,135768,551,533,1,534,7
2020-10-16,Imperial,025,180216,12549,11885,13,11898,330
2020-10-16,Inyo,027,18085,224,212,5,217,14
2020-10-16,Kern,029,883053,33453,32660,377,33037,428
2020-10-16,Kings,031,150075,8361,8146,45,8191,80
2020-10-16,Lake,033,64148,693,644,0,644,14
2020-10-16,Lassen,035,31185,768,757,2,759,0
2020-10-16,Los Angeles,037,10098052,292149,284988,2522,287510,6835
2020-10-16,Madera,039,155013,4930,4736,35,4771,53
2020-10-16,Marin,041,260295,7050,6933,19,6952,99
2020-10-16,Mariposa,043,17540,78,76,0,76,2
2020-10-16,Mendocino,045,87422,1043,974,4,978,21
2020-10-16,Merced,047,269075,9368,9246,29,9275,148
2020-10-16,Modoc,049,8938,30,26,0,26,0
2020-10-16,Mono,051,14174,174,155,5,160,1
2020-10-16,Monterey,053,433212,11044,10727,48,10775,79
2020-10-16,Napa,055,140530,1942,1855,8,1863,12
2020-10-16,Nevada,057,99092,607,579,18,597,8
2020-10-16,Orange,059,3164182,59038,56091,1661,57752,1388
2020-10-16,Placer,061,380077,4086,3864,15,3879,49
2020-10-16,Plumas,063,18699,61,52,0,52,0
2020-10-16,Riverside,065,2383286,65216,62986,250,63236,1267
2020-10-16,Sacramento,067,1510023,24758,24144,26,24170,479
2020-10-16,San Benito,069,59416,1401,1388,1,1389,14
2020-10-16,San Bernardino,071,2135413,61021,58233,381,58614,1069
2020-10-16,San Diego,073,3302833,53966,51785,1378,53163,850
2020-10-16,San Francisco,075,870044,11971,11840,41,11881,126
2020-10-16,San Joaquin,077,732212,21411,20910,144,21054,489
2020-10-16,San Luis Obispo,079,281455,4223,3952,20,3972,32
2020-10-16,San Mateo,081,765935,11043,10405,11,10416,153
2020-10-16,Santa Barbara,083,443738,9738,9549,86,9635,119
2020-10-16,Santa Clara,085,1922200,24461,22920,50,22970,345
2020-10-16,Santa Cruz,087,273765,2751,2666,32,2698,20
2020-10-16,Shasta,089,179085,1935,1660,18,1678,20
2020-10-16,Sierra,091,2930,6,6,0,6,0
2020-10-16,Siskiyou,093,43540,179,167,10,177,0
2020-10-16,Solano,095,438530,7121,6879,39,6918,55
2020-10-16,Sonoma,097,501317,9096,8652,23,8675,133
2020-10-16,Stanislaus,099,539301,17399,17201,670,17871,366
2020-10-16,Sutter,101,95872,1791,1756,1,1757,12
2020-10-16,Tehama,103,63373,822,737,2,739,3
2020-10-16,Trinity,105,12862,75,20,9,29,0
2020-10-16,Tulare,107,460477,17573,16965,277,17242,290
2020-10-16,Tuolumne,109,53932,264,237,5,242,4
2020-10-16,Ventura,111,848112,14531,13805,299,14104,152
2020-10-16,Yolo,113,214977,3132,3030,9,3039,55
2020-10-16,Yuba,115,75493,1203,1155,3,1158,10
2020-10-15,Alameda,001,1643700,23003,22267,207,22474,390
2020-10-15,Alpine,003,1148,3,3,0,3,0
2020-10-15,Amador,005,37829,314,309,0,309,16
2020-10-15,Butte,007,227075,3108,3000,32,3032,54
2020-10-15,Calaveras,009,45235,327,267,0,267,13
2020-10-15,Colusa,011,21464,542,543,1,544,6
2020-10-15,Contra Costa,013,1133247,18438,17893,91,17984,237
2020-10-15,Del Norte,015,27424,169,164,0,164,2
2020-10-15,El Dorado,017,186661,1332,1265,11,1276,4
2020-10-15,Fresno,019,978130,32732,29727,428,30155,425
2020-10-15,Glenn,021,27897,642,632,0,632,3
2020-10-15,Humboldt,023,135768,547,531,1,532,7
2020-10-15,Imperial,025,180216,12508,11820,12,11832,330
2020-10-15,Inyo,027,18085,224,210,5,215,14
2020-10-15,Kern,029,883053,33372,32593,374,32967,427
2020-10-15,Kings,031,150075,8346,8134,45,8179,80
2020-10-15,Lake,033,64148,691,642,0,642,14
2020-10-15,Lassen,035,31185,767,752,2,754,0
2020-10-15,Los Angeles,037,10098052,290864,284019,2489,286508,6807
2020-10-15,Madera,039,155013,4918,4723,34,4757,50
2020-10-15,Marin,041,260295,7042,6912,19,6931,99
2020-10-15,Mariposa,043,17540,78,76,0,76,2
2020-10-15,Mendocino,045,87422,1037,963,4,967,21
2020-10-15,Merced,047,269075,9341,9213,29,9242,147
2020-10-15,Modoc,049,8938,30,26,0,26,0
2020-10-15,Mono,051,14174,174,155,5,160,1
2020-10-15,Monterey,053,433212,10977,10677,47,10724,79
2020-10-15,Napa,055,140530,1929,1842,8,1850,12
2020-10-15,Nevada,057,99092,603,575,18,593,8
2020-10-15,Orange,059,3164182,58822,55952,1649,57601,1379
2020-10-15,Placer,061,380077,4057,3848,15,3863,48
2020-10-15,Plumas,063,18699,58,52,0,52,0
2020-10-15,Riverside,065,2383286,64883,62819,247,63066,1266
2020-10-15,Sacramento,067,1510023,24642,24068,26,24094,474
2020-10-15,San Benito,069,59416,1398,1384,1,1385,14
2020-10-15,San Bernardino,071,2135413,60682,58068,378,58446,1067
2020-10-15,San Diego,073,3302833,53682,51472,1362,52834,847
2020-10-15,San Francisco,075,870044,11943,11808,38,11846,126
2020-10-15,San Joaquin,077,732212,21338,20880,138,21018,487
2020-10-15,San Luis Obispo,079,281455,4207,3934,20,3954,32
2020-10-15,San Mateo,081,765935,11003,10340,11,10351,152
2020-10-15,Santa Barbara,083,443738,9714,9526,85,9611,117
2020-10-15,Santa Clara,085,1922200,24346,22808,50,22858,343
2020-10-15,Santa Cruz,087,273765,2737,2656,32,2688,13
2020-10-15,Shasta,089,179085,1924,1635,18,1653,20
2020-10-15,Sierra,091,2930,6,6,0,6,0
2020-10-15,Siskiyou,093,43540,175,166,10,176,0
2020-10-15,Solano,095,438530,7082,6830,39,6869,55
2020-10-15,Sonoma,097,501317,9004,8571,23,8594,133
2020-10-15,Stanislaus,099,539301,17361,17151,656,17807,366
2020-10-15,Sutter,101,95872,1788,1752,1,1753,12
2020-10-15,Tehama,103,63373,795,726,2,728,3
2020-10-15,Trinity,105,12862,75,20,9,29,0
2020-10-15,Tulare,107,460477,17513,16918,262,17180,289
2020-10-15,Tuolumne,109,53932,262,236,5,241,4
2020-10-15,Ventura,111,848112,14475,13750,294,14044,152
2020-10-15,Yolo,113,214977,3112,3014,9,3023,55
2020-10-15,Yuba,115,75493,1196,1151,3,1154,10
2020-10-14,Alameda,001,1643700,22904,22227,206,22433,398
2020-10-14,Alpine,003,1148,3,3,0,3,0
2020-10-14,Amador,005,37829,312,308,0,308,16
2020-10-14,Butte,007,227075,3100,2995,32,3027,54
2020-10-14,Calaveras,009,45235,327,266,0,266,12
2020-10-14,Colusa,011,21464,542,543,1,544,6
2020-10-14,Contra Costa,013,1133247,18380,17820,89,17909,236
2020-10-14,Del Norte,015,27424,168,163,0,163,2
2020-10-14,El Dorado,017,186661,1326,1264,10,1274,4
2020-10-14,Fresno,019,978130,32617,29650,422,30072,424
2020-10-14,Glenn,021,27897,641,629,0,629,3
2020-10-14,Humboldt,023,135768,544,531,1,532,7
2020-10-14,Imperial,025,180216,12471,11765,10,11775,330
2020-10-14,Inyo,027,18085,223,209,4,213,14
2020-10-14,Kern,029,883053,33297,32528,372,32900,425
2020-10-14,Kings,031,150075,8328,8118,45,8163,80
2020-10-14,Lake,033,64148,690,642,0,642,14
2020-10-14,Lassen,035,31185,765,752,2,754,0
2020-10-14,Los Angeles,037,10098052,289550,282918,2445,285363,6786
2020-10-14,Madera,039,155013,4903,4713,33,4746,50
2020-10-14,Marin,041,260295,7036,6907,19,6926,99
2020-10-14,Mariposa,043,17540,77,76,0,76,2
2020-10-14,Mendocino,045,87422,1031,955,4,959,21
2020-10-14,Merced,047,269075,9316,9201,27,9228,147
2020-10-14,Modoc,049,8938,30,27,0,27,0
2020-10-14,Mono,051,14174,174,155,5,160,1
2020-10-14,Monterey,053,433212,10927,10616,47,10663,78
2020-10-14,Napa,055,140530,1912,1837,8,1845,12
2020-10-14,Nevada,057,99092,601,573,18,591,7
2020-10-14,Orange,059,3164182,58609,55756,1640,57396,1348
2020-10-14,Placer,061,380077,4034,3829,15,3844,48
2020-10-14,Plumas,063,18699,54,52,0,52,0
2020-10-14,Riverside,065,2383286,64600,62607,246,62853,1261
2020-10-14,Sacramento,067,1510023,24498,24013,26,24039,472
2020-10-14,San Benito,069,59416,1396,1381,0,1381,14
2020-10-14,San Bernardino,071,2135413,60355,57774,374,58148,1063
2020-10-14,San Diego,073,3302833,53363,51329,1338,52667,844
2020-10-14,San Francisco,075,870044,11911,11783,37,11820,123
2020-10-14,San Joaquin,077,732212,21259,20845,124,20969,487
2020-10-14,San Luis Obispo,079,281455,4184,3901,19,3920,32
2020-10-14,San Mateo,081,765935,10952,10309,11,10320,132
2020-10-14,Santa Barbara,083,443738,9680,9509,85,9594,117
2020-10-14,Santa Clara,085,1922200,24197,22735,50,22785,343
2020-10-14,Santa Cruz,087,273765,2727,2618,32,2650,13
2020-10-14,Shasta,089,179085,1886,1553,18,1571,20
2020-10-14,Sierra,091,2930,6,6,0,6,0
2020-10-14,Siskiyou,093,43540,175,166,10,176,0
2020-10-14,Solano,095,438530,7026,6786,39,6825,55
2020-10-14,Sonoma,097,501317,8951,8514,23,8537,133
2020-10-14,Stanislaus,099,539301,17316,17105,653,17758,365
2020-10-14,Sutter,101,95872,1779,1747,1,1748,12
2020-10-14,Tehama,103,63373,784,721,2,723,3
2020-10-14,Trinity,105,12862,74,20,9,29,0
2020-10-14,Tulare,107,460477,17451,16863,249,17112,287
2020-10-14,Tuolumne,109,53932,261,236,5,241,4
2020-10-14,Ventura,111,848112,14422,13697,290,13987,152
2020-10-14,Yolo,113,214977,3094,3007,8,3015,55
2020-10-14,Yuba,115,75493,1188,1147,3,1150,10
2020-10-13,Alameda,001,1643700,22799,22185,204,22389,389
2020-10-13,Alpine,003,1148,3,3,0,3,0
2020-10-13,Amador,005,37829,310,306,0,306,16
2020-10-13,Butte,007,227075,3091,2992,32,3024,54
2020-10-13,Calaveras,009,45235,323,262,0,262,12
2020-10-13,Colusa,011,21464,542,541,1,542,6
2020-10-13,Contra Costa,013,1133247,18323,17783,89,17872,234
2020-10-13,Del Norte,015,27424,168,163,0,163,2
2020-10-13,El Dorado,017,186661,1317,1262,10,1272,4
2020-10-13,Fresno,019,978130,32495,29579,418,29997,424
2020-10-13,Glenn,021,27897,640,629,0,629,3
2020-10-13,Humboldt,023,135768,542,523,1,524,7
2020-10-13,Imperial,025,180216,12436,11727,10,11737,327
2020-10-13,Inyo,027,18085,220,207,4,211,14
2020-10-13,Kern,029,883053,33222,32497,370,32867,419
2020-10-13,Kings,031,150075,8319,8111,45,8156,80
2020-10-13,Lake,033,64148,687,639,0,639,12
2020-10-13,Lassen,035,31185,763,752,2,754,0
2020-10-13,Los Angeles,037,10098052,288268,281716,2405,284121,6767
2020-10-13,Madera,039,155013,4885,4700,33,4733,50
2020-10-13,Marin,041,260295,7014,6900,18,6918,97
2020-10-13,Mariposa,043,17540,77,76,0,76,2
2020-10-13,Mendocino,045,87422,1022,950,4,954,21
2020-10-13,Merced,047,269075,9299,9181,27,9208,146
2020-10-13,Modoc,049,8938,29,28,0,28,0
2020-10-13,Mono,051,14174,174,155,4,159,1
2020-10-13,Monterey,053,433212,10866,10574,46,10620,78
2020-10-13,Napa,055,140530,1903,1825,8,1833,12
2020-10-13,Nevada,057,99092,594,572,18,590,7
2020-10-13,Orange,059,3164182,58396,55515,1627,57142,1326
2020-10-13,Placer,061,380077,3996,3825,15,3840,48
2020-10-13,Plumas,063,18699,52,51,0,51,0
2020-10-13,Riverside,065,2383286,64281,62279,244,62523,1254
2020-10-13,Sacramento,067,1510023,24421,23930,26,23956,466
2020-10-13,San Benito,069,59416,1388,1380,0,1380,14
2020-10-13,San Bernardino,071,2135413,60017,57411,372,57783,1061
2020-10-13,San Diego,073,3302833,53070,51026,1321,52347,840
2020-10-13,San Francisco,075,870044,11876,11659,37,11696,122
2020-10-13,San Joaquin,077,732212,21198,20822,120,20942,481
2020-10-13,San Luis Obispo,079,281455,4167,3892,18,3910,32
2020-10-13,San Mateo,081,765935,10909,10286,11,10297,130
2020-10-13,Santa Barbara,083,443738,9649,9489,85,9574,117
2020-10-13,Santa Clara,085,1922200,24070,22678,50,22728,343
2020-10-13,Santa Cruz,087,273765,2709,2603,32,2635,13
2020-10-13,Shasta,089,179085,1862,1606,18,1624,20
2020-10-13,Sierra,091,2930,6,6,0,6,0
2020-10-13,Siskiyou,093,43540,174,163,10,173,0
2020-10-13,Solano,095,438530,6991,6761,39,6800,55
2020-10-13,Sonoma,097,501317,8868,8456,23,8479,133
2020-10-13,Stanislaus,099,539301,17271,17082,648,17730,362
2020-10-13,Sutter,101,95872,1770,1748,1,1749,12
2020-10-13,Tehama,103,63373,777,717,2,719,3
2020-10-13,Trinity,105,12862,70,19,8,27,0
2020-10-13,Tulare,107,460477,17393,16822,241,17063,286
2020-10-13,Tuolumne,109,53932,259,235,5,240,4
2020-10-13,Ventura,111,848112,14367,13645,286,13931,151
2020-10-13,Yolo,113,214977,3086,2983,7,2990,55
2020-10-13,Yuba,115,75493,1183,1143,3,1146,10
2020-10-12,Alameda,001,1643700,22719,22126,203,22329,389
2020-10-12,Alpine,003,1148,3,3,0,3,0
2020-10-12,Amador,005,37829,309,305,0,305,16
2020-10-12,Butte,007,227075,3085,2975,32,3007,54
2020-10-12,Calaveras,009,45235,323,262,0,262,12
2020-10-12,Colusa,011,21464,542,541,1,542,6
2020-10-12,Contra Costa,013,1133247,18249,17728,89,17817,233
2020-10-12,Del Norte,015,27424,168,161,0,161,2
2020-10-12,El Dorado,017,186661,1314,1254,10,1264,4
2020-10-12,Fresno,019,978130,32362,29523,414,29937,421
2020-10-12,Glenn,021,27897,639,626,0,626,3
2020-10-12,Humboldt,023,135768,539,522,1,523,7
2020-10-12,Imperial,025,180216,12397,11689,10,11699,328
2020-10-12,Inyo,027,18085,217,201,4,205,14
2020-10-12,Kern,029,883053,33129,32425,367,32792,419
2020-10-12,Kings,031,150075,8313,8106,45,8151,80
2020-10-12,Lake,033,64148,681,633,0,633,12
2020-10-12,Lassen,035,31185,763,752,2,754,0
2020-10-12,Los Angeles,037,10098052,287048,280961,2378,283339,6747
2020-10-12,Madera,039,155013,4866,4689,33,4722,50
2020-10-12,Marin,041,260295,6997,6886,18,6904,97
2020-10-12,Mariposa,043,17540,77,76,0,76,2
2020-10-12,Mendocino,045,87422,1016,947,4,951,21
2020-10-12,Merced,047,269075,9278,9141,27,9168,146
2020-10-12,Modoc,049,8938,29,27,0,27,0
2020-10-12,Mono,051,14174,174,154,4,158,1
2020-10-12,Monterey,053,433212,10800,10473,46,10519,77
2020-10-12,Napa,055,140530,1895,1819,8,1827,11
2020-10-12,Nevada,057,99092,590,570,18,588,7
2020-10-12,Orange,059,3164182,58167,55373,1617,56990,1326
2020-10-12,Placer,061,380077,3964,3808,14,3822,48
2020-10-12,Plumas,063,18699,52,51,0,51,0
2020-10-12,Riverside,065,2383286,63970,62279,240,62519,1254
2020-10-12,Sacramento,067,1510023,24315,23807,26,23833,466
2020-10-12,San Benito,069,59416,1385,1376,0,1376,13
2020-10-12,San Bernardino,071,2135413,59642,57235,371,57606,1061
2020-10-12,San Diego,073,3302833,52780,50748,1294,52042,826
2020-10-12,San Francisco,075,870044,11844,11659,37,11696,122
2020-10-12,San Joaquin,077,732212,21135,20701,114,20815,480
2020-10-12,San Luis Obispo,079,281455,4139,3874,18,3892,32
2020-10-12,San Mateo,081,765935,10861,10262,11,10273,130
2020-10-12,Santa Barbara,083,443738,9610,9462,85,9547,117
2020-10-12,Santa Clara,085,1922200,23954,22578,50,22628,343
2020-10-12,Santa Cruz,087,273765,2692,2590,32,2622,13
2020-10-12,Shasta,089,179085,1837,1515,18,1533,20
2020-10-12,Sierra,091,2930,6,6,0,6,0
2020-10-12,Siskiyou,093,43540,173,162,10,172,0
2020-10-12,Solano,095,438530,6952,6742,39,6781,55
2020-10-12,Sonoma,097,501317,8796,8377,23,8400,133
2020-10-12,Stanislaus,099,539301,17222,17051,639,17690,361
2020-10-12,Sutter,101,95872,1762,1741,1,1742,12
2020-10-12,Tehama,103,63373,761,708,2,710,3
2020-10-12,Trinity,105,12862,69,19,8,27,0
2020-10-12,Tulare,107,460477,17342,16742,234,16976,286
2020-10-12,Tuolumne,109,53932,254,234,5,239,4
2020-10-12,Ventura,111,848112,14305,13617,282,13899,151
2020-10-12,Yolo,113,214977,3071,2964,7,2971,55
2020-10-12,Yuba,115,75493,1173,1141,3,1144,10
2020-10-11,Alameda,001,1643700,22629,22057,199,22256,392
2020-10-11,Alpine,003,1148,3,3,0,3,0
2020-10-11,Amador,005,37829,307,305,0,305,16
2020-10-11,Butte,007,227075,3077,2967,31,2998,54
2020-10-11,Calaveras,009,45235,321,262,0,262,12
2020-10-11,Colusa,011,21464,540,541,1,542,6
2020-10-11,Contra Costa,013,1133247,18165,17678,89,17767,233
2020-10-11,Del Norte,015,27424,166,161,0,161,2
2020-10-11,El Dorado,017,186661,1305,1242,10,1252,4
2020-10-11,Fresno,019,978130,32224,29419,406,29825,421
2020-10-11,Glenn,021,27897,637,625,0,625,3
2020-10-11,Humboldt,023,135768,538,521,1,522,7
2020-10-11,Imperial,025,180216,12337,11614,10,11624,328
2020-10-11,Inyo,027,18085,213,201,4,205,14
2020-10-11,Kern,029,883053,33042,32399,358,32757,418
2020-10-11,Kings,031,150075,8296,8094,44,8138,80
2020-10-11,Lake,033,64148,668,631,0,631,12
2020-10-11,Lassen,035,31185,762,752,2,754,0
2020-10-11,Los Angeles,037,10098052,285610,280190,2337,282527,6745
2020-10-11,Madera,039,155013,4838,4680,32,4712,50
2020-10-11,Marin,041,260295,6988,6870,18,6888,97
2020-10-11,Mariposa,043,17540,77,76,0,76,2
2020-10-11,Mendocino,045,87422,1009,944,4,948,21
2020-10-11,Merced,047,269075,9260,9124,27,9151,146
2020-10-11,Modoc,049,8938,29,27,0,27,0
2020-10-11,Mono,051,14174,174,154,4,158,1
2020-10-11,Monterey,053,433212,10749,10445,44,10489,77
2020-10-11,Napa,055,140530,1879,1811,8,1819,11
2020-10-11,Nevada,057,99092,588,569,18,587,7
2020-10-11,Orange,059,3164182,57937,55202,1611,56813,1326
2020-10-11,Placer,061,380077,3943,3787,14,3801,48
2020-10-11,Plumas,063,18699,52,51,0,51,0
2020-10-11,Riverside,065,2383286,63682,62112,236,62348,1254
2020-10-11,Sacramento,067,1510023,24172,23778,26,23804,466
2020-10-11,San Benito,069,59416,1384,1374,0,1374,13
2020-10-11,San Bernardino,071,2135413,59190,56997,369,57366,1061
2020-10-11,San Diego,073,3302833,52430,50553,1272,51825,826
2020-10-11,San Francisco,075,870044,11801,11659,37,11696,122
2020-10-11,San Joaquin,077,732212,21060,20700,104,20804,480
2020-10-11,San Luis Obispo,079,281455,4122,3874,17,3891,32
2020-10-11,San Mateo,081,765935,10829,10240,11,10251,130
2020-10-11,Santa Barbara,083,443738,9579,9440,84,9524,117
2020-10-11,Santa Clara,085,1922200,23812,22487,49,22536,336
2020-10-11,Santa Cruz,087,273765,2678,2578,32,2610,13
2020-10-11,Shasta,089,179085,1807,1515,17,1532,20
2020-10-11,Sierra,091,2930,6,6,0,6,0
2020-10-11,Siskiyou,093,43540,172,162,10,172,0
2020-10-11,Solano,095,438530,6898,6685,39,6724,53
2020-10-11,Sonoma,097,501317,8739,8319,23,8342,133
2020-10-11,Stanislaus,099,539301,17158,17007,623,17630,360
2020-10-11,Sutter,101,95872,1759,1742,1,1743,12
2020-10-11,Tehama,103,63373,737,702,2,704,3
2020-10-11,Trinity,105,12862,69,19,8,27,0
2020-10-11,Tulare,107,460477,17278,16741,226,16967,286
2020-10-11,Tuolumne,109,53932,249,234,5,239,4
2020-10-11,Ventura,111,848112,14244,13604,277,13881,151
2020-10-11,Yolo,113,214977,3041,2952,7,2959,55
2020-10-11,Yuba,115,75493,1162,1137,3,1140,10
2020-10-10,Alameda,001,1643700,22579,21979,198,22177,398
2020-10-10,Alpine,003,1148,3,3,0,3,0
2020-10-10,Amador,005,37829,306,304,0,304,16
2020-10-10,Butte,007,227075,3072,2962,30,2992,54
2020-10-10,Calaveras,009,45235,320,262,0,262,12
2020-10-10,Colusa,011,21464,540,541,1,542,6
2020-10-10,Contra Costa,013,1133247,18129,17566,88,17654,233
2020-10-10,Del Norte,015,27424,166,161,0,161,2
2020-10-10,El Dorado,017,186661,1303,1240,10,1250,4
2020-10-10,Fresno,019,978130,32160,29286,404,29690,421
2020-10-10,Glenn,021,27897,637,623,0,623,3
2020-10-10,Humboldt,023,135768,535,518,1,519,7
2020-10-10,Imperial,025,180216,12322,11591,10,11601,327
2020-10-10,Inyo,027,18085,210,201,4,205,14
2020-10-10,Kern,029,883053,33005,32338,358,32696,418
2020-10-10,Kings,031,150075,8292,8078,44,8122,80
2020-10-10,Lake,033,64148,667,630,0,630,11
2020-10-10,Lassen,035,31185,762,752,2,754,0
2020-10-10,Los Angeles,037,10098052,284892,279213,2303,281516,6743
2020-10-10,Madera,039,155013,4825,4662,32,4694,50
2020-10-10,Marin,041,260295,6979,6852,18,6870,97
2020-10-10,Mariposa,043,17540,77,76,0,76,2
2020-10-10,Mendocino,045,87422,1002,935,4,939,21
2020-10-10,Merced,047,269075,9254,9105,26,9131,146
2020-10-10,Modoc,049,8938,29,27,0,27,0
2020-10-10,Mono,051,14174,174,154,4,158,1
2020-10-10,Monterey,053,433212,10716,10410,44,10454,75
2020-10-10,Napa,055,140530,1872,1804,8,1812,11
2020-10-10,Nevada,057,99092,585,564,18,582,6
2020-10-10,Orange,059,3164182,57816,54965,1606,56571,1324
2020-10-10,Placer,061,380077,3926,3757,14,3771,48
2020-10-10,Plumas,063,18699,52,51,0,51,0
2020-10-10,Riverside,065,2383286,63479,61845,234,62079,1254
2020-10-10,Sacramento,067,1510023,24105,23689,26,23715,466
2020-10-10,San Benito,069,59416,1382,1370,0,1370,13
2020-10-10,San Bernardino,071,2135413,59027,56683,367,57050,1061
2020-10-10,San Diego,073,3302833,52200,50145,1254,51399,825
2020-10-10,San Francisco,075,870044,11780,11663,37,11700,122
2020-10-10,San Joaquin,077,732212,21032,20700,100,20800,481
2020-10-10,San Luis Obispo,079,281455,4102,3832,17,3849,32
2020-10-10,San Mateo,081,765935,10792,10218,11,10229,130
2020-10-10,Santa Barbara,083,443738,9568,9417,84,9501,116
2020-10-10,Santa Clara,085,1922200,23721,22354,49,22403,330
2020-10-10,Santa Cruz,087,273765,2664,2572,32,2604,13
2020-10-10,Shasta,089,179085,1790,1473,17,1490,20
2020-10-10,Sierra,091,2930,6,6,0,6,0
2020-10-10,Siskiyou,093,43540,172,161,10,171,0
2020-10-10,Solano,095,438530,6872,6655,39,6694,53
2020-10-10,Sonoma,097,501317,8719,8235,23,8258,133
2020-10-10,Stanislaus,099,539301,17123,16960,615,17575,360
2020-10-10,Sutter,101,95872,1756,1735,1,1736,12
2020-10-10,Tehama,103,63373,730,693,2,695,3
2020-10-10,Trinity,105,12862,69,19,8,27,0
2020-10-10,Tulare,107,460477,17242,16709,221,16930,286
2020-10-10,Tuolumne,109,53932,249,233,5,238,4
2020-10-10,Ventura,111,848112,14219,13520,277,13797,151
2020-10-10,Yolo,113,214977,3032,2939,7,2946,55
2020-10-10,Yuba,115,75493,1160,1134,3,1137,10
2020-10-09,Alameda,001,1643700,22531,21924,198,22122,399
2020-10-09,Alpine,003,1148,3,3,0,3,0
2020-10-09,Amador,005,37829,306,303,0,303,16
2020-10-09,Butte,007,227075,3069,2956,30,2986,51
2020-10-09,Calaveras,009,45235,318,262,0,262,11
2020-10-09,Colusa,011,21464,540,541,1,542,6
2020-10-09,Contra Costa,013,1133247,18079,17487,88,17575,229
2020-10-09,Del Norte,015,27424,165,161,0,161,2
2020-10-09,El Dorado,017,186661,1299,1234,10,1244,4
2020-10-09,Fresno,019,978130,32087,29208,402,29610,417
2020-10-09,Glenn,021,27897,632,617,0,617,3
2020-10-09,Humboldt,023,135768,533,516,1,517,7
2020-10-09,Imperial,025,180216,12295,11516,10,11526,330
2020-10-09,Inyo,027,18085,207,200,4,204,14
2020-10-09,Kern,029,883053,32962,32237,356,32593,417
2020-10-09,Kings,031,150075,8285,7993,42,8035,80
2020-10-09,Lake,033,64148,657,610,0,610,11
2020-10-09,Lassen,035,31185,762,751,2,753,0
2020-10-09,Los Angeles,037,10098052,283758,278039,2278,280317,6715
2020-10-09,Madera,039,155013,4815,4646,32,4678,50
2020-10-09,Marin,041,260295,6965,6838,18,6856,96
2020-10-09,Mariposa,043,17540,77,76,0,76,2
2020-10-09,Mendocino,045,87422,992,933,4,937,20
2020-10-09,Merced,047,269075,9240,9095,26,9121,145
2020-10-09,Modoc,049,8938,29,27,0,27,0
2020-10-09,Mono,051,14174,174,154,4,158,1
2020-10-09,Monterey,053,433212,10682,10369,44,10413,75
2020-10-09,Napa,055,140530,1862,1795,8,1803,11
2020-10-09,Nevada,057,99092,580,561,18,579,6
2020-10-09,Orange,059,3164182,57645,54746,1601,56347,1305
2020-10-09,Placer,061,380077,3912,3737,13,3750,48
2020-10-09,Plumas,063,18699,52,50,0,50,0
2020-10-09,Riverside,065,2383286,63243,61529,233,61762,1252
2020-10-09,Sacramento,067,1510023,24035,23606,26,23632,457
2020-10-09,San Benito,069,59416,1377,1367,0,1367,13
2020-10-09,San Bernardino,071,2135413,58787,56434,365,56799,1057
2020-10-09,San Diego,073,3302833,51924,49825,1243,51068,821
2020-10-09,San Francisco,075,870044,11750,11620,37,11657,120
2020-10-09,San Joaquin,077,732212,21002,20648,92,20740,481
2020-10-09,San Luis Obispo,079,281455,4083,3810,17,3827,32
2020-10-09,San Mateo,081,765935,10764,10140,11,10151,130
2020-10-09,Santa Barbara,083,443738,9540,9396,84,9480,116
2020-10-09,Santa Clara,085,1922200,23619,22251,48,22299,328
2020-10-09,Santa Cruz,087,273765,2655,2555,32,2587,13
2020-10-09,Shasta,089,179085,1764,1353,16,1369,20
2020-10-09,Sierra,091,2930,6,6,0,6,0
2020-10-09,Siskiyou,093,43540,170,156,10,166,0
2020-10-09,Solano,095,438530,6833,6614,39,6653,53
2020-10-09,Sonoma,097,501317,8665,8133,23,8156,133
2020-10-09,Stanislaus,099,539301,17099,16904,608,17512,362
2020-10-09,Sutter,101,95872,1752,1732,1,1733,12
2020-10-09,Tehama,103,63373,724,682,2,684,3
2020-10-09,Trinity,105,12862,69,25,8,33,0
2020-10-09,Tulare,107,460477,17202,16644,212,16856,286
2020-10-09,Tuolumne,109,53932,246,230,5,235,4
2020-10-09,Ventura,111,848112,14183,13469,274,13743,151
2020-10-09,Yolo,113,214977,3025,2928,7,2935,55
2020-10-09,Yuba,115,75493,1159,1129,3,1132,10
2020-10-08,Alameda,001,1643700,22450,21826,197,22023,395
2020-10-08,Alpine,003,1148,3,3,0,3,0
2020-10-08,Amador,005,37829,305,302,0,302,16
2020-10-08,Butte,007,227075,3059,2935,30,2965,51
2020-10-08,Calaveras,009,45235,317,262,0,262,11
2020-10-08,Colusa,011,21464,540,539,1,540,6
2020-10-08,Contra Costa,013,1133247,18019,17418,87,17505,228
2020-10-08,Del Norte,015,27424,165,151,0,151,2
2020-10-08,El Dorado,017,186661,1298,1230,10,1240,4
2020-10-08,Fresno,019,978130,31982,29111,402,29513,416
2020-10-08,Glenn,021,27897,629,616,0,616,3
2020-10-08,Humboldt,023,135768,529,515,1,516,7
2020-10-08,Imperial,025,180216,12256,11405,10,11415,330
2020-10-08,Inyo,027,18085,204,199,4,203,14
2020-10-08,Kern,029,883053,32904,32169,351,32520,411
2020-10-08,Kings,031,150075,8279,7968,42,8010,80
2020-10-08,Lake,033,64148,652,604,0,604,11
2020-10-08,Lassen,035,31185,757,751,2,753,0
2020-10-08,Los Angeles,037,10098052,282556,276763,2238,279001,6699
2020-10-08,Madera,039,155013,4796,4637,32,4669,50
2020-10-08,Marin,041,260295,6951,6810,18,6828,96
2020-10-08,Mariposa,043,17540,77,76,0,76,2
2020-10-08,Mendocino,045,87422,987,930,4,934,20
2020-10-08,Merced,047,269075,9220,9069,26,9095,144
2020-10-08,Modoc,049,8938,29,27,0,27,0
2020-10-08,Mono,051,14174,174,153,4,157,1
2020-10-08,Monterey,053,433212,10615,10343,44,10387,75
2020-10-08,Napa,055,140530,1847,1779,8,1787,11
2020-10-08,Nevada,057,99092,577,556,18,574,6
2020-10-08,Orange,059,3164182,57452,54523,1590,56113,1293
2020-10-08,Placer,061,380077,3894,3715,13,3728,48
2020-10-08,Plumas,063,18699,52,50,0,50,0
2020-10-08,Riverside,065,2383286,62975,61105,232,61337,1244
2020-10-08,Sacramento,067,1510023,23928,23482,26,23508,454
2020-10-08,San Benito,069,59416,1372,1367,0,1367,13
2020-10-08,San Bernardino,071,2135413,58422,56152,364,56516,1048
2020-10-08,San Diego,073,3302833,51644,49468,1211,50679,819
2020-10-08,San Francisco,075,870044,11712,11608,37,11645,115
2020-10-08,San Joaquin,077,732212,20950,20576,87,20663,478
2020-10-08,San Luis Obispo,079,281455,4067,3785,17,3802,32
2020-10-08,San Mateo,081,765935,10732,10044,11,10055,130
2020-10-08,Santa Barbara,083,443738,9512,9374,84,9458,116
2020-10-08,Santa Clara,085,1922200,23517,22095,48,22143,323
2020-10-08,Santa Cruz,087,273765,2643,2535,32,2567,13
2020-10-08,Shasta,089,179085,1730,1305,16,1321,20
2020-10-08,Sierra,091,2930,6,6,0,6,0
2020-10-08,Siskiyou,093,43540,170,156,10,166,0
2020-10-08,Solano,095,438530,6809,6556,39,6595,53
2020-10-08,Sonoma,097,501317,8599,8063,23,8086,132
2020-10-08,Stanislaus,099,539301,17053,16821,600,17421,360
2020-10-08,Sutter,101,95872,1752,1725,1,1726,12
2020-10-08,Tehama,103,63373,715,676,2,678,3
2020-10-08,Trinity,105,12862,68,25,8,33,0
2020-10-08,Tulare,107,460477,17141,16573,204,16777,283
2020-10-08,Tuolumne,109,53932,245,230,5,235,4
2020-10-08,Ventura,111,848112,14135,13399,272,13671,151
2020-10-08,Yolo,113,214977,3008,2914,7,2921,55
2020-10-08,Yuba,115,75493,1154,1126,3,1129,10
2020-10-07,Alameda,001,1643700,22373,21736,197,21933,395
2020-10-07,Alpine,003,1148,3,3,0,3,0
2020-10-07,Amador,005,37829,305,302,0,302,16
2020-10-07,Butte,007,227075,3047,2927,30,2957,47
2020-10-07,Calaveras,009,45235,315,262,0,262,11
2020-10-07,Colusa,011,21464,539,539,0,539,6
2020-10-07,Contra Costa,013,1133247,17949,17346,86,17432,225
2020-10-07,Del Norte,015,27424,164,149,0,149,2
2020-10-07,El Dorado,017,186661,1290,1219,10,1229,4
2020-10-07,Fresno,019,978130,31861,29069,397,29466,413
2020-10-07,Glenn,021,27897,629,615,0,615,3
2020-10-07,Humboldt,023,135768,526,512,1,513,7
2020-10-07,Imperial,025,180216,12219,11289,9,11298,330
2020-10-07,Inyo,027,18085,204,199,4,203,14
2020-10-07,Kern,029,883053,32831,32068,350,32418,410
2020-10-07,Kings,031,150075,8264,7948,42,7990,80
2020-10-07,Lake,033,64148,651,599,0,599,11
2020-10-07,Lassen,035,31185,757,751,2,753,0
2020-10-07,Los Angeles,037,10098052,281375,275559,2205,277764,6681
2020-10-07,Madera,039,155013,4776,4618,32,4650,50
2020-10-07,Marin,041,260295,6924,6790,18,6808,95
2020-10-07,Mariposa,043,17540,77,75,0,75,2
2020-10-07,Mendocino,045,87422,981,927,4,931,19
2020-10-07,Merced,047,269075,9183,9045,25,9070,144
2020-10-07,Modoc,049,8938,29,27,0,27,0
2020-10-07,Mono,051,14174,173,153,3,156,1
2020-10-07,Monterey,053,433212,10556,10272,44,10316,75
2020-10-07,Napa,055,140530,1834,1774,8,1782,11
2020-10-07,Nevada,057,99092,573,552,18,570,6
2020-10-07,Orange,059,3164182,57235,54332,1579,55911,1277
2020-10-07,Placer,061,380077,3878,3693,13,3706,48
2020-10-07,Plumas,063,18699,52,50,0,50,0
2020-10-07,Riverside,065,2383286,62628,60857,228,61085,1241
2020-10-07,Sacramento,067,1510023,23831,23380,26,23406,452
2020-10-07,San Benito,069,59416,1369,1363,0,1363,13
2020-10-07,San Bernardino,071,2135413,58073,55738,363,56101,1043
2020-10-07,San Diego,073,3302833,51328,49177,1187,50364,813
2020-10-07,San Francisco,075,870044,11677,11551,37,11588,115
2020-10-07,San Joaquin,077,732212,20898,20527,80,20607,478
2020-10-07,San Luis Obispo,079,281455,4037,3749,17,3766,32
2020-10-07,San Mateo,081,765935,10689,9980,11,9991,130
2020-10-07,Santa Barbara,083,443738,9486,9350,83,9433,116
2020-10-07,Santa Clara,085,1922200,23389,21993,48,22041,320
2020-10-07,Santa Cruz,087,273765,2631,2518,32,2550,14
2020-10-07,Shasta,089,179085,1687,1268,16,1284,20
2020-10-07,Sierra,091,2930,6,6,0,6,0
2020-10-07,Siskiyou,093,43540,168,154,10,164,0
2020-10-07,Solano,095,438530,6774,6526,39,6565,53
2020-10-07,Sonoma,097,501317,8524,7993,22,8015,130
2020-10-07,Stanislaus,099,539301,17018,16786,594,17380,357
2020-10-07,Sutter,101,95872,1749,1723,1,1724,12
2020-10-07,Tehama,103,63373,706,666,2,668,3
2020-10-07,Trinity,105,12862,64,25,8,33,0
2020-10-07,Tulare,107,460477,17098,16483,196,16679,282
2020-10-07,Tuolumne,109,53932,245,227,5,232,3
2020-10-07,Ventura,111,848112,14085,13333,266,13599,150
2020-10-07,Yolo,113,214977,2982,2904,7,2911,55
2020-10-07,Yuba,115,75493,1148,1120,3,1123,10
2020-10-06,Alameda,001,1643700,22282,21698,195,21893,385
2020-10-06,Alpine,003,1148,3,3,0,3,0
2020-10-06,Amador,005,37829,303,301,0,301,16
2020-10-06,Butte,007,227075,3040,2925,30,2955,47
2020-10-06,Calaveras,009,45235,315,261,0,261,11
2020-10-06,Colusa,011,21464,538,538,0,538,6
2020-10-06,Contra Costa,013,1133247,17870,17295,86,17381,219
2020-10-06,Del Norte,015,27424,164,144,0,144,2
2020-10-06,El Dorado,017,186661,1286,1211,10,1221,4
2020-10-06,Fresno,019,978130,31718,29022,394,29416,412
2020-10-06,Glenn,021,27897,626,604,0,604,3
2020-10-06,Humboldt,023,135768,523,508,1,509,7
2020-10-06,Imperial,025,180216,12181,11196,9,11205,327
2020-10-06,Inyo,027,18085,202,198,4,202,14
2020-10-06,Kern,029,883053,32754,32006,348,32354,407
2020-10-06,Kings,031,150075,8248,7943,42,7985,81
2020-10-06,Lake,033,64148,645,596,0,596,11
2020-10-06,Lassen,035,31185,757,743,2,745,0
2020-10-06,Los Angeles,037,10098052,280137,274115,2156,276271,6657
2020-10-06,Madera,039,155013,4764,4608,32,4640,50
2020-10-06,Marin,041,260295,6909,6766,18,6784,91
2020-10-06,Mariposa,043,17540,77,75,0,75,2
2020-10-06,Mendocino,045,87422,974,920,4,924,19
2020-10-06,Merced,047,269075,9147,9034,24,9058,143
2020-10-06,Modoc,049,8938,29,26,0,26,0
2020-10-06,Mono,051,14174,173,153,3,156,1
2020-10-06,Monterey,053,433212,10501,10235,42,10277,72
2020-10-06,Napa,055,140530,1828,1770,8,1778,11
2020-10-06,Nevada,057,99092,570,551,18,569,6
2020-10-06,Orange,059,3164182,57019,54203,1570,55773,1273
2020-10-06,Placer,061,380077,3856,3680,13,3693,48
2020-10-06,Plumas,063,18699,52,49,0,49,0
2020-10-06,Riverside,065,2383286,62363,60593,226,60819,1238
2020-10-06,Sacramento,067,1510023,23744,23322,26,23348,442
2020-10-06,San Benito,069,59416,1368,1358,0,1358,12
2020-10-06,San Bernardino,071,2135413,57759,55416,359,55775,1040
2020-10-06,San Diego,073,3302833,50991,48823,1170,49993,806
2020-10-06,San Francisco,075,870044,11651,11513,36,11549,115
2020-10-06,San Joaquin,077,732212,20858,20481,77,20558,477
2020-10-06,San Luis Obispo,079,281455,4003,3723,17,3740,32
2020-10-06,San Mateo,081,765935,10657,9934,11,9945,129
2020-10-06,Santa Barbara,083,443738,9457,9331,82,9413,116
2020-10-06,Santa Clara,085,1922200,23294,21914,48,21962,320
2020-10-06,Santa Cruz,087,273765,2609,2510,32,2542,12
2020-10-06,Shasta,089,179085,1647,1242,16,1258,18
2020-10-06,Sierra,091,2930,6,6,0,6,0
2020-10-06,Siskiyou,093,43540,168,154,10,164,0
2020-10-06,Solano,095,438530,6728,6506,39,6545,52
2020-10-06,Sonoma,097,501317,8431,7895,22,7917,130
2020-10-06,Stanislaus,099,539301,16973,16759,588,17347,354
2020-10-06,Sutter,101,95872,1747,1722,1,1723,12
2020-10-06,Tehama,103,63373,696,660,2,662,3
2020-10-06,Trinity,105,12862,64,25,8,33,0
2020-10-06,Tulare,107,460477,17056,16456,188,16644,280
2020-10-06,Tuolumne,109,53932,244,227,5,232,2
2020-10-06,Ventura,111,848112,14018,13242,261,13503,150
2020-10-06,Yolo,113,214977,2968,2899,7,2906,56
2020-10-06,Yuba,115,75493,1147,1114,3,1117,10
2020-10-05,Alameda,001,1643700,22194,21637,192,21829,383
2020-10-05,Alpine,003,1148,3,2,0,2,0
2020-10-05,Amador,005,37829,303,299,0,299,16
2020-10-05,Butte,007,227075,3030,2910,30,2940,46
2020-10-05,Calaveras,009,45235,315,259,0,259,11
2020-10-05,Colusa,011,21464,538,537,0,537,6
2020-10-05,Contra Costa,013,1133247,17793,17250,86,17336,216
2020-10-05,Del Norte,015,27424,161,142,0,142,2
2020-10-05,El Dorado,017,186661,1282,1202,9,1211,4
2020-10-05,Fresno,019,978130,31601,29136,394,29530,408
2020-10-05,Glenn,021,27897,624,603,0,603,3
2020-10-05,Humboldt,023,135768,522,506,1,507,6
2020-10-05,Imperial,025,180216,12141,11169,9,11178,327
2020-10-05,Inyo,027,18085,202,197,4,201,14
2020-10-05,Kern,029,883053,32675,31933,344,32277,404
2020-10-05,Kings,031,150075,8151,7932,42,7974,80
2020-10-05,Lake,033,64148,641,592,0,592,10
2020-10-05,Lassen,035,31185,756,743,2,745,0
2020-10-05,Los Angeles,037,10098052,279043,273200,2117,275317,6632
2020-10-05,Madera,039,155013,4756,4598,30,4628,50
2020-10-05,Marin,041,260295,6892,6751,18,6769,91
2020-10-05,Mariposa,043,17540,77,75,0,75,2
2020-10-05,Mendocino,045,87422,966,913,4,917,19
2020-10-05,Merced,047,269075,9128,9021,23,9044,143
2020-10-05,Modoc,049,8938,29,26,0,26,0
2020-10-05,Mono,051,14174,173,152,3,155,1
2020-10-05,Monterey,053,433212,10454,10187,42,10229,72
2020-10-05,Napa,055,140530,1817,1760,8,1768,11
2020-10-05,Nevada,057,99092,567,550,17,567,6
2020-10-05,Orange,059,3164182,56803,54103,1557,55660,1271
2020-10-05,Placer,061,380077,3830,3670,13,3683,46
2020-10-05,Plumas,063,18699,51,49,0,49,0
2020-10-05,Riverside,065,2383286,62043,60454,222,60676,1232
2020-10-05,Sacramento,067,1510023,23640,23207,26,23233,438
2020-10-05,San Benito,069,59416,1365,1356,0,1356,12
2020-10-05,San Bernardino,071,2135413,57452,55100,358,55458,1031
2020-10-05,San Diego,073,3302833,50655,48662,1146,49808,803
2020-10-05,San Francisco,075,870044,11612,11476,34,11510,110
2020-10-05,San Joaquin,077,732212,20788,20319,74,20393,476
2020-10-05,San Luis Obispo,079,281455,3976,3710,17,3727,32
2020-10-05,San Mateo,081,765935,10630,9896,11,9907,128
2020-10-05,Santa Barbara,083,443738,9435,9309,82,9391,116
2020-10-05,Santa Clara,085,1922200,23177,21861,48,21909,319
2020-10-05,Santa Cruz,087,273765,2597,2492,32,2524,9
2020-10-05,Shasta,089,179085,1615,1158,16,1174,18
2020-10-05,Sierra,091,2930,6,6,0,6,0
2020-10-05,Siskiyou,093,43540,168,153,10,163,0
2020-10-05,Solano,095,438530,6689,6475,39,6514,52
2020-10-05,Sonoma,097,501317,8339,7817,22,7839,130
2020-10-05,Stanislaus,099,539301,16937,16730,581,17311,351
2020-10-05,Sutter,101,95872,1739,1719,1,1720,12
2020-10-05,Tehama,103,63373,688,642,2,644,3
2020-10-05,Trinity,105,12862,62,22,8,30,0
2020-10-05,Tulare,107,460477,16997,16343,183,16526,278
2020-10-05,Tuolumne,109,53932,241,226,5,231,2
2020-10-05,Ventura,111,848112,13949,13224,242,13466,149
2020-10-05,Yolo,113,214977,2949,2889,7,2896,56
2020-10-05,Yuba,115,75493,1134,1108,3,1111,9
2020-10-04,Alameda,001,1643700,22098,21597,192,21789,383
2020-10-04,Alpine,003,1148,3,2,0,2,0
2020-10-04,Amador,005,37829,302,297,0,297,16
2020-10-04,Butte,007,227075,3016,2903,30,2933,46
2020-10-04,Calaveras,009,45235,315,259,0,259,11
2020-10-04,Colusa,011,21464,537,537,0,537,6
2020-10-04,Contra Costa,013,1133247,17728,17192,86,17278,214
2020-10-04,Del Norte,015,27424,157,142,0,142,2
2020-10-04,El Dorado,017,186661,1278,1196,9,1205,4
2020-10-04,Fresno,019,978130,31478,29065,394,29459,408
2020-10-04,Glenn,021,27897,622,601,0,601,3
2020-10-04,Humboldt,023,135768,521,506,1,507,6
2020-10-04,Imperial,025,180216,12102,11127,9,11136,327
2020-10-04,Inyo,027,18085,199,195,4,199,14
2020-10-04,Kern,029,883053,32601,31906,341,32247,404
2020-10-04,Kings,031,150075,8136,7919,42,7961,80
2020-10-04,Lake,033,64148,627,589,0,589,10
2020-10-04,Lassen,035,31185,756,743,2,745,0
2020-10-04,Los Angeles,037,10098052,277657,272822,2069,274891,6625
2020-10-04,Madera,039,155013,4740,4587,30,4617,50
2020-10-04,Marin,041,260295,6872,6741,18,6759,91
2020-10-04,Mariposa,043,17540,77,75,0,75,2
2020-10-04,Mendocino,045,87422,953,905,4,909,18
2020-10-04,Merced,047,269075,9103,9006,23,9029,140
2020-10-04,Modoc,049,8938,29,26,0,26,0
2020-10-04,Mono,051,14174,172,152,2,154,1
2020-10-04,Monterey,053,433212,10413,10141,41,10182,72
2020-10-04,Napa,055,140530,1805,1759,8,1767,11
2020-10-04,Nevada,057,99092,563,547,16,563,6
2020-10-04,Orange,059,3164182,56567,53966,1548,55514,1270
2020-10-04,Placer,061,380077,3809,3664,13,3677,46
2020-10-04,Plumas,063,18699,51,49,0,49,0
2020-10-04,Riverside,065,2383286,61757,60251,218,60469,1226
2020-10-04,Sacramento,067,1510023,23527,23162,26,23188,438
2020-10-04,San Benito,069,59416,1365,1355,0,1355,12
2020-10-04,San Bernardino,071,2135413,57004,55100,356,55456,1031
2020-10-04,San Diego,073,3302833,50288,48438,1121,49559,803
2020-10-04,San Francisco,075,870044,11580,11474,32,11506,110
2020-10-04,San Joaquin,077,732212,20711,20320,68,20388,476
2020-10-04,San Luis Obispo,079,281455,3951,3688,17,3705,31
2020-10-04,San Mateo,081,765935,10570,9858,11,9869,128
2020-10-04,Santa Barbara,083,443738,9409,9276,80,9356,116
2020-10-04,Santa Clara,085,1922200,23040,21780,48,21828,316
2020-10-04,Santa Cruz,087,273765,2581,2483,32,2515,9
2020-10-04,Shasta,089,179085,1517,1158,15,1173,18
2020-10-04,Sierra,091,2930,6,6,0,6,0
2020-10-04,Siskiyou,093,43540,168,153,10,163,0
2020-10-04,Solano,095,438530,6638,6445,39,6484,52
2020-10-04,Sonoma,097,501317,8251,7794,22,7816,129
2020-10-04,Stanislaus,099,539301,16887,16711,572,17283,351
2020-10-04,Sutter,101,95872,1736,1711,1,1712,11
2020-10-04,Tehama,103,63373,673,637,2,639,3
2020-10-04,Trinity,105,12862,61,21,8,29,0
2020-10-04,Tulare,107,460477,16920,16343,172,16515,278
2020-10-04,Tuolumne,109,53932,239,226,5,231,2
2020-10-04,Ventura,111,848112,13867,13197,225,13422,149
2020-10-04,Yolo,113,214977,2938,2875,7,2882,56
2020-10-04,Yuba,115,75493,1130,1103,3,1106,9
2020-10-03,Alameda,001,1643700,22052,21510,191,21701,386
2020-10-03,Alpine,003,1148,3,2,0,2,0
2020-10-03,Amador,005,37829,301,296,0,296,16
2020-10-03,Butte,007,227075,3010,2894,30,2924,46
2020-10-03,Calaveras,009,45235,315,259,0,259,11
2020-10-03,Colusa,011,21464,536,537,0,537,6
2020-10-03,Contra Costa,013,1133247,17678,17087,84,17171,213
2020-10-03,Del Norte,015,27424,153,142,0,142,2
2020-10-03,El Dorado,017,186661,1271,1188,9,1197,4
2020-10-03,Fresno,019,978130,31418,28975,393,29368,408
2020-10-03,Glenn,021,27897,620,601,0,601,3
2020-10-03,Humboldt,023,135768,520,504,1,505,6
2020-10-03,Imperial,025,180216,12079,11090,9,11099,327
2020-10-03,Inyo,027,18085,199,194,4,198,14
2020-10-03,Kern,029,883053,32551,31864,337,32201,403
2020-10-03,Kings,031,150075,8132,7887,42,7929,80
2020-10-03,Lake,033,64148,617,588,0,588,10
2020-10-03,Lassen,035,31185,756,743,2,745,0
2020-10-03,Los Angeles,037,10098052,276950,271869,2040,273909,6620
2020-10-03,Madera,039,155013,4723,4565,30,4595,50
2020-10-03,Marin,041,260295,6866,6728,18,6746,91
2020-10-03,Mariposa,043,17540,77,75,0,75,2
2020-10-03,Mendocino,045,87422,951,898,4,902,18
2020-10-03,Merced,047,269075,9090,8986,23,9009,139
2020-10-03,Modoc,049,8938,29,26,0,26,0
2020-10-03,Mono,051,14174,171,152,2,154,1
2020-10-03,Monterey,053,433212,10379,10092,38,10130,72
2020-10-03,Napa,055,140530,1801,1752,8,1760,11
2020-10-03,Nevada,057,99092,562,544,16,560,6
2020-10-03,Orange,059,3164182,56450,53573,1543,55116,1268
2020-10-03,Placer,061,380077,3798,3648,13,3661,47
2020-10-03,Plumas,063,18699,51,48,0,48,0
2020-10-03,Riverside,065,2383286,61605,59991,216,60207,1226
2020-10-03,Sacramento,067,1510023,23476,23076,26,23102,437
2020-10-03,San Benito,069,59416,1365,1351,0,1351,12
2020-10-03,San Bernardino,071,2135413,56831,55004,353,55357,1031
2020-10-03,San Diego,073,3302833,50057,48202,1104,49306,798
2020-10-03,San Francisco,075,870044,11555,11475,30,11505,110
2020-10-03,San Joaquin,077,732212,20685,20322,68,20390,476
2020-10-03,San Luis Obispo,079,281455,3927,3670,17,3687,31
2020-10-03,San Mateo,081,765935,10543,9822,10,9832,128
2020-10-03,Santa Barbara,083,443738,9396,9256,80,9336,116
2020-10-03,Santa Clara,085,1922200,22960,21672,48,21720,309
2020-10-03,Santa Cruz,087,273765,2573,2476,32,2508,9
2020-10-03,Shasta,089,179085,1489,1117,14,1131,18
2020-10-03,Sierra,091,2930,6,6,0,6,0
2020-10-03,Siskiyou,093,43540,168,152,10,162,0
2020-10-03,Solano,095,438530,6612,6419,39,6458,52
2020-10-03,Sonoma,097,501317,8209,7747,22,7769,129
2020-10-03,Stanislaus,099,539301,16854,16645,568,17213,351
2020-10-03,Sutter,101,95872,1732,1705,1,1706,11
2020-10-03,Tehama,103,63373,667,630,2,632,3
2020-10-03,Trinity,105,12862,61,15,8,23,0
2020-10-03,Tulare,107,460477,16876,16322,168,16490,278
2020-10-03,Tuolumne,109,53932,238,224,5,229,2
2020-10-03,Ventura,111,848112,13829,13150,221,13371,148
2020-10-03,Yolo,113,214977,2931,2863,7,2870,56
2020-10-03,Yuba,115,75493,1122,1097,3,1100,8
2020-10-02,Alameda,001,1643700,21997,21404,190,21594,382
2020-10-02,Alpine,003,1148,3,2,0,2,0
2020-10-02,Amador,005,37829,300,296,0,296,16
2020-10-02,Butte,007,227075,3000,2879,30,2909,46
2020-10-02,Calaveras,009,45235,314,259,0,259,11
2020-10-02,Colusa,011,21464,535,537,0,537,6
2020-10-02,Contra Costa,013,1133247,17635,17002,83,17085,213
2020-10-02,Del Norte,015,27424,152,141,0,141,2
2020-10-02,El Dorado,017,186661,1264,1168,9,1177,4
2020-10-02,Fresno,019,978130,31335,28855,393,29248,403
2020-10-02,Glenn,021,27897,615,594,0,594,3
2020-10-02,Humboldt,023,135768,519,503,1,504,6
2020-10-02,Imperial,025,180216,12057,11024,9,11033,327
2020-10-02,Inyo,027,18085,197,191,4,195,14
2020-10-02,Kern,029,883053,32499,31790,335,32125,399
2020-10-02,Kings,031,150075,8123,7716,42,7758,79
2020-10-02,Lake,033,64148,611,579,0,579,10
2020-10-02,Lassen,035,31185,756,742,2,744,0
2020-10-02,Los Angeles,037,10098052,276049,270935,2014,272949,6602
2020-10-02,Madera,039,155013,4714,4537,30,4567,49
2020-10-02,Marin,041,260295,6849,6717,18,6735,91
2020-10-02,Mariposa,043,17540,77,75,0,75,2
2020-10-02,Mendocino,045,87422,946,883,4,887,18
2020-10-02,Merced,047,269075,9080,8961,23,8984,139
2020-10-02,Modoc,049,8938,29,26,0,26,0
2020-10-02,Mono,051,14174,171,150,2,152,1
2020-10-02,Monterey,053,433212,10345,9997,38,10035,71
2020-10-02,Napa,055,140530,1795,1737,8,1745,11
2020-10-02,Nevada,057,99092,559,543,16,559,6
2020-10-02,Orange,059,3164182,56319,53299,1536,54835,1262
2020-10-02,Placer,061,380077,3778,3612,13,3625,46
2020-10-02,Plumas,063,18699,51,48,0,48,0
2020-10-02,Riverside,065,2383286,61384,59673,213,59886,1223
2020-10-02,Sacramento,067,1510023,23411,22818,26,22844,436
2020-10-02,San Benito,069,59416,1361,1347,0,1347,12
2020-10-02,San Bernardino,071,2135413,56644,54613,353,54966,1028
2020-10-02,San Diego,073,3302833,49805,47793,1088,48881,794
2020-10-02,San Francisco,075,870044,11532,11398,30,11428,110
2020-10-02,San Joaquin,077,732212,20651,20235,67,20302,474
2020-10-02,San Luis Obispo,079,281455,3904,3654,17,3671,31
2020-10-02,San Mateo,081,765935,10502,9745,10,9755,128
2020-10-02,Santa Barbara,083,443738,9373,9234,80,9314,116
2020-10-02,Santa Clara,085,1922200,22874,21545,47,21592,305
2020-10-02,Santa Cruz,087,273765,2556,2463,32,2495,9
2020-10-02,Shasta,089,179085,1454,1046,14,1060,18
2020-10-02,Sierra,091,2930,6,6,0,6,0
2020-10-02,Siskiyou,093,43540,168,151,10,161,0
2020-10-02,Solano,095,438530,6582,6385,39,6424,52
2020-10-02,Sonoma,097,501317,8152,7662,22,7684,125
2020-10-02,Stanislaus,099,539301,16813,16609,559,17168,349
2020-10-02,Sutter,101,95872,1731,1693,1,1694,11
2020-10-02,Tehama,103,63373,662,619,2,621,3
2020-10-02,Trinity,105,12862,61,15,8,23,0
2020-10-02,Tulare,107,460477,16835,16245,161,16406,278
2020-10-02,Tuolumne,109,53932,236,225,5,230,2
2020-10-02,Ventura,111,848112,13790,13120,216,13336,146
2020-10-02,Yolo,113,214977,2926,2845,7,2852,55
2020-10-02,Yuba,115,75493,1120,1090,3,1093,8
2020-10-01,Alameda,001,1643700,21936,21349,186,21535,383
2020-10-01,Alpine,003,1148,3,2,0,2,0
2020-10-01,Amador,005,37829,300,294,0,294,16
2020-10-01,Butte,007,227075,2992,2865,30,2895,45
2020-10-01,Calaveras,009,45235,314,257,0,257,11
2020-10-01,Colusa,011,21464,535,536,0,536,6
2020-10-01,Contra Costa,013,1133247,17572,16898,83,16981,211
2020-10-01,Del Norte,015,27424,147,140,0,140,2
2020-10-01,El Dorado,017,186661,1260,1162,8,1170,4
2020-10-01,Fresno,019,978130,31255,28796,391,29187,397
2020-10-01,Glenn,021,27897,611,593,0,593,3
2020-10-01,Humboldt,023,135768,519,499,1,500,6
2020-10-01,Imperial,025,180216,12014,10928,9,10937,325
2020-10-01,Inyo,027,18085,197,191,4,195,14
2020-10-01,Kern,029,883053,32436,31678,330,32008,399
2020-10-01,Kings,031,150075,8112,7688,39,7727,79
2020-10-01,Lake,033,64148,605,572,0,572,11
2020-10-01,Lassen,035,31185,753,742,2,744,0
2020-10-01,Los Angeles,037,10098052,275003,271513,1981,273494,6621
2020-10-01,Madera,039,155013,4691,4508,30,4538,48
2020-10-01,Marin,041,260295,6835,6710,18,6728,92
2020-10-01,Mariposa,043,17540,77,76,0,76,2
2020-10-01,Mendocino,045,87422,941,874,4,878,19
2020-10-01,Merced,047,269075,9052,8942,23,8965,138
2020-10-01,Modoc,049,8938,29,26,0,26,0
2020-10-01,Mono,051,14174,169,150,2,152,1
2020-10-01,Monterey,053,433212,10269,9958,38,9996,71
2020-10-01,Napa,055,140530,1787,1729,8,1737,11
2020-10-01,Nevada,057,99092,558,543,16,559,6
2020-10-01,Orange,059,3164182,56154,53088,1523,54611,1257
2020-10-01,Placer,061,380077,3751,3599,13,3612,45
2020-10-01,Plumas,063,18699,51,48,0,48,0
2020-10-01,Riverside,065,2383286,61132,59293,207,59500,1223
2020-10-01,Sacramento,067,1510023,23299,22714,25,22739,433
2020-10-01,San Benito,069,59416,1359,1346,0,1346,12
2020-10-01,San Bernardino,071,2135413,56351,54350,350,54700,1021
2020-10-01,San Diego,073,3302833,49523,47487,1068,48555,792
2020-10-01,San Francisco,075,870044,11501,11284,28,11312,110
2020-10-01,San Joaquin,077,732212,20604,20204,64,20268,471
2020-10-01,San Luis Obispo,079,281455,3877,3625,17,3642,31
2020-10-01,San Mateo,081,765935,10457,9681,10,9691,128
2020-10-01,Santa Barbara,083,443738,9333,9215,80,9295,118
2020-10-01,Santa Clara,085,1922200,22773,21398,47,21445,305
2020-10-01,Santa Cruz,087,273765,2541,2418,32,2450,10
2020-10-01,Shasta,089,179085,1403,991,14,1005,18
2020-10-01,Sierra,091,2930,6,6,0,6,0
2020-10-01,Siskiyou,093,43540,165,150,10,160,0
2020-10-01,Solano,095,438530,6544,6352,39,6391,52
2020-10-01,Sonoma,097,501317,8085,7569,22,7591,125
2020-10-01,Stanislaus,099,539301,16780,16555,553,17108,346
2020-10-01,Sutter,101,95872,1726,1684,1,1685,11
2020-10-01,Tehama,103,63373,652,606,2,608,3
2020-10-01,Trinity,105,12862,61,15,8,23,0
2020-10-01,Tulare,107,460477,16760,16182,158,16340,275
2020-10-01,Tuolumne,109,53932,236,223,5,228,2
2020-10-01,Ventura,111,848112,13738,13057,203,13260,146
2020-10-01,Yolo,113,214977,2908,2833,7,2840,55
2020-10-01,Yuba,115,75493,1116,1082,3,1085,8
2020-09-30,Alameda,001,1643700,21858,21271,183,21454,380
2020-09-30,Alpine,003,1148,3,2,0,2,0
2020-09-30,Amador,005,37829,300,294,0,294,16
2020-09-30,Butte,007,227075,2984,2858,30,2888,44
2020-09-30,Calaveras,009,45235,313,258,0,258,11
2020-09-30,Colusa,011,21464,534,534,0,534,6
2020-09-30,Contra Costa,013,1133247,17504,16819,83,16902,211
2020-09-30,Del Norte,015,27424,146,140,0,140,2
2020-09-30,El Dorado,017,186661,1248,1157,8,1165,4
2020-09-30,Fresno,019,978130,31166,28706,388,29094,395
2020-09-30,Glenn,021,27897,606,592,0,592,3
2020-09-30,Humboldt,023,135768,517,497,1,498,6
2020-09-30,Imperial,025,180216,11989,10868,9,10877,287
2020-09-30,Inyo,027,18085,196,189,4,193,14
2020-09-30,Kern,029,883053,32361,31601,329,31930,398
2020-09-30,Kings,031,150075,8084,7685,39,7724,79
2020-09-30,Lake,033,64148,599,567,0,567,10
2020-09-30,Lassen,035,31185,750,742,2,744,0
2020-09-30,Los Angeles,037,10098052,273780,270260,1948,272208,6568
2020-09-30,Madera,039,155013,4682,4477,30,4507,47
2020-09-30,Marin,041,260295,6811,6700,17,6717,91
2020-09-30,Mariposa,043,17540,77,76,0,76,2
2020-09-30,Mendocino,045,87422,935,867,4,871,17
2020-09-30,Merced,047,269075,9032,8926,23,8949,136
2020-09-30,Modoc,049,8938,29,26,0,26,0
2020-09-30,Mono,051,14174,169,150,2,152,1
2020-09-30,Monterey,053,433212,10219,9898,37,9935,70
2020-09-30,Napa,055,140530,1773,1728,8,1736,11
2020-09-30,Nevada,057,99092,556,540,16,556,6
2020-09-30,Orange,059,3164182,55963,52916,1507,54423,1251
2020-09-30,Placer,061,380077,3730,3585,13,3598,43
2020-09-30,Plumas,063,18699,51,48,0,48,0
2020-09-30,Riverside,065,2383286,60777,59074,203,59277,1220
2020-09-30,Sacramento,067,1510023,23195,22613,25,22638,429
2020-09-30,San Benito,069,59416,1356,1342,0,1342,12
2020-09-30,San Bernardino,071,2135413,56073,53988,349,54337,1018
2020-09-30,San Diego,073,3302833,49219,47182,1047,48229,783
2020-09-30,San Francisco,075,870044,11471,11247,28,11275,106
2020-09-30,San Joaquin,077,732212,20521,20150,62,20212,461
2020-09-30,San Luis Obispo,079,281455,3852,3597,17,3614,31
2020-09-30,San Mateo,081,765935,10415,9634,10,9644,128
2020-09-30,Santa Barbara,083,443738,9307,9186,80,9266,115
2020-09-30,Santa Clara,085,1922200,22668,21318,47,21365,302
2020-09-30,Santa Cruz,087,273765,2528,2405,32,2437,10
2020-09-30,Shasta,089,179085,1347,976,13,989,17
2020-09-30,Sierra,091,2930,6,6,0,6,0
2020-09-30,Siskiyou,093,43540,163,150,10,160,0
2020-09-30,Solano,095,438530,6502,6315,39,6354,51
2020-09-30,Sonoma,097,501317,7996,7494,22,7516,125
2020-09-30,Stanislaus,099,539301,16733,16531,547,17078,343
2020-09-30,Sutter,101,95872,1710,1680,1,1681,10
2020-09-30,Tehama,103,63373,646,594,2,596,3
2020-09-30,Trinity,105,12862,58,15,8,23,0
2020-09-30,Tulare,107,460477,16694,16117,151,16268,274
2020-09-30,Tuolumne,109,53932,234,224,5,229,2
2020-09-30,Ventura,111,848112,13703,12968,187,13155,145
2020-09-30,Yolo,113,214977,2895,2822,7,2829,55
2020-09-30,Yuba,115,75493,1113,1075,3,1078,8
2020-09-29,Alameda,001,1643700,21783,21241,180,21421,374
2020-09-29,Alpine,003,1148,3,2,0,2,0
2020-09-29,Amador,005,37829,298,294,0,294,16
2020-09-29,Butte,007,227075,2970,2848,30,2878,44
2020-09-29,Calaveras,009,45235,311,261,0,261,11
2020-09-29,Colusa,011,21464,534,534,0,534,6
2020-09-29,Contra Costa,013,1133247,17449,16716,81,16797,209
2020-09-29,Del Norte,015,27424,142,142,0,142,2
2020-09-29,El Dorado,017,186661,1239,1151,8,1159,4
2020-09-29,Fresno,019,978130,31071,28621,387,29008,394
2020-09-29,Glenn,021,27897,602,589,0,589,3
2020-09-29,Humboldt,023,135768,515,497,1,498,6
2020-09-29,Imperial,025,180216,11955,10811,9,10820,283
2020-09-29,Inyo,027,18085,195,188,4,192,14
2020-09-29,Kern,029,883053,32306,31534,328,31862,397
2020-09-29,Kings,031,150075,8028,7681,39,7720,78
2020-09-29,Lake,033,64148,597,566,0,566,11
2020-09-29,Lassen,035,31185,750,741,2,743,0
2020-09-29,Los Angeles,037,10098052,272565,269246,1920,271166,6545
2020-09-29,Madera,039,155013,4658,4453,30,4483,47
2020-09-29,Marin,041,260295,6790,6692,17,6709,91
2020-09-29,Mariposa,043,17540,77,74,0,74,2
2020-09-29,Mendocino,045,87422,925,854,4,858,17
2020-09-29,Merced,047,269075,9019,8892,21,8913,136
2020-09-29,Modoc,049,8938,29,26,0,26,0
2020-09-29,Mono,051,14174,169,149,2,151,1
2020-09-29,Monterey,053,433212,10164,9826,35,9861,70
2020-09-29,Napa,055,140530,1770,1727,8,1735,11
2020-09-29,Nevada,057,99092,551,539,16,555,6
2020-09-29,Orange,059,3164182,55777,52755,1496,54251,1231
2020-09-29,Placer,061,380077,3708,3570,13,3583,42
2020-09-29,Plumas,063,18699,51,48,0,48,0
2020-09-29,Riverside,065,2383286,60447,58863,196,59059,1208
2020-09-29,Sacramento,067,1510023,23074,22547,25,22572,425
2020-09-29,San Benito,069,59416,1351,1341,0,1341,12
2020-09-29,San Bernardino,071,2135413,55763,53753,348,54101,1012
2020-09-29,San Diego,073,3302833,48942,46987,1024,48011,781
2020-09-29,San Francisco,075,870044,11435,11142,28,11170,104
2020-09-29,San Joaquin,077,732212,20455,20094,60,20154,454
2020-09-29,San Luis Obispo,079,281455,3830,3581,17,3598,31
2020-09-29,San Mateo,081,765935,10368,9619,10,9629,127
2020-09-29,Santa Barbara,083,443738,9287,9149,79,9228,114
2020-09-29,Santa Clara,085,1922200,22532,21233,46,21279,302
2020-09-29,Santa Cruz,087,273765,2513,2383,31,2414,10
2020-09-29,Shasta,089,179085,1286,943,13,956,17
2020-09-29,Sierra,091,2930,6,6,0,6,0
2020-09-29,Siskiyou,093,43540,157,150,10,160,0
2020-09-29,Solano,095,438530,6468,6303,39,6342,51
2020-09-29,Sonoma,097,501317,7924,7426,22,7448,125
2020-09-29,Stanislaus,099,539301,16703,16505,541,17046,341
2020-09-29,Sutter,101,95872,1704,1677,1,1678,10
2020-09-29,Tehama,103,63373,628,585,2,587,2
2020-09-29,Trinity,105,12862,56,16,8,24,0
2020-09-29,Tulare,107,460477,16630,16055,144,16199,270
2020-09-29,Tuolumne,109,53932,234,224,5,229,2
2020-09-29,Ventura,111,848112,13646,12875,184,13059,145
2020-09-29,Yolo,113,214977,2882,2818,7,2825,55
2020-09-29,Yuba,115,75493,1111,1071,3,1074,8
2020-09-28,Alameda,001,1643700,21696,21133,180,21313,370
2020-09-28,Alpine,003,1148,3,2,0,2,0
2020-09-28,Amador,005,37829,296,294,0,294,16
2020-09-28,Butte,007,227075,2955,2837,30,2867,44
2020-09-28,Calaveras,009,45235,311,257,0,257,11
2020-09-28,Colusa,011,21464,533,531,0,531,6
2020-09-28,Contra Costa,013,1133247,17385,16653,81,16734,195
2020-09-28,Del Norte,015,27424,142,138,0,138,2
2020-09-28,El Dorado,017,186661,1232,1144,8,1152,4
2020-09-28,Fresno,019,978130,30990,28517,381,28898,389
2020-09-28,Glenn,021,27897,600,585,0,585,3
2020-09-28,Humboldt,023,135768,509,495,1,496,6
2020-09-28,Imperial,025,180216,11920,10777,9,10786,283
2020-09-28,Inyo,027,18085,194,188,4,192,14
2020-09-28,Kern,029,883053,32241,31481,324,31805,395
2020-09-28,Kings,031,150075,7887,7661,37,7698,78
2020-09-28,Lake,033,64148,593,559,0,559,10
2020-09-28,Lassen,035,31185,749,737,2,739,0
2020-09-28,Los Angeles,037,10098052,271458,268404,1890,270294,6508
2020-09-28,Madera,039,155013,4637,4438,30,4468,47
2020-09-28,Marin,041,260295,6774,6676,17,6693,91
2020-09-28,Mariposa,043,17540,77,74,0,74,2
2020-09-28,Mendocino,045,87422,910,850,4,854,17
2020-09-28,Merced,047,269075,8991,8869,21,8890,136
2020-09-28,Modoc,049,8938,29,26,0,26,0
2020-09-28,Mono,051,14174,169,148,2,150,1
2020-09-28,Monterey,053,433212,10099,9780,33,9813,69
2020-09-28,Napa,055,140530,1758,1705,8,1713,11
2020-09-28,Nevada,057,99092,543,538,16,554,6
2020-09-28,Orange,059,3164182,55571,52633,1487,54120,1196
2020-09-28,Placer,061,380077,3687,3572,13,3585,42
2020-09-28,Plumas,063,18699,50,48,0,48,0
2020-09-28,Riverside,065,2383286,60149,58570,187,58757,1198
2020-09-28,Sacramento,067,1510023,22927,22392,25,22417,423
2020-09-28,San Benito,069,59416,1348,1336,0,1336,11
2020-09-28,San Bernardino,071,2135413,55415,53501,348,53849,988
2020-09-28,San Diego,073,3302833,48624,46736,1004,47740,776
2020-09-28,San Francisco,075,870044,11401,11114,28,11142,100
2020-09-28,San Joaquin,077,732212,20407,19982,59,20041,448
2020-09-28,San Luis Obispo,079,281455,3809,3567,17,3584,31
2020-09-28,San Mateo,081,765935,10318,9582,10,9592,127
2020-09-28,Santa Barbara,083,443738,9269,9121,79,9200,114
2020-09-28,Santa Clara,085,1922200,22415,21180,46,21226,271
2020-09-28,Santa Cruz,087,273765,2503,2359,31,2390,9
2020-09-28,Shasta,089,179085,1232,883,10,893,17
2020-09-28,Sierra,091,2930,6,6,0,6,0
2020-09-28,Siskiyou,093,43540,157,149,10,159,0
2020-09-28,Solano,095,438530,6432,6254,39,6293,51
2020-09-28,Sonoma,097,501317,7848,7369,22,7391,125
2020-09-28,Stanislaus,099,539301,16664,16467,534,17001,336
2020-09-28,Sutter,101,95872,1697,1676,1,1677,10
2020-09-28,Tehama,103,63373,620,579,2,581,2
2020-09-28,Trinity,105,12862,56,16,8,24,0
2020-09-28,Tulare,107,460477,16577,15918,139,16057,270
2020-09-28,Tuolumne,109,53932,234,225,5,230,2
2020-09-28,Ventura,111,848112,13568,12812,178,12990,139
2020-09-28,Yolo,113,214977,2865,2809,7,2816,55
2020-09-28,Yuba,115,75493,1108,1062,3,1065,7
2020-09-27,Alameda,001,1643700,21614,21077,176,21253,370
2020-09-27,Alpine,003,1148,3,2,0,2,0
2020-09-27,Amador,005,37829,296,291,0,291,16
2020-09-27,Butte,007,227075,2943,2833,30,2863,44
2020-09-27,Calaveras,009,45235,310,257,0,257,11
2020-09-27,Colusa,011,21464,532,531,0,531,6
2020-09-27,Contra Costa,013,1133247,17283,16596,80,16676,195
2020-09-27,Del Norte,015,27424,142,138,0,138,2
2020-09-27,El Dorado,017,186661,1217,1130,8,1138,4
2020-09-27,Fresno,019,978130,30885,28441,381,28822,389
2020-09-27,Glenn,021,27897,596,576,0,576,3
2020-09-27,Humboldt,023,135768,507,492,1,493,6
2020-09-27,Imperial,025,180216,11886,10743,9,10752,283
2020-09-27,Inyo,027,18085,192,188,4,192,14
2020-09-27,Kern,029,883053,32122,31462,321,31783,395
2020-09-27,Kings,031,150075,7867,7641,37,7678,78
2020-09-27,Lake,033,64148,589,555,0,555,10
2020-09-27,Lassen,035,31185,749,737,2,739,0
2020-09-27,Los Angeles,037,10098052,270278,267754,1870,269624,6507
2020-09-27,Madera,039,155013,4608,4416,30,4446,47
2020-09-27,Marin,041,260295,6764,6663,17,6680,91
2020-09-27,Mariposa,043,17540,77,74,0,74,2
2020-09-27,Mendocino,045,87422,904,846,4,850,17
2020-09-27,Merced,047,269075,8957,8853,21,8874,136
2020-09-27,Modoc,049,8938,29,26,0,26,0
2020-09-27,Mono,051,14174,169,148,2,150,1
2020-09-27,Monterey,053,433212,10039,9724,32,9756,69
2020-09-27,Napa,055,140530,1753,1690,8,1698,11
2020-09-27,Nevada,057,99092,542,537,16,553,6
2020-09-27,Orange,059,3164182,55296,52458,1478,53936,1195
2020-09-27,Placer,061,380077,3674,3562,13,3575,42
2020-09-27,Plumas,063,18699,50,48,0,48,0
2020-09-27,Riverside,065,2383286,59853,58509,179,58688,1191
2020-09-27,Sacramento,067,1510023,22829,22356,25,22381,422
2020-09-27,San Benito,069,59416,1348,1331,0,1331,11
2020-09-27,San Bernardino,071,2135413,54979,53127,348,53475,988
2020-09-27,San Diego,073,3302833,48280,46612,987,47599,776
2020-09-27,San Francisco,075,870044,11349,11114,28,11142,100
2020-09-27,San Joaquin,077,732212,20347,19981,59,20040,448
2020-09-27,San Luis Obispo,079,281455,3789,3562,17,3579,31
2020-09-27,San Mateo,081,765935,10250,9566,10,9576,127
2020-09-27,Santa Barbara,083,443738,9248,9090,78,9168,114
2020-09-27,Santa Clara,085,1922200,22306,21091,46,21137,271
2020-09-27,Santa Cruz,087,273765,2481,2359,31,2390,9
2020-09-27,Shasta,089,179085,1189,883,9,892,17
2020-09-27,Sierra,091,2930,6,6,0,6,0
2020-09-27,Siskiyou,093,43540,156,149,10,159,0
2020-09-27,Solano,095,438530,6397,6211,39,6250,51
2020-09-27,Sonoma,097,501317,7767,7336,22,7358,124
2020-09-27,Stanislaus,099,539301,16613,16448,528,16976,336
2020-09-27,Sutter,101,95872,1690,1672,1,1673,10
2020-09-27,Tehama,103,63373,603,573,2,575,2
2020-09-27,Trinity,105,12862,56,16,8,24,0
2020-09-27,Tulare,107,460477,16499,15918,130,16048,270
2020-09-27,Tuolumne,109,53932,233,224,5,229,2
2020-09-27,Ventura,111,848112,13479,12775,169,12944,139
2020-09-27,Yolo,113,214977,2851,2796,7,2803,55
2020-09-27,Yuba,115,75493,1098,1059,3,1062,7
2020-09-26,Alameda,001,1643700,21556,21019,175,21194,370
2020-09-26,Alpine,003,1148,3,2,0,2,0
2020-09-26,Amador,005,37829,295,291,0,291,16
2020-09-26,Butte,007,227075,2935,2827,30,2857,44
2020-09-26,Calaveras,009,45235,310,257,0,257,11
2020-09-26,Colusa,011,21464,532,529,0,529,6
2020-09-26,Contra Costa,013,1133247,17240,16508,80,16588,194
2020-09-26,Del Norte,015,27424,142,138,0,138,2
2020-09-26,El Dorado,017,186661,1212,1127,8,1135,4
2020-09-26,Fresno,019,978130,30818,28336,381,28717,389
2020-09-26,Glenn,021,27897,596,576,0,576,3
2020-09-26,Humboldt,023,135768,507,491,1,492,6
2020-09-26,Imperial,025,180216,11869,10721,9,10730,283
2020-09-26,Inyo,027,18085,191,187,4,191,14
2020-09-26,Kern,029,883053,32071,31410,321,31731,394
2020-09-26,Kings,031,150075,7855,7537,37,7574,78
2020-09-26,Lake,033,64148,586,549,0,549,10
2020-09-26,Lassen,035,31185,749,737,2,739,0
2020-09-26,Los Angeles,037,10098052,269646,266931,1856,268787,6497
2020-09-26,Madera,039,155013,4592,4410,30,4440,47
2020-09-26,Marin,041,260295,6751,6641,17,6658,91
2020-09-26,Mariposa,043,17540,76,74,0,74,2
2020-09-26,Mendocino,045,87422,899,836,4,840,17
2020-09-26,Merced,047,269075,8945,8841,20,8861,136
2020-09-26,Modoc,049,8938,29,26,0,26,0
2020-09-26,Mono,051,14174,169,148,2,150,1
2020-09-26,Monterey,053,433212,10012,9651,32,9683,68
2020-09-26,Napa,055,140530,1751,1681,8,1689,11
2020-09-26,Nevada,057,99092,542,534,16,550,6
2020-09-26,Orange,059,3164182,55157,52203,1472,53675,1194
2020-09-26,Placer,061,380077,3661,3551,13,3564,42
2020-09-26,Plumas,063,18699,49,48,0,48,0
2020-09-26,Riverside,065,2383286,59718,58076,177,58253,1190
2020-09-26,Sacramento,067,1510023,22773,22269,25,22294,421
2020-09-26,San Benito,069,59416,1346,1325,0,1325,11
2020-09-26,San Bernardino,071,2135413,54846,53122,348,53470,988
2020-09-26,San Diego,073,3302833,48075,46333,973,47306,775
2020-09-26,San Francisco,075,870044,11320,11113,28,11141,100
2020-09-26,San Joaquin,077,732212,20312,19982,57,20039,449
2020-09-26,San Luis Obispo,079,281455,3773,3546,17,3563,31
2020-09-26,San Mateo,081,765935,10216,9509,10,9519,127
2020-09-26,Santa Barbara,083,443738,9237,9061,78,9139,114
2020-09-26,Santa Clara,085,1922200,22235,20967,45,21012,270
2020-09-26,Santa Cruz,087,273765,2473,2336,31,2367,9
2020-09-26,Shasta,089,179085,1139,856,8,864,17
2020-09-26,Sierra,091,2930,6,6,0,6,0
2020-09-26,Siskiyou,093,43540,155,149,10,159,0
2020-09-26,Solano,095,438530,6378,6209,39,6248,51
2020-09-26,Sonoma,097,501317,7742,7285,21,7306,124
2020-09-26,Stanislaus,099,539301,16588,16421,520,16941,336
2020-09-26,Sutter,101,95872,1685,1662,1,1663,10
2020-09-26,Tehama,103,63373,591,560,2,562,2
2020-09-26,Trinity,105,12862,54,16,8,24,0
2020-09-26,Tulare,107,460477,16473,15881,128,16009,270
2020-09-26,Tuolumne,109,53932,233,223,5,228,2
2020-09-26,Ventura,111,848112,13444,12729,168,12897,137
2020-09-26,Yolo,113,214977,2849,2789,7,2796,55
2020-09-26,Yuba,115,75493,1094,1056,3,1059,7
2020-09-25,Alameda,001,1643700,21502,20911,175,21086,367
2020-09-25,Alpine,003,1148,3,2,0,2,0
2020-09-25,Amador,005,37829,295,289,0,289,16
2020-09-25,Butte,007,227075,2930,2819,30,2849,43
2020-09-25,Calaveras,009,45235,310,257,0,257,11
2020-09-25,Colusa,011,21464,532,528,0,528,6
2020-09-25,Contra Costa,013,1133247,17181,16401,80,16481,194
2020-09-25,Del Norte,015,27424,142,138,0,138,2
2020-09-25,El Dorado,017,186661,1208,1104,8,1112,4
2020-09-25,Fresno,019,978130,30758,28199,380,28579,385
2020-09-25,Glenn,021,27897,594,570,0,570,3
2020-09-25,Humboldt,023,135768,506,489,1,490,5
2020-09-25,Imperial,025,180216,11851,10681,9,10690,283
2020-09-25,Inyo,027,18085,189,187,4,191,14
2020-09-25,Kern,029,883053,32018,31333,319,31652,393
2020-09-25,Kings,031,150075,7850,7450,37,7487,77
2020-09-25,Lake,033,64148,585,539,0,539,9
2020-09-25,Lassen,035,31185,749,737,2,739,0
2020-09-25,Los Angeles,037,10098052,268852,265713,1844,267557,6483
2020-09-25,Madera,039,155013,4573,4369,30,4399,48
2020-09-25,Marin,041,260295,6748,6622,17,6639,90
2020-09-25,Mariposa,043,17540,76,74,0,74,2
2020-09-25,Mendocino,045,87422,884,819,3,822,17
2020-09-25,Merced,047,269075,8929,8830,20,8850,135
2020-09-25,Modoc,049,8938,29,26,0,26,0
2020-09-25,Mono,051,14174,169,149,2,151,1
2020-09-25,Monterey,053,433212,9960,9581,32,9613,68
2020-09-25,Napa,055,140530,1749,1669,8,1677,11
2020-09-25,Nevada,057,99092,540,529,16,545,6
2020-09-25,Orange,059,3164182,55030,52031,1464,53495,1184
2020-09-25,Placer,061,380077,3650,3527,13,3540,41
2020-09-25,Plumas,063,18699,49,48,0,48,0
2020-09-25,Riverside,065,2383286,59542,57783,172,57955,1183
2020-09-25,Sacramento,067,1510023,22696,22132,25,22157,418
2020-09-25,San Benito,069,59416,1345,1318,0,1318,11
2020-09-25,San Bernardino,071,2135413,54692,52814,348,53162,987
2020-09-25,San Diego,073,3302833,47873,46003,957,46960,775
2020-09-25,San Francisco,075,870044,11286,11066,27,11093,100
2020-09-25,San Joaquin,077,732212,20260,19909,57,19966,449
2020-09-25,San Luis Obispo,079,281455,3761,3512,17,3529,31
2020-09-25,San Mateo,081,765935,10180,9447,10,9457,127
2020-09-25,Santa Barbara,083,443738,9213,9026,78,9104,114
2020-09-25,Santa Clara,085,1922200,22170,20812,44,20856,265
2020-09-25,Santa Cruz,087,273765,2461,2309,30,2339,9
2020-09-25,Shasta,089,179085,1105,806,8,814,16
2020-09-25,Sierra,091,2930,6,6,0,6,0
2020-09-25,Siskiyou,093,43540,155,149,10,159,0
2020-09-25,Solano,095,438530,6362,6179,39,6218,50
2020-09-25,Sonoma,097,501317,7702,7202,21,7223,124
2020-09-25,Stanislaus,099,539301,16570,16381,518,16899,326
2020-09-25,Sutter,101,95872,1682,1655,1,1656,10
2020-09-25,Tehama,103,63373,583,546,2,548,2
2020-09-25,Trinity,105,12862,54,15,8,23,0
2020-09-25,Tulare,107,460477,16433,15815,127,15942,267
2020-09-25,Tuolumne,109,53932,233,223,5,228,2
2020-09-25,Ventura,111,848112,13401,12664,165,12829,137
2020-09-25,Yolo,113,214977,2841,2784,7,2791,55
2020-09-25,Yuba,115,75493,1089,1049,3,1052,5
2020-09-24,Alameda,001,1643700,21427,20838,172,21010,364
2020-09-24,Alpine,003,1148,3,2,0,2,0
2020-09-24,Amador,005,37829,295,288,0,288,16
2020-09-24,Butte,007,227075,2919,2803,30,2833,43
2020-09-24,Calaveras,009,45235,310,258,0,258,11
2020-09-24,Colusa,011,21464,532,523,0,523,6
2020-09-24,Contra Costa,013,1133247,17099,16252,80,16332,192
2020-09-24,Del Norte,015,27424,138,137,0,137,2
2020-09-24,El Dorado,017,186661,1199,1093,8,1101,4
2020-09-24,Fresno,019,978130,30652,28106,376,28482,375
2020-09-24,Glenn,021,27897,590,567,0,567,3
2020-09-24,Humboldt,023,135768,503,482,1,483,5
2020-09-24,Imperial,025,180216,11827,10622,9,10631,283
2020-09-24,Inyo,027,18085,189,187,4,191,13
2020-09-24,Kern,029,883053,31955,31273,317,31590,388
2020-09-24,Kings,031,150075,7834,7428,37,7465,76
2020-09-24,Lake,033,64148,576,531,0,531,9
2020-09-24,Lassen,035,31185,748,737,2,739,0
2020-09-24,Los Angeles,037,10098052,267810,264374,1827,266201,6452
2020-09-24,Madera,039,155013,4554,4344,30,4374,48
2020-09-24,Marin,041,260295,6720,6588,17,6605,85
2020-09-24,Mariposa,043,17540,76,74,0,74,2
2020-09-24,Mendocino,045,87422,880,810,3,813,17
2020-09-24,Merced,047,269075,8900,8813,19,8832,135
2020-09-24,Modoc,049,8938,29,24,0,24,0
2020-09-24,Mono,051,14174,169,149,2,151,1
2020-09-24,Monterey,053,433212,9894,9544,30,9574,67
2020-09-24,Napa,055,140530,1737,1661,8,1669,11
2020-09-24,Nevada,057,99092,539,527,16,543,6
2020-09-24,Orange,059,3164182,54823,51749,1446,53195,1164
2020-09-24,Placer,061,380077,3635,3514,13,3527,41
2020-09-24,Plumas,063,18699,49,48,0,48,0
2020-09-24,Riverside,065,2383286,59277,57491,166,57657,1172
2020-09-24,Sacramento,067,1510023,22570,21985,24,22009,417
2020-09-24,San Benito,069,59416,1343,1308,0,1308,11
2020-09-24,San Bernardino,071,2135413,54355,52455,347,52802,988
2020-09-24,San Diego,073,3302833,47604,45598,942,46540,773
2020-09-24,San Francisco,075,870044,11239,10992,27,11019,99
2020-09-24,San Joaquin,077,732212,20222,19851,55,19906,444
2020-09-24,San Luis Obispo,079,281455,3745,3480,17,3497,31
2020-09-24,San Mateo,081,765935,10132,9376,10,9386,127
2020-09-24,Santa Barbara,083,443738,9160,8988,77,9065,114
2020-09-24,Santa Clara,085,1922200,22082,20689,44,20733,262
2020-09-24,Santa Cruz,087,273765,2441,2300,28,2328,9
2020-09-24,Shasta,089,179085,1068,773,5,778,14
2020-09-24,Sierra,091,2930,6,6,0,6,0
2020-09-24,Siskiyou,093,43540,155,149,10,159,0
2020-09-24,Solano,095,438530,6329,6137,39,6176,49
2020-09-24,Sonoma,097,501317,7621,7163,21,7184,122
2020-09-24,Stanislaus,099,539301,16533,16326,513,16839,326
2020-09-24,Sutter,101,95872,1679,1646,1,1647,10
2020-09-24,Tehama,103,63373,580,540,2,542,2
2020-09-24,Trinity,105,12862,54,15,8,23,0
2020-09-24,Tulare,107,460477,16368,15754,126,15880,267
2020-09-24,Tuolumne,109,53932,233,224,5,229,2
2020-09-24,Ventura,111,848112,13319,12617,164,12781,138
2020-09-24,Yolo,113,214977,2834,2776,7,2783,55
2020-09-24,Yuba,115,75493,1084,1042,3,1045,5
2020-09-23,Alameda,001,1643700,21359,20718,170,20888,361
2020-09-23,Alpine,003,1148,3,2,0,2,0
2020-09-23,Amador,005,37829,294,288,0,288,16
2020-09-23,Butte,007,227075,2911,2790,30,2820,43
2020-09-23,Calaveras,009,45235,309,258,0,258,11
2020-09-23,Colusa,011,21464,531,521,0,521,6
2020-09-23,Contra Costa,013,1133247,17037,16167,80,16247,192
2020-09-23,Del Norte,015,27424,136,137,0,137,2
2020-09-23,El Dorado,017,186661,1185,1088,8,1096,4
2020-09-23,Fresno,019,978130,30557,28019,374,28393,371
2020-09-23,Glenn,021,27897,583,561,0,561,3
2020-09-23,Humboldt,023,135768,499,477,1,478,5
2020-09-23,Imperial,025,180216,11801,10587,9,10596,284
2020-09-23,Inyo,027,18085,188,177,4,181,13
2020-09-23,Kern,029,883053,31911,31172,315,31487,387
2020-09-23,Kings,031,150075,7812,7406,37,7443,76
2020-09-23,Lake,033,64148,571,519,0,519,9
2020-09-23,Lassen,035,31185,748,736,2,738,0
2020-09-23,Los Angeles,037,10098052,266792,263318,1799,265117,6421
2020-09-23,Madera,039,155013,4539,4311,30,4341,48
2020-09-23,Marin,041,260295,6701,6567,17,6584,85
2020-09-23,Mariposa,043,17540,76,74,0,74,2
2020-09-23,Mendocino,045,87422,879,801,2,803,17
2020-09-23,Merced,047,269075,8879,8785,17,8802,134
2020-09-23,Modoc,049,8938,29,24,0,24,0
2020-09-23,Mono,051,14174,169,149,2,151,1
2020-09-23,Monterey,053,433212,9825,9452,29,9481,67
2020-09-23,Napa,055,140530,1728,1653,8,1661,11
2020-09-23,Nevada,057,99092,538,523,16,539,6
2020-09-23,Orange,059,3164182,54596,51658,1438,53096,1155
2020-09-23,Placer,061,380077,3623,3506,13,3519,41
2020-09-23,Plumas,063,18699,49,48,0,48,0
2020-09-23,Riverside,065,2383286,58971,57257,163,57420,1165
2020-09-23,Sacramento,067,1510023,22493,21821,24,21845,415
2020-09-23,San Benito,069,59416,1337,1305,0,1305,10
2020-09-23,San Bernardino,071,2135413,54063,52132,345,52477,973
2020-09-23,San Diego,073,3302833,47328,45427,923,46350,767
2020-09-23,San Francisco,075,870044,11190,10926,27,10953,95
2020-09-23,San Joaquin,077,732212,20168,19785,55,19840,439
2020-09-23,San Luis Obispo,079,281455,3727,3447,17,3464,31
2020-09-23,San Mateo,081,765935,10092,9351,10,9361,127
2020-09-23,Santa Barbara,083,443738,9131,8952,77,9029,112
2020-09-23,Santa Clara,085,1922200,21971,20575,41,20616,260
2020-09-23,Santa Cruz,087,273765,2422,2283,28,2311,9
2020-09-23,Shasta,089,179085,1029,756,4,760,14
2020-09-23,Sierra,091,2930,6,6,0,6,0
2020-09-23,Siskiyou,093,43540,155,149,10,159,0
2020-09-23,Solano,095,438530,6303,6123,39,6162,50
2020-09-23,Sonoma,097,501317,7545,7091,21,7112,122
2020-09-23,Stanislaus,099,539301,16503,16271,510,16781,317
2020-09-23,Sutter,101,95872,1675,1646,1,1647,10
2020-09-23,Tehama,103,63373,574,533,2,535,2
2020-09-23,Trinity,105,12862,53,15,8,23,0
2020-09-23,Tulare,107,460477,16303,15664,125,15789,266
2020-09-23,Tuolumne,109,53932,233,223,5,228,2
2020-09-23,Ventura,111,848112,13263,12591,162,12753,137
2020-09-23,Yolo,113,214977,2816,2766,7,2773,55
2020-09-23,Yuba,115,75493,1082,1038,3,1041,5
2020-09-22,Alameda,001,1643700,21280,20607,168,20775,355
2020-09-22,Alpine,003,1148,2,2,0,2,0
2020-09-22,Amador,005,37829,293,287,0,287,16
2020-09-22,Butte,007,227075,2906,2776,30,2806,43
2020-09-22,Calaveras,009,45235,309,258,0,258,11
2020-09-22,Colusa,011,21464,529,518,0,518,6
2020-09-22,Contra Costa,013,1133247,16947,16090,80,16170,190
2020-09-22,Del Norte,015,27424,136,137,0,137,2
2020-09-22,El Dorado,017,186661,1166,1076,8,1084,4
2020-09-22,Fresno,019,978130,30462,27944,371,28315,369
2020-09-22,Glenn,021,27897,580,560,0,560,3
2020-09-22,Humboldt,023,135768,498,476,1,477,5
2020-09-22,Imperial,025,180216,11772,10529,9,10538,284
2020-09-22,Inyo,027,18085,188,177,4,181,13
2020-09-22,Kern,029,883053,31843,31110,308,31418,383
2020-09-22,Kings,031,150075,7755,7395,36,7431,76
2020-09-22,Lake,033,64148,563,516,0,516,9
2020-09-22,Lassen,035,31185,747,736,2,738,0
2020-09-22,Los Angeles,037,10098052,265726,262117,1774,263891,6394
2020-09-22,Madera,039,155013,4523,4303,30,4333,47
2020-09-22,Marin,041,260295,6687,6561,17,6578,84
2020-09-22,Mariposa,043,17540,76,74,0,74,2
2020-09-22,Mendocino,045,87422,859,794,1,795,18
2020-09-22,Merced,047,269075,8849,8769,17,8786,132
2020-09-22,Modoc,049,8938,29,24,0,24,0
2020-09-22,Mono,051,14174,168,149,2,151,1
2020-09-22,Monterey,053,433212,9767,9393,28,9421,67
2020-09-22,Napa,055,140530,1711,1652,8,1660,11
2020-09-22,Nevada,057,99092,538,523,16,539,6
2020-09-22,Orange,059,3164182,54346,51528,1429,52957,1132
2020-09-22,Placer,061,380077,3611,3492,13,3505,40
2020-09-22,Plumas,063,18699,49,48,0,48,0
2020-09-22,Riverside,065,2383286,58487,57066,159,57225,1162
2020-09-22,Sacramento,067,1510023,22373,21745,24,21769,410
2020-09-22,San Benito,069,59416,1332,1305,0,1305,10
2020-09-22,San Bernardino,071,2135413,53789,51899,345,52244,971
2020-09-22,San Diego,073,3302833,47021,45149,904,46053,765
2020-09-22,San Francisco,075,870044,11146,10893,26,10919,95
2020-09-22,San Joaquin,077,732212,20121,19755,54,19809,426
2020-09-22,San Luis Obispo,079,281455,3705,3420,17,3437,31
2020-09-22,San Mateo,081,765935,10054,9291,10,9301,127
2020-09-22,Santa Barbara,083,443738,9101,8927,76,9003,111
2020-09-22,Santa Clara,085,1922200,21852,20514,41,20555,253
2020-09-22,Santa Cruz,087,273765,2399,2264,28,2292,8
2020-09-22,Shasta,089,179085,994,723,4,727,14
2020-09-22,Sierra,091,2930,6,6,0,6,0
2020-09-22,Siskiyou,093,43540,155,149,10,159,0
2020-09-22,Solano,095,438530,6272,6107,39,6146,48
2020-09-22,Sonoma,097,501317,7466,7068,20,7088,117
2020-09-22,Stanislaus,099,539301,16480,16231,503,16734,316
2020-09-22,Sutter,101,95872,1669,1638,1,1639,10
2020-09-22,Tehama,103,63373,566,529,2,531,2
2020-09-22,Trinity,105,12862,53,15,8,23,0
2020-09-22,Tulare,107,460477,16236,15616,122,15738,263
2020-09-22,Tuolumne,109,53932,232,224,5,229,1
2020-09-22,Ventura,111,848112,13211,12507,158,12665,136
2020-09-22,Yolo,113,214977,2809,2763,7,2770,54
2020-09-22,Yuba,115,75493,1073,1035,3,1038,5
2020-09-21,Alameda,001,1643700,21201,20501,167,20668,343
2020-09-21,Alpine,003,1148,2,2,0,2,0
2020-09-21,Amador,005,37829,291,286,0,286,16
2020-09-21,Butte,007,227075,2892,2769,30,2799,41
2020-09-21,Calaveras,009,45235,307,256,0,256,10
2020-09-21,Colusa,011,21464,528,517,0,517,6
2020-09-21,Contra Costa,013,1133247,16860,16008,80,16088,189
2020-09-21,Del Norte,015,27424,136,132,0,132,2
2020-09-21,El Dorado,017,186661,1157,1074,8,1082,4
2020-09-21,Fresno,019,978130,30360,27843,364,28207,362
2020-09-21,Glenn,021,27897,576,556,0,556,3
2020-09-21,Humboldt,023,135768,494,473,1,474,5
2020-09-21,Imperial,025,180216,11742,10521,9,10530,284
2020-09-21,Inyo,027,18085,187,177,4,181,12
2020-09-21,Kern,029,883053,31771,31031,306,31337,379
2020-09-21,Kings,031,150075,7642,7297,35,7332,76
2020-09-21,Lake,033,64148,558,508,0,508,8
2020-09-21,Lassen,035,31185,745,735,2,737,0
2020-09-21,Los Angeles,037,10098052,264640,261418,1729,263147,6360
2020-09-21,Madera,039,155013,4512,4275,29,4304,47
2020-09-21,Marin,041,260295,6676,6538,16,6554,84
2020-09-21,Mariposa,043,17540,75,74,0,74,2
2020-09-21,Mendocino,045,87422,844,778,0,778,18
2020-09-21,Merced,047,269075,8830,8749,15,8764,128
2020-09-21,Modoc,049,8938,29,22,0,22,0
2020-09-21,Mono,051,14174,168,147,2,149,1
2020-09-21,Monterey,053,433212,9703,9331,25,9356,66
2020-09-21,Napa,055,140530,1700,1641,8,1649,11
2020-09-21,Nevada,057,99092,536,515,16,531,6
2020-09-21,Orange,059,3164182,54124,51363,1422,52785,1110
2020-09-21,Placer,061,380077,3601,3473,13,3486,40
2020-09-21,Plumas,063,18699,49,47,0,47,0
2020-09-21,Riverside,065,2383286,58215,57001,152,57153,1153
2020-09-21,Sacramento,067,1510023,22192,21568,24,21592,404
2020-09-21,San Benito,069,59416,1330,1298,0,1298,10
2020-09-21,San Bernardino,071,2135413,53503,51654,345,51999,970
2020-09-21,San Diego,073,3302833,46737,44927,883,45810,760
2020-09-21,San Francisco,075,870044,11098,10743,26,10769,95
2020-09-21,San Joaquin,077,732212,20063,19579,54,19633,423
2020-09-21,San Luis Obispo,079,281455,3679,3406,17,3423,27
2020-09-21,San Mateo,081,765935,10002,9239,10,9249,127
2020-09-21,Santa Barbara,083,443738,9073,8911,76,8987,110
2020-09-21,Santa Clara,085,1922200,21751,20432,41,20473,252
2020-09-21,Santa Cruz,087,273765,2382,2257,26,2283,8
2020-09-21,Shasta,089,179085,944,696,4,700,14
2020-09-21,Sierra,091,2930,6,6,0,6,0
2020-09-21,Siskiyou,093,43540,155,146,10,156,0
2020-09-21,Solano,095,438530,6248,6019,39,6058,46
2020-09-21,Sonoma,097,501317,7390,7017,20,7037,117
2020-09-21,Stanislaus,099,539301,16450,16186,503,16689,310
2020-09-21,Sutter,101,95872,1662,1634,1,1635,10
2020-09-21,Tehama,103,63373,547,513,2,515,2
2020-09-21,Trinity,105,12862,53,15,8,23,0
2020-09-21,Tulare,107,460477,16162,15528,113,15641,260
2020-09-21,Tuolumne,109,53932,232,221,5,226,1
2020-09-21,Ventura,111,848112,13127,12477,152,12629,133
2020-09-21,Yolo,113,214977,2803,2752,7,2759,54
2020-09-21,Yuba,115,75493,1069,1033,3,1036,1
2020-09-20,Alameda,001,1643700,21101,20425,164,20589,343
2020-09-20,Alpine,003,1148,2,2,0,2,0
2020-09-20,Amador,005,37829,290,286,0,286,16
2020-09-20,Butte,007,227075,2880,2764,30,2794,39
2020-09-20,Calaveras,009,45235,303,256,0,256,10
2020-09-20,Colusa,011,21464,526,510,0,510,6
2020-09-20,Contra Costa,013,1133247,16726,15917,79,15996,189
2020-09-20,Del Norte,015,27424,134,132,0,132,2
2020-09-20,El Dorado,017,186661,1142,1073,8,1081,4
2020-09-20,Fresno,019,978130,30246,27769,359,28128,362
2020-09-20,Glenn,021,27897,572,550,0,550,3
2020-09-20,Humboldt,023,135768,494,472,1,473,5
2020-09-20,Imperial,025,180216,11715,10496,8,10504,284
2020-09-20,Inyo,027,18085,187,177,4,181,12
2020-09-20,Kern,029,883053,31688,30992,302,31294,379
2020-09-20,Kings,031,150075,7595,7159,34,7193,76
2020-09-20,Lake,033,64148,546,492,0,492,8
2020-09-20,Lassen,035,31185,745,735,2,737,0
2020-09-20,Los Angeles,037,10098052,263412,260770,1704,262474,6347
2020-09-20,Madera,039,155013,4492,4257,29,4286,47
2020-09-20,Marin,041,260295,6650,6533,16,6549,83
2020-09-20,Mariposa,043,17540,75,74,0,74,2
2020-09-20,Mendocino,045,87422,832,765,0,765,18
2020-09-20,Merced,047,269075,8803,8745,15,8760,128
2020-09-20,Modoc,049,8938,27,22,0,22,0
2020-09-20,Mono,051,14174,167,147,2,149,1
2020-09-20,Monterey,053,433212,9624,9312,25,9337,65
2020-09-20,Napa,055,140530,1691,1626,8,1634,11
2020-09-20,Nevada,057,99092,533,511,16,527,6
2020-09-20,Orange,059,3164182,53883,51233,1412,52645,1110
2020-09-20,Placer,061,380077,3586,3452,13,3465,40
2020-09-20,Plumas,063,18699,49,47,0,47,0
2020-09-20,Riverside,065,2383286,58014,56783,146,56929,1147
2020-09-20,Sacramento,067,1510023,22005,21394,23,21417,401
2020-09-20,San Benito,069,59416,1319,1291,0,1291,9
2020-09-20,San Bernardino,071,2135413,53184,51559,343,51902,970
2020-09-20,San Diego,073,3302833,46364,44579,854,45433,760
2020-09-20,San Francisco,075,870044,11044,10743,26,10769,95
2020-09-20,San Joaquin,077,732212,19998,19578,47,19625,423
2020-09-20,San Luis Obispo,079,281455,3652,3393,17,3410,27
2020-09-20,San Mateo,081,765935,9936,9198,10,9208,127
2020-09-20,Santa Barbara,083,443738,9037,8880,75,8955,110
2020-09-20,Santa Clara,085,1922200,21631,20330,40,20370,252
2020-09-20,Santa Cruz,087,273765,2362,2199,26,2225,8
2020-09-20,Shasta,089,179085,903,696,3,699,14
2020-09-20,Sierra,091,2930,6,6,0,6,0
2020-09-20,Siskiyou,093,43540,155,146,10,156,0
2020-09-20,Solano,095,438530,6204,6020,39,6059,46
2020-09-20,Sonoma,097,501317,7286,6954,20,6974,117
2020-09-20,Stanislaus,099,539301,16419,16159,496,16655,310
2020-09-20,Sutter,101,95872,1656,1624,1,1625,10
2020-09-20,Tehama,103,63373,534,509,2,511,2
2020-09-20,Trinity,105,12862,53,15,8,23,0
2020-09-20,Tulare,107,460477,16076,15528,106,15634,260
2020-09-20,Tuolumne,109,53932,232,221,5,226,1
2020-09-20,Ventura,111,848112,13061,12406,148,12554,133
2020-09-20,Yolo,113,214977,2795,2745,7,2752,54
2020-09-20,Yuba,115,75493,1062,1029,3,1032,1
2020-09-19,Alameda,001,1643700,21051,20349,161,20510,343
2020-09-19,Alpine,003,1148,2,2,0,2,0
2020-09-19,Amador,005,37829,290,285,0,285,16
2020-09-19,Butte,007,227075,2874,2748,30,2778,38
2020-09-19,Calaveras,009,45235,303,256,0,256,10
2020-09-19,Colusa,011,21464,526,507,0,507,6
2020-09-19,Contra Costa,013,1133247,16663,15783,79,15862,186
2020-09-19,Del Norte,015,27424,133,132,0,132,2
2020-09-19,El Dorado,017,186661,1136,1068,7,1075,4
2020-09-19,Fresno,019,978130,30173,27668,359,28027,362
2020-09-19,Glenn,021,27897,569,547,0,547,3
2020-09-19,Humboldt,023,135768,493,471,1,472,5
2020-09-19,Imperial,025,180216,11700,10496,8,10504,284
2020-09-19,Inyo,027,18085,187,177,4,181,12
2020-09-19,Kern,029,883053,31634,30886,299,31185,379
2020-09-19,Kings,031,150075,7589,7130,34,7164,76
2020-09-19,Lake,033,64148,546,465,0,465,8
2020-09-19,Lassen,035,31185,745,731,2,733,0
2020-09-19,Los Angeles,037,10098052,262788,259801,1690,261491,6325
2020-09-19,Madera,039,155013,4469,4237,29,4266,47
2020-09-19,Marin,041,260295,6643,6513,15,6528,81
2020-09-19,Mariposa,043,17540,75,74,0,74,2
2020-09-19,Mendocino,045,87422,829,750,0,750,18
2020-09-19,Merced,047,269075,8792,8717,14,8731,128
2020-09-19,Modoc,049,8938,27,22,0,22,0
2020-09-19,Mono,051,14174,167,147,2,149,1
2020-09-19,Monterey,053,433212,9582,9237,25,9262,65
2020-09-19,Napa,055,140530,1683,1614,8,1622,11
2020-09-19,Nevada,057,99092,531,505,16,521,6
2020-09-19,Orange,059,3164182,53755,50999,1405,52404,1105
2020-09-19,Placer,061,380077,3577,3412,13,3425,40
2020-09-19,Plumas,063,18699,49,47,0,47,0
2020-09-19,Riverside,065,2383286,57887,56562,145,56707,1147
2020-09-19,Sacramento,067,1510023,21951,21297,23,21320,396
2020-09-19,San Benito,069,59416,1315,1276,0,1276,9
2020-09-19,San Bernardino,071,2135413,53028,51353,340,51693,971
2020-09-19,San Diego,073,3302833,46136,44295,831,45126,773
2020-09-19,San Francisco,075,870044,11011,10741,26,10767,95
2020-09-19,San Joaquin,077,732212,19961,19580,47,19627,424
2020-09-19,San Luis Obispo,079,281455,3631,3369,17,3386,27
2020-09-19,San Mateo,081,765935,9905,9158,10,9168,127
2020-09-19,Santa Barbara,083,443738,9017,8862,75,8937,106
2020-09-19,Santa Clara,085,1922200,21542,20170,40,20210,251
2020-09-19,Santa Cruz,087,273765,2348,2198,25,2223,8
2020-09-19,Shasta,089,179085,876,687,3,690,14
2020-09-19,Sierra,091,2930,6,6,0,6,0
2020-09-19,Siskiyou,093,43540,155,146,10,156,0
2020-09-19,Solano,095,438530,6188,5998,39,6037,46
2020-09-19,Sonoma,097,501317,7253,6905,20,6925,117
2020-09-19,Stanislaus,099,539301,16379,16109,489,16598,313
2020-09-19,Sutter,101,95872,1655,1602,1,1603,10
2020-09-19,Tehama,103,63373,529,498,2,500,2
2020-09-19,Trinity,105,12862,53,15,8,23,0
2020-09-19,Tulare,107,460477,16027,15485,103,15588,260
2020-09-19,Tuolumne,109,53932,232,217,5,222,1
2020-09-19,Ventura,111,848112,13029,12328,148,12476,133
2020-09-19,Yolo,113,214977,2787,2739,7,2746,54
2020-09-19,Yuba,115,75493,1055,1023,3,1026,1
2020-09-18,Alameda,001,1643700,20986,20222,155,20377,341
2020-09-18,Alpine,003,1148,2,2,0,2,0
2020-09-18,Amador,005,37829,290,285,0,285,16
2020-09-18,Butte,007,227075,2872,2738,30,2768,37
2020-09-18,Calaveras,009,45235,303,255,0,255,9
2020-09-18,Colusa,011,21464,526,504,0,504,6
2020-09-18,Contra Costa,013,1133247,16578,15667,79,15746,185
2020-09-18,Del Norte,015,27424,133,131,0,131,2
2020-09-18,El Dorado,017,186661,1123,1063,7,1070,4
2020-09-18,Fresno,019,978130,30108,27560,359,27919,359
2020-09-18,Glenn,021,27897,566,541,0,541,3
2020-09-18,Humboldt,023,135768,490,470,1,471,5
2020-09-18,Imperial,025,180216,11685,10460,8,10468,283
2020-09-18,Inyo,027,18085,187,177,4,181,12
2020-09-18,Kern,029,883053,31576,30742,296,31038,373
2020-09-18,Kings,031,150075,7579,7062,34,7096,74
2020-09-18,Lake,033,64148,540,458,0,458,8
2020-09-18,Lassen,035,31185,744,731,2,733,0
2020-09-18,Los Angeles,037,10098052,262027,258488,1672,260160,6324
2020-09-18,Madera,039,155013,4457,4211,29,4240,45
2020-09-18,Marin,041,260295,6628,6475,15,6490,81
2020-09-18,Mariposa,043,17540,75,74,0,74,2
2020-09-18,Mendocino,045,87422,821,739,0,739,18
2020-09-18,Merced,047,269075,8780,8691,13,8704,127
2020-09-18,Modoc,049,8938,27,22,0,22,0
2020-09-18,Mono,051,14174,165,147,2,149,1
2020-09-18,Monterey,053,433212,9541,9183,25,9208,64
2020-09-18,Napa,055,140530,1677,1604,8,1612,11
2020-09-18,Nevada,057,99092,528,504,16,520,6
2020-09-18,Orange,059,3164182,53609,50733,1393,52126,1107
2020-09-18,Placer,061,380077,3566,3389,13,3402,40
2020-09-18,Plumas,063,18699,49,45,0,45,0
2020-09-18,Riverside,065,2383286,57765,56248,140,56388,1143
2020-09-18,Sacramento,067,1510023,21868,21105,23,21128,391
2020-09-18,San Benito,069,59416,1307,1257,0,1257,8
2020-09-18,San Bernardino,071,2135413,52883,51106,337,51443,970
2020-09-18,San Diego,073,3302833,45886,44009,826,44835,757
2020-09-18,San Francisco,075,870044,10973,10644,25,10669,95
2020-09-18,San Joaquin,077,732212,19917,19531,46,19577,423
2020-09-18,San Luis Obispo,079,281455,3607,3328,17,3345,27
2020-09-18,San Mateo,081,765935,9865,9062,10,9072,127
2020-09-18,Santa Barbara,083,443738,8996,8824,75,8899,107
2020-09-18,Santa Clara,085,1922200,21444,20058,40,20098,252
2020-09-18,Santa Cruz,087,273765,2327,2180,24,2204,8
2020-09-18,Shasta,089,179085,841,668,3,671,14
2020-09-18,Sierra,091,2930,6,6,0,6,0
2020-09-18,Siskiyou,093,43540,154,146,10,156,0
2020-09-18,Solano,095,438530,6172,5961,39,6000,46
2020-09-18,Sonoma,097,501317,7205,6856,20,6876,114
2020-09-18,Stanislaus,099,539301,16351,16042,483,16525,277
2020-09-18,Sutter,101,95872,1648,1586,1,1587,10
2020-09-18,Tehama,103,63373,529,490,2,492,2
2020-09-18,Trinity,105,12862,53,15,7,22,0
2020-09-18,Tulare,107,460477,15994,15435,99,15534,259
2020-09-18,Tuolumne,109,53932,231,216,5,221,1
2020-09-18,Ventura,111,848112,12968,12236,144,12380,133
2020-09-18,Yolo,113,214977,2781,2732,7,2739,54
2020-09-18,Yuba,115,75493,1051,1020,3,1023,1
2020-09-17,Alameda,001,1643700,20887,20146,155,20301,339
2020-09-17,Alpine,003,1148,2,2,0,2,0
2020-09-17,Amador,005,37829,288,284,0,284,16
2020-09-17,Butte,007,227075,2854,2720,30,2750,38
2020-09-17,Calaveras,009,45235,303,254,0,254,9
2020-09-17,Colusa,011,21464,524,499,0,499,6
2020-09-17,Contra Costa,013,1133247,16489,15576,79,15655,184
2020-09-17,Del Norte,015,27424,133,131,0,131,2
2020-09-17,El Dorado,017,186661,1114,1057,7,1064,4
2020-09-17,Fresno,019,978130,29999,27487,354,27841,355
2020-09-17,Glenn,021,27897,565,541,0,541,3
2020-09-17,Humboldt,023,135768,484,466,1,467,5
2020-09-17,Imperial,025,180216,11668,10436,8,10444,281
2020-09-17,Inyo,027,18085,187,176,4,180,12
2020-09-17,Kern,029,883053,31515,30627,289,30916,372
2020-09-17,Kings,031,150075,7508,7015,34,7049,72
2020-09-17,Lake,033,64148,530,433,0,433,8
2020-09-17,Lassen,035,31185,742,731,2,733,0
2020-09-17,Los Angeles,037,10098052,261084,257246,1658,258904,6318
2020-09-17,Madera,039,155013,4423,4152,29,4181,45
2020-09-17,Marin,041,260295,6607,6457,15,6472,81
2020-09-17,Mariposa,043,17540,75,74,0,74,2
2020-09-17,Mendocino,045,87422,810,737,0,737,18
2020-09-17,Merced,047,269075,8761,8671,13,8684,119
2020-09-17,Modoc,049,8938,27,22,0,22,0
2020-09-17,Mono,051,14174,165,147,2,149,1
2020-09-17,Monterey,053,433212,9479,9113,25,9138,62
2020-09-17,Napa,055,140530,1666,1592,8,1600,11
2020-09-17,Nevada,057,99092,526,494,16,510,6
2020-09-17,Orange,059,3164182,53429,50537,1381,51918,1098
2020-09-17,Placer,061,380077,3545,3368,13,3381,40
2020-09-17,Plumas,063,18699,49,45,0,45,0
2020-09-17,Riverside,065,2383286,57539,56007,139,56146,1134
2020-09-17,Sacramento,067,1510023,21633,20895,23,20918,385
2020-09-17,San Benito,069,59416,1305,1252,0,1252,8
2020-09-17,San Bernardino,071,2135413,52680,50770,337,51107,904
2020-09-17,San Diego,073,3302833,45606,43621,814,44435,754
2020-09-17,San Francisco,075,870044,10879,10564,25,10589,95
2020-09-17,San Joaquin,077,732212,19858,19439,46,19485,416
2020-09-17,San Luis Obispo,079,281455,3577,3299,17,3316,27
2020-09-17,San Mateo,081,765935,9823,8984,10,8994,127
2020-09-17,Santa Barbara,083,443738,8972,8779,75,8854,107
2020-09-17,Santa Clara,085,1922200,21327,19825,40,19865,254
2020-09-17,Santa Cruz,087,273765,2311,2155,24,2179,7
2020-09-17,Shasta,089,179085,802,660,3,663,12
2020-09-17,Sierra,091,2930,6,6,0,6,0
2020-09-17,Siskiyou,093,43540,154,146,10,156,0
2020-09-17,Solano,095,438530,6149,5915,39,5954,44
2020-09-17,Sonoma,097,501317,7141,6754,20,6774,114
2020-09-17,Stanislaus,099,539301,16318,15984,479,16463,277
2020-09-17,Sutter,101,95872,1643,1572,1,1573,10
2020-09-17,Tehama,103,63373,515,487,2,489,2
2020-09-17,Trinity,105,12862,53,15,7,22,0
2020-09-17,Tulare,107,460477,15941,15344,97,15441,258
2020-09-17,Tuolumne,109,53932,230,214,5,219,1
2020-09-17,Ventura,111,848112,12881,12167,141,12308,130
2020-09-17,Yolo,113,214977,2772,2724,7,2731,53
2020-09-17,Yuba,115,75493,1047,1015,3,1018,1
2020-09-16,Alameda,001,1643700,20789,20009,153,20162,333
2020-09-16,Alpine,003,1148,2,2,0,2,0
2020-09-16,Amador,005,37829,288,284,0,284,16
2020-09-16,Butte,007,227075,2844,2704,29,2733,38
2020-09-16,Calaveras,009,45235,303,254,0,254,9
2020-09-16,Colusa,011,21464,522,497,0,497,6
2020-09-16,Contra Costa,013,1133247,16403,15473,79,15552,183
2020-09-16,Del Norte,015,27424,133,131,0,131,2
2020-09-16,El Dorado,017,186661,1106,1049,7,1056,4
2020-09-16,Fresno,019,978130,29892,27381,352,27733,343
2020-09-16,Glenn,021,27897,563,539,0,539,3
2020-09-16,Humboldt,023,135768,483,455,1,456,4
2020-09-16,Imperial,025,180216,11645,10401,8,10409,277
2020-09-16,Inyo,027,18085,186,176,4,180,12
2020-09-16,Kern,029,883053,31455,30570,288,30858,371
2020-09-16,Kings,031,150075,7483,7002,32,7034,71
2020-09-16,Lake,033,64148,519,417,0,417,6
2020-09-16,Lassen,035,31185,741,730,2,732,0
2020-09-16,Los Angeles,037,10098052,260102,256101,1641,257742,6299
2020-09-16,Madera,039,155013,4400,4138,29,4167,45
2020-09-16,Marin,041,260295,6579,6430,15,6445,77
2020-09-16,Mariposa,043,17540,75,74,0,74,2
2020-09-16,Mendocino,045,87422,801,727,0,727,18
2020-09-16,Merced,047,269075,8740,8646,13,8659,118
2020-09-16,Modoc,049,8938,27,22,0,22,0
2020-09-16,Mono,051,14174,165,147,2,149,1
2020-09-16,Monterey,053,433212,9425,8997,25,9022,62
2020-09-16,Napa,055,140530,1652,1587,8,1595,11
2020-09-16,Nevada,057,99092,521,495,15,510,6
2020-09-16,Orange,059,3164182,53228,50414,1372,51786,1096
2020-09-16,Placer,061,380077,3527,3351,13,3364,39
2020-09-16,Plumas,063,18699,49,45,0,45,0
2020-09-16,Riverside,065,2383286,57345,55811,131,55942,1127
2020-09-16,Sacramento,067,1510023,21538,20610,23,20633,377
2020-09-16,San Benito,069,59416,1297,1244,0,1244,8
2020-09-16,San Bernardino,071,2135413,52455,50509,336,50845,907
2020-09-16,San Diego,073,3302833,45314,43447,793,44240,748
2020-09-16,San Francisco,075,870044,10832,10502,25,10527,90
2020-09-16,San Joaquin,077,732212,19804,19377,45,19422,409
2020-09-16,San Luis Obispo,079,281455,3546,3285,17,3302,28
2020-09-16,San Mateo,081,765935,9758,8944,10,8954,127
2020-09-16,Santa Barbara,083,443738,8939,8764,75,8839,107
2020-09-16,Santa Clara,085,1922200,21208,19684,40,19724,253
2020-09-16,Santa Cruz,087,273765,2270,2089,23,2112,7
2020-09-16,Shasta,089,179085,776,635,3,638,11
2020-09-16,Sierra,091,2930,6,6,0,6,0
2020-09-16,Siskiyou,093,43540,153,145,10,155,0
2020-09-16,Solano,095,438530,6120,5899,39,5938,44
2020-09-16,Sonoma,097,501317,7080,6731,20,6751,104
2020-09-16,Stanislaus,099,539301,16270,15897,471,16368,263
2020-09-16,Sutter,101,95872,1630,1567,1,1568,10
2020-09-16,Tehama,103,63373,507,485,2,487,2
2020-09-16,Trinity,105,12862,53,15,7,22,0
2020-09-16,Tulare,107,460477,15896,15314,90,15404,258
2020-09-16,Tuolumne,109,53932,229,210,5,215,1
2020-09-16,Ventura,111,848112,12810,12073,139,12212,130
2020-09-16,Yolo,113,214977,2765,2709,7,2716,53
2020-09-16,Yuba,115,75493,1045,1000,3,1003,1
2020-09-15,Alameda,001,1643700,20683,19931,150,20081,327
2020-09-15,Alpine,003,1148,2,2,0,2,0
2020-09-15,Amador,005,37829,287,282,0,282,16
2020-09-15,Butte,007,227075,2831,2695,27,2722,38
2020-09-15,Calaveras,009,45235,303,248,0,248,5
2020-09-15,Colusa,011,21464,516,497,0,497,6
2020-09-15,Contra Costa,013,1133247,16302,15423,77,15500,180
2020-09-15,Del Norte,015,27424,133,129,0,129,2
2020-09-15,El Dorado,017,186661,1101,1046,7,1053,4
2020-09-15,Fresno,019,978130,29785,27312,347,27659,343
2020-09-15,Glenn,021,27897,562,531,0,531,3
2020-09-15,Humboldt,023,135768,481,456,1,457,4
2020-09-15,Imperial,025,180216,11620,10376,8,10384,277
2020-09-15,Inyo,027,18085,186,176,4,180,12
2020-09-15,Kern,029,883053,31342,30429,285,30714,368
2020-09-15,Kings,031,150075,7325,6977,32,7009,70
2020-09-15,Lake,033,64148,505,416,0,416,4
2020-09-15,Lassen,035,31185,737,719,2,721,0
2020-09-15,Los Angeles,037,10098052,258991,255048,1619,256667,6269
2020-09-15,Madera,039,155013,4381,4122,29,4151,45
2020-09-15,Marin,041,260295,6548,6423,15,6438,77
2020-09-15,Mariposa,043,17540,75,74,0,74,2
2020-09-15,Mendocino,045,87422,783,724,0,724,18
2020-09-15,Merced,047,269075,8710,8633,13,8646,114
2020-09-15,Modoc,049,8938,26,21,0,21,0
2020-09-15,Mono,051,14174,165,147,2,149,1
2020-09-15,Monterey,053,433212,9376,8943,25,8968,62
2020-09-15,Napa,055,140530,1638,1580,8,1588,11
2020-09-15,Nevada,057,99092,516,494,15,509,6
2020-09-15,Orange,059,3164182,53046,50294,1358,51652,1088
2020-09-15,Placer,061,380077,3503,3331,13,3344,38
2020-09-15,Plumas,063,18699,49,44,0,44,0
2020-09-15,Riverside,065,2383286,57051,55569,121,55690,1118
2020-09-15,Sacramento,067,1510023,21394,20487,23,20510,372
2020-09-15,San Benito,069,59416,1290,1237,0,1237,7
2020-09-15,San Bernardino,071,2135413,52239,50333,335,50668,904
2020-09-15,San Diego,073,3302833,44995,43183,773,43956,742
2020-09-15,San Francisco,075,870044,10774,10414,25,10439,90
2020-09-15,San Joaquin,077,732212,19752,19313,45,19358,401
2020-09-15,San Luis Obispo,079,281455,3526,3262,17,3279,28
2020-09-15,San Mateo,081,765935,9688,8895,10,8905,127
2020-09-15,Santa Barbara,083,443738,8914,8724,74,8798,104
2020-09-15,Santa Clara,085,1922200,21074,19610,40,19650,252
2020-09-15,Santa Cruz,087,273765,2244,2079,22,2101,7
2020-09-15,Shasta,089,179085,764,627,3,630,11
2020-09-15,Sierra,091,2930,6,6,0,6,0
2020-09-15,Siskiyou,093,43540,153,143,10,153,0
2020-09-15,Solano,095,438530,6086,5878,39,5917,45
2020-09-15,Sonoma,097,501317,7041,6701,20,6721,104
2020-09-15,Stanislaus,099,539301,16222,15880,469,16349,260
2020-09-15,Sutter,101,95872,1619,1556,1,1557,10
2020-09-15,Tehama,103,63373,495,484,2,486,2
2020-09-15,Trinity,105,12862,53,15,7,22,0
2020-09-15,Tulare,107,460477,15820,15203,88,15291,254
2020-09-15,Tuolumne,109,53932,229,209,5,214,1
2020-09-15,Ventura,111,848112,12757,11932,138,12070,128
2020-09-15,Yolo,113,214977,2761,2708,7,2715,53
2020-09-15,Yuba,115,75493,1039,991,3,994,1
2020-09-14,Alameda,001,1643700,20556,19851,149,20000,306
2020-09-14,Alpine,003,1148,2,2,0,2,0
2020-09-14,Amador,005,37829,285,281,0,281,16
2020-09-14,Butte,007,227075,2814,2642,27,2669,37
2020-09-14,Calaveras,009,45235,303,244,0,244,3
2020-09-14,Colusa,011,21464,515,486,0,486,6
2020-09-14,Contra Costa,013,1133247,16178,15354,76,15430,174
2020-09-14,Del Norte,015,27424,130,116,0,116,2
2020-09-14,El Dorado,017,186661,1097,1039,7,1046,3
2020-09-14,Fresno,019,978130,29701,27232,344,27576,344
2020-09-14,Glenn,021,27897,554,521,0,521,3
2020-09-14,Humboldt,023,135768,478,437,1,438,4
2020-09-14,Imperial,025,180216,11600,10340,8,10348,273
2020-09-14,Inyo,027,18085,186,176,4,180,12
2020-09-14,Kern,029,883053,31254,30344,284,30628,368
2020-09-14,Kings,031,150075,7244,6950,32,6982,70
2020-09-14,Lake,033,64148,485,407,0,407,4
2020-09-14,Lassen,035,31185,737,719,2,721,0
2020-09-14,Los Angeles,037,10098052,257960,254622,1594,256216,6226
2020-09-14,Madera,039,155013,4367,4104,29,4133,45
2020-09-14,Marin,041,260295,6527,6409,15,6424,70
2020-09-14,Mariposa,043,17540,75,74,0,74,2
2020-09-14,Mendocino,045,87422,766,710,0,710,17
2020-09-14,Merced,047,269075,8691,8593,13,8606,112
2020-09-14,Modoc,049,8938,26,21,0,21,0
2020-09-14,Mono,051,14174,165,147,2,149,1
2020-09-14,Monterey,053,433212,9305,8845,24,8869,61
2020-09-14,Napa,055,140530,1621,1576,8,1584,11
2020-09-14,Nevada,057,99092,511,489,15,504,6
2020-09-14,Orange,059,3164182,52885,50149,1342,51491,1079
2020-09-14,Placer,061,380077,3482,3302,13,3315,38
2020-09-14,Plumas,063,18699,48,42,0,42,0
2020-09-14,Riverside,065,2383286,56832,55488,117,55605,1113
2020-09-14,Sacramento,067,1510023,21199,20377,22,20399,367
2020-09-14,San Benito,069,59416,1275,1233,0,1233,7
2020-09-14,San Bernardino,071,2135413,52014,50163,334,50497,895
2020-09-14,San Diego,073,3302833,44684,42889,753,43642,734
2020-09-14,San Francisco,075,870044,10707,10255,23,10278,90
2020-09-14,San Joaquin,077,732212,19678,19111,44,19155,397
2020-09-14,San Luis Obispo,079,281455,3501,3248,17,3265,25
2020-09-14,San Mateo,081,765935,9627,8847,10,8857,127
2020-09-14,Santa Barbara,083,443738,8888,8692,74,8766,104
2020-09-14,Santa Clara,085,1922200,20886,19545,40,19585,247
2020-09-14,Santa Cruz,087,273765,2222,2016,21,2037,7
2020-09-14,Shasta,089,179085,741,584,3,587,10
2020-09-14,Sierra,091,2930,6,6,0,6,0
2020-09-14,Siskiyou,093,43540,152,143,10,153,0
2020-09-14,Solano,095,438530,6051,5834,39,5873,44
2020-09-14,Sonoma,097,501317,6979,6630,20,6650,102
2020-09-14,Stanislaus,099,539301,16177,15812,466,16278,253
2020-09-14,Sutter,101,95872,1608,1549,1,1550,10
2020-09-14,Tehama,103,63373,493,475,2,477,1
2020-09-14,Trinity,105,12862,52,14,7,21,0
2020-09-14,Tulare,107,460477,15750,15096,82,15178,254
2020-09-14,Tuolumne,109,53932,228,208,5,213,1
2020-09-14,Ventura,111,848112,12655,11903,135,12038,125
2020-09-14,Yolo,113,214977,2750,2687,7,2694,53
2020-09-14,Yuba,115,75493,1031,977,3,980,1
2020-09-13,Alameda,001,1643700,20450,19815,146,19961,306
2020-09-13,Alpine,003,1148,2,2,0,2,0
2020-09-13,Amador,005,37829,282,279,0,279,16
2020-09-13,Butte,007,227075,2792,2640,27,2667,37
2020-09-13,Calaveras,009,45235,302,246,0,246,3
2020-09-13,Colusa,011,21464,511,486,0,486,6
2020-09-13,Contra Costa,013,1133247,16072,15284,76,15360,172
2020-09-13,Del Norte,015,27424,127,116,0,116,1
2020-09-13,El Dorado,017,186661,1092,1035,7,1042,2
2020-09-13,Fresno,019,978130,29593,27196,335,27531,345
2020-09-13,Glenn,021,27897,550,517,0,517,3
2020-09-13,Humboldt,023,135768,478,434,1,435,4
2020-09-13,Imperial,025,180216,11563,10304,7,10311,273
2020-09-13,Inyo,027,18085,186,176,4,180,12
2020-09-13,Kern,029,883053,31161,30277,278,30555,368
2020-09-13,Kings,031,150075,7225,6937,32,6969,70
2020-09-13,Lake,033,64148,466,397,0,397,4
2020-09-13,Lassen,035,31185,734,719,2,721,0
2020-09-13,Los Angeles,037,10098052,256808,253950,1579,255529,6203
2020-09-13,Madera,039,155013,4310,4090,29,4119,45
2020-09-13,Marin,041,260295,6506,6395,15,6410,70
2020-09-13,Mariposa,043,17540,75,74,0,74,2
2020-09-13,Mendocino,045,87422,759,707,0,707,17
2020-09-13,Merced,047,269075,8657,8575,13,8588,112
2020-09-13,Modoc,049,8938,26,21,0,21,0
2020-09-13,Mono,051,14174,165,147,2,149,1
2020-09-13,Monterey,053,433212,9223,8826,23,8849,61
2020-09-13,Napa,055,140530,1614,1563,8,1571,11
2020-09-13,Nevada,057,99092,503,486,15,501,6
2020-09-13,Orange,059,3164182,52669,50061,1335,51396,1075
2020-09-13,Placer,061,380077,3452,3291,13,3304,38
2020-09-13,Plumas,063,18699,48,42,0,42,0
2020-09-13,Riverside,065,2383286,56625,55235,106,55341,1108
2020-09-13,Sacramento,067,1510023,20853,20279,22,20301,367
2020-09-13,San Benito,069,59416,1267,1217,0,1217,7
2020-09-13,San Bernardino,071,2135413,51728,49968,332,50300,895
2020-09-13,San Diego,073,3302833,44358,42681,719,43400,734
2020-09-13,San Francisco,075,870044,10629,10254,23,10277,90
2020-09-13,San Joaquin,077,732212,19607,19110,43,19153,396
2020-09-13,San Luis Obispo,079,281455,3464,3240,17,3257,24
2020-09-13,San Mateo,081,765935,9566,8811,10,8821,127
2020-09-13,Santa Barbara,083,443738,8851,8690,74,8764,104
2020-09-13,Santa Clara,085,1922200,20747,19456,39,19495,245
2020-09-13,Santa Cruz,087,273765,2189,2016,19,2035,7
2020-09-13,Shasta,089,179085,729,583,3,586,10
2020-09-13,Sierra,091,2930,6,6,0,6,0
2020-09-13,Siskiyou,093,43540,152,143,9,152,0
2020-09-13,Solano,095,438530,6005,5810,39,5849,43
2020-09-13,Sonoma,097,501317,6914,6592,20,6612,95
2020-09-13,Stanislaus,099,539301,16114,15759,454,16213,253
2020-09-13,Sutter,101,95872,1596,1539,1,1540,10
2020-09-13,Tehama,103,63373,489,476,2,478,1
2020-09-13,Trinity,105,12862,52,14,7,21,0
2020-09-13,Tulare,107,460477,15679,15098,81,15179,254
2020-09-13,Tuolumne,109,53932,224,208,5,213,1
2020-09-13,Ventura,111,848112,12547,11855,134,11989,123
2020-09-13,Yolo,113,214977,2738,2675,7,2682,53
2020-09-13,Yuba,115,75493,1026,967,3,970,1
2020-09-12,Alameda,001,1643700,20391,19758,146,19904,307
2020-09-12,Alpine,003,1148,2,2,0,2,0
2020-09-12,Amador,005,37829,281,278,0,278,16
2020-09-12,Butte,007,227075,2785,2629,26,2655,37
2020-09-12,Calaveras,009,45235,300,246,0,246,3
2020-09-12,Colusa,011,21464,507,486,0,486,6
2020-09-12,Contra Costa,013,1133247,15995,15135,75,15210,174
2020-09-12,Del Norte,015,27424,126,116,0,116,1
2020-09-12,El Dorado,017,186661,1085,1034,7,1041,2
2020-09-12,Fresno,019,978130,29522,27076,335,27411,345
2020-09-12,Glenn,021,27897,549,517,0,517,3
2020-09-12,Humboldt,023,135768,477,430,1,431,4
2020-09-12,Imperial,025,180216,11551,10305,7,10312,273
2020-09-12,Inyo,027,18085,186,177,4,181,12
2020-09-12,Kern,029,883053,31095,30202,278,30480,368
2020-09-12,Kings,031,150075,7215,6895,32,6927,70
2020-09-12,Lake,033,64148,460,393,0,393,4
2020-09-12,Lassen,035,31185,734,719,2,721,0
2020-09-12,Los Angeles,037,10098052,256251,253156,1558,254714,6193
2020-09-12,Madera,039,155013,4299,4058,29,4087,43
2020-09-12,Marin,041,260295,6497,6393,15,6408,69
2020-09-12,Mariposa,043,17540,75,72,0,72,2
2020-09-12,Mendocino,045,87422,756,700,0,700,17
2020-09-12,Merced,047,269075,8648,8533,13,8546,112
2020-09-12,Modoc,049,8938,25,21,0,21,0
2020-09-12,Mono,051,14174,165,147,2,149,1
2020-09-12,Monterey,053,433212,9187,8743,23,8766,61
2020-09-12,Napa,055,140530,1611,1556,8,1564,11
2020-09-12,Nevada,057,99092,502,482,15,497,6
2020-09-12,Orange,059,3164182,52554,49895,1332,51227,1078
2020-09-12,Placer,061,380077,3435,3280,13,3293,38
2020-09-12,Plumas,063,18699,48,42,0,42,0
2020-09-12,Riverside,065,2383286,56497,55058,102,55160,1108
2020-09-12,Sacramento,067,1510023,20784,20184,22,20206,367
2020-09-12,San Benito,069,59416,1264,1208,0,1208,7
2020-09-12,San Bernardino,071,2135413,51637,49945,330,50275,896
2020-09-12,San Diego,073,3302833,44163,42416,710,43126,747
2020-09-12,San Francisco,075,870044,10585,10257,23,10280,90
2020-09-12,San Joaquin,077,732212,19579,19108,43,19151,396
2020-09-12,San Luis Obispo,079,281455,3437,3220,17,3237,24
2020-09-12,San Mateo,081,765935,9521,8759,10,8769,127
2020-09-12,Santa Barbara,083,443738,8837,8642,74,8716,104
2020-09-12,Santa Clara,085,1922200,20663,19330,39,19369,237
2020-09-12,Santa Cruz,087,273765,2177,2016,19,2035,7
2020-09-12,Shasta,089,179085,717,569,3,572,10
2020-09-12,Sierra,091,2930,6,6,0,6,0
2020-09-12,Siskiyou,093,43540,152,141,9,150,0
2020-09-12,Solano,095,438530,5981,5772,39,5811,43
2020-09-12,Sonoma,097,501317,6889,6531,20,6551,95
2020-09-12,Stanislaus,099,539301,16082,15675,451,16126,253
2020-09-12,Sutter,101,95872,1590,1529,1,1530,10
2020-09-12,Tehama,103,63373,486,471,2,473,1
2020-09-12,Trinity,105,12862,52,15,7,22,0
2020-09-12,Tulare,107,460477,15633,15018,80,15098,254
2020-09-12,Tuolumne,109,53932,224,208,5,213,1
2020-09-12,Ventura,111,848112,12496,11759,132,11891,123
2020-09-12,Yolo,113,214977,2731,2646,7,2653,53
2020-09-12,Yuba,115,75493,1022,963,3,966,1
2020-09-11,Alameda,001,1643700,20336,19625,145,19770,298
2020-09-11,Alpine,003,1148,2,2,0,2,0
2020-09-11,Amador,005,37829,281,277,0,277,16
2020-09-11,Butte,007,227075,2774,2605,26,2631,37
2020-09-11,Calaveras,009,45235,299,242,0,242,1
2020-09-11,Colusa,011,21464,506,484,0,484,6
2020-09-11,Contra Costa,013,1133247,15943,15001,72,15073,173
2020-09-11,Del Norte,015,27424,126,115,0,115,1
2020-09-11,El Dorado,017,186661,1082,1024,7,1031,2
2020-09-11,Fresno,019,978130,29444,26917,334,27251,344
2020-09-11,Glenn,021,27897,544,515,0,515,3
2020-09-11,Humboldt,023,135768,475,426,1,427,4
2020-09-11,Imperial,025,180216,11533,10286,7,10293,273
2020-09-11,Inyo,027,18085,186,176,4,180,12
2020-09-11,Kern,029,883053,31027,30059,277,30336,365
2020-09-11,Kings,031,150075,7198,6770,32,6802,70
2020-09-11,Lake,033,64148,453,382,0,382,4
2020-09-11,Lassen,035,31185,734,719,2,721,0
2020-09-11,Los Angeles,037,10098052,255570,252057,1547,253604,6172
2020-09-11,Madera,039,155013,4280,4018,29,4047,43
2020-09-11,Marin,041,260295,6494,6364,15,6379,69
2020-09-11,Mariposa,043,17540,75,72,0,72,2
2020-09-11,Mendocino,045,87422,745,700,0,700,17
2020-09-11,Merced,047,269075,8627,8489,13,8502,109
2020-09-11,Modoc,049,8938,25,21,0,21,0
2020-09-11,Mono,051,14174,165,145,2,147,1
2020-09-11,Monterey,053,433212,9139,8595,23,8618,61
2020-09-11,Napa,055,140530,1600,1543,8,1551,11
2020-09-11,Nevada,057,99092,495,483,15,498,6
2020-09-11,Orange,059,3164182,52424,49755,1320,51075,1068
2020-09-11,Placer,061,380077,3420,3254,13,3267,37
2020-09-11,Plumas,063,18699,48,42,0,42,0
2020-09-11,Riverside,065,2383286,56362,54717,99,54816,1099
2020-09-11,Sacramento,067,1510023,20699,20012,22,20034,358
2020-09-11,San Benito,069,59416,1254,1202,0,1202,7
2020-09-11,San Bernardino,071,2135413,51538,49682,330,50012,871
2020-09-11,San Diego,073,3302833,43943,41971,704,42675,730
2020-09-11,San Francisco,075,870044,10537,10133,22,10155,89
2020-09-11,San Joaquin,077,732212,19531,19019,43,19062,391
2020-09-11,San Luis Obispo,079,281455,3419,3190,17,3207,24
2020-09-11,San Mateo,081,765935,9479,8611,10,8621,127
2020-09-11,Santa Barbara,083,443738,8804,8592,73,8665,103
2020-09-11,Santa Clara,085,1922200,20574,19065,39,19104,234
2020-09-11,Santa Cruz,087,273765,2160,1997,19,2016,7
2020-09-11,Shasta,089,179085,707,568,3,571,10
2020-09-11,Sierra,091,2930,6,6,0,6,0
2020-09-11,Siskiyou,093,43540,151,139,9,148,0
2020-09-11,Solano,095,438530,5964,5742,39,5781,42
2020-09-11,Sonoma,097,501317,6845,6469,20,6489,91
2020-09-11,Stanislaus,099,539301,16044,15613,448,16061,253
2020-09-11,Sutter,101,95872,1580,1505,1,1506,11
2020-09-11,Tehama,103,63373,483,466,2,468,1
2020-09-11,Trinity,105,12862,52,16,7,23,0
2020-09-11,Tulare,107,460477,15602,14932,78,15010,251
2020-09-11,Tuolumne,109,53932,224,208,5,213,1
2020-09-11,Ventura,111,848112,12442,11700,130,11830,123
2020-09-11,Yolo,113,214977,2720,2632,7,2639,53
2020-09-11,Yuba,115,75493,1014,946,3,949,1
2020-09-10,Alameda,001,1643700,20262,19509,145,19654,292
2020-09-10,Alpine,003,1148,2,2,0,2,0
2020-09-10,Amador,005,37829,280,277,0,277,16
2020-09-10,Butte,007,227075,2757,2590,26,2616,37
2020-09-10,Calaveras,009,45235,299,244,0,244,1
2020-09-10,Colusa,011,21464,504,482,0,482,6
2020-09-10,Contra Costa,013,1133247,15873,14909,72,14981,172
2020-09-10,Del Norte,015,27424,125,112,0,112,1
2020-09-10,El Dorado,017,186661,1079,1020,7,1027,2
2020-09-10,Fresno,019,978130,29322,26783,334,27117,338
2020-09-10,Glenn,021,27897,534,511,0,511,3
2020-09-10,Humboldt,023,135768,464,422,1,423,4
2020-09-10,Imperial,025,180216,11517,10251,7,10258,270
2020-09-10,Inyo,027,18085,185,176,4,180,11
2020-09-10,Kern,029,883053,30944,29988,273,30261,363
2020-09-10,Kings,031,150075,7168,6739,32,6771,70
2020-09-10,Lake,033,64148,446,377,0,377,4
2020-09-10,Lassen,035,31185,733,716,2,718,0
2020-09-10,Los Angeles,037,10098052,254591,251003,1526,252529,6132
2020-09-10,Madera,039,155013,4262,3979,29,4008,43
2020-09-10,Marin,041,260295,6482,6344,15,6359,68
2020-09-10,Mariposa,043,17540,75,72,0,72,2
2020-09-10,Mendocino,045,87422,735,697,0,697,16
2020-09-10,Merced,047,269075,8581,8461,13,8474,109
2020-09-10,Modoc,049,8938,25,21,0,21,0
2020-09-10,Mono,051,14174,165,145,2,147,1
2020-09-10,Monterey,053,433212,9069,8570,23,8593,59
2020-09-10,Napa,055,140530,1594,1536,8,1544,11
2020-09-10,Nevada,057,99092,491,478,15,493,6
2020-09-10,Orange,059,3164182,52261,49617,1314,50931,1057
2020-09-10,Placer,061,380077,3400,3233,13,3246,37
2020-09-10,Plumas,063,18699,48,42,0,42,0
2020-09-10,Riverside,065,2383286,56043,54417,96,54513,1091
2020-09-10,Sacramento,067,1510023,20577,19618,21,19639,354
2020-09-10,San Benito,069,59416,1248,1201,0,1201,5
2020-09-10,San Bernardino,071,2135413,51350,49467,328,49795,867
2020-09-10,San Diego,073,3302833,43677,41610,677,42287,725
2020-09-10,San Francisco,075,870044,10460,10082,22,10104,89
2020-09-10,San Joaquin,077,732212,19478,18854,43,18897,389
2020-09-10,San Luis Obispo,079,281455,3405,3161,16,3177,24
2020-09-10,San Mateo,081,765935,9433,8529,10,8539,125
2020-09-10,Santa Barbara,083,443738,8759,8552,73,8625,100
2020-09-10,Santa Clara,085,1922200,20460,18870,39,18909,231
2020-09-10,Santa Cruz,087,273765,2145,1986,17,2003,7
2020-09-10,Shasta,089,179085,696,566,3,569,10
2020-09-10,Sierra,091,2930,6,6,0,6,0
2020-09-10,Siskiyou,093,43540,151,137,9,146,0
2020-09-10,Solano,095,438530,5924,5696,39,5735,42
2020-09-10,Sonoma,097,501317,6796,6424,20,6444,91
2020-09-10,Stanislaus,099,539301,15990,15509,443,15952,243
2020-09-10,Sutter,101,95872,1570,1494,1,1495,11
2020-09-10,Tehama,103,63373,476,466,2,468,1
2020-09-10,Trinity,105,12862,52,15,7,22,0
2020-09-10,Tulare,107,460477,15547,14860,75,14935,250
2020-09-10,Tuolumne,109,53932,223,205,5,210,1
2020-09-10,Ventura,111,848112,12348,11600,123,11723,122
2020-09-10,Yolo,113,214977,2715,2612,7,2619,53
2020-09-10,Yuba,115,75493,1008,941,3,944,1
2020-09-09,Alameda,001,1643700,20183,19399,144,19543,289
2020-09-09,Alpine,003,1148,2,2,0,2,0
2020-09-09,Amador,005,37829,279,276,0,276,16
2020-09-09,Butte,007,227075,2740,2561,26,2587,37
2020-09-09,Calaveras,009,45235,299,242,0,242,1
2020-09-09,Colusa,011,21464,499,479,0,479,6
2020-09-09,Contra Costa,013,1133247,15787,14816,72,14888,171
2020-09-09,Del Norte,015,27424,121,109,0,109,1
2020-09-09,El Dorado,017,186661,1076,1020,7,1027,2
2020-09-09,Fresno,019,978130,29219,26724,329,27053,329
2020-09-09,Glenn,021,27897,531,508,0,508,3
2020-09-09,Humboldt,023,135768,462,420,1,421,4
2020-09-09,Imperial,025,180216,11496,10233,7,10240,268
2020-09-09,Inyo,027,18085,184,173,4,177,2
2020-09-09,Kern,029,883053,30846,29925,270,30195,355
2020-09-09,Kings,031,150075,7150,6721,32,6753,72
2020-09-09,Lake,033,64148,438,371,0,371,4
2020-09-09,Lassen,035,31185,732,714,2,716,0
2020-09-09,Los Angeles,037,10098052,253718,249876,1508,251384,6091
2020-09-09,Madera,039,155013,4236,3926,29,3955,43
2020-09-09,Marin,041,260295,6463,6321,15,6336,68
2020-09-09,Mariposa,043,17540,74,72,0,72,2
2020-09-09,Mendocino,045,87422,727,695,0,695,16
2020-09-09,Merced,047,269075,8555,8441,13,8454,107
2020-09-09,Modoc,049,8938,24,20,0,20,0
2020-09-09,Mono,051,14174,165,145,2,147,1
2020-09-09,Monterey,053,433212,8997,8527,23,8550,59
2020-09-09,Napa,055,140530,1584,1531,8,1539,11
2020-09-09,Nevada,057,99092,487,476,15,491,6
2020-09-09,Orange,059,3164182,52082,49394,1307,50701,1054
2020-09-09,Placer,061,380077,3380,3222,13,3235,36
2020-09-09,Plumas,063,18699,46,42,0,42,0
2020-09-09,Riverside,065,2383286,55813,54320,93,54413,1081
2020-09-09,Sacramento,067,1510023,20471,19474,20,19494,347
2020-09-09,San Benito,069,59416,1244,1199,0,1199,5
2020-09-09,San Bernardino,071,2135413,51152,49264,327,49591,866
2020-09-09,San Diego,073,3302833,43388,41326,665,41991,721
2020-09-09,San Francisco,075,870044,10410,9996,21,10017,86
2020-09-09,San Joaquin,077,732212,19414,18799,42,18841,388
2020-09-09,San Luis Obispo,079,281455,3387,3131,16,3147,24
2020-09-09,San Mateo,081,765935,9373,8478,10,8488,125
2020-09-09,Santa Barbara,083,443738,8716,8528,73,8601,97
2020-09-09,Santa Clara,085,1922200,20328,18759,39,18798,228
2020-09-09,Santa Cruz,087,273765,2122,1967,17,1984,7
2020-09-09,Shasta,089,179085,684,562,3,565,10
2020-09-09,Sierra,091,2930,6,6,0,6,0
2020-09-09,Siskiyou,093,43540,149,137,9,146,0
2020-09-09,Solano,095,438530,5892,5680,39,5719,36
2020-09-09,Sonoma,097,501317,6730,6397,20,6417,92
2020-09-09,Stanislaus,099,539301,15951,15469,432,15901,243
2020-09-09,Sutter,101,95872,1562,1487,1,1488,11
2020-09-09,Tehama,103,63373,473,462,2,464,1
2020-09-09,Trinity,105,12862,52,14,7,21,0
2020-09-09,Tulare,107,460477,15498,14787,70,14857,249
2020-09-09,Tuolumne,109,53932,222,204,4,208,1
2020-09-09,Ventura,111,848112,12257,11497,120,11617,121
2020-09-09,Yolo,113,214977,2704,2604,7,2611,53
2020-09-09,Yuba,115,75493,1003,936,3,939,1
2020-09-08,Alameda,001,1643700,20075,19293,144,19437,288
2020-09-08,Alpine,003,1148,2,2,0,2,0
2020-09-08,Amador,005,37829,279,276,0,276,16
2020-09-08,Butte,007,227075,2722,2453,26,2479,36
2020-09-08,Calaveras,009,45235,297,233,0,233,1
2020-09-08,Colusa,011,21464,497,475,0,475,6
2020-09-08,Contra Costa,013,1133247,15659,14740,69,14809,171
2020-09-08,Del Norte,015,27424,121,109,0,109,2
2020-09-08,El Dorado,017,186661,1073,1011,7,1018,2
2020-09-08,Fresno,019,978130,29099,26640,325,26965,329
2020-09-08,Glenn,021,27897,527,492,0,492,3
2020-09-08,Humboldt,023,135768,460,420,1,421,4
2020-09-08,Imperial,025,180216,11480,10198,7,10205,267
2020-09-08,Inyo,027,18085,184,169,4,173,2
2020-09-08,Kern,029,883053,30761,29850,268,30118,351
2020-09-08,Kings,031,150075,7112,6658,32,6690,72
2020-09-08,Lake,033,64148,428,370,0,370,4
2020-09-08,Lassen,035,31185,732,710,2,712,0
2020-09-08,Los Angeles,037,10098052,252787,249217,1480,250697,6034
2020-09-08,Madera,039,155013,4212,3904,29,3933,43
2020-09-08,Marin,041,260295,6432,6313,15,6328,68
2020-09-08,Mariposa,043,17540,74,72,0,72,2
2020-09-08,Mendocino,045,87422,720,690,0,690,16
2020-09-08,Merced,047,269075,8532,8381,13,8394,104
2020-09-08,Modoc,049,8938,24,20,0,20,0
2020-09-08,Mono,051,14174,165,145,2,147,1
2020-09-08,Monterey,053,433212,8912,8491,23,8514,59
2020-09-08,Napa,055,140530,1580,1518,8,1526,11
2020-09-08,Nevada,057,99092,487,470,15,485,6
2020-09-08,Orange,059,3164182,51940,49214,1303,50517,1044
2020-09-08,Placer,061,380077,3366,3205,13,3218,36
2020-09-08,Plumas,063,18699,46,42,0,42,0
2020-09-08,Riverside,065,2383286,55599,54168,90,54258,1069
2020-09-08,Sacramento,067,1510023,20236,19411,19,19430,347
2020-09-08,San Benito,069,59416,1237,1188,0,1188,5
2020-09-08,San Bernardino,071,2135413,50964,49034,325,49359,856
2020-09-08,San Diego,073,3302833,43072,41079,653,41732,709
2020-09-08,San Francisco,075,870044,10337,9821,21,9842,86
2020-09-08,San Joaquin,077,732212,19336,18550,42,18592,388
2020-09-08,San Luis Obispo,079,281455,3372,3120,16,3136,23
2020-09-08,San Mateo,081,765935,9297,8460,10,8470,125
2020-09-08,Santa Barbara,083,443738,8682,8488,72,8560,96
2020-09-08,Santa Clara,085,1922200,20152,18645,39,18684,228
2020-09-08,Santa Cruz,087,273765,2094,1903,17,1920,7
2020-09-08,Shasta,089,179085,676,556,3,559,10
2020-09-08,Sierra,091,2930,6,6,0,6,0
2020-09-08,Siskiyou,093,43540,147,136,9,145,0
2020-09-08,Solano,095,438530,5855,5654,39,5693,36
2020-09-08,Sonoma,097,501317,6661,6356,20,6376,92
2020-09-08,Stanislaus,099,539301,15887,15415,420,15835,238
2020-09-08,Sutter,101,95872,1546,1473,1,1474,11
2020-09-08,Tehama,103,63373,469,458,2,460,1
2020-09-08,Trinity,105,12862,51,13,7,20,0
2020-09-08,Tulare,107,460477,15418,14635,69,14704,249
2020-09-08,Tuolumne,109,53932,221,197,4,201,1
2020-09-08,Ventura,111,848112,12188,11475,117,11592,118
2020-09-08,Yolo,113,214977,2694,2580,7,2587,53
2020-09-08,Yuba,115,75493,991,923,3,926,1
2020-09-07,Alameda,001,1643700,19954,19188,138,19326,281
2020-09-07,Alpine,003,1148,2,2,0,2,0
2020-09-07,Amador,005,37829,279,276,0,276,16
2020-09-07,Butte,007,227075,2689,2450,25,2475,30
2020-09-07,Calaveras,009,45235,287,234,0,234,1
2020-09-07,Colusa,011,21464,496,475,0,475,6
2020-09-07,Contra Costa,013,1133247,15546,14637,66,14703,172
2020-09-07,Del Norte,015,27424,121,109,0,109,2
2020-09-07,El Dorado,017,186661,1062,1011,7,1018,2
2020-09-07,Fresno,019,978130,29005,26565,322,26887,329
2020-09-07,Glenn,021,27897,522,488,0,488,3
2020-09-07,Humboldt,023,135768,451,416,1,417,4
2020-09-07,Imperial,025,180216,11449,10199,7,10206,267
2020-09-07,Inyo,027,18085,184,169,4,173,2
2020-09-07,Kern,029,883053,30641,29790,263,30053,348
2020-09-07,Kings,031,150075,6988,6630,32,6662,72
2020-09-07,Lake,033,64148,405,367,0,367,2
2020-09-07,Lassen,035,31185,732,709,2,711,0
2020-09-07,Los Angeles,037,10098052,251740,248804,1459,250263,6030
2020-09-07,Madera,039,155013,4181,3889,28,3917,43
2020-09-07,Marin,041,260295,6402,6296,15,6311,67
2020-09-07,Mariposa,043,17540,74,72,0,72,2
2020-09-07,Mendocino,045,87422,712,687,0,687,16
2020-09-07,Merced,047,269075,8485,8381,13,8394,104
2020-09-07,Modoc,049,8938,23,20,0,20,0
2020-09-07,Mono,051,14174,165,145,2,147,1
2020-09-07,Monterey,053,433212,8833,8463,23,8486,57
2020-09-07,Napa,055,140530,1568,1514,8,1522,11
2020-09-07,Nevada,057,99092,485,469,15,484,6
2020-09-07,Orange,059,3164182,51766,49132,1299,50431,1042
2020-09-07,Placer,061,380077,3336,3188,12,3200,36
2020-09-07,Plumas,063,18699,45,42,0,42,0
2020-09-07,Riverside,065,2383286,55324,54178,84,54262,1069
2020-09-07,Sacramento,067,1510023,19994,19292,18,19310,345
2020-09-07,San Benito,069,59416,1231,1180,0,1180,4
2020-09-07,San Bernardino,071,2135413,50736,49043,323,49366,821
2020-09-07,San Diego,073,3302833,42672,40868,626,41494,708
2020-09-07,San Francisco,075,870044,10286,9813,20,9833,85
2020-09-07,San Joaquin,077,732212,19255,18552,40,18592,386
2020-09-07,San Luis Obispo,079,281455,3335,3116,16,3132,23
2020-09-07,San Mateo,081,765935,9215,8409,10,8419,125
2020-09-07,Santa Barbara,083,443738,8638,8479,72,8551,95
2020-09-07,Santa Clara,085,1922200,19994,18596,38,18634,226
2020-09-07,Santa Cruz,087,273765,2066,1902,17,1919,7
2020-09-07,Shasta,089,179085,666,556,3,559,10
2020-09-07,Sierra,091,2930,6,6,0,6,0
2020-09-07,Siskiyou,093,43540,146,133,9,142,0
2020-09-07,Solano,095,438530,5790,5640,39,5679,36
2020-09-07,Sonoma,097,501317,6595,6268,20,6288,85
2020-09-07,Stanislaus,099,539301,15822,15343,408,15751,236
2020-09-07,Sutter,101,95872,1529,1468,1,1469,11
2020-09-07,Tehama,103,63373,466,453,2,455,1
2020-09-07,Trinity,105,12862,51,13,7,20,0
2020-09-07,Tulare,107,460477,15313,14637,67,14704,249
2020-09-07,Tuolumne,109,53932,220,196,4,200,1
2020-09-07,Ventura,111,848112,12093,11463,114,11577,118
2020-09-07,Yolo,113,214977,2677,2565,6,2571,53
2020-09-07,Yuba,115,75493,975,923,3,926,1
2020-09-06,Alameda,001,1643700,19896,19029,136,19165,281
2020-09-06,Alpine,003,1148,2,2,0,2,0
2020-09-06,Amador,005,37829,277,275,0,275,16
2020-09-06,Butte,007,227075,2680,2446,25,2471,30
2020-09-06,Calaveras,009,45235,287,235,0,235,1
2020-09-06,Colusa,011,21464,492,475,0,475,6
2020-09-06,Contra Costa,013,1133247,15466,14565,65,14630,171
2020-09-06,Del Norte,015,27424,121,109,0,109,2
2020-09-06,El Dorado,017,186661,1060,1008,7,1015,2
2020-09-06,Fresno,019,978130,28941,26471,320,26791,329
2020-09-06,Glenn,021,27897,516,474,0,474,3
2020-09-06,Humboldt,023,135768,448,404,1,405,4
2020-09-06,Imperial,025,180216,11432,10152,7,10159,267
2020-09-06,Inyo,027,18085,184,169,4,173,2
2020-09-06,Kern,029,883053,30585,29699,259,29958,348
2020-09-06,Kings,031,150075,6968,6561,31,6592,72
2020-09-06,Lake,033,64148,402,362,0,362,2
2020-09-06,Lassen,035,31185,732,709,2,711,0
2020-09-06,Los Angeles,037,10098052,251107,248316,1445,249761,6004
2020-09-06,Madera,039,155013,4137,3867,28,3895,42
2020-09-06,Marin,041,260295,6390,6276,15,6291,67
2020-09-06,Mariposa,043,17540,74,72,0,72,2
2020-09-06,Mendocino,045,87422,711,672,0,672,16
2020-09-06,Merced,047,269075,8465,8327,13,8340,104
2020-09-06,Modoc,049,8938,23,20,0,20,0
2020-09-06,Mono,051,14174,164,145,2,147,1
2020-09-06,Monterey,053,433212,8793,8403,22,8425,56
2020-09-06,Napa,055,140530,1564,1501,6,1507,11
2020-09-06,Nevada,057,99092,485,467,14,481,6
2020-09-06,Orange,059,3164182,51653,48931,1295,50226,1042
2020-09-06,Placer,061,380077,3319,3169,12,3181,36
2020-09-06,Plumas,063,18699,44,42,0,42,0
2020-09-06,Riverside,065,2383286,55208,53970,82,54052,1069
2020-09-06,Sacramento,067,1510023,19899,19128,18,19146,340
2020-09-06,San Benito,069,59416,1229,1178,0,1178,4
2020-09-06,San Bernardino,071,2135413,50629,48923,323,49246,823
2020-09-06,San Diego,073,3302833,42424,40652,620,41272,707
2020-09-06,San Francisco,075,870044,10212,9813,20,9833,85
2020-09-06,San Joaquin,077,732212,19206,18558,40,18598,386
2020-09-06,San Luis Obispo,079,281455,3324,3101,16,3117,23
2020-09-06,San Mateo,081,765935,9162,8387,10,8397,125
2020-09-06,Santa Barbara,083,443738,8609,8434,72,8506,95
2020-09-06,Santa Clara,085,1922200,19893,18495,38,18533,207
2020-09-06,Santa Cruz,087,273765,2059,1902,17,1919,7
2020-09-06,Shasta,089,179085,660,550,3,553,10
2020-09-06,Sierra,091,2930,6,6,0,6,0
2020-09-06,Siskiyou,093,43540,146,132,9,141,0
2020-09-06,Solano,095,438530,5764,5619,39,5658,37
2020-09-06,Sonoma,097,501317,6566,6212,20,6232,85
2020-09-06,Stanislaus,099,539301,15778,15288,404,15692,236
2020-09-06,Sutter,101,95872,1516,1451,1,1452,11
2020-09-06,Tehama,103,63373,465,455,2,457,1
2020-09-06,Trinity,105,12862,50,13,7,20,0
2020-09-06,Tulare,107,460477,15270,14636,66,14702,249
2020-09-06,Tuolumne,109,53932,217,194,4,198,1
2020-09-06,Ventura,111,848112,12048,11315,114,11429,118
2020-09-06,Yolo,113,214977,2663,2556,6,2562,53
2020-09-06,Yuba,115,75493,966,913,3,916,1
2020-09-05,Alameda,001,1643700,19851,18973,134,19107,279
2020-09-05,Alpine,003,1148,2,2,0,2,0
2020-09-05,Amador,005,37829,277,274,0,274,16
2020-09-05,Butte,007,227075,2664,2406,24,2430,30
2020-09-05,Calaveras,009,45235,287,237,0,237,1
2020-09-05,Colusa,011,21464,488,472,0,472,6
2020-09-05,Contra Costa,013,1133247,15389,14456,63,14519,173
2020-09-05,Del Norte,015,27424,121,109,0,109,2
2020-09-05,El Dorado,017,186661,1060,1007,7,1014,2
2020-09-05,Fresno,019,978130,28873,26325,320,26645,331
2020-09-05,Glenn,021,27897,515,474,0,474,3
2020-09-05,Humboldt,023,135768,446,402,1,403,4
2020-09-05,Imperial,025,180216,11415,10151,7,10158,268
2020-09-05,Inyo,027,18085,184,169,4,173,2
2020-09-05,Kern,029,883053,30525,29645,255,29900,347
2020-09-05,Kings,031,150075,6959,6518,31,6549,66
2020-09-05,Lake,033,64148,399,359,0,359,2
2020-09-05,Lassen,035,31185,732,709,2,711,0
2020-09-05,Los Angeles,037,10098052,250572,247572,1433,249005,6001
2020-09-05,Madera,039,155013,4096,3851,28,3879,42
2020-09-05,Marin,041,260295,6383,6259,15,6274,66
2020-09-05,Mariposa,043,17540,74,72,0,72,2
2020-09-05,Mendocino,045,87422,710,658,0,658,16
2020-09-05,Merced,047,269075,8433,8297,11,8308,104
2020-09-05,Modoc,049,8938,23,19,0,19,0
2020-09-05,Mono,051,14174,164,145,2,147,1
2020-09-05,Monterey,053,433212,8763,8301,22,8323,56
2020-09-05,Napa,055,140530,1558,1484,6,1490,11
2020-09-05,Nevada,057,99092,482,461,14,475,6
2020-09-05,Orange,059,3164182,51551,48726,1290,50016,1039
2020-09-05,Placer,061,380077,3308,3141,12,3153,35
2020-09-05,Plumas,063,18699,44,42,0,42,0
2020-09-05,Riverside,065,2383286,55102,53780,82,53862,1066
2020-09-05,Sacramento,067,1510023,19809,18955,18,18973,339
2020-09-05,San Benito,069,59416,1227,1153,0,1153,4
2020-09-05,San Bernardino,071,2135413,50553,48800,322,49122,825
2020-09-05,San Diego,073,3302833,42231,40344,608,40952,717
2020-09-05,San Francisco,075,870044,10179,9812,19,9831,85
2020-09-05,San Joaquin,077,732212,19177,18557,40,18597,386
2020-09-05,San Luis Obispo,079,281455,3314,3083,16,3099,23
2020-09-05,San Mateo,081,765935,9117,8352,10,8362,124
2020-09-05,Santa Barbara,083,443738,8593,8404,72,8476,96
2020-09-05,Santa Clara,085,1922200,19810,18311,38,18349,207
2020-09-05,Santa Cruz,087,273765,2051,1904,17,1921,7
2020-09-05,Shasta,089,179085,659,544,3,547,10
2020-09-05,Sierra,091,2930,6,6,0,6,0
2020-09-05,Siskiyou,093,43540,145,131,9,140,0
2020-09-05,Solano,095,438530,5752,5579,39,5618,37
2020-09-05,Sonoma,097,501317,6533,6149,20,6169,85
2020-09-05,Stanislaus,099,539301,15730,15198,400,15598,236
2020-09-05,Sutter,101,95872,1509,1445,1,1446,11
2020-09-05,Tehama,103,63373,464,447,2,449,1
2020-09-05,Trinity,105,12862,50,13,7,20,0
2020-09-05,Tulare,107,460477,15212,14576,64,14640,249
2020-09-05,Tuolumne,109,53932,217,194,4,198,1
2020-09-05,Ventura,111,848112,12005,11254,114,11368,118
2020-09-05,Yolo,113,214977,2653,2534,6,2540,53
2020-09-05,Yuba,115,75493,960,902,3,905,1
2020-09-04,Alameda,001,1643700,19782,18843,132,18975,276
2020-09-04,Alpine,003,1148,2,2,0,2,0
2020-09-04,Amador,005,37829,276,274,0,274,16
2020-09-04,Butte,007,227075,2641,2325,24,2349,28
2020-09-04,Calaveras,009,45235,285,237,0,237,1
2020-09-04,Colusa,011,21464,486,467,0,467,6
2020-09-04,Contra Costa,013,1133247,15306,14355,62,14417,164
2020-09-04,Del Norte,015,27424,121,109,0,109,2
2020-09-04,El Dorado,017,186661,1056,992,7,999,2
2020-09-04,Fresno,019,978130,28769,26147,319,26466,321
2020-09-04,Glenn,021,27897,507,463,0,463,3
2020-09-04,Humboldt,023,135768,441,390,1,391,4
2020-09-04,Imperial,025,180216,11406,10136,7,10143,267
2020-09-04,Inyo,027,18085,184,169,4,173,2
2020-09-04,Kern,029,883053,30457,29526,252,29778,345
2020-09-04,Kings,031,150075,6946,6259,31,6290,66
2020-09-04,Lake,033,64148,399,347,0,347,2
2020-09-04,Lassen,035,31185,732,708,2,710,0
2020-09-04,Los Angeles,037,10098052,250004,246396,1413,247809,5977
2020-09-04,Madera,039,155013,4083,3838,28,3866,42
2020-09-04,Marin,041,260295,6371,6251,15,6266,66
2020-09-04,Mariposa,043,17540,74,72,0,72,2
2020-09-04,Mendocino,045,87422,708,646,0,646,16
2020-09-04,Merced,047,269075,8413,8214,11,8225,104
2020-09-04,Modoc,049,8938,23,15,0,15,0
2020-09-04,Mono,051,14174,164,145,2,147,1
2020-09-04,Monterey,053,433212,8718,8208,22,8230,56
2020-09-04,Napa,055,140530,1549,1475,6,1481,11
2020-09-04,Nevada,057,99092,479,455,14,469,6
2020-09-04,Orange,059,3164182,51427,48488,1283,49771,1031
2020-09-04,Placer,061,380077,3296,3101,12,3113,35
2020-09-04,Plumas,063,18699,44,42,0,42,0
2020-09-04,Riverside,065,2383286,54989,53606,77,53683,1066
2020-09-04,Sacramento,067,1510023,19721,18765,18,18783,337
2020-09-04,San Benito,069,59416,1218,1137,0,1137,4
2020-09-04,San Bernardino,071,2135413,50460,48497,320,48817,800
2020-09-04,San Diego,073,3302833,42001,39901,599,40500,701
2020-09-04,San Francisco,075,870044,10139,9694,18,9712,85
2020-09-04,San Joaquin,077,732212,19123,18438,40,18478,376
2020-09-04,San Luis Obispo,079,281455,3299,3049,15,3064,21
2020-09-04,San Mateo,081,765935,9073,8275,10,8285,122
2020-09-04,Santa Barbara,083,443738,8563,8340,72,8412,96
2020-09-04,Santa Clara,085,1922200,19702,18074,38,18112,209
2020-09-04,Santa Cruz,087,273765,2034,1896,16,1912,7
2020-09-04,Shasta,089,179085,656,536,3,539,10
2020-09-04,Sierra,091,2930,6,6,0,6,0
2020-09-04,Siskiyou,093,43540,145,129,9,138,0
2020-09-04,Solano,095,438530,5739,5552,39,5591,37
2020-09-04,Sonoma,097,501317,6468,6050,20,6070,85
2020-09-04,Stanislaus,099,539301,15696,15074,391,15465,233
2020-09-04,Sutter,101,95872,1493,1425,1,1426,11
2020-09-04,Tehama,103,63373,460,442,2,444,1
2020-09-04,Trinity,105,12862,50,13,7,20,0
2020-09-04,Tulare,107,460477,15184,14501,60,14561,247
2020-09-04,Tuolumne,109,53932,217,193,4,197,1
2020-09-04,Ventura,111,848112,11963,11171,114,11285,114
2020-09-04,Yolo,113,214977,2639,2495,6,2501,53
2020-09-04,Yuba,115,75493,955,884,3,887,1
2020-09-03,Alameda,001,1643700,19679,18687,132,18819,275
2020-09-03,Alpine,003,1148,2,2,0,2,0
2020-09-03,Amador,005,37829,276,274,0,274,16
2020-09-03,Butte,007,227075,2597,2274,24,2298,27
2020-09-03,Calaveras,009,45235,284,238,0,238,1
2020-09-03,Colusa,011,21464,484,464,0,464,6
2020-09-03,Contra Costa,013,1133247,15199,14206,59,14265,159
2020-09-03,Del Norte,015,27424,118,109,0,109,2
2020-09-03,El Dorado,017,186661,1052,983,7,990,2
2020-09-03,Fresno,019,978130,28650,25978,314,26292,313
2020-09-03,Glenn,021,27897,503,460,0,460,3
2020-09-03,Humboldt,023,135768,436,390,1,391,4
2020-09-03,Imperial,025,180216,11385,10083,7,10090,255
2020-09-03,Inyo,027,18085,182,171,4,175,3
2020-09-03,Kern,029,883053,30365,29426,238,29664,340
2020-09-03,Kings,031,150075,6866,6200,31,6231,64
2020-09-03,Lake,033,64148,390,347,0,347,2
2020-09-03,Lassen,035,31185,732,707,2,709,0
2020-09-03,Los Angeles,037,10098052,249141,245026,1393,246419,5931
2020-09-03,Madera,039,155013,4064,3780,28,3808,43
2020-09-03,Marin,041,260295,6352,6175,15,6190,66
2020-09-03,Mariposa,043,17540,74,71,0,71,2
2020-09-03,Mendocino,045,87422,699,638,0,638,16
2020-09-03,Merced,047,269075,8371,8136,11,8147,105
2020-09-03,Modoc,049,8938,23,14,0,14,0
2020-09-03,Mono,051,14174,163,144,2,146,1
2020-09-03,Monterey,053,433212,8664,8128,22,8150,56
2020-09-03,Napa,055,140530,1542,1466,6,1472,10
2020-09-03,Nevada,057,99092,476,453,14,467,6
2020-09-03,Orange,059,3164182,51241,48226,1269,49495,1009
2020-09-03,Placer,061,380077,3278,3069,12,3081,34
2020-09-03,Plumas,063,18699,44,39,0,39,0
2020-09-03,Riverside,065,2383286,54809,53341,73,53414,1052
2020-09-03,Sacramento,067,1510023,19593,18553,17,18570,328
2020-09-03,San Benito,069,59416,1207,1121,0,1121,4
2020-09-03,San Bernardino,071,2135413,50294,48165,319,48484,800
2020-09-03,San Diego,073,3302833,41687,39448,583,40031,700
2020-09-03,San Francisco,075,870044,10073,9636,16,9652,84
2020-09-03,San Joaquin,077,732212,19046,18331,40,18371,371
2020-09-03,San Luis Obispo,079,281455,3282,3023,15,3038,21
2020-09-03,San Mateo,081,765935,8999,8211,10,8221,122
2020-09-03,Santa Barbara,083,443738,8516,8277,72,8349,96
2020-09-03,Santa Clara,085,1922200,19521,17879,38,17917,208
2020-09-03,Santa Cruz,087,273765,2019,1870,16,1886,7
2020-09-03,Shasta,089,179085,651,535,3,538,10
2020-09-03,Sierra,091,2930,6,6,0,6,0
2020-09-03,Siskiyou,093,43540,145,128,9,137,0
2020-09-03,Solano,095,438530,5719,5499,38,5537,36
2020-09-03,Sonoma,097,501317,6406,5997,20,6017,62
2020-09-03,Stanislaus,099,539301,15644,14985,387,15372,217
2020-09-03,Sutter,101,95872,1483,1412,1,1413,11
2020-09-03,Tehama,103,63373,456,436,2,438,1
2020-09-03,Trinity,105,12862,48,13,7,20,0
2020-09-03,Tulare,107,460477,15118,14408,59,14467,244
2020-09-03,Tuolumne,109,53932,217,193,4,197,1
2020-09-03,Ventura,111,848112,11845,11109,111,11220,112
2020-09-03,Yolo,113,214977,2623,2475,6,2481,53
2020-09-03,Yuba,115,75493,948,867,3,870,1
2020-09-02,Alameda,001,1643700,19561,18522,129,18651,260
2020-09-02,Alpine,003,1148,2,2,0,2,0
2020-09-02,Amador,005,37829,276,245,0,245,14
2020-09-02,Butte,007,227075,2551,2241,24,2265,27
2020-09-02,Calaveras,009,45235,283,235,0,235,1
2020-09-02,Colusa,011,21464,480,460,0,460,6
2020-09-02,Contra Costa,013,1133247,15110,14097,57,14154,159
2020-09-02,Del Norte,015,27424,117,109,0,109,2
2020-09-02,El Dorado,017,186661,1048,975,6,981,2
2020-09-02,Fresno,019,978130,28502,25785,311,26096,292
2020-09-02,Glenn,021,27897,498,457,0,457,3
2020-09-02,Humboldt,023,135768,433,381,1,382,4
2020-09-02,Imperial,025,180216,11369,9832,7,9839,255
2020-09-02,Inyo,027,18085,182,171,4,175,3
2020-09-02,Kern,029,883053,30273,29288,232,29520,335
2020-09-02,Kings,031,150075,6781,6142,31,6173,64
2020-09-02,Lake,033,64148,386,342,0,342,2
2020-09-02,Lassen,035,31185,730,706,2,708,0
2020-09-02,Los Angeles,037,10098052,248210,243999,1365,245364,5887
2020-09-02,Madera,039,155013,4044,3735,28,3763,41
2020-09-02,Marin,041,260295,6337,6131,15,6146,66
2020-09-02,Mariposa,043,17540,74,71,0,71,2
2020-09-02,Mendocino,045,87422,689,636,0,636,15
2020-09-02,Merced,047,269075,8340,8097,10,8107,103
2020-09-02,Modoc,049,8938,22,11,0,11,0
2020-09-02,Mono,051,14174,163,145,2,147,1
2020-09-02,Monterey,053,433212,8600,8070,22,8092,56
2020-09-02,Napa,055,140530,1530,1454,6,1460,10
2020-09-02,Nevada,057,99092,470,452,13,465,6
2020-09-02,Orange,059,3164182,51060,47871,1259,49130,994
2020-09-02,Placer,061,380077,3253,3047,11,3058,33
2020-09-02,Plumas,063,18699,44,39,0,39,0
2020-09-02,Riverside,065,2383286,54607,52923,70,52993,1032
2020-09-02,Sacramento,067,1510023,19360,18355,16,18371,316
2020-09-02,San Benito,069,59416,1194,1107,0,1107,4
2020-09-02,San Bernardino,071,2135413,50131,47766,316,48082,794
2020-09-02,San Diego,073,3302833,41367,39123,569,39692,695
2020-09-02,San Francisco,075,870044,10004,9587,16,9603,84
2020-09-02,San Joaquin,077,732212,18966,18194,39,18233,352
2020-09-02,San Luis Obispo,079,281455,3256,3002,14,3016,21
2020-09-02,San Mateo,081,765935,8942,8148,10,8158,122
2020-09-02,Santa Barbara,083,443738,8461,8206,71,8277,94
2020-09-02,Santa Clara,085,1922200,19367,17673,38,17711,206
2020-09-02,Santa Cruz,087,273765,1996,1850,16,1866,7
2020-09-02,Shasta,089,179085,650,531,3,534,10
2020-09-02,Sierra,091,2930,6,6,0,6,0
2020-09-02,Siskiyou,093,43540,144,127,9,136,0
2020-09-02,Solano,095,438530,5691,5463,38,5501,36
2020-09-02,Sonoma,097,501317,6344,5846,20,5866,62
2020-09-02,Stanislaus,099,539301,15574,14854,380,15234,220
2020-09-02,Sutter,101,95872,1468,1401,1,1402,10
2020-09-02,Tehama,103,63373,453,429,2,431,1
2020-09-02,Trinity,105,12862,48,13,7,20,0
2020-09-02,Tulare,107,460477,15051,14298,59,14357,244
2020-09-02,Tuolumne,109,53932,217,190,4,194,1
2020-09-02,Ventura,111,848112,11758,11031,110,11141,111
2020-09-02,Yolo,113,214977,2602,2449,6,2455,54
2020-09-02,Yuba,115,75493,941,856,3,859,1
2020-09-01,Alameda,001,1643700,19421,18382,126,18508,248
2020-09-01,Alpine,003,1148,2,2,0,2,0
2020-09-01,Amador,005,37829,275,244,0,244,13
2020-09-01,Butte,007,227075,2494,2146,24,2170,26
2020-09-01,Calaveras,009,45235,275,228,0,228,1
2020-09-01,Colusa,011,21464,476,454,0,454,6
2020-09-01,Contra Costa,013,1133247,15017,13998,55,14053,158
2020-09-01,Del Norte,015,27424,116,108,0,108,2
2020-09-01,El Dorado,017,186661,1040,972,6,978,2
2020-09-01,Fresno,019,978130,28355,25542,309,25851,290
2020-09-01,Glenn,021,27897,491,449,0,449,3
2020-09-01,Humboldt,023,135768,427,378,1,379,4
2020-09-01,Imperial,025,180216,11343,9782,7,9789,250
2020-09-01,Inyo,027,18085,182,171,4,175,3
2020-09-01,Kern,029,883053,30182,29162,227,29389,332
2020-09-01,Kings,031,150075,6750,6088,31,6119,62
2020-09-01,Lake,033,64148,383,341,0,341,2
2020-09-01,Lassen,035,31185,727,706,2,708,0
2020-09-01,Los Angeles,037,10098052,247119,242633,1342,243975,5832
2020-09-01,Madera,039,155013,4015,3703,27,3730,41
2020-09-01,Marin,041,260295,6322,6102,15,6117,67
2020-09-01,Mariposa,043,17540,73,72,0,72,2
2020-09-01,Mendocino,045,87422,674,626,0,626,15
2020-09-01,Merced,047,269075,8287,8046,9,8055,103
2020-09-01,Modoc,049,8938,20,10,0,10,0
2020-09-01,Mono,051,14174,163,145,2,147,1
2020-09-01,Monterey,053,433212,8494,7926,22,7948,56
2020-09-01,Napa,055,140530,1515,1446,6,1452,10
2020-09-01,Nevada,057,99092,464,450,13,463,6
2020-09-01,Orange,059,3164182,50896,47671,1240,48911,976
2020-09-01,Placer,061,380077,3231,3013,11,3024,33
2020-09-01,Plumas,063,18699,44,39,0,39,0
2020-09-01,Riverside,065,2383286,54390,52785,69,52854,1027
2020-09-01,Sacramento,067,1510023,19177,18217,15,18232,305
2020-09-01,San Benito,069,59416,1182,1089,0,1089,4
2020-09-01,San Bernardino,071,2135413,49924,47371,315,47686,786
2020-09-01,San Diego,073,3302833,41009,38873,531,39404,688
2020-09-01,San Francisco,075,870044,9935,9492,16,9508,83
2020-09-01,San Joaquin,077,732212,18884,17915,38,17953,341
2020-09-01,San Luis Obispo,079,281455,3230,2970,14,2984,21
2020-09-01,San Mateo,081,765935,8862,8132,10,8142,122
2020-09-01,Santa Barbara,083,443738,8411,8142,70,8212,93
2020-09-01,Santa Clara,085,1922200,19188,17319,38,17357,204
2020-09-01,Santa Cruz,087,273765,1972,1752,16,1768,7
2020-09-01,Shasta,089,179085,642,527,3,530,9
2020-09-01,Sierra,091,2930,6,6,0,6,0
2020-09-01,Siskiyou,093,43540,141,128,8,136,0
2020-09-01,Solano,095,438530,5665,5438,38,5476,34
2020-09-01,Sonoma,097,501317,6254,5733,20,5753,60
2020-09-01,Stanislaus,099,539301,15498,14784,370,15154,212
2020-09-01,Sutter,101,95872,1457,1389,1,1390,10
2020-09-01,Tehama,103,63373,449,422,2,424,1
2020-09-01,Trinity,105,12862,47,13,6,19,0
2020-09-01,Tulare,107,460477,14968,14156,59,14215,241
2020-09-01,Tuolumne,109,53932,211,183,4,187,1
2020-09-01,Ventura,111,848112,11680,10899,105,11004,108
2020-09-01,Yolo,113,214977,2585,2440,6,2446,51
2020-09-01,Yuba,115,75493,932,841,3,844,1
2020-08-31,Alameda,001,1643700,19276,18148,126,18274,248
2020-08-31,Alpine,003,1148,2,2,0,2,0
2020-08-31,Amador,005,37829,275,243,0,243,13
2020-08-31,Butte,007,227075,2430,2069,24,2093,26
2020-08-31,Calaveras,009,45235,270,212,0,212,1
2020-08-31,Colusa,011,21464,475,443,0,443,6
2020-08-31,Contra Costa,013,1133247,14890,13902,52,13954,153
2020-08-31,Del Norte,015,27424,116,108,0,108,2
2020-08-31,El Dorado,017,186661,1033,965,6,971,2
2020-08-31,Fresno,019,978130,28134,25185,303,25488,290
2020-08-31,Glenn,021,27897,479,437,0,437,3
2020-08-31,Humboldt,023,135768,425,374,1,375,4
2020-08-31,Imperial,025,180216,11312,9759,7,9766,250
2020-08-31,Inyo,027,18085,181,160,4,164,3
2020-08-31,Kern,029,883053,30084,29067,226,29293,318
2020-08-31,Kings,031,150075,6483,6037,31,6068,62
2020-08-31,Lake,033,64148,367,341,0,341,2
2020-08-31,Lassen,035,31185,724,706,2,708,0
2020-08-31,Los Angeles,037,10098052,246012,241793,1315,243108,5787
2020-08-31,Madera,039,155013,3992,3662,26,3688,35
2020-08-31,Marin,041,260295,6286,6074,15,6089,67
2020-08-31,Mariposa,043,17540,73,69,0,69,2
2020-08-31,Mendocino,045,87422,662,618,0,618,15
2020-08-31,Merced,047,269075,8225,7991,9,8000,79
2020-08-31,Modoc,049,8938,18,10,0,10,0
2020-08-31,Mono,051,14174,163,145,2,147,1
2020-08-31,Monterey,053,433212,8387,7839,22,7861,56
2020-08-31,Napa,055,140530,1507,1434,6,1440,10
2020-08-31,Nevada,057,99092,462,447,13,460,6
2020-08-31,Orange,059,3164182,50697,47392,1212,48604,965
2020-08-31,Placer,061,380077,3182,2989,11,3000,33
2020-08-31,Plumas,063,18699,43,39,0,39,0
2020-08-31,Riverside,065,2383286,54168,52508,67,52575,1020
2020-08-31,Sacramento,067,1510023,18940,17999,15,18014,303
2020-08-31,San Benito,069,59416,1166,1080,0,1080,4
2020-08-31,San Bernardino,071,2135413,49712,47370,314,47684,755
2020-08-31,San Diego,073,3302833,40642,38606,498,39104,682
2020-08-31,San Francisco,075,870044,9856,9293,13,9306,83
2020-08-31,San Joaquin,077,732212,18797,17807,37,17844,338
2020-08-31,San Luis Obispo,079,281455,3207,2951,13,2964,21
2020-08-31,San Mateo,081,765935,8792,8065,10,8075,122
2020-08-31,Santa Barbara,083,443738,8365,8124,70,8194,94
2020-08-31,Santa Clara,085,1922200,18999,17211,38,17249,202
2020-08-31,Santa Cruz,087,273765,1947,1742,16,1758,7
2020-08-31,Shasta,089,179085,637,528,3,531,9
2020-08-31,Sierra,091,2930,6,6,0,6,0
2020-08-31,Siskiyou,093,43540,140,127,8,135,0
2020-08-31,Solano,095,438530,5633,5302,37,5339,34
2020-08-31,Sonoma,097,501317,6179,5650,20,5670,60
2020-08-31,Stanislaus,099,539301,15423,14685,361,15046,213
2020-08-31,Sutter,101,95872,1442,1365,1,1366,10
2020-08-31,Tehama,103,63373,446,421,2,423,1
2020-08-31,Trinity,105,12862,47,13,6,19,0
2020-08-31,Tulare,107,460477,14881,13985,57,14042,237
2020-08-31,Tuolumne,109,53932,211,178,4,182,1
2020-08-31,Ventura,111,848112,11592,10866,104,10970,108
2020-08-31,Yolo,113,214977,2567,2423,5,2428,51
2020-08-31,Yuba,115,75493,918,830,3,833,1
2020-08-30,Alameda,001,1643700,19151,18099,124,18223,248
2020-08-30,Alpine,003,1148,2,2,0,2,0
2020-08-30,Amador,005,37829,274,240,0,240,13
2020-08-30,Butte,007,227075,2349,1988,24,2012,26
2020-08-30,Calaveras,009,45235,261,211,0,211,1
2020-08-30,Colusa,011,21464,474,440,0,440,6
2020-08-30,Contra Costa,013,1133247,14753,13780,52,13832,150
2020-08-30,Del Norte,015,27424,115,108,0,108,2
2020-08-30,El Dorado,017,186661,1023,962,6,968,2
2020-08-30,Fresno,019,978130,28008,24963,302,25265,291
2020-08-30,Glenn,021,27897,472,437,0,437,3
2020-08-30,Humboldt,023,135768,414,362,1,363,4
2020-08-30,Imperial,025,180216,11294,9703,7,9710,250
2020-08-30,Inyo,027,18085,181,160,4,164,3
2020-08-30,Kern,029,883053,29991,28987,226,29213,317
2020-08-30,Kings,031,150075,6437,6000,31,6031,62
2020-08-30,Lake,033,64148,362,334,0,334,2
2020-08-30,Lassen,035,31185,722,706,2,708,0
2020-08-30,Los Angeles,037,10098052,244875,240775,1283,242058,5772
2020-08-30,Madera,039,155013,3963,3626,26,3652,33
2020-08-30,Marin,041,260295,6256,6060,15,6075,66
2020-08-30,Mariposa,043,17540,73,69,0,69,2
2020-08-30,Mendocino,045,87422,656,611,0,611,13
2020-08-30,Merced,047,269075,8150,7960,9,7969,79
2020-08-30,Modoc,049,8938,13,10,0,10,0
2020-08-30,Mono,051,14174,163,145,2,147,1
2020-08-30,Monterey,053,433212,8303,7816,22,7838,54
2020-08-30,Napa,055,140530,1495,1423,6,1429,10
2020-08-30,Nevada,057,99092,459,445,13,458,6
2020-08-30,Orange,059,3164182,50501,47283,1198,48481,965
2020-08-30,Placer,061,380077,3149,2961,11,2972,32
2020-08-30,Plumas,063,18699,42,39,0,39,0
2020-08-30,Riverside,065,2383286,53989,52227,66,52293,1017
2020-08-30,Sacramento,067,1510023,18762,17751,15,17766,300
2020-08-30,San Benito,069,59416,1156,1071,0,1071,4
2020-08-30,San Bernardino,071,2135413,49455,47201,314,47515,755
2020-08-30,San Diego,073,3302833,40244,38302,477,38779,682
2020-08-30,San Francisco,075,870044,9759,9294,10,9304,83
2020-08-30,San Joaquin,077,732212,18680,17637,36,17673,338
2020-08-30,San Luis Obispo,079,281455,3182,2934,13,2947,21
2020-08-30,San Mateo,081,765935,8715,8013,10,8023,122
2020-08-30,Santa Barbara,083,443738,8305,8088,70,8158,93
2020-08-30,Santa Clara,085,1922200,18823,17045,38,17083,202
2020-08-30,Santa Cruz,087,273765,1921,1743,16,1759,7
2020-08-30,Shasta,089,179085,634,525,3,528,9
2020-08-30,Sierra,091,2930,6,6,0,6,0
2020-08-30,Siskiyou,093,43540,138,125,8,133,0
2020-08-30,Solano,095,438530,5589,5303,37,5340,34
2020-08-30,Sonoma,097,501317,6119,5590,20,5610,60
2020-08-30,Stanislaus,099,539301,15351,14580,352,14932,209
2020-08-30,Sutter,101,95872,1421,1351,1,1352,10
2020-08-30,Tehama,103,63373,437,419,2,421,1
2020-08-30,Trinity,105,12862,47,13,6,19,0
2020-08-30,Tulare,107,460477,14786,13985,56,14041,236
2020-08-30,Tuolumne,109,53932,207,178,4,182,1
2020-08-30,Ventura,111,848112,11479,10775,99,10874,108
2020-08-30,Yolo,113,214977,2539,2391,4,2395,51
2020-08-30,Yuba,115,75493,904,832,3,835,1
2020-08-29,Alameda,001,1643700,19084,17888,124,18012,250
2020-08-29,Alpine,003,1148,2,2,0,2,0
2020-08-29,Amador,005,37829,274,239,0,239,13
2020-08-29,Butte,007,227075,2318,1948,24,1972,26
2020-08-29,Calaveras,009,45235,257,211,0,211,1
2020-08-29,Colusa,011,21464,471,440,0,440,6
2020-08-29,Contra Costa,013,1133247,14680,13663,51,13714,159
2020-08-29,Del Norte,015,27424,115,108,0,108,1
2020-08-29,El Dorado,017,186661,1020,958,6,964,2
2020-08-29,Fresno,019,978130,27953,24821,302,25123,291
2020-08-29,Glenn,021,27897,466,437,0,437,3
2020-08-29,Humboldt,023,135768,411,363,1,364,4
2020-08-29,Imperial,025,180216,11279,9698,7,9705,250
2020-08-29,Inyo,027,18085,181,160,4,164,3
2020-08-29,Kern,029,883053,29950,28947,225,29172,317
2020-08-29,Kings,031,150075,6422,5906,31,5937,62
2020-08-29,Lake,033,64148,361,329,0,329,2
2020-08-29,Lassen,035,31185,722,706,2,708,0
2020-08-29,Los Angeles,037,10098052,244247,239815,1270,241085,5762
2020-08-29,Madera,039,155013,3954,3605,25,3630,33
2020-08-29,Marin,041,260295,6244,6007,15,6022,64
2020-08-29,Mariposa,043,17540,73,69,0,69,2
2020-08-29,Mendocino,045,87422,652,596,0,596,13
2020-08-29,Merced,047,269075,8120,7867,9,7876,79
2020-08-29,Modoc,049,8938,13,9,0,9,0
2020-08-29,Mono,051,14174,163,145,2,147,1
2020-08-29,Monterey,053,433212,8258,7680,22,7702,53
2020-08-29,Napa,055,140530,1492,1413,6,1419,10
2020-08-29,Nevada,057,99092,459,442,13,455,5
2020-08-29,Orange,059,3164182,50390,47007,1188,48195,960
2020-08-29,Placer,061,380077,3132,2935,11,2946,32
2020-08-29,Plumas,063,18699,41,39,0,39,0
2020-08-29,Riverside,065,2383286,53877,51918,64,51982,1016
2020-08-29,Sacramento,067,1510023,18690,17588,15,17603,291
2020-08-29,San Benito,069,59416,1147,1045,0,1045,4
2020-08-29,San Bernardino,071,2135413,49340,46849,314,47163,755
2020-08-29,San Diego,073,3302833,39978,38049,459,38508,694
2020-08-29,San Francisco,075,870044,9731,9291,9,9300,83
2020-08-29,San Joaquin,077,732212,18636,17493,36,17529,335
2020-08-29,San Luis Obispo,079,281455,3157,2917,13,2930,21
2020-08-29,San Mateo,081,765935,8673,7928,10,7938,122
2020-08-29,Santa Barbara,083,443738,8279,8052,69,8121,93
2020-08-29,Santa Clara,085,1922200,18726,16898,37,16935,202
2020-08-29,Santa Cruz,087,273765,1909,1746,16,1762,7
2020-08-29,Shasta,089,179085,626,522,3,525,9
2020-08-29,Sierra,091,2930,6,6,0,6,0
2020-08-29,Siskiyou,093,43540,138,121,8,129,0
2020-08-29,Solano,095,438530,5568,5303,37,5340,34
2020-08-29,Sonoma,097,501317,6084,5537,20,5557,60
2020-08-29,Stanislaus,099,539301,15302,14479,342,14821,208
2020-08-29,Sutter,101,95872,1416,1333,1,1334,9
2020-08-29,Tehama,103,63373,436,417,2,419,1
2020-08-29,Trinity,105,12862,46,11,6,17,0
2020-08-29,Tulare,107,460477,14748,13890,55,13945,236
2020-08-29,Tuolumne,109,53932,207,178,4,182,1
2020-08-29,Ventura,111,848112,11437,10705,99,10804,108
2020-08-29,Yolo,113,214977,2521,2357,4,2361,51
2020-08-29,Yuba,115,75493,895,822,3,825,1
2020-08-28,Alameda,001,1643700,19001,17729,123,17852,237
2020-08-28,Alpine,003,1148,2,2,0,2,0
2020-08-28,Amador,005,37829,274,234,0,234,13
2020-08-28,Butte,007,227075,2288,1886,24,1910,25
2020-08-28,Calaveras,009,45235,255,207,0,207,1
2020-08-28,Colusa,011,21464,470,441,0,441,6
2020-08-28,Contra Costa,013,1133247,14609,13522,50,13572,158
2020-08-28,Del Norte,015,27424,115,107,0,107,1
2020-08-28,El Dorado,017,186661,1014,949,6,955,2
2020-08-28,Fresno,019,978130,27819,24612,302,24914,282
2020-08-28,Glenn,021,27897,459,429,0,429,3
2020-08-28,Humboldt,023,135768,407,362,1,363,4
2020-08-28,Imperial,025,180216,11265,9656,7,9663,241
2020-08-28,Inyo,027,18085,180,160,4,164,2
2020-08-28,Kern,029,883053,29902,28744,225,28969,306
2020-08-28,Kings,031,150075,6415,5829,30,5859,62
2020-08-28,Lake,033,64148,356,320,0,320,2
2020-08-28,Lassen,035,31185,722,704,2,706,0
2020-08-28,Los Angeles,037,10098052,243435,238544,1245,239789,5740
2020-08-28,Madera,039,155013,3935,3552,25,3577,33
2020-08-28,Marin,041,260295,6222,5991,15,6006,63
2020-08-28,Mariposa,043,17540,73,67,0,67,2
2020-08-28,Mendocino,045,87422,647,588,0,588,11
2020-08-28,Merced,047,269075,8090,7803,9,7812,77
2020-08-28,Modoc,049,8938,13,6,0,6,0
2020-08-28,Mono,051,14174,163,145,2,147,1
2020-08-28,Monterey,053,433212,8201,7591,22,7613,53
2020-08-28,Napa,055,140530,1484,1403,5,1408,10
2020-08-28,Nevada,057,99092,458,438,13,451,5
2020-08-28,Orange,059,3164182,50290,46696,1173,47869,942
2020-08-28,Placer,061,380077,3121,2891,11,2902,32
2020-08-28,Plumas,063,18699,41,39,0,39,0
2020-08-28,Riverside,065,2383286,53746,51510,60,51570,1008
2020-08-28,Sacramento,067,1510023,18593,17119,15,17134,283
2020-08-28,San Benito,069,59416,1131,1016,0,1016,3
2020-08-28,San Bernardino,071,2135413,49221,46553,310,46863,754
2020-08-28,San Diego,073,3302833,39748,37786,444,38230,676
2020-08-28,San Francisco,075,870044,9679,9135,9,9144,83
2020-08-28,San Joaquin,077,732212,18583,17114,35,17149,314
2020-08-28,San Luis Obispo,079,281455,3140,2849,13,2862,20
2020-08-28,San Mateo,081,765935,8627,7783,9,7792,121
2020-08-28,Santa Barbara,083,443738,8247,8001,69,8070,92
2020-08-28,Santa Clara,085,1922200,18595,16696,37,16733,201
2020-08-28,Santa Cruz,087,273765,1897,1747,16,1763,7
2020-08-28,Shasta,089,179085,622,516,3,519,9
2020-08-28,Sierra,091,2930,6,6,0,6,0
2020-08-28,Siskiyou,093,43540,136,119,8,127,0
2020-08-28,Solano,095,438530,5549,5219,37,5256,34
2020-08-28,Sonoma,097,501317,6049,5425,19,5444,58
2020-08-28,Stanislaus,099,539301,15260,14176,338,14514,190
2020-08-28,Sutter,101,95872,1406,1308,1,1309,9
2020-08-28,Tehama,103,63373,431,410,2,412,1
2020-08-28,Trinity,105,12862,46,11,6,17,0
2020-08-28,Tulare,107,460477,14703,13776,55,13831,236
2020-08-28,Tuolumne,109,53932,207,176,4,180,1
2020-08-28,Ventura,111,848112,11401,10606,97,10703,103
2020-08-28,Yolo,113,214977,2512,2323,4,2327,51
2020-08-28,Yuba,115,75493,886,810,3,813,1
2020-08-27,Alameda,001,1643700,18856,17584,120,17704,234
2020-08-27,Alpine,003,1148,2,2,0,2,0
2020-08-27,Amador,005,37829,273,233,0,233,13
2020-08-27,Butte,007,227075,2222,1803,23,1826,25
2020-08-27,Calaveras,009,45235,249,204,0,204,1
2020-08-27,Colusa,011,21464,468,438,0,438,6
2020-08-27,Contra Costa,013,1133247,14508,13379,49,13428,158
2020-08-27,Del Norte,015,27424,115,107,0,107,1
2020-08-27,El Dorado,017,186661,1010,942,6,948,2
2020-08-27,Fresno,019,978130,27637,24367,297,24664,272
2020-08-27,Glenn,021,27897,451,429,0,429,3
2020-08-27,Humboldt,023,135768,399,358,1,359,4
2020-08-27,Imperial,025,180216,11238,9608,7,9615,235
2020-08-27,Inyo,027,18085,180,157,3,160,2
2020-08-27,Kern,029,883053,29830,28635,216,28851,294
2020-08-27,Kings,031,150075,6393,5759,30,5789,62
2020-08-27,Lake,033,64148,354,314,0,314,2
2020-08-27,Lassen,035,31185,722,703,2,705,0
2020-08-27,Los Angeles,037,10098052,242433,237103,1230,238333,5704
2020-08-27,Madera,039,155013,3909,3465,25,3490,33
2020-08-27,Marin,041,260295,6198,5929,15,5944,62
2020-08-27,Mariposa,043,17540,73,67,0,67,2
2020-08-27,Mendocino,045,87422,638,581,0,581,10
2020-08-27,Merced,047,269075,8046,7765,9,7774,75
2020-08-27,Modoc,049,8938,11,5,0,5,0
2020-08-27,Mono,051,14174,163,145,2,147,1
2020-08-27,Monterey,053,433212,8107,7501,22,7523,52
2020-08-27,Napa,055,140530,1478,1397,5,1402,10
2020-08-27,Nevada,057,99092,455,435,13,448,5
2020-08-27,Orange,059,3164182,50133,46449,1162,47611,935
2020-08-27,Placer,061,380077,3090,2869,11,2880,32
2020-08-27,Plumas,063,18699,40,39,0,39,0
2020-08-27,Riverside,065,2383286,53537,51306,57,51363,999
2020-08-27,Sacramento,067,1510023,18395,16875,15,16890,281
2020-08-27,San Benito,069,59416,1115,987,0,987,3
2020-08-27,San Bernardino,071,2135413,48996,46345,304,46649,751
2020-08-27,San Diego,073,3302833,39477,37501,424,37925,673
2020-08-27,San Francisco,075,870044,9613,9014,9,9023,83
2020-08-27,San Joaquin,077,732212,18503,16989,35,17024,314
2020-08-27,San Luis Obispo,079,281455,3115,2808,13,2821,20
2020-08-27,San Mateo,081,765935,8518,7728,9,7737,121
2020-08-27,Santa Barbara,083,443738,8209,7934,69,8003,92
2020-08-27,Santa Clara,085,1922200,18412,16495,37,16532,199
2020-08-27,Santa Cruz,087,273765,1880,1734,16,1750,7
2020-08-27,Shasta,089,179085,616,512,3,515,9
2020-08-27,Sierra,091,2930,6,6,0,6,0
2020-08-27,Siskiyou,093,43540,136,118,8,126,0
2020-08-27,Solano,095,438530,5511,5167,37,5204,34
2020-08-27,Sonoma,097,501317,5938,5357,19,5376,58
2020-08-27,Stanislaus,099,539301,15179,14080,335,14415,186
2020-08-27,Sutter,101,95872,1386,1296,1,1297,9
2020-08-27,Tehama,103,63373,427,398,2,400,1
2020-08-27,Trinity,105,12862,46,11,6,17,0
2020-08-27,Tulare,107,460477,14612,13666,55,13721,231
2020-08-27,Tuolumne,109,53932,202,174,4,178,1
2020-08-27,Ventura,111,848112,11338,10483,93,10576,102
2020-08-27,Yolo,113,214977,2488,2293,4,2297,51
2020-08-27,Yuba,115,75493,875,807,3,810,1
2020-08-26,Alameda,001,1643700,18694,17373,120,17493,233
2020-08-26,Alpine,003,1148,2,2,0,2,0
2020-08-26,Amador,005,37829,273,229,0,229,13
2020-08-26,Butte,007,227075,2154,1765,21,1786,25
2020-08-26,Calaveras,009,45235,242,201,0,201,1
2020-08-26,Colusa,011,21464,462,433,0,433,5
2020-08-26,Contra Costa,013,1133247,14371,13248,49,13297,157
2020-08-26,Del Norte,015,27424,114,86,0,86,1
2020-08-26,El Dorado,017,186661,1008,938,6,944,2
2020-08-26,Fresno,019,978130,27489,24071,295,24366,255
2020-08-26,Glenn,021,27897,449,429,0,429,3
2020-08-26,Humboldt,023,135768,387,357,1,358,4
2020-08-26,Imperial,025,180216,11216,9453,7,9460,227
2020-08-26,Inyo,027,18085,177,157,3,160,2
2020-08-26,Kern,029,883053,29691,28507,213,28720,286
2020-08-26,Kings,031,150075,6372,5720,30,5750,62
2020-08-26,Lake,033,64148,349,308,0,308,2
2020-08-26,Lassen,035,31185,722,702,2,704,0
2020-08-26,Los Angeles,037,10098052,241421,235499,1200,236699,5665
2020-08-26,Madera,039,155013,3880,3458,25,3483,32
2020-08-26,Marin,041,260295,6181,5887,15,5902,56
2020-08-26,Mariposa,043,17540,73,68,0,68,2
2020-08-26,Mendocino,045,87422,627,581,0,581,10
2020-08-26,Merced,047,269075,8013,7720,9,7729,74
2020-08-26,Modoc,049,8938,8,5,0,5,0
2020-08-26,Mono,051,14174,163,141,2,143,1
2020-08-26,Monterey,053,433212,8014,7439,22,7461,51
2020-08-26,Napa,055,140530,1465,1382,5,1387,10
2020-08-26,Nevada,057,99092,452,432,13,445,2
2020-08-26,Orange,059,3164182,49949,46157,1146,47303,905
2020-08-26,Placer,061,380077,3068,2846,9,2855,32
2020-08-26,Plumas,063,18699,39,39,0,39,0
2020-08-26,Riverside,065,2383286,53296,51138,57,51195,987
2020-08-26,Sacramento,067,1510023,18232,16708,15,16723,271
2020-08-26,San Benito,069,59416,1100,978,0,978,3
2020-08-26,San Bernardino,071,2135413,48788,45840,300,46140,743
2020-08-26,San Diego,073,3302833,39139,37224,397,37621,668
2020-08-26,San Francisco,075,870044,9539,8938,9,8947,81
2020-08-26,San Joaquin,077,732212,18414,16845,34,16879,309
2020-08-26,San Luis Obispo,079,281455,3087,2761,13,2774,20
2020-08-26,San Mateo,081,765935,8451,7655,9,7664,121
2020-08-26,Santa Barbara,083,443738,8175,7904,69,7973,90
2020-08-26,Santa Clara,085,1922200,18236,16283,37,16320,198
2020-08-26,Santa Cruz,087,273765,1869,1726,16,1742,7
2020-08-26,Shasta,089,179085,611,511,3,514,9
2020-08-26,Sierra,091,2930,6,6,0,6,0
2020-08-26,Siskiyou,093,43540,133,109,8,117,0
2020-08-26,Solano,095,438530,5487,5131,36,5167,34
2020-08-26,Sonoma,097,501317,5865,5283,19,5302,58
2020-08-26,Stanislaus,099,539301,15102,13964,329,14293,186
2020-08-26,Sutter,101,95872,1368,1275,1,1276,9
2020-08-26,Tehama,103,63373,424,396,2,398,1
2020-08-26,Trinity,105,12862,45,10,6,16,0
2020-08-26,Tulare,107,460477,14545,13568,55,13623,232
2020-08-26,Tuolumne,109,53932,201,172,4,176,1
2020-08-26,Ventura,111,848112,11266,10412,86,10498,100
2020-08-26,Yolo,113,214977,2466,2279,4,2283,49
2020-08-26,Yuba,115,75493,860,779,3,782,1
2020-08-25,Alameda,001,1643700,18537,17278,120,17398,232
2020-08-25,Alpine,003,1148,2,2,0,2,0
2020-08-25,Amador,005,37829,273,227,0,227,13
2020-08-25,Butte,007,227075,2087,1718,21,1739,24
2020-08-25,Calaveras,009,45235,240,196,0,196,1
2020-08-25,Colusa,011,21464,455,430,0,430,5
2020-08-25,Contra Costa,013,1133247,14233,13181,48,13229,156
2020-08-25,Del Norte,015,27424,113,83,0,83,1
2020-08-25,El Dorado,017,186661,1005,928,6,934,2
2020-08-25,Fresno,019,978130,27301,23932,294,24226,250
2020-08-25,Glenn,021,27897,446,429,0,429,3
2020-08-25,Humboldt,023,135768,382,342,1,343,4
2020-08-25,Imperial,025,180216,11188,9381,7,9388,217
2020-08-25,Inyo,027,18085,175,144,3,147,1
2020-08-25,Kern,029,883053,29554,28416,213,28629,285
2020-08-25,Kings,031,150075,6215,5702,30,5732,59
2020-08-25,Lake,033,64148,344,304,0,304,2
2020-08-25,Lassen,035,31185,721,692,2,694,0
2020-08-25,Los Angeles,037,10098052,240122,233961,1151,235112,5612
2020-08-25,Madera,039,155013,3865,3446,24,3470,32
2020-08-25,Marin,041,260295,6143,5860,15,5875,56
2020-08-25,Mariposa,043,17540,73,67,0,67,2
2020-08-25,Mendocino,045,87422,619,571,0,571,10
2020-08-25,Merced,047,269075,7946,7693,8,7701,69
2020-08-25,Modoc,049,8938,8,5,0,5,0
2020-08-25,Mono,051,14174,163,129,2,131,1
2020-08-25,Monterey,053,433212,7934,7333,22,7355,51
2020-08-25,Napa,055,140530,1458,1374,5,1379,10
2020-08-25,Nevada,057,99092,448,430,13,443,2
2020-08-25,Orange,059,3164182,49755,45737,1130,46867,902
2020-08-25,Placer,061,380077,3049,2829,6,2835,31
2020-08-25,Plumas,063,18699,39,39,0,39,0
2020-08-25,Riverside,065,2383286,53064,50889,57,50946,981
2020-08-25,Sacramento,067,1510023,18079,16601,15,16616,265
2020-08-25,San Benito,069,59416,1084,973,0,973,3
2020-08-25,San Bernardino,071,2135413,48553,45544,297,45841,727
2020-08-25,San Diego,073,3302833,38860,36996,375,37371,665
2020-08-25,San Francisco,075,870044,9462,8848,9,8857,81
2020-08-25,San Joaquin,077,732212,18287,16795,34,16829,306
2020-08-25,San Luis Obispo,079,281455,3028,2731,12,2743,20
2020-08-25,San Mateo,081,765935,8391,7636,8,7644,120
2020-08-25,Santa Barbara,083,443738,8123,7854,69,7923,90
2020-08-25,Santa Clara,085,1922200,18064,16199,37,16236,194
2020-08-25,Santa Cruz,087,273765,1850,1708,16,1724,7
2020-08-25,Shasta,089,179085,607,511,3,514,9
2020-08-25,Sierra,091,2930,6,6,0,6,0
2020-08-25,Siskiyou,093,43540,132,109,8,117,0
2020-08-25,Solano,095,438530,5426,5114,36,5150,34
2020-08-25,Sonoma,097,501317,5779,5148,19,5167,56
2020-08-25,Stanislaus,099,539301,14994,13886,318,14204,182
2020-08-25,Sutter,101,95872,1351,1259,1,1260,9
2020-08-25,Tehama,103,63373,421,394,2,396,1
2020-08-25,Trinity,105,12862,44,10,6,16,0
2020-08-25,Tulare,107,460477,14441,13514,54,13568,224
2020-08-25,Tuolumne,109,53932,199,172,4,176,1
2020-08-25,Ventura,111,848112,11181,10313,81,10394,99
2020-08-25,Yolo,113,214977,2453,2254,4,2258,50
2020-08-25,Yuba,115,75493,850,775,3,778,1
2020-08-24,Alameda,001,1643700,18342,16913,119,17032,231
2020-08-24,Alpine,003,1148,2,2,0,2,0
2020-08-24,Amador,005,37829,271,227,0,227,13
2020-08-24,Butte,007,227075,2003,1649,21,1670,23
2020-08-24,Calaveras,009,45235,231,187,0,187,1
2020-08-24,Colusa,011,21464,451,425,0,425,5
2020-08-24,Contra Costa,013,1133247,14117,12906,46,12952,153
2020-08-24,Del Norte,015,27424,113,80,0,80,1
2020-08-24,El Dorado,017,186661,997,908,6,914,2
2020-08-24,Fresno,019,978130,27113,23618,287,23905,235
2020-08-24,Glenn,021,27897,444,421,0,421,2
2020-08-24,Humboldt,023,135768,378,340,1,341,4
2020-08-24,Imperial,025,180216,11155,9323,7,9330,210
2020-08-24,Inyo,027,18085,171,144,3,147,2
2020-08-24,Kern,029,883053,29456,28157,207,28364,277
2020-08-24,Kings,031,150075,6127,5652,30,5682,60
2020-08-24,Lake,033,64148,329,302,0,302,2
2020-08-24,Lassen,035,31185,721,693,2,695,0
2020-08-24,Los Angeles,037,10098052,238760,233036,1133,234169,5562
2020-08-24,Madera,039,155013,3838,3418,24,3442,32
2020-08-24,Marin,041,260295,6080,5834,15,5849,56
2020-08-24,Mariposa,043,17540,71,66,0,66,2
2020-08-24,Mendocino,045,87422,604,550,0,550,10
2020-08-24,Merced,047,269075,7868,7605,8,7613,69
2020-08-24,Modoc,049,8938,8,5,0,5,0
2020-08-24,Mono,051,14174,163,129,2,131,1
2020-08-24,Monterey,053,433212,7825,7212,21,7233,50
2020-08-24,Napa,055,140530,1445,1358,5,1363,10
2020-08-24,Nevada,057,99092,443,423,13,436,2
2020-08-24,Orange,059,3164182,49562,45536,1121,46657,887
2020-08-24,Placer,061,380077,3003,2793,6,2799,31
2020-08-24,Plumas,063,18699,39,37,0,37,0
2020-08-24,Riverside,065,2383286,52786,50496,57,50553,975
2020-08-24,Sacramento,067,1510023,17882,16318,15,16333,249
2020-08-24,San Benito,069,59416,1063,961,0,961,3
2020-08-24,San Bernardino,071,2135413,48290,45199,295,45494,720
2020-08-24,San Diego,073,3302833,38572,36729,347,37076,660
2020-08-24,San Francisco,075,870044,9379,8621,9,8630,81
2020-08-24,San Joaquin,077,732212,18146,16565,33,16598,305
2020-08-24,San Luis Obispo,079,281455,3000,2705,12,2717,20
2020-08-24,San Mateo,081,765935,8324,7502,8,7510,120
2020-08-24,Santa Barbara,083,443738,8082,7784,69,7853,90
2020-08-24,Santa Clara,085,1922200,17860,16049,37,16086,192
2020-08-24,Santa Cruz,087,273765,1830,1627,15,1642,6
2020-08-24,Shasta,089,179085,605,505,3,508,9
2020-08-24,Sierra,091,2930,6,6,0,6,0
2020-08-24,Siskiyou,093,43540,128,107,8,115,0
2020-08-24,Solano,095,438530,5377,4979,34,5013,32
2020-08-24,Sonoma,097,501317,5677,5071,19,5090,56
2020-08-24,Stanislaus,099,539301,14896,13521,304,13825,171
2020-08-24,Sutter,101,95872,1332,1219,1,1220,9
2020-08-24,Tehama,103,63373,416,388,2,390,1
2020-08-24,Trinity,105,12862,44,10,6,16,0
2020-08-24,Tulare,107,460477,14333,13360,53,13413,223
2020-08-24,Tuolumne,109,53932,198,170,4,174,1
2020-08-24,Ventura,111,848112,11101,10261,77,10338,99
2020-08-24,Yolo,113,214977,2419,2239,4,2243,47
2020-08-24,Yuba,115,75493,833,750,3,753,1
2020-08-23,Alameda,001,1643700,18120,16786,118,16904,231
2020-08-23,Alpine,003,1148,2,2,0,2,0
2020-08-23,Amador,005,37829,268,227,0,227,13
2020-08-23,Butte,007,227075,1888,1637,21,1658,23
2020-08-23,Calaveras,009,45235,222,187,0,187,1
2020-08-23,Colusa,011,21464,444,424,0,424,5
2020-08-23,Contra Costa,013,1133247,13956,12642,46,12688,153
2020-08-23,Del Norte,015,27424,113,80,0,80,1
2020-08-23,El Dorado,017,186661,984,901,6,907,2
2020-08-23,Fresno,019,978130,26908,23414,284,23698,235
2020-08-23,Glenn,021,27897,437,421,0,421,2
2020-08-23,Humboldt,023,135768,376,341,1,342,4
2020-08-23,Imperial,025,180216,11126,9243,7,9250,210
2020-08-23,Inyo,027,18085,168,144,3,147,2
2020-08-23,Kern,029,883053,29307,28028,202,28230,277
2020-08-23,Kings,031,150075,6084,5628,30,5658,60
2020-08-23,Lake,033,64148,325,299,0,299,2
2020-08-23,Lassen,035,31185,720,693,2,695,0
2020-08-23,Los Angeles,037,10098052,237162,231833,1065,232898,5549
2020-08-23,Madera,039,155013,3807,3401,23,3424,32
2020-08-23,Marin,041,260295,6041,5807,14,5821,50
2020-08-23,Mariposa,043,17540,71,66,0,66,2
2020-08-23,Mendocino,045,87422,600,550,0,550,10
2020-08-23,Merced,047,269075,7799,7574,7,7581,69
2020-08-23,Modoc,049,8938,7,5,0,5,0
2020-08-23,Mono,051,14174,163,129,2,131,1
2020-08-23,Monterey,053,433212,7735,7173,21,7194,50
2020-08-23,Napa,055,140530,1433,1348,5,1353,10
2020-08-23,Nevada,057,99092,438,421,13,434,2
2020-08-23,Orange,059,3164182,49324,45267,1109,46376,887
2020-08-23,Placer,061,380077,2964,2772,6,2778,31
2020-08-23,Plumas,063,18699,39,37,0,37,0
2020-08-23,Riverside,065,2383286,52516,50293,55,50348,955
2020-08-23,Sacramento,067,1510023,17658,16084,14,16098,243
2020-08-23,San Benito,069,59416,1050,938,0,938,3
2020-08-23,San Bernardino,071,2135413,48022,45010,285,45295,719
2020-08-23,San Diego,073,3302833,38251,36542,320,36862,660
2020-08-23,San Francisco,075,870044,9284,8564,8,8572,80
2020-08-23,San Joaquin,077,732212,18013,16069,32,16101,305
2020-08-23,San Luis Obispo,079,281455,2958,2679,12,2691,20
2020-08-23,San Mateo,081,765935,8229,7450,8,7458,120
2020-08-23,Santa Barbara,083,443738,8014,7725,69,7794,90
2020-08-23,Santa Clara,085,1922200,17665,15912,35,15947,191
2020-08-23,Santa Cruz,087,273765,1804,1627,15,1642,6
2020-08-23,Shasta,089,179085,600,501,3,504,9
2020-08-23,Sierra,091,2930,6,6,0,6,0
2020-08-23,Siskiyou,093,43540,123,107,8,115,0
2020-08-23,Solano,095,438530,5319,4977,32,5009,32
2020-08-23,Sonoma,097,501317,5589,5018,19,5037,56
2020-08-23,Stanislaus,099,539301,14761,13483,281,13764,171
2020-08-23,Sutter,101,95872,1310,1203,1,1204,9
2020-08-23,Tehama,103,63373,406,381,2,383,1
2020-08-23,Trinity,105,12862,44,10,6,16,0
2020-08-23,Tulare,107,460477,14201,13303,50,13353,223
2020-08-23,Tuolumne,109,53932,195,164,4,168,1
2020-08-23,Ventura,111,848112,11000,10126,73,10199,99
2020-08-23,Yolo,113,214977,2391,2210,4,2214,47
2020-08-23,Yuba,115,75493,812,750,3,753,1
2020-08-22,Alameda,001,1643700,18026,16648,117,16765,231
2020-08-22,Alpine,003,1148,2,2,0,2,0
2020-08-22,Amador,005,37829,267,224,0,224,13
2020-08-22,Butte,007,227075,1837,1618,21,1639,22
2020-08-22,Calaveras,009,45235,218,187,0,187,1
2020-08-22,Colusa,011,21464,440,419,0,419,5
2020-08-22,Contra Costa,013,1133247,13869,12522,46,12568,153
2020-08-22,Del Norte,015,27424,112,80,0,80,1
2020-08-22,El Dorado,017,186661,982,900,6,906,2
2020-08-22,Fresno,019,978130,26811,23197,283,23480,235
2020-08-22,Glenn,021,27897,436,421,0,421,2
2020-08-22,Humboldt,023,135768,366,334,1,335,4
2020-08-22,Imperial,025,180216,11118,9244,7,9251,210
2020-08-22,Inyo,027,18085,168,144,3,147,1
2020-08-22,Kern,029,883053,29253,27807,202,28009,277
2020-08-22,Kings,031,150075,6075,5447,30,5477,60
2020-08-22,Lake,033,64148,323,291,0,291,2
2020-08-22,Lassen,035,31185,720,693,2,695,0
2020-08-22,Los Angeles,037,10098052,236503,230858,1048,231906,5540
2020-08-22,Madera,039,155013,3788,3330,23,3353,32
2020-08-22,Marin,041,260295,6029,5789,14,5803,49
2020-08-22,Mariposa,043,17540,71,66,0,66,2
2020-08-22,Mendocino,045,87422,597,529,0,529,10
2020-08-22,Merced,047,269075,7771,7493,7,7500,69
2020-08-22,Modoc,049,8938,7,5,0,5,0
2020-08-22,Mono,051,14174,163,129,2,131,1
2020-08-22,Monterey,053,433212,7687,7081,21,7102,50
2020-08-22,Napa,055,140530,1428,1328,5,1333,11
2020-08-22,Nevada,057,99092,438,411,13,424,2
2020-08-22,Orange,059,3164182,49183,45131,1103,46234,885
2020-08-22,Placer,061,380077,2950,2734,6,2740,30
2020-08-22,Plumas,063,18699,39,37,0,37,0
2020-08-22,Riverside,065,2383286,52368,49944,54,49998,953
2020-08-22,Sacramento,067,1510023,17546,15516,14,15530,239
2020-08-22,San Benito,069,59416,1034,912,0,912,3
2020-08-22,San Bernardino,071,2135413,47893,44803,281,45084,719
2020-08-22,San Diego,073,3302833,38068,36205,309,36514,673
2020-08-22,San Francisco,075,870044,9224,8568,8,8576,80
2020-08-22,San Joaquin,077,732212,17957,16068,32,16100,305
2020-08-22,San Luis Obispo,079,281455,2932,2660,12,2672,20
2020-08-22,San Mateo,081,765935,8182,7361,8,7369,120
2020-08-22,Santa Barbara,083,443738,7988,7685,69,7754,90
2020-08-22,Santa Clara,085,1922200,17557,15590,35,15625,190
2020-08-22,Santa Cruz,087,273765,1788,1628,14,1642,6
2020-08-22,Shasta,089,179085,598,493,3,496,9
2020-08-22,Sierra,091,2930,6,6,0,6,0
2020-08-22,Siskiyou,093,43540,123,106,8,114,0
2020-08-22,Solano,095,438530,5289,4944,31,4975,32
2020-08-22,Sonoma,097,501317,5543,4891,19,4910,57
2020-08-22,Stanislaus,099,539301,14711,13380,264,13644,170
2020-08-22,Sutter,101,95872,1303,1189,1,1190,8
2020-08-22,Tehama,103,63373,405,368,2,370,1
2020-08-22,Trinity,105,12862,44,8,6,14,0
2020-08-22,Tulare,107,460477,14134,13196,50,13246,222
2020-08-22,Tuolumne,109,53932,193,162,4,166,1
2020-08-22,Ventura,111,848112,10945,9959,71,10030,99
2020-08-22,Yolo,113,214977,2375,2188,4,2192,47
2020-08-22,Yuba,115,75493,800,738,3,741,1
2020-08-21,Alameda,001,1643700,17934,16413,117,16530,232
2020-08-21,Alpine,003,1148,2,2,0,2,0
2020-08-21,Amador,005,37829,266,223,0,223,11
2020-08-21,Butte,007,227075,1798,1582,21,1603,19
2020-08-21,Calaveras,009,45235,218,182,0,182,1
2020-08-21,Colusa,011,21464,438,418,0,418,5
2020-08-21,Contra Costa,013,1133247,13779,12333,45,12378,149
2020-08-21,Del Norte,015,27424,112,78,0,78,1
2020-08-21,El Dorado,017,186661,978,885,6,891,2
2020-08-21,Fresno,019,978130,26641,22840,282,23122,232
2020-08-21,Glenn,021,27897,432,418,0,418,2
2020-08-21,Humboldt,023,135768,363,331,1,332,4
2020-08-21,Imperial,025,180216,11102,9166,7,9173,204
2020-08-21,Inyo,027,18085,168,144,3,147,1
2020-08-21,Kern,029,883053,29194,27567,200,27767,269
2020-08-21,Kings,031,150075,6053,5391,30,5421,60
2020-08-21,Lake,033,64148,321,281,0,281,2
2020-08-21,Lassen,035,31185,720,693,2,695,0
2020-08-21,Los Angeles,037,10098052,235629,229235,1027,230262,5494
2020-08-21,Madera,039,155013,3758,3271,23,3294,31
2020-08-21,Marin,041,260295,6009,5762,14,5776,49
2020-08-21,Mariposa,043,17540,71,66,0,66,2
2020-08-21,Mendocino,045,87422,587,505,0,505,10
2020-08-21,Merced,047,269075,7742,7357,7,7364,69
2020-08-21,Modoc,049,8938,7,5,0,5,0
2020-08-21,Mono,051,14174,163,128,2,130,1
2020-08-21,Monterey,053,433212,7615,6974,21,6995,49
2020-08-21,Napa,055,140530,1419,1317,5,1322,10
2020-08-21,Nevada,057,99092,437,406,13,419,2
2020-08-21,Orange,059,3164182,49042,44625,1094,45719,875
2020-08-21,Placer,061,380077,2934,2698,6,2704,30
2020-08-21,Plumas,063,18699,39,36,0,36,0
2020-08-21,Riverside,065,2383286,52173,49409,54,49463,932
2020-08-21,Sacramento,067,1510023,17423,15247,14,15261,237
2020-08-21,San Benito,069,59416,1024,891,0,891,3
2020-08-21,San Bernardino,071,2135413,47773,44249,277,44526,668
2020-08-21,San Diego,073,3302833,37864,35914,292,36206,652
2020-08-21,San Francisco,075,870044,9174,8375,8,8383,80
2020-08-21,San Joaquin,077,732212,17874,15888,30,15918,301
2020-08-21,San Luis Obispo,079,281455,2909,2640,12,2652,19
2020-08-21,San Mateo,081,765935,8125,7253,8,7261,120
2020-08-21,Santa Barbara,083,443738,7947,7645,69,7714,86
2020-08-21,Santa Clara,085,1922200,17405,15399,35,15434,190
2020-08-21,Santa Cruz,087,273765,1776,1617,14,1631,6
2020-08-21,Shasta,089,179085,598,486,3,489,9
2020-08-21,Sierra,091,2930,6,6,0,6,0
2020-08-21,Siskiyou,093,43540,123,103,6,109,0
2020-08-21,Solano,095,438530,5266,4891,30,4921,32
2020-08-21,Sonoma,097,501317,5473,4816,19,4835,57
2020-08-21,Stanislaus,099,539301,14642,13282,250,13532,161
2020-08-21,Sutter,101,95872,1290,1173,1,1174,8
2020-08-21,Tehama,103,63373,403,357,2,359,1
2020-08-21,Trinity,105,12862,44,8,6,14,0
2020-08-21,Tulare,107,460477,14063,13002,49,13051,217
2020-08-21,Tuolumne,109,53932,185,161,4,165,1
2020-08-21,Ventura,111,848112,10880,9865,69,9934,98
2020-08-21,Yolo,113,214977,2360,2164,4,2168,46
2020-08-21,Yuba,115,75493,796,717,3,720,1
2020-08-20,Alameda,001,1643700,17774,16174,117,16291,229
2020-08-20,Alpine,003,1148,2,2,0,2,0
2020-08-20,Amador,005,37829,264,222,0,222,11
2020-08-20,Butte,007,227075,1748,1549,21,1570,18
2020-08-20,Calaveras,009,45235,215,179,0,179,1
2020-08-20,Colusa,011,21464,436,415,0,415,5
2020-08-20,Contra Costa,013,1133247,13651,12108,44,12152,144
2020-08-20,Del Norte,015,27424,112,78,0,78,1
2020-08-20,El Dorado,017,186661,974,881,6,887,2
2020-08-20,Fresno,019,978130,26459,22535,277,22812,228
2020-08-20,Glenn,021,27897,427,414,0,414,2
2020-08-20,Humboldt,023,135768,358,318,1,319,4
2020-08-20,Imperial,025,180216,11083,9086,7,9093,196
2020-08-20,Inyo,027,18085,167,144,3,147,1
2020-08-20,Kern,029,883053,29026,27337,189,27526,267
2020-08-20,Kings,031,150075,6013,5347,29,5376,59
2020-08-20,Lake,033,64148,316,280,0,280,2
2020-08-20,Lassen,035,31185,719,693,2,695,0
2020-08-20,Los Angeles,037,10098052,234395,227492,1008,228500,5445
2020-08-20,Madera,039,155013,3732,3197,23,3220,31
2020-08-20,Marin,041,260295,5991,5745,14,5759,47
2020-08-20,Mariposa,043,17540,71,67,0,67,2
2020-08-20,Mendocino,045,87422,577,497,0,497,10
2020-08-20,Merced,047,269075,7667,7173,7,7180,68
2020-08-20,Modoc,049,8938,7,5,0,5,0
2020-08-20,Mono,051,14174,163,128,2,130,1
2020-08-20,Monterey,053,433212,7544,6892,21,6913,47
2020-08-20,Napa,055,140530,1411,1306,5,1311,10
2020-08-20,Nevada,057,99092,436,401,13,414,2
2020-08-20,Orange,059,3164182,48815,44299,1084,45383,849
2020-08-20,Placer,061,380077,2918,2681,6,2687,30
2020-08-20,Plumas,063,18699,39,36,0,36,0
2020-08-20,Riverside,065,2383286,51954,48953,53,49006,927
2020-08-20,Sacramento,067,1510023,17181,14992,14,15006,231
2020-08-20,San Benito,069,59416,1011,866,0,866,3
2020-08-20,San Bernardino,071,2135413,47517,43627,273,43900,665
2020-08-20,San Diego,073,3302833,37644,35610,274,35884,644
2020-08-20,San Francisco,075,870044,9088,8262,8,8270,72
2020-08-20,San Joaquin,077,732212,17781,15778,30,15808,297
2020-08-20,San Luis Obispo,079,281455,2889,2590,12,2602,19
2020-08-20,San Mateo,081,765935,8060,7188,8,7196,120
2020-08-20,Santa Barbara,083,443738,7909,7571,69,7640,81
2020-08-20,Santa Clara,085,1922200,17232,15162,35,15197,190
2020-08-20,Santa Cruz,087,273765,1763,1581,14,1595,6
2020-08-20,Shasta,089,179085,597,478,3,481,9
2020-08-20,Sierra,091,2930,6,6,0,6,0
2020-08-20,Siskiyou,093,43540,122,102,1,103,0
2020-08-20,Solano,095,438530,5222,4843,30,4873,31
2020-08-20,Sonoma,097,501317,5401,4737,19,4756,54
2020-08-20,Stanislaus,099,539301,14546,13120,241,13361,161
2020-08-20,Sutter,101,95872,1266,1158,1,1159,8
2020-08-20,Tehama,103,63373,398,350,2,352,1
2020-08-20,Trinity,105,12862,44,8,6,14,0
2020-08-20,Tulare,107,460477,13955,12907,48,12955,217
2020-08-20,Tuolumne,109,53932,181,159,4,163,1
2020-08-20,Ventura,111,848112,10767,9744,68,9812,93
2020-08-20,Yolo,113,214977,2338,2150,4,2154,47
2020-08-20,Yuba,115,75493,779,709,3,712,1
2020-08-19,Alameda,001,1643700,17616,15874,116,15990,226
2020-08-19,Alpine,003,1148,2,2,0,2,0
2020-08-19,Amador,005,37829,263,219,0,219,9
2020-08-19,Butte,007,227075,1705,1517,21,1538,16
2020-08-19,Calaveras,009,45235,213,177,0,177,1
2020-08-19,Colusa,011,21464,435,415,0,415,5
2020-08-19,Contra Costa,013,1133247,13539,11895,43,11938,142
2020-08-19,Del Norte,015,27424,112,78,0,78,1
2020-08-19,El Dorado,017,186661,968,870,6,876,2
2020-08-19,Fresno,019,978130,26270,22167,268,22435,221
2020-08-19,Glenn,021,27897,425,414,0,414,2
2020-08-19,Humboldt,023,135768,355,316,1,317,4
2020-08-19,Imperial,025,180216,11055,9041,7,9048,192
2020-08-19,Inyo,027,18085,165,140,3,143,1
2020-08-19,Kern,029,883053,28909,27142,185,27327,263
2020-08-19,Kings,031,150075,5840,5301,27,5328,59
2020-08-19,Lake,033,64148,313,277,0,277,2
2020-08-19,Lassen,035,31185,711,693,2,695,0
2020-08-19,Los Angeles,037,10098052,233117,226006,968,226974,5399
2020-08-19,Madera,039,155013,3698,3158,21,3179,30
2020-08-19,Marin,041,260295,5967,5723,13,5736,46
2020-08-19,Mariposa,043,17540,71,64,0,64,2
2020-08-19,Mendocino,045,87422,560,495,0,495,8
2020-08-19,Merced,047,269075,7540,7082,4,7086,66
2020-08-19,Modoc,049,8938,7,5,0,5,0
2020-08-19,Mono,051,14174,163,128,2,130,1
2020-08-19,Monterey,053,433212,7444,6693,21,6714,45
2020-08-19,Napa,055,140530,1406,1293,5,1298,10
2020-08-19,Nevada,057,99092,429,398,13,411,2
2020-08-19,Orange,059,3164182,48610,43938,1081,45019,829
2020-08-19,Placer,061,380077,2896,2659,6,2665,28
2020-08-19,Plumas,063,18699,39,36,0,36,0
2020-08-19,Riverside,065,2383286,51705,48741,53,48794,922
2020-08-19,Sacramento,067,1510023,17001,14764,14,14778,229
2020-08-19,San Benito,069,59416,994,853,0,853,3
2020-08-19,San Bernardino,071,2135413,47219,43224,267,43491,661
2020-08-19,San Diego,073,3302833,37394,35378,259,35637,638
2020-08-19,San Francisco,075,870044,9024,8236,8,8244,72
2020-08-19,San Joaquin,077,732212,17655,15677,29,15706,296
2020-08-19,San Luis Obispo,079,281455,2849,2553,12,2565,19
2020-08-19,San Mateo,081,765935,7991,7146,8,7154,119
2020-08-19,Santa Barbara,083,443738,7860,7499,69,7568,80
2020-08-19,Santa Clara,085,1922200,17086,14994,35,15029,189
2020-08-19,Santa Cruz,087,273765,1737,1554,14,1568,6
2020-08-19,Shasta,089,179085,593,475,3,478,9
2020-08-19,Sierra,091,2930,6,6,0,6,0
2020-08-19,Siskiyou,093,43540,121,103,1,104,0
2020-08-19,Solano,095,438530,5181,4807,30,4837,31
2020-08-19,Sonoma,097,501317,5322,4614,19,4633,54
2020-08-19,Stanislaus,099,539301,14443,13084,219,13303,160
2020-08-19,Sutter,101,95872,1232,1146,1,1147,8
2020-08-19,Tehama,103,63373,392,342,2,344,1
2020-08-19,Trinity,105,12862,43,8,6,14,0
2020-08-19,Tulare,107,460477,13857,12756,48,12804,217
2020-08-19,Tuolumne,109,53932,178,159,4,163,1
2020-08-19,Ventura,111,848112,10675,9587,66,9653,91
2020-08-19,Yolo,113,214977,2316,2126,4,2130,47
2020-08-19,Yuba,115,75493,767,701,3,704,1
2020-08-18,Alameda,001,1643700,17438,15627,114,15741,223
2020-08-18,Alpine,003,1148,2,2,0,2,0
2020-08-18,Amador,005,37829,262,215,0,215,9
2020-08-18,Butte,007,227075,1672,1491,21,1512,16
2020-08-18,Calaveras,009,45235,210,174,0,174,1
2020-08-18,Colusa,011,21464,434,415,0,415,5
2020-08-18,Contra Costa,013,1133247,13419,11689,41,11730,141
2020-08-18,Del Norte,015,27424,111,78,0,78,0
2020-08-18,El Dorado,017,186661,963,866,6,872,2
2020-08-18,Fresno,019,978130,26049,21798,262,22060,212
2020-08-18,Glenn,021,27897,425,407,0,407,2
2020-08-18,Humboldt,023,135768,353,315,1,316,4
2020-08-18,Imperial,025,180216,11021,8968,7,8975,189
2020-08-18,Inyo,027,18085,164,140,3,143,1
2020-08-18,Kern,029,883053,28756,26978,181,27159,263
2020-08-18,Kings,031,150075,5805,5269,26,5295,58
2020-08-18,Lake,033,64148,310,274,0,274,2
2020-08-18,Lassen,035,31185,711,693,2,695,0
2020-08-18,Los Angeles,037,10098052,231851,224218,931,225149,5339
2020-08-18,Madera,039,155013,3670,3125,21,3146,28
2020-08-18,Marin,041,260295,5937,5708,13,5721,47
2020-08-18,Mariposa,043,17540,71,61,0,61,2
2020-08-18,Mendocino,045,87422,551,468,0,468,8
2020-08-18,Merced,047,269075,7492,6940,4,6944,66
2020-08-18,Modoc,049,8938,7,5,0,5,0
2020-08-18,Mono,051,14174,162,129,2,131,1
2020-08-18,Monterey,053,433212,7352,6691,20,6711,44
2020-08-18,Napa,055,140530,1403,1274,5,1279,10
2020-08-18,Nevada,057,99092,422,389,13,402,2
2020-08-18,Orange,059,3164182,48385,43659,1067,44726,809
2020-08-18,Placer,061,380077,2870,2644,5,2649,28
2020-08-18,Plumas,063,18699,39,34,0,34,0
2020-08-18,Riverside,065,2383286,51373,48447,53,48500,917
2020-08-18,Sacramento,067,1510023,16771,14610,13,14623,222
2020-08-18,San Benito,069,59416,974,836,0,836,3
2020-08-18,San Bernardino,071,2135413,46938,42827,261,43088,648
2020-08-18,San Diego,073,3302833,37101,35164,227,35391,633
2020-08-18,San Francisco,075,870044,8939,8016,8,8024,72
2020-08-18,San Joaquin,077,732212,17539,15509,28,15537,290
2020-08-18,San Luis Obispo,079,281455,2824,2535,11,2546,18
2020-08-18,San Mateo,081,765935,7930,7074,8,7082,119
2020-08-18,Santa Barbara,083,443738,7818,7472,69,7541,81
2020-08-18,Santa Clara,085,1922200,16915,14786,34,14820,184
2020-08-18,Santa Cruz,087,273765,1724,1509,14,1523,6
2020-08-18,Shasta,089,179085,589,468,3,471,9
2020-08-18,Sierra,091,2930,6,6,0,6,0
2020-08-18,Siskiyou,093,43540,120,103,1,104,0
2020-08-18,Solano,095,438530,5154,4700,30,4730,31
2020-08-18,Sonoma,097,501317,5253,4506,19,4525,48
2020-08-18,Stanislaus,099,539301,14345,12935,203,13138,149
2020-08-18,Sutter,101,95872,1213,1126,1,1127,8
2020-08-18,Tehama,103,63373,382,333,2,335,1
2020-08-18,Trinity,105,12862,41,8,6,14,0
2020-08-18,Tulare,107,460477,13726,12637,45,12682,212
2020-08-18,Tuolumne,109,53932,175,159,4,163,1
2020-08-18,Ventura,111,848112,10585,9536,61,9597,89
2020-08-18,Yolo,113,214977,2294,2102,4,2106,47
2020-08-18,Yuba,115,75493,759,679,3,682,1
2020-08-17,Alameda,001,1643700,17245,15454,113,15567,221
2020-08-17,Alpine,003,1148,2,2,0,2,0
2020-08-17,Amador,005,37829,262,215,0,215,9
2020-08-17,Butte,007,227075,1627,1463,21,1484,15
2020-08-17,Calaveras,009,45235,206,167,0,167,1
2020-08-17,Colusa,011,21464,431,408,0,408,5
2020-08-17,Contra Costa,013,1133247,13282,11442,41,11483,141
2020-08-17,Del Norte,015,27424,107,77,0,77,0
2020-08-17,El Dorado,017,186661,960,846,6,852,2
2020-08-17,Fresno,019,978130,25842,21316,255,21571,211
2020-08-17,Glenn,021,27897,424,402,0,402,2
2020-08-17,Humboldt,023,135768,349,302,1,303,4
2020-08-17,Imperial,025,180216,10980,8897,7,8904,188
2020-08-17,Inyo,027,18085,156,124,3,127,1
2020-08-17,Kern,029,883053,28609,26773,171,26944,249
2020-08-17,Kings,031,150075,5767,5249,26,5275,58
2020-08-17,Lake,033,64148,305,270,0,270,2
2020-08-17,Lassen,035,31185,711,666,2,668,0
2020-08-17,Los Angeles,037,10098052,230331,223418,887,224305,5282
2020-08-17,Madera,039,155013,3627,3050,20,3070,26
2020-08-17,Marin,041,260295,5914,5683,12,5695,46
2020-08-17,Mariposa,043,17540,71,61,0,61,2
2020-08-17,Mendocino,045,87422,533,454,0,454,8
2020-08-17,Merced,047,269075,7397,6814,4,6818,66
2020-08-17,Modoc,049,8938,7,5,0,5,0
2020-08-17,Mono,051,14174,162,126,2,128,1
2020-08-17,Monterey,053,433212,7252,6553,20,6573,44
2020-08-17,Napa,055,140530,1382,1255,5,1260,10
2020-08-17,Nevada,057,99092,417,383,13,396,2
2020-08-17,Orange,059,3164182,48175,43621,1054,44675,804
2020-08-17,Placer,061,380077,2845,2609,5,2614,28
2020-08-17,Plumas,063,18699,39,33,0,33,0
2020-08-17,Riverside,065,2383286,51040,48062,51,48113,916
2020-08-17,Sacramento,067,1510023,16551,14333,13,14346,219
2020-08-17,San Benito,069,59416,959,822,0,822,2
2020-08-17,San Bernardino,071,2135413,46594,42005,253,42258,604
2020-08-17,San Diego,073,3302833,36836,34962,213,35175,626
2020-08-17,San Francisco,075,870044,8868,7600,8,7608,72
2020-08-17,San Joaquin,077,732212,17378,15323,27,15350,280
2020-08-17,San Luis Obispo,079,281455,2791,2527,11,2538,18
2020-08-17,San Mateo,081,765935,7873,6987,7,6994,118
2020-08-17,Santa Barbara,083,443738,7776,7438,69,7507,80
2020-08-17,Santa Clara,085,1922200,16691,14546,34,14580,183
2020-08-17,Santa Cruz,087,273765,1708,1453,13,1466,6
2020-08-17,Shasta,089,179085,583,467,3,470,9
2020-08-17,Sierra,091,2930,6,6,0,6,0
2020-08-17,Siskiyou,093,43540,119,103,0,103,0
2020-08-17,Solano,095,438530,5097,4479,30,4509,31
2020-08-17,Sonoma,097,501317,5165,4402,17,4419,48
2020-08-17,Stanislaus,099,539301,14220,12745,196,12941,148
2020-08-17,Sutter,101,95872,1197,1071,1,1072,8
2020-08-17,Tehama,103,63373,372,324,2,326,1
2020-08-17,Trinity,105,12862,41,8,6,14,0
2020-08-17,Tulare,107,460477,13614,12487,44,12531,210
2020-08-17,Tuolumne,109,53932,172,157,4,161,1
2020-08-17,Ventura,111,848112,10462,9490,56,9546,89
2020-08-17,Yolo,113,214977,2267,2083,4,2087,47
2020-08-17,Yuba,115,75493,744,647,3,650,1
2020-08-16,Alameda,001,1643700,16953,15338,113,15451,221
2020-08-16,Alpine,003,1148,2,2,0,2,0
2020-08-16,Amador,005,37829,259,215,0,215,9
2020-08-16,Butte,007,227075,1589,1432,21,1453,15
2020-08-16,Calaveras,009,45235,199,167,0,167,1
2020-08-16,Colusa,011,21464,429,407,0,407,5
2020-08-16,Contra Costa,013,1133247,13096,11255,41,11296,140
2020-08-16,Del Norte,015,27424,103,77,0,77,0
2020-08-16,El Dorado,017,186661,948,843,6,849,2
2020-08-16,Fresno,019,978130,25620,21010,250,21260,211
2020-08-16,Glenn,021,27897,422,400,0,400,2
2020-08-16,Humboldt,023,135768,347,301,1,302,4
2020-08-16,Imperial,025,180216,10936,8883,7,8890,188
2020-08-16,Inyo,027,18085,149,125,2,127,1
2020-08-16,Kern,029,883053,28410,26520,163,26683,249
2020-08-16,Kings,031,150075,5736,5146,26,5172,58
2020-08-16,Lake,033,64148,301,269,0,269,2
2020-08-16,Lassen,035,31185,711,666,2,668,0
2020-08-16,Los Angeles,037,10098052,228761,222236,857,223093,5263
2020-08-16,Madera,039,155013,3582,3013,20,3033,26
2020-08-16,Marin,041,260295,5888,5664,12,5676,46
2020-08-16,Mariposa,043,17540,71,61,0,61,2
2020-08-16,Mendocino,045,87422,525,451,0,451,8
2020-08-16,Merced,047,269075,7315,6744,4,6748,66
2020-08-16,Modoc,049,8938,7,5,0,5,0
2020-08-16,Mono,051,14174,162,126,2,128,1
2020-08-16,Monterey,053,433212,7154,6516,19,6535,44
2020-08-16,Napa,055,140530,1364,1241,3,1244,10
2020-08-16,Nevada,057,99092,408,379,13,392,2
2020-08-16,Orange,059,3164182,47926,43303,1043,44346,803
2020-08-16,Placer,061,380077,2816,2583,4,2587,28
2020-08-16,Plumas,063,18699,39,33,0,33,0
2020-08-16,Riverside,065,2383286,50709,47669,50,47719,910
2020-08-16,Sacramento,067,1510023,16311,14210,13,14223,219
2020-08-16,San Benito,069,59416,930,815,0,815,2
2020-08-16,San Bernardino,071,2135413,46170,41724,245,41969,603
2020-08-16,San Diego,073,3302833,36572,34680,198,34878,626
2020-08-16,San Francisco,075,870044,8781,7602,8,7610,72
2020-08-16,San Joaquin,077,732212,17175,15288,27,15315,280
2020-08-16,San Luis Obispo,079,281455,2762,2494,11,2505,17
2020-08-16,San Mateo,081,765935,7799,6942,7,6949,118
2020-08-16,Santa Barbara,083,443738,7727,7368,69,7437,79
2020-08-16,Santa Clara,085,1922200,16493,14329,34,14363,183
2020-08-16,Santa Cruz,087,273765,1681,1449,12,1461,6
2020-08-16,Shasta,089,179085,576,465,3,468,9
2020-08-16,Sierra,091,2930,6,6,0,6,0
2020-08-16,Siskiyou,093,43540,118,102,0,102,0
2020-08-16,Solano,095,438530,5037,4479,30,4509,31
2020-08-16,Sonoma,097,501317,5061,4329,17,4346,46
2020-08-16,Stanislaus,099,539301,14062,12668,186,12854,148
2020-08-16,Sutter,101,95872,1179,1071,1,1072,8
2020-08-16,Tehama,103,63373,363,318,2,320,1
2020-08-16,Trinity,105,12862,38,8,6,14,0
2020-08-16,Tulare,107,460477,13482,12334,41,12375,211
2020-08-16,Tuolumne,109,53932,172,156,4,160,1
2020-08-16,Ventura,111,848112,10353,9408,51,9459,89
2020-08-16,Yolo,113,214977,2248,2057,4,2061,47
2020-08-16,Yuba,115,75493,735,647,2,649,1
2020-08-15,Alameda,001,1643700,16876,15165,113,15278,221
2020-08-15,Alpine,003,1148,2,2,0,2,0
2020-08-15,Amador,005,37829,259,210,0,210,9
2020-08-15,Butte,007,227075,1567,1409,21,1430,15
2020-08-15,Calaveras,009,45235,197,167,0,167,1
2020-08-15,Colusa,011,21464,428,401,0,401,5
2020-08-15,Contra Costa,013,1133247,13000,11106,41,11147,138
2020-08-15,Del Norte,015,27424,103,77,0,77,0
2020-08-15,El Dorado,017,186661,943,838,6,844,2
2020-08-15,Fresno,019,978130,25504,20603,248,20851,211
2020-08-15,Glenn,021,27897,422,398,0,398,2
2020-08-15,Humboldt,023,135768,346,301,1,302,4
2020-08-15,Imperial,025,180216,10916,8794,7,8801,188
2020-08-15,Inyo,027,18085,149,123,2,125,1
2020-08-15,Kern,029,883053,28322,26338,163,26501,249
2020-08-15,Kings,031,150075,5718,5039,26,5065,56
2020-08-15,Lake,033,64148,299,268,0,268,2
2020-08-15,Lassen,035,31185,711,666,2,668,0
2020-08-15,Los Angeles,037,10098052,228009,221043,847,221890,5252
2020-08-15,Madera,039,155013,3532,2950,20,2970,26
2020-08-15,Marin,041,260295,5881,5628,12,5640,46
2020-08-15,Mariposa,043,17540,71,61,0,61,2
2020-08-15,Mendocino,045,87422,521,444,0,444,8
2020-08-15,Merced,047,269075,7281,6656,4,6660,66
2020-08-15,Modoc,049,8938,7,5,0,5,0
2020-08-15,Mono,051,14174,162,126,2,128,1
2020-08-15,Monterey,053,433212,7109,6162,19,6181,44
2020-08-15,Napa,055,140530,1354,1232,3,1235,10
2020-08-15,Nevada,057,99092,408,376,13,389,2
2020-08-15,Orange,059,3164182,47813,42811,1032,43843,801
2020-08-15,Placer,061,380077,2795,2551,4,2555,27
2020-08-15,Plumas,063,18699,39,33,0,33,0
2020-08-15,Riverside,065,2383286,50558,46720,50,46770,910
2020-08-15,Sacramento,067,1510023,16201,14018,13,14031,219
2020-08-15,San Benito,069,59416,917,805,0,805,2
2020-08-15,San Bernardino,071,2135413,46018,41231,243,41474,602
2020-08-15,San Diego,073,3302833,36406,34346,184,34530,639
2020-08-15,San Francisco,075,870044,8719,7601,8,7609,69
2020-08-15,San Joaquin,077,732212,17102,15113,27,15140,280
2020-08-15,San Luis Obispo,079,281455,2745,2461,11,2472,17
2020-08-15,San Mateo,081,765935,7762,6860,7,6867,118
2020-08-15,Santa Barbara,083,443738,7699,7338,69,7407,79
2020-08-15,Santa Clara,085,1922200,16397,14105,34,14139,183
2020-08-15,Santa Cruz,087,273765,1660,1449,12,1461,6
2020-08-15,Shasta,089,179085,573,458,3,461,9
2020-08-15,Sierra,091,2930,6,6,0,6,0
2020-08-15,Siskiyou,093,43540,117,100,0,100,0
2020-08-15,Solano,095,438530,5015,4477,30,4507,31
2020-08-15,Sonoma,097,501317,5006,4134,17,4151,45
2020-08-15,Stanislaus,099,539301,13998,12541,185,12726,149
2020-08-15,Sutter,101,95872,1168,1046,1,1047,8
2020-08-15,Tehama,103,63373,362,312,2,314,1
2020-08-15,Trinity,105,12862,36,6,6,12,0
2020-08-15,Tulare,107,460477,13443,12262,41,12303,211
2020-08-15,Tuolumne,109,53932,172,155,4,159,1
2020-08-15,Ventura,111,848112,10294,9379,49,9428,89
2020-08-15,Yolo,113,214977,2236,2031,4,2035,46
2020-08-15,Yuba,115,75493,731,623,2,625,1
2020-08-14,Alameda,001,1643700,16736,14909,113,15022,221
2020-08-14,Alpine,003,1148,2,2,0,2,0
2020-08-14,Amador,005,37829,259,209,0,209,9
2020-08-14,Butte,007,227075,1559,1384,21,1405,15
2020-08-14,Calaveras,009,45235,193,165,0,165,1
2020-08-14,Colusa,011,21464,426,399,0,399,5
2020-08-14,Contra Costa,013,1133247,12888,10893,41,10934,137
2020-08-14,Del Norte,015,27424,103,76,0,76,0
2020-08-14,El Dorado,017,186661,935,827,6,833,2
2020-08-14,Fresno,019,978130,25371,19900,248,20148,208
2020-08-14,Glenn,021,27897,420,395,0,395,2
2020-08-14,Humboldt,023,135768,340,294,1,295,4
2020-08-14,Imperial,025,180216,10892,8756,7,8763,185
2020-08-14,Inyo,027,18085,148,115,2,117,1
2020-08-14,Kern,029,883053,28218,25893,162,26055,249
2020-08-14,Kings,031,150075,5704,4953,26,4979,56
2020-08-14,Lake,033,64148,290,267,0,267,2
2020-08-14,Lassen,035,31185,711,665,2,667,0
2020-08-14,Los Angeles,037,10098052,226836,219083,831,219914,5222
2020-08-14,Madera,039,155013,3502,2876,20,2896,26
2020-08-14,Marin,041,260295,5870,5601,12,5613,46
2020-08-14,Mariposa,043,17540,70,61,0,61,2
2020-08-14,Mendocino,045,87422,512,432,0,432,8
2020-08-14,Merced,047,269075,7251,6466,4,6470,67
2020-08-14,Modoc,049,8938,7,5,0,5,0
2020-08-14,Mono,051,14174,162,126,2,128,1
2020-08-14,Monterey,053,433212,7058,6121,19,6140,41
2020-08-14,Napa,055,140530,1344,1230,3,1233,10
2020-08-14,Nevada,057,99092,404,377,13,390,2
2020-08-14,Orange,059,3164182,47663,42399,1020,43419,798
2020-08-14,Placer,061,380077,2776,2546,4,2550,26
2020-08-14,Plumas,063,18699,38,33,0,33,0
2020-08-14,Riverside,065,2383286,50329,46456,50,46506,891
2020-08-14,Sacramento,067,1510023,16052,13645,13,13658,212
2020-08-14,San Benito,069,59416,900,783,0,783,2
2020-08-14,San Bernardino,071,2135413,45831,40442,240,40682,594
2020-08-14,San Diego,073,3302833,36212,34067,177,34244,622
2020-08-14,San Francisco,075,870044,8661,7467,8,7475,69
2020-08-14,San Joaquin,077,732212,17002,14925,27,14952,276
2020-08-14,San Luis Obispo,079,281455,2730,2422,11,2433,17
2020-08-14,San Mateo,081,765935,7703,6655,7,6662,118
2020-08-14,Santa Barbara,083,443738,7649,7302,69,7371,77
2020-08-14,Santa Clara,085,1922200,16231,13785,33,13818,183
2020-08-14,Santa Cruz,087,273765,1638,1418,11,1429,6
2020-08-14,Shasta,089,179085,568,446,3,449,9
2020-08-14,Sierra,091,2930,6,5,0,5,0
2020-08-14,Siskiyou,093,43540,117,98,0,98,0
2020-08-14,Solano,095,438530,4994,4421,30,4451,31
2020-08-14,Sonoma,097,501317,4947,4087,14,4101,45
2020-08-14,Stanislaus,099,539301,13920,12379,181,12560,140
2020-08-14,Sutter,101,95872,1160,1039,1,1040,8
2020-08-14,Tehama,103,63373,357,305,2,307,1
2020-08-14,Trinity,105,12862,36,6,6,12,0
2020-08-14,Tulare,107,460477,13366,12009,41,12050,211
2020-08-14,Tuolumne,109,53932,171,155,4,159,1
2020-08-14,Ventura,111,848112,10219,9313,49,9362,89
2020-08-14,Yolo,113,214977,2222,1991,4,1995,45
2020-08-14,Yuba,115,75493,715,606,2,608,1
2020-08-13,Alameda,001,1643700,16455,14385,113,14498,218
2020-08-13,Alpine,003,1148,2,2,0,2,0
2020-08-13,Amador,005,37829,259,198,0,198,8
2020-08-13,Butte,007,227075,1534,1345,21,1366,15
2020-08-13,Calaveras,009,45235,191,162,0,162,1
2020-08-13,Colusa,011,21464,426,395,0,395,5
2020-08-13,Contra Costa,013,1133247,12734,10545,40,10585,136
2020-08-13,Del Norte,015,27424,102,74,0,74,0
2020-08-13,El Dorado,017,186661,930,803,6,809,2
2020-08-13,Fresno,019,978130,25144,19157,242,19399,201
2020-08-13,Glenn,021,27897,416,392,0,392,1
2020-08-13,Humboldt,023,135768,332,281,1,282,4
2020-08-13,Imperial,025,180216,10861,8640,7,8647,170
2020-08-13,Inyo,027,18085,144,97,2,99,1
2020-08-13,Kern,029,883053,28051,25472,159,25631,242
2020-08-13,Kings,031,150075,5669,4824,26,4850,52
2020-08-13,Lake,033,64148,285,263,0,263,2
2020-08-13,Lassen,035,31185,711,652,2,654,0
2020-08-13,Los Angeles,037,10098052,225454,216497,809,217306,5179
2020-08-13,Madera,039,155013,3458,2675,19,2694,25
2020-08-13,Marin,041,260295,5854,5503,12,5515,44
2020-08-13,Mariposa,043,17540,69,61,0,61,2
2020-08-13,Mendocino,045,87422,507,401,0,401,8
2020-08-13,Merced,047,269075,7134,5945,4,5949,63
2020-08-13,Modoc,049,8938,7,5,0,5,0
2020-08-13,Mono,051,14174,162,124,2,126,1
2020-08-13,Monterey,053,433212,6975,5925,19,5944,38
2020-08-13,Napa,055,140530,1335,1179,3,1182,10
2020-08-13,Nevada,057,99092,400,362,13,375,1
2020-08-13,Orange,059,3164182,47424,42019,1009,43028,773
2020-08-13,Placer,061,380077,2753,2460,4,2464,26
2020-08-13,Plumas,063,18699,38,32,0,32,0
2020-08-13,Riverside,065,2383286,50033,45327,50,45377,885
2020-08-13,Sacramento,067,1510023,15849,13237,13,13250,197
2020-08-13,San Benito,069,59416,871,757,0,757,2
2020-08-13,San Bernardino,071,2135413,45436,39395,233,39628,591
2020-08-13,San Diego,073,3302833,35976,33661,159,33820,627
2020-08-13,San Francisco,075,870044,8567,7277,8,7285,69
2020-08-13,San Joaquin,077,732212,16846,14537,26,14563,261
2020-08-13,San Luis Obispo,079,281455,2708,2283,11,2294,16
2020-08-13,San Mateo,081,765935,7641,6503,7,6510,117
2020-08-13,Santa Barbara,083,443738,7604,7129,68,7197,74
2020-08-13,Santa Clara,085,1922200,16009,13257,33,13290,182
2020-08-13,Santa Cruz,087,273765,1613,1383,11,1394,6
2020-08-13,Shasta,089,179085,563,428,3,431,9
2020-08-13,Sierra,091,2930,6,5,0,5,0
2020-08-13,Siskiyou,093,43540,117,95,0,95,0
2020-08-13,Solano,095,438530,4956,4305,30,4335,31
2020-08-13,Sonoma,097,501317,4873,3902,14,3916,45
2020-08-13,Stanislaus,099,539301,13790,11953,165,12118,136
2020-08-13,Sutter,101,95872,1138,992,1,993,8
2020-08-13,Tehama,103,63373,348,302,2,304,1
2020-08-13,Trinity,105,12862,35,6,6,12,0
2020-08-13,Tulare,107,460477,13222,11692,38,11730,210
2020-08-13,Tuolumne,109,53932,170,152,4,156,1
2020-08-13,Ventura,111,848112,10130,9114,49,9163,90
2020-08-13,Yolo,113,214977,2195,1938,4,1942,44
2020-08-13,Yuba,115,75493,699,568,2,570,1
2020-08-12,Alameda,001,1643700,16242,14214,113,14327,215
2020-08-12,Alpine,003,1148,2,2,0,2,0
2020-08-12,Amador,005,37829,256,197,0,197,8
2020-08-12,Butte,007,227075,1506,1317,21,1338,15
2020-08-12,Calaveras,009,45235,188,157,0,157,1
2020-08-12,Colusa,011,21464,421,394,0,394,5
2020-08-12,Contra Costa,013,1133247,12589,10304,39,10343,134
2020-08-12,Del Norte,015,27424,101,74,0,74,0
2020-08-12,El Dorado,017,186661,912,794,6,800,2
2020-08-12,Fresno,019,978130,24914,18690,236,18926,194
2020-08-12,Glenn,021,27897,413,388,0,388,1
2020-08-12,Humboldt,023,135768,325,281,1,282,4
2020-08-12,Imperial,025,180216,10838,8566,7,8573,167
2020-08-12,Inyo,027,18085,127,97,2,99,1
2020-08-12,Kern,029,883053,27859,25191,157,25348,232
2020-08-12,Kings,031,150075,5630,4736,26,4762,50
2020-08-12,Lake,033,64148,283,253,0,253,2
2020-08-12,Lassen,035,31185,710,651,2,653,0
2020-08-12,Los Angeles,037,10098052,224056,214542,794,215336,5119
2020-08-12,Madera,039,155013,3424,2681,17,2698,23
2020-08-12,Marin,041,260295,5832,5423,12,5435,44
2020-08-12,Mariposa,043,17540,69,61,0,61,2
2020-08-12,Mendocino,045,87422,488,386,0,386,9
2020-08-12,Merced,047,269075,7072,5777,4,5781,66
2020-08-12,Modoc,049,8938,7,5,0,5,0
2020-08-12,Mono,051,14174,161,124,2,126,1
2020-08-12,Monterey,053,433212,6871,5919,19,5938,38
2020-08-12,Napa,055,140530,1325,1161,3,1164,10
2020-08-12,Nevada,057,99092,395,357,13,370,1
2020-08-12,Orange,059,3164182,47173,41576,985,42561,754
2020-08-12,Placer,061,380077,2721,2417,4,2421,25
2020-08-12,Plumas,063,18699,38,31,0,31,0
2020-08-12,Riverside,065,2383286,49685,44747,50,44797,867
2020-08-12,Sacramento,067,1510023,15637,12528,13,12541,189
2020-08-12,San Benito,069,59416,858,751,0,751,2
2020-08-12,San Bernardino,071,2135413,45092,38811,224,39035,589
2020-08-12,San Diego,073,3302833,35767,33395,139,33534,608
2020-08-12,San Francisco,075,870044,8484,7194,8,7202,66
2020-08-12,San Joaquin,077,732212,16700,14154,26,14180,253
2020-08-12,San Luis Obispo,079,281455,2683,2263,11,2274,15
2020-08-12,San Mateo,081,765935,7562,6427,7,6434,117
2020-08-12,Santa Barbara,083,443738,7544,7049,66,7115,74
2020-08-12,Santa Clara,085,1922200,15833,13002,33,13035,182
2020-08-12,Santa Cruz,087,273765,1584,1382,10,1392,6
2020-08-12,Shasta,089,179085,559,417,3,420,9
2020-08-12,Sierra,091,2930,5,4,0,4,0
2020-08-12,Siskiyou,093,43540,116,90,0,90,0
2020-08-12,Solano,095,438530,4911,4258,30,4288,31
2020-08-12,Sonoma,097,501317,4799,3847,14,3861,47
2020-08-12,Stanislaus,099,539301,13651,11682,158,11840,136
2020-08-12,Sutter,101,95872,1114,987,1,988,7
2020-08-12,Tehama,103,63373,338,289,2,291,1
2020-08-12,Trinity,105,12862,34,6,6,12,0
2020-08-12,Tulare,107,460477,13094,11460,38,11498,211
2020-08-12,Tuolumne,109,53932,169,150,4,154,1
2020-08-12,Ventura,111,848112,10043,9005,49,9054,87
2020-08-12,Yolo,113,214977,2171,1921,4,1925,44
2020-08-12,Yuba,115,75493,677,549,1,550,1
2020-08-11,Alameda,001,1643700,15981,13960,110,14070,204
2020-08-11,Alpine,003,1148,2,2,0,2,0
2020-08-11,Amador,005,37829,250,187,0,187,3
2020-08-11,Butte,007,227075,1478,1296,21,1317,15
2020-08-11,Calaveras,009,45235,186,161,0,161,1
2020-08-11,Colusa,011,21464,416,390,0,390,5
2020-08-11,Contra Costa,013,1133247,12399,10012,37,10049,131
2020-08-11,Del Norte,015,27424,100,73,0,73,0
2020-08-11,El Dorado,017,186661,905,786,5,791,2
2020-08-11,Fresno,019,978130,24592,18344,233,18577,187
2020-08-11,Glenn,021,27897,411,380,0,380,1
2020-08-11,Humboldt,023,135768,320,283,1,284,4
2020-08-11,Imperial,025,180216,10783,8518,7,8525,165
2020-08-11,Inyo,027,18085,122,97,2,99,1
2020-08-11,Kern,029,883053,27524,25042,155,25197,230
2020-08-11,Kings,031,150075,5439,4696,26,4722,50
2020-08-11,Lake,033,64148,280,243,0,243,2
2020-08-11,Lassen,035,31185,704,605,2,607,0
2020-08-11,Los Angeles,037,10098052,222555,212421,770,213191,5065
2020-08-11,Madera,039,155013,3370,2673,17,2690,22
2020-08-11,Marin,041,260295,5805,5287,11,5298,44
2020-08-11,Mariposa,043,17540,68,60,0,60,2
2020-08-11,Mendocino,045,87422,478,385,0,385,9
2020-08-11,Merced,047,269075,6977,5322,3,5325,65
2020-08-11,Modoc,049,8938,7,5,0,5,0
2020-08-11,Mono,051,14174,161,124,2,126,1
2020-08-11,Monterey,053,433212,6762,5624,19,5643,36
2020-08-11,Napa,055,140530,1314,1143,2,1145,11
2020-08-11,Nevada,057,99092,392,358,13,371,1
2020-08-11,Orange,059,3164182,46952,41205,964,42169,742
2020-08-11,Placer,061,380077,2689,2393,4,2397,24
2020-08-11,Plumas,063,18699,38,31,0,31,0
2020-08-11,Riverside,065,2383286,49328,44237,50,44287,836
2020-08-11,Sacramento,067,1510023,15346,12298,13,12311,182
2020-08-11,San Benito,069,59416,846,750,0,750,2
2020-08-11,San Bernardino,071,2135413,44752,38467,217,38684,584
2020-08-11,San Diego,073,3302833,35500,33159,120,33279,602
2020-08-11,San Francisco,075,870044,8388,6988,8,6996,66
2020-08-11,San Joaquin,077,732212,16522,13997,21,14018,251
2020-08-11,San Luis Obispo,079,281455,2626,2234,11,2245,15
2020-08-11,San Mateo,081,765935,7488,6339,7,6346,117
2020-08-11,Santa Barbara,083,443738,7495,6942,66,7008,70
2020-08-11,Santa Clara,085,1922200,15612,12920,33,12953,183
2020-08-11,Santa Cruz,087,273765,1561,1352,10,1362,4
2020-08-11,Shasta,089,179085,555,416,3,419,9
2020-08-11,Sierra,091,2930,5,4,0,4,0
2020-08-11,Siskiyou,093,43540,116,90,0,90,0
2020-08-11,Solano,095,438530,4863,4206,29,4235,31
2020-08-11,Sonoma,097,501317,4704,3752,14,3766,45
2020-08-11,Stanislaus,099,539301,13547,11592,146,11738,128
2020-08-11,Sutter,101,95872,1092,964,1,965,7
2020-08-11,Tehama,103,63373,334,289,2,291,1
2020-08-11,Trinity,105,12862,34,5,6,11,0
2020-08-11,Tulare,107,460477,12969,11392,37,11429,201
2020-08-11,Tuolumne,109,53932,164,146,4,150,1
2020-08-11,Ventura,111,848112,9975,8953,48,9001,88
2020-08-11,Yolo,113,214977,2149,1912,4,1916,44
2020-08-11,Yuba,115,75493,666,540,1,541,1
2020-08-10,Alameda,001,1643700,15742,13420,109,13529,203
2020-08-10,Alpine,003,1148,2,2,0,2,0
2020-08-10,Amador,005,37829,249,172,0,172,2
2020-08-10,Butte,007,227075,1454,1174,19,1193,15
2020-08-10,Calaveras,009,45235,175,121,0,121,1
2020-08-10,Colusa,011,21464,414,387,0,387,4
2020-08-10,Contra Costa,013,1133247,12246,9454,35,9489,130
2020-08-10,Del Norte,015,27424,98,69,0,69,0
2020-08-10,El Dorado,017,186661,893,771,5,776,2
2020-08-10,Fresno,019,978130,24311,17978,233,18211,183
2020-08-10,Glenn,021,27897,408,381,0,381,1
2020-08-10,Humboldt,023,135768,314,277,1,278,4
2020-08-10,Imperial,025,180216,10739,8465,7,8472,165
2020-08-10,Inyo,027,18085,122,97,2,99,1
2020-08-10,Kern,029,883053,27298,24499,154,24653,215
2020-08-10,Kings,031,150075,5333,4588,26,4614,50
2020-08-10,Lake,033,64148,273,239,0,239,2
2020-08-10,Lassen,035,31185,704,588,2,590,0
2020-08-10,Los Angeles,037,10098052,220978,211035,752,211787,5003
2020-08-10,Madera,039,155013,3337,2365,17,2382,22
2020-08-10,Marin,041,260295,5760,5242,10,5252,44
2020-08-10,Mariposa,043,17540,68,57,0,57,2
2020-08-10,Mendocino,045,87422,454,364,0,364,1
2020-08-10,Merced,047,269075,6896,4913,3,4916,51
2020-08-10,Modoc,049,8938,7,5,0,5,0
2020-08-10,Mono,051,14174,161,123,2,125,1
2020-08-10,Monterey,053,433212,6652,5358,19,5377,34
2020-08-10,Napa,055,140530,1296,1084,2,1086,8
2020-08-10,Nevada,057,99092,384,356,13,369,1
2020-08-10,Orange,059,3164182,46682,40445,946,41391,721
2020-08-10,Placer,061,380077,2650,2298,4,2302,21
2020-08-10,Plumas,063,18699,38,27,0,27,0
2020-08-10,Riverside,065,2383286,48943,43296,49,43345,830
2020-08-10,Sacramento,067,1510023,15035,12059,13,12072,168
2020-08-10,San Benito,069,59416,833,743,0,743,2
2020-08-10,San Bernardino,071,2135413,44375,37367,208,37575,579
2020-08-10,San Diego,073,3302833,35234,32977,104,33081,594
2020-08-10,San Francisco,075,870044,8298,6816,7,6823,66
2020-08-10,San Joaquin,077,732212,16340,13308,21,13329,240
2020-08-10,San Luis Obispo,079,281455,2527,2208,11,2219,15
2020-08-10,San Mateo,081,765935,7411,6222,7,6229,117
2020-08-10,Santa Barbara,083,443738,7440,6869,66,6935,66
2020-08-10,Santa Clara,085,1922200,15352,12615,32,12647,182
2020-08-10,Santa Cruz,087,273765,1541,1239,9,1248,4
2020-08-10,Shasta,089,179085,551,384,3,387,9
2020-08-10,Sierra,091,2930,5,3,0,3,0
2020-08-10,Siskiyou,093,43540,113,88,0,88,0
2020-08-10,Solano,095,438530,4803,4101,29,4130,31
2020-08-10,Sonoma,097,501317,4535,3640,10,3650,42
2020-08-10,Stanislaus,099,539301,13364,10855,130,10985,106
2020-08-10,Sutter,101,95872,1067,865,1,866,7
2020-08-10,Tehama,103,63373,327,282,2,284,1
2020-08-10,Trinity,105,12862,31,5,6,11,0
2020-08-10,Tulare,107,460477,12796,10750,35,10785,194
2020-08-10,Tuolumne,109,53932,164,143,3,146,1
2020-08-10,Ventura,111,848112,9891,8851,47,8898,85
2020-08-10,Yolo,113,214977,2126,1840,4,1844,45
2020-08-10,Yuba,115,75493,649,527,1,528,1
2020-08-09,Alameda,001,1643700,15461,13241,107,13348,203
2020-08-09,Alpine,003,1148,2,2,0,2,0
2020-08-09,Amador,005,37829,244,153,0,153,2
2020-08-09,Butte,007,227075,1411,1155,19,1174,15
2020-08-09,Calaveras,009,45235,170,122,0,122,1
2020-08-09,Colusa,011,21464,410,371,0,371,4
2020-08-09,Contra Costa,013,1133247,12019,9214,34,9248,130
2020-08-09,Del Norte,015,27424,98,69,0,69,0
2020-08-09,El Dorado,017,186661,885,748,5,753,2
2020-08-09,Fresno,019,978130,24002,17846,229,18075,183
2020-08-09,Glenn,021,27897,406,354,0,354,1
2020-08-09,Humboldt,023,135768,308,279,1,280,4
2020-08-09,Imperial,025,180216,10696,8310,6,8316,165
2020-08-09,Inyo,027,18085,117,86,1,87,1
2020-08-09,Kern,029,883053,27042,23680,154,23834,215
2020-08-09,Kings,031,150075,5290,4446,25,4471,50
2020-08-09,Lake,033,64148,266,225,0,225,2
2020-08-09,Lassen,035,31185,698,589,2,591,0
2020-08-09,Los Angeles,037,10098052,218916,208810,730,209540,4984
2020-08-09,Madera,039,155013,3278,2322,13,2335,22
2020-08-09,Marin,041,260295,5717,5204,10,5214,44
2020-08-09,Mariposa,043,17540,66,56,0,56,2
2020-08-09,Mendocino,045,87422,444,283,0,283,1
2020-08-09,Merced,047,269075,6799,4735,2,4737,51
2020-08-09,Modoc,049,8938,7,4,0,4,0
2020-08-09,Mono,051,14174,160,113,2,115,1
2020-08-09,Monterey,053,433212,6528,5199,19,5218,34
2020-08-09,Napa,055,140530,1277,1062,2,1064,8
2020-08-09,Nevada,057,99092,376,332,13,345,1
2020-08-09,Orange,059,3164182,46383,39244,931,40175,722
2020-08-09,Placer,061,380077,2621,2211,4,2215,20
2020-08-09,Plumas,063,18699,38,27,0,27,0
2020-08-09,Riverside,065,2383286,48598,41894,49,41943,828
2020-08-09,Sacramento,067,1510023,14755,11301,13,11314,167
2020-08-09,San Benito,069,59416,814,687,0,687,2
2020-08-09,San Bernardino,071,2135413,43896,36092,208,36300,579
2020-08-09,San Diego,073,3302833,34943,32749,93,32842,594
2020-08-09,San Francisco,075,870044,8183,6820,7,6827,66
2020-08-09,San Joaquin,077,732212,16136,12933,20,12953,240
2020-08-09,San Luis Obispo,079,281455,2491,2124,11,2135,15
2020-08-09,San Mateo,081,765935,7316,6094,7,6101,117
2020-08-09,Santa Barbara,083,443738,7352,6669,66,6735,66
2020-08-09,Santa Clara,085,1922200,15081,11878,32,11910,181
2020-08-09,Santa Cruz,087,273765,1517,1246,9,1255,4
2020-08-09,Shasta,089,179085,547,361,3,364,9
2020-08-09,Sierra,091,2930,5,3,0,3,0
2020-08-09,Siskiyou,093,43540,112,74,0,74,0
2020-08-09,Solano,095,438530,4750,3954,28,3982,31
2020-08-09,Sonoma,097,501317,4399,3531,8,3539,41
2020-08-09,Stanislaus,099,539301,13156,10264,117,10381,106
2020-08-09,Sutter,101,95872,1033,857,1,858,7
2020-08-09,Tehama,103,63373,319,265,2,267,1
2020-08-09,Trinity,105,12862,31,5,6,11,0
2020-08-09,Tulare,107,460477,12605,10630,32,10662,194
2020-08-09,Tuolumne,109,53932,161,143,3,146,1
2020-08-09,Ventura,111,848112,9743,8633,46,8679,85
2020-08-09,Yolo,113,214977,2095,1765,4,1769,44
2020-08-09,Yuba,115,75493,629,442,1,443,1
2020-08-08,Alameda,001,1643700,15351,13087,107,13194,204
2020-08-08,Alpine,003,1148,2,2,0,2,0
2020-08-08,Amador,005,37829,244,139,0,139,2
2020-08-08,Butte,007,227075,1393,1140,19,1159,15
2020-08-08,Calaveras,009,45235,169,122,0,122,1
2020-08-08,Colusa,011,21464,409,368,0,368,4
2020-08-08,Contra Costa,013,1133247,11910,9104,34,9138,129
2020-08-08,Del Norte,015,27424,97,69,0,69,0
2020-08-08,El Dorado,017,186661,878,734,5,739,2
2020-08-08,Fresno,019,978130,23865,17538,227,17765,183
2020-08-08,Glenn,021,27897,406,344,0,344,1
2020-08-08,Humboldt,023,135768,305,277,1,278,4
2020-08-08,Imperial,025,180216,10681,8213,6,8219,165
2020-08-08,Inyo,027,18085,113,86,1,87,1
2020-08-08,Kern,029,883053,26928,22803,154,22957,215
2020-08-08,Kings,031,150075,5276,4367,25,4392,49
2020-08-08,Lake,033,64148,264,221,0,221,2
2020-08-08,Lassen,035,31185,698,589,2,591,0
2020-08-08,Los Angeles,037,10098052,218031,206971,719,207690,4974
2020-08-08,Madera,039,155013,3247,2275,13,2288,22
2020-08-08,Marin,041,260295,5697,5118,10,5128,44
2020-08-08,Mariposa,043,17540,65,55,0,55,2
2020-08-08,Mendocino,045,87422,442,264,0,264,1
2020-08-08,Merced,047,269075,6759,4570,2,4572,51
2020-08-08,Modoc,049,8938,7,4,0,4,0
2020-08-08,Mono,051,14174,160,113,2,115,1
2020-08-08,Monterey,053,433212,6470,5101,19,5120,33
2020-08-08,Napa,055,140530,1269,1062,2,1064,8
2020-08-08,Nevada,057,99092,374,325,13,338,1
2020-08-08,Orange,059,3164182,46253,38688,922,39610,718
2020-08-08,Placer,061,380077,2604,2153,4,2157,20
2020-08-08,Plumas,063,18699,38,27,0,27,0
2020-08-08,Riverside,065,2383286,48394,41412,49,41461,823
2020-08-08,Sacramento,067,1510023,14626,11144,13,11157,166
2020-08-08,San Benito,069,59416,806,684,0,684,2
2020-08-08,San Bernardino,071,2135413,43701,35691,207,35898,531
2020-08-08,San Diego,073,3302833,34754,32332,84,32416,593
2020-08-08,San Francisco,075,870044,8117,6820,7,6827,66
2020-08-08,San Joaquin,077,732212,16055,12559,19,12578,240
2020-08-08,San Luis Obispo,079,281455,2468,2081,11,2092,15
2020-08-08,San Mateo,081,765935,7258,6021,7,6028,117
2020-08-08,Santa Barbara,083,443738,7314,6598,66,6664,66
2020-08-08,Santa Clara,085,1922200,14929,11615,32,11647,181
2020-08-08,Santa Cruz,087,273765,1503,1247,9,1256,4
2020-08-08,Shasta,089,179085,545,343,3,346,9
2020-08-08,Sierra,091,2930,5,3,0,3,0
2020-08-08,Siskiyou,093,43540,112,73,0,73,0
2020-08-08,Solano,095,438530,4729,3889,27,3916,31
2020-08-08,Sonoma,097,501317,4368,3399,8,3407,41
2020-08-08,Stanislaus,099,539301,13081,9963,112,10075,105
2020-08-08,Sutter,101,95872,1023,830,1,831,7
2020-08-08,Tehama,103,63373,318,251,2,253,1
2020-08-08,Trinity,105,12862,31,5,6,11,0
2020-08-08,Tulare,107,460477,12530,10505,32,10537,192
2020-08-08,Tuolumne,109,53932,161,143,3,146,1
2020-08-08,Ventura,111,848112,9688,8462,45,8507,85
2020-08-08,Yolo,113,214977,2082,1725,4,1729,44
2020-08-08,Yuba,115,75493,620,430,1,431,1
2020-08-07,Alameda,001,1643700,15241,12805,107,12912,204
2020-08-07,Alpine,003,1148,2,2,0,2,0
2020-08-07,Amador,005,37829,242,125,0,125,2
2020-08-07,Butte,007,227075,1375,1092,19,1111,13
2020-08-07,Calaveras,009,45235,169,119,0,119,1
2020-08-07,Colusa,011,21464,408,358,0,358,4
2020-08-07,Contra Costa,013,1133247,11762,8810,34,8844,126
2020-08-07,Del Norte,015,27424,97,69,0,69,0
2020-08-07,El Dorado,017,186661,873,724,5,729,2
2020-08-07,Fresno,019,978130,23705,17290,227,17517,171
2020-08-07,Glenn,021,27897,405,339,0,339,1
2020-08-07,Humboldt,023,135768,301,274,1,275,4
2020-08-07,Imperial,025,180216,10656,8085,6,8091,164
2020-08-07,Inyo,027,18085,112,81,1,82,1
2020-08-07,Kern,029,883053,26802,22143,152,22295,206
2020-08-07,Kings,031,150075,5259,4315,25,4340,48
2020-08-07,Lake,033,64148,262,215,0,215,1
2020-08-07,Lassen,035,31185,697,588,2,590,0
2020-08-07,Los Angeles,037,10098052,216564,204406,708,205114,4924
2020-08-07,Madera,039,155013,3215,2245,13,2258,20
2020-08-07,Marin,041,260295,5668,5094,10,5104,43
2020-08-07,Mariposa,043,17540,65,53,0,53,2
2020-08-07,Mendocino,045,87422,428,262,0,262,1
2020-08-07,Merced,047,269075,6716,4358,2,4360,30
2020-08-07,Modoc,049,8938,7,4,0,4,0
2020-08-07,Mono,051,14174,160,112,2,114,1
2020-08-07,Monterey,053,433212,6395,5041,19,5060,33
2020-08-07,Napa,055,140530,1264,1055,2,1057,8
2020-08-07,Nevada,057,99092,371,324,13,337,1
2020-08-07,Orange,059,3164182,46042,38459,905,39364,701
2020-08-07,Placer,061,380077,2586,2078,4,2082,20
2020-08-07,Plumas,063,18699,38,25,0,25,0
2020-08-07,Riverside,065,2383286,48130,40902,48,40950,810
2020-08-07,Sacramento,067,1510023,14481,10798,13,10811,160
2020-08-07,San Benito,069,59416,800,647,0,647,2
2020-08-07,San Bernardino,071,2135413,43454,35200,206,35406,524
2020-08-07,San Diego,073,3302833,34569,31781,81,31862,586
2020-08-07,San Francisco,075,870044,8039,6765,7,6772,66
2020-08-07,San Joaquin,077,732212,15970,12392,19,12411,223
2020-08-07,San Luis Obispo,079,281455,2437,2050,11,2061,14
2020-08-07,San Mateo,081,765935,7198,5948,7,5955,117
2020-08-07,Santa Barbara,083,443738,7263,6509,66,6575,66
2020-08-07,Santa Clara,085,1922200,14730,11409,32,11441,180
2020-08-07,Santa Cruz,087,273765,1485,1234,9,1243,5
2020-08-07,Shasta,089,179085,540,342,3,345,9
2020-08-07,Sierra,091,2930,5,3,0,3,0
2020-08-07,Siskiyou,093,43540,109,73,0,73,0
2020-08-07,Solano,095,438530,4697,3844,26,3870,31
2020-08-07,Sonoma,097,501317,4304,3329,8,3337,34
2020-08-07,Stanislaus,099,539301,12959,9665,102,9767,98
2020-08-07,Sutter,101,95872,1019,807,1,808,6
2020-08-07,Tehama,103,63373,314,246,2,248,1
2020-08-07,Trinity,105,12862,30,5,6,11,0
2020-08-07,Tulare,107,460477,12453,10292,32,10324,195
2020-08-07,Tuolumne,109,53932,160,136,3,139,1
2020-08-07,Ventura,111,848112,9628,8356,43,8399,84
2020-08-07,Yolo,113,214977,2055,1689,4,1693,37
2020-08-07,Yuba,115,75493,615,413,1,414,1
2020-08-06,Alameda,001,1643700,15020,12474,106,12580,200
2020-08-06,Alpine,003,1148,2,2,0,2,0
2020-08-06,Amador,005,37829,228,125,0,125,0
2020-08-06,Butte,007,227075,1356,1060,19,1079,13
2020-08-06,Calaveras,009,45235,166,117,0,117,1
2020-08-06,Colusa,011,21464,405,358,0,358,3
2020-08-06,Contra Costa,013,1133247,11568,8583,33,8616,124
2020-08-06,Del Norte,015,27424,97,69,0,69,0
2020-08-06,El Dorado,017,186661,862,703,5,708,1
2020-08-06,Fresno,019,978130,23407,17031,220,17251,161
2020-08-06,Glenn,021,27897,400,332,0,332,1
2020-08-06,Humboldt,023,135768,296,266,1,267,4
2020-08-06,Imperial,025,180216,10613,8064,6,8070,163
2020-08-06,Inyo,027,18085,104,83,1,84,1
2020-08-06,Kern,029,883053,26566,21843,151,21994,197
2020-08-06,Kings,031,150075,5197,4264,24,4288,47
2020-08-06,Lake,033,64148,259,209,0,209,1
2020-08-06,Lassen,035,31185,695,588,2,590,0
2020-08-06,Los Angeles,037,10098052,214491,201372,692,202064,4874
2020-08-06,Madera,039,155013,3167,2240,12,2252,19
2020-08-06,Marin,041,260295,5636,5058,10,5068,43
2020-08-06,Mariposa,043,17540,64,52,0,52,2
2020-08-06,Mendocino,045,87422,414,260,0,260,1
2020-08-06,Merced,047,269075,6614,4235,2,4237,30
2020-08-06,Modoc,049,8938,7,4,0,4,0
2020-08-06,Mono,051,14174,159,111,2,113,1
2020-08-06,Monterey,053,433212,6286,5001,18,5019,33
2020-08-06,Napa,055,140530,1250,1032,2,1034,8
2020-08-06,Nevada,057,99092,366,321,13,334,1
2020-08-06,Orange,059,3164182,45750,38399,900,39299,694
2020-08-06,Placer,061,380077,2560,2045,4,2049,20
2020-08-06,Plumas,063,18699,37,25,0,25,0
2020-08-06,Riverside,065,2383286,47736,40269,48,40317,781
2020-08-06,Sacramento,067,1510023,14252,10548,13,10561,153
2020-08-06,San Benito,069,59416,792,626,0,626,2
2020-08-06,San Bernardino,071,2135413,43049,34819,204,35023,516
2020-08-06,San Diego,073,3302833,34302,31129,74,31203,583
2020-08-06,San Francisco,075,870044,7946,6737,6,6743,60
2020-08-06,San Joaquin,077,732212,15810,12269,19,12288,203
2020-08-06,San Luis Obispo,079,281455,2413,2000,10,2010,13
2020-08-06,San Mateo,081,765935,7098,5885,7,5892,117
2020-08-06,Santa Barbara,083,443738,7203,6620,66,6686,65
2020-08-06,Santa Clara,085,1922200,14501,11280,32,11312,178
2020-08-06,Santa Cruz,087,273765,1464,1215,9,1224,4
2020-08-06,Shasta,089,179085,531,343,3,346,9
2020-08-06,Sierra,091,2930,5,3,0,3,0
2020-08-06,Siskiyou,093,43540,109,73,0,73,0
2020-08-06,Solano,095,438530,4653,3784,26,3810,29
2020-08-06,Sonoma,097,501317,4240,3259,8,3267,33
2020-08-06,Stanislaus,099,539301,12809,9566,86,9652,98
2020-08-06,Sutter,101,95872,988,797,1,798,6
2020-08-06,Tehama,103,63373,311,242,2,244,1
2020-08-06,Trinity,105,12862,27,5,6,11,0
2020-08-06,Tulare,107,460477,12293,10169,32,10201,195
2020-08-06,Tuolumne,109,53932,159,136,3,139,1
2020-08-06,Ventura,111,848112,9513,8245,40,8285,80
2020-08-06,Yolo,113,214977,2031,1662,4,1666,36
2020-08-06,Yuba,115,75493,606,407,0,407,1
2020-08-05,Alameda,001,1643700,14805,12140,106,12246,193
2020-08-05,Alpine,003,1148,2,2,0,2,0
2020-08-05,Amador,005,37829,218,123,0,123,0
2020-08-05,Butte,007,227075,1322,1038,18,1056,13
2020-08-05,Calaveras,009,45235,163,116,0,116,1
2020-08-05,Colusa,011,21464,401,354,0,354,3
2020-08-05,Contra Costa,013,1133247,11399,8362,33,8395,122
2020-08-05,Del Norte,015,27424,96,69,0,69,0
2020-08-05,El Dorado,017,186661,854,692,5,697,1
2020-08-05,Fresno,019,978130,23163,16625,215,16840,159
2020-08-05,Glenn,021,27897,397,330,0,330,1
2020-08-05,Humboldt,023,135768,294,249,1,250,4
2020-08-05,Imperial,025,180216,10578,8036,6,8042,163
2020-08-05,Inyo,027,18085,102,62,1,63,1
2020-08-05,Kern,029,883053,26378,21540,146,21686,194
2020-08-05,Kings,031,150075,5152,4192,23,4215,47
2020-08-05,Lake,033,64148,252,209,0,209,1
2020-08-05,Lassen,035,31185,648,557,2,559,0
2020-08-05,Los Angeles,037,10098052,212570,198355,672,199027,4832
2020-08-05,Madera,039,155013,3125,2172,12,2184,19
2020-08-05,Marin,041,260295,5604,5036,10,5046,43
2020-08-05,Mariposa,043,17540,64,52,0,52,2
2020-08-05,Mendocino,045,87422,402,248,0,248,1
2020-08-05,Merced,047,269075,6479,4119,2,4121,30
2020-08-05,Modoc,049,8938,7,3,0,3,0
2020-08-05,Mono,051,14174,159,104,2,106,1
2020-08-05,Monterey,053,433212,6171,4936,18,4954,32
2020-08-05,Napa,055,140530,1238,1020,2,1022,8
2020-08-05,Nevada,057,99092,357,327,13,340,2
2020-08-05,Orange,059,3164182,45441,37907,892,38799,663
2020-08-05,Placer,061,380077,2519,1989,4,1993,18
2020-08-05,Plumas,063,18699,36,25,0,25,0
2020-08-05,Riverside,065,2383286,47344,39454,46,39500,761
2020-08-05,Sacramento,067,1510023,14033,10261,12,10273,151
2020-08-05,San Benito,069,59416,783,613,0,613,2
2020-08-05,San Bernardino,071,2135413,42587,34442,199,34641,504
2020-08-05,San Diego,073,3302833,34078,30866,58,30924,578
2020-08-05,San Francisco,075,870044,7853,6701,6,6707,60
2020-08-05,San Joaquin,077,732212,15647,12148,19,12167,199
2020-08-05,San Luis Obispo,079,281455,2389,1928,10,1938,13
2020-08-05,San Mateo,081,765935,7003,5695,7,5702,116
2020-08-05,Santa Barbara,083,443738,7143,6597,66,6663,63
2020-08-05,Santa Clara,085,1922200,14267,11074,32,11106,176
2020-08-05,Santa Cruz,087,273765,1444,1192,7,1199,4
2020-08-05,Shasta,089,179085,525,338,3,341,9
2020-08-05,Sierra,091,2930,5,3,0,3,0
2020-08-05,Siskiyou,093,43540,105,72,0,72,0
2020-08-05,Solano,095,438530,4602,3750,25,3775,29
2020-08-05,Sonoma,097,501317,4157,3173,8,3181,33
2020-08-05,Stanislaus,099,539301,12650,9408,81,9489,97
2020-08-05,Sutter,101,95872,977,780,1,781,6
2020-08-05,Tehama,103,63373,308,231,2,233,1
2020-08-05,Trinity,105,12862,27,5,6,11,0
2020-08-05,Tulare,107,460477,12152,9924,32,9956,192
2020-08-05,Tuolumne,109,53932,159,137,3,140,0
2020-08-05,Ventura,111,848112,9397,8162,36,8198,75
2020-08-05,Yolo,113,214977,2003,1634,4,1638,36
2020-08-05,Yuba,115,75493,589,400,0,400,1
2020-08-04,Alameda,001,1643700,14588,11983,105,12088,192
2020-08-04,Alpine,003,1148,2,2,0,2,0
2020-08-04,Amador,005,37829,203,123,0,123,0
2020-08-04,Butte,007,227075,1298,1011,18,1029,10
2020-08-04,Calaveras,009,45235,159,116,0,116,1
2020-08-04,Colusa,011,21464,396,354,0,354,3
2020-08-04,Contra Costa,013,1133247,11232,8210,33,8243,122
2020-08-04,Del Norte,015,27424,94,69,0,69,0
2020-08-04,El Dorado,017,186661,844,668,5,673,1
2020-08-04,Fresno,019,978130,22878,16272,208,16480,154
2020-08-04,Glenn,021,27897,396,325,0,325,1
2020-08-04,Humboldt,023,135768,284,241,1,242,4
2020-08-04,Imperial,025,180216,10541,7974,6,7980,163
2020-08-04,Inyo,027,18085,88,59,1,60,1
2020-08-04,Kern,029,883053,26095,21403,146,21549,190
2020-08-04,Kings,031,150075,5087,4163,23,4186,47
2020-08-04,Lake,033,64148,252,206,0,206,1
2020-08-04,Lassen,035,31185,645,556,2,558,0
2020-08-04,Los Angeles,037,10098052,210630,196014,645,196659,4764
2020-08-04,Madera,039,155013,3082,2161,8,2169,19
2020-08-04,Marin,041,260295,5573,5020,9,5029,43
2020-08-04,Mariposa,043,17540,64,51,0,51,2
2020-08-04,Mendocino,045,87422,377,248,0,248,1
2020-08-04,Merced,047,269075,6365,4085,2,4087,30
2020-08-04,Modoc,049,8938,7,3,0,3,0
2020-08-04,Mono,051,14174,158,104,1,105,1
2020-08-04,Monterey,053,433212,6057,4892,18,4910,32
2020-08-04,Napa,055,140530,1225,994,0,994,8
2020-08-04,Nevada,057,99092,356,322,13,335,2
2020-08-04,Orange,059,3164182,45065,37844,886,38730,659
2020-08-04,Placer,061,380077,2482,1964,4,1968,17
2020-08-04,Plumas,063,18699,36,25,0,25,0
2020-08-04,Riverside,065,2383286,46959,38991,45,39036,743
2020-08-04,Sacramento,067,1510023,13815,10205,12,10217,146
2020-08-04,San Benito,069,59416,767,608,0,608,2
2020-08-04,San Bernardino,071,2135413,42037,34215,194,34409,495
2020-08-04,San Diego,073,3302833,33785,30518,46,30564,568
2020-08-04,San Francisco,075,870044,7765,6568,6,6574,60
2020-08-04,San Joaquin,077,732212,15518,12087,16,12103,189
2020-08-04,San Luis Obispo,079,281455,2359,1886,10,1896,13
2020-08-04,San Mateo,081,765935,6897,5690,7,5697,116
2020-08-04,Santa Barbara,083,443738,7083,6591,66,6657,61
2020-08-04,Santa Clara,085,1922200,13965,10986,31,11017,175
2020-08-04,Santa Cruz,087,273765,1425,1202,7,1209,4
2020-08-04,Shasta,089,179085,519,335,3,338,9
2020-08-04,Sierra,091,2930,5,1,0,1,0
2020-08-04,Siskiyou,093,43540,103,71,0,71,0
2020-08-04,Solano,095,438530,4531,3690,25,3715,29
2020-08-04,Sonoma,097,501317,4090,3108,8,3116,33
2020-08-04,Stanislaus,099,539301,12481,9359,74,9433,97
2020-08-04,Sutter,101,95872,963,761,1,762,6
2020-08-04,Tehama,103,63373,301,226,2,228,1
2020-08-04,Trinity,105,12862,27,5,6,11,0
2020-08-04,Tulare,107,460477,11972,9866,32,9898,192
2020-08-04,Tuolumne,109,53932,158,127,3,130,0
2020-08-04,Ventura,111,848112,9283,8134,34,8168,75
2020-08-04,Yolo,113,214977,1977,1626,4,1630,37
2020-08-04,Yuba,115,75493,574,398,0,398,1
2020-08-03,Alameda,001,1643700,14406,11817,102,11919,189
2020-08-03,Alpine,003,1148,2,2,0,2,0
2020-08-03,Amador,005,37829,199,119,0,119,0
2020-08-03,Butte,007,227075,1252,989,17,1006,9
2020-08-03,Calaveras,009,45235,156,117,0,117,1
2020-08-03,Colusa,011,21464,392,336,0,336,2
2020-08-03,Contra Costa,013,1133247,11035,8069,30,8099,120
2020-08-03,Del Norte,015,27424,90,68,0,68,0
2020-08-03,El Dorado,017,186661,833,645,5,650,1
2020-08-03,Fresno,019,978130,22584,15945,202,16147,151
2020-08-03,Glenn,021,27897,389,316,0,316,1
2020-08-03,Humboldt,023,135768,277,234,1,235,4
2020-08-03,Imperial,025,180216,10486,7953,6,7959,161
2020-08-03,Inyo,027,18085,85,57,1,58,1
2020-08-03,Kern,029,883053,25728,21285,139,21424,176
2020-08-03,Kings,031,150075,4975,4107,22,4129,47
2020-08-03,Lake,033,64148,245,201,0,201,1
2020-08-03,Lassen,035,31185,645,555,2,557,0
2020-08-03,Los Angeles,037,10098052,208591,194103,617,194720,4706
2020-08-03,Madera,039,155013,3033,2143,7,2150,18
2020-08-03,Marin,041,260295,5526,5001,9,5010,43
2020-08-03,Mariposa,043,17540,63,52,0,52,2
2020-08-03,Mendocino,045,87422,354,248,0,248,1
2020-08-03,Merced,047,269075,6243,4028,2,4030,29
2020-08-03,Modoc,049,8938,7,2,0,2,0
2020-08-03,Mono,051,14174,158,104,1,105,1
2020-08-03,Monterey,053,433212,5906,4806,15,4821,28
2020-08-03,Napa,055,140530,1211,973,0,973,8
2020-08-03,Nevada,057,99092,352,315,13,328,2
2020-08-03,Orange,059,3164182,44671,37705,876,38581,651
2020-08-03,Placer,061,380077,2426,1947,3,1950,16
2020-08-03,Plumas,063,18699,36,25,0,25,0
2020-08-03,Riverside,065,2383286,46491,38642,45,38687,740
2020-08-03,Sacramento,067,1510023,13620,10143,12,10155,142
2020-08-03,San Benito,069,59416,755,603,0,603,2
2020-08-03,San Bernardino,071,2135413,41512,33979,188,34167,444
2020-08-03,San Diego,073,3302833,33471,30228,36,30264,565
2020-08-03,San Francisco,075,870044,7671,6319,6,6325,60
2020-08-03,San Joaquin,077,732212,15322,12007,15,12022,189
2020-08-03,San Luis Obispo,079,281455,2317,1863,8,1871,14
2020-08-03,San Mateo,081,765935,6816,5661,7,5668,115
2020-08-03,Santa Barbara,083,443738,7039,6580,66,6646,59
2020-08-03,Santa Clara,085,1922200,13689,10747,31,10778,172
2020-08-03,Santa Cruz,087,273765,1405,1154,7,1161,4
2020-08-03,Shasta,089,179085,512,322,3,325,9
2020-08-03,Sierra,091,2930,5,1,0,1,0
2020-08-03,Siskiyou,093,43540,99,67,0,67,0
2020-08-03,Solano,095,438530,4462,3610,24,3634,29
2020-08-03,Sonoma,097,501317,3989,3079,7,3086,33
2020-08-03,Stanislaus,099,539301,12272,9308,66,9374,96
2020-08-03,Sutter,101,95872,939,713,1,714,6
2020-08-03,Tehama,103,63373,293,225,2,227,1
2020-08-03,Trinity,105,12862,27,5,6,11,0
2020-08-03,Tulare,107,460477,11788,9703,32,9735,188
2020-08-03,Tuolumne,109,53932,158,123,3,126,0
2020-08-03,Ventura,111,848112,9192,8084,31,8115,74
2020-08-03,Yolo,113,214977,1942,1598,3,1601,37
2020-08-03,Yuba,115,75493,550,393,0,393,1
2020-08-02,Alameda,001,1643700,14159,11696,90,11786,188
2020-08-02,Alpine,003,1148,2,2,0,2,0
2020-08-02,Amador,005,37829,194,117,0,117,0
2020-08-02,Butte,007,227075,1217,987,17,1004,9
2020-08-02,Calaveras,009,45235,153,116,0,116,1
2020-08-02,Colusa,011,21464,387,335,0,335,2
2020-08-02,Contra Costa,013,1133247,10796,7995,30,8025,118
2020-08-02,Del Norte,015,27424,89,68,0,68,0
2020-08-02,El Dorado,017,186661,823,643,5,648,1
2020-08-02,Fresno,019,978130,22309,15759,196,15955,151
2020-08-02,Glenn,021,27897,388,315,0,315,1
2020-08-02,Humboldt,023,135768,272,232,1,233,4
2020-08-02,Imperial,025,180216,10423,7919,6,7925,157
2020-08-02,Inyo,027,18085,84,45,1,46,1
2020-08-02,Kern,029,883053,25430,21162,137,21299,176
2020-08-02,Kings,031,150075,4913,3964,21,3985,47
2020-08-02,Lake,033,64148,240,201,0,201,1
2020-08-02,Lassen,035,31185,645,555,2,557,0
2020-08-02,Los Angeles,037,10098052,206498,192480,599,193079,4698
2020-08-02,Madera,039,155013,2967,2123,5,2128,18
2020-08-02,Marin,041,260295,5491,4985,9,4994,43
2020-08-02,Mariposa,043,17540,61,52,0,52,2
2020-08-02,Mendocino,045,87422,344,247,0,247,1
2020-08-02,Merced,047,269075,6102,4011,2,4013,29
2020-08-02,Modoc,049,8938,7,2,0,2,0
2020-08-02,Mono,051,14174,151,104,1,105,1
2020-08-02,Monterey,053,433212,5780,4698,15,4713,28
2020-08-02,Napa,055,140530,1196,956,0,956,8
2020-08-02,Nevada,057,99092,349,314,13,327,2
2020-08-02,Orange,059,3164182,44290,37266,865,38131,651
2020-08-02,Placer,061,380077,2387,1920,3,1923,15
2020-08-02,Plumas,063,18699,36,25,0,25,0
2020-08-02,Riverside,065,2383286,46058,38507,44,38551,735
2020-08-02,Sacramento,067,1510023,13341,10099,12,10111,142
2020-08-02,San Benito,069,59416,741,599,0,599,2
2020-08-02,San Bernardino,071,2135413,40910,33643,184,33827,443
2020-08-02,San Diego,073,3302833,33131,29885,27,29912,565
2020-08-02,San Francisco,075,870044,7553,6297,6,6303,60
2020-08-02,San Joaquin,077,732212,15038,11937,13,11950,189
2020-08-02,San Luis Obispo,079,281455,2254,1821,8,1829,14
2020-08-02,San Mateo,081,765935,6701,5618,7,5625,115
2020-08-02,Santa Barbara,083,443738,6949,6532,66,6598,59
2020-08-02,Santa Clara,085,1922200,13470,10577,31,10608,172
2020-08-02,Santa Cruz,087,273765,1385,1162,7,1169,4
2020-08-02,Shasta,089,179085,508,318,3,321,9
2020-08-02,Sierra,091,2930,4,1,0,1,0
2020-08-02,Siskiyou,093,43540,99,65,0,65,0
2020-08-02,Solano,095,438530,4404,3609,24,3633,29
2020-08-02,Sonoma,097,501317,3904,3005,7,3012,33
2020-08-02,Stanislaus,099,539301,12057,9277,61,9338,96
2020-08-02,Sutter,101,95872,904,714,1,715,6
2020-08-02,Tehama,103,63373,287,222,2,224,1
2020-08-02,Trinity,105,12862,27,5,6,11,0
2020-08-02,Tulare,107,460477,11579,9593,32,9625,188
2020-08-02,Tuolumne,109,53932,155,123,3,126,0
2020-08-02,Ventura,111,848112,9045,8014,31,8045,73
2020-08-02,Yolo,113,214977,1917,1588,3,1591,37
2020-08-02,Yuba,115,75493,530,393,0,393,1
2020-08-01,Alameda,001,1643700,14047,11590,90,11680,188
2020-08-01,Alpine,003,1148,2,2,0,2,0
2020-08-01,Amador,005,37829,190,109,0,109,0
2020-08-01,Butte,007,227075,1203,976,17,993,9
2020-08-01,Calaveras,009,45235,149,116,0,116,1
2020-08-01,Colusa,011,21464,386,327,0,327,2
2020-08-01,Contra Costa,013,1133247,10663,7867,29,7896,116
2020-08-01,Del Norte,015,27424,89,68,0,68,0
2020-08-01,El Dorado,017,186661,820,637,5,642,1
2020-08-01,Fresno,019,978130,22172,15448,196,15644,149
2020-08-01,Glenn,021,27897,387,311,0,311,1
2020-08-01,Humboldt,023,135768,271,232,1,233,4
2020-08-01,Imperial,025,180216,10387,7919,6,7925,156
2020-08-01,Inyo,027,18085,82,45,1,46,1
2020-08-01,Kern,029,883053,25272,20796,133,20929,176
2020-08-01,Kings,031,150075,4887,3948,21,3969,47
2020-08-01,Lake,033,64148,238,194,0,194,1
2020-08-01,Lassen,035,31185,644,555,2,557,0
2020-08-01,Los Angeles,037,10098052,205606,191023,572,191595,4674
2020-08-01,Madera,039,155013,2928,2103,5,2108,18
2020-08-01,Marin,041,260295,5476,4945,9,4954,43
2020-08-01,Mariposa,043,17540,61,50,0,50,2
2020-08-01,Mendocino,045,87422,337,243,0,243,1
2020-08-01,Merced,047,269075,6054,3972,2,3974,29
2020-08-01,Modoc,049,8938,7,2,0,2,0
2020-08-01,Mono,051,14174,150,104,1,105,1
2020-08-01,Monterey,053,433212,5713,4611,14,4625,28
2020-08-01,Napa,055,140530,1187,923,0,923,8
2020-08-01,Nevada,057,99092,345,305,13,318,2
2020-08-01,Orange,059,3164182,44063,36703,859,37562,648
2020-08-01,Placer,061,380077,2353,1891,3,1894,14
2020-08-01,Plumas,063,18699,35,25,0,25,0
2020-08-01,Riverside,065,2383286,45846,38216,42,38258,704
2020-08-01,Sacramento,067,1510023,13190,10044,12,10056,141
2020-08-01,San Benito,069,59416,730,579,0,579,2
2020-08-01,San Bernardino,071,2135413,40674,32947,183,33130,440
2020-08-01,San Diego,073,3302833,32914,29579,19,29598,565
2020-08-01,San Francisco,075,870044,7492,6296,6,6302,60
2020-08-01,San Joaquin,077,732212,14964,11807,12,11819,189
2020-08-01,San Luis Obispo,079,281455,2225,1798,8,1806,13
2020-08-01,San Mateo,081,765935,6647,5520,7,5527,115
2020-08-01,Santa Barbara,083,443738,6909,6465,66,6531,59
2020-08-01,Santa Clara,085,1922200,13319,10281,30,10311,171
2020-08-01,Santa Cruz,087,273765,1369,1164,7,1171,4
2020-08-01,Shasta,089,179085,503,312,3,315,9
2020-08-01,Sierra,091,2930,3,1,0,1,0
2020-08-01,Siskiyou,093,43540,99,64,0,64,0
2020-08-01,Solano,095,438530,4370,3591,23,3614,29
2020-08-01,Sonoma,097,501317,3858,2890,7,2897,29
2020-08-01,Stanislaus,099,539301,11939,9221,54,9275,96
2020-08-01,Sutter,101,95872,900,714,1,715,6
2020-08-01,Tehama,103,63373,284,220,2,222,1
2020-08-01,Trinity,105,12862,27,5,6,11,0
2020-08-01,Tulare,107,460477,11511,9520,32,9552,188
2020-08-01,Tuolumne,109,53932,155,123,3,126,0
2020-08-01,Ventura,111,848112,8999,7819,31,7850,73
2020-08-01,Yolo,113,214977,1907,1557,3,1560,37
2020-08-01,Yuba,115,75493,525,387,0,387,1
2020-07-31,Alameda,001,1643700,13918,11441,90,11531,187
2020-07-31,Alpine,003,1148,2,2,0,2,0
2020-07-31,Amador,005,37829,189,98,0,98,0
2020-07-31,Butte,007,227075,1180,925,17,942,7
2020-07-31,Calaveras,009,45235,149,112,0,112,1
2020-07-31,Colusa,011,21464,376,319,0,319,2
2020-07-31,Contra Costa,013,1133247,10516,7697,28,7725,113
2020-07-31,Del Norte,015,27424,88,68,0,68,0
2020-07-31,El Dorado,017,186661,809,616,5,621,1
2020-07-31,Fresno,019,978130,21952,15083,196,15279,133
2020-07-31,Glenn,021,27897,380,304,0,304,1
2020-07-31,Humboldt,023,135768,264,229,1,230,4
2020-07-31,Imperial,025,180216,10355,7886,5,7891,155
2020-07-31,Inyo,027,18085,72,45,1,46,1
2020-07-31,Kern,029,883053,25031,20061,129,20190,173
2020-07-31,Kings,031,150075,4859,3807,21,3828,45
2020-07-31,Lake,033,64148,237,191,0,191,1
2020-07-31,Lassen,035,31185,639,544,2,546,0
2020-07-31,Los Angeles,037,10098052,204008,188688,559,189247,4628
2020-07-31,Madera,039,155013,2881,2036,5,2041,19
2020-07-31,Marin,041,260295,5432,4885,6,4891,43
2020-07-31,Mariposa,043,17540,61,49,0,49,2
2020-07-31,Mendocino,045,87422,322,232,0,232,1
2020-07-31,Merced,047,269075,5971,3789,2,3791,30
2020-07-31,Modoc,049,8938,6,0,0,0,0
2020-07-31,Mono,051,14174,149,104,1,105,1
2020-07-31,Monterey,053,433212,5621,4493,14,4507,24
2020-07-31,Napa,055,140530,1175,897,0,897,7
2020-07-31,Nevada,057,99092,343,302,13,315,2
2020-07-31,Orange,059,3164182,43764,36196,842,37038,620
2020-07-31,Placer,061,380077,2328,1853,3,1856,14
2020-07-31,Plumas,063,18699,34,25,0,25,0
2020-07-31,Riverside,065,2383286,45456,37612,41,37653,694
2020-07-31,Sacramento,067,1510023,13012,9872,12,9884,132
2020-07-31,San Benito,069,59416,722,567,0,567,2
2020-07-31,San Bernardino,071,2135413,40345,32332,182,32514,434
2020-07-31,San Diego,073,3302833,32680,29050,11,29061,561
2020-07-31,San Francisco,075,870044,7392,6126,6,6132,60
2020-07-31,San Joaquin,077,732212,14824,11561,12,11573,177
2020-07-31,San Luis Obispo,079,281455,2156,1746,8,1754,12
2020-07-31,San Mateo,081,765935,6575,5416,7,5423,115
2020-07-31,Santa Barbara,083,443738,6842,6375,66,6441,58
2020-07-31,Santa Clara,085,1922200,13098,9863,30,9893,171
2020-07-31,Santa Cruz,087,273765,1346,1118,7,1125,4
2020-07-31,Shasta,089,179085,493,305,3,308,9
2020-07-31,Sierra,091,2930,3,1,0,1,0
2020-07-31,Siskiyou,093,43540,97,61,0,61,0
2020-07-31,Solano,095,438530,4323,3510,22,3532,29
2020-07-31,Sonoma,097,501317,3800,2745,7,2752,27
2020-07-31,Stanislaus,099,539301,11833,9061,49,9110,94
2020-07-31,Sutter,101,95872,895,714,1,715,6
2020-07-31,Tehama,103,63373,281,213,2,215,1
2020-07-31,Trinity,105,12862,27,5,6,11,0
2020-07-31,Tulare,107,460477,11390,9365,32,9397,184
2020-07-31,Tuolumne,109,53932,155,120,3,123,0
2020-07-31,Ventura,111,848112,8924,7521,31,7552,71
2020-07-31,Yolo,113,214977,1881,1522,3,1525,38
2020-07-31,Yuba,115,75493,516,369,0,369,1
2020-07-30,Alameda,001,1643700,13715,11303,52,11355,185
2020-07-30,Alpine,003,1148,2,2,0,2,0
2020-07-30,Amador,005,37829,171,97,0,97,0
2020-07-30,Butte,007,227075,1164,915,17,932,7
2020-07-30,Calaveras,009,45235,145,111,0,111,1
2020-07-30,Colusa,011,21464,373,315,0,315,2
2020-07-30,Contra Costa,013,1133247,10332,7615,27,7642,112
2020-07-30,Del Norte,015,27424,88,68,0,68,0
2020-07-30,El Dorado,017,186661,802,608,5,613,1
2020-07-30,Fresno,019,978130,21616,14793,190,14983,133
2020-07-30,Glenn,021,27897,373,297,0,297,1
2020-07-30,Humboldt,023,135768,262,228,1,229,4
2020-07-30,Imperial,025,180216,10296,7849,5,7854,151
2020-07-30,Inyo,027,18085,68,44,1,45,1
2020-07-30,Kern,029,883053,24738,19552,125,19677,171
2020-07-30,Kings,031,150075,4755,3785,21,3806,43
2020-07-30,Lake,033,64148,231,181,0,181,1
2020-07-30,Lassen,035,31185,636,544,2,546,0
2020-07-30,Los Angeles,037,10098052,201978,186177,529,186706,4564
2020-07-30,Madera,039,155013,2811,2007,5,2012,18
2020-07-30,Marin,041,260295,5390,4835,5,4840,39
2020-07-30,Mariposa,043,17540,61,49,0,49,1
2020-07-30,Mendocino,045,87422,315,232,0,232,1
2020-07-30,Merced,047,269075,5807,3695,2,3697,30
2020-07-30,Modoc,049,8938,6,0,0,0,0
2020-07-30,Mono,051,14174,148,104,1,105,1
2020-07-30,Monterey,053,433212,5509,4352,14,4366,24
2020-07-30,Napa,055,140530,1158,874,0,874,7
2020-07-30,Nevada,057,99092,338,292,13,305,2
2020-07-30,Orange,059,3164182,43349,36105,818,36923,607
2020-07-30,Placer,061,380077,2277,1821,3,1824,14
2020-07-30,Plumas,063,18699,33,25,0,25,0
2020-07-30,Riverside,065,2383286,44915,37308,41,37349,685
2020-07-30,Sacramento,067,1510023,12793,9704,12,9716,126
2020-07-30,San Benito,069,59416,709,558,0,558,2
2020-07-30,San Bernardino,071,2135413,39822,32010,182,32192,427
2020-07-30,San Diego,073,3302833,32333,28670,9,28679,558
2020-07-30,San Francisco,075,870044,7291,6107,6,6113,59
2020-07-30,San Joaquin,077,732212,14630,11435,12,11447,161
2020-07-30,San Luis Obispo,079,281455,2120,1703,8,1711,12
2020-07-30,San Mateo,081,765935,6480,5369,7,5376,115
2020-07-30,Santa Barbara,083,443738,6762,6273,66,6339,52
2020-07-30,Santa Clara,085,1922200,12864,9708,29,9737,170
2020-07-30,Santa Cruz,087,273765,1318,1087,7,1094,4
2020-07-30,Shasta,089,179085,489,306,3,309,8
2020-07-30,Sierra,091,2930,3,1,0,1,0
2020-07-30,Siskiyou,093,43540,96,60,0,60,0
2020-07-30,Solano,095,438530,4272,3463,22,3485,29
2020-07-30,Sonoma,097,501317,3729,2684,7,2691,25
2020-07-30,Stanislaus,099,539301,11620,8890,41,8931,94
2020-07-30,Sutter,101,95872,876,698,1,699,6
2020-07-30,Tehama,103,63373,278,208,2,210,1
2020-07-30,Trinity,105,12862,26,4,6,10,0
2020-07-30,Tulare,107,460477,11261,9167,32,9199,177
2020-07-30,Tuolumne,109,53932,154,119,3,122,0
2020-07-30,Ventura,111,848112,8812,7304,29,7333,69
2020-07-30,Yolo,113,214977,1861,1511,3,1514,37
2020-07-30,Yuba,115,75493,503,362,0,362,1
2020-07-29,Alameda,001,1643700,13495,11177,47,11224,180
2020-07-29,Alpine,003,1148,2,2,0,2,0
2020-07-29,Amador,005,37829,163,80,0,80,0
2020-07-29,Butte,007,227075,1138,889,15,904,7
2020-07-29,Calaveras,009,45235,139,107,0,107,1
2020-07-29,Colusa,011,21464,369,302,0,302,2
2020-07-29,Contra Costa,013,1133247,10128,7520,27,7547,108
2020-07-29,Del Norte,015,27424,88,68,0,68,0
2020-07-29,El Dorado,017,186661,792,588,5,593,1
2020-07-29,Fresno,019,978130,21324,14312,190,14502,125
2020-07-29,Glenn,021,27897,366,294,0,294,1
2020-07-29,Humboldt,023,135768,259,221,1,222,4
2020-07-29,Imperial,025,180216,10248,7825,5,7830,147
2020-07-29,Inyo,027,18085,63,44,1,45,1
2020-07-29,Kern,029,883053,24399,19073,122,19195,162
2020-07-29,Kings,031,150075,4707,3755,21,3776,43
2020-07-29,Lake,033,64148,229,179,0,179,1
2020-07-29,Lassen,035,31185,621,513,2,515,0
2020-07-29,Los Angeles,037,10098052,199953,183600,512,184112,4523
2020-07-29,Madera,039,155013,2757,1941,5,1946,18
2020-07-29,Marin,041,260295,5352,4747,5,4752,34
2020-07-29,Mariposa,043,17540,60,47,0,47,1
2020-07-29,Mendocino,045,87422,307,228,0,228,0
2020-07-29,Merced,047,269075,5667,3605,2,3607,25
2020-07-29,Modoc,049,8938,5,0,0,0,0
2020-07-29,Mono,051,14174,145,102,1,103,1
2020-07-29,Monterey,053,433212,5409,4252,14,4266,24
2020-07-29,Napa,055,140530,1130,866,0,866,7
2020-07-29,Nevada,057,99092,334,288,13,301,1
2020-07-29,Orange,059,3164182,42915,35339,807,36146,589
2020-07-29,Placer,061,380077,2245,1798,3,1801,14
2020-07-29,Plumas,063,18699,33,25,0,25,0
2020-07-29,Riverside,065,2383286,44323,36968,41,37009,678
2020-07-29,Sacramento,067,1510023,12547,9538,12,9550,122
2020-07-29,San Benito,069,59416,694,537,0,537,2
2020-07-29,San Bernardino,071,2135413,39333,31168,171,31339,417
2020-07-29,San Diego,073,3302833,32008,28289,8,28297,552
2020-07-29,San Francisco,075,870044,7197,6041,6,6047,56
2020-07-29,San Joaquin,077,732212,14382,11249,9,11258,154
2020-07-29,San Luis Obispo,079,281455,2099,1673,8,1681,11
2020-07-29,San Mateo,081,765935,6392,5305,7,5312,114
2020-07-29,Santa Barbara,083,443738,6695,6215,66,6281,31
2020-07-29,Santa Clara,085,1922200,12658,9567,29,9596,165
2020-07-29,Santa Cruz,087,273765,1294,1051,7,1058,4
2020-07-29,Shasta,089,179085,477,297,3,300,8
2020-07-29,Sierra,091,2930,2,1,0,1,0
2020-07-29,Siskiyou,093,43540,94,58,0,58,0
2020-07-29,Solano,095,438530,4218,3380,22,3402,29
2020-07-29,Sonoma,097,501317,3651,2598,7,2605,26
2020-07-29,Stanislaus,099,539301,11399,8745,35,8780,94
2020-07-29,Sutter,101,95872,848,678,1,679,6
2020-07-29,Tehama,103,63373,274,206,2,208,1
2020-07-29,Trinity,105,12862,26,4,6,10,0
2020-07-29,Tulare,107,460477,11090,9028,32,9060,156
2020-07-29,Tuolumne,109,53932,154,118,3,121,0
2020-07-29,Ventura,111,848112,8707,7161,29,7190,68
2020-07-29,Yolo,113,214977,1835,1488,3,1491,36
2020-07-29,Yuba,115,75493,487,350,0,350,1
2020-07-28,Alameda,001,1643700,13265,10875,46,10921,180
2020-07-28,Alpine,003,1148,2,2,0,2,0
2020-07-28,Amador,005,37829,153,77,0,77,0
2020-07-28,Butte,007,227075,1103,857,15,872,7
2020-07-28,Calaveras,009,45235,138,105,0,105,1
2020-07-28,Colusa,011,21464,363,290,0,290,2
2020-07-28,Contra Costa,013,1133247,9906,7426,27,7453,107
2020-07-28,Del Norte,015,27424,87,68,0,68,0
2020-07-28,El Dorado,017,186661,777,558,5,563,1
2020-07-28,Fresno,019,978130,20988,13933,184,14117,125
2020-07-28,Glenn,021,27897,364,289,0,289,1
2020-07-28,Humboldt,023,135768,258,218,1,219,4
2020-07-28,Imperial,025,180216,10212,7804,5,7809,145
2020-07-28,Inyo,027,18085,61,43,1,44,1
2020-07-28,Kern,029,883053,24036,18834,116,18950,155
2020-07-28,Kings,031,150075,4661,3721,21,3742,41
2020-07-28,Lake,033,64148,225,179,0,179,1
2020-07-28,Lassen,035,31185,615,508,2,510,0
2020-07-28,Los Angeles,037,10098052,197722,179107,490,179597,4435
2020-07-28,Madera,039,155013,2691,1889,5,1894,18
2020-07-28,Marin,041,260295,5283,4698,5,4703,23
2020-07-28,Mariposa,043,17540,58,45,0,45,1
2020-07-28,Mendocino,045,87422,296,222,0,222,0
2020-07-28,Merced,047,269075,5522,3446,2,3448,23
2020-07-28,Modoc,049,8938,4,0,0,0,0
2020-07-28,Mono,051,14174,144,102,1,103,1
2020-07-28,Monterey,053,433212,5289,4047,14,4061,22
2020-07-28,Napa,055,140530,1108,824,0,824,6
2020-07-28,Nevada,057,99092,329,278,13,291,1
2020-07-28,Orange,059,3164182,42457,34832,793,35625,582
2020-07-28,Placer,061,380077,2209,1759,3,1762,14
2020-07-28,Plumas,063,18699,33,22,0,22,0
2020-07-28,Riverside,065,2383286,43722,36458,41,36499,668
2020-07-28,Sacramento,067,1510023,12288,9429,11,9440,117
2020-07-28,San Benito,069,59416,684,503,0,503,2
2020-07-28,San Bernardino,071,2135413,38810,30493,167,30660,412
2020-07-28,San Diego,073,3302833,31658,28007,6,28013,547
2020-07-28,San Francisco,075,870044,7084,5888,6,5894,56
2020-07-28,San Joaquin,077,732212,14100,10958,6,10964,141
2020-07-28,San Luis Obispo,079,281455,2066,1636,8,1644,9
2020-07-28,San Mateo,081,765935,6319,5171,7,5178,114
2020-07-28,Santa Barbara,083,443738,6631,6110,64,6174,31
2020-07-28,Santa Clara,085,1922200,12424,9307,29,9336,165
2020-07-28,Santa Cruz,087,273765,1267,1018,7,1025,4
2020-07-28,Shasta,089,179085,465,275,3,278,8
2020-07-28,Sierra,091,2930,2,1,0,1,0
2020-07-28,Siskiyou,093,43540,90,57,0,57,0
2020-07-28,Solano,095,438530,4171,3292,21,3313,29
2020-07-28,Sonoma,097,501317,3577,2553,7,2560,20
2020-07-28,Stanislaus,099,539301,11177,8492,27,8519,92
2020-07-28,Sutter,101,95872,811,653,0,653,2
2020-07-28,Tehama,103,63373,269,199,2,201,1
2020-07-28,Trinity,105,12862,26,3,6,9,0
2020-07-28,Tulare,107,460477,10903,8787,32,8819,96
2020-07-28,Tuolumne,109,53932,153,116,3,119,0
2020-07-28,Ventura,111,848112,8581,7045,28,7073,68
2020-07-28,Yolo,113,214977,1807,1459,3,1462,36
2020-07-28,Yuba,115,75493,470,333,0,333,1
2020-07-27,Alameda,001,1643700,13037,10645,43,10688,176
2020-07-27,Alpine,003,1148,2,2,0,2,0
2020-07-27,Amador,005,37829,148,72,0,72,0
2020-07-27,Butte,007,227075,1076,843,15,858,7
2020-07-27,Calaveras,009,45235,134,103,0,103,1
2020-07-27,Colusa,011,21464,356,271,0,271,2
2020-07-27,Contra Costa,013,1133247,9683,7256,27,7283,104
2020-07-27,Del Norte,015,27424,86,67,0,67,0
2020-07-27,El Dorado,017,186661,765,548,5,553,1
2020-07-27,Fresno,019,978130,20640,13485,178,13663,117
2020-07-27,Glenn,021,27897,362,277,0,277,1
2020-07-27,Humboldt,023,135768,253,218,1,219,4
2020-07-27,Imperial,025,180216,10162,7789,5,7794,144
2020-07-27,Inyo,027,18085,61,43,1,44,1
2020-07-27,Kern,029,883053,23534,17994,110,18104,148
2020-07-27,Kings,031,150075,4412,3685,21,3706,39
2020-07-27,Lake,033,64148,221,176,0,176,1
2020-07-27,Lassen,035,31185,615,503,2,505,0
2020-07-27,Los Angeles,037,10098052,195296,176351,472,176823,4379
2020-07-27,Madera,039,155013,2626,1793,5,1798,17
2020-07-27,Marin,041,260295,5195,4669,5,4674,22
2020-07-27,Mariposa,043,17540,58,43,0,43,1
2020-07-27,Mendocino,045,87422,282,209,0,209,0
2020-07-27,Merced,047,269075,5382,3292,2,3294,23
2020-07-27,Modoc,049,8938,3,0,0,0,0
2020-07-27,Mono,051,14174,140,99,1,100,1
2020-07-27,Monterey,053,433212,5100,3960,14,3974,21
2020-07-27,Napa,055,140530,1093,769,0,769,6
2020-07-27,Nevada,057,99092,325,268,13,281,1
2020-07-27,Orange,059,3164182,42017,34649,777,35426,566
2020-07-27,Placer,061,380077,2159,1679,3,1682,12
2020-07-27,Plumas,063,18699,33,22,0,22,0
2020-07-27,Riverside,065,2383286,43043,35822,41,35863,667
2020-07-27,Sacramento,067,1510023,11995,9091,11,9102,114
2020-07-27,San Benito,069,59416,669,498,0,498,2
2020-07-27,San Bernardino,071,2135413,38217,29928,157,30085,401
2020-07-27,San Diego,073,3302833,31284,27509,5,27514,533
2020-07-27,San Francisco,075,870044,6997,5825,6,5831,55
2020-07-27,San Joaquin,077,732212,13811,10728,6,10734,129
2020-07-27,San Luis Obispo,079,281455,2020,1612,8,1620,9
2020-07-27,San Mateo,081,765935,6210,5108,7,5115,113
2020-07-27,Santa Barbara,083,443738,6552,6026,62,6088,30
2020-07-27,Santa Clara,085,1922200,12155,9157,28,9185,166
2020-07-27,Santa Cruz,087,273765,1243,984,7,991,4
2020-07-27,Shasta,089,179085,458,275,3,278,8
2020-07-27,Sierra,091,2930,2,1,0,1,0
2020-07-27,Siskiyou,093,43540,88,54,0,54,0
2020-07-27,Solano,095,438530,4104,3198,20,3218,29
2020-07-27,Sonoma,097,501317,3486,2504,7,2511,20
2020-07-27,Stanislaus,099,539301,10951,8288,19,8307,84
2020-07-27,Sutter,101,95872,785,620,0,620,2
2020-07-27,Tehama,103,63373,261,192,2,194,1
2020-07-27,Trinity,105,12862,26,3,6,9,0
2020-07-27,Tulare,107,460477,10685,8462,32,8494,172
2020-07-27,Tuolumne,109,53932,150,115,3,118,0
2020-07-27,Ventura,111,848112,8453,6998,27,7025,68
2020-07-27,Yolo,113,214977,1762,1439,3,1442,33
2020-07-27,Yuba,115,75493,450,328,0,328,1
2020-07-26,Alameda,001,1643700,12799,10489,42,10531,176
2020-07-26,Alpine,003,1148,2,2,0,2,0
2020-07-26,Amador,005,37829,142,67,0,67,0
2020-07-26,Butte,007,227075,1039,822,15,837,5
2020-07-26,Calaveras,009,45235,131,103,0,103,1
2020-07-26,Colusa,011,21464,347,270,0,270,2
2020-07-26,Contra Costa,013,1133247,9446,7095,27,7122,104
2020-07-26,Del Norte,015,27424,84,67,0,67,0
2020-07-26,El Dorado,017,186661,747,539,5,544,1
2020-07-26,Fresno,019,978130,20249,13209,170,13379,117
2020-07-26,Glenn,021,27897,354,265,0,265,1
2020-07-26,Humboldt,023,135768,247,214,1,215,4
2020-07-26,Imperial,025,180216,10090,7781,5,7786,144
2020-07-26,Inyo,027,18085,56,43,1,44,1
2020-07-26,Kern,029,883053,23009,17394,107,17501,148
2020-07-26,Kings,031,150075,4353,3591,21,3612,39
2020-07-26,Lake,033,64148,213,174,0,174,1
2020-07-26,Lassen,035,31185,574,503,2,505,0
2020-07-26,Los Angeles,037,10098052,192727,174322,454,174776,4364
2020-07-26,Madera,039,155013,2539,1744,5,1749,17
2020-07-26,Marin,041,260295,5149,4595,5,4600,22
2020-07-26,Mariposa,043,17540,56,43,0,43,1
2020-07-26,Mendocino,045,87422,273,206,0,206,0
2020-07-26,Merced,047,269075,5202,3251,2,3253,23
2020-07-26,Modoc,049,8938,3,0,0,0,0
2020-07-26,Mono,051,14174,136,82,1,83,1
2020-07-26,Monterey,053,433212,4934,3901,14,3915,21
2020-07-26,Napa,055,140530,1074,769,0,769,6
2020-07-26,Nevada,057,99092,322,261,13,274,1
2020-07-26,Orange,059,3164182,41492,34352,746,35098,564
2020-07-26,Placer,061,380077,2095,1628,3,1631,12
2020-07-26,Plumas,063,18699,33,22,0,22,0
2020-07-26,Riverside,065,2383286,42483,35636,41,35677,665
2020-07-26,Sacramento,067,1510023,11690,8972,11,8983,114
2020-07-26,San Benito,069,59416,657,495,0,495,2
2020-07-26,San Bernardino,071,2135413,37576,29545,149,29694,400
2020-07-26,San Diego,073,3302833,30888,26986,4,26990,533
2020-07-26,San Francisco,075,870044,6891,5823,6,5829,55
2020-07-26,San Joaquin,077,732212,13518,10637,6,10643,129
2020-07-26,San Luis Obispo,079,281455,1978,1565,8,1573,8
2020-07-26,San Mateo,081,765935,6105,5078,7,5085,113
2020-07-26,Santa Barbara,083,443738,6451,5939,62,6001,30
2020-07-26,Santa Clara,085,1922200,11926,8986,28,9014,166
2020-07-26,Santa Cruz,087,273765,1216,970,7,977,4
2020-07-26,Shasta,089,179085,451,265,3,268,8
2020-07-26,Sierra,091,2930,2,1,0,1,0
2020-07-26,Siskiyou,093,43540,86,54,0,54,0
2020-07-26,Solano,095,438530,4024,3197,18,3215,29
2020-07-26,Sonoma,097,501317,3397,2503,6,2509,20
2020-07-26,Stanislaus,099,539301,10690,8228,18,8246,84
2020-07-26,Sutter,101,95872,771,612,0,612,2
2020-07-26,Tehama,103,63373,254,175,2,177,1
2020-07-26,Trinity,105,12862,26,3,6,9,0
2020-07-26,Tulare,107,460477,10479,8392,32,8424,172
2020-07-26,Tuolumne,109,53932,145,113,3,116,0
2020-07-26,Ventura,111,848112,8246,6844,27,6871,67
2020-07-26,Yolo,113,214977,1731,1408,3,1411,33
2020-07-26,Yuba,115,75493,431,313,0,313,1
2020-07-25,Alameda,001,1643700,12702,10361,40,10401,176
2020-07-25,Alpine,003,1148,2,2,0,2,0
2020-07-25,Amador,005,37829,139,67,0,67,0
2020-07-25,Butte,007,227075,1030,810,15,825,5
2020-07-25,Calaveras,009,45235,127,103,0,103,1
2020-07-25,Colusa,011,21464,340,265,0,265,2
2020-07-25,Contra Costa,013,1133247,9302,6920,27,6947,104
2020-07-25,Del Norte,015,27424,84,67,0,67,0
2020-07-25,El Dorado,017,186661,736,528,5,533,1
2020-07-25,Fresno,019,978130,20062,12866,170,13036,117
2020-07-25,Glenn,021,27897,352,260,0,260,1
2020-07-25,Humboldt,023,135768,244,212,1,213,4
2020-07-25,Imperial,025,180216,10064,7727,5,7732,144
2020-07-25,Inyo,027,18085,55,43,1,44,1
2020-07-25,Kern,029,883053,22791,16910,106,17016,148
2020-07-25,Kings,031,150075,4336,3516,21,3537,39
2020-07-25,Lake,033,64148,211,173,0,173,1
2020-07-25,Lassen,035,31185,574,503,2,505,0
2020-07-25,Los Angeles,037,10098052,191592,172611,447,173058,4357
2020-07-25,Madera,039,155013,2507,1724,5,1729,17
2020-07-25,Marin,041,260295,5133,4562,5,4567,22
2020-07-25,Mariposa,043,17540,55,43,0,43,1
2020-07-25,Mendocino,045,87422,267,190,0,190,0
2020-07-25,Merced,047,269075,5123,3176,2,3178,23
2020-07-25,Modoc,049,8938,3,0,0,0,0
2020-07-25,Mono,051,14174,136,82,1,83,1
2020-07-25,Monterey,053,433212,4857,3805,14,3819,21
2020-07-25,Napa,055,140530,1061,746,0,746,6
2020-07-25,Nevada,057,99092,320,257,13,270,1
2020-07-25,Orange,059,3164182,41273,33978,725,34703,561
2020-07-25,Placer,061,380077,2079,1596,3,1599,12
2020-07-25,Plumas,063,18699,33,22,0,22,0
2020-07-25,Riverside,065,2383286,42214,34921,41,34962,655
2020-07-25,Sacramento,067,1510023,11544,8674,11,8685,113
2020-07-25,San Benito,069,59416,641,492,0,492,2
2020-07-25,San Bernardino,071,2135413,37298,29265,146,29411,394
2020-07-25,San Diego,073,3302833,30627,26703,3,26706,533
2020-07-25,San Francisco,075,870044,6833,5644,6,5650,55
2020-07-25,San Joaquin,077,732212,13392,10347,5,10352,129
2020-07-25,San Luis Obispo,079,281455,1958,1530,7,1537,8
2020-07-25,San Mateo,081,765935,6042,5023,7,5030,113
2020-07-25,Santa Barbara,083,443738,6416,5880,62,5942,30
2020-07-25,Santa Clara,085,1922200,11792,8767,28,8795,166
2020-07-25,Santa Cruz,087,273765,1199,939,7,946,4
2020-07-25,Shasta,089,179085,446,263,1,264,8
2020-07-25,Sierra,091,2930,2,1,0,1,0
2020-07-25,Siskiyou,093,43540,84,54,0,54,0
2020-07-25,Solano,095,438530,3984,3107,16,3123,29
2020-07-25,Sonoma,097,501317,3358,2412,6,2418,20
2020-07-25,Stanislaus,099,539301,10587,7994,15,8009,84
2020-07-25,Sutter,101,95872,752,603,0,603,2
2020-07-25,Tehama,103,63373,253,169,2,171,1
2020-07-25,Trinity,105,12862,26,3,6,9,0
2020-07-25,Tulare,107,460477,10379,8310,32,8342,172
2020-07-25,Tuolumne,109,53932,144,99,3,102,0
2020-07-25,Ventura,111,848112,8173,6662,27,6689,62
2020-07-25,Yolo,113,214977,1716,1357,3,1360,35
2020-07-25,Yuba,115,75493,425,312,0,312,1
2020-07-24,Alameda,001,1643700,12560,10216,37,10253,176
2020-07-24,Alpine,003,1148,2,2,0,2,0
2020-07-24,Amador,005,37829,137,66,0,66,0
2020-07-24,Butte,007,227075,1018,751,15,766,5
2020-07-24,Calaveras,009,45235,123,102,0,102,0
2020-07-24,Colusa,011,21464,337,255,0,255,2
2020-07-24,Contra Costa,013,1133247,9157,6814,27,6841,100
2020-07-24,Del Norte,015,27424,84,66,0,66,0
2020-07-24,El Dorado,017,186661,714,516,5,521,1
2020-07-24,Fresno,019,978130,19837,12564,170,12734,115
2020-07-24,Glenn,021,27897,349,251,0,251,1
2020-07-24,Humboldt,023,135768,241,210,1,211,4
2020-07-24,Imperial,025,180216,10042,7686,5,7691,141
2020-07-24,Inyo,027,18085,55,41,1,42,1
2020-07-24,Kern,029,883053,22550,16124,106,16230,143
2020-07-24,Kings,031,150075,4306,3471,21,3492,39
2020-07-24,Lake,033,64148,209,167,0,167,1
2020-07-24,Lassen,035,31185,574,503,2,505,0
2020-07-24,Los Angeles,037,10098052,189567,169078,436,169514,4302
2020-07-24,Madera,039,155013,2474,1679,5,1684,16
2020-07-24,Marin,041,260295,5106,4517,5,4522,22
2020-07-24,Mariposa,043,17540,55,41,0,41,1
2020-07-24,Mendocino,045,87422,260,188,0,188,0
2020-07-24,Merced,047,269075,5038,3100,2,3102,23
2020-07-24,Modoc,049,8938,3,0,0,0,0
2020-07-24,Mono,051,14174,135,82,1,83,1
2020-07-24,Monterey,053,433212,4785,3748,14,3762,21
2020-07-24,Napa,055,140530,1048,741,0,741,6
2020-07-24,Nevada,057,99092,317,255,13,268,1
2020-07-24,Orange,059,3164182,40986,33530,709,34239,557
2020-07-24,Placer,061,380077,2048,1551,3,1554,12
2020-07-24,Plumas,063,18699,33,22,0,22,0
2020-07-24,Riverside,065,2383286,41790,34513,40,34553,631
2020-07-24,Sacramento,067,1510023,11356,8570,11,8581,110
2020-07-24,San Benito,069,59416,634,485,0,485,2
2020-07-24,San Bernardino,071,2135413,36927,28990,141,29131,386
2020-07-24,San Diego,073,3302833,30327,26100,3,26103,524
2020-07-24,San Francisco,075,870044,6739,5611,6,5617,55
2020-07-24,San Joaquin,077,732212,13243,10190,5,10195,118
2020-07-24,San Luis Obispo,079,281455,1934,1476,7,1483,8
2020-07-24,San Mateo,081,765935,5979,4954,7,4961,112
2020-07-24,Santa Barbara,083,443738,6363,5776,60,5836,30
2020-07-24,Santa Clara,085,1922200,11627,8658,28,8686,165
2020-07-24,Santa Cruz,087,273765,1179,930,7,937,4
2020-07-24,Shasta,089,179085,438,262,1,263,8
2020-07-24,Sierra,091,2930,2,1,0,1,0
2020-07-24,Siskiyou,093,43540,84,53,0,53,0
2020-07-24,Solano,095,438530,3948,3062,13,3075,29
2020-07-24,Sonoma,097,501317,3306,2345,6,2351,20
2020-07-24,Stanislaus,099,539301,10415,7861,12,7873,82
2020-07-24,Sutter,101,95872,741,593,0,593,2
2020-07-24,Tehama,103,63373,245,170,2,172,1
2020-07-24,Trinity,105,12862,25,3,6,9,0
2020-07-24,Tulare,107,460477,10285,8167,30,8197,167
2020-07-24,Tuolumne,109,53932,138,99,3,102,0
2020-07-24,Ventura,111,848112,8088,6553,27,6580,60
2020-07-24,Yolo,113,214977,1702,1329,3,1332,35
2020-07-24,Yuba,115,75493,410,307,0,307,1
2020-07-23,Alameda,001,1643700,12318,9924,37,9961,171
2020-07-23,Alpine,003,1148,2,2,0,2,0
2020-07-23,Amador,005,37829,120,61,0,61,0
2020-07-23,Butte,007,227075,1003,726,14,740,5
2020-07-23,Calaveras,009,45235,116,102,0,102,0
2020-07-23,Colusa,011,21464,329,242,0,242,2
2020-07-23,Contra Costa,013,1133247,8958,6619,25,6644,98
2020-07-23,Del Norte,015,27424,84,66,0,66,0
2020-07-23,El Dorado,017,186661,703,491,5,496,1
2020-07-23,Fresno,019,978130,19480,12164,167,12331,112
2020-07-23,Glenn,021,27897,344,246,0,246,1
2020-07-23,Humboldt,023,135768,240,208,1,209,4
2020-07-23,Imperial,025,180216,9992,7604,5,7609,138
2020-07-23,Inyo,027,18085,53,38,1,39,1
2020-07-23,Kern,029,883053,22143,14491,102,14593,128
2020-07-23,Kings,031,150075,4194,3371,21,3392,39
2020-07-23,Lake,033,64148,200,160,0,160,1
2020-07-23,Lassen,035,31185,571,503,2,505,0
2020-07-23,Los Angeles,037,10098052,187016,167198,410,167608,4265
2020-07-23,Madera,039,155013,2408,1659,4,1663,13
2020-07-23,Marin,041,260295,5054,4423,5,4428,22
2020-07-23,Mariposa,043,17540,55,40,0,40,1
2020-07-23,Mendocino,045,87422,250,178,0,178,0
2020-07-23,Merced,047,269075,4881,2972,2,2974,22
2020-07-23,Modoc,049,8938,3,0,0,0,0
2020-07-23,Mono,051,14174,131,82,1,83,1
2020-07-23,Monterey,053,433212,4668,3655,14,3669,21
2020-07-23,Napa,055,140530,1024,713,0,713,5
2020-07-23,Nevada,057,99092,314,247,13,260,1
2020-07-23,Orange,059,3164182,40489,32863,679,33542,544
2020-07-23,Placer,061,380077,2004,1519,3,1522,12
2020-07-23,Plumas,063,18699,32,21,0,21,0
2020-07-23,Riverside,065,2383286,41185,33833,40,33873,630
2020-07-23,Sacramento,067,1510023,11123,8222,11,8233,108
2020-07-23,San Benito,069,59416,619,478,0,478,2
2020-07-23,San Bernardino,071,2135413,36408,28121,135,28256,369
2020-07-23,San Diego,073,3302833,29953,25109,3,25112,505
2020-07-23,San Francisco,075,870044,6638,5543,6,5549,55
2020-07-23,San Joaquin,077,732212,13024,9861,5,9866,111
2020-07-23,San Luis Obispo,079,281455,1905,1438,7,1445,7
2020-07-23,San Mateo,081,765935,5874,4895,7,4902,113
2020-07-23,Santa Barbara,083,443738,6290,5628,60,5688,30
2020-07-23,Santa Clara,085,1922200,11408,8458,28,8486,165
2020-07-23,Santa Cruz,087,273765,1143,887,7,894,3
2020-07-23,Shasta,089,179085,427,254,1,255,9
2020-07-23,Sierra,091,2930,2,1,0,1,0
2020-07-23,Siskiyou,093,43540,82,53,0,53,0
2020-07-23,Solano,095,438530,3884,2962,11,2973,29
2020-07-23,Sonoma,097,501317,3230,2289,6,2295,18
2020-07-23,Stanislaus,099,539301,10173,7603,12,7615,71
2020-07-23,Sutter,101,95872,708,570,0,570,2
2020-07-23,Tehama,103,63373,239,158,2,160,1
2020-07-23,Trinity,105,12862,24,3,6,9,0
2020-07-23,Tulare,107,460477,10096,7898,30,7928,168
2020-07-23,Tuolumne,109,53932,138,93,3,96,0
2020-07-23,Ventura,111,848112,7964,6303,27,6330,56
2020-07-23,Yolo,113,214977,1683,1279,3,1282,35
2020-07-23,Yuba,115,75493,390,297,0,297,1
2020-07-22,Alameda,001,1643700,12100,9678,36,9714,169
2020-07-22,Alpine,003,1148,2,2,0,2,0
2020-07-22,Amador,005,37829,118,58,0,58,0
2020-07-22,Butte,007,227075,967,694,14,708,5
2020-07-22,Calaveras,009,45235,116,98,0,98,0
2020-07-22,Colusa,011,21464,322,236,0,236,0
2020-07-22,Contra Costa,013,1133247,8732,6401,25,6426,98
2020-07-22,Del Norte,015,27424,84,66,0,66,0
2020-07-22,El Dorado,017,186661,690,466,5,471,1
2020-07-22,Fresno,019,978130,19117,11756,161,11917,110
2020-07-22,Glenn,021,27897,338,236,0,236,1
2020-07-22,Humboldt,023,135768,238,201,1,202,4
2020-07-22,Imperial,025,180216,9932,7533,5,7538,134
2020-07-22,Inyo,027,18085,49,38,1,39,1
2020-07-22,Kern,029,883053,21711,13513,94,13607,127
2020-07-22,Kings,031,150075,4138,3271,21,3292,38
2020-07-22,Lake,033,64148,197,160,0,160,1
2020-07-22,Lassen,035,31185,568,500,2,502,0
2020-07-22,Los Angeles,037,10098052,184366,165242,389,165631,4218
2020-07-22,Madera,039,155013,2333,1578,4,1582,10
2020-07-22,Marin,041,260295,4998,4373,5,4378,23
2020-07-22,Mariposa,043,17540,55,38,0,38,1
2020-07-22,Mendocino,045,87422,243,166,0,166,0
2020-07-22,Merced,047,269075,4755,2828,2,2830,15
2020-07-22,Modoc,049,8938,3,0,0,0,0
2020-07-22,Mono,051,14174,128,82,1,83,1
2020-07-22,Monterey,053,433212,4567,3533,14,3547,20
2020-07-22,Napa,055,140530,1002,687,0,687,5
2020-07-22,Nevada,057,99092,308,239,12,251,1
2020-07-22,Orange,059,3164182,39990,32047,670,32717,522
2020-07-22,Placer,061,380077,1948,1469,3,1472,12
2020-07-22,Plumas,063,18699,31,20,0,20,0
2020-07-22,Riverside,065,2383286,40549,33093,40,33133,612
2020-07-22,Sacramento,067,1510023,10861,8028,11,8039,106
2020-07-22,San Benito,069,59416,605,465,0,465,2
2020-07-22,San Bernardino,071,2135413,35886,26820,124,26944,348
2020-07-22,San Diego,073,3302833,29565,25109,2,25111,505
2020-07-22,San Francisco,075,870044,6534,5473,5,5478,53
2020-07-22,San Joaquin,077,732212,12748,9628,5,9633,102
2020-07-22,San Luis Obispo,079,281455,1859,1373,7,1380,7
2020-07-22,San Mateo,081,765935,5785,4796,7,4803,112
2020-07-22,Santa Barbara,083,443738,6206,5508,58,5566,29
2020-07-22,Santa Clara,085,1922200,11164,8266,28,8294,166
2020-07-22,Santa Cruz,087,273765,1119,866,7,873,3
2020-07-22,Shasta,089,179085,417,246,1,247,9
2020-07-22,Sierra,091,2930,1,1,0,1,0
2020-07-22,Siskiyou,093,43540,81,52,0,52,0
2020-07-22,Solano,095,438530,3823,2839,10,2849,29
2020-07-22,Sonoma,097,501317,3153,2255,6,2261,17
2020-07-22,Stanislaus,099,539301,10002,7401,12,7413,71
2020-07-22,Sutter,101,95872,684,551,0,551,2
2020-07-22,Tehama,103,63373,231,155,2,157,1
2020-07-22,Trinity,105,12862,23,3,6,9,0
2020-07-22,Tulare,107,460477,9863,7640,30,7670,167
2020-07-22,Tuolumne,109,53932,134,91,3,94,0
2020-07-22,Ventura,111,848112,7836,6223,25,6248,56
2020-07-22,Yolo,113,214977,1640,1233,3,1236,34
2020-07-22,Yuba,115,75493,375,288,0,288,1
2020-07-21,Alameda,001,1643700,11887,9390,36,9426,166
2020-07-21,Alpine,003,1148,2,2,0,2,0
2020-07-21,Amador,005,37829,113,55,0,55,0
2020-07-21,Butte,007,227075,922,659,13,672,5
2020-07-21,Calaveras,009,45235,110,96,0,96,0
2020-07-21,Colusa,011,21464,298,227,0,227,0
2020-07-21,Contra Costa,013,1133247,8490,6210,25,6235,98
2020-07-21,Del Norte,015,27424,84,66,0,66,0
2020-07-21,El Dorado,017,186661,682,440,5,445,1
2020-07-21,Fresno,019,978130,18717,11412,155,11567,107
2020-07-21,Glenn,021,27897,331,229,0,229,1
2020-07-21,Humboldt,023,135768,236,198,1,199,4
2020-07-21,Imperial,025,180216,9883,7458,5,7463,128
2020-07-21,Inyo,027,18085,48,38,1,39,1
2020-07-21,Kern,029,883053,21289,11998,88,12086,119
2020-07-21,Kings,031,150075,4073,3187,20,3207,38
2020-07-21,Lake,033,64148,197,157,0,157,1
2020-07-21,Lassen,035,31185,566,474,2,476,0
2020-07-21,Los Angeles,037,10098052,181376,162205,367,162572,4159
2020-07-21,Madera,039,155013,2268,1508,3,1511,10
2020-07-21,Marin,041,260295,4926,4318,5,4323,21
2020-07-21,Mariposa,043,17540,54,37,0,37,1
2020-07-21,Mendocino,045,87422,232,160,0,160,0
2020-07-21,Merced,047,269075,4576,2725,2,2727,15
2020-07-21,Modoc,049,8938,3,0,0,0,0
2020-07-21,Mono,051,14174,124,79,1,80,1
2020-07-21,Monterey,053,433212,4435,3404,13,3417,20
2020-07-21,Napa,055,140530,975,660,0,660,5
2020-07-21,Nevada,057,99092,306,228,10,238,1
2020-07-21,Orange,059,3164182,39494,31356,638,31994,515
2020-07-21,Placer,061,380077,1907,1413,3,1416,11
2020-07-21,Plumas,063,18699,31,19,0,19,0
2020-07-21,Riverside,065,2383286,39847,32231,40,32271,583
2020-07-21,Sacramento,067,1510023,10589,7789,10,7799,102
2020-07-21,San Benito,069,59416,594,444,0,444,2
2020-07-21,San Bernardino,071,2135413,35239,25323,117,25440,343
2020-07-21,San Diego,073,3302833,29116,24522,2,24524,487
2020-07-21,San Francisco,075,870044,6425,5377,5,5382,53
2020-07-21,San Joaquin,077,732212,12419,9150,5,9155,99
2020-07-21,San Luis Obispo,079,281455,1810,1338,7,1345,7
2020-07-21,San Mateo,081,765935,5693,4733,7,4740,111
2020-07-21,Santa Barbara,083,443738,6126,5422,57,5479,29
2020-07-21,Santa Clara,085,1922200,10901,7989,28,8017,164
2020-07-21,Santa Cruz,087,273765,1086,835,7,842,3
2020-07-21,Shasta,089,179085,409,241,1,242,9
2020-07-21,Sierra,091,2930,1,1,0,1,0
2020-07-21,Siskiyou,093,43540,81,48,0,48,0
2020-07-21,Solano,095,438530,3750,2727,10,2737,27
2020-07-21,Sonoma,097,501317,3096,2200,6,2206,17
2020-07-21,Stanislaus,099,539301,9739,6984,12,6996,69
2020-07-21,Sutter,101,95872,668,533,0,533,2
2020-07-21,Tehama,103,63373,221,150,2,152,1
2020-07-21,Trinity,105,12862,23,2,6,8,0
2020-07-21,Tulare,107,460477,9661,7447,30,7477,167
2020-07-21,Tuolumne,109,53932,132,75,3,78,0
2020-07-21,Ventura,111,848112,7704,6131,25,6156,55
2020-07-21,Yolo,113,214977,1586,1204,3,1207,34
2020-07-21,Yuba,115,75493,369,269,0,269,1
2020-07-20,Alameda,001,1643700,11632,9244,35,9279,162
2020-07-20,Alpine,003,1148,2,2,0,2,0
2020-07-20,Amador,005,37829,110,53,0,53,0
2020-07-20,Butte,007,227075,885,586,13,599,4
2020-07-20,Calaveras,009,45235,107,90,0,90,0
2020-07-20,Colusa,011,21464,287,217,0,217,0
2020-07-20,Contra Costa,013,1133247,8282,5823,25,5848,97
2020-07-20,Del Norte,015,27424,84,61,0,61,0
2020-07-20,El Dorado,017,186661,659,407,5,412,0
2020-07-20,Fresno,019,978130,18275,10891,154,11045,106
2020-07-20,Glenn,021,27897,323,225,0,225,1
2020-07-20,Humboldt,023,135768,229,194,1,195,4
2020-07-20,Imperial,025,180216,9843,7337,5,7342,124
2020-07-20,Inyo,027,18085,46,38,1,39,1
2020-07-20,Kern,029,883053,20779,10908,84,10992,118
2020-07-20,Kings,031,150075,4023,3093,20,3113,37
2020-07-20,Lake,033,64148,194,147,0,147,1
2020-07-20,Lassen,035,31185,564,474,2,476,0
2020-07-20,Los Angeles,037,10098052,178414,159202,341,159543,4108
2020-07-20,Madera,039,155013,2193,1433,3,1436,10
2020-07-20,Marin,041,260295,4844,4255,5,4260,21
2020-07-20,Mariposa,043,17540,53,36,0,36,1
2020-07-20,Mendocino,045,87422,219,153,0,153,0
2020-07-20,Merced,047,269075,4406,2584,2,2586,15
2020-07-20,Modoc,049,8938,3,0,0,0,0
2020-07-20,Mono,051,14174,118,78,1,79,1
2020-07-20,Monterey,053,433212,4329,3205,13,3218,19
2020-07-20,Napa,055,140530,940,632,0,632,5
2020-07-20,Nevada,057,99092,298,218,10,228,1
2020-07-20,Orange,059,3164182,38884,30337,608,30945,507
2020-07-20,Placer,061,380077,1856,1364,3,1367,11
2020-07-20,Plumas,063,18699,30,17,0,17,0
2020-07-20,Riverside,065,2383286,39016,31163,40,31203,581
2020-07-20,Sacramento,067,1510023,10261,7369,10,7379,99
2020-07-20,San Benito,069,59416,576,433,0,433,2
2020-07-20,San Bernardino,071,2135413,34429,24226,113,24339,338
2020-07-20,San Diego,073,3302833,28674,24137,2,24139,478
2020-07-20,San Francisco,075,870044,6304,5090,5,5095,53
2020-07-20,San Joaquin,077,732212,12063,8583,5,8588,97
2020-07-20,San Luis Obispo,079,281455,1768,1282,7,1289,6
2020-07-20,San Mateo,081,765935,5593,4609,7,4616,111
2020-07-20,Santa Barbara,083,443738,6016,5266,55,5321,29
2020-07-20,Santa Clara,085,1922200,10673,7711,27,7738,164
2020-07-20,Santa Cruz,087,273765,1054,758,7,765,3
2020-07-20,Shasta,089,179085,394,233,1,234,9
2020-07-20,Sierra,091,2930,1,1,0,1,0
2020-07-20,Siskiyou,093,43540,77,42,0,42,0
2020-07-20,Solano,095,438530,3667,2537,10,2547,26
2020-07-20,Sonoma,097,501317,2989,2148,6,2154,17
2020-07-20,Stanislaus,099,539301,9455,6835,12,6847,58
2020-07-20,Sutter,101,95872,635,507,0,507,2
2020-07-20,Tehama,103,63373,211,146,2,148,1
2020-07-20,Trinity,105,12862,23,2,6,8,0
2020-07-20,Tulare,107,460477,9428,6974,30,7004,166
2020-07-20,Tuolumne,109,53932,131,75,3,78,0
2020-07-20,Ventura,111,848112,7570,5912,25,5937,52
2020-07-20,Yolo,113,214977,1545,1155,3,1158,30
2020-07-20,Yuba,115,75493,349,258,0,258,1
2020-07-19,Alameda,001,1643700,11391,9227,29,9256,162
2020-07-19,Alpine,003,1148,2,2,0,2,0
2020-07-19,Amador,005,37829,103,51,0,51,0
2020-07-19,Butte,007,227075,860,555,13,568,4
2020-07-19,Calaveras,009,45235,105,89,0,89,0
2020-07-19,Colusa,011,21464,279,187,0,187,0
2020-07-19,Contra Costa,013,1133247,7991,5691,23,5714,95
2020-07-19,Del Norte,015,27424,83,61,0,61,0
2020-07-19,El Dorado,017,186661,641,385,5,390,0
2020-07-19,Fresno,019,978130,17751,10639,142,10781,106
2020-07-19,Glenn,021,27897,309,215,0,215,0
2020-07-19,Humboldt,023,135768,221,195,1,196,4
2020-07-19,Imperial,025,180216,9752,7280,5,7285,124
2020-07-19,Inyo,027,18085,42,38,1,39,1
2020-07-19,Kern,029,883053,20162,10094,77,10171,115
2020-07-19,Kings,031,150075,3937,3035,20,3055,37
2020-07-19,Lake,033,64148,189,144,0,144,1
2020-07-19,Lassen,035,31185,545,474,2,476,0
2020-07-19,Los Angeles,037,10098052,174968,156039,318,156357,4100
2020-07-19,Madera,039,155013,2116,1301,3,1304,10
2020-07-19,Marin,041,260295,4789,4172,5,4177,21
2020-07-19,Mariposa,043,17540,49,35,0,35,1
2020-07-19,Mendocino,045,87422,214,137,0,137,0
2020-07-19,Merced,047,269075,4199,2460,2,2462,15
2020-07-19,Modoc,049,8938,3,0,0,0,0
2020-07-19,Mono,051,14174,107,63,1,64,1
2020-07-19,Monterey,053,433212,4210,3079,13,3092,18
2020-07-19,Napa,055,140530,911,612,0,612,5
2020-07-19,Nevada,057,99092,292,210,10,220,1
2020-07-19,Orange,059,3164182,38320,29941,595,30536,505
2020-07-19,Placer,061,380077,1809,1246,3,1249,11
2020-07-19,Plumas,063,18699,30,17,0,17,0
2020-07-19,Riverside,065,2383286,38311,30340,40,30380,581
2020-07-19,Sacramento,067,1510023,9868,6985,10,6995,97
2020-07-19,San Benito,069,59416,560,412,0,412,2
2020-07-19,San Bernardino,071,2135413,33656,23928,101,24029,337
2020-07-19,San Diego,073,3302833,28173,23684,2,23686,478
2020-07-19,San Francisco,075,870044,6158,5094,5,5099,52
2020-07-19,San Joaquin,077,732212,11657,8308,5,8313,93
2020-07-19,San Luis Obispo,079,281455,1724,1262,7,1269,6
2020-07-19,San Mateo,081,765935,5489,4522,7,4529,110
2020-07-19,Santa Barbara,083,443738,5914,5145,52,5197,29
2020-07-19,Santa Clara,085,1922200,10429,7403,27,7430,164
2020-07-19,Santa Cruz,087,273765,1010,753,7,760,3
2020-07-19,Shasta,089,179085,381,218,1,219,9
2020-07-19,Sierra,091,2930,1,1,0,1,0
2020-07-19,Siskiyou,093,43540,75,42,0,42,0
2020-07-19,Solano,095,438530,3562,2551,10,2561,26
2020-07-19,Sonoma,097,501317,2889,2074,6,2080,17
2020-07-19,Stanislaus,099,539301,9159,6508,12,6520,58
2020-07-19,Sutter,101,95872,604,480,0,480,2
2020-07-19,Tehama,103,63373,207,138,2,140,1
2020-07-19,Trinity,105,12862,23,2,6,8,0
2020-07-19,Tulare,107,460477,9180,6856,30,6886,166
2020-07-19,Tuolumne,109,53932,126,75,3,78,0
2020-07-19,Ventura,111,848112,7380,5706,25,5731,52
2020-07-19,Yolo,113,214977,1505,1127,3,1130,30
2020-07-19,Yuba,115,75493,329,240,0,240,1
2020-07-18,Alameda,001,1643700,11254,9089,28,9117,162
2020-07-18,Alpine,003,1148,2,2,0,2,0
2020-07-18,Amador,005,37829,99,49,0,49,0
2020-07-18,Butte,007,227075,851,551,13,564,4
2020-07-18,Calaveras,009,45235,101,89,0,89,0
2020-07-18,Colusa,011,21464,274,182,0,182,0
2020-07-18,Contra Costa,013,1133247,7857,5617,23,5640,95
2020-07-18,Del Norte,015,27424,83,61,0,61,0
2020-07-18,El Dorado,017,186661,638,385,5,390,0
2020-07-18,Fresno,019,978130,17502,10381,140,10521,106
2020-07-18,Glenn,021,27897,303,212,0,212,0
2020-07-18,Humboldt,023,135768,218,189,1,190,4
2020-07-18,Imperial,025,180216,9721,7268,5,7273,124
2020-07-18,Inyo,027,18085,42,38,1,39,1
2020-07-18,Kern,029,883053,19859,9250,74,9324,114
2020-07-18,Kings,031,150075,3897,2996,19,3015,37
2020-07-18,Lake,033,64148,186,142,0,142,1
2020-07-18,Lassen,035,31185,544,474,2,476,0
2020-07-18,Los Angeles,037,10098052,173522,153265,308,153573,4088
2020-07-18,Madera,039,155013,2070,1260,3,1263,9
2020-07-18,Marin,041,260295,4760,4089,5,4094,21
2020-07-18,Mariposa,043,17540,49,35,0,35,1
2020-07-18,Mendocino,045,87422,208,137,0,137,0
2020-07-18,Merced,047,269075,4080,2424,2,2426,15
2020-07-18,Modoc,049,8938,3,0,0,0,0
2020-07-18,Mono,051,14174,105,54,1,55,1
2020-07-18,Monterey,053,433212,4142,3020,13,3033,17
2020-07-18,Napa,055,140530,900,609,0,609,5
2020-07-18,Nevada,057,99092,288,204,9,213,1
2020-07-18,Orange,059,3164182,38001,29603,575,30178,493
2020-07-18,Placer,061,380077,1786,1233,3,1236,11
2020-07-18,Plumas,063,18699,30,17,0,17,0
2020-07-18,Riverside,065,2383286,37957,30245,39,30284,581
2020-07-18,Sacramento,067,1510023,9623,6739,10,6749,95
2020-07-18,San Benito,069,59416,545,407,0,407,2
2020-07-18,San Bernardino,071,2135413,33196,23680,94,23774,336
2020-07-18,San Diego,073,3302833,27870,23116,2,23118,478
2020-07-18,San Francisco,075,870044,6056,5051,5,5056,52
2020-07-18,San Joaquin,077,732212,11444,8118,5,8123,93
2020-07-18,San Luis Obispo,079,281455,1689,1234,7,1241,6
2020-07-18,San Mateo,081,765935,5429,4488,7,4495,110
2020-07-18,Santa Barbara,083,443738,5854,5110,50,5160,29
2020-07-18,Santa Clara,085,1922200,10280,7255,26,7281,164
2020-07-18,Santa Cruz,087,273765,993,751,7,758,3
2020-07-18,Shasta,089,179085,372,216,1,217,9
2020-07-18,Sierra,091,2930,1,1,0,1,0
2020-07-18,Siskiyou,093,43540,71,42,0,42,0
2020-07-18,Solano,095,438530,3521,2503,10,2513,26
2020-07-18,Sonoma,097,501317,2838,2019,6,2025,15
2020-07-18,Stanislaus,099,539301,9024,6344,12,6356,58
2020-07-18,Sutter,101,95872,598,473,0,473,2
2020-07-18,Tehama,103,63373,202,136,2,138,1
2020-07-18,Trinity,105,12862,23,2,6,8,0
2020-07-18,Tulare,107,460477,9089,6810,29,6839,167
2020-07-18,Tuolumne,109,53932,123,75,3,78,0
2020-07-18,Ventura,111,848112,7298,5630,25,5655,52
2020-07-18,Yolo,113,214977,1477,1077,3,1080,30
2020-07-18,Yuba,115,75493,318,237,0,237,1
2020-07-17,Alameda,001,1643700,11113,8893,27,8920,160
2020-07-17,Alpine,003,1148,2,1,0,1,0
2020-07-17,Amador,005,37829,97,48,0,48,0
2020-07-17,Butte,007,227075,837,497,13,510,4
2020-07-17,Calaveras,009,45235,99,86,0,86,0
2020-07-17,Colusa,011,21464,272,146,0,146,0
2020-07-17,Contra Costa,013,1133247,7709,5483,23,5506,93
2020-07-17,Del Norte,015,27424,82,60,0,60,0
2020-07-17,El Dorado,017,186661,622,368,5,373,0
2020-07-17,Fresno,019,978130,17204,9954,140,10094,104
2020-07-17,Glenn,021,27897,296,203,0,203,0
2020-07-17,Humboldt,023,135768,217,185,1,186,4
2020-07-17,Imperial,025,180216,9699,7193,5,7198,120
2020-07-17,Inyo,027,18085,42,38,1,39,1
2020-07-17,Kern,029,883053,19539,8291,73,8364,113
2020-07-17,Kings,031,150075,3858,2978,19,2997,37
2020-07-17,Lake,033,64148,184,139,0,139,1
2020-07-17,Lassen,035,31185,525,391,2,393,0
2020-07-17,Los Angeles,037,10098052,171150,150481,296,150777,4052
2020-07-17,Madera,039,155013,2026,1214,3,1217,9
2020-07-17,Marin,041,260295,4723,3839,5,3844,21
2020-07-17,Mariposa,043,17540,47,35,0,35,1
2020-07-17,Mendocino,045,87422,200,126,0,126,0
2020-07-17,Merced,047,269075,4004,2328,2,2330,12
2020-07-17,Modoc,049,8938,2,0,0,0,0
2020-07-17,Mono,051,14174,100,54,1,55,1
2020-07-17,Monterey,053,433212,4013,2922,13,2935,18
2020-07-17,Napa,055,140530,886,598,0,598,5
2020-07-17,Nevada,057,99092,281,200,9,209,1
2020-07-17,Orange,059,3164182,37538,28962,542,29504,485
2020-07-17,Placer,061,380077,1757,1207,3,1210,11
2020-07-17,Plumas,063,18699,27,16,0,16,0
2020-07-17,Riverside,065,2383286,37358,29639,39,29678,580
2020-07-17,Sacramento,067,1510023,9379,6563,10,6573,95
2020-07-17,San Benito,069,59416,530,399,0,399,2
2020-07-17,San Bernardino,071,2135413,32676,23057,91,23148,322
2020-07-17,San Diego,073,3302833,27482,22491,2,22493,472
2020-07-17,San Francisco,075,870044,5962,4967,5,4972,52
2020-07-17,San Joaquin,077,732212,11200,7925,5,7930,86
2020-07-17,San Luis Obispo,079,281455,1652,1190,7,1197,6
2020-07-17,San Mateo,081,765935,5332,4407,7,4414,110
2020-07-17,Santa Barbara,083,443738,5782,5001,49,5050,29
2020-07-17,Santa Clara,085,1922200,10062,7080,26,7106,164
2020-07-17,Santa Cruz,087,273765,971,716,7,723,3
2020-07-17,Shasta,089,179085,360,213,1,214,8
2020-07-17,Sierra,091,2930,1,1,0,1,0
2020-07-17,Siskiyou,093,43540,70,40,0,40,0
2020-07-17,Solano,095,438530,3472,2452,10,2462,26
2020-07-17,Sonoma,097,501317,2789,1982,6,1988,15
2020-07-17,Stanislaus,099,539301,8850,6220,12,6232,56
2020-07-17,Sutter,101,95872,585,458,0,458,2
2020-07-17,Tehama,103,63373,198,128,2,130,1
2020-07-17,Trinity,105,12862,23,2,6,8,0
2020-07-17,Tulare,107,460477,8953,6671,29,6700,166
2020-07-17,Tuolumne,109,53932,122,73,3,76,0
2020-07-17,Ventura,111,848112,7215,5451,25,5476,51
2020-07-17,Yolo,113,214977,1453,1055,3,1058,30
2020-07-17,Yuba,115,75493,308,231,0,231,1
2020-07-16,Alameda,001,1643700,10879,8719,22,8741,153
2020-07-16,Alpine,003,1148,2,1,0,1,0
2020-07-16,Amador,005,37829,94,46,0,46,0
2020-07-16,Butte,007,227075,800,465,12,477,4
2020-07-16,Calaveras,009,45235,97,82,0,82,0
2020-07-16,Colusa,011,21464,263,140,0,140,0
2020-07-16,Contra Costa,013,1133247,7496,5338,17,5355,91
2020-07-16,Del Norte,015,27424,82,60,0,60,0
2020-07-16,El Dorado,017,186661,605,357,5,362,0
2020-07-16,Fresno,019,978130,16693,9481,131,9612,101
2020-07-16,Glenn,021,27897,287,190,0,190,0
2020-07-16,Humboldt,023,135768,215,184,1,185,4
2020-07-16,Imperial,025,180216,9605,7148,5,7153,113
2020-07-16,Inyo,027,18085,42,38,1,39,1
2020-07-16,Kern,029,883053,19017,7435,71,7506,112
2020-07-16,Kings,031,150075,3691,2937,19,2956,37
2020-07-16,Lake,033,64148,179,128,0,128,1
2020-07-16,Lassen,035,31185,524,355,2,357,0
2020-07-16,Los Angeles,037,10098052,167928,147759,271,148030,3994
2020-07-16,Madera,039,155013,1962,1192,3,1195,8
2020-07-16,Marin,041,260295,4651,3546,5,3551,21
2020-07-16,Mariposa,043,17540,45,34,0,34,1
2020-07-16,Mendocino,045,87422,195,121,0,121,0
2020-07-16,Merced,047,269075,3842,2228,2,2230,12
2020-07-16,Modoc,049,8938,1,0,0,0,0
2020-07-16,Mono,051,14174,97,53,1,54,1
2020-07-16,Monterey,053,433212,3908,2857,12,2869,18
2020-07-16,Napa,055,140530,857,581,0,581,5
2020-07-16,Nevada,057,99092,278,191,9,200,1
2020-07-16,Orange,059,3164182,36836,28525,506,29031,471
2020-07-16,Placer,061,380077,1709,1168,3,1171,11
2020-07-16,Plumas,063,18699,25,16,0,16,0
2020-07-16,Riverside,065,2383286,36613,28904,37,28941,577
2020-07-16,Sacramento,067,1510023,9066,6440,9,6449,91
2020-07-16,San Benito,069,59416,513,389,0,389,2
2020-07-16,San Bernardino,071,2135413,31815,22355,73,22428,321
2020-07-16,San Diego,073,3302833,26995,21857,2,21859,465
2020-07-16,San Francisco,075,870044,5821,4838,5,4843,52
2020-07-16,San Joaquin,077,732212,10838,7713,5,7718,82
2020-07-16,San Luis Obispo,079,281455,1608,1146,7,1153,6
2020-07-16,San Mateo,081,765935,5228,4336,7,4343,110
2020-07-16,Santa Barbara,083,443738,5687,4872,48,4920,28
2020-07-16,Santa Clara,085,1922200,9782,6990,24,7014,164
2020-07-16,Santa Cruz,087,273765,930,698,7,705,3
2020-07-16,Shasta,089,179085,345,208,1,209,7
2020-07-16,Sierra,091,2930,1,1,0,1,0
2020-07-16,Siskiyou,093,43540,67,39,0,39,0
2020-07-16,Solano,095,438530,3378,2372,10,2382,25
2020-07-16,Sonoma,097,501317,2699,1954,6,1960,14
2020-07-16,Stanislaus,099,539301,8567,6077,11,6088,56
2020-07-16,Sutter,101,95872,569,444,0,444,2
2020-07-16,Tehama,103,63373,188,126,2,128,1
2020-07-16,Trinity,105,12862,23,2,5,7,0
2020-07-16,Tulare,107,460477,8737,6467,28,6495,163
2020-07-16,Tuolumne,109,53932,117,71,3,74,0
2020-07-16,Ventura,111,848112,7053,5231,25,5256,50
2020-07-16,Yolo,113,214977,1411,1034,3,1037,29
2020-07-16,Yuba,115,75493,290,221,0,221,1
2020-07-15,Alameda,001,1643700,10674,8615,17,8632,153
2020-07-15,Alpine,003,1148,2,1,0,1,0
2020-07-15,Amador,005,37829,73,44,0,44,0
2020-07-15,Butte,007,227075,758,420,12,432,4
2020-07-15,Calaveras,009,45235,97,75,0,75,0
2020-07-15,Colusa,011,21464,258,135,0,135,0
2020-07-15,Contra Costa,013,1133247,7265,5246,17,5263,90
2020-07-15,Del Norte,015,27424,81,60,0,60,0
2020-07-15,El Dorado,017,186661,581,339,5,344,0
2020-07-15,Fresno,019,978130,16219,9124,125,9249,101
2020-07-15,Glenn,021,27897,278,184,0,184,0
2020-07-15,Humboldt,023,135768,213,181,1,182,4
2020-07-15,Imperial,025,180216,9538,7110,5,7115,110
2020-07-15,Inyo,027,18085,42,36,1,37,1
2020-07-15,Kern,029,883053,18397,7155,68,7223,108
2020-07-15,Kings,031,150075,3630,2906,19,2925,37
2020-07-15,Lake,033,64148,177,122,0,122,1
2020-07-15,Lassen,035,31185,520,319,2,321,0
2020-07-15,Los Angeles,037,10098052,164462,143343,256,143599,3946
2020-07-15,Madera,039,155013,1893,1147,3,1150,4
2020-07-15,Marin,041,260295,4596,3458,5,3463,21
2020-07-15,Mariposa,043,17540,45,34,0,34,1
2020-07-15,Mendocino,045,87422,192,119,0,119,0
2020-07-15,Merced,047,269075,3692,2156,2,2158,12
2020-07-15,Modoc,049,8938,1,0,0,0,0
2020-07-15,Mono,051,14174,95,52,1,53,1
2020-07-15,Monterey,053,433212,3796,2780,12,2792,18
2020-07-15,Napa,055,140530,831,573,0,573,5
2020-07-15,Nevada,057,99092,274,185,7,192,1
2020-07-15,Orange,059,3164182,36036,27718,472,28190,454
2020-07-15,Placer,061,380077,1651,1145,3,1148,11
2020-07-15,Plumas,063,18699,25,16,0,16,0
2020-07-15,Riverside,065,2383286,35831,28492,35,28527,568
2020-07-15,Sacramento,067,1510023,8686,6217,9,6226,91
2020-07-15,San Benito,069,59416,504,388,0,388,2
2020-07-15,San Bernardino,071,2135413,31026,21508,57,21565,317
2020-07-15,San Diego,073,3302833,26528,21448,2,21450,448
2020-07-15,San Francisco,075,870044,5708,4757,5,4762,50
2020-07-15,San Joaquin,077,732212,10406,7381,4,7385,75
2020-07-15,San Luis Obispo,079,281455,1565,1097,7,1104,6
2020-07-15,San Mateo,081,765935,5115,4258,7,4265,109
2020-07-15,Santa Barbara,083,443738,5573,4733,48,4781,28
2020-07-15,Santa Clara,085,1922200,9478,6900,24,6924,164
2020-07-15,Santa Cruz,087,273765,894,660,6,666,3
2020-07-15,Shasta,089,179085,336,193,1,194,7
2020-07-15,Sierra,091,2930,1,1,0,1,0
2020-07-15,Siskiyou,093,43540,66,38,0,38,0
2020-07-15,Solano,095,438530,3283,2343,10,2353,25
2020-07-15,Sonoma,097,501317,2601,1920,6,1926,14
2020-07-15,Stanislaus,099,539301,8270,5777,11,5788,56
2020-07-15,Sutter,101,95872,543,433,0,433,2
2020-07-15,Tehama,103,63373,180,126,2,128,1
2020-07-15,Trinity,105,12862,22,2,5,7,0
2020-07-15,Tulare,107,460477,8526,6320,27,6347,156
2020-07-15,Tuolumne,109,53932,110,68,3,71,0
2020-07-15,Ventura,111,848112,6876,5087,25,5112,50
2020-07-15,Yolo,113,214977,1378,1002,3,1005,27
2020-07-15,Yuba,115,75493,278,221,0,221,1
2020-07-14,Alameda,001,1643700,10333,8388,11,8399,151
2020-07-14,Alpine,003,1148,2,1,0,1,0
2020-07-14,Amador,005,37829,69,44,0,44,0
2020-07-14,Butte,007,227075,712,382,12,394,4
2020-07-14,Calaveras,009,45235,95,74,0,74,0
2020-07-14,Colusa,011,21464,248,128,0,128,0
2020-07-14,Contra Costa,013,1133247,7028,5110,15,5125,90
2020-07-14,Del Norte,015,27424,80,60,0,60,0
2020-07-14,El Dorado,017,186661,566,324,5,329,0
2020-07-14,Fresno,019,978130,15799,8941,120,9061,98
2020-07-14,Glenn,021,27897,268,177,0,177,0
2020-07-14,Humboldt,023,135768,210,175,1,176,4
2020-07-14,Imperial,025,180216,9410,7095,5,7100,109
2020-07-14,Inyo,027,18085,42,35,1,36,1
2020-07-14,Kern,029,883053,17638,6979,55,7034,107
2020-07-14,Kings,031,150075,3563,2867,18,2885,37
2020-07-14,Lake,033,64148,171,120,0,120,1
2020-07-14,Lassen,035,31185,503,263,2,265,0
2020-07-14,Los Angeles,037,10098052,161329,140632,227,140859,3900
2020-07-14,Madera,039,155013,1819,1118,3,1121,4
2020-07-14,Marin,041,260295,4482,3451,5,3456,21
2020-07-14,Mariposa,043,17540,41,32,0,32,1
2020-07-14,Mendocino,045,87422,184,110,0,110,0
2020-07-14,Merced,047,269075,3513,2084,2,2086,12
2020-07-14,Modoc,049,8938,1,0,0,0,0
2020-07-14,Mono,051,14174,85,48,1,49,1
2020-07-14,Monterey,053,433212,3683,2724,12,2736,18
2020-07-14,Napa,055,140530,775,557,0,557,4
2020-07-14,Nevada,057,99092,257,180,6,186,1
2020-07-14,Orange,059,3164182,35156,26915,424,27339,432
2020-07-14,Placer,061,380077,1593,1122,3,1125,11
2020-07-14,Plumas,063,18699,24,14,0,14,0
2020-07-14,Riverside,065,2383286,35074,27850,34,27884,547
2020-07-14,Sacramento,067,1510023,8332,5978,9,5987,87
2020-07-14,San Benito,069,59416,485,360,0,360,2
2020-07-14,San Bernardino,071,2135413,30174,20489,47,20536,316
2020-07-14,San Diego,073,3302833,25908,20887,2,20889,436
2020-07-14,San Francisco,075,870044,5557,4659,4,4663,50
2020-07-14,San Joaquin,077,732212,9979,7143,4,7147,75
2020-07-14,San Luis Obispo,079,281455,1527,1060,7,1067,5
2020-07-14,San Mateo,081,765935,5022,4173,7,4180,108
2020-07-14,Santa Barbara,083,443738,5449,4641,46,4687,28
2020-07-14,Santa Clara,085,1922200,9150,6686,21,6707,164
2020-07-14,Santa Cruz,087,273765,855,639,6,645,3
2020-07-14,Shasta,089,179085,327,190,1,191,7
2020-07-14,Sierra,091,2930,1,1,0,1,0
2020-07-14,Siskiyou,093,43540,65,38,0,38,0
2020-07-14,Solano,095,438530,3184,2266,9,2275,25
2020-07-14,Sonoma,097,501317,2508,1866,6,1872,14
2020-07-14,Stanislaus,099,539301,7896,5631,10,5641,53
2020-07-14,Sutter,101,95872,524,405,0,405,2
2020-07-14,Tehama,103,63373,168,123,2,125,1
2020-07-14,Trinity,105,12862,21,2,5,7,0
2020-07-14,Tulare,107,460477,8281,6199,27,6226,156
2020-07-14,Tuolumne,109,53932,105,68,3,71,0
2020-07-14,Ventura,111,848112,6715,4950,25,4975,50
2020-07-14,Yolo,113,214977,1331,966,3,969,27
2020-07-14,Yuba,115,75493,261,210,0,210,1
2020-07-13,Alameda,001,1643700,10025,8115,11,8126,148
2020-07-13,Alpine,003,1148,2,1,0,1,0
2020-07-13,Amador,005,37829,65,42,0,42,0
2020-07-13,Butte,007,227075,676,354,12,366,4
2020-07-13,Calaveras,009,45235,87,63,0,63,0
2020-07-13,Colusa,011,21464,242,116,0,116,0
2020-07-13,Contra Costa,013,1133247,6755,4882,13,4895,88
2020-07-13,Del Norte,015,27424,74,59,0,59,0
2020-07-13,El Dorado,017,186661,535,298,5,303,0
2020-07-13,Fresno,019,978130,15370,8666,115,8781,95
2020-07-13,Glenn,021,27897,261,168,0,168,0
2020-07-13,Humboldt,023,135768,205,174,1,175,4
2020-07-13,Imperial,025,180216,9323,7052,5,7057,109
2020-07-13,Inyo,027,18085,41,35,1,36,1
2020-07-13,Kern,029,883053,16953,6808,50,6858,107
2020-07-13,Kings,031,150075,3512,2824,18,2842,37
2020-07-13,Lake,033,64148,166,118,0,118,1
2020-07-13,Lassen,035,31185,498,237,2,239,0
2020-07-13,Los Angeles,037,10098052,158096,136368,213,136581,3829
2020-07-13,Madera,039,155013,1750,1059,3,1062,4
2020-07-13,Marin,041,260295,4378,3402,5,3407,21
2020-07-13,Mariposa,043,17540,40,31,0,31,1
2020-07-13,Mendocino,045,87422,180,87,0,87,0
2020-07-13,Merced,047,269075,3364,2007,2,2009,12
2020-07-13,Modoc,049,8938,1,0,0,0,0
2020-07-13,Mono,051,14174,81,47,0,47,1
2020-07-13,Monterey,053,433212,3560,2613,9,2622,18
2020-07-13,Napa,055,140530,739,534,0,534,4
2020-07-13,Nevada,057,99092,243,172,6,178,1
2020-07-13,Orange,059,3164182,34292,25978,392,26370,423
2020-07-13,Placer,061,380077,1548,1096,3,1099,11
2020-07-13,Plumas,063,18699,22,14,0,14,0
2020-07-13,Riverside,065,2383286,34149,27136,32,27168,545
2020-07-13,Sacramento,067,1510023,8035,5747,9,5756,85
2020-07-13,San Benito,069,59416,472,343,0,343,2
2020-07-13,San Bernardino,071,2135413,29297,19610,40,19650,313
2020-07-13,San Diego,073,3302833,25341,20348,2,20350,422
2020-07-13,San Francisco,075,870044,5430,4534,3,4537,50
2020-07-13,San Joaquin,077,732212,9565,6927,4,6931,71
2020-07-13,San Luis Obispo,079,281455,1496,989,7,996,5
2020-07-13,San Mateo,081,765935,4891,4057,7,4064,108
2020-07-13,Santa Barbara,083,443738,5335,4441,45,4486,28
2020-07-13,Santa Clara,085,1922200,8827,6488,20,6508,164
2020-07-13,Santa Cruz,087,273765,817,574,6,580,3
2020-07-13,Shasta,089,179085,316,185,1,186,6
2020-07-13,Sierra,091,2930,1,1,0,1,0
2020-07-13,Siskiyou,093,43540,61,37,0,37,0
2020-07-13,Solano,095,438530,3072,2046,9,2055,23
2020-07-13,Sonoma,097,501317,2397,1818,6,1824,14
2020-07-13,Stanislaus,099,539301,7593,5324,9,5333,53
2020-07-13,Sutter,101,95872,486,379,0,379,2
2020-07-13,Tehama,103,63373,155,112,2,114,1
2020-07-13,Trinity,105,12862,21,2,5,7,0
2020-07-13,Tulare,107,460477,8020,5930,25,5955,147
2020-07-13,Tuolumne,109,53932,97,56,3,59,0
2020-07-13,Ventura,111,848112,6525,4800,22,4822,50
2020-07-13,Yolo,113,214977,1285,941,3,944,27
2020-07-13,Yuba,115,75493,246,194,0,194,1
2020-07-12,Alameda,001,1643700,9755,8056,11,8067,148
2020-07-12,Alpine,003,1148,2,1,0,1,0
2020-07-12,Amador,005,37829,55,40,0,40,0
2020-07-12,Butte,007,227075,626,341,11,352,4
2020-07-12,Calaveras,009,45235,87,62,0,62,0
2020-07-12,Colusa,011,21464,208,116,0,116,0
2020-07-12,Contra Costa,013,1133247,6486,4708,11,4719,88
2020-07-12,Del Norte,015,27424,63,59,0,59,0
2020-07-12,El Dorado,017,186661,513,290,5,295,0
2020-07-12,Fresno,019,978130,14945,8407,110,8517,95
2020-07-12,Glenn,021,27897,248,166,0,166,0
2020-07-12,Humboldt,023,135768,201,174,1,175,4
2020-07-12,Imperial,025,180216,9208,6999,5,7004,109
2020-07-12,Inyo,027,18085,39,35,1,36,1
2020-07-12,Kern,029,883053,16210,6662,47,6709,105
2020-07-12,Kings,031,150075,3450,2779,18,2797,34
2020-07-12,Lake,033,64148,157,114,0,114,1
2020-07-12,Lassen,035,31185,491,237,2,239,0
2020-07-12,Los Angeles,037,10098052,154672,133830,184,134014,3816
2020-07-12,Madera,039,155013,1695,1025,3,1028,4
2020-07-12,Marin,041,260295,4301,3358,5,3363,21
2020-07-12,Mariposa,043,17540,39,31,0,31,1
2020-07-12,Mendocino,045,87422,161,88,0,88,0
2020-07-12,Merced,047,269075,3234,1908,2,1910,12
2020-07-12,Modoc,049,8938,1,0,0,0,0
2020-07-12,Mono,051,14174,71,45,0,45,1
2020-07-12,Monterey,053,433212,3445,2521,9,2530,18
2020-07-12,Napa,055,140530,707,519,0,519,4
2020-07-12,Nevada,057,99092,233,166,6,172,1
2020-07-12,Orange,059,3164182,33416,25399,383,25782,422
2020-07-12,Placer,061,380077,1491,1058,3,1061,11
2020-07-12,Plumas,063,18699,21,14,0,14,0
2020-07-12,Riverside,065,2383286,33391,26404,31,26435,542
2020-07-12,Sacramento,067,1510023,7723,5515,7,5522,85
2020-07-12,San Benito,069,59416,457,324,0,324,2
2020-07-12,San Bernardino,071,2135413,28386,19042,36,19078,312
2020-07-12,San Diego,073,3302833,24711,19929,2,19931,422
2020-07-12,San Francisco,075,870044,5280,4535,3,4538,50
2020-07-12,San Joaquin,077,732212,9203,6703,4,6707,71
2020-07-12,San Luis Obispo,079,281455,1449,972,7,979,5
2020-07-12,San Mateo,081,765935,4773,3988,7,3995,108
2020-07-12,Santa Barbara,083,443738,5205,4353,44,4397,28
2020-07-12,Santa Clara,085,1922200,8589,6252,19,6271,164
2020-07-12,Santa Cruz,087,273765,775,573,5,578,3
2020-07-12,Shasta,089,179085,310,173,1,174,6
2020-07-12,Sierra,091,2930,1,1,0,1,0
2020-07-12,Siskiyou,093,43540,59,36,0,36,0
2020-07-12,Solano,095,438530,2947,2037,9,2046,23
2020-07-12,Sonoma,097,501317,2303,1743,6,1749,13
2020-07-12,Stanislaus,099,539301,7289,5177,9,5186,53
2020-07-12,Sutter,101,95872,468,362,0,362,2
2020-07-12,Tehama,103,63373,148,111,2,113,1
2020-07-12,Trinity,105,12862,21,2,5,7,0
2020-07-12,Tulare,107,460477,7765,5864,24,5888,146
2020-07-12,Tuolumne,109,53932,89,52,3,55,0
2020-07-12,Ventura,111,848112,6309,4724,21,4745,50
2020-07-12,Yolo,113,214977,1244,889,3,892,27
2020-07-12,Yuba,115,75493,235,188,0,188,1
2020-07-11,Alameda,001,1643700,9653,7845,11,7856,148
2020-07-11,Alpine,003,1148,2,1,0,1,0
2020-07-11,Amador,005,37829,51,37,0,37,0
2020-07-11,Butte,007,227075,610,325,11,336,4
2020-07-11,Calaveras,009,45235,84,62,0,62,0
2020-07-11,Colusa,011,21464,203,110,0,110,0
2020-07-11,Contra Costa,013,1133247,6370,4650,11,4661,87
2020-07-11,Del Norte,015,27424,63,59,0,59,0
2020-07-11,El Dorado,017,186661,502,283,5,288,0
2020-07-11,Fresno,019,978130,14685,8086,108,8194,95
2020-07-11,Glenn,021,27897,240,161,0,161,0
2020-07-11,Humboldt,023,135768,200,174,1,175,4
2020-07-11,Imperial,025,180216,9169,6884,5,6889,109
2020-07-11,Inyo,027,18085,39,35,1,36,1
2020-07-11,Kern,029,883053,15853,6509,46,6555,103
2020-07-11,Kings,031,150075,3423,2753,18,2771,33
2020-07-11,Lake,033,64148,156,110,0,110,1
2020-07-11,Lassen,035,31185,490,237,2,239,0
2020-07-11,Los Angeles,037,10098052,152953,130479,174,130653,3802
2020-07-11,Madera,039,155013,1654,988,3,991,4
2020-07-11,Marin,041,260295,4273,3191,5,3196,21
2020-07-11,Mariposa,043,17540,39,31,0,31,1
2020-07-11,Mendocino,045,87422,157,88,0,88,0
2020-07-11,Merced,047,269075,3153,1851,2,1853,12
2020-07-11,Modoc,049,8938,1,0,0,0,0
2020-07-11,Mono,051,14174,68,45,0,45,1
2020-07-11,Monterey,053,433212,3356,2376,8,2384,18
2020-07-11,Napa,055,140530,695,509,0,509,4
2020-07-11,Nevada,057,99092,224,163,5,168,1
2020-07-11,Orange,059,3164182,33039,24430,369,24799,422
2020-07-11,Placer,061,380077,1456,1029,3,1032,11
2020-07-11,Plumas,063,18699,21,12,0,12,0
2020-07-11,Riverside,065,2383286,33000,25994,31,26025,538
2020-07-11,Sacramento,067,1510023,7549,5367,7,5374,84
2020-07-11,San Benito,069,59416,442,314,0,314,2
2020-07-11,San Bernardino,071,2135413,27949,18907,34,18941,310
2020-07-11,San Diego,073,3302833,24319,19371,2,19373,422
2020-07-11,San Francisco,075,870044,5184,4430,2,4432,50
2020-07-11,San Joaquin,077,732212,9025,6518,4,6522,72
2020-07-11,San Luis Obispo,079,281455,1401,930,7,937,4
2020-07-11,San Mateo,081,765935,4705,3956,7,3963,108
2020-07-11,Santa Barbara,083,443738,5136,4283,43,4326,28
2020-07-11,Santa Clara,085,1922200,8430,5959,19,5978,164
2020-07-11,Santa Cruz,087,273765,744,571,5,576,3
2020-07-11,Shasta,089,179085,303,168,1,169,6
2020-07-11,Sierra,091,2930,1,1,0,1,0
2020-07-11,Siskiyou,093,43540,59,36,0,36,0
2020-07-11,Solano,095,438530,2906,2034,9,2043,23
2020-07-11,Sonoma,097,501317,2265,1690,6,1696,13
2020-07-11,Stanislaus,099,539301,7148,4911,9,4920,51
2020-07-11,Sutter,101,95872,452,352,0,352,2
2020-07-11,Tehama,103,63373,146,111,2,113,1
2020-07-11,Trinity,105,12862,21,2,5,7,0
2020-07-11,Tulare,107,460477,7659,5780,24,5804,149
2020-07-11,Tuolumne,109,53932,87,50,3,53,0
2020-07-11,Ventura,111,848112,6213,4545,20,4565,49
2020-07-11,Yolo,113,214977,1215,833,3,836,27
2020-07-11,Yuba,115,75493,225,175,0,175,1
2020-07-10,Alameda,001,1643700,9496,7551,11,7562,147
2020-07-10,Alpine,003,1148,2,1,0,1,0
2020-07-10,Amador,005,37829,47,37,0,37,0
2020-07-10,Butte,007,227075,599,318,11,329,4
2020-07-10,Calaveras,009,45235,84,61,0,61,0
2020-07-10,Colusa,011,21464,197,103,0,103,0
2020-07-10,Contra Costa,013,1133247,6228,4482,11,4493,86
2020-07-10,Del Norte,015,27424,63,57,0,57,0
2020-07-10,El Dorado,017,186661,484,266,5,271,0
2020-07-10,Fresno,019,978130,14353,7760,105,7865,93
2020-07-10,Glenn,021,27897,235,157,0,157,0
2020-07-10,Humboldt,023,135768,199,168,1,169,4
2020-07-10,Imperial,025,180216,9124,6878,4,6882,98
2020-07-10,Inyo,027,18085,39,35,1,36,1
2020-07-10,Kern,029,883053,15421,6344,45,6389,102
2020-07-10,Kings,031,150075,3387,2707,18,2725,33
2020-07-10,Lake,033,64148,149,104,0,104,1
2020-07-10,Lassen,035,31185,489,235,2,237,0
2020-07-10,Los Angeles,037,10098052,150532,127503,168,127671,3750
2020-07-10,Madera,039,155013,1608,914,3,917,4
2020-07-10,Marin,041,260295,4210,3101,5,3106,21
2020-07-10,Mariposa,043,17540,38,31,0,31,1
2020-07-10,Mendocino,045,87422,149,88,0,88,0
2020-07-10,Merced,047,269075,3074,1802,2,1804,12
2020-07-10,Modoc,049,8938,1,0,0,0,0
2020-07-10,Mono,051,14174,67,45,0,45,1
2020-07-10,Monterey,053,433212,3278,2285,8,2293,18
2020-07-10,Napa,055,140530,684,496,0,496,4
2020-07-10,Nevada,057,99092,219,161,5,166,1
2020-07-10,Orange,059,3164182,32452,23692,366,24058,416
2020-07-10,Placer,061,380077,1414,1002,3,1005,11
2020-07-10,Plumas,063,18699,19,12,0,12,0
2020-07-10,Riverside,065,2383286,32482,25481,31,25512,533
2020-07-10,Sacramento,067,1510023,7294,5181,7,5188,81
2020-07-10,San Benito,069,59416,433,302,0,302,2
2020-07-10,San Bernardino,071,2135413,27425,18242,31,18273,308
2020-07-10,San Diego,073,3302833,23935,18862,2,18864,420
2020-07-10,San Francisco,075,870044,5093,4305,2,4307,50
2020-07-10,San Joaquin,077,732212,8792,6225,4,6229,67
2020-07-10,San Luis Obispo,079,281455,1363,891,7,898,4
2020-07-10,San Mateo,081,765935,4640,3844,7,3851,107
2020-07-10,Santa Barbara,083,443738,5039,4177,42,4219,28
2020-07-10,Santa Clara,085,1922200,8206,5819,19,5838,164
2020-07-10,Santa Cruz,087,273765,716,540,5,545,3
2020-07-10,Shasta,089,179085,299,158,1,159,6
2020-07-10,Sierra,091,2930,1,1,0,1,0
2020-07-10,Siskiyou,093,43540,59,31,0,31,0
2020-07-10,Solano,095,438530,2859,1950,9,1959,23
2020-07-10,Sonoma,097,501317,2218,1606,5,1611,13
2020-07-10,Stanislaus,099,539301,6978,4781,9,4790,46
2020-07-10,Sutter,101,95872,445,338,0,338,2
2020-07-10,Tehama,103,63373,145,107,2,109,1
2020-07-10,Trinity,105,12862,21,2,5,7,0
2020-07-10,Tulare,107,460477,7522,5677,24,5701,150
2020-07-10,Tuolumne,109,53932,86,49,3,52,0
2020-07-10,Ventura,111,848112,6099,4416,20,4436,48
2020-07-10,Yolo,113,214977,1191,794,3,797,27
2020-07-10,Yuba,115,75493,211,164,0,164,1
2020-07-09,Alameda,001,1643700,9265,7433,11,7444,146
2020-07-09,Alpine,003,1148,2,1,0,1,0
2020-07-09,Amador,005,37829,44,36,0,36,0
2020-07-09,Butte,007,227075,567,295,11,306,4
2020-07-09,Calaveras,009,45235,83,59,0,59,0
2020-07-09,Colusa,011,21464,189,97,0,97,0
2020-07-09,Contra Costa,013,1133247,5984,4388,11,4399,86
2020-07-09,Del Norte,015,27424,63,57,0,57,0
2020-07-09,El Dorado,017,186661,459,255,4,259,0
2020-07-09,Fresno,019,978130,13899,7385,102,7487,90
2020-07-09,Glenn,021,27897,225,150,0,150,0
2020-07-09,Humboldt,023,135768,196,166,1,167,4
2020-07-09,Imperial,025,180216,9027,6778,4,6782,87
2020-07-09,Inyo,027,18085,37,35,1,36,1
2020-07-09,Kern,029,883053,14776,6100,43,6143,95
2020-07-09,Kings,031,150075,3323,2686,18,2704,33
2020-07-09,Lake,033,64148,146,99,0,99,1
2020-07-09,Lassen,035,31185,433,221,2,223,0
2020-07-09,Los Angeles,037,10098052,147273,125062,145,125207,3698
2020-07-09,Madera,039,155013,1531,850,3,853,4
2020-07-09,Marin,041,260295,4059,2975,4,2979,20
2020-07-09,Mariposa,043,17540,38,32,0,32,1
2020-07-09,Mendocino,045,87422,145,88,0,88,0
2020-07-09,Merced,047,269075,2940,1728,2,1730,11
2020-07-09,Modoc,049,8938,1,0,0,0,0
2020-07-09,Mono,051,14174,63,45,0,45,1
2020-07-09,Monterey,053,433212,3153,2223,8,2231,17
2020-07-09,Napa,055,140530,667,468,0,468,4
2020-07-09,Nevada,057,99092,213,156,5,161,1
2020-07-09,Orange,059,3164182,31482,22960,348,23308,407
2020-07-09,Placer,061,380077,1372,982,3,985,11
2020-07-09,Plumas,063,18699,19,12,0,12,0
2020-07-09,Riverside,065,2383286,31589,24980,30,25010,529
2020-07-09,Sacramento,067,1510023,6967,4950,7,4957,81
2020-07-09,San Benito,069,59416,417,295,0,295,2
2020-07-09,San Bernardino,071,2135413,26555,17339,25,17364,307
2020-07-09,San Diego,073,3302833,23343,18404,2,18406,415
2020-07-09,San Francisco,075,870044,4961,4143,2,4145,50
2020-07-09,San Joaquin,077,732212,8433,6004,4,6008,66
2020-07-09,San Luis Obispo,079,281455,1323,869,7,876,3
2020-07-09,San Mateo,081,765935,4514,3792,7,3799,106
2020-07-09,Santa Barbara,083,443738,4907,4068,42,4110,28
2020-07-09,Santa Clara,085,1922200,7945,5638,19,5657,164
2020-07-09,Santa Cruz,087,273765,689,526,5,531,3
2020-07-09,Shasta,089,179085,293,155,1,156,5
2020-07-09,Sierra,091,2930,1,1,0,1,0
2020-07-09,Siskiyou,093,43540,55,31,0,31,0
2020-07-09,Solano,095,438530,2761,1892,9,1901,23
2020-07-09,Sonoma,097,501317,2132,1584,5,1589,13
2020-07-09,Stanislaus,099,539301,6663,4633,8,4641,46
2020-07-09,Sutter,101,95872,428,321,0,321,2
2020-07-09,Tehama,103,63373,140,102,2,104,1
2020-07-09,Trinity,105,12862,21,2,5,7,0
2020-07-09,Tulare,107,460477,7303,5501,23,5524,146
2020-07-09,Tuolumne,109,53932,85,47,3,50,0
2020-07-09,Ventura,111,848112,5931,4278,20,4298,47
2020-07-09,Yolo,113,214977,1143,764,3,767,27
2020-07-09,Yuba,115,75493,194,152,0,152,1
2020-07-08,Alameda,001,1643700,8975,7335,11,7346,142
2020-07-08,Alpine,003,1148,2,1,0,1,0
2020-07-08,Amador,005,37829,41,35,0,35,0
2020-07-08,Butte,007,227075,530,281,11,292,3
2020-07-08,Calaveras,009,45235,78,58,0,58,0
2020-07-08,Colusa,011,21464,176,90,0,90,0
2020-07-08,Contra Costa,013,1133247,5738,4268,9,4277,84
2020-07-08,Del Norte,015,27424,61,57,0,57,0
2020-07-08,El Dorado,017,186661,437,248,4,252,0
2020-07-08,Fresno,019,978130,13483,7102,94,7196,86
2020-07-08,Glenn,021,27897,214,146,0,146,0
2020-07-08,Humboldt,023,135768,193,162,1,163,4
2020-07-08,Imperial,025,180216,8940,6727,4,6731,76
2020-07-08,Inyo,027,18085,37,35,1,36,1
2020-07-08,Kern,029,883053,14198,5873,41,5914,91
2020-07-08,Kings,031,150075,3263,2629,15,2644,33
2020-07-08,Lake,033,64148,139,97,0,97,1
2020-07-08,Lassen,035,31185,337,221,2,223,0
2020-07-08,Los Angeles,037,10098052,144068,123462,118,123580,3650
2020-07-08,Madera,039,155013,1461,828,3,831,4
2020-07-08,Marin,041,260295,3960,2756,4,2760,17
2020-07-08,Mariposa,043,17540,38,31,0,31,1
2020-07-08,Mendocino,045,87422,132,84,0,84,0
2020-07-08,Merced,047,269075,2820,1578,2,1580,11
2020-07-08,Modoc,049,8938,1,0,0,0,0
2020-07-08,Mono,051,14174,60,45,0,45,1
2020-07-08,Monterey,053,433212,3035,2182,7,2189,17
2020-07-08,Napa,055,140530,645,468,0,468,4
2020-07-08,Nevada,057,99092,204,156,5,161,1
2020-07-08,Orange,059,3164182,30531,22088,343,22431,378
2020-07-08,Placer,061,380077,1325,948,3,951,11
2020-07-08,Plumas,063,18699,19,12,0,12,0
2020-07-08,Riverside,065,2383286,30625,24042,29,24071,508
2020-07-08,Sacramento,067,1510023,6678,4799,7,4806,80
2020-07-08,San Benito,069,59416,400,282,0,282,2
2020-07-08,San Bernardino,071,2135413,25701,16510,21,16531,296
2020-07-08,San Diego,073,3302833,22773,17844,2,17846,406
2020-07-08,San Francisco,075,870044,4872,4093,2,4095,50
2020-07-08,San Joaquin,077,732212,8090,5759,4,5763,61
2020-07-08,San Luis Obispo,079,281455,1271,825,7,832,2
2020-07-08,San Mateo,081,765935,4393,3733,7,3740,106
2020-07-08,Santa Barbara,083,443738,4788,3985,42,4027,28
2020-07-08,Santa Clara,085,1922200,7711,5510,19,5529,164
2020-07-08,Santa Cruz,087,273765,656,509,4,513,3
2020-07-08,Shasta,089,179085,284,148,1,149,6
2020-07-08,Sierra,091,2930,1,1,0,1,0
2020-07-08,Siskiyou,093,43540,55,31,0,31,0
2020-07-08,Solano,095,438530,2645,1821,9,1830,23
2020-07-08,Sonoma,097,501317,2056,1495,5,1500,9
2020-07-08,Stanislaus,099,539301,6363,4344,8,4352,46
2020-07-08,Sutter,101,95872,403,298,0,298,2
2020-07-08,Tehama,103,63373,134,100,2,102,1
2020-07-08,Trinity,105,12862,20,2,5,7,0
2020-07-08,Tulare,107,460477,7111,5307,18,5325,138
2020-07-08,Tuolumne,109,53932,81,42,3,45,0
2020-07-08,Ventura,111,848112,5766,4139,20,4159,47
2020-07-08,Yolo,113,214977,1099,727,3,730,26
2020-07-08,Yuba,115,75493,181,145,0,145,1
2020-07-07,Alameda,001,1643700,8654,7097,10,7107,141
2020-07-07,Alpine,003,1148,2,1,0,1,0
2020-07-07,Amador,005,37829,41,33,0,33,0
2020-07-07,Butte,007,227075,487,269,11,280,3
2020-07-07,Calaveras,009,45235,76,58,0,58,0
2020-07-07,Colusa,011,21464,143,84,0,84,0
2020-07-07,Contra Costa,013,1133247,5501,4131,8,4139,84
2020-07-07,Del Norte,015,27424,61,57,0,57,0
2020-07-07,El Dorado,017,186661,417,244,4,248,0
2020-07-07,Fresno,019,978130,13030,6738,94,6832,84
2020-07-07,Glenn,021,27897,205,145,0,145,0
2020-07-07,Humboldt,023,135768,190,150,1,151,4
2020-07-07,Imperial,025,180216,8841,6678,4,6682,51
2020-07-07,Inyo,027,18085,36,32,1,33,1
2020-07-07,Kern,029,883053,13499,5645,37,5682,88
2020-07-07,Kings,031,150075,3200,2623,14,2637,33
2020-07-07,Lake,033,64148,129,94,0,94,1
2020-07-07,Lassen,035,31185,266,219,2,221,0
2020-07-07,Los Angeles,037,10098052,140489,121026,111,121137,3588
2020-07-07,Madera,039,155013,1417,794,3,797,4
2020-07-07,Marin,041,260295,3871,2627,4,2631,17
2020-07-07,Mariposa,043,17540,38,31,0,31,1
2020-07-07,Mendocino,045,87422,124,82,0,82,0
2020-07-07,Merced,047,269075,2646,1531,2,1533,10
2020-07-07,Modoc,049,8938,1,0,0,0,0
2020-07-07,Mono,051,14174,59,42,0,42,1
2020-07-07,Monterey,053,433212,2892,2166,7,2173,17
2020-07-07,Napa,055,140530,626,459,0,459,4
2020-07-07,Nevada,057,99092,198,150,5,155,1
2020-07-07,Orange,059,3164182,29520,21741,329,22070,373
2020-07-07,Placer,061,380077,1284,930,3,933,11
2020-07-07,Plumas,063,18699,17,12,0,12,0
2020-07-07,Riverside,065,2383286,29609,23279,29,23308,499
2020-07-07,Sacramento,067,1510023,6336,4592,7,4599,76
2020-07-07,San Benito,069,59416,382,274,0,274,2
2020-07-07,San Bernardino,071,2135413,24831,16004,19,16023,277
2020-07-07,San Diego,073,3302833,22054,17580,2,17582,399
2020-07-07,San Francisco,075,870044,4780,4045,1,4046,50
2020-07-07,San Joaquin,077,732212,7748,5547,4,5551,59
2020-07-07,San Luis Obispo,079,281455,1210,795,7,802,2
2020-07-07,San Mateo,081,765935,4278,3691,7,3698,106
2020-07-07,Santa Barbara,083,443738,4660,3866,41,3907,27
2020-07-07,Santa Clara,085,1922200,7442,5438,19,5457,164
2020-07-07,Santa Cruz,087,273765,622,502,3,505,2
2020-07-07,Shasta,089,179085,271,144,1,145,6
2020-07-07,Sierra,091,2930,1,1,0,1,0
2020-07-07,Siskiyou,093,43540,54,30,0,30,0
2020-07-07,Solano,095,438530,2534,1776,8,1784,22
2020-07-07,Sonoma,097,501317,1985,1473,5,1478,8
2020-07-07,Stanislaus,099,539301,6024,4101,8,4109,46
2020-07-07,Sutter,101,95872,377,273,0,273,2
2020-07-07,Tehama,103,63373,125,95,2,97,1
2020-07-07,Trinity,105,12862,20,2,5,7,0
2020-07-07,Tulare,107,460477,6931,5189,17,5206,137
2020-07-07,Tuolumne,109,53932,75,40,3,43,0
2020-07-07,Ventura,111,848112,5597,3992,18,4010,46
2020-07-07,Yolo,113,214977,1031,706,3,709,26
2020-07-07,Yuba,115,75493,161,138,0,138,1
2020-07-06,Alameda,001,1643700,8419,6970,10,6980,141
2020-07-06,Alpine,003,1148,1,1,0,1,0
2020-07-06,Amador,005,37829,39,33,0,33,0
2020-07-06,Butte,007,227075,431,257,11,268,2
2020-07-06,Calaveras,009,45235,73,45,0,45,0
2020-07-06,Colusa,011,21464,134,80,0,80,0
2020-07-06,Contra Costa,013,1133247,5271,3901,7,3908,83
2020-07-06,Del Norte,015,27424,60,57,0,57,0
2020-07-06,El Dorado,017,186661,402,232,3,235,0
2020-07-06,Fresno,019,978130,12561,6364,88,6452,82
2020-07-06,Glenn,021,27897,197,129,0,129,0
2020-07-06,Humboldt,023,135768,188,148,1,149,3
2020-07-06,Imperial,025,180216,8722,6443,4,6447,47
2020-07-06,Inyo,027,18085,36,32,1,33,1
2020-07-06,Kern,029,883053,12693,5491,37,5528,82
2020-07-06,Kings,031,150075,3149,2583,10,2593,33
2020-07-06,Lake,033,64148,122,93,0,93,1
2020-07-06,Lassen,035,31185,264,219,2,221,0
2020-07-06,Los Angeles,037,10098052,136888,116707,97,116804,3541
2020-07-06,Madera,039,155013,1347,734,3,737,4
2020-07-06,Marin,041,260295,3630,2136,4,2140,17
2020-07-06,Mariposa,043,17540,36,31,0,31,1
2020-07-06,Mendocino,045,87422,107,72,0,72,0
2020-07-06,Merced,047,269075,2495,1396,2,1398,10
2020-07-06,Modoc,049,8938,1,0,0,0,0
2020-07-06,Mono,051,14174,58,40,0,40,1
2020-07-06,Monterey,053,433212,2803,2078,7,2085,15
2020-07-06,Napa,055,140530,608,454,0,454,4
2020-07-06,Nevada,057,99092,192,146,5,151,1
2020-07-06,Orange,059,3164182,28459,20167,292,20459,372
2020-07-06,Placer,061,380077,1222,904,3,907,11
2020-07-06,Plumas,063,18699,17,11,0,11,0
2020-07-06,Riverside,065,2383286,28554,22485,28,22513,477
2020-07-06,Sacramento,067,1510023,5985,4420,7,4427,71
2020-07-06,San Benito,069,59416,367,264,0,264,2
2020-07-06,San Bernardino,071,2135413,23978,15346,16,15362,272
2020-07-06,San Diego,073,3302833,21322,17002,2,17004,387
2020-07-06,San Francisco,075,870044,4659,3861,1,3862,50
2020-07-06,San Joaquin,077,732212,7378,5104,4,5108,57
2020-07-06,San Luis Obispo,079,281455,1152,751,7,758,2
2020-07-06,San Mateo,081,765935,4186,3650,6,3656,106
2020-07-06,Santa Barbara,083,443738,4523,3763,40,3803,27
2020-07-06,Santa Clara,085,1922200,7170,5369,19,5388,165
2020-07-06,Santa Cruz,087,273765,600,466,2,468,2
2020-07-06,Shasta,089,179085,261,143,1,144,6
2020-07-06,Sierra,091,2930,1,1,0,1,0
2020-07-06,Siskiyou,093,43540,50,30,0,30,0
2020-07-06,Solano,095,438530,2398,1668,8,1676,22
2020-07-06,Sonoma,097,501317,1921,1369,5,1374,8
2020-07-06,Stanislaus,099,539301,5622,3983,8,3991,46
2020-07-06,Sutter,101,95872,350,250,0,250,2
2020-07-06,Tehama,103,63373,122,95,2,97,1
2020-07-06,Trinity,105,12862,19,2,5,7,0
2020-07-06,Tulare,107,460477,6726,5039,15,5054,136
2020-07-06,Tuolumne,109,53932,72,30,3,33,0
2020-07-06,Ventura,111,848112,5404,3912,18,3930,44
2020-07-06,Yolo,113,214977,975,685,3,688,26
2020-07-06,Yuba,115,75493,147,124,0,124,1
2020-07-05,Alameda,001,1643700,8169,6861,10,6871,141
2020-07-05,Alpine,003,1148,1,1,0,1,0
2020-07-05,Amador,005,37829,37,31,0,31,0
2020-07-05,Butte,007,227075,396,248,11,259,2
2020-07-05,Calaveras,009,45235,69,45,0,45,0
2020-07-05,Colusa,011,21464,124,79,0,79,0
2020-07-05,Contra Costa,013,1133247,5031,3665,6,3671,80
2020-07-05,Del Norte,015,27424,60,57,0,57,0
2020-07-05,El Dorado,017,186661,384,227,3,230,0
2020-07-05,Fresno,019,978130,11995,6186,87,6273,82
2020-07-05,Glenn,021,27897,194,129,0,129,0
2020-07-05,Humboldt,023,135768,184,147,1,148,3
2020-07-05,Imperial,025,180216,8588,6441,4,6445,47
2020-07-05,Inyo,027,18085,35,32,1,33,1
2020-07-05,Kern,029,883053,11985,5351,37,5388,82
2020-07-05,Kings,031,150075,3066,2546,9,2555,31
2020-07-05,Lake,033,64148,122,92,0,92,1
2020-07-05,Lassen,035,31185,258,219,2,221,0
2020-07-05,Los Angeles,037,10098052,133657,115133,91,115224,3495
2020-07-05,Madera,039,155013,1269,564,3,567,4
2020-07-05,Marin,041,260295,3447,2080,4,2084,17
2020-07-05,Mariposa,043,17540,36,31,0,31,1
2020-07-05,Mendocino,045,87422,104,72,0,72,0
2020-07-05,Merced,047,269075,2350,1340,2,1342,10
2020-07-05,Modoc,049,8938,1,0,0,0,0
2020-07-05,Mono,051,14174,54,39,0,39,1
2020-07-05,Monterey,053,433212,2700,1994,7,2001,15
2020-07-05,Napa,055,140530,578,450,0,450,4
2020-07-05,Nevada,057,99092,186,141,5,146,1
2020-07-05,Orange,059,3164182,27518,19430,279,19709,372
2020-07-05,Placer,061,380077,1165,855,3,858,11
2020-07-05,Plumas,063,18699,16,11,0,11,0
2020-07-05,Riverside,065,2383286,27698,21511,28,21539,474
2020-07-05,Sacramento,067,1510023,5670,4265,6,4271,71
2020-07-05,San Benito,069,59416,348,258,0,258,2
2020-07-05,San Bernardino,071,2135413,23100,15026,16,15042,270
2020-07-05,San Diego,073,3302833,20631,16728,2,16730,387
2020-07-05,San Francisco,075,870044,4542,3861,1,3862,50
2020-07-05,San Joaquin,077,732212,7059,5015,4,5019,57
2020-07-05,San Luis Obispo,079,281455,1073,730,7,737,2
2020-07-05,San Mateo,081,765935,4076,3575,6,3581,106
2020-07-05,Santa Barbara,083,443738,4376,3671,37,3708,27
2020-07-05,Santa Clara,085,1922200,6876,5237,19,5256,162
2020-07-05,Santa Cruz,087,273765,582,467,0,467,2
2020-07-05,Shasta,089,179085,255,138,1,139,6
2020-07-05,Sierra,091,2930,1,1,0,1,0
2020-07-05,Siskiyou,093,43540,46,30,0,30,0
2020-07-05,Solano,095,438530,2277,1547,8,1555,22
2020-07-05,Sonoma,097,501317,1840,1369,5,1374,8
2020-07-05,Stanislaus,099,539301,5291,3777,7,3784,45
2020-07-05,Sutter,101,95872,322,241,0,241,2
2020-07-05,Tehama,103,63373,120,95,2,97,1
2020-07-05,Trinity,105,12862,19,2,5,7,0
2020-07-05,Tulare,107,460477,6467,4981,13,4994,135
2020-07-05,Tuolumne,109,53932,67,30,3,33,0
2020-07-05,Ventura,111,848112,5201,3866,18,3884,44
2020-07-05,Yolo,113,214977,935,644,3,647,26
2020-07-05,Yuba,115,75493,137,115,0,115,1
2020-07-04,Alameda,001,1643700,8057,6737,10,6747,141
2020-07-04,Alpine,003,1148,1,1,0,1,0
2020-07-04,Amador,005,37829,36,31,0,31,0
2020-07-04,Butte,007,227075,378,224,11,235,2
2020-07-04,Calaveras,009,45235,69,45,0,45,0
2020-07-04,Colusa,011,21464,123,76,0,76,0
2020-07-04,Contra Costa,013,1133247,4883,3583,6,3589,80
2020-07-04,Del Norte,015,27424,60,50,0,50,0
2020-07-04,El Dorado,017,186661,365,211,3,214,0
2020-07-04,Fresno,019,978130,11678,5999,85,6084,82
2020-07-04,Glenn,021,27897,187,128,0,128,0
2020-07-04,Humboldt,023,135768,177,144,1,145,3
2020-07-04,Imperial,025,180216,8539,6441,4,6445,47
2020-07-04,Inyo,027,18085,35,32,1,33,1
2020-07-04,Kern,029,883053,11681,5231,37,5268,81
2020-07-04,Kings,031,150075,3023,2509,9,2518,31
2020-07-04,Lake,033,64148,115,86,0,86,1
2020-07-04,Lassen,035,31185,258,219,2,221,0
2020-07-04,Los Angeles,037,10098052,131842,107256,80,107336,3462
2020-07-04,Madera,039,155013,1223,568,3,571,4
2020-07-04,Marin,041,260295,3418,1962,4,1966,17
2020-07-04,Mariposa,043,17540,36,28,0,28,1
2020-07-04,Mendocino,045,87422,104,72,0,72,0
2020-07-04,Merced,047,269075,2248,1252,2,1254,10
2020-07-04,Modoc,049,8938,1,0,0,0,0
2020-07-04,Mono,051,14174,54,37,0,37,1
2020-07-04,Monterey,053,433212,2620,1878,7,1885,15
2020-07-04,Napa,055,140530,569,426,0,426,4
2020-07-04,Nevada,057,99092,183,125,5,130,1
2020-07-04,Orange,059,3164182,27084,19247,266,19513,372
2020-07-04,Placer,061,380077,1130,796,3,799,11
2020-07-04,Plumas,063,18699,16,11,0,11,0
2020-07-04,Riverside,065,2383286,27332,21508,28,21536,474
2020-07-04,Sacramento,067,1510023,5499,4039,6,4045,71
2020-07-04,San Benito,069,59416,335,255,0,255,2
2020-07-04,San Bernardino,071,2135413,22674,14636,14,14650,270
2020-07-04,San Diego,073,3302833,20171,16166,2,16168,387
2020-07-04,San Francisco,075,870044,4450,3861,1,3862,50
2020-07-04,San Joaquin,077,732212,6847,4807,4,4811,57
2020-07-04,San Luis Obispo,079,281455,1033,699,7,706,2
2020-07-04,San Mateo,081,765935,4013,3532,6,3538,106
2020-07-04,Santa Barbara,083,443738,4301,3520,35,3555,27
2020-07-04,Santa Clara,085,1922200,6684,5045,18,5063,161
2020-07-04,Santa Cruz,087,273765,572,466,0,466,2
2020-07-04,Shasta,089,179085,252,135,1,136,6
2020-07-04,Sierra,091,2930,1,1,0,1,0
2020-07-04,Siskiyou,093,43540,39,30,0,30,0
2020-07-04,Solano,095,438530,2241,1548,8,1556,22
2020-07-04,Sonoma,097,501317,1814,1370,5,1375,8
2020-07-04,Stanislaus,099,539301,5133,3572,7,3579,44
2020-07-04,Sutter,101,95872,303,225,0,225,2
2020-07-04,Tehama,103,63373,117,92,2,94,1
2020-07-04,Trinity,105,12862,19,2,5,7,0
2020-07-04,Tulare,107,460477,6355,4802,13,4815,135
2020-07-04,Tuolumne,109,53932,63,30,3,33,0
2020-07-04,Ventura,111,848112,5077,3687,18,3705,44
2020-07-04,Yolo,113,214977,910,615,3,618,26
2020-07-04,Yuba,115,75493,130,102,0,102,1
2020-07-03,Alameda,001,1643700,7936,6486,10,6496,141
2020-07-03,Alpine,003,1148,1,1,0,1,0
2020-07-03,Amador,005,37829,36,25,0,25,0
2020-07-03,Butte,007,227075,366,212,11,223,2
2020-07-03,Calaveras,009,45235,69,44,0,44,0
2020-07-03,Colusa,011,21464,117,70,0,70,0
2020-07-03,Contra Costa,013,1133247,4749,3447,6,3453,78
2020-07-03,Del Norte,015,27424,60,50,0,50,0
2020-07-03,El Dorado,017,186661,353,201,3,204,0
2020-07-03,Fresno,019,978130,11373,5783,83,5866,81
2020-07-03,Glenn,021,27897,182,122,0,122,0
2020-07-03,Humboldt,023,135768,173,143,1,144,3
2020-07-03,Imperial,025,180216,8491,6345,4,6349,47
2020-07-03,Inyo,027,18085,35,32,1,33,1
2020-07-03,Kern,029,883053,11420,5213,37,5250,81
2020-07-03,Kings,031,150075,2987,2492,9,2501,31
2020-07-03,Lake,033,64148,108,83,0,83,0
2020-07-03,Lassen,035,31185,258,219,2,221,0
2020-07-03,Los Angeles,037,10098052,130329,107236,76,107312,3461
2020-07-03,Madera,039,155013,1178,565,3,568,4
2020-07-03,Marin,041,260295,3390,1776,4,1780,17
2020-07-03,Mariposa,043,17540,36,28,0,28,1
2020-07-03,Mendocino,045,87422,103,72,0,72,0
2020-07-03,Merced,047,269075,2182,1188,2,1190,10
2020-07-03,Modoc,049,8938,1,0,0,0,0
2020-07-03,Mono,051,14174,54,37,0,37,1
2020-07-03,Monterey,053,433212,2550,1804,7,1811,15
2020-07-03,Napa,055,140530,551,388,0,388,4
2020-07-03,Nevada,057,99092,182,125,5,130,1
2020-07-03,Orange,059,3164182,26693,18819,258,19077,366
2020-07-03,Placer,061,380077,1103,745,3,748,11
2020-07-03,Plumas,063,18699,16,11,0,11,0
2020-07-03,Riverside,065,2383286,27026,21171,28,21199,472
2020-07-03,Sacramento,067,1510023,5365,3711,6,3717,71
2020-07-03,San Benito,069,59416,328,243,0,243,2
2020-07-03,San Bernardino,071,2135413,22286,14040,14,14054,269
2020-07-03,San Diego,073,3302833,19716,15698,2,15700,387
2020-07-03,San Francisco,075,870044,4404,3781,1,3782,50
2020-07-03,San Joaquin,077,732212,6708,4416,3,4419,56
2020-07-03,San Luis Obispo,079,281455,998,676,7,683,2
2020-07-03,San Mateo,081,765935,3956,3439,6,3445,106
2020-07-03,Santa Barbara,083,443738,4214,3406,34,3440,27
2020-07-03,Santa Clara,085,1922200,6572,4820,18,4838,161
2020-07-03,Santa Cruz,087,273765,558,436,0,436,2
2020-07-03,Shasta,089,179085,244,113,1,114,6
2020-07-03,Sierra,091,2930,1,1,0,1,0
2020-07-03,Siskiyou,093,43540,36,30,0,30,0
2020-07-03,Solano,095,438530,2197,1496,7,1503,22
2020-07-03,Sonoma,097,501317,1766,1282,5,1287,8
2020-07-03,Stanislaus,099,539301,5009,3021,7,3028,43
2020-07-03,Sutter,101,95872,293,205,0,205,2
2020-07-03,Tehama,103,63373,115,89,2,91,1
2020-07-03,Trinity,105,12862,19,2,5,7,0
2020-07-03,Tulare,107,460477,6240,4656,13,4669,134
2020-07-03,Tuolumne,109,53932,61,27,3,30,0
2020-07-03,Ventura,111,848112,4981,3536,18,3554,44
2020-07-03,Yolo,113,214977,876,586,3,589,25
2020-07-03,Yuba,115,75493,125,96,0,96,1
2020-07-02,Alameda,001,1643700,7810,6386,10,6396,139
2020-07-02,Alpine,003,1148,1,1,0,1,0
2020-07-02,Amador,005,37829,35,23,0,23,0
2020-07-02,Butte,007,227075,349,199,11,210,2
2020-07-02,Calaveras,009,45235,65,42,0,42,0
2020-07-02,Colusa,011,21464,109,60,0,60,0
2020-07-02,Contra Costa,013,1133247,4566,3347,6,3353,77
2020-07-02,Del Norte,015,27424,59,50,0,50,0
2020-07-02,El Dorado,017,186661,342,193,3,196,0
2020-07-02,Fresno,019,978130,10913,5402,82,5484,78
2020-07-02,Glenn,021,27897,176,114,0,114,0
2020-07-02,Humboldt,023,135768,169,138,1,139,3
2020-07-02,Imperial,025,180216,8390,6236,4,6240,47
2020-07-02,Inyo,027,18085,35,29,1,30,1
2020-07-02,Kern,029,883053,10885,5036,35,5071,78
2020-07-02,Kings,031,150075,2936,2419,9,2428,31
2020-07-02,Lake,033,64148,104,81,0,81,0
2020-07-02,Lassen,035,31185,256,218,2,220,0
2020-07-02,Los Angeles,037,10098052,128312,107144,53,107197,3458
2020-07-02,Madera,039,155013,1110,548,3,551,4
2020-07-02,Marin,041,260295,3304,1706,4,1710,17
2020-07-02,Mariposa,043,17540,35,28,0,28,1
2020-07-02,Mendocino,045,87422,99,71,0,71,0
2020-07-02,Merced,047,269075,2085,1122,2,1124,10
2020-07-02,Modoc,049,8938,1,0,0,0,0
2020-07-02,Mono,051,14174,54,37,0,37,1
2020-07-02,Monterey,053,433212,2490,1796,7,1803,15
2020-07-02,Napa,055,140530,534,352,0,352,4
2020-07-02,Nevada,057,99092,176,118,4,122,1
2020-07-02,Orange,059,3164182,25930,17056,245,17301,360
2020-07-02,Placer,061,380077,1079,740,3,743,11
2020-07-02,Plumas,063,18699,15,8,0,8,0
2020-07-02,Riverside,065,2383286,26453,20253,28,20281,458
2020-07-02,Sacramento,067,1510023,5138,3587,6,3593,70
2020-07-02,San Benito,069,59416,320,236,0,236,2
2020-07-02,San Bernardino,071,2135413,21748,13185,14,13199,260
2020-07-02,San Diego,073,3302833,19251,15208,2,15210,377
2020-07-02,San Francisco,075,870044,4309,3676,1,3677,50
2020-07-02,San Joaquin,077,732212,6361,4243,3,4246,56
2020-07-02,San Luis Obispo,079,281455,953,659,7,666,2
2020-07-02,San Mateo,081,765935,3876,3390,6,3396,107
2020-07-02,Santa Barbara,083,443738,4114,3385,32,3417,27
2020-07-02,Santa Clara,085,1922200,6446,4722,18,4740,160
2020-07-02,Santa Cruz,087,273765,535,414,0,414,2
2020-07-02,Shasta,089,179085,241,110,1,111,5
2020-07-02,Sierra,091,2930,1,1,0,1,0
2020-07-02,Siskiyou,093,43540,36,30,0,30,0
2020-07-02,Solano,095,438530,2114,1429,7,1436,21
2020-07-02,Sonoma,097,501317,1708,1244,5,1249,6
2020-07-02,Stanislaus,099,539301,4837,2850,7,2857,41
2020-07-02,Sutter,101,95872,282,195,0,195,2
2020-07-02,Tehama,103,63373,113,86,2,88,1
2020-07-02,Trinity,105,12862,19,2,5,7,0
2020-07-02,Tulare,107,460477,6073,4559,12,4571,132
2020-07-02,Tuolumne,109,53932,58,23,2,25,0
2020-07-02,Ventura,111,848112,4825,3394,18,3412,42
2020-07-02,Yolo,113,214977,844,554,3,557,24
2020-07-02,Yuba,115,75493,115,93,0,93,1
2020-07-01,Alameda,001,1643700,7593,6125,10,6135,137
2020-07-01,Alpine,003,1148,1,1,0,1,0
2020-07-01,Amador,005,37829,34,22,0,22,0
2020-07-01,Butte,007,227075,324,185,11,196,2
2020-07-01,Calaveras,009,45235,63,37,0,37,0
2020-07-01,Colusa,011,21464,103,53,0,53,0
2020-07-01,Contra Costa,013,1133247,4352,3259,6,3265,76
2020-07-01,Del Norte,015,27424,59,50,0,50,0
2020-07-01,El Dorado,017,186661,315,183,3,186,0
2020-07-01,Fresno,019,978130,10478,5111,79,5190,76
2020-07-01,Glenn,021,27897,170,110,0,110,0
2020-07-01,Humboldt,023,135768,164,134,0,134,3
2020-07-01,Imperial,025,180216,8293,6150,4,6154,46
2020-07-01,Inyo,027,18085,34,30,1,31,1
2020-07-01,Kern,029,883053,10251,4853,34,4887,78
2020-07-01,Kings,031,150075,2868,2360,9,2369,30
2020-07-01,Lake,033,64148,103,75,0,75,0
2020-07-01,Lassen,035,31185,255,217,2,219,0
2020-07-01,Los Angeles,037,10098052,125112,105325,44,105369,3408
2020-07-01,Madera,039,155013,1069,519,3,522,4
2020-07-01,Marin,041,260295,3147,1636,4,1640,17
2020-07-01,Mariposa,043,17540,35,29,0,29,1
2020-07-01,Mendocino,045,87422,95,70,0,70,0
2020-07-01,Merced,047,269075,1986,1052,2,1054,10
2020-07-01,Modoc,049,8938,1,0,0,0,0
2020-07-01,Mono,051,14174,51,37,0,37,1
2020-07-01,Monterey,053,433212,2382,1703,6,1709,15
2020-07-01,Napa,055,140530,511,347,0,347,4
2020-07-01,Nevada,057,99092,166,115,4,119,1
2020-07-01,Orange,059,3164182,25044,15662,224,15886,343
2020-07-01,Placer,061,380077,1032,713,3,716,11
2020-07-01,Plumas,063,18699,13,8,0,8,0
2020-07-01,Riverside,065,2383286,25611,19537,27,19564,457
2020-07-01,Sacramento,067,1510023,4883,3425,6,3431,64
2020-07-01,San Benito,069,59416,311,219,0,219,2
2020-07-01,San Bernardino,071,2135413,20853,12712,11,12723,253
2020-07-01,San Diego,073,3302833,18683,14624,2,14626,372
2020-07-01,San Francisco,075,870044,4216,3626,1,3627,50
2020-07-01,San Joaquin,077,732212,6003,3990,3,3993,54
2020-07-01,San Luis Obispo,079,281455,926,613,7,620,1
2020-07-01,San Mateo,081,765935,3814,3326,6,3332,84
2020-07-01,Santa Barbara,083,443738,3994,3268,31,3299,27
2020-07-01,Santa Clara,085,1922200,6259,4547,17,4564,159
2020-07-01,Santa Cruz,087,273765,511,398,0,398,2
2020-07-01,Shasta,089,179085,236,104,1,105,5
2020-07-01,Sierra,091,2930,1,1,0,1,0
2020-07-01,Siskiyou,093,43540,36,28,0,28,0
2020-07-01,Solano,095,438530,2023,1350,7,1357,21
2020-07-01,Sonoma,097,501317,1613,1178,5,1183,6
2020-07-01,Stanislaus,099,539301,4559,2619,7,2626,41
2020-07-01,Sutter,101,95872,269,188,0,188,2
2020-07-01,Tehama,103,63373,106,80,2,82,1
2020-07-01,Trinity,105,12862,19,2,4,6,0
2020-07-01,Tulare,107,460477,5895,4359,12,4371,128
2020-07-01,Tuolumne,109,53932,55,17,2,19,0
2020-07-01,Ventura,111,848112,4683,3224,16,3240,41
2020-07-01,Yolo,113,214977,793,526,3,529,24
2020-07-01,Yuba,115,75493,110,57,0,57,1
2020-06-30,Alameda,001,1643700,7345,5959,8,5967,137
2020-06-30,Alpine,003,1148,1,1,0,1,0
2020-06-30,Amador,005,37829,34,21,0,21,0
2020-06-30,Butte,007,227075,307,163,11,174,2
2020-06-30,Calaveras,009,45235,58,31,0,31,0
2020-06-30,Colusa,011,21464,94,33,0,33,0
2020-06-30,Contra Costa,013,1133247,4144,3140,6,3146,75
2020-06-30,Del Norte,015,27424,59,48,0,48,0
2020-06-30,El Dorado,017,186661,302,175,3,178,0
2020-06-30,Fresno,019,978130,10031,4826,74,4900,75
2020-06-30,Glenn,021,27897,165,96,0,96,0
2020-06-30,Humboldt,023,135768,160,132,0,132,3
2020-06-30,Imperial,025,180216,8194,5968,4,5972,45
2020-06-30,Inyo,027,18085,34,30,1,31,1
2020-06-30,Kern,029,883053,9604,4721,31,4752,75
2020-06-30,Kings,031,150075,2819,2315,6,2321,30
2020-06-30,Lake,033,64148,95,56,0,56,0
2020-06-30,Lassen,035,31185,248,215,2,217,0
2020-06-30,Los Angeles,037,10098052,121528,103640,41,103681,3378
2020-06-30,Madera,039,155013,1012,475,3,478,4
2020-06-30,Marin,041,260295,3076,1614,4,1618,17
2020-06-30,Mariposa,043,17540,34,27,0,27,1
2020-06-30,Mendocino,045,87422,90,65,0,65,0
2020-06-30,Merced,047,269075,1849,970,2,972,10
2020-06-30,Modoc,049,8938,1,0,0,0,0
2020-06-30,Mono,051,14174,49,36,0,36,1
2020-06-30,Monterey,053,433212,2285,1657,6,1663,15
2020-06-30,Napa,055,140530,486,342,0,342,4
2020-06-30,Nevada,057,99092,158,113,4,117,1
2020-06-30,Orange,059,3164182,24113,14354,214,14568,335
2020-06-30,Placer,061,380077,1005,667,3,670,11
2020-06-30,Plumas,063,18699,12,8,0,8,0
2020-06-30,Riverside,065,2383286,24893,18656,26,18682,449
2020-06-30,Sacramento,067,1510023,4594,3246,6,3252,64
2020-06-30,San Benito,069,59416,300,200,0,200,2
2020-06-30,San Bernardino,071,2135413,19871,12375,10,12385,249
2020-06-30,San Diego,073,3302833,17978,14150,2,14152,365
2020-06-30,San Francisco,075,870044,4111,3555,1,3556,50
2020-06-30,San Joaquin,077,732212,5628,3744,3,3747,52
2020-06-30,San Luis Obispo,079,281455,888,583,7,590,1
2020-06-30,San Mateo,081,765935,3736,3268,6,3274,84
2020-06-30,Santa Barbara,083,443738,3878,3102,31,3133,25
2020-06-30,Santa Clara,085,1922200,6056,4346,17,4363,157
2020-06-30,Santa Cruz,087,273765,485,379,0,379,2
2020-06-30,Shasta,089,179085,220,100,1,101,5
2020-06-30,Sierra,091,2930,1,1,0,1,0
2020-06-30,Siskiyou,093,43540,35,26,0,26,0
2020-06-30,Solano,095,438530,1931,1256,7,1263,21
2020-06-30,Sonoma,097,501317,1550,1122,5,1127,6
2020-06-30,Stanislaus,099,539301,4262,2578,7,2585,41
2020-06-30,Sutter,101,95872,246,168,0,168,2
2020-06-30,Tehama,103,63373,104,75,2,77,1
2020-06-30,Trinity,105,12862,19,2,4,6,0
2020-06-30,Tulare,107,460477,5686,4207,12,4219,117
2020-06-30,Tuolumne,109,53932,51,16,2,18,0
2020-06-30,Ventura,111,848112,4549,3030,16,3046,40
2020-06-30,Yolo,113,214977,755,515,3,518,24
2020-06-30,Yuba,115,75493,106,55,0,55,1
2020-06-29,Alameda,001,1643700,7137,5766,8,5774,135
2020-06-29,Alpine,003,1148,1,1,0,1,0
2020-06-29,Amador,005,37829,31,20,0,20,0
2020-06-29,Butte,007,227075,286,157,11,168,2
2020-06-29,Calaveras,009,45235,56,30,0,30,0
2020-06-29,Colusa,011,21464,89,17,0,17,0
2020-06-29,Contra Costa,013,1133247,3981,2976,5,2981,75
2020-06-29,Del Norte,015,27424,59,47,0,47,0
2020-06-29,El Dorado,017,186661,288,163,1,164,0
2020-06-29,Fresno,019,978130,9683,4531,72,4603,74
2020-06-29,Glenn,021,27897,156,77,0,77,0
2020-06-29,Humboldt,023,135768,159,128,0,128,3
2020-06-29,Imperial,025,180216,8063,5512,4,5516,45
2020-06-29,Inyo,027,18085,33,29,0,29,1
2020-06-29,Kern,029,883053,8941,4613,29,4642,73
2020-06-29,Kings,031,150075,2754,2280,6,2286,20
2020-06-29,Lake,033,64148,88,53,0,53,0
2020-06-29,Lassen,035,31185,240,77,2,79,0
2020-06-29,Los Angeles,037,10098052,118488,100846,35,100881,3337
2020-06-29,Madera,039,155013,955,422,3,425,4
2020-06-29,Marin,041,260295,3000,1517,4,1521,17
2020-06-29,Mariposa,043,17540,32,25,0,25,1
2020-06-29,Mendocino,045,87422,87,63,0,63,0
2020-06-29,Merced,047,269075,1743,848,2,850,10
2020-06-29,Modoc,049,8938,1,0,0,0,0
2020-06-29,Mono,051,14174,47,35,0,35,1
2020-06-29,Monterey,053,433212,2213,1614,6,1620,14
2020-06-29,Napa,055,140530,464,317,0,317,4
2020-06-29,Nevada,057,99092,155,107,3,110,1
2020-06-29,Orange,059,3164182,23123,13682,199,13881,324
2020-06-29,Placer,061,380077,969,628,3,631,11
2020-06-29,Plumas,063,18699,12,6,0,6,0
2020-06-29,Riverside,065,2383286,23859,17683,26,17709,432
2020-06-29,Sacramento,067,1510023,4307,2985,6,2991,62
2020-06-29,San Benito,069,59416,285,193,0,193,2
2020-06-29,San Bernardino,071,2135413,18908,11643,10,11653,245
2020-06-29,San Diego,073,3302833,17400,13834,2,13836,361
2020-06-29,San Francisco,075,870044,4034,3389,1,3390,50
2020-06-29,San Joaquin,077,732212,5270,3202,3,3205,52
2020-06-29,San Luis Obispo,079,281455,854,544,7,551,1
2020-06-29,San Mateo,081,765935,3682,3170,6,3176,84
2020-06-29,Santa Barbara,083,443738,3769,2933,30,2963,25
2020-06-29,Santa Clara,085,1922200,5885,4231,17,4248,157
2020-06-29,Santa Cruz,087,273765,467,348,0,348,2
2020-06-29,Shasta,089,179085,212,94,1,95,5
2020-06-29,Sierra,091,2930,1,1,0,1,0
2020-06-29,Siskiyou,093,43540,35,25,0,25,0
2020-06-29,Solano,095,438530,1828,1077,7,1084,21
2020-06-29,Sonoma,097,501317,1478,1103,5,1108,5
2020-06-29,Stanislaus,099,539301,4056,2400,6,2406,36
2020-06-29,Sutter,101,95872,224,152,0,152,2
2020-06-29,Tehama,103,63373,100,63,2,65,1
2020-06-29,Trinity,105,12862,18,2,4,6,0
2020-06-29,Tulare,107,460477,5531,3906,11,3917,117
2020-06-29,Tuolumne,109,53932,47,16,2,18,0
2020-06-29,Ventura,111,848112,4402,2794,16,2810,40
2020-06-29,Yolo,113,214977,722,483,3,486,24
2020-06-29,Yuba,115,75493,93,55,0,55,1
2020-06-28,Alameda,001,1643700,6878,5698,8,5706,135
2020-06-28,Alpine,003,1148,1,1,0,1,0
2020-06-28,Amador,005,37829,29,20,0,20,0
2020-06-28,Butte,007,227075,266,150,11,161,2
2020-06-28,Calaveras,009,45235,51,30,0,30,0
2020-06-28,Colusa,011,21464,74,17,0,17,0
2020-06-28,Contra Costa,013,1133247,3790,2803,4,2807,73
2020-06-28,Del Norte,015,27424,58,47,0,47,0
2020-06-28,El Dorado,017,186661,276,162,1,163,0
2020-06-28,Fresno,019,978130,9320,4365,72,4437,74
2020-06-28,Glenn,021,27897,148,77,0,77,0
2020-06-28,Humboldt,023,135768,156,127,0,127,3
2020-06-28,Imperial,025,180216,7874,5513,4,5517,45
2020-06-28,Inyo,027,18085,33,29,0,29,1
2020-06-28,Kern,029,883053,8390,4541,27,4568,72
2020-06-28,Kings,031,150075,2694,2234,6,2240,18
2020-06-28,Lake,033,64148,84,53,0,53,0
2020-06-28,Lassen,035,31185,240,77,2,79,0
2020-06-28,Los Angeles,037,10098052,115285,98003,31,98034,3316
2020-06-28,Madera,039,155013,907,424,3,427,4
2020-06-28,Marin,041,260295,2654,1473,4,1477,17
2020-06-28,Mariposa,043,17540,32,24,0,24,1
2020-06-28,Mendocino,045,87422,85,63,0,63,0
2020-06-28,Merced,047,269075,1630,814,2,816,10
2020-06-28,Modoc,049,8938,1,0,0,0,0
2020-06-28,Mono,051,14174,47,35,0,35,1
2020-06-28,Monterey,053,433212,2131,1560,6,1566,13
2020-06-28,Napa,055,140530,430,307,0,307,4
2020-06-28,Nevada,057,99092,144,102,3,105,1
2020-06-28,Orange,059,3164182,22149,13213,181,13394,324
2020-06-28,Placer,061,380077,930,618,3,621,11
2020-06-28,Plumas,063,18699,11,6,0,6,0
2020-06-28,Riverside,065,2383286,23031,16848,25,16873,432
2020-06-28,Sacramento,067,1510023,4079,2803,6,2809,63
2020-06-28,San Benito,069,59416,274,190,0,190,2
2020-06-28,San Bernardino,071,2135413,18155,11344,9,11353,245
2020-06-28,San Diego,073,3302833,16855,13333,2,13335,361
2020-06-28,San Francisco,075,870044,3956,3388,1,3389,50
2020-06-28,San Joaquin,077,732212,4933,3201,3,3204,52
2020-06-28,San Luis Obispo,079,281455,815,531,6,537,1
2020-06-28,San Mateo,081,765935,3605,3124,5,3129,84
2020-06-28,Santa Barbara,083,443738,3624,2872,30,2902,25
2020-06-28,Santa Clara,085,1922200,5723,4131,17,4148,156
2020-06-28,Santa Cruz,087,273765,444,349,0,349,2
2020-06-28,Shasta,089,179085,199,89,0,89,5
2020-06-28,Sierra,091,2930,1,1,0,1,0
2020-06-28,Siskiyou,093,43540,35,25,0,25,0
2020-06-28,Solano,095,438530,1753,1077,7,1084,21
2020-06-28,Sonoma,097,501317,1424,1084,5,1089,5
2020-06-28,Stanislaus,099,539301,3850,2376,6,2382,36
2020-06-28,Sutter,101,95872,198,145,0,145,2
2020-06-28,Tehama,103,63373,93,63,2,65,1
2020-06-28,Trinity,105,12862,17,2,4,6,0
2020-06-28,Tulare,107,460477,5363,3812,11,3823,117
2020-06-28,Tuolumne,109,53932,42,14,2,16,0
2020-06-28,Ventura,111,848112,4244,2650,16,2666,40
2020-06-28,Yolo,113,214977,687,468,3,471,24
2020-06-28,Yuba,115,75493,89,39,0,39,1
2020-06-27,Alameda,001,1643700,6782,5581,8,5589,135
2020-06-27,Alpine,003,1148,1,1,0,1,0
2020-06-27,Amador,005,37829,27,20,0,20,0
2020-06-27,Butte,007,227075,258,137,11,148,2
2020-06-27,Calaveras,009,45235,49,30,0,30,0
2020-06-27,Colusa,011,21464,68,17,0,17,0
2020-06-27,Contra Costa,013,1133247,3696,2717,3,2720,72
2020-06-27,Del Norte,015,27424,58,47,0,47,0
2020-06-27,El Dorado,017,186661,270,159,1,160,0
2020-06-27,Fresno,019,978130,9074,4238,72,4310,74
2020-06-27,Glenn,021,27897,144,77,0,77,0
2020-06-27,Humboldt,023,135768,154,127,0,127,3
2020-06-27,Imperial,025,180216,7813,5513,4,5517,45
2020-06-27,Inyo,027,18085,33,29,0,29,1
2020-06-27,Kern,029,883053,8127,4411,26,4437,70
2020-06-27,Kings,031,150075,2668,2187,6,2193,18
2020-06-27,Lake,033,64148,81,42,0,42,0
2020-06-27,Lassen,035,31185,240,33,2,35,0
2020-06-27,Los Angeles,037,10098052,113544,95341,28,95369,3291
2020-06-27,Madera,039,155013,864,427,2,429,4
2020-06-27,Marin,041,260295,2609,1423,4,1427,17
2020-06-27,Mariposa,043,17540,31,22,0,22,1
2020-06-27,Mendocino,045,87422,85,63,0,63,0
2020-06-27,Merced,047,269075,1572,807,1,808,10
2020-06-27,Modoc,049,8938,1,0,0,0,0
2020-06-27,Mono,051,14174,46,35,0,35,1
2020-06-27,Monterey,053,433212,2067,1455,6,1461,12
2020-06-27,Napa,055,140530,420,282,0,282,3
2020-06-27,Nevada,057,99092,140,102,2,104,1
2020-06-27,Orange,059,3164182,21638,12951,176,13127,320
2020-06-27,Placer,061,380077,909,584,3,587,10
2020-06-27,Plumas,063,18699,11,6,0,6,0
2020-06-27,Riverside,065,2383286,22642,16209,25,16234,432
2020-06-27,Sacramento,067,1510023,3962,2685,6,2691,63
2020-06-27,San Benito,069,59416,267,182,0,182,2
2020-06-27,San Bernardino,071,2135413,17779,11238,9,11247,243
2020-06-27,San Diego,073,3302833,16490,12836,2,12838,360
2020-06-27,San Francisco,075,870044,3901,3332,1,3333,49
2020-06-27,San Joaquin,077,732212,4767,2995,3,2998,52
2020-06-27,San Luis Obispo,079,281455,792,505,6,511,1
2020-06-27,San Mateo,081,765935,3548,3083,5,3088,83
2020-06-27,Santa Barbara,083,443738,3552,2799,30,2829,25
2020-06-27,Santa Clara,085,1922200,5617,4006,17,4023,157
2020-06-27,Santa Cruz,087,273765,437,347,0,347,2
2020-06-27,Shasta,089,179085,193,87,0,87,5
2020-06-27,Sierra,091,2930,1,1,0,1,0
2020-06-27,Siskiyou,093,43540,35,25,0,25,0
2020-06-27,Solano,095,438530,1720,1076,7,1083,21
2020-06-27,Sonoma,097,501317,1391,1004,5,1009,5
2020-06-27,Stanislaus,099,539301,3750,2164,6,2170,36
2020-06-27,Sutter,101,95872,191,141,0,141,2
2020-06-27,Tehama,103,63373,90,63,2,65,1
2020-06-27,Trinity,105,12862,17,2,4,6,0
2020-06-27,Tulare,107,460477,5267,3810,11,3821,117
2020-06-27,Tuolumne,109,53932,41,13,2,15,0
2020-06-27,Ventura,111,848112,4144,2471,16,2487,40
2020-06-27,Yolo,113,214977,663,432,3,435,24
2020-06-27,Yuba,115,75493,81,39,0,39,1
2020-06-26,Alameda,001,1643700,6696,5502,7,5509,132
2020-06-26,Alpine,003,1148,1,1,0,1,0
2020-06-26,Amador,005,37829,26,20,0,20,0
2020-06-26,Butte,007,227075,243,135,11,146,2
2020-06-26,Calaveras,009,45235,47,30,0,30,0
2020-06-26,Colusa,011,21464,63,17,0,17,0
2020-06-26,Contra Costa,013,1133247,3584,2676,3,2679,72
2020-06-26,Del Norte,015,27424,57,47,0,47,0
2020-06-26,El Dorado,017,186661,262,159,1,160,0
2020-06-26,Fresno,019,978130,8848,4166,72,4238,74
2020-06-26,Glenn,021,27897,137,71,0,71,0
2020-06-26,Humboldt,023,135768,152,126,0,126,3
2020-06-26,Imperial,025,180216,7750,5400,4,5404,44
2020-06-26,Inyo,027,18085,32,29,0,29,1
2020-06-26,Kern,029,883053,7797,4366,26,4392,70
2020-06-26,Kings,031,150075,2636,2176,5,2181,18
2020-06-26,Lake,033,64148,80,42,0,42,0
2020-06-26,Lassen,035,31185,239,30,2,32,0
2020-06-26,Los Angeles,037,10098052,111378,93328,28,93356,3275
2020-06-26,Madera,039,155013,832,409,2,411,4
2020-06-26,Marin,041,260295,2572,1406,4,1410,17
2020-06-26,Mariposa,043,17540,30,21,0,21,1
2020-06-26,Mendocino,045,87422,82,63,0,63,0
2020-06-26,Merced,047,269075,1526,797,1,798,10
2020-06-26,Modoc,049,8938,1,0,0,0,0
2020-06-26,Mono,051,14174,45,35,0,35,1
2020-06-26,Monterey,053,433212,2015,1449,6,1455,12
2020-06-26,Napa,055,140530,410,277,0,277,3
2020-06-26,Nevada,057,99092,136,101,1,102,1
2020-06-26,Orange,059,3164182,20962,12659,173,12832,320
2020-06-26,Placer,061,380077,880,584,3,587,10
2020-06-26,Plumas,063,18699,11,6,0,6,0
2020-06-26,Riverside,065,2383286,22179,15858,25,15883,430
2020-06-26,Sacramento,067,1510023,3797,2687,6,2693,63
2020-06-26,San Benito,069,59416,263,176,0,176,2
2020-06-26,San Bernardino,071,2135413,17401,11111,9,11120,243
2020-06-26,San Diego,073,3302833,16125,12402,2,12404,358
2020-06-26,San Francisco,075,870044,3846,3330,1,3331,49
2020-06-26,San Joaquin,077,732212,4553,2943,3,2946,52
2020-06-26,San Luis Obispo,079,281455,777,498,6,504,1
2020-06-26,San Mateo,081,765935,3496,3055,5,3060,83
2020-06-26,Santa Barbara,083,443738,3462,2784,28,2812,25
2020-06-26,Santa Clara,085,1922200,5517,3968,17,3985,156
2020-06-26,Santa Cruz,087,273765,430,344,0,344,2
2020-06-26,Shasta,089,179085,186,86,0,86,5
2020-06-26,Sierra,091,2930,1,1,0,1,0
2020-06-26,Siskiyou,093,43540,34,24,0,24,0
2020-06-26,Solano,095,438530,1678,1068,7,1075,21
2020-06-26,Sonoma,097,501317,1360,977,5,982,5
2020-06-26,Stanislaus,099,539301,3637,2157,6,2163,36
2020-06-26,Sutter,101,95872,184,138,0,138,2
2020-06-26,Tehama,103,63373,87,63,2,65,1
2020-06-26,Trinity,105,12862,17,2,4,6,0
2020-06-26,Tulare,107,460477,5178,3720,11,3731,117
2020-06-26,Tuolumne,109,53932,39,10,2,12,0
2020-06-26,Ventura,111,848112,4058,2444,16,2460,40
2020-06-26,Yolo,113,214977,640,418,3,421,24
2020-06-26,Yuba,115,75493,75,38,0,38,1
2020-06-25,Alameda,001,1643700,6507,5398,7,5405,130
2020-06-25,Alpine,003,1148,1,1,0,1,0
2020-06-25,Amador,005,37829,25,18,0,18,0
2020-06-25,Butte,007,227075,238,127,11,138,1
2020-06-25,Calaveras,009,45235,42,26,0,26,0
2020-06-25,Colusa,011,21464,53,14,0,14,0
2020-06-25,Contra Costa,013,1133247,3399,2591,3,2594,71
2020-06-25,Del Norte,015,27424,55,47,0,47,0
2020-06-25,El Dorado,017,186661,254,150,1,151,0
2020-06-25,Fresno,019,978130,8535,3938,71,4009,71
2020-06-25,Glenn,021,27897,132,59,0,59,0
2020-06-25,Humboldt,023,135768,151,121,0,121,3
2020-06-25,Imperial,025,180216,7621,5192,4,5196,44
2020-06-25,Inyo,027,18085,29,27,0,27,1
2020-06-25,Kern,029,883053,7373,4236,23,4259,69
2020-06-25,Kings,031,150075,2584,2110,5,2115,17
2020-06-25,Lake,033,64148,79,42,0,42,0
2020-06-25,Lassen,035,31185,233,13,2,15,0
2020-06-25,Los Angeles,037,10098052,108609,91524,28,91552,3239
2020-06-25,Madera,039,155013,788,380,2,382,4
2020-06-25,Marin,041,260295,2470,1321,4,1325,17
2020-06-25,Mariposa,043,17540,29,20,0,20,1
2020-06-25,Mendocino,045,87422,79,61,0,61,0
2020-06-25,Merced,047,269075,1439,747,1,748,10
2020-06-25,Modoc,049,8938,1,0,0,0,0
2020-06-25,Mono,051,14174,44,35,0,35,1
2020-06-25,Monterey,053,433212,1927,1426,5,1431,12
2020-06-25,Napa,055,140530,392,260,0,260,3
2020-06-25,Nevada,057,99092,128,92,1,93,1
2020-06-25,Orange,059,3164182,20041,12221,171,12392,311
2020-06-25,Placer,061,380077,826,574,3,577,10
2020-06-25,Plumas,063,18699,10,6,0,6,0
2020-06-25,Riverside,065,2383286,21424,15224,25,15249,427
2020-06-25,Sacramento,067,1510023,3574,2519,6,2525,62
2020-06-25,San Benito,069,59416,255,174,0,174,2
2020-06-25,San Bernardino,071,2135413,16649,10590,9,10599,242
2020-06-25,San Diego,073,3302833,15586,11963,2,11965,352
2020-06-25,San Francisco,075,870044,3780,3252,1,3253,48
2020-06-25,San Joaquin,077,732212,4281,2803,3,2806,50
2020-06-25,San Luis Obispo,079,281455,745,473,6,479,1
2020-06-25,San Mateo,081,765935,3428,2996,4,3000,82
2020-06-25,Santa Barbara,083,443738,3357,2622,27,2649,25
2020-06-25,Santa Clara,085,1922200,5368,3871,17,3888,156
2020-06-25,Santa Cruz,087,273765,418,335,0,335,2
2020-06-25,Shasta,089,179085,176,84,0,84,5
2020-06-25,Sierra,091,2930,1,1,0,1,0
2020-06-25,Siskiyou,093,43540,33,24,0,24,0
2020-06-25,Solano,095,438530,1625,1034,7,1041,21
2020-06-25,Sonoma,097,501317,1311,953,4,957,5
2020-06-25,Stanislaus,099,539301,3425,2130,6,2136,36
2020-06-25,Sutter,101,95872,172,126,0,126,2
2020-06-25,Tehama,103,63373,83,59,2,61,1
2020-06-25,Trinity,105,12862,17,2,4,6,0
2020-06-25,Tulare,107,460477,5047,3656,11,3667,117
2020-06-25,Tuolumne,109,53932,38,10,1,11,0
2020-06-25,Ventura,111,848112,3876,2346,15,2361,40
2020-06-25,Yolo,113,214977,611,397,3,400,24
2020-06-25,Yuba,115,75493,64,38,0,38,1
2020-06-24,Alameda,001,1643700,6345,5242,7,5249,123
2020-06-24,Alpine,003,1148,1,1,0,1,0
2020-06-24,Amador,005,37829,23,16,0,16,0
2020-06-24,Butte,007,227075,222,119,10,129,1
2020-06-24,Calaveras,009,45235,40,26,0,26,0
2020-06-24,Colusa,011,21464,44,11,0,11,0
2020-06-24,Contra Costa,013,1133247,3243,2520,3,2523,66
2020-06-24,Del Norte,015,27424,49,47,0,47,0
2020-06-24,El Dorado,017,186661,238,149,1,150,0
2020-06-24,Fresno,019,978130,8204,3765,71,3836,71
2020-06-24,Glenn,021,27897,124,54,0,54,0
2020-06-24,Humboldt,023,135768,151,117,0,117,3
2020-06-24,Imperial,025,180216,7503,5138,4,5142,38
2020-06-24,Inyo,027,18085,29,28,0,28,1
2020-06-24,Kern,029,883053,6980,4155,21,4176,67
2020-06-24,Kings,031,150075,2520,2063,5,2068,16
2020-06-24,Lake,033,64148,66,40,0,40,0
2020-06-24,Lassen,035,31185,232,9,2,11,0
2020-06-24,Los Angeles,037,10098052,105847,89566,28,89594,3186
2020-06-24,Madera,039,155013,766,373,2,375,4
2020-06-24,Marin,041,260295,2242,1261,4,1265,17
2020-06-24,Mariposa,043,17540,28,19,0,19,1
2020-06-24,Mendocino,045,87422,79,60,0,60,0
2020-06-24,Merced,047,269075,1353,696,1,697,8
2020-06-24,Modoc,049,8938,1,0,0,0,0
2020-06-24,Mono,051,14174,42,35,0,35,1
2020-06-24,Monterey,053,433212,1850,1407,5,1412,12
2020-06-24,Napa,055,140530,375,258,0,258,3
2020-06-24,Nevada,057,99092,122,92,1,93,1
2020-06-24,Orange,059,3164182,19044,11804,153,11957,303
2020-06-24,Placer,061,380077,787,548,3,551,10
2020-06-24,Plumas,063,18699,10,6,0,6,0
2020-06-24,Riverside,065,2383286,20577,14946,25,14971,410
2020-06-24,Sacramento,067,1510023,3370,2446,5,2451,62
2020-06-24,San Benito,069,59416,251,171,0,171,2
2020-06-24,San Bernardino,071,2135413,15834,10211,9,10220,239
2020-06-24,San Diego,073,3302833,15083,11628,2,11630,347
2020-06-24,San Francisco,075,870044,3717,3216,1,3217,48
2020-06-24,San Joaquin,077,732212,4060,2680,3,2683,49
2020-06-24,San Luis Obispo,079,281455,714,461,5,466,1
2020-06-24,San Mateo,081,765935,3371,2964,4,2968,82
2020-06-24,Santa Barbara,083,443738,3238,2569,25,2594,22
2020-06-24,Santa Clara,085,1922200,5237,3812,17,3829,155
2020-06-24,Santa Cruz,087,273765,406,329,0,329,2
2020-06-24,Shasta,089,179085,168,83,0,83,5
2020-06-24,Sierra,091,2930,1,1,0,1,0
2020-06-24,Siskiyou,093,43540,32,24,0,24,0
2020-06-24,Solano,095,438530,1535,979,6,985,21
2020-06-24,Sonoma,097,501317,1262,933,4,937,4
2020-06-24,Stanislaus,099,539301,3246,2039,6,2045,36
2020-06-24,Sutter,101,95872,159,118,0,118,2
2020-06-24,Tehama,103,63373,81,55,2,57,1
2020-06-24,Trinity,105,12862,16,2,3,5,0
2020-06-24,Tulare,107,460477,4892,3541,10,3551,116
2020-06-24,Tuolumne,109,53932,33,9,1,10,0
2020-06-24,Ventura,111,848112,3535,2314,15,2329,42
2020-06-24,Yolo,113,214977,576,376,3,379,24
2020-06-24,Yuba,115,75493,58,37,0,37,1
2020-06-23,Alameda,001,1643700,6165,5159,7,5166,121
2020-06-23,Alpine,003,1148,1,1,0,1,0
2020-06-23,Amador,005,37829,22,13,0,13,0
2020-06-23,Butte,007,227075,204,111,10,121,1
2020-06-23,Calaveras,009,45235,40,26,0,26,0
2020-06-23,Colusa,011,21464,40,7,0,7,0
2020-06-23,Contra Costa,013,1133247,3116,2453,3,2456,60
2020-06-23,Del Norte,015,27424,48,46,0,46,0
2020-06-23,El Dorado,017,186661,229,142,1,143,0
2020-06-23,Fresno,019,978130,7552,3569,69,3638,67
2020-06-23,Glenn,021,27897,120,47,0,47,0
2020-06-23,Humboldt,023,135768,151,110,0,110,3
2020-06-23,Imperial,025,180216,7340,5025,4,5029,38
2020-06-23,Inyo,027,18085,29,26,0,26,1
2020-06-23,Kern,029,883053,6613,4087,18,4105,64
2020-06-23,Kings,031,150075,2455,1727,5,1732,16
2020-06-23,Lake,033,64148,60,40,0,40,0
2020-06-23,Lassen,035,31185,228,9,2,11,0
2020-06-23,Los Angeles,037,10098052,102905,88433,27,88460,3152
2020-06-23,Madera,039,155013,727,369,2,371,4
2020-06-23,Marin,041,260295,1974,1139,4,1143,17
2020-06-23,Mariposa,043,17540,26,18,0,18,1
2020-06-23,Mendocino,045,87422,78,61,0,61,0
2020-06-23,Merced,047,269075,1255,656,1,657,8
2020-06-23,Modoc,049,8938,1,0,0,0,0
2020-06-23,Mono,051,14174,42,35,0,35,1
2020-06-23,Monterey,053,433212,1780,1346,5,1351,12
2020-06-23,Napa,055,140530,360,230,0,230,3
2020-06-23,Nevada,057,99092,116,81,1,82,1
2020-06-23,Orange,059,3164182,18075,11071,150,11221,278
2020-06-23,Placer,061,380077,761,525,3,528,10
2020-06-23,Plumas,063,18699,9,6,0,6,0
2020-06-23,Riverside,065,2383286,19558,14469,25,14494,406
2020-06-23,Sacramento,067,1510023,3191,2374,5,2379,62
2020-06-23,San Benito,069,59416,237,167,0,167,2
2020-06-23,San Bernardino,071,2135413,15052,9771,9,9780,229
2020-06-23,San Diego,073,3302833,14563,11296,2,11298,341
2020-06-23,San Francisco,075,870044,3644,3177,1,3178,48
2020-06-23,San Joaquin,077,732212,3801,2502,3,2505,48
2020-06-23,San Luis Obispo,079,281455,683,445,5,450,1
2020-06-23,San Mateo,081,765935,3306,2907,4,2911,81
2020-06-23,Santa Barbara,083,443738,3143,2498,25,2523,22
2020-06-23,Santa Clara,085,1922200,5091,3700,17,3717,155
2020-06-23,Santa Cruz,087,273765,396,313,0,313,2
2020-06-23,Shasta,089,179085,159,81,0,81,5
2020-06-23,Sierra,091,2930,1,1,0,1,0
2020-06-23,Siskiyou,093,43540,30,24,0,24,0
2020-06-23,Solano,095,438530,1478,941,5,946,21
2020-06-23,Sonoma,097,501317,1209,912,4,916,4
2020-06-23,Stanislaus,099,539301,3069,1850,6,1856,35
2020-06-23,Sutter,101,95872,149,112,0,112,2
2020-06-23,Tehama,103,63373,79,50,2,52,1
2020-06-23,Trinity,105,12862,16,2,3,5,0
2020-06-23,Tulare,107,460477,4770,3456,10,3466,111
2020-06-23,Tuolumne,109,53932,28,9,0,9,0
2020-06-23,Ventura,111,848112,3375,2209,14,2223,40
2020-06-23,Yolo,113,214977,550,350,0,350,24
2020-06-23,Yuba,115,75493,55,35,0,35,1
2020-06-22,Alameda,001,1643700,6015,4944,7,4951,121
2020-06-22,Alpine,003,1148,1,1,0,1,0
2020-06-22,Amador,005,37829,19,12,0,12,0
2020-06-22,Butte,007,227075,185,104,10,114,1
2020-06-22,Calaveras,009,45235,38,20,0,20,0
2020-06-22,Colusa,011,21464,37,7,0,7,0
2020-06-22,Contra Costa,013,1133247,2974,2363,3,2366,60
2020-06-22,Del Norte,015,27424,48,46,0,46,0
2020-06-22,El Dorado,017,186661,220,137,1,138,0
2020-06-22,Fresno,019,978130,7020,3425,69,3494,67
2020-06-22,Glenn,021,27897,111,40,0,40,0
2020-06-22,Humboldt,023,135768,148,110,0,110,3
2020-06-22,Imperial,025,180216,7183,4700,4,4704,38
2020-06-22,Inyo,027,18085,29,26,0,26,1
2020-06-22,Kern,029,883053,6261,3982,16,3998,60
2020-06-22,Kings,031,150075,2406,1513,5,1518,13
2020-06-22,Lake,033,64148,54,37,0,37,0
2020-06-22,Lassen,035,31185,118,7,2,9,0
2020-06-22,Los Angeles,037,10098052,100005,85925,26,85951,3117
2020-06-22,Madera,039,155013,702,333,2,335,4
2020-06-22,Marin,041,260295,1717,1029,4,1033,17
2020-06-22,Mariposa,043,17540,25,18,0,18,1
2020-06-22,Mendocino,045,87422,73,48,0,48,0
2020-06-22,Merced,047,269075,1166,619,1,620,8
2020-06-22,Modoc,049,8938,1,0,0,0,0
2020-06-22,Mono,051,14174,42,34,0,34,1
2020-06-22,Monterey,053,433212,1719,1293,5,1298,12
2020-06-22,Napa,055,140530,336,222,0,222,3
2020-06-22,Nevada,057,99092,111,79,1,80,1
2020-06-22,Orange,059,3164182,17143,10711,147,10858,275
2020-06-22,Placer,061,380077,735,512,3,515,9
2020-06-22,Plumas,063,18699,7,6,0,6,0
2020-06-22,Riverside,065,2383286,18586,13948,25,13973,403
2020-06-22,Sacramento,067,1510023,2974,2243,5,2248,62
2020-06-22,San Benito,069,59416,228,164,0,164,2
2020-06-22,San Bernardino,071,2135413,14279,9133,9,9142,229
2020-06-22,San Diego,073,3302833,14071,11098,2,11100,338
2020-06-22,San Francisco,075,870044,3551,3000,1,3001,47
2020-06-22,San Joaquin,077,732212,3553,2332,3,2335,48
2020-06-22,San Luis Obispo,079,281455,650,422,5,427,1
2020-06-22,San Mateo,081,765935,3233,2813,3,2816,81
2020-06-22,Santa Barbara,083,443738,3051,2447,25,2472,21
2020-06-22,Santa Clara,085,1922200,4928,3580,17,3597,155
2020-06-22,Santa Cruz,087,273765,383,290,0,290,3
2020-06-22,Shasta,089,179085,156,77,0,77,5
2020-06-22,Sierra,091,2930,1,1,0,1,0
2020-06-22,Siskiyou,093,43540,30,23,0,23,0
2020-06-22,Solano,095,438530,1400,784,4,788,21
2020-06-22,Sonoma,097,501317,1165,860,2,862,4
2020-06-22,Stanislaus,099,539301,2884,1784,6,1790,35
2020-06-22,Sutter,101,95872,140,100,0,100,2
2020-06-22,Tehama,103,63373,75,38,2,40,1
2020-06-22,Trinity,105,12862,16,2,3,5,0
2020-06-22,Tulare,107,460477,4633,3185,10,3195,111
2020-06-22,Tuolumne,109,53932,19,8,0,8,0
2020-06-22,Ventura,111,848112,3227,2065,14,2079,39
2020-06-22,Yolo,113,214977,524,333,0,333,24
2020-06-22,Yuba,115,75493,50,36,0,36,1
2020-06-21,Alameda,001,1643700,5820,4835,7,4842,121
2020-06-21,Alpine,003,1148,1,1,0,1,0
2020-06-21,Amador,005,37829,14,12,0,12,0
2020-06-21,Butte,007,227075,171,97,10,107,1
2020-06-21,Calaveras,009,45235,38,20,0,20,0
2020-06-21,Colusa,011,21464,29,7,0,7,0
2020-06-21,Contra Costa,013,1133247,2848,2282,3,2285,60
2020-06-21,Del Norte,015,27424,47,46,0,46,0
2020-06-21,El Dorado,017,186661,211,132,1,133,0
2020-06-21,Fresno,019,978130,6450,3296,67,3363,67
2020-06-21,Glenn,021,27897,102,40,0,40,0
2020-06-21,Humboldt,023,135768,143,108,0,108,3
2020-06-21,Imperial,025,180216,7000,4701,4,4705,38
2020-06-21,Inyo,027,18085,27,26,0,26,1
2020-06-21,Kern,029,883053,5969,3918,14,3932,60
2020-06-21,Kings,031,150075,2342,1334,5,1339,11
2020-06-21,Lake,033,64148,49,36,0,36,0
2020-06-21,Lassen,035,31185,25,7,2,9,0
2020-06-21,Los Angeles,037,10098052,97112,83383,25,83408,3101
2020-06-21,Madera,039,155013,668,319,2,321,4
2020-06-21,Marin,041,260295,1560,907,4,911,17
2020-06-21,Mariposa,043,17540,22,18,0,18,1
2020-06-21,Mendocino,045,87422,70,48,0,48,0
2020-06-21,Merced,047,269075,1071,577,1,578,8
2020-06-21,Modoc,049,8938,1,0,0,0,0
2020-06-21,Mono,051,14174,42,34,0,34,1
2020-06-21,Monterey,053,433212,1646,1227,5,1232,12
2020-06-21,Napa,055,140530,321,218,0,218,3
2020-06-21,Nevada,057,99092,108,79,1,80,1
2020-06-21,Orange,059,3164182,16310,10563,144,10707,275
2020-06-21,Placer,061,380077,695,498,3,501,9
2020-06-21,Plumas,063,18699,7,6,0,6,0
2020-06-21,Riverside,065,2383286,17880,13528,24,13552,402
2020-06-21,Sacramento,067,1510023,2773,2156,4,2160,62
2020-06-21,San Benito,069,59416,214,151,0,151,2
2020-06-21,San Bernardino,071,2135413,13504,8925,8,8933,229
2020-06-21,San Diego,073,3302833,13525,10796,2,10798,338
2020-06-21,San Francisco,075,870044,3445,3000,1,3001,47
2020-06-21,San Joaquin,077,732212,3317,2188,3,2191,48
2020-06-21,San Luis Obispo,079,281455,624,418,5,423,1
2020-06-21,San Mateo,081,765935,3175,2781,3,2784,81
2020-06-21,Santa Barbara,083,443738,2944,2430,24,2454,21
2020-06-21,Santa Clara,085,1922200,4791,3514,17,3531,154
2020-06-21,Santa Cruz,087,273765,373,290,0,290,3
2020-06-21,Shasta,089,179085,146,75,0,75,5
2020-06-21,Sierra,091,2930,1,1,0,1,0
2020-06-21,Siskiyou,093,43540,30,23,0,23,0
2020-06-21,Solano,095,438530,1300,783,4,787,21
2020-06-21,Sonoma,097,501317,1115,836,2,838,4
2020-06-21,Stanislaus,099,539301,2698,1688,6,1694,35
2020-06-21,Sutter,101,95872,132,96,0,96,2
2020-06-21,Tehama,103,63373,64,35,2,37,1
2020-06-21,Trinity,105,12862,15,2,3,5,0
2020-06-21,Tulare,107,460477,4464,3173,10,3183,111
2020-06-21,Tuolumne,109,53932,17,8,0,8,0
2020-06-21,Ventura,111,848112,3049,2021,14,2035,39
2020-06-21,Yolo,113,214977,492,323,0,323,24
2020-06-21,Yuba,115,75493,46,35,0,35,1
2020-06-20,Alameda,001,1643700,5758,4758,7,4765,119
2020-06-20,Alpine,003,1148,1,1,0,1,0
2020-06-20,Amador,005,37829,14,12,0,12,0
2020-06-20,Butte,007,227075,164,94,10,104,1
2020-06-20,Calaveras,009,45235,38,20,0,20,0
2020-06-20,Colusa,011,21464,26,7,0,7,0
2020-06-20,Contra Costa,013,1133247,2789,2231,3,2234,54
2020-06-20,Del Norte,015,27424,47,46,0,46,0
2020-06-20,El Dorado,017,186661,206,130,1,131,0
2020-06-20,Fresno,019,978130,6324,3222,64,3286,67
2020-06-20,Glenn,021,27897,97,40,0,40,0
2020-06-20,Humboldt,023,135768,143,108,0,108,3
2020-06-20,Imperial,025,180216,6919,4616,4,4620,37
2020-06-20,Inyo,027,18085,27,26,0,26,1
2020-06-20,Kern,029,883053,5804,3836,14,3850,59
2020-06-20,Kings,031,150075,2318,1331,5,1336,9
2020-06-20,Lake,033,64148,49,37,0,37,0
2020-06-20,Lassen,035,31185,24,7,2,9,0
2020-06-20,Los Angeles,037,10098052,95537,81604,24,81628,3093
2020-06-20,Madera,039,155013,635,321,2,323,4
2020-06-20,Marin,041,260295,1540,879,4,883,17
2020-06-20,Mariposa,043,17540,22,18,0,18,1
2020-06-20,Mendocino,045,87422,69,48,0,48,0
2020-06-20,Merced,047,269075,1031,566,1,567,8
2020-06-20,Modoc,049,8938,1,0,0,0,0
2020-06-20,Mono,051,14174,42,34,0,34,1
2020-06-20,Monterey,053,433212,1610,1181,5,1186,12
2020-06-20,Napa,055,140530,312,212,0,212,3
2020-06-20,Nevada,057,99092,105,73,1,74,1
2020-06-20,Orange,059,3164182,15960,10284,140,10424,273
2020-06-20,Placer,061,380077,670,483,3,486,9
2020-06-20,Plumas,063,18699,6,6,0,6,0
2020-06-20,Riverside,065,2383286,17580,13021,24,13045,402
2020-06-20,Sacramento,067,1510023,2702,2069,4,2073,63
2020-06-20,San Benito,069,59416,210,139,0,139,2
2020-06-20,San Bernardino,071,2135413,13141,8718,8,8726,229
2020-06-20,San Diego,073,3302833,13202,10486,2,10488,338
2020-06-20,San Francisco,075,870044,3401,2999,1,3000,47
2020-06-20,San Joaquin,077,732212,3235,2046,3,2049,48
2020-06-20,San Luis Obispo,079,281455,610,405,5,410,1
2020-06-20,San Mateo,081,765935,3127,2755,3,2758,81
2020-06-20,Santa Barbara,083,443738,2887,2358,23,2381,21
2020-06-20,Santa Clara,085,1922200,4717,3435,17,3452,154
2020-06-20,Santa Cruz,087,273765,371,287,0,287,3
2020-06-20,Shasta,089,179085,140,66,0,66,5
2020-06-20,Sierra,091,2930,1,1,0,1,0
2020-06-20,Siskiyou,093,43540,29,22,0,22,0
2020-06-20,Solano,095,438530,1276,784,4,788,21
2020-06-20,Sonoma,097,501317,1079,806,2,808,4
2020-06-20,Stanislaus,099,539301,2590,1598,6,1604,35
2020-06-20,Sutter,101,95872,130,89,0,89,2
2020-06-20,Tehama,103,63373,62,35,2,37,1
2020-06-20,Trinity,105,12862,15,2,3,5,0
2020-06-20,Tulare,107,460477,4391,3172,10,3182,111
2020-06-20,Tuolumne,109,53932,14,8,0,8,0
2020-06-20,Ventura,111,848112,2983,1946,14,1960,37
2020-06-20,Yolo,113,214977,476,309,0,309,24
2020-06-20,Yuba,115,75493,44,34,0,34,1
2020-06-19,Alameda,001,1643700,5685,4646,7,4653,119
2020-06-19,Alpine,003,1148,1,1,0,1,0
2020-06-19,Amador,005,37829,14,12,0,12,0
2020-06-19,Butte,007,227075,159,91,10,101,1
2020-06-19,Calaveras,009,45235,37,20,0,20,0
2020-06-19,Colusa,011,21464,24,7,0,7,0
2020-06-19,Contra Costa,013,1133247,2710,2106,3,2109,54
2020-06-19,Del Norte,015,27424,47,46,0,46,0
2020-06-19,El Dorado,017,186661,198,124,1,125,0
2020-06-19,Fresno,019,978130,6162,3109,63,3172,61
2020-06-19,Glenn,021,27897,91,40,0,40,0
2020-06-19,Humboldt,023,135768,141,106,0,106,3
2020-06-19,Imperial,025,180216,6827,4504,4,4508,36
2020-06-19,Inyo,027,18085,27,26,0,26,1
2020-06-19,Kern,029,883053,5581,3742,13,3755,57
2020-06-19,Kings,031,150075,2297,1285,5,1290,9
2020-06-19,Lake,033,64148,46,36,0,36,0
2020-06-19,Lassen,035,31185,23,7,2,9,0
2020-06-19,Los Angeles,037,10098052,93550,79572,23,79595,3047
2020-06-19,Madera,039,155013,616,300,2,302,4
2020-06-19,Marin,041,260295,1511,829,4,833,17
2020-06-19,Mariposa,043,17540,21,18,0,18,1
2020-06-19,Mendocino,045,87422,68,48,0,48,0
2020-06-19,Merced,047,269075,986,529,1,530,8
2020-06-19,Modoc,049,8938,1,0,0,0,0
2020-06-19,Mono,051,14174,42,34,0,34,1
2020-06-19,Monterey,053,433212,1581,1159,5,1164,12
2020-06-19,Napa,055,140530,302,209,0,209,3
2020-06-19,Nevada,057,99092,102,71,1,72,1
2020-06-19,Orange,059,3164182,15427,9972,133,10105,260
2020-06-19,Placer,061,380077,652,464,3,467,9
2020-06-19,Plumas,063,18699,6,5,0,5,0
2020-06-19,Riverside,065,2383286,17175,12710,24,12734,398
2020-06-19,Sacramento,067,1510023,2619,1976,4,1980,64
2020-06-19,San Benito,069,59416,209,136,0,136,2
2020-06-19,San Bernardino,071,2135413,12736,8454,7,8461,226
2020-06-19,San Diego,073,3302833,12839,10352,2,10354,332
2020-06-19,San Francisco,075,870044,3346,2968,1,2969,47
2020-06-19,San Joaquin,077,732212,3112,1969,3,1972,48
2020-06-19,San Luis Obispo,079,281455,594,392,5,397,1
2020-06-19,San Mateo,081,765935,3088,2713,3,2716,81
2020-06-19,Santa Barbara,083,443738,2814,2284,21,2305,21
2020-06-19,Santa Clara,085,1922200,4643,3376,17,3393,154
2020-06-19,Santa Cruz,087,273765,361,283,0,283,3
2020-06-19,Shasta,089,179085,137,58,0,58,5
2020-06-19,Sierra,091,2930,1,1,0,1,0
2020-06-19,Siskiyou,093,43540,29,21,0,21,0
2020-06-19,Solano,095,438530,1238,755,4,759,21
2020-06-19,Sonoma,097,501317,1052,803,2,805,4
2020-06-19,Stanislaus,099,539301,2480,1549,6,1555,35
2020-06-19,Sutter,101,95872,129,89,0,89,2
2020-06-19,Tehama,103,63373,61,35,2,37,1
2020-06-19,Trinity,105,12862,15,2,3,5,0
2020-06-19,Tulare,107,460477,4321,3053,10,3063,107
2020-06-19,Tuolumne,109,53932,13,8,0,8,0
2020-06-19,Ventura,111,848112,2899,1865,14,1879,37
2020-06-19,Yolo,113,214977,457,303,0,303,24
2020-06-19,Yuba,115,75493,43,33,0,33,1
2020-06-18,Alameda,001,1643700,5556,4589,7,4596,118
2020-06-18,Alpine,003,1148,1,1,0,1,0
2020-06-18,Amador,005,37829,13,12,0,12,0
2020-06-18,Butte,007,227075,154,88,10,98,1
2020-06-18,Calaveras,009,45235,37,20,0,20,0
2020-06-18,Colusa,011,21464,20,7,0,7,0
2020-06-18,Contra Costa,013,1133247,2603,2072,3,2075,53
2020-06-18,Del Norte,015,27424,47,46,0,46,0
2020-06-18,El Dorado,017,186661,194,121,1,122,0
2020-06-18,Fresno,019,978130,5896,2947,62,3009,57
2020-06-18,Glenn,021,27897,82,35,0,35,0
2020-06-18,Humboldt,023,135768,140,106,0,106,3
2020-06-18,Imperial,025,180216,6677,4366,4,4370,36
2020-06-18,Inyo,027,18085,26,25,0,25,1
2020-06-18,Kern,029,883053,5363,3634,13,3647,57
2020-06-18,Kings,031,150075,2238,1141,5,1146,8
2020-06-18,Lake,033,64148,45,36,0,36,0
2020-06-18,Lassen,035,31185,22,5,2,7,0
2020-06-18,Los Angeles,037,10098052,91283,78244,23,78267,3009
2020-06-18,Madera,039,155013,581,288,2,290,4
2020-06-18,Marin,041,260295,1448,819,4,823,17
2020-06-18,Mariposa,043,17540,19,18,0,18,1
2020-06-18,Mendocino,045,87422,64,45,0,45,0
2020-06-18,Merced,047,269075,934,486,1,487,7
2020-06-18,Modoc,049,8938,1,0,0,0,0
2020-06-18,Mono,051,14174,42,34,0,34,1
2020-06-18,Monterey,053,433212,1513,1127,5,1132,12
2020-06-18,Napa,055,140530,287,205,0,205,3
2020-06-18,Nevada,057,99092,98,68,1,69,1
2020-06-18,Orange,059,3164182,14772,9597,114,9711,255
2020-06-18,Placer,061,380077,629,457,3,460,9
2020-06-18,Plumas,063,18699,6,5,0,5,0
2020-06-18,Riverside,065,2383286,16559,12410,24,12434,392
2020-06-18,Sacramento,067,1510023,2503,1938,4,1942,63
2020-06-18,San Benito,069,59416,203,134,0,134,2
2020-06-18,San Bernardino,071,2135413,12096,8141,7,8148,226
2020-06-18,San Diego,073,3302833,12417,10094,2,10096,331
2020-06-18,San Francisco,075,870044,3297,2951,1,2952,47
2020-06-18,San Joaquin,077,732212,2960,1908,3,1911,47
2020-06-18,San Luis Obispo,079,281455,574,378,5,383,1
2020-06-18,San Mateo,081,765935,3049,2674,3,2677,78
2020-06-18,Santa Barbara,083,443738,2740,2201,21,2222,19
2020-06-18,Santa Clara,085,1922200,4540,3338,17,3355,152
2020-06-18,Santa Cruz,087,273765,344,275,0,275,3
2020-06-18,Shasta,089,179085,126,51,0,51,4
2020-06-18,Sierra,091,2930,1,1,0,1,0
2020-06-18,Siskiyou,093,43540,29,18,0,18,0
2020-06-18,Solano,095,438530,1200,735,4,739,21
2020-06-18,Sonoma,097,501317,1010,789,2,791,4
2020-06-18,Stanislaus,099,539301,2347,1495,6,1501,35
2020-06-18,Sutter,101,95872,125,85,0,85,2
2020-06-18,Tehama,103,63373,56,31,2,33,1
2020-06-18,Trinity,105,12862,15,2,3,5,0
2020-06-18,Tulare,107,460477,4198,3005,10,3015,107
2020-06-18,Tuolumne,109,53932,12,8,0,8,0
2020-06-18,Ventura,111,848112,2773,1781,14,1795,37
2020-06-18,Yolo,113,214977,424,294,0,294,24
2020-06-18,Yuba,115,75493,42,32,0,32,1
2020-06-17,Alameda,001,1643700,5434,4485,7,4492,117
2020-06-17,Alpine,003,1148,1,1,0,1,0
2020-06-17,Amador,005,37829,12,10,0,10,0
2020-06-17,Butte,007,227075,145,81,10,91,1
2020-06-17,Calaveras,009,45235,37,20,0,20,0
2020-06-17,Colusa,011,21464,19,7,0,7,0
2020-06-17,Contra Costa,013,1133247,2506,2020,3,2023,45
2020-06-17,Del Norte,015,27424,47,45,0,45,0
2020-06-17,El Dorado,017,186661,187,116,1,117,0
2020-06-17,Fresno,019,978130,5670,2801,60,2861,56
2020-06-17,Glenn,021,27897,75,31,0,31,0
2020-06-17,Humboldt,023,135768,138,105,0,105,3
2020-06-17,Imperial,025,180216,6504,4108,4,4112,36
2020-06-17,Inyo,027,18085,25,25,0,25,1
2020-06-17,Kern,029,883053,5162,3547,13,3560,56
2020-06-17,Kings,031,150075,2208,1097,5,1102,7
2020-06-17,Lake,033,64148,44,32,0,32,0
2020-06-17,Lassen,035,31185,18,5,2,7,0
2020-06-17,Los Angeles,037,10098052,88974,77166,22,77188,2973
2020-06-17,Madera,039,155013,559,258,2,260,4
2020-06-17,Marin,041,260295,1256,771,3,774,17
2020-06-17,Mariposa,043,17540,18,18,0,18,1
2020-06-17,Mendocino,045,87422,62,42,0,42,0
2020-06-17,Merced,047,269075,862,460,1,461,7
2020-06-17,Modoc,049,8938,1,0,0,0,0
2020-06-17,Mono,051,14174,42,34,0,34,1
2020-06-17,Monterey,053,433212,1461,1077,5,1082,12
2020-06-17,Napa,055,140530,272,202,0,202,3
2020-06-17,Nevada,057,99092,94,57,1,58,1
2020-06-17,Orange,059,3164182,14166,9278,108,9386,230
2020-06-17,Placer,061,380077,609,427,3,430,9
2020-06-17,Plumas,063,18699,6,5,0,5,0
2020-06-17,Riverside,065,2383286,15923,11859,24,11883,370
2020-06-17,Sacramento,067,1510023,2396,1889,4,1893,63
2020-06-17,San Benito,069,59416,198,116,0,116,2
2020-06-17,San Bernardino,071,2135413,11547,7670,7,7677,225
2020-06-17,San Diego,073,3302833,12038,9856,2,9858,327
2020-06-17,San Francisco,075,870044,3258,2906,1,2907,46
2020-06-17,San Joaquin,077,732212,2787,1825,3,1828,46
2020-06-17,San Luis Obispo,079,281455,555,362,5,367,1
2020-06-17,San Mateo,081,765935,3002,2649,3,2652,78
2020-06-17,Santa Barbara,083,443738,2668,2147,19,2166,19
2020-06-17,Santa Clara,085,1922200,4447,3264,16,3280,148
2020-06-17,Santa Cruz,087,273765,338,265,0,265,2
2020-06-17,Shasta,089,179085,124,51,0,51,4
2020-06-17,Sierra,091,2930,1,1,0,1,0
2020-06-17,Siskiyou,093,43540,28,16,0,16,0
2020-06-17,Solano,095,438530,1150,722,4,726,21
2020-06-17,Sonoma,097,501317,985,748,2,750,4
2020-06-17,Stanislaus,099,539301,2223,1387,6,1393,35
2020-06-17,Sutter,101,95872,119,79,0,79,2
2020-06-17,Tehama,103,63373,41,24,2,26,1
2020-06-17,Trinity,105,12862,14,2,3,5,0
2020-06-17,Tulare,107,460477,4088,2882,10,2892,106
2020-06-17,Tuolumne,109,53932,12,7,0,7,0
2020-06-17,Ventura,111,848112,2673,1729,14,1743,37
2020-06-17,Yolo,113,214977,404,277,0,277,24
2020-06-17,Yuba,115,75493,41,30,0,30,1
2020-06-16,Alameda,001,1643700,5316,4428,7,4435,113
2020-06-16,Alpine,003,1148,1,1,0,1,0
2020-06-16,Amador,005,37829,12,10,0,10,0
2020-06-16,Butte,007,227075,141,79,10,89,1
2020-06-16,Calaveras,009,45235,34,19,0,19,0
2020-06-16,Colusa,011,21464,16,7,0,7,0
2020-06-16,Contra Costa,013,1133247,2415,1971,2,1973,45
2020-06-16,Del Norte,015,27424,47,45,0,45,0
2020-06-16,El Dorado,017,186661,181,115,1,116,0
2020-06-16,Fresno,019,978130,5432,2731,58,2789,50
2020-06-16,Glenn,021,27897,71,30,0,30,0
2020-06-16,Humboldt,023,135768,135,105,0,105,3
2020-06-16,Imperial,025,180216,6345,3939,4,3943,36
2020-06-16,Inyo,027,18085,25,24,0,24,1
2020-06-16,Kern,029,883053,4939,3496,13,3509,55
2020-06-16,Kings,031,150075,2162,1044,5,1049,6
2020-06-16,Lake,033,64148,44,31,0,31,0
2020-06-16,Lassen,035,31185,15,5,2,7,0
2020-06-16,Los Angeles,037,10098052,86653,75051,22,75073,2942
2020-06-16,Madera,039,155013,533,239,2,241,3
2020-06-16,Marin,041,260295,1203,725,3,728,17
2020-06-16,Mariposa,043,17540,18,17,0,17,1
2020-06-16,Mendocino,045,87422,61,35,0,35,0
2020-06-16,Merced,047,269075,814,436,1,437,7
2020-06-16,Modoc,049,8938,1,0,0,0,0
2020-06-16,Mono,051,14174,42,34,0,34,1
2020-06-16,Monterey,053,433212,1413,1019,5,1024,12
2020-06-16,Napa,055,140530,257,196,0,196,3
2020-06-16,Nevada,057,99092,91,53,1,54,1
2020-06-16,Orange,059,3164182,13582,9163,102,9265,223
2020-06-16,Placer,061,380077,577,392,3,395,9
2020-06-16,Plumas,063,18699,6,5,0,5,0
2020-06-16,Riverside,065,2383286,15248,11638,24,11662,364
2020-06-16,Sacramento,067,1510023,2286,1825,4,1829,60
2020-06-16,San Benito,069,59416,190,110,0,110,2
2020-06-16,San Bernardino,071,2135413,11003,7463,7,7470,225
2020-06-16,San Diego,073,3302833,11676,9732,1,9733,323
2020-06-16,San Francisco,075,870044,3207,2893,1,2894,46
2020-06-16,San Joaquin,077,732212,2634,1718,3,1721,47
2020-06-16,San Luis Obispo,079,281455,531,343,5,348,1
2020-06-16,San Mateo,081,765935,2948,2618,3,2621,77
2020-06-16,Santa Barbara,083,443738,2601,2090,19,2109,16
2020-06-16,Santa Clara,085,1922200,4336,3228,15,3243,148
2020-06-16,Santa Cruz,087,273765,322,257,0,257,2
2020-06-16,Shasta,089,179085,115,51,0,51,4
2020-06-16,Sierra,091,2930,1,1,0,1,0
2020-06-16,Siskiyou,093,43540,27,15,0,15,0
2020-06-16,Solano,095,438530,1060,694,4,698,19
2020-06-16,Sonoma,097,501317,953,739,2,741,4
2020-06-16,Stanislaus,099,539301,2070,1278,6,1284,36
2020-06-16,Sutter,101,95872,112,73,0,73,2
2020-06-16,Tehama,103,63373,37,24,2,26,1
2020-06-16,Trinity,105,12862,14,2,3,5,0
2020-06-16,Tulare,107,460477,3969,2802,10,2812,96
2020-06-16,Tuolumne,109,53932,12,7,0,7,0
2020-06-16,Ventura,111,848112,2573,1676,14,1690,37
2020-06-16,Yolo,113,214977,381,262,0,262,24
2020-06-16,Yuba,115,75493,39,29,0,29,1
2020-06-15,Alameda,001,1643700,5190,4323,7,4330,112
2020-06-15,Alpine,003,1148,1,1,0,1,0
2020-06-15,Amador,005,37829,12,10,0,10,0
2020-06-15,Butte,007,227075,133,78,10,88,1
2020-06-15,Calaveras,009,45235,34,18,0,18,0
2020-06-15,Colusa,011,21464,14,7,0,7,0
2020-06-15,Contra Costa,013,1133247,2338,1918,2,1920,43
2020-06-15,Del Norte,015,27424,47,45,0,45,0
2020-06-15,El Dorado,017,186661,171,114,1,115,0
2020-06-15,Fresno,019,978130,5220,2616,57,2673,48
2020-06-15,Glenn,021,27897,66,21,0,21,0
2020-06-15,Humboldt,023,135768,133,105,0,105,3
2020-06-15,Imperial,025,180216,6170,3726,4,3730,36
2020-06-15,Inyo,027,18085,25,23,0,23,1
2020-06-15,Kern,029,883053,4716,3417,13,3430,55
2020-06-15,Kings,031,150075,2085,1022,5,1027,6
2020-06-15,Lake,033,64148,44,31,0,31,0
2020-06-15,Lassen,035,31185,15,5,2,7,0
2020-06-15,Los Angeles,037,10098052,84464,73705,22,73727,2908
2020-06-15,Madera,039,155013,511,203,2,205,3
2020-06-15,Marin,041,260295,1036,708,3,711,17
2020-06-15,Mariposa,043,17540,18,17,0,17,1
2020-06-15,Mendocino,045,87422,52,33,0,33,0
2020-06-15,Merced,047,269075,768,414,1,415,7
2020-06-15,Modoc,049,8938,1,0,0,0,0
2020-06-15,Mono,051,14174,42,34,0,34,1
2020-06-15,Monterey,053,433212,1347,998,5,1003,12
2020-06-15,Napa,055,140530,249,187,0,187,3
2020-06-15,Nevada,057,99092,85,52,1,53,1
2020-06-15,Orange,059,3164182,13014,8944,94,9038,212
2020-06-15,Placer,061,380077,555,386,3,389,9
2020-06-15,Plumas,063,18699,6,4,0,4,0
2020-06-15,Riverside,065,2383286,14630,11376,23,11399,364
2020-06-15,Sacramento,067,1510023,2170,1791,4,1795,60
2020-06-15,San Benito,069,59416,184,108,0,108,2
2020-06-15,San Bernardino,071,2135413,10500,7189,7,7196,224
2020-06-15,San Diego,073,3302833,11336,9612,1,9613,320
2020-06-15,San Francisco,075,870044,3163,2833,1,2834,45
2020-06-15,San Joaquin,077,732212,2498,1667,3,1670,43
2020-06-15,San Luis Obispo,079,281455,516,332,5,337,1
2020-06-15,San Mateo,081,765935,2901,2591,3,2594,75
2020-06-15,Santa Barbara,083,443738,2533,2054,19,2073,16
2020-06-15,Santa Clara,085,1922200,4236,3204,15,3219,148
2020-06-15,Santa Cruz,087,273765,311,254,0,254,2
2020-06-15,Shasta,089,179085,109,50,0,50,4
2020-06-15,Sierra,091,2930,1,1,0,1,0
2020-06-15,Siskiyou,093,43540,26,14,0,14,0
2020-06-15,Solano,095,438530,1000,638,4,642,19
2020-06-15,Sonoma,097,501317,924,726,2,728,4
2020-06-15,Stanislaus,099,539301,1953,1253,6,1259,35
2020-06-15,Sutter,101,95872,102,71,0,71,2
2020-06-15,Tehama,103,63373,37,17,2,19,1
2020-06-15,Trinity,105,12862,13,2,3,5,0
2020-06-15,Tulare,107,460477,3855,2662,10,2672,96
2020-06-15,Tuolumne,109,53932,11,7,0,7,0
2020-06-15,Ventura,111,848112,2492,1656,14,1670,37
2020-06-15,Yolo,113,214977,361,255,0,255,24
2020-06-15,Yuba,115,75493,39,28,0,28,1
2020-06-14,Alameda,001,1643700,5043,4271,7,4278,112
2020-06-14,Alpine,003,1148,1,1,0,1,0
2020-06-14,Amador,005,37829,12,10,0,10,0
2020-06-14,Butte,007,227075,125,78,10,88,1
2020-06-14,Calaveras,009,45235,33,18,0,18,0
2020-06-14,Colusa,011,21464,13,7,0,7,0
2020-06-14,Contra Costa,013,1133247,2270,1893,2,1895,43
2020-06-14,Del Norte,015,27424,47,45,0,45,0
2020-06-14,El Dorado,017,186661,167,110,1,111,0
2020-06-14,Fresno,019,978130,5035,2585,56,2641,48
2020-06-14,Glenn,021,27897,51,21,0,21,0
2020-06-14,Humboldt,023,135768,129,105,0,105,3
2020-06-14,Imperial,025,180216,5939,3730,4,3734,36
2020-06-14,Inyo,027,18085,24,23,0,23,1
2020-06-14,Kern,029,883053,4505,3328,13,3341,55
2020-06-14,Kings,031,150075,2034,1022,4,1026,6
2020-06-14,Lake,033,64148,41,31,0,31,0
2020-06-14,Lassen,035,31185,15,5,2,7,0
2020-06-14,Los Angeles,037,10098052,82138,72932,21,72953,2887
2020-06-14,Madera,039,155013,492,203,2,205,3
2020-06-14,Marin,041,260295,871,689,2,691,17
2020-06-14,Mariposa,043,17540,18,16,0,16,1
2020-06-14,Mendocino,045,87422,49,33,0,33,0
2020-06-14,Merced,047,269075,717,403,1,404,7
2020-06-14,Modoc,049,8938,1,0,0,0,0
2020-06-14,Mono,051,14174,42,34,0,34,1
2020-06-14,Monterey,053,433212,1286,949,5,954,12
2020-06-14,Napa,055,140530,227,181,0,181,3
2020-06-14,Nevada,057,99092,81,52,1,53,1
2020-06-14,Orange,059,3164182,12587,8744,90,8834,211
2020-06-14,Placer,061,380077,529,369,3,372,9
2020-06-14,Plumas,063,18699,5,4,0,4,0
2020-06-14,Riverside,065,2383286,14187,11218,23,11241,364
2020-06-14,Sacramento,067,1510023,2083,1750,4,1754,60
2020-06-14,San Benito,069,59416,173,104,0,104,2
2020-06-14,San Bernardino,071,2135413,9961,7015,7,7022,224
2020-06-14,San Diego,073,3302833,10961,9442,1,9443,319
2020-06-14,San Francisco,075,870044,3123,2834,1,2835,45
2020-06-14,San Joaquin,077,732212,2347,1603,3,1606,43
2020-06-14,San Luis Obispo,079,281455,501,330,5,335,1
2020-06-14,San Mateo,081,765935,2843,2571,3,2574,75
2020-06-14,Santa Barbara,083,443738,2456,2049,19,2068,17
2020-06-14,Santa Clara,085,1922200,4141,3178,15,3193,148
2020-06-14,Santa Cruz,087,273765,297,254,0,254,2
2020-06-14,Shasta,089,179085,103,48,0,48,4
2020-06-14,Sierra,091,2930,1,1,0,1,0
2020-06-14,Siskiyou,093,43540,25,13,0,13,0
2020-06-14,Solano,095,438530,951,638,4,642,19
2020-06-14,Sonoma,097,501317,896,724,2,726,4
2020-06-14,Stanislaus,099,539301,1805,1159,6,1165,35
2020-06-14,Sutter,101,95872,97,63,0,63,2
2020-06-14,Tehama,103,63373,34,17,2,19,1
2020-06-14,Trinity,105,12862,13,2,3,5,0
2020-06-14,Tulare,107,460477,3721,2646,10,2656,96
2020-06-14,Tuolumne,109,53932,11,7,0,7,0
2020-06-14,Ventura,111,848112,2393,1610,13,1623,37
2020-06-14,Yolo,113,214977,345,254,0,254,24
2020-06-14,Yuba,115,75493,38,28,0,28,1
2020-06-13,Alameda,001,1643700,4980,4196,7,4203,112
2020-06-13,Alpine,003,1148,1,1,0,1,0
2020-06-13,Amador,005,37829,11,10,0,10,0
2020-06-13,Butte,007,227075,116,72,10,82,1
2020-06-13,Calaveras,009,45235,31,18,0,18,0
2020-06-13,Colusa,011,21464,12,7,0,7,0
2020-06-13,Contra Costa,013,1133247,2234,1868,2,1870,43
2020-06-13,Del Norte,015,27424,47,45,0,45,0
2020-06-13,El Dorado,017,186661,163,110,1,111,0
2020-06-13,Fresno,019,978130,4937,2499,56,2555,48
2020-06-13,Glenn,021,27897,49,21,0,21,0
2020-06-13,Humboldt,023,135768,128,104,0,104,3
2020-06-13,Imperial,025,180216,5866,3646,4,3650,36
2020-06-13,Inyo,027,18085,24,23,0,23,1
2020-06-13,Kern,029,883053,4396,3239,13,3252,55
2020-06-13,Kings,031,150075,2014,1023,4,1027,6
2020-06-13,Lake,033,64148,40,29,0,29,0
2020-06-13,Lassen,035,31185,15,5,2,7,0
2020-06-13,Los Angeles,037,10098052,81097,71938,21,71959,2874
2020-06-13,Madera,039,155013,488,203,2,205,3
2020-06-13,Marin,041,260295,840,677,2,679,17
2020-06-13,Mariposa,043,17540,18,16,0,16,1
2020-06-13,Mendocino,045,87422,49,33,0,33,0
2020-06-13,Merced,047,269075,699,376,1,377,7
2020-06-13,Modoc,049,8938,1,0,0,0,0
2020-06-13,Mono,051,14174,42,35,0,35,1
2020-06-13,Monterey,053,433212,1248,900,5,905,11
2020-06-13,Napa,055,140530,224,171,0,171,3
2020-06-13,Nevada,057,99092,79,52,1,53,1
2020-06-13,Orange,059,3164182,12343,8581,87,8668,211
2020-06-13,Placer,061,380077,512,346,3,349,9
2020-06-13,Plumas,063,18699,5,4,0,4,0
2020-06-13,Riverside,065,2383286,13908,10931,23,10954,364
2020-06-13,Sacramento,067,1510023,2028,1713,4,1717,60
2020-06-13,San Benito,069,59416,166,99,0,99,2
2020-06-13,San Bernardino,071,2135413,9738,6885,7,6892,224
2020-06-13,San Diego,073,3302833,10789,9316,1,9317,319
2020-06-13,San Francisco,075,870044,3103,2834,1,2835,44
2020-06-13,San Joaquin,077,732212,2266,1461,3,1464,43
2020-06-13,San Luis Obispo,079,281455,490,326,5,331,1
2020-06-13,San Mateo,081,765935,2820,2551,3,2554,75
2020-06-13,Santa Barbara,083,443738,2398,1999,19,2018,15
2020-06-13,Santa Clara,085,1922200,4098,3141,15,3156,148
2020-06-13,Santa Cruz,087,273765,291,254,0,254,2
2020-06-13,Shasta,089,179085,101,48,0,48,4
2020-06-13,Sierra,091,2930,1,1,0,1,0
2020-06-13,Siskiyou,093,43540,25,13,0,13,0
2020-06-13,Solano,095,438530,923,637,4,641,19
2020-06-13,Sonoma,097,501317,881,711,2,713,4
2020-06-13,Stanislaus,099,539301,1748,1122,6,1128,33
2020-06-13,Sutter,101,95872,96,62,0,62,2
2020-06-13,Tehama,103,63373,33,17,2,19,1
2020-06-13,Trinity,105,12862,13,2,3,5,0
2020-06-13,Tulare,107,460477,3689,2626,10,2636,96
2020-06-13,Tuolumne,109,53932,10,7,0,7,0
2020-06-13,Ventura,111,848112,2347,1567,13,1580,37
2020-06-13,Yolo,113,214977,325,251,0,251,24
2020-06-13,Yuba,115,75493,38,28,0,28,1
2020-06-12,Alameda,001,1643700,4907,4167,7,4174,109
2020-06-12,Alpine,003,1148,1,1,0,1,0
2020-06-12,Amador,005,37829,11,10,0,10,0
2020-06-12,Butte,007,227075,112,71,9,80,1
2020-06-12,Calaveras,009,45235,28,18,0,18,0
2020-06-12,Colusa,011,21464,12,7,0,7,0
2020-06-12,Contra Costa,013,1133247,2197,1827,2,1829,43
2020-06-12,Del Norte,015,27424,47,45,0,45,0
2020-06-12,El Dorado,017,186661,163,110,1,111,0
2020-06-12,Fresno,019,978130,4799,2428,56,2484,47
2020-06-12,Glenn,021,27897,46,21,0,21,0
2020-06-12,Humboldt,023,135768,126,105,0,105,3
2020-06-12,Imperial,025,180216,5782,3543,4,3547,36
2020-06-12,Inyo,027,18085,24,23,0,23,1
2020-06-12,Kern,029,883053,4279,3152,13,3165,54
2020-06-12,Kings,031,150075,2001,987,4,991,6
2020-06-12,Lake,033,64148,39,29,0,29,0
2020-06-12,Lassen,035,31185,15,5,2,7,0
2020-06-12,Los Angeles,037,10098052,79692,70385,21,70406,2814
2020-06-12,Madera,039,155013,463,187,2,189,3
2020-06-12,Marin,041,260295,837,649,2,651,17
2020-06-12,Mariposa,043,17540,18,16,0,16,1
2020-06-12,Mendocino,045,87422,49,33,0,33,0
2020-06-12,Merced,047,269075,665,372,1,373,7
2020-06-12,Modoc,049,8938,1,0,0,0,0
2020-06-12,Mono,051,14174,39,35,0,35,1
2020-06-12,Monterey,053,433212,1207,864,4,868,11
2020-06-12,Napa,055,140530,221,162,0,162,3
2020-06-12,Nevada,057,99092,73,52,1,53,1
2020-06-12,Orange,059,3164182,12037,8440,86,8526,203
2020-06-12,Placer,061,380077,495,333,3,336,9
2020-06-12,Plumas,063,18699,5,4,0,4,0
2020-06-12,Riverside,065,2383286,13571,10616,23,10639,364
2020-06-12,Sacramento,067,1510023,1973,1702,4,1706,60
2020-06-12,San Benito,069,59416,159,96,0,96,2
2020-06-12,San Bernardino,071,2135413,9470,6707,7,6714,223
2020-06-12,San Diego,073,3302833,10619,9132,1,9133,313
2020-06-12,San Francisco,075,870044,3069,2823,1,2824,44
2020-06-12,San Joaquin,077,732212,2186,1406,3,1409,43
2020-06-12,San Luis Obispo,079,281455,474,321,5,326,1
2020-06-12,San Mateo,081,765935,2785,2533,3,2536,75
2020-06-12,Santa Barbara,083,443738,2344,1969,19,1988,14
2020-06-12,Santa Clara,085,1922200,4054,3099,15,3114,149
2020-06-12,Santa Cruz,087,273765,283,251,0,251,2
2020-06-12,Shasta,089,179085,94,48,0,48,5
2020-06-12,Sierra,091,2930,1,1,0,1,0
2020-06-12,Siskiyou,093,43540,25,13,0,13,0
2020-06-12,Solano,095,438530,909,620,4,624,19
2020-06-12,Sonoma,097,501317,862,696,2,698,4
2020-06-12,Stanislaus,099,539301,1689,1092,6,1098,33
2020-06-12,Sutter,101,95872,95,56,0,56,2
2020-06-12,Tehama,103,63373,32,13,2,15,1
2020-06-12,Trinity,105,12862,13,2,3,5,0
2020-06-12,Tulare,107,460477,3635,2552,10,2562,95
2020-06-12,Tuolumne,109,53932,10,7,0,7,0
2020-06-12,Ventura,111,848112,2295,1534,13,1547,35
2020-06-12,Yolo,113,214977,313,243,0,243,24
2020-06-12,Yuba,115,75493,36,27,0,27,1
2020-06-11,Alameda,001,1643700,4777,4073,6,4079,108
2020-06-11,Alpine,003,1148,1,1,0,1,0
2020-06-11,Amador,005,37829,10,10,0,10,0
2020-06-11,Butte,007,227075,106,72,9,81,1
2020-06-11,Calaveras,009,45235,27,16,0,16,0
2020-06-11,Colusa,011,21464,12,7,0,7,0
2020-06-11,Contra Costa,013,1133247,2144,1797,2,1799,43
2020-06-11,Del Norte,015,27424,47,45,0,45,0
2020-06-11,El Dorado,017,186661,155,109,1,110,0
2020-06-11,Fresno,019,978130,4646,2338,56,2394,45
2020-06-11,Glenn,021,27897,42,21,0,21,0
2020-06-11,Humboldt,023,135768,122,113,0,113,3
2020-06-11,Imperial,025,180216,5625,3463,4,3467,36
2020-06-11,Inyo,027,18085,22,23,0,23,1
2020-06-11,Kern,029,883053,4127,3047,11,3058,54
2020-06-11,Kings,031,150075,1968,963,4,967,6
2020-06-11,Lake,033,64148,39,28,0,28,0
2020-06-11,Lassen,035,31185,15,5,2,7,0
2020-06-11,Los Angeles,037,10098052,78025,68807,20,68827,2800
2020-06-11,Madera,039,155013,445,178,2,180,3
2020-06-11,Marin,041,260295,789,637,2,639,17
2020-06-11,Mariposa,043,17540,18,16,0,16,1
2020-06-11,Mendocino,045,87422,40,35,0,35,0
2020-06-11,Merced,047,269075,625,370,1,371,7
2020-06-11,Modoc,049,8938,1,0,0,0,0
2020-06-11,Mono,051,14174,39,35,0,35,1
2020-06-11,Monterey,053,433212,1160,813,4,817,11
2020-06-11,Napa,055,140530,212,162,0,162,3
2020-06-11,Nevada,057,99092,67,50,1,51,1
2020-06-11,Orange,059,3164182,11729,8304,85,8389,188
2020-06-11,Placer,061,380077,476,321,3,324,9
2020-06-11,Plumas,063,18699,5,4,0,4,0
2020-06-11,Riverside,065,2383286,13218,10014,23,10037,361
2020-06-11,Sacramento,067,1510023,1925,1669,4,1673,60
2020-06-11,San Benito,069,59416,153,94,0,94,2
2020-06-11,San Bernardino,071,2135413,9173,6509,7,6516,221
2020-06-11,San Diego,073,3302833,10389,9000,0,9000,308
2020-06-11,San Francisco,075,870044,3040,2766,1,2767,44
2020-06-11,San Joaquin,077,732212,2074,1351,3,1354,43
2020-06-11,San Luis Obispo,079,281455,460,307,5,312,1
2020-06-11,San Mateo,081,765935,2747,2499,3,2502,74
2020-06-11,Santa Barbara,083,443738,2283,1895,19,1914,14
2020-06-11,Santa Clara,085,1922200,3987,3049,15,3064,149
2020-06-11,Santa Cruz,087,273765,279,247,0,247,2
2020-06-11,Shasta,089,179085,87,47,0,47,5
2020-06-11,Sierra,091,2930,1,1,0,1,0
2020-06-11,Siskiyou,093,43540,25,14,0,14,0
2020-06-11,Solano,095,438530,883,616,4,620,19
2020-06-11,Sonoma,097,501317,840,682,2,684,4
2020-06-11,Stanislaus,099,539301,1598,1062,6,1068,30
2020-06-11,Sutter,101,95872,92,56,0,56,2
2020-06-11,Tehama,103,63373,27,10,2,12,1
2020-06-11,Trinity,105,12862,11,2,3,5,0
2020-06-11,Tulare,107,460477,3536,2473,10,2483,95
2020-06-11,Tuolumne,109,53932,10,7,0,7,0
2020-06-11,Ventura,111,848112,2218,1491,12,1503,34
2020-06-11,Yolo,113,214977,305,230,0,230,24
2020-06-11,Yuba,115,75493,36,27,0,27,1
2020-06-10,Alameda,001,1643700,4677,4027,6,4033,107
2020-06-10,Alpine,003,1148,1,1,0,1,0
2020-06-10,Amador,005,37829,10,10,0,10,0
2020-06-10,Butte,007,227075,102,71,9,80,1
2020-06-10,Calaveras,009,45235,27,16,0,16,0
2020-06-10,Colusa,011,21464,11,7,0,7,0
2020-06-10,Contra Costa,013,1133247,2100,1778,2,1780,43
2020-06-10,Del Norte,015,27424,47,45,0,45,0
2020-06-10,El Dorado,017,186661,152,109,1,110,0
2020-06-10,Fresno,019,978130,4469,2324,56,2380,45
2020-06-10,Glenn,021,27897,39,21,0,21,0
2020-06-10,Humboldt,023,135768,118,112,0,112,3
2020-06-10,Imperial,025,180216,5477,3454,4,3458,36
2020-06-10,Inyo,027,18085,22,23,0,23,1
2020-06-10,Kern,029,883053,4002,3000,10,3010,54
2020-06-10,Kings,031,150075,1922,952,3,955,6
2020-06-10,Lake,033,64148,39,28,0,28,0
2020-06-10,Lassen,035,31185,15,5,2,7,0
2020-06-10,Los Angeles,037,10098052,76510,67018,20,67038,2752
2020-06-10,Madera,039,155013,431,176,1,177,3
2020-06-10,Marin,041,260295,757,633,2,635,17
2020-06-10,Mariposa,043,17540,17,16,0,16,1
2020-06-10,Mendocino,045,87422,39,35,0,35,0
2020-06-10,Merced,047,269075,592,370,1,371,7
2020-06-10,Modoc,049,8938,1,0,0,0,0
2020-06-10,Mono,051,14174,39,35,0,35,1
2020-06-10,Monterey,053,433212,1106,791,4,795,11
2020-06-10,Napa,055,140530,209,159,0,159,3
2020-06-10,Nevada,057,99092,65,50,1,51,1
2020-06-10,Orange,059,3164182,11453,8222,81,8303,184
2020-06-10,Placer,061,380077,451,309,3,312,9
2020-06-10,Plumas,063,18699,5,4,0,4,0
2020-06-10,Riverside,065,2383286,12895,9857,23,9880,361
2020-06-10,Sacramento,067,1510023,1886,1643,2,1645,59
2020-06-10,San Benito,069,59416,144,94,0,94,2
2020-06-10,San Bernardino,071,2135413,8880,6438,7,6445,219
2020-06-10,San Diego,073,3302833,10225,8839,0,8839,305
2020-06-10,San Francisco,075,870044,3015,2774,1,2775,44
2020-06-10,San Joaquin,077,732212,1945,1282,3,1285,41
2020-06-10,San Luis Obispo,079,281455,440,306,5,311,1
2020-06-10,San Mateo,081,765935,2707,2492,3,2495,74
2020-06-10,Santa Barbara,083,443738,2227,1878,19,1897,13
2020-06-10,Santa Clara,085,1922200,3936,3032,15,3047,149
2020-06-10,Santa Cruz,087,273765,275,242,0,242,2
2020-06-10,Shasta,089,179085,82,45,0,45,5
2020-06-10,Sierra,091,2930,1,1,0,1,0
2020-06-10,Siskiyou,093,43540,25,14,0,14,0
2020-06-10,Solano,095,438530,847,608,4,612,19
2020-06-10,Sonoma,097,501317,822,673,2,675,4
2020-06-10,Stanislaus,099,539301,1508,1030,6,1036,29
2020-06-10,Sutter,101,95872,91,56,0,56,2
2020-06-10,Tehama,103,63373,25,10,2,12,1
2020-06-10,Trinity,105,12862,11,2,3,5,0
2020-06-10,Tulare,107,460477,3443,2455,10,2465,95
2020-06-10,Tuolumne,109,53932,10,7,0,7,0
2020-06-10,Ventura,111,848112,2172,1446,11,1457,34
2020-06-10,Yolo,113,214977,297,226,0,226,24
2020-06-10,Yuba,115,75493,35,27,0,27,1
2020-06-09,Alameda,001,1643700,4567,3963,6,3969,103
2020-06-09,Alpine,003,1148,1,1,0,1,0
2020-06-09,Amador,005,37829,10,10,0,10,0
2020-06-09,Butte,007,227075,101,70,8,78,1
2020-06-09,Calaveras,009,45235,27,16,0,16,0
2020-06-09,Colusa,011,21464,10,7,0,7,0
2020-06-09,Contra Costa,013,1133247,2059,1744,2,1746,42
2020-06-09,Del Norte,015,27424,47,45,0,45,0
2020-06-09,El Dorado,017,186661,142,108,1,109,0
2020-06-09,Fresno,019,978130,4318,2278,56,2334,43
2020-06-09,Glenn,021,27897,38,19,0,19,0
2020-06-09,Humboldt,023,135768,116,113,0,113,2
2020-06-09,Imperial,025,180216,5326,3067,4,3071,36
2020-06-09,Inyo,027,18085,22,22,0,22,1
2020-06-09,Kern,029,883053,3874,2920,10,2930,51
2020-06-09,Kings,031,150075,1890,934,3,937,6
2020-06-09,Lake,033,64148,39,28,0,28,0
2020-06-09,Lassen,035,31185,15,5,2,7,0
2020-06-09,Los Angeles,037,10098052,74850,65827,20,65847,2692
2020-06-09,Madera,039,155013,416,172,1,173,3
2020-06-09,Marin,041,260295,721,616,2,618,17
2020-06-09,Mariposa,043,17540,17,16,0,16,1
2020-06-09,Mendocino,045,87422,35,35,0,35,0
2020-06-09,Merced,047,269075,563,349,1,350,7
2020-06-09,Modoc,049,8938,1,0,0,0,0
2020-06-09,Mono,051,14174,39,35,0,35,1
2020-06-09,Monterey,053,433212,1065,772,4,776,11
2020-06-09,Napa,055,140530,199,156,0,156,3
2020-06-09,Nevada,057,99092,57,50,1,51,1
2020-06-09,Orange,059,3164182,11212,7991,79,8070,174
2020-06-09,Placer,061,380077,438,301,3,304,9
2020-06-09,Plumas,063,18699,5,4,0,4,0
2020-06-09,Riverside,065,2383286,12517,9511,23,9534,354
2020-06-09,Sacramento,067,1510023,1832,1625,2,1627,59
2020-06-09,San Benito,069,59416,138,95,0,95,2
2020-06-09,San Bernardino,071,2135413,8557,6268,6,6274,217
2020-06-09,San Diego,073,3302833,10040,8731,0,8731,301
2020-06-09,San Francisco,075,870044,2990,2749,1,2750,44
2020-06-09,San Joaquin,077,732212,1839,1240,3,1243,41
2020-06-09,San Luis Obispo,079,281455,427,301,4,305,1
2020-06-09,San Mateo,081,765935,2676,2463,3,2466,74
2020-06-09,Santa Barbara,083,443738,2171,1854,19,1873,13
2020-06-09,Santa Clara,085,1922200,3868,3006,14,3020,147
2020-06-09,Santa Cruz,087,273765,269,237,0,237,2
2020-06-09,Shasta,089,179085,78,44,0,44,4
2020-06-09,Sierra,091,2930,1,1,0,1,0
2020-06-09,Siskiyou,093,43540,20,10,0,10,0
2020-06-09,Solano,095,438530,812,596,4,600,18
2020-06-09,Sonoma,097,501317,799,661,2,663,4
2020-06-09,Stanislaus,099,539301,1407,993,6,999,25
2020-06-09,Sutter,101,95872,88,56,0,56,2
2020-06-09,Tehama,103,63373,25,9,2,11,1
2020-06-09,Trinity,105,12862,10,2,3,5,0
2020-06-09,Tulare,107,460477,3377,2393,10,2403,91
2020-06-09,Tuolumne,109,53932,10,8,0,8,0
2020-06-09,Ventura,111,848112,2106,1407,11,1418,34
2020-06-09,Yolo,113,214977,286,226,0,226,24
2020-06-09,Yuba,115,75493,34,27,0,27,1
2020-06-08,Alameda,001,1643700,4486,3937,6,3943,103
2020-06-08,Alpine,003,1148,1,1,0,1,0
2020-06-08,Amador,005,37829,10,10,0,10,0
2020-06-08,Butte,007,227075,97,68,8,76,1
2020-06-08,Calaveras,009,45235,27,16,0,16,0
2020-06-08,Colusa,011,21464,9,7,0,7,0
2020-06-08,Contra Costa,013,1133247,2016,1714,2,1716,41
2020-06-08,Del Norte,015,27424,47,45,0,45,0
2020-06-08,El Dorado,017,186661,138,107,1,108,0
2020-06-08,Fresno,019,978130,4195,2194,55,2249,42
2020-06-08,Glenn,021,27897,36,17,0,17,0
2020-06-08,Humboldt,023,135768,116,112,0,112,2
2020-06-08,Imperial,025,180216,5174,3051,4,3055,21
2020-06-08,Inyo,027,18085,22,22,0,22,1
2020-06-08,Kern,029,883053,3743,2853,9,2862,49
2020-06-08,Kings,031,150075,1814,892,3,895,6
2020-06-08,Lake,033,64148,39,28,0,28,0
2020-06-08,Lassen,035,31185,15,4,2,6,0
2020-06-08,Los Angeles,037,10098052,73388,64634,20,64654,2640
2020-06-08,Madera,039,155013,386,154,1,155,3
2020-06-08,Marin,041,260295,680,596,2,598,17
2020-06-08,Mariposa,043,17540,16,16,0,16,1
2020-06-08,Mendocino,045,87422,33,32,0,32,0
2020-06-08,Merced,047,269075,529,331,1,332,7
2020-06-08,Modoc,049,8938,1,0,0,0,0
2020-06-08,Mono,051,14174,39,35,0,35,1
2020-06-08,Monterey,053,433212,1014,751,3,754,10
2020-06-08,Napa,055,140530,183,151,0,151,3
2020-06-08,Nevada,057,99092,56,50,1,51,1
2020-06-08,Orange,059,3164182,10961,7786,77,7863,160
2020-06-08,Placer,061,380077,421,290,3,293,9
2020-06-08,Plumas,063,18699,5,4,0,4,0
2020-06-08,Riverside,065,2383286,12148,9246,23,9269,347
2020-06-08,Sacramento,067,1510023,1782,1591,2,1593,59
2020-06-08,San Benito,069,59416,131,93,0,93,2
2020-06-08,San Bernardino,071,2135413,8238,6122,6,6128,214
2020-06-08,San Diego,073,3302833,9883,8621,0,8621,296
2020-06-08,San Francisco,075,870044,2963,2715,1,2716,43
2020-06-08,San Joaquin,077,732212,1732,1198,3,1201,40
2020-06-08,San Luis Obispo,079,281455,421,300,4,304,1
2020-06-08,San Mateo,081,765935,2645,2431,2,2433,74
2020-06-08,Santa Barbara,083,443738,2116,1824,17,1841,13
2020-06-08,Santa Clara,085,1922200,3822,2971,14,2985,146
2020-06-08,Santa Cruz,087,273765,268,234,0,234,2
2020-06-08,Shasta,089,179085,74,43,0,43,4
2020-06-08,Sierra,091,2930,1,1,0,1,0
2020-06-08,Siskiyou,093,43540,20,8,0,8,0
2020-06-08,Solano,095,438530,785,560,4,564,19
2020-06-08,Sonoma,097,501317,783,654,2,656,4
2020-06-08,Stanislaus,099,539301,1325,956,6,962,28
2020-06-08,Sutter,101,95872,81,55,0,55,2
2020-06-08,Tehama,103,63373,19,8,2,10,1
2020-06-08,Trinity,105,12862,10,2,3,5,0
2020-06-08,Tulare,107,460477,3294,2301,10,2311,91
2020-06-08,Tuolumne,109,53932,9,8,0,8,0
2020-06-08,Ventura,111,848112,2048,1382,11,1393,30
2020-06-08,Yolo,113,214977,275,228,0,228,24
2020-06-08,Yuba,115,75493,32,27,0,27,1
2020-06-07,Alameda,001,1643700,4373,3866,6,3872,102
2020-06-07,Alpine,003,1148,1,1,0,1,0
2020-06-07,Amador,005,37829,10,10,0,10,0
2020-06-07,Butte,007,227075,95,64,6,70,1
2020-06-07,Calaveras,009,45235,25,16,0,16,0
2020-06-07,Colusa,011,21464,9,7,0,7,0
2020-06-07,Contra Costa,013,1133247,1965,1653,1,1654,38
2020-06-07,Del Norte,015,27424,45,45,0,45,0
2020-06-07,El Dorado,017,186661,138,104,1,105,0
2020-06-07,Fresno,019,978130,4065,2144,55,2199,41
2020-06-07,Glenn,021,27897,29,16,0,16,0
2020-06-07,Humboldt,023,135768,116,112,0,112,2
2020-06-07,Imperial,025,180216,5024,3048,4,3052,19
2020-06-07,Inyo,027,18085,22,21,0,21,1
2020-06-07,Kern,029,883053,3612,2771,9,2780,46
2020-06-07,Kings,031,150075,1765,882,3,885,6
2020-06-07,Lake,033,64148,36,28,0,28,0
2020-06-07,Lassen,035,31185,14,4,2,6,0
2020-06-07,Los Angeles,037,10098052,71680,63750,20,63770,2629
2020-06-07,Madera,039,155013,369,149,1,150,3
2020-06-07,Marin,041,260295,666,584,2,586,17
2020-06-07,Mariposa,043,17540,16,16,0,16,1
2020-06-07,Mendocino,045,87422,33,32,0,32,0
2020-06-07,Merced,047,269075,496,318,1,319,7
2020-06-07,Modoc,049,8938,1,0,0,0,0
2020-06-07,Mono,051,14174,39,35,0,35,1
2020-06-07,Monterey,053,433212,968,732,3,735,10
2020-06-07,Napa,055,140530,175,142,0,142,3
2020-06-07,Nevada,057,99092,55,50,1,51,1
2020-06-07,Orange,059,3164182,10704,7643,75,7718,158
2020-06-07,Placer,061,380077,400,273,2,275,9
2020-06-07,Plumas,063,18699,5,4,0,4,0
2020-06-07,Riverside,065,2383286,11852,9105,23,9128,344
2020-06-07,Sacramento,067,1510023,1734,1568,2,1570,59
2020-06-07,San Benito,069,59416,128,92,0,92,2
2020-06-07,San Bernardino,071,2135413,7952,6033,6,6039,214
2020-06-07,San Diego,073,3302833,9704,8478,0,8478,296
2020-06-07,San Francisco,075,870044,2919,2674,0,2674,43
2020-06-07,San Joaquin,077,732212,1631,1126,3,1129,37
2020-06-07,San Luis Obispo,079,281455,411,296,4,300,1
2020-06-07,San Mateo,081,765935,2618,2399,2,2401,73
2020-06-07,Santa Barbara,083,443738,2061,1818,17,1835,13
2020-06-07,Santa Clara,085,1922200,3770,2947,14,2961,146
2020-06-07,Santa Cruz,087,273765,260,230,0,230,2
2020-06-07,Shasta,089,179085,73,41,0,41,4
2020-06-07,Sierra,091,2930,1,1,0,1,0
2020-06-07,Siskiyou,093,43540,20,8,0,8,0
2020-06-07,Solano,095,438530,762,560,4,564,19
2020-06-07,Sonoma,097,501317,752,639,2,641,4
2020-06-07,Stanislaus,099,539301,1245,905,5,910,28
2020-06-07,Sutter,101,95872,73,55,0,55,2
2020-06-07,Tehama,103,63373,16,8,2,10,1
2020-06-07,Trinity,105,12862,8,2,3,5,0
2020-06-07,Tulare,107,460477,3172,2219,10,2229,90
2020-06-07,Tuolumne,109,53932,9,4,0,4,0
2020-06-07,Ventura,111,848112,1982,1337,11,1348,30
2020-06-07,Yolo,113,214977,265,224,0,224,24
2020-06-07,Yuba,115,75493,32,27,0,27,1
2020-06-06,Alameda,001,1643700,4328,3801,6,3807,102
2020-06-06,Alpine,003,1148,1,1,0,1,0
2020-06-06,Amador,005,37829,10,10,0,10,0
2020-06-06,Butte,007,227075,94,63,6,69,1
2020-06-06,Calaveras,009,45235,23,16,0,16,0
2020-06-06,Colusa,011,21464,9,7,0,7,0
2020-06-06,Contra Costa,013,1133247,1944,1619,1,1620,37
2020-06-06,Del Norte,015,27424,45,45,0,45,0
2020-06-06,El Dorado,017,186661,133,104,1,105,0
2020-06-06,Fresno,019,978130,4010,2117,55,2172,41
2020-06-06,Glenn,021,27897,27,16,0,16,0
2020-06-06,Humboldt,023,135768,116,112,0,112,2
2020-06-06,Imperial,025,180216,4948,3047,4,3051,19
2020-06-06,Inyo,027,18085,22,21,0,21,1
2020-06-06,Kern,029,883053,3541,2695,9,2704,46
2020-06-06,Kings,031,150075,1746,882,3,885,6
2020-06-06,Lake,033,64148,36,28,0,28,0
2020-06-06,Lassen,035,31185,14,4,2,6,0
2020-06-06,Los Angeles,037,10098052,70927,62269,20,62289,2607
2020-06-06,Madera,039,155013,360,149,1,150,3
2020-06-06,Marin,041,260295,661,556,2,558,17
2020-06-06,Mariposa,043,17540,16,16,0,16,1
2020-06-06,Mendocino,045,87422,33,32,0,32,0
2020-06-06,Merced,047,269075,495,315,1,316,7
2020-06-06,Modoc,049,8938,1,0,0,0,0
2020-06-06,Mono,051,14174,39,35,0,35,1
2020-06-06,Monterey,053,433212,944,679,3,682,10
2020-06-06,Napa,055,140530,169,136,0,136,3
2020-06-06,Nevada,057,99092,54,50,1,51,1
2020-06-06,Orange,059,3164182,10545,7576,74,7650,157
2020-06-06,Placer,061,380077,388,270,2,272,9
2020-06-06,Plumas,063,18699,5,4,0,4,0
2020-06-06,Riverside,065,2383286,11674,8935,23,8958,345
2020-06-06,Sacramento,067,1510023,1711,1533,2,1535,59
2020-06-06,San Benito,069,59416,118,92,0,92,2
2020-06-06,San Bernardino,071,2135413,7803,5946,6,5952,214
2020-06-06,San Diego,073,3302833,9583,8347,0,8347,296
2020-06-06,San Francisco,075,870044,2904,2674,0,2674,43
2020-06-06,San Joaquin,077,732212,1591,1076,3,1079,37
2020-06-06,San Luis Obispo,079,281455,405,295,4,299,1
2020-06-06,San Mateo,081,765935,2603,2342,2,2344,72
2020-06-06,Santa Barbara,083,443738,2022,1815,17,1832,13
2020-06-06,Santa Clara,085,1922200,3729,2934,14,2948,144
2020-06-06,Santa Cruz,087,273765,258,226,0,226,2
2020-06-06,Shasta,089,179085,73,40,0,40,4
2020-06-06,Sierra,091,2930,1,1,0,1,0
2020-06-06,Siskiyou,093,43540,18,8,0,8,0
2020-06-06,Solano,095,438530,747,560,4,564,19
2020-06-06,Sonoma,097,501317,740,622,2,624,4
2020-06-06,Stanislaus,099,539301,1211,858,5,863,27
2020-06-06,Sutter,101,95872,73,51,0,51,2
2020-06-06,Tehama,103,63373,15,8,2,10,1
2020-06-06,Trinity,105,12862,8,2,2,4,0
2020-06-06,Tulare,107,460477,3139,2213,10,2223,90
2020-06-06,Tuolumne,109,53932,9,4,0,4,0
2020-06-06,Ventura,111,848112,1958,1303,11,1314,30
2020-06-06,Yolo,113,214977,263,223,0,223,24
2020-06-06,Yuba,115,75493,32,27,0,27,1
2020-06-05,Alameda,001,1643700,4277,3734,6,3740,102
2020-06-05,Alpine,003,1148,1,1,0,1,0
2020-06-05,Amador,005,37829,10,10,0,10,0
2020-06-05,Butte,007,227075,91,61,6,67,1
2020-06-05,Calaveras,009,45235,22,16,0,16,0
2020-06-05,Colusa,011,21464,9,7,0,7,0
2020-06-05,Contra Costa,013,1133247,1929,1575,1,1576,37
2020-06-05,Del Norte,015,27424,45,45,0,45,0
2020-06-05,El Dorado,017,186661,131,101,1,102,0
2020-06-05,Fresno,019,978130,3946,2051,54,2105,38
2020-06-05,Glenn,021,27897,25,16,0,16,0
2020-06-05,Humboldt,023,135768,115,111,0,111,2
2020-06-05,Imperial,025,180216,4841,2778,4,2782,19
2020-06-05,Inyo,027,18085,22,21,0,21,1
2020-06-05,Kern,029,883053,3452,2624,9,2633,46
2020-06-05,Kings,031,150075,1731,865,3,868,6
2020-06-05,Lake,033,64148,35,28,0,28,0
2020-06-05,Lassen,035,31185,13,4,2,6,0
2020-06-05,Los Angeles,037,10098052,69775,60955,20,60975,2553
2020-06-05,Madera,039,155013,338,144,1,145,3
2020-06-05,Marin,041,260295,652,546,2,548,17
2020-06-05,Mariposa,043,17540,16,16,0,16,1
2020-06-05,Mendocino,045,87422,33,32,0,32,0
2020-06-05,Merced,047,269075,493,309,1,310,7
2020-06-05,Modoc,049,8938,1,0,0,0,0
2020-06-05,Mono,051,14174,39,35,0,35,1
2020-06-05,Monterey,053,433212,912,649,3,652,10
2020-06-05,Napa,055,140530,166,123,0,123,3
2020-06-05,Nevada,057,99092,54,50,1,51,1
2020-06-05,Orange,059,3164182,10350,7391,73,7464,153
2020-06-05,Placer,061,380077,378,265,2,267,9
2020-06-05,Plumas,063,18699,5,4,0,4,0
2020-06-05,Riverside,065,2383286,11415,8700,23,8723,345
2020-06-05,Sacramento,067,1510023,1689,1514,2,1516,59
2020-06-05,San Benito,069,59416,116,92,0,92,2
2020-06-05,San Bernardino,071,2135413,7621,5869,5,5874,212
2020-06-05,San Diego,073,3302833,9468,8182,0,8182,294
2020-06-05,San Francisco,075,870044,2886,2675,0,2675,43
2020-06-05,San Joaquin,077,732212,1512,1046,3,1049,36
2020-06-05,San Luis Obispo,079,281455,398,293,4,297,1
2020-06-05,San Mateo,081,765935,2578,2331,2,2333,72
2020-06-05,Santa Barbara,083,443738,1991,1795,17,1812,13
2020-06-05,Santa Clara,085,1922200,3694,2902,14,2916,144
2020-06-05,Santa Cruz,087,273765,255,222,0,222,2
2020-06-05,Shasta,089,179085,72,40,0,40,4
2020-06-05,Sierra,091,2930,1,1,0,1,0
2020-06-05,Siskiyou,093,43540,16,8,0,8,0
2020-06-05,Solano,095,438530,740,558,4,562,19
2020-06-05,Sonoma,097,501317,719,618,2,620,4
2020-06-05,Stanislaus,099,539301,1178,842,5,847,27
2020-06-05,Sutter,101,95872,73,49,0,49,2
2020-06-05,Tehama,103,63373,15,7,2,9,1
2020-06-05,Trinity,105,12862,8,1,2,3,0
2020-06-05,Tulare,107,460477,3090,2180,10,2190,90
2020-06-05,Tuolumne,109,53932,9,4,0,4,0
2020-06-05,Ventura,111,848112,1925,1274,11,1285,30
2020-06-05,Yolo,113,214977,262,216,0,216,24
2020-06-05,Yuba,115,75493,32,27,0,27,1
2020-06-04,Alameda,001,1643700,4178,3643,6,3649,99
2020-06-04,Alpine,003,1148,1,1,0,1,0
2020-06-04,Amador,005,37829,10,10,0,10,0
2020-06-04,Butte,007,227075,87,57,5,62,1
2020-06-04,Calaveras,009,45235,22,15,0,15,0
2020-06-04,Colusa,011,21464,9,7,0,7,0
2020-06-04,Contra Costa,013,1133247,1871,1551,1,1552,37
2020-06-04,Del Norte,015,27424,45,45,0,45,0
2020-06-04,El Dorado,017,186661,129,101,1,102,0
2020-06-04,Fresno,019,978130,3841,2007,53,2060,35
2020-06-04,Glenn,021,27897,22,16,0,16,0
2020-06-04,Humboldt,023,135768,115,109,0,109,2
2020-06-04,Imperial,025,180216,4659,2631,4,2635,19
2020-06-04,Inyo,027,18085,22,20,0,20,1
2020-06-04,Kern,029,883053,3336,2530,9,2539,46
2020-06-04,Kings,031,150075,1661,842,3,845,6
2020-06-04,Lake,033,64148,34,27,0,27,0
2020-06-04,Lassen,035,31185,11,4,2,6,0
2020-06-04,Los Angeles,037,10098052,68309,59596,20,59616,2515
2020-06-04,Madera,039,155013,330,127,1,128,3
2020-06-04,Marin,041,260295,630,533,2,535,14
2020-06-04,Mariposa,043,17540,16,16,0,16,1
2020-06-04,Mendocino,045,87422,33,29,0,29,0
2020-06-04,Merced,047,269075,473,304,1,305,7
2020-06-04,Modoc,049,8938,1,0,0,0,0
2020-06-04,Mono,051,14174,39,35,0,35,1
2020-06-04,Monterey,053,433212,877,621,2,623,10
2020-06-04,Napa,055,140530,162,117,0,117,3
2020-06-04,Nevada,057,99092,53,49,1,50,1
2020-06-04,Orange,059,3164182,10098,7192,72,7264,148
2020-06-04,Placer,061,380077,362,256,2,258,9
2020-06-04,Plumas,063,18699,4,4,0,4,0
2020-06-04,Riverside,065,2383286,11137,8473,23,8496,341
2020-06-04,Sacramento,067,1510023,1661,1492,2,1494,58
2020-06-04,San Benito,069,59416,114,88,0,88,2
2020-06-04,San Bernardino,071,2135413,7352,5726,5,5731,207
2020-06-04,San Diego,073,3302833,9305,7942,0,7942,288
2020-06-04,San Francisco,075,870044,2853,2636,0,2636,43
2020-06-04,San Joaquin,077,732212,1450,1016,3,1019,36
2020-06-04,San Luis Obispo,079,281455,387,288,4,292,1
2020-06-04,San Mateo,081,765935,2551,2284,2,2286,72
2020-06-04,Santa Barbara,083,443738,1960,1750,16,1766,13
2020-06-04,Santa Clara,085,1922200,3660,2871,14,2885,144
2020-06-04,Santa Cruz,087,273765,249,218,0,218,2
2020-06-04,Shasta,089,179085,66,40,0,40,4
2020-06-04,Sierra,091,2930,1,1,0,1,0
2020-06-04,Siskiyou,093,43540,15,8,0,8,0
2020-06-04,Solano,095,438530,723,551,4,555,19
2020-06-04,Sonoma,097,501317,700,591,1,592,4
2020-06-04,Stanislaus,099,539301,1102,806,5,811,28
2020-06-04,Sutter,101,95872,68,46,0,46,2
2020-06-04,Tehama,103,63373,14,6,1,7,1
2020-06-04,Trinity,105,12862,8,1,2,3,0
2020-06-04,Tulare,107,460477,2973,2086,10,2096,90
2020-06-04,Tuolumne,109,53932,8,4,0,4,0
2020-06-04,Ventura,111,848112,1881,1236,10,1246,30
2020-06-04,Yolo,113,214977,257,216,0,216,24
2020-06-04,Yuba,115,75493,31,27,0,27,1
2020-06-03,Alameda,001,1643700,4119,3589,5,3594,99
2020-06-03,Alpine,003,1148,1,1,0,1,0
2020-06-03,Amador,005,37829,10,10,0,10,0
2020-06-03,Butte,007,227075,85,53,5,58,1
2020-06-03,Calaveras,009,45235,21,15,0,15,0
2020-06-03,Colusa,011,21464,9,7,0,7,0
2020-06-03,Contra Costa,013,1133247,1823,1511,1,1512,37
2020-06-03,Del Norte,015,27424,45,39,0,39,0
2020-06-03,El Dorado,017,186661,126,90,1,91,0
2020-06-03,Fresno,019,978130,3742,1943,53,1996,35
2020-06-03,Glenn,021,27897,22,16,0,16,0
2020-06-03,Humboldt,023,135768,115,103,0,103,2
2020-06-03,Imperial,025,180216,4486,2540,4,2544,19
2020-06-03,Inyo,027,18085,22,20,0,20,1
2020-06-03,Kern,029,883053,3240,2452,8,2460,44
2020-06-03,Kings,031,150075,1596,744,3,747,6
2020-06-03,Lake,033,64148,32,26,0,26,0
2020-06-03,Lassen,035,31185,11,4,2,6,0
2020-06-03,Los Angeles,037,10098052,66700,58166,20,58186,2472
2020-06-03,Madera,039,155013,322,117,1,118,3
2020-06-03,Marin,041,260295,612,527,2,529,14
2020-06-03,Mariposa,043,17540,16,16,0,16,1
2020-06-03,Mendocino,045,87422,32,29,0,29,0
2020-06-03,Merced,047,269075,459,299,1,300,7
2020-06-03,Modoc,049,8938,1,0,0,0,0
2020-06-03,Mono,051,14174,39,35,0,35,1
2020-06-03,Monterey,053,433212,849,592,2,594,10
2020-06-03,Napa,055,140530,161,116,0,116,3
2020-06-03,Nevada,057,99092,52,43,1,44,1
2020-06-03,Orange,059,3164182,9872,6939,71,7010,145
2020-06-03,Placer,061,380077,342,243,2,245,9
2020-06-03,Plumas,063,18699,4,4,0,4,0
2020-06-03,Riverside,065,2383286,10863,8208,23,8231,335
2020-06-03,Sacramento,067,1510023,1632,1457,2,1459,58
2020-06-03,San Benito,069,59416,108,88,0,88,2
2020-06-03,San Bernardino,071,2135413,7129,5565,5,5570,203
2020-06-03,San Diego,073,3302833,9157,7800,0,7800,283
2020-06-03,San Francisco,075,870044,2822,2608,0,2608,43
2020-06-03,San Joaquin,077,732212,1386,1004,3,1007,35
2020-06-03,San Luis Obispo,079,281455,382,279,4,283,1
2020-06-03,San Mateo,081,765935,2523,2243,2,2245,71
2020-06-03,Santa Barbara,083,443738,1926,1722,15,1737,12
2020-06-03,Santa Clara,085,1922200,3618,2836,14,2850,144
2020-06-03,Santa Cruz,087,273765,243,217,0,217,2
2020-06-03,Shasta,089,179085,63,40,0,40,4
2020-06-03,Sierra,091,2930,1,1,0,1,0
2020-06-03,Siskiyou,093,43540,14,8,0,8,0
2020-06-03,Solano,095,438530,698,543,2,545,18
2020-06-03,Sonoma,097,501317,688,578,1,579,4
2020-06-03,Stanislaus,099,539301,1062,780,5,785,27
2020-06-03,Sutter,101,95872,60,45,0,45,2
2020-06-03,Tehama,103,63373,14,6,1,7,1
2020-06-03,Trinity,105,12862,8,1,2,3,0
2020-06-03,Tulare,107,460477,2904,2041,10,2051,88
2020-06-03,Tuolumne,109,53932,6,4,0,4,0
2020-06-03,Ventura,111,848112,1814,1202,10,1212,30
2020-06-03,Yolo,113,214977,253,213,0,213,24
2020-06-03,Yuba,115,75493,31,27,0,27,1
2020-06-02,Alameda,001,1643700,4043,3517,5,3522,99
2020-06-02,Alpine,003,1148,1,1,0,1,0
2020-06-02,Amador,005,37829,10,10,0,10,0
2020-06-02,Butte,007,227075,81,51,4,55,1
2020-06-02,Calaveras,009,45235,21,15,0,15,0
2020-06-02,Colusa,011,21464,9,7,0,7,0
2020-06-02,Contra Costa,013,1133247,1791,1505,1,1506,37
2020-06-02,Del Norte,015,27424,45,39,0,39,0
2020-06-02,El Dorado,017,186661,125,88,1,89,0
2020-06-02,Fresno,019,978130,3629,1917,53,1970,34
2020-06-02,Glenn,021,27897,21,16,0,16,0
2020-06-02,Humboldt,023,135768,115,101,0,101,2
2020-06-02,Imperial,025,180216,4293,2459,4,2463,19
2020-06-02,Inyo,027,18085,20,20,0,20,1
2020-06-02,Kern,029,883053,3141,2406,6,2412,41
2020-06-02,Kings,031,150075,1568,720,3,723,5
2020-06-02,Lake,033,64148,32,25,0,25,0
2020-06-02,Lassen,035,31185,10,4,2,6,0
2020-06-02,Los Angeles,037,10098052,65296,57144,20,57164,2430
2020-06-02,Madera,039,155013,301,110,1,111,2
2020-06-02,Marin,041,260295,585,509,2,511,14
2020-06-02,Mariposa,043,17540,16,16,0,16,1
2020-06-02,Mendocino,045,87422,32,29,0,29,0
2020-06-02,Merced,047,269075,443,297,1,298,6
2020-06-02,Modoc,049,8938,1,0,0,0,0
2020-06-02,Mono,051,14174,39,35,0,35,1
2020-06-02,Monterey,053,433212,819,582,2,584,10
2020-06-02,Napa,055,140530,152,116,0,116,3
2020-06-02,Nevada,057,99092,51,41,1,42,1
2020-06-02,Orange,059,3164182,9671,6790,70,6860,142
2020-06-02,Placer,061,380077,328,226,2,228,9
2020-06-02,Plumas,063,18699,4,4,0,4,0
2020-06-02,Riverside,065,2383286,10567,8091,22,8113,330
2020-06-02,Sacramento,067,1510023,1603,1428,2,1430,58
2020-06-02,San Benito,069,59416,107,86,0,86,2
2020-06-02,San Bernardino,071,2135413,6922,5438,5,5443,202
2020-06-02,San Diego,073,3302833,9011,7676,0,7676,276
2020-06-02,San Francisco,075,870044,2787,2554,0,2554,43
2020-06-02,San Joaquin,077,732212,1320,985,3,988,35
2020-06-02,San Luis Obispo,079,281455,377,275,4,279,1
2020-06-02,San Mateo,081,765935,2488,2203,2,2205,71
2020-06-02,Santa Barbara,083,443738,1886,1703,15,1718,12
2020-06-02,Santa Clara,085,1922200,3568,2819,14,2833,144
2020-06-02,Santa Cruz,087,273765,238,215,0,215,2
2020-06-02,Shasta,089,179085,62,38,0,38,4
2020-06-02,Sierra,091,2930,1,1,0,1,0
2020-06-02,Siskiyou,093,43540,13,8,0,8,0
2020-06-02,Solano,095,438530,683,537,1,538,18
2020-06-02,Sonoma,097,501317,677,571,1,572,4
2020-06-02,Stanislaus,099,539301,1003,772,5,777,27
2020-06-02,Sutter,101,95872,57,43,0,43,2
2020-06-02,Tehama,103,63373,14,6,1,7,1
2020-06-02,Trinity,105,12862,8,1,2,3,0
2020-06-02,Tulare,107,460477,2824,2012,10,2022,86
2020-06-02,Tuolumne,109,53932,6,4,0,4,0
2020-06-02,Ventura,111,848112,1761,1178,10,1188,30
2020-06-02,Yolo,113,214977,251,213,0,213,24
2020-06-02,Yuba,115,75493,31,27,0,27,1
2020-06-01,Alameda,001,1643700,3977,3460,5,3465,98
2020-06-01,Alpine,003,1148,1,1,0,1,0
2020-06-01,Amador,005,37829,10,10,0,10,0
2020-06-01,Butte,007,227075,80,50,3,53,1
2020-06-01,Calaveras,009,45235,21,15,0,15,0
2020-06-01,Colusa,011,21464,9,7,0,7,0
2020-06-01,Contra Costa,013,1133247,1755,1486,1,1487,37
2020-06-01,Del Norte,015,27424,45,38,0,38,0
2020-06-01,El Dorado,017,186661,123,88,1,89,0
2020-06-01,Fresno,019,978130,3534,1854,51,1905,33
2020-06-01,Glenn,021,27897,21,16,0,16,0
2020-06-01,Humboldt,023,135768,115,98,0,98,2
2020-06-01,Imperial,025,180216,4071,2366,4,2370,14
2020-06-01,Inyo,027,18085,20,20,0,20,1
2020-06-01,Kern,029,883053,3058,2366,6,2372,38
2020-06-01,Kings,031,150075,1300,703,3,706,4
2020-06-01,Lake,033,64148,32,22,0,22,0
2020-06-01,Lassen,035,31185,10,4,2,6,0
2020-06-01,Los Angeles,037,10098052,63823,55899,20,55919,2367
2020-06-01,Madera,039,155013,289,103,1,104,2
2020-06-01,Marin,041,260295,544,495,2,497,14
2020-06-01,Mariposa,043,17540,16,16,0,16,1
2020-06-01,Mendocino,045,87422,32,28,0,28,0
2020-06-01,Merced,047,269075,424,289,1,290,6
2020-06-01,Modoc,049,8938,1,0,0,0,0
2020-06-01,Mono,051,14174,39,35,0,35,1
2020-06-01,Monterey,053,433212,795,554,2,556,10
2020-06-01,Napa,055,140530,149,114,0,114,3
2020-06-01,Nevada,057,99092,51,41,1,42,1
2020-06-01,Orange,059,3164182,9474,6640,69,6709,135
2020-06-01,Placer,061,380077,316,218,2,220,9
2020-06-01,Plumas,063,18699,4,4,0,4,0
2020-06-01,Riverside,065,2383286,10115,7921,21,7942,322
2020-06-01,Sacramento,067,1510023,1564,1415,2,1417,58
2020-06-01,San Benito,069,59416,104,86,0,86,2
2020-06-01,San Bernardino,071,2135413,6716,5310,5,5315,202
2020-06-01,San Diego,073,3302833,8831,7556,0,7556,269
2020-06-01,San Francisco,075,870044,2750,2546,0,2546,43
2020-06-01,San Joaquin,077,732212,1255,957,3,960,35
2020-06-01,San Luis Obispo,079,281455,373,275,4,279,1
2020-06-01,San Mateo,081,765935,2458,2190,2,2192,71
2020-06-01,Santa Barbara,083,443738,1852,1671,14,1685,10
2020-06-01,Santa Clara,085,1922200,3530,2797,13,2810,142
2020-06-01,Santa Cruz,087,273765,234,215,0,215,2
2020-06-01,Shasta,089,179085,62,38,0,38,4
2020-06-01,Sierra,091,2930,1,1,0,1,0
2020-06-01,Siskiyou,093,43540,13,7,0,7,0
2020-06-01,Solano,095,438530,659,529,1,530,17
2020-06-01,Sonoma,097,501317,661,565,1,566,4
2020-06-01,Stanislaus,099,539301,966,758,5,763,27
2020-06-01,Sutter,101,95872,52,43,0,43,2
2020-06-01,Tehama,103,63373,11,5,1,6,1
2020-06-01,Trinity,105,12862,7,1,2,3,0
2020-06-01,Tulare,107,460477,2709,1976,10,1986,84
2020-06-01,Tuolumne,109,53932,5,4,0,4,0
2020-06-01,Ventura,111,848112,1708,1163,10,1173,29
2020-06-01,Yolo,113,214977,248,212,0,212,24
2020-06-01,Yuba,115,75493,30,26,0,26,1
2020-05-31,Alameda,001,1643700,3872,3362,5,3367,98
2020-05-31,Alpine,003,1148,1,1,0,1,0
2020-05-31,Amador,005,37829,10,10,0,10,0
2020-05-31,Butte,007,227075,78,51,3,54,0
2020-05-31,Calaveras,009,45235,18,15,0,15,0
2020-05-31,Colusa,011,21464,9,5,0,5,0
2020-05-31,Contra Costa,013,1133247,1721,1458,1,1459,37
2020-05-31,Del Norte,015,27424,45,37,0,37,0
2020-05-31,El Dorado,017,186661,119,88,1,89,0
2020-05-31,Fresno,019,978130,3370,1780,46,1826,31
2020-05-31,Glenn,021,27897,20,16,0,16,0
2020-05-31,Humboldt,023,135768,113,98,0,98,2
2020-05-31,Imperial,025,180216,3804,2197,4,2201,14
2020-05-31,Inyo,027,18085,20,20,0,20,1
2020-05-31,Kern,029,883053,2923,2300,6,2306,38
2020-05-31,Kings,031,150075,1263,703,3,706,3
2020-05-31,Lake,033,64148,32,19,0,19,0
2020-05-31,Lassen,035,31185,10,4,2,6,0
2020-05-31,Los Angeles,037,10098052,62528,54925,20,54945,2344
2020-05-31,Madera,039,155013,271,101,1,102,2
2020-05-31,Marin,041,260295,534,486,2,488,14
2020-05-31,Mariposa,043,17540,16,16,0,16,1
2020-05-31,Mendocino,045,87422,32,24,0,24,0
2020-05-31,Merced,047,269075,397,288,0,288,6
2020-05-31,Modoc,049,8938,0,0,0,0,0
2020-05-31,Mono,051,14174,39,34,0,34,1
2020-05-31,Monterey,053,433212,721,545,2,547,10
2020-05-31,Napa,055,140530,147,114,0,114,3
2020-05-31,Nevada,057,99092,50,41,1,42,1
2020-05-31,Orange,059,3164182,9264,6532,68,6600,135
2020-05-31,Placer,061,380077,294,215,2,217,9
2020-05-31,Plumas,063,18699,4,4,0,4,0
2020-05-31,Riverside,065,2383286,9859,7704,21,7725,321
2020-05-31,Sacramento,067,1510023,1533,1398,2,1400,57
2020-05-31,San Benito,069,59416,98,85,0,85,2
2020-05-31,San Bernardino,071,2135413,6448,5185,5,5190,198
2020-05-31,San Diego,073,3302833,8638,7483,0,7483,269
2020-05-31,San Francisco,075,870044,2714,2501,0,2501,43
2020-05-31,San Joaquin,077,732212,1190,888,3,891,34
2020-05-31,San Luis Obispo,079,281455,363,271,4,275,1
2020-05-31,San Mateo,081,765935,2412,2169,2,2171,71
2020-05-31,Santa Barbara,083,443738,1801,1662,13,1675,9
2020-05-31,Santa Clara,085,1922200,3486,2785,13,2798,142
2020-05-31,Santa Cruz,087,273765,231,210,0,210,2
2020-05-31,Shasta,089,179085,60,38,0,38,4
2020-05-31,Sierra,091,2930,1,1,0,1,0
2020-05-31,Siskiyou,093,43540,12,7,0,7,0
2020-05-31,Solano,095,438530,633,512,1,513,6
2020-05-31,Sonoma,097,501317,641,555,1,556,4
2020-05-31,Stanislaus,099,539301,912,738,5,743,27
2020-05-31,Sutter,101,95872,50,42,0,42,2
2020-05-31,Tehama,103,63373,10,4,1,5,1
2020-05-31,Trinity,105,12862,7,1,2,3,0
2020-05-31,Tulare,107,460477,2636,1884,10,1894,82
2020-05-31,Tuolumne,109,53932,5,4,0,4,0
2020-05-31,Ventura,111,848112,1647,1151,10,1161,30
2020-05-31,Yolo,113,214977,242,211,0,211,24
2020-05-31,Yuba,115,75493,30,26,0,26,1
2020-05-30,Alameda,001,1643700,3846,3304,5,3309,96
2020-05-30,Alpine,003,1148,1,1,0,1,0
2020-05-30,Amador,005,37829,10,10,0,10,0
2020-05-30,Butte,007,227075,77,44,3,47,0
2020-05-30,Calaveras,009,45235,17,15,0,15,0
2020-05-30,Colusa,011,21464,8,5,0,5,0
2020-05-30,Contra Costa,013,1133247,1705,1429,1,1430,37
2020-05-30,Del Norte,015,27424,45,37,0,37,0
2020-05-30,El Dorado,017,186661,118,86,1,87,0
2020-05-30,Fresno,019,978130,3309,1744,45,1789,31
2020-05-30,Glenn,021,27897,19,16,0,16,0
2020-05-30,Humboldt,023,135768,112,98,0,98,2
2020-05-30,Imperial,025,180216,3714,2091,4,2095,14
2020-05-30,Inyo,027,18085,20,20,0,20,1
2020-05-30,Kern,029,883053,2854,2217,6,2223,38
2020-05-30,Kings,031,150075,1249,703,3,706,3
2020-05-30,Lake,033,64148,31,18,0,18,0
2020-05-30,Lassen,035,31185,10,4,2,6,0
2020-05-30,Los Angeles,037,10098052,61992,53627,20,53647,2319
2020-05-30,Madera,039,155013,266,101,1,102,2
2020-05-30,Marin,041,260295,534,462,2,464,14
2020-05-30,Mariposa,043,17540,16,16,0,16,1
2020-05-30,Mendocino,045,87422,32,24,0,24,0
2020-05-30,Merced,047,269075,396,285,0,285,6
2020-05-30,Modoc,049,8938,0,0,0,0,0
2020-05-30,Mono,051,14174,39,34,0,34,1
2020-05-30,Monterey,053,433212,705,520,2,522,10
2020-05-30,Napa,055,140530,145,113,0,113,3
2020-05-30,Nevada,057,99092,50,41,1,42,1
2020-05-30,Orange,059,3164182,9107,6354,67,6421,134
2020-05-30,Placer,061,380077,286,199,1,200,9
2020-05-30,Plumas,063,18699,4,4,0,4,0
2020-05-30,Riverside,065,2383286,9715,7492,21,7513,316
2020-05-30,Sacramento,067,1510023,1522,1384,2,1386,57
2020-05-30,San Benito,069,59416,97,85,0,85,2
2020-05-30,San Bernardino,071,2135413,6339,5122,5,5127,198
2020-05-30,San Diego,073,3302833,8545,7387,0,7387,269
2020-05-30,San Francisco,075,870044,2689,2496,0,2496,41
2020-05-30,San Joaquin,077,732212,1152,888,3,891,34
2020-05-30,San Luis Obispo,079,281455,358,270,4,274,1
2020-05-30,San Mateo,081,765935,2388,2129,2,2131,71
2020-05-30,Santa Barbara,083,443738,1782,1660,13,1673,9
2020-05-30,Santa Clara,085,1922200,3470,2741,13,2754,141
2020-05-30,Santa Cruz,087,273765,231,206,0,206,2
2020-05-30,Shasta,089,179085,60,36,0,36,4
2020-05-30,Sierra,091,2930,1,1,0,1,0
2020-05-30,Siskiyou,093,43540,11,7,0,7,0
2020-05-30,Solano,095,438530,626,512,1,513,6
2020-05-30,Sonoma,097,501317,631,551,1,552,4
2020-05-30,Stanislaus,099,539301,895,712,5,717,27
2020-05-30,Sutter,101,95872,49,40,0,40,2
2020-05-30,Tehama,103,63373,10,4,1,5,1
2020-05-30,Trinity,105,12862,7,1,2,3,0
2020-05-30,Tulare,107,460477,2599,1879,10,1889,81
2020-05-30,Tuolumne,109,53932,5,4,0,4,0
2020-05-30,Ventura,111,848112,1630,1116,10,1126,30
2020-05-30,Yolo,113,214977,238,210,0,210,24
2020-05-30,Yuba,115,75493,30,25,0,25,1
2020-05-29,Alameda,001,1643700,3811,3209,5,3214,96
2020-05-29,Alpine,003,1148,1,1,0,1,0
2020-05-29,Amador,005,37829,10,10,0,10,0
2020-05-29,Butte,007,227075,72,41,3,44,0
2020-05-29,Calaveras,009,45235,17,15,0,15,0
2020-05-29,Colusa,011,21464,8,5,0,5,0
2020-05-29,Contra Costa,013,1133247,1689,1411,1,1412,37
2020-05-29,Del Norte,015,27424,45,37,0,37,0
2020-05-29,El Dorado,017,186661,117,85,1,86,0
2020-05-29,Fresno,019,978130,3259,1687,45,1732,31
2020-05-29,Glenn,021,27897,19,14,0,14,0
2020-05-29,Humboldt,023,135768,111,98,0,98,2
2020-05-29,Imperial,025,180216,3596,1607,4,1611,14
2020-05-29,Inyo,027,18085,20,20,0,20,1
2020-05-29,Kern,029,883053,2796,2128,6,2134,36
2020-05-29,Kings,031,150075,1238,693,3,696,3
2020-05-29,Lake,033,64148,30,17,0,17,0
2020-05-29,Lassen,035,31185,10,0,2,2,0
2020-05-29,Los Angeles,037,10098052,61035,51578,20,51598,2273
2020-05-29,Madera,039,155013,251,98,1,99,2
2020-05-29,Marin,041,260295,526,448,2,450,14
2020-05-29,Mariposa,043,17540,16,16,0,16,1
2020-05-29,Mendocino,045,87422,30,25,0,25,0
2020-05-29,Merced,047,269075,391,285,0,285,7
2020-05-29,Modoc,049,8938,0,0,0,0,0
2020-05-29,Mono,051,14174,38,34,0,34,1
2020-05-29,Monterey,053,433212,675,479,2,481,10
2020-05-29,Napa,055,140530,142,113,0,113,3
2020-05-29,Nevada,057,99092,50,41,1,42,1
2020-05-29,Orange,059,3164182,8921,6176,64,6240,133
2020-05-29,Placer,061,380077,264,199,1,200,9
2020-05-29,Plumas,063,18699,4,4,0,4,0
2020-05-29,Riverside,065,2383286,9529,7376,21,7397,313
2020-05-29,Sacramento,067,1510023,1499,1360,2,1362,57
2020-05-29,San Benito,069,59416,97,84,0,84,2
2020-05-29,San Bernardino,071,2135413,6231,4983,5,4988,196
2020-05-29,San Diego,073,3302833,8422,7242,0,7242,266
2020-05-29,San Francisco,075,870044,2665,2453,0,2453,41
2020-05-29,San Joaquin,077,732212,1115,855,3,858,34
2020-05-29,San Luis Obispo,079,281455,354,270,4,274,1
2020-05-29,San Mateo,081,765935,2372,2103,2,2105,71
2020-05-29,Santa Barbara,083,443738,1754,1656,13,1669,9
2020-05-29,Santa Clara,085,1922200,3442,2707,13,2720,141
2020-05-29,Santa Cruz,087,273765,228,203,0,203,2
2020-05-29,Shasta,089,179085,60,36,0,36,4
2020-05-29,Sierra,091,2930,1,1,0,1,0
2020-05-29,Siskiyou,093,43540,11,7,0,7,0
2020-05-29,Solano,095,438530,618,498,1,499,6
2020-05-29,Sonoma,097,501317,620,537,1,538,4
2020-05-29,Stanislaus,099,539301,865,698,5,703,27
2020-05-29,Sutter,101,95872,47,40,0,40,2
2020-05-29,Tehama,103,63373,9,4,1,5,1
2020-05-29,Trinity,105,12862,7,1,2,3,0
2020-05-29,Tulare,107,460477,2561,1852,10,1862,80
2020-05-29,Tuolumne,109,53932,5,4,0,4,0
2020-05-29,Ventura,111,848112,1606,1093,10,1103,29
2020-05-29,Yolo,113,214977,234,211,0,211,24
2020-05-29,Yuba,115,75493,29,25,0,25,1
2020-05-28,Alameda,001,1643700,3712,3083,5,3088,94
2020-05-28,Alpine,003,1148,1,1,0,1,0
2020-05-28,Amador,005,37829,10,10,0,10,0
2020-05-28,Butte,007,227075,71,40,3,43,0
2020-05-28,Calaveras,009,45235,16,15,0,15,0
2020-05-28,Colusa,011,21464,8,5,0,5,0
2020-05-28,Contra Costa,013,1133247,1650,1392,1,1393,37
2020-05-28,Del Norte,015,27424,45,37,0,37,0
2020-05-28,El Dorado,017,186661,114,82,1,83,0
2020-05-28,Fresno,019,978130,3178,1653,44,1697,31
2020-05-28,Glenn,021,27897,18,14,0,14,0
2020-05-28,Humboldt,023,135768,110,97,0,97,2
2020-05-28,Imperial,025,180216,3402,1430,4,1434,14
2020-05-28,Inyo,027,18085,20,20,0,20,1
2020-05-28,Kern,029,883053,2718,2069,6,2075,36
2020-05-28,Kings,031,150075,901,626,3,629,3
2020-05-28,Lake,033,64148,29,17,0,17,0
2020-05-28,Lassen,035,31185,10,0,2,2,0
2020-05-28,Los Angeles,037,10098052,59458,49861,20,49881,2222
2020-05-28,Madera,039,155013,233,93,1,94,2
2020-05-28,Marin,041,260295,501,443,2,445,14
2020-05-28,Mariposa,043,17540,16,16,0,16,1
2020-05-28,Mendocino,045,87422,28,24,0,24,0
2020-05-28,Merced,047,269075,382,283,0,283,7
2020-05-28,Modoc,049,8938,0,0,0,0,0
2020-05-28,Mono,051,14174,38,34,0,34,1
2020-05-28,Monterey,053,433212,643,471,2,473,10
2020-05-28,Napa,055,140530,139,113,0,113,3
2020-05-28,Nevada,057,99092,45,41,1,42,1
2020-05-28,Orange,059,3164182,8725,6045,64,6109,130
2020-05-28,Placer,061,380077,257,196,1,197,9
2020-05-28,Plumas,063,18699,4,4,0,4,0
2020-05-28,Riverside,065,2383286,9125,7240,20,7260,304
2020-05-28,Sacramento,067,1510023,1479,1339,2,1341,57
2020-05-28,San Benito,069,59416,96,82,0,82,2
2020-05-28,San Bernardino,071,2135413,6066,4831,5,4836,191
2020-05-28,San Diego,073,3302833,8265,7102,0,7102,260
2020-05-28,San Francisco,075,870044,2631,2417,0,2417,40
2020-05-28,San Joaquin,077,732212,1080,840,3,843,34
2020-05-28,San Luis Obispo,079,281455,351,267,4,271,1
2020-05-28,San Mateo,081,765935,2345,2070,2,2072,71
2020-05-28,Santa Barbara,083,443738,1726,1642,12,1654,9
2020-05-28,Santa Clara,085,1922200,3402,2698,13,2711,140
2020-05-28,Santa Cruz,087,273765,227,201,0,201,2
2020-05-28,Shasta,089,179085,58,36,0,36,4
2020-05-28,Sierra,091,2930,1,1,0,1,0
2020-05-28,Siskiyou,093,43540,9,6,0,6,0
2020-05-28,Solano,095,438530,601,489,1,490,6
2020-05-28,Sonoma,097,501317,598,529,1,530,4
2020-05-28,Stanislaus,099,539301,824,684,5,689,27
2020-05-28,Sutter,101,95872,47,40,0,40,2
2020-05-28,Tehama,103,63373,9,4,1,5,1
2020-05-28,Trinity,105,12862,6,1,2,3,0
2020-05-28,Tulare,107,460477,2525,1832,10,1842,79
2020-05-28,Tuolumne,109,53932,5,4,0,4,0
2020-05-28,Ventura,111,848112,1573,1083,10,1093,29
2020-05-28,Yolo,113,214977,231,206,0,206,22
2020-05-28,Yuba,115,75493,28,24,0,24,1
2020-05-27,Alameda,001,1643700,3629,3037,5,3042,94
2020-05-27,Alpine,003,1148,1,1,0,1,0
2020-05-27,Amador,005,37829,10,10,0,10,0
2020-05-27,Butte,007,227075,68,40,2,42,0
2020-05-27,Calaveras,009,45235,15,15,0,15,0
2020-05-27,Colusa,011,21464,8,5,0,5,0
2020-05-27,Contra Costa,013,1133247,1610,1373,1,1374,37
2020-05-27,Del Norte,015,27424,45,34,0,34,0
2020-05-27,El Dorado,017,186661,113,82,1,83,0
2020-05-27,Fresno,019,978130,3090,1620,44,1664,27
2020-05-27,Glenn,021,27897,18,14,0,14,0
2020-05-27,Humboldt,023,135768,110,86,0,86,2
2020-05-27,Imperial,025,180216,3222,1369,4,1373,14
2020-05-27,Inyo,027,18085,20,20,0,20,1
2020-05-27,Kern,029,883053,2653,1999,6,2005,37
2020-05-27,Kings,031,150075,874,586,3,589,3
2020-05-27,Lake,033,64148,29,13,0,13,0
2020-05-27,Lassen,035,31185,10,0,2,2,0
2020-05-27,Los Angeles,037,10098052,58083,48711,20,48731,2177
2020-05-27,Madera,039,155013,224,91,1,92,2
2020-05-27,Marin,041,260295,472,439,2,441,14
2020-05-27,Mariposa,043,17540,16,16,0,16,1
2020-05-27,Mendocino,045,87422,27,21,0,21,0
2020-05-27,Merced,047,269075,378,278,0,278,7
2020-05-27,Modoc,049,8938,0,0,0,0,0
2020-05-27,Mono,051,14174,38,34,0,34,1
2020-05-27,Monterey,053,433212,603,443,2,445,8
2020-05-27,Napa,055,140530,134,112,0,112,3
2020-05-27,Nevada,057,99092,44,41,1,42,1
2020-05-27,Orange,059,3164182,8570,5849,64,5913,121
2020-05-27,Placer,061,380077,238,196,0,196,9
2020-05-27,Plumas,063,18699,4,4,0,4,0
2020-05-27,Riverside,065,2383286,8746,7156,20,7176,299
2020-05-27,Sacramento,067,1510023,1451,1318,2,1320,50
2020-05-27,San Benito,069,59416,93,74,0,74,2
2020-05-27,San Bernardino,071,2135413,5882,4708,5,4713,183
2020-05-27,San Diego,073,3302833,8114,6985,0,6985,255
2020-05-27,San Francisco,075,870044,2602,2394,0,2394,40
2020-05-27,San Joaquin,077,732212,1039,825,3,828,34
2020-05-27,San Luis Obispo,079,281455,346,266,4,270,1
2020-05-27,San Mateo,081,765935,2305,2045,2,2047,71
2020-05-27,Santa Barbara,083,443738,1711,1629,12,1641,9
2020-05-27,Santa Clara,085,1922200,3369,2680,13,2693,140
2020-05-27,Santa Cruz,087,273765,223,202,0,202,2
2020-05-27,Shasta,089,179085,55,36,0,36,4
2020-05-27,Sierra,091,2930,1,1,0,1,0
2020-05-27,Siskiyou,093,43540,9,6,0,6,0
2020-05-27,Solano,095,438530,581,477,1,478,5
2020-05-27,Sonoma,097,501317,584,521,1,522,4
2020-05-27,Stanislaus,099,539301,799,675,5,680,27
2020-05-27,Sutter,101,95872,46,40,0,40,2
2020-05-27,Tehama,103,63373,9,3,1,4,1
2020-05-27,Trinity,105,12862,6,1,2,3,0
2020-05-27,Tulare,107,460477,2473,1817,10,1827,77
2020-05-27,Tuolumne,109,53932,5,4,0,4,0
2020-05-27,Ventura,111,848112,1548,1065,10,1075,28
2020-05-27,Yolo,113,214977,230,204,0,204,22
2020-05-27,Yuba,115,75493,28,24,0,24,1
2020-05-26,Alameda,001,1643700,3534,2956,5,2961,92
2020-05-26,Alpine,003,1148,1,1,0,1,0
2020-05-26,Amador,005,37829,10,10,0,10,0
2020-05-26,Butte,007,227075,66,37,1,38,0
2020-05-26,Calaveras,009,45235,15,13,0,13,0
2020-05-26,Colusa,011,21464,8,4,0,4,0
2020-05-26,Contra Costa,013,1133247,1574,1352,1,1353,37
2020-05-26,Del Norte,015,27424,44,30,0,30,0
2020-05-26,El Dorado,017,186661,109,79,1,80,0
2020-05-26,Fresno,019,978130,3003,1496,44,1540,22
2020-05-26,Glenn,021,27897,16,12,0,12,0
2020-05-26,Humboldt,023,135768,108,81,0,81,2
2020-05-26,Imperial,025,180216,3007,1369,4,1373,14
2020-05-26,Inyo,027,18085,20,20,0,20,1
2020-05-26,Kern,029,883053,2575,1890,6,1896,31
2020-05-26,Kings,031,150075,806,449,2,451,2
2020-05-26,Lake,033,64148,27,12,0,12,0
2020-05-26,Lassen,035,31185,9,0,2,2,0
2020-05-26,Los Angeles,037,10098052,56616,47760,20,47780,2121
2020-05-26,Madera,039,155013,209,83,1,84,2
2020-05-26,Marin,041,260295,460,424,2,426,14
2020-05-26,Mariposa,043,17540,16,16,0,16,1
2020-05-26,Mendocino,045,87422,25,20,0,20,0
2020-05-26,Merced,047,269075,363,266,0,266,7
2020-05-26,Modoc,049,8938,0,1,0,1,0
2020-05-26,Mono,051,14174,37,34,0,34,1
2020-05-26,Monterey,053,433212,575,424,1,425,8
2020-05-26,Napa,055,140530,129,109,0,109,3
2020-05-26,Nevada,057,99092,43,41,1,42,1
2020-05-26,Orange,059,3164182,8300,5651,63,5714,115
2020-05-26,Placer,061,380077,233,188,0,188,9
2020-05-26,Plumas,063,18699,4,4,0,4,0
2020-05-26,Riverside,065,2383286,8299,6917,20,6937,284
2020-05-26,Sacramento,067,1510023,1425,1298,2,1300,50
2020-05-26,San Benito,069,59416,88,69,0,69,2
2020-05-26,San Bernardino,071,2135413,5714,4430,5,4435,175
2020-05-26,San Diego,073,3302833,7971,6884,0,6884,249
2020-05-26,San Francisco,075,870044,2569,2363,0,2363,40
2020-05-26,San Joaquin,077,732212,992,760,3,763,33
2020-05-26,San Luis Obispo,079,281455,344,260,4,264,1
2020-05-26,San Mateo,081,765935,2267,1967,2,1969,71
2020-05-26,Santa Barbara,083,443738,1694,1590,11,1601,9
2020-05-26,Santa Clara,085,1922200,3337,2659,13,2672,139
2020-05-26,Santa Cruz,087,273765,221,197,0,197,2
2020-05-26,Shasta,089,179085,55,36,0,36,4
2020-05-26,Sierra,091,2930,1,1,0,1,0
2020-05-26,Siskiyou,093,43540,8,6,0,6,0
2020-05-26,Solano,095,438530,563,470,1,471,5
2020-05-26,Sonoma,097,501317,576,509,0,509,4
2020-05-26,Stanislaus,099,539301,779,663,5,668,27
2020-05-26,Sutter,101,95872,45,39,0,39,2
2020-05-26,Tehama,103,63373,8,2,1,3,1
2020-05-26,Trinity,105,12862,6,1,2,3,0
2020-05-26,Tulare,107,460477,2417,1768,10,1778,76
2020-05-26,Tuolumne,109,53932,5,2,0,2,0
2020-05-26,Ventura,111,848112,1511,1033,8,1041,27
2020-05-26,Yolo,113,214977,224,198,0,198,22
2020-05-26,Yuba,115,75493,27,24,0,24,1
2020-05-25,Alameda,001,1643700,3440,2900,5,2905,92
2020-05-25,Alpine,003,1148,1,1,0,1,0
2020-05-25,Amador,005,37829,10,10,0,10,0
2020-05-25,Butte,007,227075,63,37,1,38,0
2020-05-25,Calaveras,009,45235,15,13,0,13,0
2020-05-25,Colusa,011,21464,7,4,0,4,0
2020-05-25,Contra Costa,013,1133247,1542,1348,1,1349,37
2020-05-25,Del Norte,015,27424,44,20,0,20,0
2020-05-25,El Dorado,017,186661,101,78,1,79,0
2020-05-25,Fresno,019,978130,2900,1496,42,1538,22
2020-05-25,Glenn,021,27897,16,12,0,12,0
2020-05-25,Humboldt,023,135768,107,81,0,81,2
2020-05-25,Imperial,025,180216,2798,1369,4,1373,14
2020-05-25,Inyo,027,18085,19,20,0,20,1
2020-05-25,Kern,029,883053,2504,1890,6,1896,31
2020-05-25,Kings,031,150075,776,447,2,449,2
2020-05-25,Lake,033,64148,25,13,0,13,0
2020-05-25,Lassen,035,31185,9,0,2,2,0
2020-05-25,Los Angeles,037,10098052,54804,45952,19,45971,2094
2020-05-25,Madera,039,155013,196,83,1,84,2
2020-05-25,Marin,041,260295,442,415,2,417,14
2020-05-25,Mariposa,043,17540,16,15,0,15,1
2020-05-25,Mendocino,045,87422,22,19,0,19,0
2020-05-25,Merced,047,269075,356,262,0,262,6
2020-05-25,Modoc,049,8938,0,1,0,1,0
2020-05-25,Mono,051,14174,37,34,0,34,1
2020-05-25,Monterey,053,433212,545,418,1,419,8
2020-05-25,Napa,055,140530,129,107,0,107,3
2020-05-25,Nevada,057,99092,43,41,1,42,1
2020-05-25,Orange,059,3164182,8078,5601,62,5663,115
2020-05-25,Placer,061,380077,229,186,0,186,9
2020-05-25,Plumas,063,18699,4,4,0,4,0
2020-05-25,Riverside,065,2383286,8068,6900,20,6920,284
2020-05-25,Sacramento,067,1510023,1405,1290,1,1291,50
2020-05-25,San Benito,069,59416,87,70,0,70,2
2020-05-25,San Bernardino,071,2135413,5524,4393,4,4397,175
2020-05-25,San Diego,073,3302833,7795,6799,0,6799,249
2020-05-25,San Francisco,075,870044,2532,2358,0,2358,40
2020-05-25,San Joaquin,077,732212,966,760,3,763,33
2020-05-25,San Luis Obispo,079,281455,341,260,4,264,1
2020-05-25,San Mateo,081,765935,2230,1938,2,1940,71
2020-05-25,Santa Barbara,083,443738,1684,1590,11,1601,9
2020-05-25,Santa Clara,085,1922200,3304,2647,13,2660,139
2020-05-25,Santa Cruz,087,273765,219,191,0,191,2
2020-05-25,Shasta,089,179085,54,36,0,36,4
2020-05-25,Sierra,091,2930,1,1,0,1,0
2020-05-25,Siskiyou,093,43540,8,6,0,6,0
2020-05-25,Solano,095,438530,549,437,1,438,5
2020-05-25,Sonoma,097,501317,564,496,0,496,4
2020-05-25,Stanislaus,099,539301,749,651,5,656,27
2020-05-25,Sutter,101,95872,45,38,0,38,2
2020-05-25,Tehama,103,63373,7,2,1,3,1
2020-05-25,Trinity,105,12862,6,1,2,3,0
2020-05-25,Tulare,107,460477,2353,1747,10,1757,76
2020-05-25,Tuolumne,109,53932,5,2,0,2,0
2020-05-25,Ventura,111,848112,1470,1020,8,1028,27
2020-05-25,Yolo,113,214977,222,197,0,197,22
2020-05-25,Yuba,115,75493,26,24,0,24,1
2020-05-24,Alameda,001,1643700,3367,2830,5,2835,92
2020-05-24,Alpine,003,1148,1,1,0,1,0
2020-05-24,Amador,005,37829,10,9,0,9,0
2020-05-24,Butte,007,227075,61,35,1,36,0
2020-05-24,Calaveras,009,45235,15,13,0,13,0
2020-05-24,Colusa,011,21464,7,4,0,4,0
2020-05-24,Contra Costa,013,1133247,1514,1325,1,1326,37
2020-05-24,Del Norte,015,27424,43,16,0,16,0
2020-05-24,El Dorado,017,186661,100,76,1,77,0
2020-05-24,Fresno,019,978130,2833,1455,41,1496,22
2020-05-24,Glenn,021,27897,15,12,0,12,0
2020-05-24,Humboldt,023,135768,107,81,0,81,2
2020-05-24,Imperial,025,180216,2672,1369,4,1373,14
2020-05-24,Inyo,027,18085,19,20,0,20,1
2020-05-24,Kern,029,883053,2431,1861,5,1866,31
2020-05-24,Kings,031,150075,765,446,2,448,2
2020-05-24,Lake,033,64148,24,12,0,12,0
2020-05-24,Lassen,035,31185,8,0,2,2,0
2020-05-24,Los Angeles,037,10098052,53788,44954,19,44973,2085
2020-05-24,Madera,039,155013,190,83,1,84,2
2020-05-24,Marin,041,260295,440,401,2,403,14
2020-05-24,Mariposa,043,17540,16,15,0,15,1
2020-05-24,Mendocino,045,87422,21,19,0,19,0
2020-05-24,Merced,047,269075,355,258,0,258,6
2020-05-24,Modoc,049,8938,0,0,0,0,0
2020-05-24,Mono,051,14174,37,34,0,34,1
2020-05-24,Monterey,053,433212,517,405,1,406,8
2020-05-24,Napa,055,140530,127,104,0,104,3
2020-05-24,Nevada,057,99092,43,41,1,42,1
2020-05-24,Orange,059,3164182,7924,5439,61,5500,113
2020-05-24,Placer,061,380077,221,184,0,184,9
2020-05-24,Plumas,063,18699,4,4,0,4,0
2020-05-24,Riverside,065,2383286,7927,6571,20,6591,284
2020-05-24,Sacramento,067,1510023,1389,1283,1,1284,50
2020-05-24,San Benito,069,59416,86,67,0,67,2
2020-05-24,San Bernardino,071,2135413,5416,4262,4,4266,175
2020-05-24,San Diego,073,3302833,7652,6703,0,6703,249
2020-05-24,San Francisco,075,870044,2509,2318,0,2318,40
2020-05-24,San Joaquin,077,732212,947,760,3,763,33
2020-05-24,San Luis Obispo,079,281455,339,257,4,261,1
2020-05-24,San Mateo,081,765935,2195,1925,2,1927,71
2020-05-24,Santa Barbara,083,443738,1672,1573,11,1584,9
2020-05-24,Santa Clara,085,1922200,3284,2623,13,2636,139
2020-05-24,Santa Cruz,087,273765,216,185,0,185,2
2020-05-24,Shasta,089,179085,53,36,0,36,4
2020-05-24,Sierra,091,2930,1,1,0,1,0
2020-05-24,Siskiyou,093,43540,7,6,0,6,0
2020-05-24,Solano,095,438530,541,436,0,436,5
2020-05-24,Sonoma,097,501317,553,485,0,485,4
2020-05-24,Stanislaus,099,539301,729,634,5,639,27
2020-05-24,Sutter,101,95872,45,38,0,38,2
2020-05-24,Tehama,103,63373,5,2,1,3,1
2020-05-24,Trinity,105,12862,6,1,2,3,0
2020-05-24,Tulare,107,460477,2307,1684,10,1694,74
2020-05-24,Tuolumne,109,53932,5,2,0,2,0
2020-05-24,Ventura,111,848112,1458,982,8,990,27
2020-05-24,Yolo,113,214977,220,192,0,192,22
2020-05-24,Yuba,115,75493,26,24,0,24,1
2020-05-23,Alameda,001,1643700,3326,2783,5,2788,91
2020-05-23,Alpine,003,1148,1,1,0,1,0
2020-05-23,Amador,005,37829,10,9,0,9,0
2020-05-23,Butte,007,227075,60,34,1,35,0
2020-05-23,Calaveras,009,45235,15,13,0,13,0
2020-05-23,Colusa,011,21464,7,4,0,4,0
2020-05-23,Contra Costa,013,1133247,1503,1302,1,1303,36
2020-05-23,Del Norte,015,27424,43,10,0,10,0
2020-05-23,El Dorado,017,186661,100,74,1,75,0
2020-05-23,Fresno,019,978130,2813,1447,41,1488,21
2020-05-23,Glenn,021,27897,15,12,0,12,0
2020-05-23,Humboldt,023,135768,105,80,0,80,2
2020-05-23,Imperial,025,180216,2584,1283,4,1287,14
2020-05-23,Inyo,027,18085,19,20,0,20,1
2020-05-23,Kern,029,883053,2388,1806,5,1811,31
2020-05-23,Kings,031,150075,761,444,2,446,2
2020-05-23,Lake,033,64148,23,10,0,10,0
2020-05-23,Lassen,035,31185,8,0,2,2,0
2020-05-23,Los Angeles,037,10098052,53243,44029,19,44048,2069
2020-05-23,Madera,039,155013,186,83,1,84,2
2020-05-23,Marin,041,260295,440,393,1,394,14
2020-05-23,Mariposa,043,17540,16,15,0,15,1
2020-05-23,Mendocino,045,87422,21,13,0,13,0
2020-05-23,Merced,047,269075,352,247,0,247,6
2020-05-23,Modoc,049,8938,0,0,0,0,0
2020-05-23,Mono,051,14174,36,34,0,34,1
2020-05-23,Monterey,053,433212,503,397,1,398,8
2020-05-23,Napa,055,140530,123,101,0,101,3
2020-05-23,Nevada,057,99092,43,41,1,42,1
2020-05-23,Orange,059,3164182,7765,5313,60,5373,113
2020-05-23,Placer,061,380077,215,184,0,184,9
2020-05-23,Plumas,063,18699,4,4,0,4,0
2020-05-23,Riverside,065,2383286,7836,6460,20,6480,284
2020-05-23,Sacramento,067,1510023,1373,1275,1,1276,50
2020-05-23,San Benito,069,59416,81,67,0,67,2
2020-05-23,San Bernardino,071,2135413,5322,4172,4,4176,175
2020-05-23,San Diego,073,3302833,7561,6561,0,6561,249
2020-05-23,San Francisco,075,870044,2490,2312,0,2312,40
2020-05-23,San Joaquin,077,732212,932,759,3,762,33
2020-05-23,San Luis Obispo,079,281455,335,256,4,260,1
2020-05-23,San Mateo,081,765935,2167,1862,2,1864,71
2020-05-23,Santa Barbara,083,443738,1664,1566,11,1577,9
2020-05-23,Santa Clara,085,1922200,3270,2593,12,2605,139
2020-05-23,Santa Cruz,087,273765,214,177,0,177,2
2020-05-23,Shasta,089,179085,53,35,0,35,4
2020-05-23,Sierra,091,2930,1,1,0,1,0
2020-05-23,Siskiyou,093,43540,7,6,0,6,0
2020-05-23,Solano,095,438530,536,435,0,435,5
2020-05-23,Sonoma,097,501317,539,462,0,462,4
2020-05-23,Stanislaus,099,539301,721,625,5,630,27
2020-05-23,Sutter,101,95872,44,38,0,38,2
2020-05-23,Tehama,103,63373,5,2,1,3,1
2020-05-23,Trinity,105,12862,6,1,2,3,0
2020-05-23,Tulare,107,460477,2286,1682,10,1692,73
2020-05-23,Tuolumne,109,53932,5,2,0,2,0
2020-05-23,Ventura,111,848112,1438,961,8,969,27
2020-05-23,Yolo,113,214977,219,188,0,188,22
2020-05-23,Yuba,115,75493,26,24,0,24,1
2020-05-22,Alameda,001,1643700,3272,2722,5,2727,91
2020-05-22,Alpine,003,1148,1,1,0,1,0
2020-05-22,Amador,005,37829,10,9,0,9,0
2020-05-22,Butte,007,227075,58,34,1,35,0
2020-05-22,Calaveras,009,45235,15,13,0,13,0
2020-05-22,Colusa,011,21464,7,4,0,4,0
2020-05-22,Contra Costa,013,1133247,1491,1272,1,1273,36
2020-05-22,Del Norte,015,27424,41,9,0,9,0
2020-05-22,El Dorado,017,186661,97,74,1,75,0
2020-05-22,Fresno,019,978130,2754,1399,40,1439,20
2020-05-22,Glenn,021,27897,15,12,0,12,0
2020-05-22,Humboldt,023,135768,105,80,0,80,2
2020-05-22,Imperial,025,180216,2483,1214,4,1218,14
2020-05-22,Inyo,027,18085,19,20,0,20,1
2020-05-22,Kern,029,883053,2339,1749,5,1754,28
2020-05-22,Kings,031,150075,758,428,2,430,2
2020-05-22,Lake,033,64148,22,10,0,10,0
2020-05-22,Lassen,035,31185,6,0,2,2,0
2020-05-22,Los Angeles,037,10098052,52446,43025,19,43044,2027
2020-05-22,Madera,039,155013,182,82,1,83,2
2020-05-22,Marin,041,260295,436,372,1,373,14
2020-05-22,Mariposa,043,17540,16,15,0,15,1
2020-05-22,Mendocino,045,87422,20,13,0,13,0
2020-05-22,Merced,047,269075,352,233,0,233,6
2020-05-22,Modoc,049,8938,0,0,0,0,0
2020-05-22,Mono,051,14174,36,34,0,34,1
2020-05-22,Monterey,053,433212,492,372,1,373,8
2020-05-22,Napa,055,140530,121,97,0,97,3
2020-05-22,Nevada,057,99092,42,41,1,42,1
2020-05-22,Orange,059,3164182,7568,5144,58,5202,113
2020-05-22,Placer,061,380077,215,181,0,181,9
2020-05-22,Plumas,063,18699,4,4,0,4,0
2020-05-22,Riverside,065,2383286,7721,6351,20,6371,283
2020-05-22,Sacramento,067,1510023,1357,1262,1,1263,50
2020-05-22,San Benito,069,59416,80,64,0,64,2
2020-05-22,San Bernardino,071,2135413,5247,4107,4,4111,173
2020-05-22,San Diego,073,3302833,7475,6436,0,6436,242
2020-05-22,San Francisco,075,870044,2472,2251,0,2251,40
2020-05-22,San Joaquin,077,732212,919,747,3,750,33
2020-05-22,San Luis Obispo,079,281455,334,254,4,258,1
2020-05-22,San Mateo,081,765935,2148,1847,2,1849,71
2020-05-22,Santa Barbara,083,443738,1654,1554,11,1565,9
2020-05-22,Santa Clara,085,1922200,3250,2537,12,2549,139
2020-05-22,Santa Cruz,087,273765,211,171,0,171,2
2020-05-22,Shasta,089,179085,53,34,0,34,4
2020-05-22,Sierra,091,2930,1,0,0,0,0
2020-05-22,Siskiyou,093,43540,7,6,0,6,0
2020-05-22,Solano,095,438530,533,431,0,431,4
2020-05-22,Sonoma,097,501317,535,444,0,444,4
2020-05-22,Stanislaus,099,539301,711,616,5,621,27
2020-05-22,Sutter,101,95872,44,38,0,38,2
2020-05-22,Tehama,103,63373,5,2,0,2,1
2020-05-22,Trinity,105,12862,6,1,2,3,0
2020-05-22,Tulare,107,460477,2256,1662,10,1672,73
2020-05-22,Tuolumne,109,53932,5,2,0,2,0
2020-05-22,Ventura,111,848112,1420,937,8,945,27
2020-05-22,Yolo,113,214977,217,187,0,187,22
2020-05-22,Yuba,115,75493,26,24,0,24,1
2020-05-21,Alameda,001,1643700,3206,2606,5,2611,89
2020-05-21,Alpine,003,1148,1,1,0,1,0
2020-05-21,Amador,005,37829,10,9,0,9,0
2020-05-21,Butte,007,227075,57,31,1,32,0
2020-05-21,Calaveras,009,45235,15,13,0,13,0
2020-05-21,Colusa,011,21464,7,4,0,4,0
2020-05-21,Contra Costa,013,1133247,1455,1243,1,1244,36
2020-05-21,Del Norte,015,27424,38,9,0,9,0
2020-05-21,El Dorado,017,186661,95,67,1,68,0
2020-05-21,Fresno,019,978130,2663,1362,39,1401,20
2020-05-21,Glenn,021,27897,14,12,0,12,0
2020-05-21,Humboldt,023,135768,104,79,0,79,0
2020-05-21,Imperial,025,180216,2322,1096,4,1100,14
2020-05-21,Inyo,027,18085,19,20,0,20,1
2020-05-21,Kern,029,883053,2263,1684,4,1688,27
2020-05-21,Kings,031,150075,737,417,2,419,2
2020-05-21,Lake,033,64148,17,10,0,10,0
2020-05-21,Lassen,035,31185,6,0,2,2,0
2020-05-21,Los Angeles,037,10098052,51408,42063,19,42082,1996
2020-05-21,Madera,039,155013,179,82,1,83,2
2020-05-21,Marin,041,260295,425,359,1,360,14
2020-05-21,Mariposa,043,17540,16,15,0,15,1
2020-05-21,Mendocino,045,87422,20,12,0,12,0
2020-05-21,Merced,047,269075,341,226,0,226,6
2020-05-21,Modoc,049,8938,0,0,0,0,0
2020-05-21,Mono,051,14174,36,33,0,33,1
2020-05-21,Monterey,053,433212,481,363,1,364,8
2020-05-21,Napa,055,140530,119,96,0,96,3
2020-05-21,Nevada,057,99092,42,41,1,42,1
2020-05-21,Orange,059,3164182,7365,4975,58,5033,106
2020-05-21,Placer,061,380077,208,176,0,176,8
2020-05-21,Plumas,063,18699,4,4,0,4,0
2020-05-21,Riverside,065,2383286,7535,6245,20,6265,279
2020-05-21,Sacramento,067,1510023,1344,1258,1,1259,56
2020-05-21,San Benito,069,59416,77,61,0,61,2
2020-05-21,San Bernardino,071,2135413,5100,3950,4,3954,167
2020-05-21,San Diego,073,3302833,7339,6317,0,6317,241
2020-05-21,San Francisco,075,870044,2448,2248,0,2248,37
2020-05-21,San Joaquin,077,732212,883,730,3,733,33
2020-05-21,San Luis Obispo,079,281455,334,251,3,254,1
2020-05-21,San Mateo,081,765935,2112,1791,2,1793,74
2020-05-21,Santa Barbara,083,443738,1639,1541,11,1552,10
2020-05-21,Santa Clara,085,1922200,3227,2520,12,2532,138
2020-05-21,Santa Cruz,087,273765,203,164,0,164,3
2020-05-21,Shasta,089,179085,51,34,0,34,4
2020-05-21,Sierra,091,2930,1,0,0,0,0
2020-05-21,Siskiyou,093,43540,7,6,0,6,0
2020-05-21,Solano,095,438530,524,424,0,424,4
2020-05-21,Sonoma,097,501317,517,427,0,427,4
2020-05-21,Stanislaus,099,539301,700,602,5,607,27
2020-05-21,Sutter,101,95872,43,38,0,38,2
2020-05-21,Tehama,103,63373,4,2,0,2,1
2020-05-21,Trinity,105,12862,5,1,2,3,0
2020-05-21,Tulare,107,460477,2206,1606,8,1614,73
2020-05-21,Tuolumne,109,53932,3,2,0,2,0
2020-05-21,Ventura,111,848112,1371,907,8,915,30
2020-05-21,Yolo,113,214977,214,185,0,185,22
2020-05-21,Yuba,115,75493,26,24,0,24,1
2020-05-20,Alameda,001,1643700,3133,2554,5,2559,89
2020-05-20,Alpine,003,1148,1,1,0,1,0
2020-05-20,Amador,005,37829,10,9,0,9,0
2020-05-20,Butte,007,227075,54,30,1,31,0
2020-05-20,Calaveras,009,45235,15,13,0,13,0
2020-05-20,Colusa,011,21464,7,3,0,3,0
2020-05-20,Contra Costa,013,1133247,1425,1223,1,1224,33
2020-05-20,Del Norte,015,27424,31,9,0,9,0
2020-05-20,El Dorado,017,186661,94,67,1,68,0
2020-05-20,Fresno,019,978130,2590,1329,38,1367,17
2020-05-20,Glenn,021,27897,13,12,0,12,0
2020-05-20,Humboldt,023,135768,101,73,0,73,0
2020-05-20,Imperial,025,180216,2209,1047,4,1051,14
2020-05-20,Inyo,027,18085,19,20,0,20,1
2020-05-20,Kern,029,883053,2200,1639,3,1642,27
2020-05-20,Kings,031,150075,593,403,2,405,2
2020-05-20,Lake,033,64148,17,9,0,9,0
2020-05-20,Lassen,035,31185,5,0,2,2,0
2020-05-20,Los Angeles,037,10098052,50411,40932,19,40951,1955
2020-05-20,Madera,039,155013,177,82,1,83,2
2020-05-20,Marin,041,260295,398,348,1,349,14
2020-05-20,Mariposa,043,17540,16,15,0,15,1
2020-05-20,Mendocino,045,87422,20,12,0,12,0
2020-05-20,Merced,047,269075,334,225,0,225,6
2020-05-20,Modoc,049,8938,0,0,0,0,0
2020-05-20,Mono,051,14174,36,33,0,33,1
2020-05-20,Monterey,053,433212,467,356,1,357,8
2020-05-20,Napa,055,140530,112,93,0,93,3
2020-05-20,Nevada,057,99092,42,41,1,42,1
2020-05-20,Orange,059,3164182,7157,4866,56,4922,96
2020-05-20,Placer,061,380077,206,176,0,176,8
2020-05-20,Plumas,063,18699,4,4,0,4,0
2020-05-20,Riverside,065,2383286,7392,6090,20,6110,265
2020-05-20,Sacramento,067,1510023,1334,1244,1,1245,56
2020-05-20,San Benito,069,59416,76,61,0,61,2
2020-05-20,San Bernardino,071,2135413,4972,3771,4,3775,161
2020-05-20,San Diego,073,3302833,7222,6142,0,6142,230
2020-05-20,San Francisco,075,870044,2425,2199,0,2199,37
2020-05-20,San Joaquin,077,732212,847,713,3,716,33
2020-05-20,San Luis Obispo,079,281455,327,249,3,252,1
2020-05-20,San Mateo,081,765935,2059,1739,2,1741,74
2020-05-20,Santa Barbara,083,443738,1620,1524,11,1535,10
2020-05-20,Santa Clara,085,1922200,3206,2508,11,2519,138
2020-05-20,Santa Cruz,087,273765,200,163,0,163,3
2020-05-20,Shasta,089,179085,51,34,0,34,4
2020-05-20,Sierra,091,2930,1,0,0,0,0
2020-05-20,Siskiyou,093,43540,7,6,0,6,0
2020-05-20,Solano,095,438530,519,418,0,418,4
2020-05-20,Sonoma,097,501317,508,411,0,411,4
2020-05-20,Stanislaus,099,539301,684,584,4,588,25
2020-05-20,Sutter,101,95872,43,38,0,38,2
2020-05-20,Tehama,103,63373,4,2,0,2,1
2020-05-20,Trinity,105,12862,4,1,1,2,0
2020-05-20,Tulare,107,460477,2165,1585,8,1593,71
2020-05-20,Tuolumne,109,53932,3,2,0,2,0
2020-05-20,Ventura,111,848112,1335,879,8,887,29
2020-05-20,Yolo,113,214977,211,184,0,184,22
2020-05-20,Yuba,115,75493,26,23,0,23,1
2020-05-19,Alameda,001,1643700,3056,2493,3,2496,88
2020-05-19,Alpine,003,1148,1,1,0,1,0
2020-05-19,Amador,005,37829,10,9,0,9,0
2020-05-19,Butte,007,227075,52,25,1,26,0
2020-05-19,Calaveras,009,45235,15,13,0,13,0
2020-05-19,Colusa,011,21464,5,3,0,3,0
2020-05-19,Contra Costa,013,1133247,1401,1205,1,1206,33
2020-05-19,Del Norte,015,27424,28,8,0,8,0
2020-05-19,El Dorado,017,186661,91,67,0,67,0
2020-05-19,Fresno,019,978130,2476,1288,37,1325,15
2020-05-19,Glenn,021,27897,13,12,0,12,0
2020-05-19,Humboldt,023,135768,101,72,0,72,0
2020-05-19,Imperial,025,180216,2048,1012,4,1016,14
2020-05-19,Inyo,027,18085,19,20,0,20,1
2020-05-19,Kern,029,883053,2102,1601,3,1604,26
2020-05-19,Kings,031,150075,582,393,2,395,2
2020-05-19,Lake,033,64148,14,11,0,11,0
2020-05-19,Lassen,035,31185,5,0,2,2,0
2020-05-19,Los Angeles,037,10098052,49207,39670,19,39689,1906
2020-05-19,Madera,039,155013,173,80,1,81,2
2020-05-19,Marin,041,260295,374,340,1,341,14
2020-05-19,Mariposa,043,17540,16,15,0,15,1
2020-05-19,Mendocino,045,87422,20,12,0,12,0
2020-05-19,Merced,047,269075,326,222,0,222,5
2020-05-19,Modoc,049,8938,0,0,0,0,0
2020-05-19,Mono,051,14174,36,33,0,33,1
2020-05-19,Monterey,053,433212,455,350,1,351,8
2020-05-19,Napa,055,140530,111,93,0,93,3
2020-05-19,Nevada,057,99092,42,41,1,42,1
2020-05-19,Orange,059,3164182,6963,4746,54,4800,90
2020-05-19,Placer,061,380077,204,177,0,177,8
2020-05-19,Plumas,063,18699,4,5,0,5,0
2020-05-19,Riverside,065,2383286,7232,5963,19,5982,265
2020-05-19,Sacramento,067,1510023,1320,1239,1,1240,57
2020-05-19,San Benito,069,59416,74,59,0,59,2
2020-05-19,San Bernardino,071,2135413,4822,3656,4,3660,158
2020-05-19,San Diego,073,3302833,7078,6028,0,6028,222
2020-05-19,San Francisco,075,870044,2391,2186,0,2186,37
2020-05-19,San Joaquin,077,732212,825,705,3,708,33
2020-05-19,San Luis Obispo,079,281455,327,245,3,248,1
2020-05-19,San Mateo,081,765935,2018,1704,2,1706,71
2020-05-19,Santa Barbara,083,443738,1606,1521,11,1532,10
2020-05-19,Santa Clara,085,1922200,3156,2480,11,2491,138
2020-05-19,Santa Cruz,087,273765,189,161,0,161,3
2020-05-19,Shasta,089,179085,51,34,0,34,4
2020-05-19,Sierra,091,2930,0,0,0,0,0
2020-05-19,Siskiyou,093,43540,7,6,0,6,0
2020-05-19,Solano,095,438530,505,415,0,415,4
2020-05-19,Sonoma,097,501317,497,389,0,389,4
2020-05-19,Stanislaus,099,539301,670,582,4,586,25
2020-05-19,Sutter,101,95872,43,38,0,38,2
2020-05-19,Tehama,103,63373,4,2,0,2,1
2020-05-19,Trinity,105,12862,3,1,0,1,0
2020-05-19,Tulare,107,460477,2117,1551,8,1559,68
2020-05-19,Tuolumne,109,53932,3,2,0,2,0
2020-05-19,Ventura,111,848112,1294,861,7,868,28
2020-05-19,Yolo,113,214977,209,183,0,183,22
2020-05-19,Yuba,115,75493,26,23,0,23,1
2020-05-18,Alameda,001,1643700,2983,2442,3,2445,84
2020-05-18,Alpine,003,1148,1,1,0,1,0
2020-05-18,Amador,005,37829,10,8,0,8,0
2020-05-18,Butte,007,227075,50,24,1,25,0
2020-05-18,Calaveras,009,45235,15,13,0,13,0
2020-05-18,Colusa,011,21464,5,3,0,3,0
2020-05-18,Contra Costa,013,1133247,1370,1173,1,1174,33
2020-05-18,Del Norte,015,27424,23,8,0,8,0
2020-05-18,El Dorado,017,186661,89,67,0,67,0
2020-05-18,Fresno,019,978130,2399,1244,36,1280,14
2020-05-18,Glenn,021,27897,13,11,0,11,0
2020-05-18,Humboldt,023,135768,101,70,0,70,0
2020-05-18,Imperial,025,180216,1894,767,4,771,14
2020-05-18,Inyo,027,18085,19,20,0,20,1
2020-05-18,Kern,029,883053,2053,1566,3,1569,26
2020-05-18,Kings,031,150075,551,381,2,383,2
2020-05-18,Lake,033,64148,13,9,0,9,0
2020-05-18,Lassen,035,31185,5,0,2,2,0
2020-05-18,Los Angeles,037,10098052,48179,38477,19,38496,1825
2020-05-18,Madera,039,155013,167,74,1,75,2
2020-05-18,Marin,041,260295,361,329,1,330,14
2020-05-18,Mariposa,043,17540,16,15,0,15,1
2020-05-18,Mendocino,045,87422,15,12,0,12,0
2020-05-18,Merced,047,269075,317,217,0,217,5
2020-05-18,Modoc,049,8938,0,0,0,0,0
2020-05-18,Mono,051,14174,36,33,0,33,1
2020-05-18,Monterey,053,433212,444,345,1,346,8
2020-05-18,Napa,055,140530,107,92,0,92,3
2020-05-18,Nevada,057,99092,42,41,1,42,1
2020-05-18,Orange,059,3164182,6774,4558,52,4610,88
2020-05-18,Placer,061,380077,202,176,0,176,8
2020-05-18,Plumas,063,18699,4,5,0,5,0
2020-05-18,Riverside,065,2383286,7032,5873,18,5891,253
2020-05-18,Sacramento,067,1510023,1314,1233,0,1233,57
2020-05-18,San Benito,069,59416,72,59,0,59,2
2020-05-18,San Bernardino,071,2135413,4675,3558,4,3562,156
2020-05-18,San Diego,073,3302833,6945,5948,0,5948,211
2020-05-18,San Francisco,075,870044,2368,2183,0,2183,36
2020-05-18,San Joaquin,077,732212,813,697,3,700,33
2020-05-18,San Luis Obispo,079,281455,323,243,3,246,1
2020-05-18,San Mateo,081,765935,1980,1701,2,1703,68
2020-05-18,Santa Barbara,083,443738,1595,1501,11,1512,10
2020-05-18,Santa Clara,085,1922200,3123,2468,11,2479,137
2020-05-18,Santa Cruz,087,273765,187,160,0,160,3
2020-05-18,Shasta,089,179085,50,34,0,34,4
2020-05-18,Sierra,091,2930,0,0,0,0,0
2020-05-18,Siskiyou,093,43540,7,6,0,6,0
2020-05-18,Solano,095,438530,495,398,0,398,4
2020-05-18,Sonoma,097,501317,479,387,0,387,4
2020-05-18,Stanislaus,099,539301,658,572,4,576,25
2020-05-18,Sutter,101,95872,43,38,0,38,2
2020-05-18,Tehama,103,63373,4,2,0,2,1
2020-05-18,Trinity,105,12862,3,1,0,1,0
2020-05-18,Tulare,107,460477,2073,1491,8,1499,63
2020-05-18,Tuolumne,109,53932,3,2,0,2,0
2020-05-18,Ventura,111,848112,1271,850,6,856,27
2020-05-18,Yolo,113,214977,204,183,0,183,22
2020-05-18,Yuba,115,75493,26,23,0,23,1
2020-05-17,Alameda,001,1643700,2888,2389,3,2392,83
2020-05-17,Alpine,003,1148,1,1,0,1,0
2020-05-17,Amador,005,37829,10,8,0,8,0
2020-05-17,Butte,007,227075,49,23,1,24,0
2020-05-17,Calaveras,009,45235,15,13,0,13,0
2020-05-17,Colusa,011,21464,3,3,0,3,0
2020-05-17,Contra Costa,013,1133247,1331,1155,1,1156,33
2020-05-17,Del Norte,015,27424,23,7,0,7,0
2020-05-17,El Dorado,017,186661,89,65,0,65,0
2020-05-17,Fresno,019,978130,2292,1213,33,1246,14
2020-05-17,Glenn,021,27897,13,9,0,9,0
2020-05-17,Humboldt,023,135768,94,70,0,70,0
2020-05-17,Imperial,025,180216,1746,715,4,719,14
2020-05-17,Inyo,027,18085,19,20,0,20,1
2020-05-17,Kern,029,883053,1975,1546,3,1549,26
2020-05-17,Kings,031,150075,504,356,2,358,2
2020-05-17,Lake,033,64148,13,7,0,7,0
2020-05-17,Lassen,035,31185,5,0,2,2,0
2020-05-17,Los Angeles,037,10098052,46938,37996,19,38015,1807
2020-05-17,Madera,039,155013,165,69,1,70,2
2020-05-17,Marin,041,260295,350,315,1,316,14
2020-05-17,Mariposa,043,17540,15,15,0,15,1
2020-05-17,Mendocino,045,87422,14,10,0,10,0
2020-05-17,Merced,047,269075,306,214,0,214,5
2020-05-17,Modoc,049,8938,0,0,0,0,0
2020-05-17,Mono,051,14174,36,32,0,32,1
2020-05-17,Monterey,053,433212,424,342,1,343,8
2020-05-17,Napa,055,140530,104,89,0,89,3
2020-05-17,Nevada,057,99092,42,41,1,42,1
2020-05-17,Orange,059,3164182,6595,4466,51,4517,88
2020-05-17,Placer,061,380077,197,175,0,175,8
2020-05-17,Plumas,063,18699,4,4,0,4,0
2020-05-17,Riverside,065,2383286,6859,5776,18,5794,245
2020-05-17,Sacramento,067,1510023,1303,1224,0,1224,56
2020-05-17,San Benito,069,59416,71,59,0,59,2
2020-05-17,San Bernardino,071,2135413,4525,3467,4,3471,155
2020-05-17,San Diego,073,3302833,6813,5838,0,5838,209
2020-05-17,San Francisco,075,870044,2341,2132,0,2132,36
2020-05-17,San Joaquin,077,732212,783,688,3,691,32
2020-05-17,San Luis Obispo,079,281455,321,242,3,245,1
2020-05-17,San Mateo,081,765935,1943,1680,2,1682,68
2020-05-17,Santa Barbara,083,443738,1576,1457,11,1468,10
2020-05-17,Santa Clara,085,1922200,3086,2453,11,2464,135
2020-05-17,Santa Cruz,087,273765,176,155,0,155,3
2020-05-17,Shasta,089,179085,49,34,0,34,4
2020-05-17,Sierra,091,2930,0,0,0,0,0
2020-05-17,Siskiyou,093,43540,7,6,0,6,0
2020-05-17,Solano,095,438530,483,392,0,392,4
2020-05-17,Sonoma,097,501317,458,376,0,376,4
2020-05-17,Stanislaus,099,539301,647,566,4,570,25
2020-05-17,Sutter,101,95872,42,38,0,38,2
2020-05-17,Tehama,103,63373,3,2,0,2,1
2020-05-17,Trinity,105,12862,2,1,0,1,0
2020-05-17,Tulare,107,460477,1997,1430,7,1437,63
2020-05-17,Tuolumne,109,53932,3,2,0,2,0
2020-05-17,Ventura,111,848112,1226,838,6,844,27
2020-05-17,Yolo,113,214977,202,182,0,182,22
2020-05-17,Yuba,115,75493,26,21,0,21,1
2020-05-16,Alameda,001,1643700,2838,2327,3,2330,83
2020-05-16,Alpine,003,1148,1,1,0,1,0
2020-05-16,Amador,005,37829,10,8,0,8,0
2020-05-16,Butte,007,227075,44,22,1,23,0
2020-05-16,Calaveras,009,45235,15,13,0,13,0
2020-05-16,Colusa,011,21464,3,3,0,3,0
2020-05-16,Contra Costa,013,1133247,1313,1136,1,1137,33
2020-05-16,Del Norte,015,27424,19,4,0,4,0
2020-05-16,El Dorado,017,186661,89,65,0,65,0
2020-05-16,Fresno,019,978130,2235,1177,33,1210,14
2020-05-16,Glenn,021,27897,13,9,0,9,0
2020-05-16,Humboldt,023,135768,92,69,0,69,0
2020-05-16,Imperial,025,180216,1682,712,4,716,14
2020-05-16,Inyo,027,18085,19,20,0,20,1
2020-05-16,Kern,029,883053,1939,1509,3,1512,26
2020-05-16,Kings,031,150075,494,356,2,358,2
2020-05-16,Lake,033,64148,13,7,0,7,0
2020-05-16,Lassen,035,31185,4,0,2,2,0
2020-05-16,Los Angeles,037,10098052,46364,37352,19,37371,1778
2020-05-16,Madera,039,155013,163,70,1,71,2
2020-05-16,Marin,041,260295,346,297,1,298,14
2020-05-16,Mariposa,043,17540,15,15,0,15,1
2020-05-16,Mendocino,045,87422,14,10,0,10,0
2020-05-16,Merced,047,269075,304,201,0,201,5
2020-05-16,Modoc,049,8938,0,0,0,0,0
2020-05-16,Mono,051,14174,36,32,0,32,1
2020-05-16,Monterey,053,433212,409,329,1,330,8
2020-05-16,Napa,055,140530,104,86,0,86,3
2020-05-16,Nevada,057,99092,42,41,1,42,1
2020-05-16,Orange,059,3164182,6519,4396,50,4446,87
2020-05-16,Placer,061,380077,195,174,0,174,8
2020-05-16,Plumas,063,18699,4,4,0,4,0
2020-05-16,Riverside,065,2383286,6774,5633,18,5651,243
2020-05-16,Sacramento,067,1510023,1296,1209,0,1209,55
2020-05-16,San Benito,069,59416,66,58,0,58,2
2020-05-16,San Bernardino,071,2135413,4453,3362,4,3366,155
2020-05-16,San Diego,073,3302833,6727,5664,0,5664,209
2020-05-16,San Francisco,075,870044,2318,2094,0,2094,36
2020-05-16,San Joaquin,077,732212,775,668,3,671,32
2020-05-16,San Luis Obispo,079,281455,320,240,3,243,1
2020-05-16,San Mateo,081,765935,1928,1652,2,1654,68
2020-05-16,Santa Barbara,083,443738,1565,1422,10,1432,10
2020-05-16,Santa Clara,085,1922200,3068,2420,11,2431,135
2020-05-16,Santa Cruz,087,273765,173,154,0,154,3
2020-05-16,Shasta,089,179085,49,33,0,33,4
2020-05-16,Sierra,091,2930,0,0,0,0,0
2020-05-16,Siskiyou,093,43540,7,6,0,6,0
2020-05-16,Solano,095,438530,478,392,0,392,4
2020-05-16,Sonoma,097,501317,445,356,0,356,4
2020-05-16,Stanislaus,099,539301,638,546,4,550,24
2020-05-16,Sutter,101,95872,42,35,0,35,2
2020-05-16,Tehama,103,63373,3,2,0,2,1
2020-05-16,Trinity,105,12862,2,1,0,1,0
2020-05-16,Tulare,107,460477,1979,1426,7,1433,63
2020-05-16,Tuolumne,109,53932,3,2,0,2,0
2020-05-16,Ventura,111,848112,1200,813,6,819,25
2020-05-16,Yolo,113,214977,201,181,0,181,22
2020-05-16,Yuba,115,75493,26,21,0,21,1
2020-05-15,Alameda,001,1643700,2804,2289,3,2292,83
2020-05-15,Alpine,003,1148,1,1,0,1,0
2020-05-15,Amador,005,37829,10,8,0,8,0
2020-05-15,Butte,007,227075,42,22,1,23,0
2020-05-15,Calaveras,009,45235,14,13,0,13,0
2020-05-15,Colusa,011,21464,3,3,0,3,0
2020-05-15,Contra Costa,013,1133247,1295,1106,1,1107,33
2020-05-15,Del Norte,015,27424,14,4,0,4,0
2020-05-15,El Dorado,017,186661,89,64,0,64,0
2020-05-15,Fresno,019,978130,2168,1126,33,1159,14
2020-05-15,Glenn,021,27897,13,9,0,9,0
2020-05-15,Humboldt,023,135768,91,60,0,60,0
2020-05-15,Imperial,025,180216,1598,680,0,680,14
2020-05-15,Inyo,027,18085,19,20,0,20,1
2020-05-15,Kern,029,883053,1883,1472,3,1475,25
2020-05-15,Kings,031,150075,491,347,2,349,2
2020-05-15,Lake,033,64148,13,7,0,7,0
2020-05-15,Lassen,035,31185,4,0,2,2,0
2020-05-15,Los Angeles,037,10098052,45577,36317,19,36336,1734
2020-05-15,Madera,039,155013,162,71,1,72,2
2020-05-15,Marin,041,260295,338,295,1,296,14
2020-05-15,Mariposa,043,17540,15,15,0,15,1
2020-05-15,Mendocino,045,87422,14,10,0,10,0
2020-05-15,Merced,047,269075,301,191,0,191,5
2020-05-15,Modoc,049,8938,0,0,0,0,0
2020-05-15,Mono,051,14174,36,31,0,31,1
2020-05-15,Monterey,053,433212,403,321,1,322,8
2020-05-15,Napa,055,140530,104,83,0,83,3
2020-05-15,Nevada,057,99092,42,41,1,42,1
2020-05-15,Orange,059,3164182,6346,4281,50,4331,87
2020-05-15,Placer,061,380077,193,174,0,174,8
2020-05-15,Plumas,063,18699,4,4,0,4,0
2020-05-15,Riverside,065,2383286,6660,5496,18,5514,233
2020-05-15,Sacramento,067,1510023,1286,1203,0,1203,55
2020-05-15,San Benito,069,59416,63,57,0,57,2
2020-05-15,San Bernardino,071,2135413,4375,3225,4,3229,153
2020-05-15,San Diego,073,3302833,6620,5525,0,5525,208
2020-05-15,San Francisco,075,870044,2302,2062,0,2062,36
2020-05-15,San Joaquin,077,732212,769,656,3,659,32
2020-05-15,San Luis Obispo,079,281455,318,237,3,240,1
2020-05-15,San Mateo,081,765935,1906,1612,2,1614,68
2020-05-15,Santa Barbara,083,443738,1556,1409,9,1418,10
2020-05-15,Santa Clara,085,1922200,3025,2395,10,2405,135
2020-05-15,Santa Cruz,087,273765,172,146,0,146,3
2020-05-15,Shasta,089,179085,48,33,0,33,4
2020-05-15,Sierra,091,2930,0,0,0,0,0
2020-05-15,Siskiyou,093,43540,6,5,0,5,0
2020-05-15,Solano,095,438530,474,388,0,388,4
2020-05-15,Sonoma,097,501317,437,349,0,349,4
2020-05-15,Stanislaus,099,539301,631,540,4,544,23
2020-05-15,Sutter,101,95872,41,35,0,35,2
2020-05-15,Tehama,103,63373,3,1,0,1,1
2020-05-15,Trinity,105,12862,2,1,0,1,0
2020-05-15,Tulare,107,460477,1951,1356,7,1363,61
2020-05-15,Tuolumne,109,53932,3,2,0,2,0
2020-05-15,Ventura,111,848112,1182,789,5,794,25
2020-05-15,Yolo,113,214977,200,182,0,182,22
2020-05-15,Yuba,115,75493,26,21,0,21,1
2020-05-14,Alameda,001,1643700,2712,2255,3,2258,80
2020-05-14,Alpine,003,1148,1,1,0,1,0
2020-05-14,Amador,005,37829,10,8,0,8,0
2020-05-14,Butte,007,227075,40,22,1,23,0
2020-05-14,Calaveras,009,45235,14,13,0,13,0
2020-05-14,Colusa,011,21464,3,3,0,3,0
2020-05-14,Contra Costa,013,1133247,1268,1090,1,1091,32
2020-05-14,Del Norte,015,27424,14,4,0,4,0
2020-05-14,El Dorado,017,186661,80,59,0,59,0
2020-05-14,Fresno,019,978130,2108,1038,29,1067,12
2020-05-14,Glenn,021,27897,12,8,0,8,0
2020-05-14,Humboldt,023,135768,89,59,0,59,0
2020-05-14,Imperial,025,180216,1481,652,0,652,13
2020-05-14,Inyo,027,18085,19,20,0,20,1
2020-05-14,Kern,029,883053,1841,1430,3,1433,21
2020-05-14,Kings,031,150075,475,342,2,344,1
2020-05-14,Lake,033,64148,13,7,0,7,0
2020-05-14,Lassen,035,31185,4,0,2,2,0
2020-05-14,Los Angeles,037,10098052,44402,35427,19,35446,1693
2020-05-14,Madera,039,155013,153,69,1,70,2
2020-05-14,Marin,041,260295,320,283,1,284,14
2020-05-14,Mariposa,043,17540,15,15,0,15,0
2020-05-14,Mendocino,045,87422,13,10,0,10,0
2020-05-14,Merced,047,269075,290,182,0,182,3
2020-05-14,Modoc,049,8938,0,0,0,0,0
2020-05-14,Mono,051,14174,36,31,0,31,1
2020-05-14,Monterey,053,433212,393,317,1,318,7
2020-05-14,Napa,055,140530,102,83,0,83,3
2020-05-14,Nevada,057,99092,41,41,1,42,1
2020-05-14,Orange,059,3164182,6171,4163,48,4211,83
2020-05-14,Placer,061,380077,193,172,0,172,8
2020-05-14,Plumas,063,18699,4,4,0,4,0
2020-05-14,Riverside,065,2383286,6476,5339,18,5357,224
2020-05-14,Sacramento,067,1510023,1274,1181,0,1181,55
2020-05-14,San Benito,069,59416,61,56,0,56,2
2020-05-14,San Bernardino,071,2135413,4196,3149,4,3153,149
2020-05-14,San Diego,073,3302833,6485,5393,0,5393,200
2020-05-14,San Francisco,075,870044,2269,2029,0,2029,36
2020-05-14,San Joaquin,077,732212,754,643,3,646,31
2020-05-14,San Luis Obispo,079,281455,315,236,3,239,1
2020-05-14,San Mateo,081,765935,1874,1588,2,1590,67
2020-05-14,Santa Barbara,083,443738,1544,1395,9,1404,11
2020-05-14,Santa Clara,085,1922200,3002,2380,10,2390,134
2020-05-14,Santa Cruz,087,273765,170,145,0,145,3
2020-05-14,Shasta,089,179085,48,33,0,33,4
2020-05-14,Sierra,091,2930,0,0,0,0,0
2020-05-14,Siskiyou,093,43540,6,5,0,5,0
2020-05-14,Solano,095,438530,465,372,0,372,4
2020-05-14,Sonoma,097,501317,420,333,0,333,4
2020-05-14,Stanislaus,099,539301,612,533,4,537,23
2020-05-14,Sutter,101,95872,41,34,0,34,2
2020-05-14,Tehama,103,63373,3,1,0,1,1
2020-05-14,Trinity,105,12862,2,1,0,1,0
2020-05-14,Tulare,107,460477,1912,1317,7,1324,55
2020-05-14,Tuolumne,109,53932,3,2,0,2,0
2020-05-14,Ventura,111,848112,1151,760,5,765,25
2020-05-14,Yolo,113,214977,200,180,0,180,22
2020-05-14,Yuba,115,75493,26,21,0,21,1
2020-05-13,Alameda,001,1643700,2654,2181,3,2184,78
2020-05-13,Alpine,003,1148,1,1,0,1,0
2020-05-13,Amador,005,37829,10,8,0,8,0
2020-05-13,Butte,007,227075,40,21,1,22,0
2020-05-13,Calaveras,009,45235,14,13,0,13,0
2020-05-13,Colusa,011,21464,3,3,0,3,0
2020-05-13,Contra Costa,013,1133247,1246,1082,1,1083,32
2020-05-13,Del Norte,015,27424,13,4,0,4,0
2020-05-13,El Dorado,017,186661,79,58,0,58,0
2020-05-13,Fresno,019,978130,2010,993,29,1022,10
2020-05-13,Glenn,021,27897,11,6,0,6,0
2020-05-13,Humboldt,023,135768,83,58,0,58,0
2020-05-13,Imperial,025,180216,1411,610,0,610,11
2020-05-13,Inyo,027,18085,19,20,0,20,1
2020-05-13,Kern,029,883053,1795,1390,3,1393,19
2020-05-13,Kings,031,150075,461,314,2,316,1
2020-05-13,Lake,033,64148,13,7,0,7,0
2020-05-13,Lassen,035,31185,4,0,2,2,0
2020-05-13,Los Angeles,037,10098052,43091,34574,19,34593,1643
2020-05-13,Madera,039,155013,144,69,1,70,2
2020-05-13,Marin,041,260295,307,278,1,279,14
2020-05-13,Mariposa,043,17540,15,15,0,15,0
2020-05-13,Mendocino,045,87422,13,10,0,10,0
2020-05-13,Merced,047,269075,287,176,0,176,3
2020-05-13,Modoc,049,8938,0,0,0,0,0
2020-05-13,Mono,051,14174,35,31,0,31,1
2020-05-13,Monterey,053,433212,383,309,1,310,6
2020-05-13,Napa,055,140530,102,81,0,81,3
2020-05-13,Nevada,057,99092,41,41,1,42,1
2020-05-13,Orange,059,3164182,5925,4025,46,4071,79
2020-05-13,Placer,061,380077,192,170,0,170,8
2020-05-13,Plumas,063,18699,4,4,0,4,0
2020-05-13,Riverside,065,2383286,6353,5204,18,5222,216
2020-05-13,Sacramento,067,1510023,1259,1173,0,1173,53
2020-05-13,San Benito,069,59416,61,55,0,55,2
2020-05-13,San Bernardino,071,2135413,3940,3064,3,3067,140
2020-05-13,San Diego,073,3302833,6349,5280,0,5280,194
2020-05-13,San Francisco,075,870044,2241,2004,0,2004,35
2020-05-13,San Joaquin,077,732212,733,639,3,642,31
2020-05-13,San Luis Obispo,079,281455,313,231,3,234,1
2020-05-13,San Mateo,081,765935,1842,1550,2,1552,66
2020-05-13,Santa Barbara,083,443738,1533,1382,9,1391,10
2020-05-13,Santa Clara,085,1922200,2982,2370,10,2380,132
2020-05-13,Santa Cruz,087,273765,166,142,0,142,2
2020-05-13,Shasta,089,179085,48,32,0,32,4
2020-05-13,Sierra,091,2930,0,0,0,0,0
2020-05-13,Siskiyou,093,43540,6,5,0,5,0
2020-05-13,Solano,095,438530,452,368,0,368,4
2020-05-13,Sonoma,097,501317,410,330,0,330,4
2020-05-13,Stanislaus,099,539301,603,521,4,525,15
2020-05-13,Sutter,101,95872,41,33,0,33,2
2020-05-13,Tehama,103,63373,3,1,0,1,1
2020-05-13,Trinity,105,12862,2,2,0,2,0
2020-05-13,Tulare,107,460477,1879,1283,7,1290,54
2020-05-13,Tuolumne,109,53932,3,2,0,2,0
2020-05-13,Ventura,111,848112,1120,742,5,747,25
2020-05-13,Yolo,113,214977,198,178,0,178,22
2020-05-13,Yuba,115,75493,24,19,0,19,1
2020-05-12,Alameda,001,1643700,2590,2146,3,2149,74
2020-05-12,Alpine,003,1148,1,1,0,1,0
2020-05-12,Amador,005,37829,10,8,0,8,0
2020-05-12,Butte,007,227075,38,20,1,21,0
2020-05-12,Calaveras,009,45235,13,13,0,13,0
2020-05-12,Colusa,011,21464,3,3,0,3,0
2020-05-12,Contra Costa,013,1133247,1215,1067,1,1068,32
2020-05-12,Del Norte,015,27424,10,3,0,3,0
2020-05-12,El Dorado,017,186661,76,56,0,56,0
2020-05-12,Fresno,019,978130,1926,978,27,1005,9
2020-05-12,Glenn,021,27897,10,6,0,6,0
2020-05-12,Humboldt,023,135768,80,58,0,58,0
2020-05-12,Imperial,025,180216,1281,602,0,602,9
2020-05-12,Inyo,027,18085,19,20,0,20,1
2020-05-12,Kern,029,883053,1754,1363,3,1366,18
2020-05-12,Kings,031,150075,440,302,2,304,1
2020-05-12,Lake,033,64148,13,7,0,7,0
2020-05-12,Lassen,035,31185,4,0,2,2,0
2020-05-12,Los Angeles,037,10098052,42093,33281,18,33299,1601
2020-05-12,Madera,039,155013,138,69,1,70,2
2020-05-12,Marin,041,260295,302,274,1,275,14
2020-05-12,Mariposa,043,17540,15,15,0,15,0
2020-05-12,Mendocino,045,87422,13,10,0,10,0
2020-05-12,Merced,047,269075,276,175,0,175,3
2020-05-12,Modoc,049,8938,0,0,0,0,0
2020-05-12,Mono,051,14174,35,31,0,31,1
2020-05-12,Monterey,053,433212,376,298,1,299,6
2020-05-12,Napa,055,140530,100,80,0,80,3
2020-05-12,Nevada,057,99092,41,41,1,42,1
2020-05-12,Orange,059,3164182,5742,3843,44,3887,78
2020-05-12,Placer,061,380077,191,170,0,170,8
2020-05-12,Plumas,063,18699,4,4,0,4,0
2020-05-12,Riverside,065,2383286,6230,5134,18,5152,210
2020-05-12,Sacramento,067,1510023,1239,1166,0,1166,52
2020-05-12,San Benito,069,59416,61,55,0,55,2
2020-05-12,San Bernardino,071,2135413,3788,2997,3,3000,131
2020-05-12,San Diego,073,3302833,6205,3,0,3,0
2020-05-12,San Francisco,075,870044,2206,1981,0,1981,35
2020-05-12,San Joaquin,077,732212,718,625,3,628,30
2020-05-12,San Luis Obispo,079,281455,310,226,3,229,1
2020-05-12,San Mateo,081,765935,1816,1533,2,1535,66
2020-05-12,Santa Barbara,083,443738,1502,1377,9,1386,10
2020-05-12,Santa Clara,085,1922200,2952,2362,10,2372,131
2020-05-12,Santa Cruz,087,273765,164,141,0,141,2
2020-05-12,Shasta,089,179085,47,33,0,33,4
2020-05-12,Sierra,091,2930,0,0,0,0,0
2020-05-12,Siskiyou,093,43540,6,5,0,5,0
2020-05-12,Solano,095,438530,444,361,0,361,4
2020-05-12,Sonoma,097,501317,387,308,0,308,4
2020-05-12,Stanislaus,099,539301,596,515,4,519,15
2020-05-12,Sutter,101,95872,41,33,0,33,2
2020-05-12,Tehama,103,63373,3,1,0,1,1
2020-05-12,Trinity,105,12862,2,1,0,1,0
2020-05-12,Tulare,107,460477,1847,1261,7,1268,52
2020-05-12,Tuolumne,109,53932,3,2,0,2,0
2020-05-12,Ventura,111,848112,1064,718,5,723,20
2020-05-12,Yolo,113,214977,197,176,0,176,22
2020-05-12,Yuba,115,75493,24,19,0,19,1
2020-05-11,Alameda,001,1643700,2540,2103,3,2106,71
2020-05-11,Alpine,003,1148,1,1,0,1,0
2020-05-11,Amador,005,37829,10,8,0,8,0
2020-05-11,Butte,007,227075,37,19,1,20,0
2020-05-11,Calaveras,009,45235,13,13,0,13,0
2020-05-11,Colusa,011,21464,3,3,0,3,0
2020-05-11,Contra Costa,013,1133247,1201,1052,1,1053,32
2020-05-11,Del Norte,015,27424,8,3,0,3,0
2020-05-11,El Dorado,017,186661,76,55,0,55,0
2020-05-11,Fresno,019,978130,1834,937,26,963,8
2020-05-11,Glenn,021,27897,10,6,0,6,0
2020-05-11,Humboldt,023,135768,77,56,0,56,0
2020-05-11,Imperial,025,180216,1174,562,0,562,9
2020-05-11,Inyo,027,18085,19,20,0,20,1
2020-05-11,Kern,029,883053,1702,1331,3,1334,17
2020-05-11,Kings,031,150075,417,289,1,290,1
2020-05-11,Lake,033,64148,12,7,0,7,0
2020-05-11,Lassen,035,31185,4,0,2,2,0
2020-05-11,Los Angeles,037,10098052,40912,32279,18,32297,1553
2020-05-11,Madera,039,155013,129,68,1,69,2
2020-05-11,Marin,041,260295,293,271,1,272,14
2020-05-11,Mariposa,043,17540,15,15,0,15,0
2020-05-11,Mendocino,045,87422,13,10,0,10,0
2020-05-11,Merced,047,269075,261,158,0,158,3
2020-05-11,Modoc,049,8938,0,0,0,0,0
2020-05-11,Mono,051,14174,35,30,0,30,1
2020-05-11,Monterey,053,433212,373,286,1,287,6
2020-05-11,Napa,055,140530,94,79,0,79,2
2020-05-11,Nevada,057,99092,41,41,1,42,1
2020-05-11,Orange,059,3164182,5528,3699,38,3737,77
2020-05-11,Placer,061,380077,191,170,0,170,8
2020-05-11,Plumas,063,18699,4,4,0,4,0
2020-05-11,Riverside,065,2383286,6072,5082,17,5099,203
2020-05-11,Sacramento,067,1510023,1224,1160,0,1160,52
2020-05-11,San Benito,069,59416,59,52,0,52,2
2020-05-11,San Bernardino,071,2135413,3677,2945,3,2948,124
2020-05-11,San Diego,073,3302833,6052,5067,0,5067,175
2020-05-11,San Francisco,075,870044,2161,1974,0,1974,35
2020-05-11,San Joaquin,077,732212,708,620,3,623,30
2020-05-11,San Luis Obispo,079,281455,308,224,3,227,1
2020-05-11,San Mateo,081,765935,1790,1499,2,1501,66
2020-05-11,Santa Barbara,083,443738,1491,1372,8,1380,10
2020-05-11,Santa Clara,085,1922200,2935,2340,10,2350,129
2020-05-11,Santa Cruz,087,273765,161,140,0,140,2
2020-05-11,Shasta,089,179085,47,31,0,31,4
2020-05-11,Sierra,091,2930,0,0,0,0,0
2020-05-11,Siskiyou,093,43540,6,5,0,5,0
2020-05-11,Solano,095,438530,439,354,0,354,4
2020-05-11,Sonoma,097,501317,377,303,0,303,3
2020-05-11,Stanislaus,099,539301,586,507,4,511,14
2020-05-11,Sutter,101,95872,40,32,0,32,2
2020-05-11,Tehama,103,63373,3,1,0,1,1
2020-05-11,Trinity,105,12862,2,1,0,1,0
2020-05-11,Tulare,107,460477,1798,1203,7,1210,49
2020-05-11,Tuolumne,109,53932,3,2,0,2,0
2020-05-11,Ventura,111,848112,1003,698,4,702,19
2020-05-11,Yolo,113,214977,197,174,0,174,20
2020-05-11,Yuba,115,75493,24,18,0,18,1
2020-05-10,Alameda,001,1643700,2463,2047,3,2050,71
2020-05-10,Alpine,003,1148,1,1,0,1,0
2020-05-10,Amador,005,37829,10,8,0,8,0
2020-05-10,Butte,007,227075,32,18,1,19,0
2020-05-10,Calaveras,009,45235,13,13,0,13,0
2020-05-10,Colusa,011,21464,3,3,0,3,0
2020-05-10,Contra Costa,013,1133247,1187,1046,0,1046,31
2020-05-10,Del Norte,015,27424,7,3,0,3,0
2020-05-10,El Dorado,017,186661,76,55,0,55,0
2020-05-10,Fresno,019,978130,1749,894,26,920,8
2020-05-10,Glenn,021,27897,10,6,0,6,0
2020-05-10,Humboldt,023,135768,73,56,0,56,0
2020-05-10,Imperial,025,180216,1079,509,0,509,7
2020-05-10,Inyo,027,18085,19,20,0,20,1
2020-05-10,Kern,029,883053,1651,1300,2,1302,16
2020-05-10,Kings,031,150075,404,266,1,267,1
2020-05-10,Lake,033,64148,12,7,0,7,0
2020-05-10,Lassen,035,31185,4,0,2,2,0
2020-05-10,Los Angeles,037,10098052,39651,31711,18,31729,1514
2020-05-10,Madera,039,155013,127,65,1,66,2
2020-05-10,Marin,041,260295,285,267,1,268,14
2020-05-10,Mariposa,043,17540,15,15,0,15,0
2020-05-10,Mendocino,045,87422,12,10,0,10,0
2020-05-10,Merced,047,269075,246,154,0,154,3
2020-05-10,Modoc,049,8938,0,0,0,0,0
2020-05-10,Mono,051,14174,35,27,0,27,1
2020-05-10,Monterey,053,433212,359,282,1,283,6
2020-05-10,Napa,055,140530,88,79,0,79,2
2020-05-10,Nevada,057,99092,41,41,1,42,1
2020-05-10,Orange,059,3164182,5385,3627,38,3665,76
2020-05-10,Placer,061,380077,190,168,0,168,8
2020-05-10,Plumas,063,18699,4,4,0,4,0
2020-05-10,Riverside,065,2383286,5950,4951,17,4968,193
2020-05-10,Sacramento,067,1510023,1208,1152,0,1152,52
2020-05-10,San Benito,069,59416,59,52,0,52,2
2020-05-10,San Bernardino,071,2135413,3579,2910,3,2913,121
2020-05-10,San Diego,073,3302833,5900,4928,0,4928,175
2020-05-10,San Francisco,075,870044,2143,1953,0,1953,35
2020-05-10,San Joaquin,077,732212,693,611,3,614,29
2020-05-10,San Luis Obispo,079,281455,305,218,3,221,1
2020-05-10,San Mateo,081,765935,1768,1463,2,1465,65
2020-05-10,Santa Barbara,083,443738,1480,1323,8,1331,10
2020-05-10,Santa Clara,085,1922200,2908,2331,10,2341,129
2020-05-10,Santa Cruz,087,273765,160,139,0,139,2
2020-05-10,Shasta,089,179085,47,31,0,31,4
2020-05-10,Sierra,091,2930,0,0,0,0,0
2020-05-10,Siskiyou,093,43540,5,5,0,5,0
2020-05-10,Solano,095,438530,429,322,0,322,4
2020-05-10,Sonoma,097,501317,367,290,0,290,3
2020-05-10,Stanislaus,099,539301,579,498,4,502,14
2020-05-10,Sutter,101,95872,37,31,0,31,2
2020-05-10,Tehama,103,63373,3,1,0,1,1
2020-05-10,Trinity,105,12862,2,1,0,1,0
2020-05-10,Tulare,107,460477,1727,1143,7,1150,47
2020-05-10,Tuolumne,109,53932,3,2,0,2,0
2020-05-10,Ventura,111,848112,945,690,2,692,19
2020-05-10,Yolo,113,214977,197,173,0,173,20
2020-05-10,Yuba,115,75493,23,17,0,17,1
2020-05-09,Alameda,001,1643700,2420,2011,3,2014,71
2020-05-09,Alpine,003,1148,1,1,0,1,0
2020-05-09,Amador,005,37829,9,8,0,8,0
2020-05-09,Butte,007,227075,31,18,1,19,0
2020-05-09,Calaveras,009,45235,13,13,0,13,0
2020-05-09,Colusa,011,21464,3,3,0,3,0
2020-05-09,Contra Costa,013,1133247,1173,1039,0,1039,31
2020-05-09,Del Norte,015,27424,7,3,0,3,0
2020-05-09,El Dorado,017,186661,73,54,0,54,0
2020-05-09,Fresno,019,978130,1711,861,25,886,8
2020-05-09,Glenn,021,27897,9,6,0,6,0
2020-05-09,Humboldt,023,135768,71,55,0,55,0
2020-05-09,Imperial,025,180216,1023,474,0,474,7
2020-05-09,Inyo,027,18085,19,20,0,20,1
2020-05-09,Kern,029,883053,1615,1262,1,1263,15
2020-05-09,Kings,031,150075,399,264,1,265,1
2020-05-09,Lake,033,64148,12,7,0,7,0
2020-05-09,Lassen,035,31185,4,0,2,2,0
2020-05-09,Los Angeles,037,10098052,39029,31268,18,31286,1499
2020-05-09,Madera,039,155013,126,61,1,62,2
2020-05-09,Marin,041,260295,284,261,1,262,14
2020-05-09,Mariposa,043,17540,15,15,0,15,0
2020-05-09,Mendocino,045,87422,12,10,0,10,0
2020-05-09,Merced,047,269075,242,153,0,153,3
2020-05-09,Modoc,049,8938,0,0,0,0,0
2020-05-09,Mono,051,14174,35,27,0,27,1
2020-05-09,Monterey,053,433212,352,273,0,273,6
2020-05-09,Napa,055,140530,87,78,0,78,2
2020-05-09,Nevada,057,99092,41,41,1,42,1
2020-05-09,Orange,059,3164182,5302,3506,38,3544,75
2020-05-09,Placer,061,380077,189,168,0,168,8
2020-05-09,Plumas,063,18699,4,4,0,4,0
2020-05-09,Riverside,065,2383286,5855,4871,17,4888,183
2020-05-09,Sacramento,067,1510023,1204,1150,0,1150,52
2020-05-09,San Benito,069,59416,58,52,0,52,2
2020-05-09,San Bernardino,071,2135413,3523,2825,3,2828,121
2020-05-09,San Diego,073,3302833,5788,4778,0,4778,175
2020-05-09,San Francisco,075,870044,2128,1944,0,1944,34
2020-05-09,San Joaquin,077,732212,684,605,3,608,28
2020-05-09,San Luis Obispo,079,281455,301,213,3,216,1
2020-05-09,San Mateo,081,765935,1749,1453,2,1455,65
2020-05-09,Santa Barbara,083,443738,1472,1245,8,1253,10
2020-05-09,Santa Clara,085,1922200,2894,2317,10,2327,128
2020-05-09,Santa Cruz,087,273765,159,138,0,138,2
2020-05-09,Shasta,089,179085,47,31,0,31,4
2020-05-09,Sierra,091,2930,0,0,0,0,0
2020-05-09,Siskiyou,093,43540,5,5,0,5,0
2020-05-09,Solano,095,438530,423,321,0,321,4
2020-05-09,Sonoma,097,501317,363,288,0,288,3
2020-05-09,Stanislaus,099,539301,571,491,4,495,12
2020-05-09,Sutter,101,95872,37,31,0,31,2
2020-05-09,Tehama,103,63373,2,1,0,1,1
2020-05-09,Trinity,105,12862,2,1,0,1,0
2020-05-09,Tulare,107,460477,1699,1083,7,1090,47
2020-05-09,Tuolumne,109,53932,3,2,0,2,0
2020-05-09,Ventura,111,848112,924,679,2,681,19
2020-05-09,Yolo,113,214977,197,172,0,172,18
2020-05-09,Yuba,115,75493,23,17,0,17,1
2020-05-08,Alameda,001,1643700,2377,1955,3,1958,70
2020-05-08,Alpine,003,1148,1,1,0,1,0
2020-05-08,Amador,005,37829,9,8,0,8,0
2020-05-08,Butte,007,227075,31,18,1,19,0
2020-05-08,Calaveras,009,45235,13,13,0,13,0
2020-05-08,Colusa,011,21464,3,3,0,3,0
2020-05-08,Contra Costa,013,1133247,1161,1024,0,1024,29
2020-05-08,Del Norte,015,27424,7,3,0,3,0
2020-05-08,El Dorado,017,186661,72,54,0,54,0
2020-05-08,Fresno,019,978130,1669,838,23,861,8
2020-05-08,Glenn,021,27897,8,6,0,6,0
2020-05-08,Humboldt,023,135768,68,54,0,54,0
2020-05-08,Imperial,025,180216,978,467,0,467,7
2020-05-08,Inyo,027,18085,19,20,0,20,1
2020-05-08,Kern,029,883053,1584,1214,1,1215,13
2020-05-08,Kings,031,150075,390,236,1,237,1
2020-05-08,Lake,033,64148,12,7,0,7,0
2020-05-08,Lassen,035,31185,4,0,2,2,0
2020-05-08,Los Angeles,037,10098052,38298,30357,18,30375,1447
2020-05-08,Madera,039,155013,123,57,1,58,2
2020-05-08,Marin,041,260295,284,257,1,258,14
2020-05-08,Mariposa,043,17540,15,15,0,15,0
2020-05-08,Mendocino,045,87422,12,10,0,10,0
2020-05-08,Merced,047,269075,241,151,0,151,3
2020-05-08,Modoc,049,8938,0,0,0,0,0
2020-05-08,Mono,051,14174,32,27,0,27,1
2020-05-08,Monterey,053,433212,344,265,0,265,6
2020-05-08,Napa,055,140530,86,78,0,78,2
2020-05-08,Nevada,057,99092,41,41,1,42,1
2020-05-08,Orange,059,3164182,5155,3395,38,3433,72
2020-05-08,Placer,061,380077,187,166,0,166,8
2020-05-08,Plumas,063,18699,4,4,0,4,0
2020-05-08,Riverside,065,2383286,5755,4672,16,4688,181
2020-05-08,Sacramento,067,1510023,1199,1145,0,1145,51
2020-05-08,San Benito,069,59416,58,51,0,51,2
2020-05-08,San Bernardino,071,2135413,3475,2631,3,2634,119
2020-05-08,San Diego,073,3302833,5681,4664,0,4664,169
2020-05-08,San Francisco,075,870044,2110,1890,0,1890,33
2020-05-08,San Joaquin,077,732212,677,595,3,598,28
2020-05-08,San Luis Obispo,079,281455,298,210,3,213,1
2020-05-08,San Mateo,081,765935,1664,1423,2,1425,62
2020-05-08,Santa Barbara,083,443738,1463,1054,6,1060,8
2020-05-08,Santa Clara,085,1922200,2871,2285,10,2295,128
2020-05-08,Santa Cruz,087,273765,155,137,0,137,2
2020-05-08,Shasta,089,179085,47,31,0,31,4
2020-05-08,Sierra,091,2930,0,0,0,0,0
2020-05-08,Siskiyou,093,43540,5,5,0,5,0
2020-05-08,Solano,095,438530,418,314,0,314,4
2020-05-08,Sonoma,097,501317,358,285,0,285,3
2020-05-08,Stanislaus,099,539301,557,487,4,491,12
2020-05-08,Sutter,101,95872,37,30,0,30,2
2020-05-08,Tehama,103,63373,2,1,0,1,1
2020-05-08,Trinity,105,12862,2,0,0,0,0
2020-05-08,Tulare,107,460477,1654,1050,6,1056,43
2020-05-08,Tuolumne,109,53932,3,2,0,2,0
2020-05-08,Ventura,111,848112,906,665,2,667,19
2020-05-08,Yolo,113,214977,196,172,0,172,18
2020-05-08,Yuba,115,75493,22,16,0,16,1
2020-05-07,Alameda,001,1643700,2317,1914,3,1917,68
2020-05-07,Alpine,003,1148,1,1,0,1,0
2020-05-07,Amador,005,37829,9,8,0,8,0
2020-05-07,Butte,007,227075,31,19,1,20,0
2020-05-07,Calaveras,009,45235,13,13,0,13,0
2020-05-07,Colusa,011,21464,3,3,0,3,0
2020-05-07,Contra Costa,013,1133247,1147,1005,0,1005,29
2020-05-07,Del Norte,015,27424,6,3,0,3,0
2020-05-07,El Dorado,017,186661,71,54,0,54,0
2020-05-07,Fresno,019,978130,1583,812,22,834,8
2020-05-07,Glenn,021,27897,8,5,0,5,0
2020-05-07,Humboldt,023,135768,67,54,0,54,0
2020-05-07,Imperial,025,180216,915,442,0,442,6
2020-05-07,Inyo,027,18085,19,20,0,20,1
2020-05-07,Kern,029,883053,1540,1176,1,1177,13
2020-05-07,Kings,031,150075,367,219,1,220,1
2020-05-07,Lake,033,64148,11,7,0,7,0
2020-05-07,Lassen,035,31185,4,0,2,2,0
2020-05-07,Los Angeles,037,10098052,37176,29544,18,29562,1399
2020-05-07,Madera,039,155013,119,54,1,55,2
2020-05-07,Marin,041,260295,277,252,1,253,14
2020-05-07,Mariposa,043,17540,15,15,0,15,0
2020-05-07,Mendocino,045,87422,12,10,0,10,0
2020-05-07,Merced,047,269075,233,146,0,146,3
2020-05-07,Modoc,049,8938,0,0,0,0,0
2020-05-07,Mono,051,14174,32,26,0,26,1
2020-05-07,Monterey,053,433212,336,249,0,249,6
2020-05-07,Napa,055,140530,86,78,0,78,2
2020-05-07,Nevada,057,99092,41,41,1,42,1
2020-05-07,Orange,059,3164182,4969,3283,37,3320,69
2020-05-07,Placer,061,380077,187,165,0,165,8
2020-05-07,Plumas,063,18699,4,4,0,4,0
2020-05-07,Riverside,065,2383286,5639,4608,16,4624,170
2020-05-07,Sacramento,067,1510023,1193,1139,0,1139,50
2020-05-07,San Benito,069,59416,58,50,0,50,2
2020-05-07,San Bernardino,071,2135413,3383,2522,3,2525,115
2020-05-07,San Diego,073,3302833,5524,4431,0,4431,165
2020-05-07,San Francisco,075,870044,2079,1852,0,1852,33
2020-05-07,San Joaquin,077,732212,664,583,3,586,28
2020-05-07,San Luis Obispo,079,281455,287,209,3,212,1
2020-05-07,San Mateo,081,765935,1642,1398,2,1400,58
2020-05-07,Santa Barbara,083,443738,1436,720,5,725,8
2020-05-07,Santa Clara,085,1922200,2833,2281,10,2291,127
2020-05-07,Santa Cruz,087,273765,152,136,0,136,2
2020-05-07,Shasta,089,179085,46,31,0,31,4
2020-05-07,Sierra,091,2930,0,0,0,0,0
2020-05-07,Siskiyou,093,43540,5,5,0,5,0
2020-05-07,Solano,095,438530,412,307,0,307,4
2020-05-07,Sonoma,097,501317,346,282,0,282,3
2020-05-07,Stanislaus,099,539301,548,466,4,470,10
2020-05-07,Sutter,101,95872,37,29,0,29,2
2020-05-07,Tehama,103,63373,2,1,0,1,1
2020-05-07,Trinity,105,12862,2,0,0,0,0
2020-05-07,Tulare,107,460477,1586,1001,6,1007,41
2020-05-07,Tuolumne,109,53932,3,2,0,2,0
2020-05-07,Ventura,111,848112,882,647,1,648,19
2020-05-07,Yolo,113,214977,195,172,0,172,18
2020-05-07,Yuba,115,75493,22,16,0,16,1
2020-05-06,Alameda,001,1643700,2279,1864,3,1867,67
2020-05-06,Alpine,003,1148,1,1,0,1,0
2020-05-06,Amador,005,37829,9,8,0,8,0
2020-05-06,Butte,007,227075,30,19,1,20,0
2020-05-06,Calaveras,009,45235,13,13,0,13,0
2020-05-06,Colusa,011,21464,3,3,0,3,0
2020-05-06,Contra Costa,013,1133247,1126,990,0,990,29
2020-05-06,Del Norte,015,27424,6,3,0,3,0
2020-05-06,El Dorado,017,186661,69,53,0,53,0
2020-05-06,Fresno,019,978130,1520,773,20,793,8
2020-05-06,Glenn,021,27897,8,3,0,3,0
2020-05-06,Humboldt,023,135768,66,54,0,54,0
2020-05-06,Imperial,025,180216,847,399,0,399,6
2020-05-06,Inyo,027,18085,19,20,0,20,1
2020-05-06,Kern,029,883053,1484,1112,1,1113,12
2020-05-06,Kings,031,150075,349,208,1,209,1
2020-05-06,Lake,033,64148,11,7,0,7,0
2020-05-06,Lassen,035,31185,4,0,2,2,0
2020-05-06,Los Angeles,037,10098052,36168,28687,18,28705,1347
2020-05-06,Madera,039,155013,117,55,1,56,2
2020-05-06,Marin,041,260295,270,244,1,245,14
2020-05-06,Mariposa,043,17540,15,14,0,14,0
2020-05-06,Mendocino,045,87422,12,10,0,10,0
2020-05-06,Merced,047,269075,226,140,0,140,3
2020-05-06,Modoc,049,8938,0,0,0,0,0
2020-05-06,Mono,051,14174,32,26,0,26,1
2020-05-06,Monterey,053,433212,328,246,0,246,6
2020-05-06,Napa,055,140530,85,78,0,78,2
2020-05-06,Nevada,057,99092,41,41,1,42,1
2020-05-06,Orange,059,3164182,4785,3156,36,3192,66
2020-05-06,Placer,061,380077,184,164,0,164,8
2020-05-06,Plumas,063,18699,4,4,0,4,0
2020-05-06,Riverside,065,2383286,5495,4535,16,4551,163
2020-05-06,Sacramento,067,1510023,1187,1135,0,1135,49
2020-05-06,San Benito,069,59416,57,50,0,50,2
2020-05-06,San Bernardino,071,2135413,3261,2426,2,2428,110
2020-05-06,San Diego,073,3302833,5391,4321,0,4321,158
2020-05-06,San Francisco,075,870044,2054,1804,0,1804,32
2020-05-06,San Joaquin,077,732212,651,581,3,584,28
2020-05-06,San Luis Obispo,079,281455,284,207,3,210,1
2020-05-06,San Mateo,081,765935,1611,1348,2,1350,57
2020-05-06,Santa Barbara,083,443738,1395,565,4,569,8
2020-05-06,Santa Clara,085,1922200,2816,2270,9,2279,127
2020-05-06,Santa Cruz,087,273765,149,135,0,135,2
2020-05-06,Shasta,089,179085,45,31,0,31,4
2020-05-06,Sierra,091,2930,0,0,0,0,0
2020-05-06,Siskiyou,093,43540,5,5,0,5,0
2020-05-06,Solano,095,438530,402,300,0,300,4
2020-05-06,Sonoma,097,501317,330,269,0,269,3
2020-05-06,Stanislaus,099,539301,532,434,4,438,9
2020-05-06,Sutter,101,95872,37,29,0,29,2
2020-05-06,Tehama,103,63373,2,1,0,1,1
2020-05-06,Trinity,105,12862,2,0,0,0,0
2020-05-06,Tulare,107,460477,1538,963,6,969,40
2020-05-06,Tuolumne,109,53932,3,2,0,2,0
2020-05-06,Ventura,111,848112,855,619,1,620,19
2020-05-06,Yolo,113,214977,194,172,0,172,18
2020-05-06,Yuba,115,75493,22,15,0,15,1
2020-05-05,Alameda,001,1643700,2236,1819,3,1822,67
2020-05-05,Alpine,003,1148,1,1,0,1,0
2020-05-05,Amador,005,37829,9,8,0,8,0
2020-05-05,Butte,007,227075,29,19,1,20,0
2020-05-05,Calaveras,009,45235,13,13,0,13,0
2020-05-05,Colusa,011,21464,3,3,0,3,0
2020-05-05,Contra Costa,013,1133247,1108,976,0,976,29
2020-05-05,Del Norte,015,27424,6,3,0,3,0
2020-05-05,El Dorado,017,186661,67,54,0,54,0
2020-05-05,Fresno,019,978130,1447,726,18,744,8
2020-05-05,Glenn,021,27897,8,3,0,3,0
2020-05-05,Humboldt,023,135768,63,54,0,54,0
2020-05-05,Imperial,025,180216,792,389,0,389,6
2020-05-05,Inyo,027,18085,19,20,0,20,1
2020-05-05,Kern,029,883053,1432,1084,1,1085,11
2020-05-05,Kings,031,150075,331,187,1,188,1
2020-05-05,Lake,033,64148,10,7,0,7,0
2020-05-05,Lassen,035,31185,4,0,2,2,0
2020-05-05,Los Angeles,037,10098052,35098,27867,18,27885,1289
2020-05-05,Madera,039,155013,113,53,1,54,2
2020-05-05,Marin,041,260295,264,244,1,245,14
2020-05-05,Mariposa,043,17540,15,14,0,14,0
2020-05-05,Mendocino,045,87422,12,10,0,10,0
2020-05-05,Merced,047,269075,221,141,0,141,3
2020-05-05,Modoc,049,8938,0,0,0,0,0
2020-05-05,Mono,051,14174,32,25,0,25,1
2020-05-05,Monterey,053,433212,314,240,0,240,6
2020-05-05,Napa,055,140530,85,74,0,74,2
2020-05-05,Nevada,057,99092,41,41,1,42,1
2020-05-05,Orange,059,3164182,4661,3041,36,3077,63
2020-05-05,Placer,061,380077,184,162,0,162,8
2020-05-05,Plumas,063,18699,4,4,0,4,0
2020-05-05,Riverside,065,2383286,5385,4309,16,4325,161
2020-05-05,Sacramento,067,1510023,1180,1125,0,1125,48
2020-05-05,San Benito,069,59416,56,50,0,50,2
2020-05-05,San Bernardino,071,2135413,3168,2345,2,2347,104
2020-05-05,San Diego,073,3302833,5248,4162,0,4162,150
2020-05-05,San Francisco,075,870044,2019,1779,0,1779,31
2020-05-05,San Joaquin,077,732212,642,577,3,580,26
2020-05-05,San Luis Obispo,079,281455,282,203,3,206,1
2020-05-05,San Mateo,081,765935,1579,1335,2,1337,56
2020-05-05,Santa Barbara,083,443738,1174,541,4,545,7
2020-05-05,Santa Clara,085,1922200,2770,2249,8,2257,124
2020-05-05,Santa Cruz,087,273765,146,134,0,134,2
2020-05-05,Shasta,089,179085,44,31,0,31,4
2020-05-05,Sierra,091,2930,0,0,0,0,0
2020-05-05,Siskiyou,093,43540,5,5,0,5,0
2020-05-05,Solano,095,438530,386,299,0,299,4
2020-05-05,Sonoma,097,501317,327,263,0,263,3
2020-05-05,Stanislaus,099,539301,520,430,4,434,9
2020-05-05,Sutter,101,95872,36,29,0,29,2
2020-05-05,Tehama,103,63373,2,1,0,1,1
2020-05-05,Trinity,105,12862,2,0,0,0,0
2020-05-05,Tulare,107,460477,1440,869,6,875,40
2020-05-05,Tuolumne,109,53932,3,2,0,2,0
2020-05-05,Ventura,111,848112,831,607,1,608,19
2020-05-05,Yolo,113,214977,192,171,0,171,18
2020-05-05,Yuba,115,75493,22,15,0,15,1
2020-05-04,Alameda,001,1643700,2178,1762,2,1764,65
2020-05-04,Alpine,003,1148,1,1,0,1,0
2020-05-04,Amador,005,37829,8,8,0,8,0
2020-05-04,Butte,007,227075,28,16,1,17,0
2020-05-04,Calaveras,009,45235,13,13,0,13,0
2020-05-04,Colusa,011,21464,3,3,0,3,0
2020-05-04,Contra Costa,013,1133247,1090,949,0,949,28
2020-05-04,Del Norte,015,27424,5,3,0,3,0
2020-05-04,El Dorado,017,186661,66,51,0,51,0
2020-05-04,Fresno,019,978130,1377,680,17,697,8
2020-05-04,Glenn,021,27897,8,4,0,4,0
2020-05-04,Humboldt,023,135768,61,54,0,54,0
2020-05-04,Imperial,025,180216,740,351,0,351,6
2020-05-04,Inyo,027,18085,19,20,0,20,1
2020-05-04,Kern,029,883053,1390,1047,1,1048,8
2020-05-04,Kings,031,150075,314,153,1,154,1
2020-05-04,Lake,033,64148,9,7,0,7,0
2020-05-04,Lassen,035,31185,3,0,2,2,0
2020-05-04,Los Angeles,037,10098052,33801,26243,16,26259,1235
2020-05-04,Madera,039,155013,110,52,1,53,2
2020-05-04,Marin,041,260295,259,244,1,245,13
2020-05-04,Mariposa,043,17540,15,13,0,13,0
2020-05-04,Mendocino,045,87422,12,10,0,10,0
2020-05-04,Merced,047,269075,221,138,0,138,3
2020-05-04,Modoc,049,8938,0,0,0,0,0
2020-05-04,Mono,051,14174,32,25,0,25,1
2020-05-04,Monterey,053,433212,303,237,0,237,6
2020-05-04,Napa,055,140530,85,72,0,72,2
2020-05-04,Nevada,057,99092,41,41,1,42,1
2020-05-04,Orange,059,3164182,4523,2931,33,2964,57
2020-05-04,Placer,061,380077,182,162,0,162,8
2020-05-04,Plumas,063,18699,4,4,0,4,0
2020-05-04,Riverside,065,2383286,5291,4221,16,4237,147
2020-05-04,Sacramento,067,1510023,1170,1119,0,1119,44
2020-05-04,San Benito,069,59416,54,49,0,49,2
2020-05-04,San Bernardino,071,2135413,3028,2184,2,2186,99
2020-05-04,San Diego,073,3302833,5107,4022,0,4022,144
2020-05-04,San Francisco,075,870044,1981,1760,0,1760,31
2020-05-04,San Joaquin,077,732212,628,574,3,577,26
2020-05-04,San Luis Obispo,079,281455,279,202,3,205,1
2020-05-04,San Mateo,081,765935,1554,1313,2,1315,53
2020-05-04,Santa Barbara,083,443738,927,524,4,528,7
2020-05-04,Santa Clara,085,1922200,2755,2238,8,2246,119
2020-05-04,Santa Cruz,087,273765,145,133,0,133,2
2020-05-04,Shasta,089,179085,42,31,0,31,4
2020-05-04,Sierra,091,2930,0,0,0,0,0
2020-05-04,Siskiyou,093,43540,5,5,0,5,0
2020-05-04,Solano,095,438530,372,293,0,293,4
2020-05-04,Sonoma,097,501317,313,256,0,256,4
2020-05-04,Stanislaus,099,539301,514,422,4,426,8
2020-05-04,Sutter,101,95872,33,28,0,28,2
2020-05-04,Tehama,103,63373,2,1,0,1,1
2020-05-04,Trinity,105,12862,1,0,0,0,0
2020-05-04,Tulare,107,460477,1361,760,6,766,40
2020-05-04,Tuolumne,109,53932,3,3,0,3,0
2020-05-04,Ventura,111,848112,810,590,1,591,19
2020-05-04,Yolo,113,214977,191,171,0,171,18
2020-05-04,Yuba,115,75493,19,16,0,16,1
2020-05-03,Alameda,001,1643700,2121,1731,2,1733,64
2020-05-03,Alpine,003,1148,1,1,0,1,0
2020-05-03,Amador,005,37829,8,8,0,8,0
2020-05-03,Butte,007,227075,28,17,1,18,0
2020-05-03,Calaveras,009,45235,13,13,0,13,0
2020-05-03,Colusa,011,21464,3,3,0,3,0
2020-05-03,Contra Costa,013,1133247,1074,945,0,945,28
2020-05-03,Del Norte,015,27424,5,3,0,3,0
2020-05-03,El Dorado,017,186661,64,49,0,49,0
2020-05-03,Fresno,019,978130,1285,646,15,661,8
2020-05-03,Glenn,021,27897,7,5,0,5,0
2020-05-03,Humboldt,023,135768,60,54,0,54,0
2020-05-03,Imperial,025,180216,684,351,0,351,6
2020-05-03,Inyo,027,18085,19,20,0,20,1
2020-05-03,Kern,029,883053,1335,1025,1,1026,8
2020-05-03,Kings,031,150075,294,137,1,138,1
2020-05-03,Lake,033,64148,9,7,0,7,0
2020-05-03,Lassen,035,31185,3,0,2,2,0
2020-05-03,Los Angeles,037,10098052,32816,25708,16,25724,1210
2020-05-03,Madera,039,155013,103,46,1,47,2
2020-05-03,Marin,041,260295,254,243,1,244,13
2020-05-03,Mariposa,043,17540,15,13,0,13,0
2020-05-03,Mendocino,045,87422,12,10,0,10,0
2020-05-03,Merced,047,269075,213,134,0,134,3
2020-05-03,Modoc,049,8938,0,0,0,0,0
2020-05-03,Mono,051,14174,32,25,0,25,1
2020-05-03,Monterey,053,433212,294,235,0,235,6
2020-05-03,Napa,055,140530,85,72,0,72,2
2020-05-03,Nevada,057,99092,41,41,1,42,1
2020-05-03,Orange,059,3164182,4349,2859,32,2891,55
2020-05-03,Placer,061,380077,182,161,0,161,8
2020-05-03,Plumas,063,18699,4,4,0,4,0
2020-05-03,Riverside,065,2383286,5186,4034,16,4050,139
2020-05-03,Sacramento,067,1510023,1161,1109,0,1109,43
2020-05-03,San Benito,069,59416,54,49,0,49,2
2020-05-03,San Bernardino,071,2135413,2968,2123,2,2125,99
2020-05-03,San Diego,073,3302833,4970,3929,0,3929,142
2020-05-03,San Francisco,075,870044,1952,1692,0,1692,30
2020-05-03,San Joaquin,077,732212,621,570,3,573,26
2020-05-03,San Luis Obispo,079,281455,276,200,3,203,1
2020-05-03,San Mateo,081,765935,1526,1277,2,1279,53
2020-05-03,Santa Barbara,083,443738,568,512,4,516,7
2020-05-03,Santa Clara,085,1922200,2718,2235,8,2243,116
2020-05-03,Santa Cruz,087,273765,145,133,0,133,2
2020-05-03,Shasta,089,179085,40,31,0,31,4
2020-05-03,Sierra,091,2930,0,0,0,0,0
2020-05-03,Siskiyou,093,43540,5,5,0,5,0
2020-05-03,Solano,095,438530,362,266,0,266,4
2020-05-03,Sonoma,097,501317,304,254,0,254,4
2020-05-03,Stanislaus,099,539301,486,411,4,415,8
2020-05-03,Sutter,101,95872,31,28,0,28,2
2020-05-03,Tehama,103,63373,2,1,0,1,1
2020-05-03,Trinity,105,12862,1,0,0,0,0
2020-05-03,Tulare,107,460477,1282,736,6,742,40
2020-05-03,Tuolumne,109,53932,3,3,0,3,0
2020-05-03,Ventura,111,848112,776,583,1,584,19
2020-05-03,Yolo,113,214977,190,171,0,171,18
2020-05-03,Yuba,115,75493,19,16,0,16,1
2020-05-02,Alameda,001,1643700,2084,1678,2,1680,63
2020-05-02,Alpine,003,1148,1,1,0,1,0
2020-05-02,Amador,005,37829,8,8,0,8,0
2020-05-02,Butte,007,227075,28,17,1,18,0
2020-05-02,Calaveras,009,45235,13,13,0,13,0
2020-05-02,Colusa,011,21464,3,3,0,3,0
2020-05-02,Contra Costa,013,1133247,1056,929,0,929,28
2020-05-02,Del Norte,015,27424,5,3,0,3,0
2020-05-02,El Dorado,017,186661,64,47,0,47,0
2020-05-02,Fresno,019,978130,1259,629,14,643,8
2020-05-02,Glenn,021,27897,7,5,0,5,0
2020-05-02,Humboldt,023,135768,60,54,0,54,0
2020-05-02,Imperial,025,180216,657,345,0,345,6
2020-05-02,Inyo,027,18085,19,20,0,20,1
2020-05-02,Kern,029,883053,1309,1007,1,1008,8
2020-05-02,Kings,031,150075,291,120,1,121,1
2020-05-02,Lake,033,64148,9,7,0,7,0
2020-05-02,Lassen,035,31185,3,0,2,2,0
2020-05-02,Los Angeles,037,10098052,32287,24955,16,24971,1192
2020-05-02,Madera,039,155013,103,46,1,47,2
2020-05-02,Marin,041,260295,253,243,1,244,13
2020-05-02,Mariposa,043,17540,15,13,0,13,0
2020-05-02,Mendocino,045,87422,12,10,0,10,0
2020-05-02,Merced,047,269075,210,131,0,131,3
2020-05-02,Modoc,049,8938,0,0,0,0,0
2020-05-02,Mono,051,14174,32,25,0,25,1
2020-05-02,Monterey,053,433212,288,225,0,225,5
2020-05-02,Napa,055,140530,85,71,0,71,2
2020-05-02,Nevada,057,99092,41,41,1,42,1
2020-05-02,Orange,059,3164182,4235,2774,32,2806,52
2020-05-02,Placer,061,380077,180,150,0,150,8
2020-05-02,Plumas,063,18699,4,4,0,4,0
2020-05-02,Riverside,065,2383286,5120,3997,16,4013,137
2020-05-02,Sacramento,067,1510023,1158,1097,0,1097,43
2020-05-02,San Benito,069,59416,54,49,0,49,2
2020-05-02,San Bernardino,071,2135413,2929,2124,2,2126,99
2020-05-02,San Diego,073,3302833,4868,3844,0,3844,138
2020-05-02,San Francisco,075,870044,1929,1632,0,1632,29
2020-05-02,San Joaquin,077,732212,613,559,3,562,25
2020-05-02,San Luis Obispo,079,281455,270,193,3,196,1
2020-05-02,San Mateo,081,765935,1510,1272,2,1274,52
2020-05-02,Santa Barbara,083,443738,560,506,4,510,7
2020-05-02,Santa Clara,085,1922200,2708,2203,8,2211,115
2020-05-02,Santa Cruz,087,273765,144,131,0,131,2
2020-05-02,Shasta,089,179085,40,31,0,31,4
2020-05-02,Sierra,091,2930,0,0,0,0,0
2020-05-02,Siskiyou,093,43540,5,5,0,5,0
2020-05-02,Solano,095,438530,355,267,0,267,4
2020-05-02,Sonoma,097,501317,301,250,0,250,3
2020-05-02,Stanislaus,099,539301,478,388,4,392,8
2020-05-02,Sutter,101,95872,31,28,0,28,2
2020-05-02,Tehama,103,63373,2,1,0,1,1
2020-05-02,Trinity,105,12862,1,0,0,0,0
2020-05-02,Tulare,107,460477,1239,711,6,717,35
2020-05-02,Tuolumne,109,53932,3,3,0,3,0
2020-05-02,Ventura,111,848112,762,564,1,565,19
2020-05-02,Yolo,113,214977,190,169,0,169,17
2020-05-02,Yuba,115,75493,19,16,0,16,1
2020-05-01,Alameda,001,1643700,2046,1630,2,1632,63
2020-05-01,Alpine,003,1148,1,1,0,1,0
2020-05-01,Amador,005,37829,8,8,0,8,0
2020-05-01,Butte,007,227075,28,17,1,18,0
2020-05-01,Calaveras,009,45235,13,13,0,13,0
2020-05-01,Colusa,011,21464,3,3,0,3,0
2020-05-01,Contra Costa,013,1133247,1042,915,0,915,28
2020-05-01,Del Norte,015,27424,5,3,0,3,0
2020-05-01,El Dorado,017,186661,64,47,0,47,0
2020-05-01,Fresno,019,978130,1228,617,14,631,7
2020-05-01,Glenn,021,27897,7,4,0,4,0
2020-05-01,Humboldt,023,135768,60,54,0,54,0
2020-05-01,Imperial,025,180216,620,337,0,337,6
2020-05-01,Inyo,027,18085,19,20,0,20,1
2020-05-01,Kern,029,883053,1282,972,1,973,8
2020-05-01,Kings,031,150075,274,112,1,113,1
2020-05-01,Lake,033,64148,9,6,0,6,0
2020-05-01,Lassen,035,31185,3,0,2,2,0
2020-05-01,Los Angeles,037,10098052,31531,24306,16,24322,1155
2020-05-01,Madera,039,155013,99,46,1,47,2
2020-05-01,Marin,041,260295,253,242,1,243,13
2020-05-01,Mariposa,043,17540,15,10,0,10,0
2020-05-01,Mendocino,045,87422,12,11,0,11,0
2020-05-01,Merced,047,269075,207,131,0,131,3
2020-05-01,Modoc,049,8938,0,0,0,0,0
2020-05-01,Mono,051,14174,32,25,0,25,1
2020-05-01,Monterey,053,433212,284,222,0,222,5
2020-05-01,Napa,055,140530,85,69,0,69,2
2020-05-01,Nevada,057,99092,41,41,1,42,1
2020-05-01,Orange,059,3164182,4158,2660,30,2690,51
2020-05-01,Placer,061,380077,179,149,0,149,8
2020-05-01,Plumas,063,18699,4,4,0,4,0
2020-05-01,Riverside,065,2383286,5056,3893,16,3909,132
2020-05-01,Sacramento,067,1510023,1153,1081,0,1081,43
2020-05-01,San Benito,069,59416,54,49,0,49,2
2020-05-01,San Bernardino,071,2135413,2874,2084,2,2086,98
2020-05-01,San Diego,073,3302833,4777,3713,0,3713,134
2020-05-01,San Francisco,075,870044,1885,1552,0,1552,29
2020-05-01,San Joaquin,077,732212,609,554,3,557,25
2020-05-01,San Luis Obispo,079,281455,267,186,3,189,1
2020-05-01,San Mateo,081,765935,1488,1222,2,1224,52
2020-05-01,Santa Barbara,083,443738,554,499,3,502,7
2020-05-01,Santa Clara,085,1922200,2696,2176,8,2184,112
2020-05-01,Santa Cruz,087,273765,144,127,0,127,2
2020-05-01,Shasta,089,179085,40,31,0,31,4
2020-05-01,Sierra,091,2930,0,0,0,0,0
2020-05-01,Siskiyou,093,43540,5,5,0,5,0
2020-05-01,Solano,095,438530,347,266,0,266,4
2020-05-01,Sonoma,097,501317,298,242,0,242,3
2020-05-01,Stanislaus,099,539301,473,384,4,388,8
2020-05-01,Sutter,101,95872,31,28,0,28,2
2020-05-01,Tehama,103,63373,2,1,0,1,1
2020-05-01,Trinity,105,12862,1,0,0,0,0
2020-05-01,Tulare,107,460477,1195,685,6,691,32
2020-05-01,Tuolumne,109,53932,3,3,0,3,0
2020-05-01,Ventura,111,848112,749,556,1,557,18
2020-05-01,Yolo,113,214977,190,165,0,165,18
2020-05-01,Yuba,115,75493,19,16,0,16,1
2020-04-30,Alameda,001,1643700,1986,1599,2,1601,60
2020-04-30,Alpine,003,1148,1,1,0,1,0
2020-04-30,Amador,005,37829,8,8,0,8,0
2020-04-30,Butte,007,227075,28,16,1,17,0
2020-04-30,Calaveras,009,45235,13,13,0,13,0
2020-04-30,Colusa,011,21464,3,3,0,3,0
2020-04-30,Contra Costa,013,1133247,1020,900,0,900,25
2020-04-30,Del Norte,015,27424,4,3,0,3,0
2020-04-30,El Dorado,017,186661,64,44,0,44,0
2020-04-30,Fresno,019,978130,1163,562,11,573,7
2020-04-30,Glenn,021,27897,7,4,0,4,0
2020-04-30,Humboldt,023,135768,60,54,0,54,0
2020-04-30,Imperial,025,180216,574,322,0,322,6
2020-04-30,Inyo,027,18085,19,20,0,20,1
2020-04-30,Kern,029,883053,1250,941,1,942,8
2020-04-30,Kings,031,150075,262,87,1,88,1
2020-04-30,Lake,033,64148,9,6,0,6,0
2020-04-30,Lassen,035,31185,3,0,2,2,0
2020-04-30,Los Angeles,037,10098052,30521,23284,16,23300,1099
2020-04-30,Madera,039,155013,88,46,1,47,2
2020-04-30,Marin,041,260295,253,240,1,241,13
2020-04-30,Mariposa,043,17540,15,3,0,3,0
2020-04-30,Mendocino,045,87422,12,11,0,11,0
2020-04-30,Merced,047,269075,200,122,0,122,3
2020-04-30,Modoc,049,8938,0,0,0,0,0
2020-04-30,Mono,051,14174,31,25,0,25,1
2020-04-30,Monterey,053,433212,274,213,0,213,5
2020-04-30,Napa,055,140530,83,69,0,69,2
2020-04-30,Nevada,057,99092,41,41,1,42,1
2020-04-30,Orange,059,3164182,3935,2591,27,2618,46
2020-04-30,Placer,061,380077,178,148,0,148,8
2020-04-30,Plumas,063,18699,4,4,0,4,0
2020-04-30,Riverside,065,2383286,4956,3820,15,3835,124
2020-04-30,Sacramento,067,1510023,1147,1071,0,1071,43
2020-04-30,San Benito,069,59416,54,48,0,48,2
2020-04-30,San Bernardino,071,2135413,2672,2020,2,2022,96
2020-04-30,San Diego,073,3302833,4606,3566,0,3566,124
2020-04-30,San Francisco,075,870044,1851,1518,0,1518,26
2020-04-30,San Joaquin,077,732212,601,548,3,551,25
2020-04-30,San Luis Obispo,079,281455,264,182,3,185,1
2020-04-30,San Mateo,081,765935,1458,1194,2,1196,52
2020-04-30,Santa Barbara,083,443738,542,490,3,493,7
2020-04-30,Santa Clara,085,1922200,2656,2172,8,2180,111
2020-04-30,Santa Cruz,087,273765,143,126,0,126,2
2020-04-30,Shasta,089,179085,39,31,0,31,4
2020-04-30,Sierra,091,2930,0,0,0,0,0
2020-04-30,Siskiyou,093,43540,5,5,0,5,0
2020-04-30,Solano,095,438530,337,262,0,262,4
2020-04-30,Sonoma,097,501317,289,233,0,233,3
2020-04-30,Stanislaus,099,539301,466,378,4,382,7
2020-04-30,Sutter,101,95872,31,28,0,28,2
2020-04-30,Tehama,103,63373,1,1,0,1,1
2020-04-30,Trinity,105,12862,1,0,0,0,0
2020-04-30,Tulare,107,460477,1129,637,6,643,31
2020-04-30,Tuolumne,109,53932,3,3,0,3,0
2020-04-30,Ventura,111,848112,721,547,1,548,18
2020-04-30,Yolo,113,214977,189,164,0,164,16
2020-04-30,Yuba,115,75493,19,15,0,15,1
2020-04-29,Alameda,001,1643700,1928,1564,2,1566,60
2020-04-29,Alpine,003,1148,1,1,0,1,0
2020-04-29,Amador,005,37829,8,8,0,8,0
2020-04-29,Butte,007,227075,28,16,1,17,0
2020-04-29,Calaveras,009,45235,13,13,0,13,0
2020-04-29,Colusa,011,21464,3,3,0,3,0
2020-04-29,Contra Costa,013,1133247,1001,885,0,885,25
2020-04-29,Del Norte,015,27424,4,3,0,3,0
2020-04-29,El Dorado,017,186661,62,44,0,44,0
2020-04-29,Fresno,019,978130,1111,544,11,555,7
2020-04-29,Glenn,021,27897,7,4,0,4,0
2020-04-29,Humboldt,023,135768,60,53,0,53,0
2020-04-29,Imperial,025,180216,544,300,0,300,6
2020-04-29,Inyo,027,18085,19,20,0,20,1
2020-04-29,Kern,029,883053,1207,910,1,911,6
2020-04-29,Kings,031,150075,243,80,1,81,1
2020-04-29,Lake,033,64148,9,6,0,6,0
2020-04-29,Lassen,035,31185,3,0,2,2,0
2020-04-29,Los Angeles,037,10098052,29544,22560,15,22575,1043
2020-04-29,Madera,039,155013,86,45,1,46,2
2020-04-29,Marin,041,260295,250,234,1,235,13
2020-04-29,Mariposa,043,17540,15,1,0,1,0
2020-04-29,Mendocino,045,87422,12,11,0,11,0
2020-04-29,Merced,047,269075,193,116,0,116,3
2020-04-29,Modoc,049,8938,0,0,0,0,0
2020-04-29,Mono,051,14174,31,25,0,25,1
2020-04-29,Monterey,053,433212,266,204,0,204,5
2020-04-29,Napa,055,140530,81,68,0,68,2
2020-04-29,Nevada,057,99092,41,41,1,42,1
2020-04-29,Orange,059,3164182,3800,2421,26,2447,43
2020-04-29,Placer,061,380077,176,145,0,145,8
2020-04-29,Plumas,063,18699,4,4,0,4,0
2020-04-29,Riverside,065,2383286,4879,3700,15,3715,116
2020-04-29,Sacramento,067,1510023,1125,1055,0,1055,41
2020-04-29,San Benito,069,59416,54,48,0,48,2
2020-04-29,San Bernardino,071,2135413,2585,1975,1,1976,91
2020-04-29,San Diego,073,3302833,4464,3434,0,3434,120
2020-04-29,San Francisco,075,870044,1823,1489,0,1489,23
2020-04-29,San Joaquin,077,732212,593,540,3,543,25
2020-04-29,San Luis Obispo,079,281455,262,181,3,184,1
2020-04-29,San Mateo,081,765935,1432,1170,2,1172,50
2020-04-29,Santa Barbara,083,443738,529,477,3,480,7
2020-04-29,Santa Clara,085,1922200,2629,2147,8,2155,108
2020-04-29,Santa Cruz,087,273765,142,124,0,124,2
2020-04-29,Shasta,089,179085,38,31,0,31,4
2020-04-29,Sierra,091,2930,0,0,0,0,0
2020-04-29,Siskiyou,093,43540,5,5,0,5,0
2020-04-29,Solano,095,438530,313,252,0,252,3
2020-04-29,Sonoma,097,501317,281,230,0,230,2
2020-04-29,Stanislaus,099,539301,453,374,4,378,5
2020-04-29,Sutter,101,95872,31,28,0,28,2
2020-04-29,Tehama,103,63373,1,1,0,1,1
2020-04-29,Trinity,105,12862,1,0,0,0,0
2020-04-29,Tulare,107,460477,1056,615,5,620,30
2020-04-29,Tuolumne,109,53932,3,4,0,4,0
2020-04-29,Ventura,111,848112,697,530,1,531,18
2020-04-29,Yolo,113,214977,186,161,0,161,11
2020-04-29,Yuba,115,75493,19,15,0,15,1
2020-04-28,Alameda,001,1643700,1871,1525,2,1527,55
2020-04-28,Alpine,003,1148,1,1,0,1,0
2020-04-28,Amador,005,37829,8,8,0,8,0
2020-04-28,Butte,007,227075,28,16,1,17,0
2020-04-28,Calaveras,009,45235,13,13,0,13,0
2020-04-28,Colusa,011,21464,3,3,0,3,0
2020-04-28,Contra Costa,013,1133247,994,866,0,866,25
2020-04-28,Del Norte,015,27424,4,3,0,3,0
2020-04-28,El Dorado,017,186661,61,43,0,43,0
2020-04-28,Fresno,019,978130,1060,525,9,534,7
2020-04-28,Glenn,021,27897,5,4,0,4,0
2020-04-28,Humboldt,023,135768,59,53,0,53,0
2020-04-28,Imperial,025,180216,510,295,0,295,6
2020-04-28,Inyo,027,18085,19,20,0,20,1
2020-04-28,Kern,029,883053,1164,882,1,883,5
2020-04-28,Kings,031,150075,230,57,1,58,1
2020-04-28,Lake,033,64148,9,6,0,6,0
2020-04-28,Lassen,035,31185,3,0,2,2,0
2020-04-28,Los Angeles,037,10098052,28480,21029,15,21044,984
2020-04-28,Madera,039,155013,86,44,1,45,2
2020-04-28,Marin,041,260295,249,228,1,229,12
2020-04-28,Mariposa,043,17540,15,0,0,0,0
2020-04-28,Mendocino,045,87422,12,10,0,10,0
2020-04-28,Merced,047,269075,186,108,0,108,3
2020-04-28,Modoc,049,8938,0,0,0,0,0
2020-04-28,Mono,051,14174,31,25,0,25,1
2020-04-28,Monterey,053,433212,260,191,0,191,5
2020-04-28,Napa,055,140530,80,67,0,67,2
2020-04-28,Nevada,057,99092,41,41,1,42,1
2020-04-28,Orange,059,3164182,3637,2324,25,2349,42
2020-04-28,Placer,061,380077,166,143,0,143,8
2020-04-28,Plumas,063,18699,4,4,0,4,0
2020-04-28,Riverside,065,2383286,4784,3504,15,3519,113
2020-04-28,Sacramento,067,1510023,1110,1044,0,1044,41
2020-04-28,San Benito,069,59416,52,46,0,46,2
2020-04-28,San Bernardino,071,2135413,2508,1891,1,1892,89
2020-04-28,San Diego,073,3302833,4334,3316,0,3316,118
2020-04-28,San Francisco,075,870044,1788,1471,0,1471,23
2020-04-28,San Joaquin,077,732212,587,532,3,535,25
2020-04-28,San Luis Obispo,079,281455,255,172,3,175,1
2020-04-28,San Mateo,081,765935,1419,1129,2,1131,48
2020-04-28,Santa Barbara,083,443738,524,469,2,471,7
2020-04-28,Santa Clara,085,1922200,2595,2130,8,2138,106
2020-04-28,Santa Cruz,087,273765,142,123,0,123,2
2020-04-28,Shasta,089,179085,38,29,0,29,4
2020-04-28,Sierra,091,2930,0,0,0,0,0
2020-04-28,Siskiyou,093,43540,5,5,0,5,0
2020-04-28,Solano,095,438530,294,246,0,246,3
2020-04-28,Sonoma,097,501317,278,226,0,226,1
2020-04-28,Stanislaus,099,539301,437,330,4,334,5
2020-04-28,Sutter,101,95872,31,25,0,25,2
2020-04-28,Tehama,103,63373,1,1,0,1,1
2020-04-28,Trinity,105,12862,1,0,0,0,0
2020-04-28,Tulare,107,460477,960,579,5,584,30
2020-04-28,Tuolumne,109,53932,3,4,0,4,0
2020-04-28,Ventura,111,848112,677,517,1,518,17
2020-04-28,Yolo,113,214977,186,160,0,160,10
2020-04-28,Yuba,115,75493,19,15,0,15,1
2020-04-27,Alameda,001,1643700,1811,1494,2,1496,53
2020-04-27,Alpine,003,1148,1,1,0,1,0
2020-04-27,Amador,005,37829,8,8,0,8,0
2020-04-27,Butte,007,227075,27,16,1,17,0
2020-04-27,Calaveras,009,45235,13,13,0,13,0
2020-04-27,Colusa,011,21464,3,3,0,3,0
2020-04-27,Contra Costa,013,1133247,982,843,0,843,25
2020-04-27,Del Norte,015,27424,4,3,0,3,0
2020-04-27,El Dorado,017,186661,60,43,0,43,0
2020-04-27,Fresno,019,978130,957,504,8,512,7
2020-04-27,Glenn,021,27897,5,4,0,4,0
2020-04-27,Humboldt,023,135768,59,52,0,52,0
2020-04-27,Imperial,025,180216,480,290,0,290,6
2020-04-27,Inyo,027,18085,19,20,0,20,1
2020-04-27,Kern,029,883053,1125,865,1,866,4
2020-04-27,Kings,031,150075,207,48,1,49,1
2020-04-27,Lake,033,64148,8,6,0,6,0
2020-04-27,Lassen,035,31185,3,0,2,2,0
2020-04-27,Los Angeles,037,10098052,27461,20456,15,20471,931
2020-04-27,Madera,039,155013,84,42,1,43,2
2020-04-27,Marin,041,260295,244,227,1,228,12
2020-04-27,Mariposa,043,17540,14,0,0,0,0
2020-04-27,Mendocino,045,87422,12,10,0,10,0
2020-04-27,Merced,047,269075,183,108,0,108,3
2020-04-27,Modoc,049,8938,0,0,0,0,0
2020-04-27,Mono,051,14174,31,23,0,23,1
2020-04-27,Monterey,053,433212,253,185,0,185,4
2020-04-27,Napa,055,140530,77,64,0,64,2
2020-04-27,Nevada,057,99092,41,39,1,40,1
2020-04-27,Orange,059,3164182,3468,2198,25,2223,42
2020-04-27,Placer,061,380077,166,142,0,142,8
2020-04-27,Plumas,063,18699,4,4,0,4,0
2020-04-27,Riverside,065,2383286,4661,3381,15,3396,100
2020-04-27,Sacramento,067,1510023,1095,1035,0,1035,41
2020-04-27,San Benito,069,59416,50,45,0,45,2
2020-04-27,San Bernardino,071,2135413,2394,1742,1,1743,82
2020-04-27,San Diego,073,3302833,4208,3143,0,3143,113
2020-04-27,San Francisco,075,870044,1734,1453,0,1453,23
2020-04-27,San Joaquin,077,732212,581,522,3,525,25
2020-04-27,San Luis Obispo,079,281455,247,166,3,169,1
2020-04-27,San Mateo,081,765935,1397,1092,2,1094,46
2020-04-27,Santa Barbara,083,443738,516,466,2,468,7
2020-04-27,Santa Clara,085,1922200,2570,2104,7,2111,105
2020-04-27,Santa Cruz,087,273765,142,123,0,123,2
2020-04-27,Shasta,089,179085,38,29,0,29,4
2020-04-27,Sierra,091,2930,0,0,0,0,0
2020-04-27,Siskiyou,093,43540,5,5,0,5,0
2020-04-27,Solano,095,438530,294,222,0,222,3
2020-04-27,Sonoma,097,501317,269,220,0,220,1
2020-04-27,Stanislaus,099,539301,421,316,4,320,5
2020-04-27,Sutter,101,95872,29,26,0,26,2
2020-04-27,Tehama,103,63373,1,1,0,1,1
2020-04-27,Trinity,105,12862,1,0,0,0,0
2020-04-27,Tulare,107,460477,889,535,5,540,28
2020-04-27,Tuolumne,109,53932,3,3,0,3,0
2020-04-27,Ventura,111,848112,658,513,1,514,17
2020-04-27,Yolo,113,214977,183,160,0,160,9
2020-04-27,Yuba,115,75493,19,15,0,15,1
2020-04-26,Alameda,001,1643700,1750,1449,2,1451,52
2020-04-26,Alpine,003,1148,1,1,0,1,0
2020-04-26,Amador,005,37829,8,8,0,8,0
2020-04-26,Butte,007,227075,27,16,1,17,0
2020-04-26,Calaveras,009,45235,13,13,0,13,0
2020-04-26,Colusa,011,21464,3,3,0,3,0
2020-04-26,Contra Costa,013,1133247,966,830,0,830,25
2020-04-26,Del Norte,015,27424,3,3,0,3,0
2020-04-26,El Dorado,017,186661,58,41,0,41,0
2020-04-26,Fresno,019,978130,863,476,7,483,7
2020-04-26,Glenn,021,27897,5,4,0,4,0
2020-04-26,Humboldt,023,135768,59,53,0,53,0
2020-04-26,Imperial,025,180216,446,272,0,272,6
2020-04-26,Inyo,027,18085,19,20,0,20,1
2020-04-26,Kern,029,883053,1075,831,1,832,4
2020-04-26,Kings,031,150075,182,33,1,34,1
2020-04-26,Lake,033,64148,8,6,0,6,0
2020-04-26,Lassen,035,31185,3,0,2,2,0
2020-04-26,Los Angeles,037,10098052,26303,19570,15,19585,901
2020-04-26,Madera,039,155013,82,39,1,40,2
2020-04-26,Marin,041,260295,238,225,1,226,12
2020-04-26,Mariposa,043,17540,14,0,0,0,0
2020-04-26,Mendocino,045,87422,12,5,0,5,0
2020-04-26,Merced,047,269075,166,104,0,104,3
2020-04-26,Modoc,049,8938,0,0,0,0,0
2020-04-26,Mono,051,14174,31,23,0,23,1
2020-04-26,Monterey,053,433212,246,182,0,182,4
2020-04-26,Napa,055,140530,76,62,0,62,2
2020-04-26,Nevada,057,99092,41,37,1,38,1
2020-04-26,Orange,059,3164182,3303,2124,25,2149,40
2020-04-26,Placer,061,380077,165,141,0,141,8
2020-04-26,Plumas,063,18699,4,4,0,4,0
2020-04-26,Riverside,065,2383286,4518,3301,15,3316,95
2020-04-26,Sacramento,067,1510023,1086,1027,0,1027,41
2020-04-26,San Benito,069,59416,50,45,0,45,2
2020-04-26,San Bernardino,071,2135413,2298,1681,1,1682,82
2020-04-26,San Diego,073,3302833,4066,3045,0,3045,111
2020-04-26,San Francisco,075,870044,1695,1403,0,1403,23
2020-04-26,San Joaquin,077,732212,573,514,3,517,25
2020-04-26,San Luis Obispo,079,281455,244,165,3,168,1
2020-04-26,San Mateo,081,765935,1371,1070,2,1072,46
2020-04-26,Santa Barbara,083,443738,509,464,2,466,7
2020-04-26,Santa Clara,085,1922200,2547,2097,6,2103,102
2020-04-26,Santa Cruz,087,273765,142,116,0,116,2
2020-04-26,Shasta,089,179085,35,29,0,29,4
2020-04-26,Sierra,091,2930,0,0,0,0,0
2020-04-26,Siskiyou,093,43540,5,5,0,5,0
2020-04-26,Solano,095,438530,285,205,0,205,3
2020-04-26,Sonoma,097,501317,258,216,0,216,1
2020-04-26,Stanislaus,099,539301,406,294,4,298,4
2020-04-26,Sutter,101,95872,29,26,0,26,2
2020-04-26,Tehama,103,63373,1,1,0,1,1
2020-04-26,Trinity,105,12862,1,0,0,0,0
2020-04-26,Tulare,107,460477,830,497,5,502,28
2020-04-26,Tuolumne,109,53932,3,3,0,3,0
2020-04-26,Ventura,111,848112,640,509,1,510,17
2020-04-26,Yolo,113,214977,182,158,0,158,8
2020-04-26,Yuba,115,75493,18,15,0,15,1
2020-04-25,Alameda,001,1643700,1725,1396,2,1398,52
2020-04-25,Alpine,003,1148,1,1,0,1,0
2020-04-25,Amador,005,37829,8,8,0,8,0
2020-04-25,Butte,007,227075,26,16,1,17,0
2020-04-25,Calaveras,009,45235,13,12,0,12,0
2020-04-25,Colusa,011,21464,3,3,0,3,0
2020-04-25,Contra Costa,013,1133247,952,821,0,821,24
2020-04-25,Del Norte,015,27424,2,2,0,2,0
2020-04-25,El Dorado,017,186661,57,41,0,41,0
2020-04-25,Fresno,019,978130,831,459,6,465,7
2020-04-25,Glenn,021,27897,5,4,0,4,0
2020-04-25,Humboldt,023,135768,59,53,0,53,0
2020-04-25,Imperial,025,180216,429,232,0,232,6
2020-04-25,Inyo,027,18085,19,20,0,20,1
2020-04-25,Kern,029,883053,1044,802,1,803,4
2020-04-25,Kings,031,150075,170,33,1,34,1
2020-04-25,Lake,033,64148,6,6,0,6,0
2020-04-25,Lassen,035,31185,3,0,2,2,0
2020-04-25,Los Angeles,037,10098052,25670,19144,15,19159,881
2020-04-25,Madera,039,155013,79,39,1,40,2
2020-04-25,Marin,041,260295,238,215,1,216,12
2020-04-25,Mariposa,043,17540,14,0,0,0,0
2020-04-25,Mendocino,045,87422,11,5,0,5,0
2020-04-25,Merced,047,269075,166,103,0,103,3
2020-04-25,Modoc,049,8938,0,0,0,0,0
2020-04-25,Mono,051,14174,31,23,0,23,1
2020-04-25,Monterey,053,433212,244,173,0,173,4
2020-04-25,Napa,055,140530,76,60,0,60,2
2020-04-25,Nevada,057,99092,41,37,1,38,1
2020-04-25,Orange,059,3164182,3195,2047,25,2072,40
2020-04-25,Placer,061,380077,165,137,0,137,8
2020-04-25,Plumas,063,18699,4,4,0,4,0
2020-04-25,Riverside,065,2383286,4428,3037,15,3052,93
2020-04-25,Sacramento,067,1510023,1084,1015,0,1015,41
2020-04-25,San Benito,069,59416,50,45,0,45,2
2020-04-25,San Bernardino,071,2135413,2252,1675,1,1676,82
2020-04-25,San Diego,073,3302833,3965,2945,0,2945,111
2020-04-25,San Francisco,075,870044,1670,1341,0,1341,22
2020-04-25,San Joaquin,077,732212,566,497,3,500,24
2020-04-25,San Luis Obispo,079,281455,243,159,3,162,1
2020-04-25,San Mateo,081,765935,1353,1054,2,1056,46
2020-04-25,Santa Barbara,083,443738,502,457,2,459,7
2020-04-25,Santa Clara,085,1922200,2525,2045,5,2050,99
2020-04-25,Santa Cruz,087,273765,142,112,0,112,2
2020-04-25,Shasta,089,179085,35,29,0,29,4
2020-04-25,Sierra,091,2930,0,0,0,0,0
2020-04-25,Siskiyou,093,43540,5,5,0,5,0
2020-04-25,Solano,095,438530,281,203,0,203,3
2020-04-25,Sonoma,097,501317,254,199,0,199,1
2020-04-25,Stanislaus,099,539301,398,276,4,280,4
2020-04-25,Sutter,101,95872,29,24,0,24,2
2020-04-25,Tehama,103,63373,1,1,0,1,1
2020-04-25,Trinity,105,12862,0,0,0,0,0
2020-04-25,Tulare,107,460477,797,478,5,483,28
2020-04-25,Tuolumne,109,53932,3,2,0,2,0
2020-04-25,Ventura,111,848112,626,494,1,495,16
2020-04-25,Yolo,113,214977,182,157,0,157,8
2020-04-25,Yuba,115,75493,17,15,0,15,1
2020-04-24,Alameda,001,1643700,1694,1385,2,1387,50
2020-04-24,Alpine,003,1148,1,1,0,1,0
2020-04-24,Amador,005,37829,8,8,0,8,0
2020-04-24,Butte,007,227075,25,15,1,16,0
2020-04-24,Calaveras,009,45235,13,12,0,12,0
2020-04-24,Colusa,011,21464,3,3,0,3,0
2020-04-24,Contra Costa,013,1133247,943,806,0,806,23
2020-04-24,Del Norte,015,27424,2,2,0,2,0
2020-04-24,El Dorado,017,186661,56,41,0,41,0
2020-04-24,Fresno,019,978130,808,449,6,455,7
2020-04-24,Glenn,021,27897,5,4,0,4,0
2020-04-24,Humboldt,023,135768,59,53,0,53,0
2020-04-24,Imperial,025,180216,413,232,0,232,6
2020-04-24,Inyo,027,18085,19,20,0,20,0
2020-04-24,Kern,029,883053,1020,770,1,771,4
2020-04-24,Kings,031,150075,141,30,1,31,1
2020-04-24,Lake,033,64148,6,6,0,6,0
2020-04-24,Lassen,035,31185,3,0,2,2,0
2020-04-24,Los Angeles,037,10098052,24740,18553,15,18568,836
2020-04-24,Madera,039,155013,79,39,1,40,2
2020-04-24,Marin,041,260295,238,211,1,212,11
2020-04-24,Mariposa,043,17540,8,0,0,0,0
2020-04-24,Mendocino,045,87422,11,5,0,5,0
2020-04-24,Merced,047,269075,163,102,0,102,3
2020-04-24,Modoc,049,8938,0,0,0,0,0
2020-04-24,Mono,051,14174,30,23,0,23,1
2020-04-24,Monterey,053,433212,237,167,0,167,4
2020-04-24,Napa,055,140530,75,59,0,59,2
2020-04-24,Nevada,057,99092,41,36,1,37,1
2020-04-24,Orange,059,3164182,3088,1945,25,1970,39
2020-04-24,Placer,061,380077,163,137,0,137,8
2020-04-24,Plumas,063,18699,4,4,0,4,0
2020-04-24,Riverside,065,2383286,4347,3044,15,3059,87
2020-04-24,Sacramento,067,1510023,1078,1009,0,1009,41
2020-04-24,San Benito,069,59416,50,45,0,45,2
2020-04-24,San Bernardino,071,2135413,2217,1667,1,1668,80
2020-04-24,San Diego,073,3302833,3854,2828,0,2828,102
2020-04-24,San Francisco,075,870044,1612,1345,0,1345,22
2020-04-24,San Joaquin,077,732212,559,484,3,487,24
2020-04-24,San Luis Obispo,079,281455,240,151,3,154,1
2020-04-24,San Mateo,081,765935,1330,1004,2,1006,43
2020-04-24,Santa Barbara,083,443738,496,450,2,452,6
2020-04-24,Santa Clara,085,1922200,2483,2026,5,2031,98
2020-04-24,Santa Cruz,087,273765,138,111,0,111,2
2020-04-24,Shasta,089,179085,35,28,0,28,4
2020-04-24,Sierra,091,2930,0,0,0,0,0
2020-04-24,Siskiyou,093,43540,5,5,0,5,0
2020-04-24,Solano,095,438530,279,203,0,203,3
2020-04-24,Sonoma,097,501317,250,199,0,199,1
2020-04-24,Stanislaus,099,539301,395,273,4,277,4
2020-04-24,Sutter,101,95872,28,24,0,24,2
2020-04-24,Tehama,103,63373,1,1,0,1,1
2020-04-24,Trinity,105,12862,0,0,0,0,0
2020-04-24,Tulare,107,460477,769,459,5,464,27
2020-04-24,Tuolumne,109,53932,3,2,0,2,0
2020-04-24,Ventura,111,848112,616,489,1,490,16
2020-04-24,Yolo,113,214977,181,155,0,155,8
2020-04-24,Yuba,115,75493,16,15,0,15,1
2020-04-23,Alameda,001,1643700,1656,1336,2,1338,46
2020-04-23,Alpine,003,1148,1,1,0,1,0
2020-04-23,Amador,005,37829,8,8,0,8,0
2020-04-23,Butte,007,227075,25,15,1,16,0
2020-04-23,Calaveras,009,45235,13,12,0,12,0
2020-04-23,Colusa,011,21464,3,3,0,3,0
2020-04-23,Contra Costa,013,1133247,922,786,0,786,23
2020-04-23,Del Norte,015,27424,2,2,0,2,0
2020-04-23,El Dorado,017,186661,55,39,0,39,0
2020-04-23,Fresno,019,978130,770,426,6,432,7
2020-04-23,Glenn,021,27897,5,3,0,3,0
2020-04-23,Humboldt,023,135768,59,53,0,53,0
2020-04-23,Imperial,025,180216,392,181,0,181,4
2020-04-23,Inyo,027,18085,19,19,0,19,0
2020-04-23,Kern,029,883053,972,732,1,733,4
2020-04-23,Kings,031,150075,126,28,1,29,1
2020-04-23,Lake,033,64148,6,6,0,6,0
2020-04-23,Lassen,035,31185,3,0,2,2,0
2020-04-23,Los Angeles,037,10098052,23679,17548,14,17562,784
2020-04-23,Madera,039,155013,77,37,1,38,2
2020-04-23,Marin,041,260295,225,209,1,210,11
2020-04-23,Mariposa,043,17540,7,0,0,0,0
2020-04-23,Mendocino,045,87422,9,5,0,5,0
2020-04-23,Merced,047,269075,159,98,0,98,3
2020-04-23,Modoc,049,8938,0,0,0,0,0
2020-04-23,Mono,051,14174,30,23,0,23,1
2020-04-23,Monterey,053,433212,233,161,0,161,4
2020-04-23,Napa,055,140530,68,59,0,59,2
2020-04-23,Nevada,057,99092,41,36,1,37,1
2020-04-23,Orange,059,3164182,2909,1841,24,1865,37
2020-04-23,Placer,061,380077,160,136,0,136,8
2020-04-23,Plumas,063,18699,4,4,0,4,0
2020-04-23,Riverside,065,2383286,4233,2935,14,2949,78
2020-04-23,Sacramento,067,1510023,1066,978,0,978,41
2020-04-23,San Benito,069,59416,47,43,0,43,2
2020-04-23,San Bernardino,071,2135413,2152,1604,1,1605,79
2020-04-23,San Diego,073,3302833,3693,2645,0,2645,100
2020-04-23,San Francisco,075,870044,1587,1312,0,1312,21
2020-04-23,San Joaquin,077,732212,549,479,3,482,20
2020-04-23,San Luis Obispo,079,281455,236,146,3,149,1
2020-04-23,San Mateo,081,765935,1291,970,2,972,42
2020-04-23,Santa Barbara,083,443738,490,445,2,447,6
2020-04-23,Santa Clara,085,1922200,2448,1996,5,2001,95
2020-04-23,Santa Cruz,087,273765,137,110,0,110,2
2020-04-23,Shasta,089,179085,35,27,0,27,3
2020-04-23,Sierra,091,2930,0,0,0,0,0
2020-04-23,Siskiyou,093,43540,5,5,0,5,0
2020-04-23,Solano,095,438530,265,196,0,196,3
2020-04-23,Sonoma,097,501317,238,187,0,187,1
2020-04-23,Stanislaus,099,539301,391,254,4,258,4
2020-04-23,Sutter,101,95872,28,24,0,24,2
2020-04-23,Tehama,103,63373,1,1,0,1,1
2020-04-23,Trinity,105,12862,0,0,0,0,0
2020-04-23,Tulare,107,460477,740,440,5,445,25
2020-04-23,Tuolumne,109,53932,3,2,0,2,0
2020-04-23,Ventura,111,848112,602,479,1,480,16
2020-04-23,Yolo,113,214977,178,151,0,151,8
2020-04-23,Yuba,115,75493,16,15,0,15,1
2020-04-22,Alameda,001,1643700,1607,1275,2,1277,46
2020-04-22,Alpine,003,1148,1,1,0,1,0
2020-04-22,Amador,005,37829,8,7,0,7,0
2020-04-22,Butte,007,227075,24,15,1,16,0
2020-04-22,Calaveras,009,45235,13,12,0,12,0
2020-04-22,Colusa,011,21464,3,3,0,3,0
2020-04-22,Contra Costa,013,1133247,907,772,0,772,22
2020-04-22,Del Norte,015,27424,2,2,0,2,0
2020-04-22,El Dorado,017,186661,55,39,0,39,0
2020-04-22,Fresno,019,978130,730,388,6,394,7
2020-04-22,Glenn,021,27897,5,3,0,3,0
2020-04-22,Humboldt,023,135768,59,53,0,53,0
2020-04-22,Imperial,025,180216,381,170,0,170,3
2020-04-22,Inyo,027,18085,19,18,0,18,0
2020-04-22,Kern,029,883053,950,713,1,714,4
2020-04-22,Kings,031,150075,105,28,1,29,1
2020-04-22,Lake,033,64148,6,6,0,6,0
2020-04-22,Lassen,035,31185,3,0,2,2,0
2020-04-22,Los Angeles,037,10098052,22654,16400,14,16414,715
2020-04-22,Madera,039,155013,75,37,1,38,2
2020-04-22,Marin,041,260295,223,202,1,203,11
2020-04-22,Mariposa,043,17540,6,0,0,0,0
2020-04-22,Mendocino,045,87422,6,5,0,5,0
2020-04-22,Merced,047,269075,147,92,0,92,3
2020-04-22,Modoc,049,8938,0,0,0,0,0
2020-04-22,Mono,051,14174,29,23,0,23,1
2020-04-22,Monterey,053,433212,226,154,0,154,4
2020-04-22,Napa,055,140530,67,58,0,58,2
2020-04-22,Nevada,057,99092,41,36,1,37,1
2020-04-22,Orange,059,3164182,2815,1785,23,1808,36
2020-04-22,Placer,061,380077,158,133,0,133,8
2020-04-22,Plumas,063,18699,4,4,0,4,0
2020-04-22,Riverside,065,2383286,4129,2822,14,2836,76
2020-04-22,Sacramento,067,1510023,1061,959,0,959,36
2020-04-22,San Benito,069,59416,46,43,0,43,2
2020-04-22,San Bernardino,071,2135413,2089,1564,1,1565,74
2020-04-22,San Diego,073,3302833,3565,2493,0,2493,96
2020-04-22,San Francisco,075,870044,1550,1255,0,1255,21
2020-04-22,San Joaquin,077,732212,538,462,3,465,20
2020-04-22,San Luis Obispo,079,281455,227,142,3,145,1
2020-04-22,San Mateo,081,765935,1268,945,2,947,40
2020-04-22,Santa Barbara,083,443738,485,437,2,439,6
2020-04-22,Santa Clara,085,1922200,2432,1969,5,1974,95
2020-04-22,Santa Cruz,087,273765,133,106,0,106,2
2020-04-22,Shasta,089,179085,34,26,0,26,3
2020-04-22,Sierra,091,2930,0,0,0,0,0
2020-04-22,Siskiyou,093,43540,5,5,0,5,0
2020-04-22,Solano,095,438530,247,195,0,195,3
2020-04-22,Sonoma,097,501317,235,185,0,185,1
2020-04-22,Stanislaus,099,539301,334,247,4,251,4
2020-04-22,Sutter,101,95872,28,22,0,22,2
2020-04-22,Tehama,103,63373,1,1,0,1,1
2020-04-22,Trinity,105,12862,0,0,0,0,0
2020-04-22,Tulare,107,460477,706,425,5,430,23
2020-04-22,Tuolumne,109,53932,3,2,0,2,0
2020-04-22,Ventura,111,848112,591,465,1,466,15
2020-04-22,Yolo,113,214977,177,147,0,147,8
2020-04-22,Yuba,115,75493,16,15,0,15,1
2020-04-21,Alameda,001,1643700,1577,1234,2,1236,46
2020-04-21,Alpine,003,1148,1,1,0,1,0
2020-04-21,Amador,005,37829,8,7,0,7,0
2020-04-21,Butte,007,227075,23,15,1,16,0
2020-04-21,Calaveras,009,45235,12,12,0,12,0
2020-04-21,Colusa,011,21464,3,3,0,3,0
2020-04-21,Contra Costa,013,1133247,893,766,0,766,22
2020-04-21,Del Norte,015,27424,2,2,0,2,0
2020-04-21,El Dorado,017,186661,54,36,0,36,0
2020-04-21,Fresno,019,978130,696,372,6,378,7
2020-04-21,Glenn,021,27897,5,3,0,3,0
2020-04-21,Humboldt,023,135768,58,53,0,53,0
2020-04-21,Imperial,025,180216,361,165,0,165,2
2020-04-21,Inyo,027,18085,19,18,0,18,0
2020-04-21,Kern,029,883053,908,676,1,677,4
2020-04-21,Kings,031,150075,91,28,1,29,1
2020-04-21,Lake,033,64148,6,6,0,6,0
2020-04-21,Lassen,035,31185,3,0,2,2,0
2020-04-21,Los Angeles,037,10098052,21793,15096,14,15110,650
2020-04-21,Madera,039,155013,75,37,1,38,2
2020-04-21,Marin,041,260295,217,202,1,203,10
2020-04-21,Mariposa,043,17540,5,0,0,0,0
2020-04-21,Mendocino,045,87422,6,5,0,5,0
2020-04-21,Merced,047,269075,143,89,0,89,3
2020-04-21,Modoc,049,8938,0,0,0,0,0
2020-04-21,Mono,051,14174,29,23,0,23,1
2020-04-21,Monterey,053,433212,223,151,0,151,4
2020-04-21,Napa,055,140530,66,58,0,58,2
2020-04-21,Nevada,057,99092,41,36,1,37,1
2020-04-21,Orange,059,3164182,2692,1717,22,1739,36
2020-04-21,Placer,061,380077,156,133,0,133,8
2020-04-21,Plumas,063,18699,4,4,0,4,0
2020-04-21,Riverside,065,2383286,3997,2631,14,2645,68
2020-04-21,Sacramento,067,1510023,1051,941,0,941,33
2020-04-21,San Benito,069,59416,44,43,0,43,2
2020-04-21,San Bernardino,071,2135413,2029,1499,1,1500,71
2020-04-21,San Diego,073,3302833,3409,2436,0,2436,87
2020-04-21,San Francisco,075,870044,1520,1232,0,1232,20
2020-04-21,San Joaquin,077,732212,528,447,3,450,20
2020-04-21,San Luis Obispo,079,281455,219,134,3,137,1
2020-04-21,San Mateo,081,765935,1222,933,2,935,34
2020-04-21,Santa Barbara,083,443738,476,414,2,416,5
2020-04-21,Santa Clara,085,1922200,2382,1943,5,1948,91
2020-04-21,Santa Cruz,087,273765,131,104,0,104,2
2020-04-21,Shasta,089,179085,33,26,0,26,3
2020-04-21,Sierra,091,2930,0,0,0,0,0
2020-04-21,Siskiyou,093,43540,5,5,0,5,0
2020-04-21,Solano,095,438530,239,193,0,193,3
2020-04-21,Sonoma,097,501317,225,182,0,182,1
2020-04-21,Stanislaus,099,539301,315,235,4,239,4
2020-04-21,Sutter,101,95872,28,22,0,22,2
2020-04-21,Tehama,103,63373,1,1,0,1,1
2020-04-21,Trinity,105,12862,0,0,0,0,0
2020-04-21,Tulare,107,460477,669,410,5,415,23
2020-04-21,Tuolumne,109,53932,3,2,0,2,0
2020-04-21,Ventura,111,848112,579,455,1,456,14
2020-04-21,Yolo,113,214977,175,143,0,143,8
2020-04-21,Yuba,115,75493,16,15,0,15,1
2020-04-20,Alameda,001,1643700,1544,1181,2,1183,42
2020-04-20,Alpine,003,1148,1,1,0,1,0
2020-04-20,Amador,005,37829,8,7,0,7,0
2020-04-20,Butte,007,227075,23,15,1,16,0
2020-04-20,Calaveras,009,45235,12,12,0,12,0
2020-04-20,Colusa,011,21464,3,3,0,3,0
2020-04-20,Contra Costa,013,1133247,883,753,0,753,22
2020-04-20,Del Norte,015,27424,2,2,0,2,0
2020-04-20,El Dorado,017,186661,54,36,0,36,0
2020-04-20,Fresno,019,978130,678,356,6,362,7
2020-04-20,Glenn,021,27897,4,3,0,3,0
2020-04-20,Humboldt,023,135768,58,53,0,53,0
2020-04-20,Imperial,025,180216,342,149,0,149,2
2020-04-20,Inyo,027,18085,19,17,0,17,0
2020-04-20,Kern,029,883053,876,651,1,652,3
2020-04-20,Kings,031,150075,80,19,1,20,1
2020-04-20,Lake,033,64148,6,6,0,6,0
2020-04-20,Lassen,035,31185,3,0,2,2,0
2020-04-20,Los Angeles,037,10098052,20877,13787,14,13801,608
2020-04-20,Madera,039,155013,74,35,1,36,2
2020-04-20,Marin,041,260295,213,200,1,201,10
2020-04-20,Mariposa,043,17540,5,0,0,0,0
2020-04-20,Mendocino,045,87422,6,5,0,5,0
2020-04-20,Merced,047,269075,136,88,0,88,3
2020-04-20,Modoc,049,8938,0,0,0,0,0
2020-04-20,Mono,051,14174,29,23,0,23,1
2020-04-20,Monterey,053,433212,214,147,0,147,4
2020-04-20,Napa,055,140530,66,55,0,55,2
2020-04-20,Nevada,057,99092,41,34,1,35,1
2020-04-20,Orange,059,3164182,2608,1679,22,1701,33
2020-04-20,Placer,061,380077,155,132,0,132,8
2020-04-20,Plumas,063,18699,4,4,0,4,0
2020-04-20,Riverside,065,2383286,3872,2477,14,2491,61
2020-04-20,Sacramento,067,1510023,1041,924,0,924,32
2020-04-20,San Benito,069,59416,44,43,0,43,2
2020-04-20,San Bernardino,071,2135413,1942,1344,1,1345,63
2020-04-20,San Diego,073,3302833,3267,2327,0,2327,72
2020-04-20,San Francisco,075,870044,1488,1223,0,1223,19
2020-04-20,San Joaquin,077,732212,524,422,3,425,17
2020-04-20,San Luis Obispo,079,281455,205,132,3,135,1
2020-04-20,San Mateo,081,765935,1199,890,2,892,31
2020-04-20,Santa Barbara,083,443738,469,388,2,390,4
2020-04-20,Santa Clara,085,1922200,2351,1920,5,1925,84
2020-04-20,Santa Cruz,087,273765,129,102,0,102,2
2020-04-20,Shasta,089,179085,33,26,0,26,3
2020-04-20,Sierra,091,2930,0,0,0,0,0
2020-04-20,Siskiyou,093,43540,5,5,0,5,0
2020-04-20,Solano,095,438530,236,185,0,185,2
2020-04-20,Sonoma,097,501317,217,178,0,178,1
2020-04-20,Stanislaus,099,539301,301,228,4,232,3
2020-04-20,Sutter,101,95872,27,22,0,22,2
2020-04-20,Tehama,103,63373,1,1,0,1,1
2020-04-20,Trinity,105,12862,0,0,0,0,0
2020-04-20,Tulare,107,460477,659,401,5,406,20
2020-04-20,Tuolumne,109,53932,3,2,0,2,0
2020-04-20,Ventura,111,848112,565,426,1,427,13
2020-04-20,Yolo,113,214977,174,125,0,125,5
2020-04-20,Yuba,115,75493,16,15,0,15,1
2020-04-19,Alameda,001,1643700,1494,1134,2,1136,41
2020-04-19,Alpine,003,1148,1,1,0,1,0
2020-04-19,Amador,005,37829,7,7,0,7,0
2020-04-19,Butte,007,227075,22,15,1,16,0
2020-04-19,Calaveras,009,45235,12,12,0,12,0
2020-04-19,Colusa,011,21464,3,3,0,3,0
2020-04-19,Contra Costa,013,1133247,867,731,0,731,20
2020-04-19,Del Norte,015,27424,2,2,0,2,0
2020-04-19,El Dorado,017,186661,54,36,0,36,0
2020-04-19,Fresno,019,978130,642,326,6,332,7
2020-04-19,Glenn,021,27897,4,3,0,3,0
2020-04-19,Humboldt,023,135768,58,53,0,53,0
2020-04-19,Imperial,025,180216,316,144,0,144,2
2020-04-19,Inyo,027,18085,19,17,0,17,0
2020-04-19,Kern,029,883053,851,629,1,630,3
2020-04-19,Kings,031,150075,70,17,1,18,1
2020-04-19,Lake,033,64148,6,6,0,6,0
2020-04-19,Lassen,035,31185,3,0,2,2,0
2020-04-19,Los Angeles,037,10098052,19874,12299,14,12313,589
2020-04-19,Madera,039,155013,72,34,1,35,2
2020-04-19,Marin,041,260295,212,194,1,195,10
2020-04-19,Mariposa,043,17540,2,0,0,0,0
2020-04-19,Mendocino,045,87422,6,4,0,4,0
2020-04-19,Merced,047,269075,131,85,0,85,3
2020-04-19,Modoc,049,8938,0,0,0,0,0
2020-04-19,Mono,051,14174,29,23,0,23,1
2020-04-19,Monterey,053,433212,205,140,0,140,4
2020-04-19,Napa,055,140530,64,49,0,49,2
2020-04-19,Nevada,057,99092,40,34,1,35,1
2020-04-19,Orange,059,3164182,2511,1591,21,1612,32
2020-04-19,Placer,061,380077,154,131,0,131,8
2020-04-19,Plumas,063,18699,4,4,0,4,0
2020-04-19,Riverside,065,2383286,3729,2316,14,2330,56
2020-04-19,Sacramento,067,1510023,1014,912,0,912,32
2020-04-19,San Benito,069,59416,42,40,0,40,2
2020-04-19,San Bernardino,071,2135413,1879,1262,1,1263,58
2020-04-19,San Diego,073,3302833,3100,2270,0,2270,71
2020-04-19,San Francisco,075,870044,1455,1153,0,1153,19
2020-04-19,San Joaquin,077,732212,506,404,3,407,17
2020-04-19,San Luis Obispo,079,281455,200,132,3,135,1
2020-04-19,San Mateo,081,765935,1163,845,2,847,31
2020-04-19,Santa Barbara,083,443738,462,377,2,379,3
2020-04-19,Santa Clara,085,1922200,2306,1878,5,1883,81
2020-04-19,Santa Cruz,087,273765,126,98,0,98,2
2020-04-19,Shasta,089,179085,31,26,0,26,3
2020-04-19,Sierra,091,2930,0,0,0,0,0
2020-04-19,Siskiyou,093,43540,5,5,0,5,0
2020-04-19,Solano,095,438530,228,174,0,174,2
2020-04-19,Sonoma,097,501317,211,172,0,172,1
2020-04-19,Stanislaus,099,539301,293,221,4,225,3
2020-04-19,Sutter,101,95872,26,21,0,21,2
2020-04-19,Tehama,103,63373,1,1,0,1,1
2020-04-19,Trinity,105,12862,0,0,0,0,0
2020-04-19,Tulare,107,460477,613,391,5,396,17
2020-04-19,Tuolumne,109,53932,3,2,0,2,0
2020-04-19,Ventura,111,848112,557,418,1,419,13
2020-04-19,Yolo,113,214977,174,120,0,120,5
2020-04-19,Yuba,115,75493,16,15,0,15,1
2020-04-18,Alameda,001,1643700,1469,1085,2,1087,40
2020-04-18,Alpine,003,1148,1,1,0,1,0
2020-04-18,Amador,005,37829,7,7,0,7,0
2020-04-18,Butte,007,227075,21,15,1,16,0
2020-04-18,Calaveras,009,45235,12,12,0,12,0
2020-04-18,Colusa,011,21464,3,3,0,3,0
2020-04-18,Contra Costa,013,1133247,855,721,0,721,17
2020-04-18,Del Norte,015,27424,2,2,0,2,0
2020-04-18,El Dorado,017,186661,54,36,0,36,0
2020-04-18,Fresno,019,978130,622,319,6,325,7
2020-04-18,Glenn,021,27897,4,3,0,3,0
2020-04-18,Humboldt,023,135768,58,52,0,52,0
2020-04-18,Imperial,025,180216,307,137,0,137,2
2020-04-18,Inyo,027,18085,19,17,0,17,0
2020-04-18,Kern,029,883053,829,626,1,627,3
2020-04-18,Kings,031,150075,69,17,1,18,1
2020-04-18,Lake,033,64148,6,6,0,6,0
2020-04-18,Lassen,035,31185,3,0,2,2,0
2020-04-18,Los Angeles,037,10098052,19344,11984,14,11998,566
2020-04-18,Madera,039,155013,71,34,1,35,2
2020-04-18,Marin,041,260295,210,193,1,194,10
2020-04-18,Mariposa,043,17540,2,0,0,0,0
2020-04-18,Mendocino,045,87422,6,4,0,4,0
2020-04-18,Merced,047,269075,129,82,0,82,3
2020-04-18,Modoc,049,8938,0,0,0,0,0
2020-04-18,Mono,051,14174,29,22,0,22,1
2020-04-18,Monterey,053,433212,201,135,0,135,3
2020-04-18,Napa,055,140530,64,49,0,49,2
2020-04-18,Nevada,057,99092,39,34,1,35,1
2020-04-18,Orange,059,3164182,2447,1569,20,1589,32
2020-04-18,Placer,061,380077,152,130,0,130,8
2020-04-18,Plumas,063,18699,4,4,0,4,0
2020-04-18,Riverside,065,2383286,3654,2257,14,2271,56
2020-04-18,Sacramento,067,1510023,1002,901,0,901,32
2020-04-18,San Benito,069,59416,42,40,0,40,2
2020-04-18,San Bernardino,071,2135413,1834,1255,1,1256,58
2020-04-18,San Diego,073,3302833,2998,2215,0,2215,71
2020-04-18,San Francisco,075,870044,1416,1144,0,1144,19
2020-04-18,San Joaquin,077,732212,497,392,3,395,17
2020-04-18,San Luis Obispo,079,281455,196,129,3,132,1
2020-04-18,San Mateo,081,765935,1141,821,2,823,31
2020-04-18,Santa Barbara,083,443738,456,372,2,374,3
2020-04-18,Santa Clara,085,1922200,2273,1862,5,1867,79
2020-04-18,Santa Cruz,087,273765,124,96,0,96,2
2020-04-18,Shasta,089,179085,31,26,0,26,3
2020-04-18,Sierra,091,2930,0,0,0,0,0
2020-04-18,Siskiyou,093,43540,5,5,0,5,0
2020-04-18,Solano,095,438530,225,175,0,175,2
2020-04-18,Sonoma,097,501317,207,168,0,168,1
2020-04-18,Stanislaus,099,539301,285,216,4,220,3
2020-04-18,Sutter,101,95872,26,21,0,21,2
2020-04-18,Tehama,103,63373,1,1,0,1,1
2020-04-18,Trinity,105,12862,0,0,0,0,0
2020-04-18,Tulare,107,460477,602,385,5,390,17
2020-04-18,Tuolumne,109,53932,3,2,0,2,0
2020-04-18,Ventura,111,848112,549,416,1,417,13
2020-04-18,Yolo,113,214977,172,118,0,118,5
2020-04-18,Yuba,115,75493,16,14,0,14,1
2020-04-17,Alameda,001,1643700,1413,1043,1,1044,40
2020-04-17,Alpine,003,1148,1,1,0,1,0
2020-04-17,Amador,005,37829,7,7,0,7,0
2020-04-17,Butte,007,227075,21,15,1,16,0
2020-04-17,Calaveras,009,45235,12,11,0,11,0
2020-04-17,Colusa,011,21464,3,3,0,3,0
2020-04-17,Contra Costa,013,1133247,844,687,0,687,15
2020-04-17,Del Norte,015,27424,2,2,0,2,0
2020-04-17,El Dorado,017,186661,54,35,0,35,0
2020-04-17,Fresno,019,978130,600,315,6,321,7
2020-04-17,Glenn,021,27897,4,3,0,3,0
2020-04-17,Humboldt,023,135768,57,52,0,52,0
2020-04-17,Imperial,025,180216,298,135,0,135,2
2020-04-17,Inyo,027,18085,19,17,0,17,0
2020-04-17,Kern,029,883053,809,612,1,613,3
2020-04-17,Kings,031,150075,67,15,1,16,1
2020-04-17,Lake,033,64148,6,6,0,6,0
2020-04-17,Lassen,035,31185,3,0,2,2,0
2020-04-17,Los Angeles,037,10098052,18705,11354,14,11368,489
2020-04-17,Madera,039,155013,71,34,1,35,2
2020-04-17,Marin,041,260295,207,189,1,190,10
2020-04-17,Mariposa,043,17540,1,0,0,0,0
2020-04-17,Mendocino,045,87422,6,4,0,4,0
2020-04-17,Merced,047,269075,128,80,0,80,3
2020-04-17,Modoc,049,8938,0,0,0,0,0
2020-04-17,Mono,051,14174,29,22,0,22,1
2020-04-17,Monterey,053,433212,196,119,0,119,3
2020-04-17,Napa,055,140530,62,46,0,46,2
2020-04-17,Nevada,057,99092,38,34,1,35,1
2020-04-17,Orange,059,3164182,2396,1496,20,1516,31
2020-04-17,Placer,061,380077,152,130,0,130,8
2020-04-17,Plumas,063,18699,4,4,0,4,0
2020-04-17,Riverside,065,2383286,3527,2080,14,2094,50
2020-04-17,Sacramento,067,1510023,995,882,0,882,32
2020-04-17,San Benito,069,59416,42,38,0,38,2
2020-04-17,San Bernardino,071,2135413,1795,1229,1,1230,57
2020-04-17,San Diego,073,3302833,2908,2160,0,2160,70
2020-04-17,San Francisco,075,870044,1391,1090,0,1090,19
2020-04-17,San Joaquin,077,732212,486,356,3,359,17
2020-04-17,San Luis Obispo,079,281455,189,116,3,119,1
2020-04-17,San Mateo,081,765935,1125,768,2,770,31
2020-04-17,Santa Barbara,083,443738,451,349,2,351,3
2020-04-17,Santa Clara,085,1922200,2237,1834,5,1839,74
2020-04-17,Santa Cruz,087,273765,123,94,0,94,2
2020-04-17,Shasta,089,179085,31,26,0,26,3
2020-04-17,Sierra,091,2930,0,0,0,0,0
2020-04-17,Siskiyou,093,43540,5,5,0,5,0
2020-04-17,Solano,095,438530,224,173,0,173,2
2020-04-17,Sonoma,097,501317,204,167,0,167,1
2020-04-17,Stanislaus,099,539301,283,201,4,205,3
2020-04-17,Sutter,101,95872,26,20,0,20,2
2020-04-17,Tehama,103,63373,1,1,0,1,1
2020-04-17,Trinity,105,12862,0,0,0,0,0
2020-04-17,Tulare,107,460477,595,370,5,375,17
2020-04-17,Tuolumne,109,53932,3,2,0,2,0
2020-04-17,Ventura,111,848112,544,398,1,399,13
2020-04-17,Yolo,113,214977,171,117,0,117,5
2020-04-17,Yuba,115,75493,16,14,0,14,1
2020-04-16,Alameda,001,1643700,1379,981,1,982,39
2020-04-16,Alpine,003,1148,1,1,0,1,0
2020-04-16,Amador,005,37829,7,7,0,7,0
2020-04-16,Butte,007,227075,20,15,1,16,0
2020-04-16,Calaveras,009,45235,12,10,0,10,0
2020-04-16,Colusa,011,21464,3,3,0,3,0
2020-04-16,Contra Costa,013,1133247,830,675,0,675,14
2020-04-16,Del Norte,015,27424,2,2,0,2,0
2020-04-16,El Dorado,017,186661,53,34,0,34,0
2020-04-16,Fresno,019,978130,570,289,6,295,7
2020-04-16,Glenn,021,27897,4,3,0,3,0
2020-04-16,Humboldt,023,135768,57,47,0,47,0
2020-04-16,Imperial,025,180216,283,132,0,132,2
2020-04-16,Inyo,027,18085,17,17,0,17,0
2020-04-16,Kern,029,883053,782,587,1,588,3
2020-04-16,Kings,031,150075,63,12,1,13,1
2020-04-16,Lake,033,64148,6,6,0,6,0
2020-04-16,Lassen,035,31185,3,0,2,2,0
2020-04-16,Los Angeles,037,10098052,17813,10786,14,10800,447
2020-04-16,Madera,039,155013,69,34,1,35,2
2020-04-16,Marin,041,260295,203,170,1,171,10
2020-04-16,Mariposa,043,17540,1,1,0,1,0
2020-04-16,Mendocino,045,87422,6,4,0,4,0
2020-04-16,Merced,047,269075,122,76,0,76,3
2020-04-16,Modoc,049,8938,0,0,0,0,0
2020-04-16,Mono,051,14174,29,22,0,22,1
2020-04-16,Monterey,053,433212,193,116,0,116,3
2020-04-16,Napa,055,140530,59,44,0,44,2
2020-04-16,Nevada,057,99092,38,34,1,35,1
2020-04-16,Orange,059,3164182,2331,1439,19,1458,28
2020-04-16,Placer,061,380077,150,129,0,129,7
2020-04-16,Plumas,063,18699,4,4,0,4,0
2020-04-16,Riverside,065,2383286,3407,1913,14,1927,45
2020-04-16,Sacramento,067,1510023,987,865,0,865,32
2020-04-16,San Benito,069,59416,42,36,0,36,2
2020-04-16,San Bernardino,071,2135413,1714,1143,0,1143,54
2020-04-16,San Diego,073,3302833,2800,2089,0,2089,63
2020-04-16,San Francisco,075,870044,1347,1039,0,1039,16
2020-04-16,San Joaquin,077,732212,471,345,3,348,17
2020-04-16,San Luis Obispo,079,281455,185,113,3,116,1
2020-04-16,San Mateo,081,765935,1096,745,2,747,29
2020-04-16,Santa Barbara,083,443738,440,331,2,333,3
2020-04-16,Santa Clara,085,1922200,2200,1789,5,1794,70
2020-04-16,Santa Cruz,087,273765,121,90,0,90,2
2020-04-16,Shasta,089,179085,31,25,0,25,3
2020-04-16,Sierra,091,2930,0,0,0,0,0
2020-04-16,Siskiyou,093,43540,5,5,0,5,0
2020-04-16,Solano,095,438530,221,162,0,162,2
2020-04-16,Sonoma,097,501317,199,145,0,145,1
2020-04-16,Stanislaus,099,539301,280,185,4,189,3
2020-04-16,Sutter,101,95872,25,21,0,21,2
2020-04-16,Tehama,103,63373,1,1,0,1,1
2020-04-16,Trinity,105,12862,0,0,0,0,0
2020-04-16,Tulare,107,460477,578,305,5,310,16
2020-04-16,Tuolumne,109,53932,3,1,0,1,0
2020-04-16,Ventura,111,848112,532,384,1,385,13
2020-04-16,Yolo,113,214977,169,98,0,98,4
2020-04-16,Yuba,115,75493,15,14,0,14,1
2020-04-15,Alameda,001,1643700,1329,915,1,916,38
2020-04-15,Alpine,003,1148,1,1,0,1,0
2020-04-15,Amador,005,37829,7,7,0,7,0
2020-04-15,Butte,007,227075,20,14,1,15,0
2020-04-15,Calaveras,009,45235,11,9,0,9,0
2020-04-15,Colusa,011,21464,3,3,0,3,0
2020-04-15,Contra Costa,013,1133247,808,645,0,645,14
2020-04-15,Del Norte,015,27424,2,2,0,2,0
2020-04-15,El Dorado,017,186661,51,33,0,33,0
2020-04-15,Fresno,019,978130,544,264,6,270,7
2020-04-15,Glenn,021,27897,4,3,0,3,0
2020-04-15,Humboldt,023,135768,57,47,0,47,0
2020-04-15,Imperial,025,180216,257,115,0,115,2
2020-04-15,Inyo,027,18085,17,12,0,12,0
2020-04-15,Kern,029,883053,760,500,1,501,3
2020-04-15,Kings,031,150075,59,12,1,13,1
2020-04-15,Lake,033,64148,6,4,0,4,0
2020-04-15,Lassen,035,31185,3,0,2,2,0
2020-04-15,Los Angeles,037,10098052,16989,10416,14,10430,394
2020-04-15,Madera,039,155013,69,30,1,31,2
2020-04-15,Marin,041,260295,200,162,1,163,10
2020-04-15,Mariposa,043,17540,0,0,0,0,0
2020-04-15,Mendocino,045,87422,5,4,0,4,0
2020-04-15,Merced,047,269075,120,74,0,74,3
2020-04-15,Modoc,049,8938,0,0,0,0,0
2020-04-15,Mono,051,14174,29,22,0,22,1
2020-04-15,Monterey,053,433212,185,106,0,106,3
2020-04-15,Napa,055,140530,56,34,0,34,2
2020-04-15,Nevada,057,99092,37,34,1,35,1
2020-04-15,Orange,059,3164182,2228,1377,19,1396,24
2020-04-15,Placer,061,380077,149,123,0,123,6
2020-04-15,Plumas,063,18699,4,4,0,4,0
2020-04-15,Riverside,065,2383286,3212,1723,14,1737,42
2020-04-15,Sacramento,067,1510023,978,839,0,839,32
2020-04-15,San Benito,069,59416,42,34,0,34,2
2020-04-15,San Bernardino,071,2135413,1644,1063,0,1063,45
2020-04-15,San Diego,073,3302833,2712,2014,0,2014,60
2020-04-15,San Francisco,075,870044,1311,1006,0,1006,16
2020-04-15,San Joaquin,077,732212,463,329,3,332,17
2020-04-15,San Luis Obispo,079,281455,177,112,3,115,1
2020-04-15,San Mateo,081,765935,1047,707,2,709,28
2020-04-15,Santa Barbara,083,443738,424,317,2,319,2
2020-04-15,Santa Clara,085,1922200,2161,1692,5,1697,69
2020-04-15,Santa Cruz,087,273765,117,92,0,92,2
2020-04-15,Shasta,089,179085,31,25,0,25,3
2020-04-15,Sierra,091,2930,0,0,0,0,0
2020-04-15,Siskiyou,093,43540,5,5,0,5,0
2020-04-15,Solano,095,438530,216,153,0,153,2
2020-04-15,Sonoma,097,501317,197,140,0,140,1
2020-04-15,Stanislaus,099,539301,273,174,4,178,3
2020-04-15,Sutter,101,95872,25,19,0,19,2
2020-04-15,Tehama,103,63373,1,1,0,1,1
2020-04-15,Trinity,105,12862,0,0,0,0,0
2020-04-15,Tulare,107,460477,560,289,5,294,14
2020-04-15,Tuolumne,109,53932,3,1,0,1,0
2020-04-15,Ventura,111,848112,517,365,1,366,13
2020-04-15,Yolo,113,214977,162,93,0,93,3
2020-04-15,Yuba,115,75493,15,15,0,15,1
2020-04-14,Alameda,001,1643700,1284,843,1,844,30
2020-04-14,Alpine,003,1148,1,1,0,1,0
2020-04-14,Amador,005,37829,7,6,0,6,0
2020-04-14,Butte,007,227075,20,13,1,14,0
2020-04-14,Calaveras,009,45235,11,5,0,5,0
2020-04-14,Colusa,011,21464,3,3,0,3,0
2020-04-14,Contra Costa,013,1133247,796,617,0,617,12
2020-04-14,Del Norte,015,27424,2,2,0,2,0
2020-04-14,El Dorado,017,186661,51,30,0,30,0
2020-04-14,Fresno,019,978130,521,244,6,250,6
2020-04-14,Glenn,021,27897,4,3,0,3,0
2020-04-14,Humboldt,023,135768,57,44,0,44,0
2020-04-14,Imperial,025,180216,237,86,0,86,2
2020-04-14,Inyo,027,18085,17,12,0,12,0
2020-04-14,Kern,029,883053,736,453,1,454,3
2020-04-14,Kings,031,150075,58,12,1,13,1
2020-04-14,Lake,033,64148,6,3,0,3,0
2020-04-14,Lassen,035,31185,3,0,2,2,0
2020-04-14,Los Angeles,037,10098052,16094,9948,13,9961,357
2020-04-14,Madera,039,155013,68,29,1,30,2
2020-04-14,Marin,041,260295,196,147,1,148,9
2020-04-14,Mariposa,043,17540,0,0,0,0,0
2020-04-14,Mendocino,045,87422,5,4,0,4,0
2020-04-14,Merced,047,269075,113,61,0,61,3
2020-04-14,Modoc,049,8938,0,0,0,0,0
2020-04-14,Mono,051,14174,29,22,0,22,1
2020-04-14,Monterey,053,433212,180,98,0,98,3
2020-04-14,Napa,055,140530,56,33,0,33,2
2020-04-14,Nevada,057,99092,37,34,1,35,1
2020-04-14,Orange,059,3164182,2126,1362,19,1381,24
2020-04-14,Placer,061,380077,148,117,0,117,5
2020-04-14,Plumas,063,18699,4,3,0,3,0
2020-04-14,Riverside,065,2383286,3077,1467,14,1481,40
2020-04-14,Sacramento,067,1510023,969,737,0,737,29
2020-04-14,San Benito,069,59416,39,34,0,34,2
2020-04-14,San Bernardino,071,2135413,1589,933,0,933,37
2020-04-14,San Diego,073,3302833,2617,1932,0,1932,53
2020-04-14,San Francisco,075,870044,1257,968,0,968,14
2020-04-14,San Joaquin,077,732212,453,280,3,283,17
2020-04-14,San Luis Obispo,079,281455,174,109,3,112,1
2020-04-14,San Mateo,081,765935,1013,681,2,683,28
2020-04-14,Santa Barbara,083,443738,400,292,2,294,2
2020-04-14,Santa Clara,085,1922200,2128,1561,5,1566,63
2020-04-14,Santa Cruz,087,273765,109,84,0,84,2
2020-04-14,Shasta,089,179085,31,24,0,24,3
2020-04-14,Sierra,091,2930,0,0,0,0,0
2020-04-14,Siskiyou,093,43540,5,5,0,5,0
2020-04-14,Solano,095,438530,213,140,0,140,2
2020-04-14,Sonoma,097,501317,193,133,0,133,1
2020-04-14,Stanislaus,099,539301,260,136,4,140,3
2020-04-14,Sutter,101,95872,24,19,0,19,2
2020-04-14,Tehama,103,63373,1,1,0,1,1
2020-04-14,Trinity,105,12862,0,0,0,0,0
2020-04-14,Tulare,107,460477,536,228,5,233,12
2020-04-14,Tuolumne,109,53932,3,0,0,0,0
2020-04-14,Ventura,111,848112,504,328,1,329,11
2020-04-14,Yolo,113,214977,159,81,0,81,3
2020-04-14,Yuba,115,75493,14,14,0,14,1
2020-04-13,Alameda,001,1643700,1245,821,1,822,23
2020-04-13,Alpine,003,1148,1,1,0,1,0
2020-04-13,Amador,005,37829,7,6,0,6,0
2020-04-13,Butte,007,227075,19,13,1,14,0
2020-04-13,Calaveras,009,45235,10,5,0,5,0
2020-04-13,Colusa,011,21464,3,3,0,3,0
2020-04-13,Contra Costa,013,1133247,780,569,0,569,12
2020-04-13,Del Norte,015,27424,2,2,0,2,0
2020-04-13,El Dorado,017,186661,49,29,0,29,0
2020-04-13,Fresno,019,978130,499,205,5,210,4
2020-04-13,Glenn,021,27897,4,3,0,3,0
2020-04-13,Humboldt,023,135768,57,44,0,44,0
2020-04-13,Imperial,025,180216,219,82,0,82,2
2020-04-13,Inyo,027,18085,17,12,0,12,0
2020-04-13,Kern,029,883053,711,346,1,347,3
2020-04-13,Kings,031,150075,54,9,1,10,0
2020-04-13,Lake,033,64148,6,3,0,3,0
2020-04-13,Lassen,035,31185,3,0,2,2,0
2020-04-13,Los Angeles,037,10098052,15376,9367,13,9380,317
2020-04-13,Madera,039,155013,66,29,1,30,2
2020-04-13,Marin,041,260295,192,144,1,145,6
2020-04-13,Mariposa,043,17540,0,0,0,0,0
2020-04-13,Mendocino,045,87422,5,4,0,4,0
2020-04-13,Merced,047,269075,112,60,0,60,3
2020-04-13,Modoc,049,8938,0,0,0,0,0
2020-04-13,Mono,051,14174,29,21,0,21,1
2020-04-13,Monterey,053,433212,173,86,0,86,3
2020-04-13,Napa,055,140530,55,30,0,30,2
2020-04-13,Nevada,057,99092,37,24,1,25,1
2020-04-13,Orange,059,3164182,2053,1313,19,1332,21
2020-04-13,Placer,061,380077,147,116,0,116,5
2020-04-13,Plumas,063,18699,4,3,0,3,0
2020-04-13,Riverside,065,2383286,2936,1460,13,1473,35
2020-04-13,Sacramento,067,1510023,957,723,0,723,25
2020-04-13,San Benito,069,59416,38,33,0,33,2
2020-04-13,San Bernardino,071,2135413,1514,920,0,920,30
2020-04-13,San Diego,073,3302833,2534,1849,0,1849,47
2020-04-13,San Francisco,075,870044,1219,948,0,948,12
2020-04-13,San Joaquin,077,732212,438,255,3,258,16
2020-04-13,San Luis Obispo,079,281455,169,106,3,109,1
2020-04-13,San Mateo,081,765935,973,679,2,681,25
2020-04-13,Santa Barbara,083,443738,381,271,1,272,2
2020-04-13,Santa Clara,085,1922200,2082,1540,5,1545,58
2020-04-13,Santa Cruz,087,273765,103,82,0,82,1
2020-04-13,Shasta,089,179085,30,24,0,24,3
2020-04-13,Sierra,091,2930,0,0,0,0,0
2020-04-13,Siskiyou,093,43540,5,5,0,5,0
2020-04-13,Solano,095,438530,210,136,0,136,2
2020-04-13,Sonoma,097,501317,186,133,0,133,1
2020-04-13,Stanislaus,099,539301,254,130,4,134,1
2020-04-13,Sutter,101,95872,24,18,0,18,2
2020-04-13,Tehama,103,63373,1,1,0,1,0
2020-04-13,Trinity,105,12862,0,0,0,0,0
2020-04-13,Tulare,107,460477,500,185,5,190,11
2020-04-13,Tuolumne,109,53932,3,0,0,0,0
2020-04-13,Ventura,111,848112,483,309,0,309,9
2020-04-13,Yolo,113,214977,153,81,0,81,3
2020-04-13,Yuba,115,75493,14,13,0,13,1
2020-04-12,Alameda,001,1643700,1202,774,1,775,23
2020-04-12,Alpine,003,1148,1,1,0,1,0
2020-04-12,Amador,005,37829,7,6,0,6,0
2020-04-12,Butte,007,227075,19,13,1,14,0
2020-04-12,Calaveras,009,45235,10,5,0,5,0
2020-04-12,Colusa,011,21464,3,3,0,3,0
2020-04-12,Contra Costa,013,1133247,767,553,0,553,12
2020-04-12,Del Norte,015,27424,2,2,0,2,0
2020-04-12,El Dorado,017,186661,49,28,0,28,0
2020-04-12,Fresno,019,978130,470,205,5,210,4
2020-04-12,Glenn,021,27897,4,3,0,3,0
2020-04-12,Humboldt,023,135768,57,43,0,43,0
2020-04-12,Imperial,025,180216,196,78,0,78,2
2020-04-12,Inyo,027,18085,15,12,0,12,0
2020-04-12,Kern,029,883053,679,319,0,319,3
2020-04-12,Kings,031,150075,52,9,1,10,0
2020-04-12,Lake,033,64148,6,3,0,3,0
2020-04-12,Lassen,035,31185,3,0,2,2,0
2020-04-12,Los Angeles,037,10098052,14656,9133,13,9146,294
2020-04-12,Madera,039,155013,65,29,1,30,2
2020-04-12,Marin,041,260295,181,138,1,139,6
2020-04-12,Mariposa,043,17540,0,0,0,0,0
2020-04-12,Mendocino,045,87422,5,4,0,4,0
2020-04-12,Merced,047,269075,106,58,0,58,3
2020-04-12,Modoc,049,8938,0,0,0,0,0
2020-04-12,Mono,051,14174,29,20,0,20,1
2020-04-12,Monterey,053,433212,159,85,0,85,3
2020-04-12,Napa,055,140530,53,29,0,29,2
2020-04-12,Nevada,057,99092,37,24,1,25,1
2020-04-12,Orange,059,3164182,1993,1283,18,1301,21
2020-04-12,Placer,061,380077,146,114,0,114,4
2020-04-12,Plumas,063,18699,4,3,0,3,0
2020-04-12,Riverside,065,2383286,2754,1330,13,1343,34
2020-04-12,Sacramento,067,1510023,920,689,0,689,25
2020-04-12,San Benito,069,59416,36,33,0,33,2
2020-04-12,San Bernardino,071,2135413,1438,827,0,827,30
2020-04-12,San Diego,073,3302833,2444,1806,0,1806,45
2020-04-12,San Francisco,075,870044,1192,886,0,886,11
2020-04-12,San Joaquin,077,732212,420,246,3,249,15
2020-04-12,San Luis Obispo,079,281455,166,102,2,104,1
2020-04-12,San Mateo,081,765935,947,664,2,666,25
2020-04-12,Santa Barbara,083,443738,362,261,1,262,2
2020-04-12,Santa Clara,085,1922200,2054,1461,5,1466,53
2020-04-12,Santa Cruz,087,273765,102,80,0,80,1
2020-04-12,Shasta,089,179085,30,24,0,24,3
2020-04-12,Sierra,091,2930,0,0,0,0,0
2020-04-12,Siskiyou,093,43540,5,5,0,5,0
2020-04-12,Solano,095,438530,204,136,0,136,2
2020-04-12,Sonoma,097,501317,183,131,0,131,1
2020-04-12,Stanislaus,099,539301,246,117,4,121,1
2020-04-12,Sutter,101,95872,23,18,0,18,2
2020-04-12,Tehama,103,63373,1,1,0,1,0
2020-04-12,Trinity,105,12862,0,0,0,0,0
2020-04-12,Tulare,107,460477,488,166,5,171,11
2020-04-12,Tuolumne,109,53932,3,0,0,0,0
2020-04-12,Ventura,111,848112,473,306,0,306,9
2020-04-12,Yolo,113,214977,139,67,0,67,3
2020-04-12,Yuba,115,75493,14,13,0,13,1
2020-04-11,Alameda,001,1643700,1161,751,1,752,23
2020-04-11,Alpine,003,1148,1,1,0,1,0
2020-04-11,Amador,005,37829,7,6,0,6,0
2020-04-11,Butte,007,227075,19,13,1,14,0
2020-04-11,Calaveras,009,45235,10,5,0,5,0
2020-04-11,Colusa,011,21464,3,3,0,3,0
2020-04-11,Contra Costa,013,1133247,758,550,0,550,12
2020-04-11,Del Norte,015,27424,2,2,0,2,0
2020-04-11,El Dorado,017,186661,48,29,0,29,0
2020-04-11,Fresno,019,978130,460,201,5,206,4
2020-04-11,Glenn,021,27897,4,3,0,3,0
2020-04-11,Humboldt,023,135768,57,38,0,38,0
2020-04-11,Imperial,025,180216,186,78,0,78,2
2020-04-11,Inyo,027,18085,15,12,0,12,0
2020-04-11,Kern,029,883053,651,304,0,304,3
2020-04-11,Kings,031,150075,49,9,1,10,0
2020-04-11,Lake,033,64148,6,3,0,3,0
2020-04-11,Lassen,035,31185,3,0,2,2,0
2020-04-11,Los Angeles,037,10098052,14181,8823,13,8836,262
2020-04-11,Madera,039,155013,64,29,1,30,2
2020-04-11,Marin,041,260295,178,136,1,137,6
2020-04-11,Mariposa,043,17540,0,0,0,0,0
2020-04-11,Mendocino,045,87422,5,4,0,4,0
2020-04-11,Merced,047,269075,103,59,0,59,3
2020-04-11,Modoc,049,8938,0,0,0,0,0
2020-04-11,Mono,051,14174,29,20,0,20,1
2020-04-11,Monterey,053,433212,153,78,0,78,3
2020-04-11,Napa,055,140530,53,29,0,29,2
2020-04-11,Nevada,057,99092,37,24,1,25,1
2020-04-11,Orange,059,3164182,1931,1267,18,1285,21
2020-04-11,Placer,061,380077,146,113,0,113,4
2020-04-11,Plumas,063,18699,4,3,0,3,0
2020-04-11,Riverside,065,2383286,2675,1260,13,1273,33
2020-04-11,Sacramento,067,1510023,909,685,0,685,25
2020-04-11,San Benito,069,59416,36,33,0,33,2
2020-04-11,San Bernardino,071,2135413,1402,826,0,826,28
2020-04-11,San Diego,073,3302833,2378,1763,0,1763,45
2020-04-11,San Francisco,075,870044,1170,860,0,860,11
2020-04-11,San Joaquin,077,732212,415,244,3,247,15
2020-04-11,San Luis Obispo,079,281455,166,100,1,101,1
2020-04-11,San Mateo,081,765935,935,662,2,664,25
2020-04-11,Santa Barbara,083,443738,354,258,1,259,2
2020-04-11,Santa Clara,085,1922200,1995,1441,5,1446,51
2020-04-11,Santa Cruz,087,273765,102,79,0,79,1
2020-04-11,Shasta,089,179085,30,24,0,24,3
2020-04-11,Sierra,091,2930,0,0,0,0,0
2020-04-11,Siskiyou,093,43540,5,5,0,5,0
2020-04-11,Solano,095,438530,200,138,0,138,2
2020-04-11,Sonoma,097,501317,181,131,0,131,1
2020-04-11,Stanislaus,099,539301,238,119,3,122,1
2020-04-11,Sutter,101,95872,23,18,0,18,2
2020-04-11,Tehama,103,63373,1,1,0,1,0
2020-04-11,Trinity,105,12862,0,0,0,0,0
2020-04-11,Tulare,107,460477,466,168,5,173,10
2020-04-11,Tuolumne,109,53932,3,0,0,0,0
2020-04-11,Ventura,111,848112,463,304,0,304,9
2020-04-11,Yolo,113,214977,136,67,0,67,3
2020-04-11,Yuba,115,75493,14,13,0,13,1
2020-04-10,Alameda,001,1643700,1120,706,1,707,21
2020-04-10,Alpine,003,1148,1,1,0,1,0
2020-04-10,Amador,005,37829,7,5,0,5,0
2020-04-10,Butte,007,227075,19,13,1,14,0
2020-04-10,Calaveras,009,45235,10,5,0,5,0
2020-04-10,Colusa,011,21464,3,3,0,3,0
2020-04-10,Contra Costa,013,1133247,745,537,0,537,10
2020-04-10,Del Norte,015,27424,2,2,0,2,0
2020-04-10,El Dorado,017,186661,48,26,0,26,0
2020-04-10,Fresno,019,978130,453,186,4,190,3
2020-04-10,Glenn,021,27897,4,3,0,3,0
2020-04-10,Humboldt,023,135768,57,36,0,36,0
2020-04-10,Imperial,025,180216,179,70,0,70,2
2020-04-10,Inyo,027,18085,13,11,0,11,0
2020-04-10,Kern,029,883053,627,272,0,272,3
2020-04-10,Kings,031,150075,46,7,1,8,0
2020-04-10,Lake,033,64148,6,3,0,3,0
2020-04-10,Lassen,035,31185,3,0,2,2,0
2020-04-10,Los Angeles,037,10098052,13666,8384,12,8396,239
2020-04-10,Madera,039,155013,63,29,1,30,2
2020-04-10,Marin,041,260295,173,128,1,129,6
2020-04-10,Mariposa,043,17540,0,0,0,0,0
2020-04-10,Mendocino,045,87422,5,4,0,4,0
2020-04-10,Merced,047,269075,100,56,0,56,3
2020-04-10,Modoc,049,8938,0,0,0,0,0
2020-04-10,Mono,051,14174,29,20,0,20,1
2020-04-10,Monterey,053,433212,142,78,0,78,3
2020-04-10,Napa,055,140530,50,28,0,28,2
2020-04-10,Nevada,057,99092,37,23,1,24,1
2020-04-10,Orange,059,3164182,1884,1167,18,1185,21
2020-04-10,Placer,061,380077,145,112,0,112,4
2020-04-10,Plumas,063,18699,4,3,0,3,0
2020-04-10,Riverside,065,2383286,2609,1162,13,1175,30
2020-04-10,Sacramento,067,1510023,900,642,0,642,24
2020-04-10,San Benito,069,59416,36,32,0,32,2
2020-04-10,San Bernardino,071,2135413,1354,779,0,779,27
2020-04-10,San Diego,073,3302833,2318,1695,0,1695,44
2020-04-10,San Francisco,075,870044,1139,797,0,797,10
2020-04-10,San Joaquin,077,732212,403,234,3,237,14
2020-04-10,San Luis Obispo,079,281455,166,97,1,98,1
2020-04-10,San Mateo,081,765935,919,642,2,644,24
2020-04-10,Santa Barbara,083,443738,346,254,1,255,2
2020-04-10,Santa Clara,085,1922200,1943,1351,5,1356,50
2020-04-10,Santa Cruz,087,273765,101,75,0,75,1
2020-04-10,Shasta,089,179085,30,24,0,24,3
2020-04-10,Sierra,091,2930,0,0,0,0,0
2020-04-10,Siskiyou,093,43540,5,5,0,5,0
2020-04-10,Solano,095,438530,197,129,0,129,2
2020-04-10,Sonoma,097,501317,180,129,0,129,1
2020-04-10,Stanislaus,099,539301,231,101,3,104,0
2020-04-10,Sutter,101,95872,23,18,0,18,2
2020-04-10,Tehama,103,63373,1,1,0,1,0
2020-04-10,Trinity,105,12862,0,0,0,0,0
2020-04-10,Tulare,107,460477,424,163,5,168,10
2020-04-10,Tuolumne,109,53932,3,0,0,0,0
2020-04-10,Ventura,111,848112,454,290,0,290,9
2020-04-10,Yolo,113,214977,134,62,0,62,3
2020-04-10,Yuba,115,75493,14,13,0,13,1
2020-04-09,Alameda,001,1643700,1070,641,1,642,17
2020-04-09,Alpine,003,1148,1,1,0,1,0
2020-04-09,Amador,005,37829,7,2,0,2,0
2020-04-09,Butte,007,227075,19,12,1,13,0
2020-04-09,Calaveras,009,45235,10,5,0,5,0
2020-04-09,Colusa,011,21464,3,3,0,3,0
2020-04-09,Contra Costa,013,1133247,702,505,0,505,7
2020-04-09,Del Norte,015,27424,2,2,0,2,0
2020-04-09,El Dorado,017,186661,47,25,0,25,0
2020-04-09,Fresno,019,978130,428,165,4,169,3
2020-04-09,Glenn,021,27897,4,2,0,2,0
2020-04-09,Humboldt,023,135768,57,36,0,36,0
2020-04-09,Imperial,025,180216,158,67,0,67,2
2020-04-09,Inyo,027,18085,12,11,0,11,0
2020-04-09,Kern,029,883053,591,241,0,241,2
2020-04-09,Kings,031,150075,43,5,1,6,0
2020-04-09,Lake,033,64148,5,1,0,1,0
2020-04-09,Lassen,035,31185,3,0,2,2,0
2020-04-09,Los Angeles,037,10098052,13035,7919,12,7931,220
2020-04-09,Madera,039,155013,63,28,1,29,2
2020-04-09,Marin,041,260295,171,126,1,127,7
2020-04-09,Mariposa,043,17540,0,0,0,0,0
2020-04-09,Mendocino,045,87422,5,4,0,4,0
2020-04-09,Merced,047,269075,97,41,0,41,3
2020-04-09,Modoc,049,8938,0,0,0,0,0
2020-04-09,Mono,051,14174,29,19,0,19,1
2020-04-09,Monterey,053,433212,124,70,0,70,3
2020-04-09,Napa,055,140530,46,27,0,27,2
2020-04-09,Nevada,057,99092,36,23,1,24,1
2020-04-09,Orange,059,3164182,1810,1105,18,1123,19
2020-04-09,Placer,061,380077,144,107,0,107,4
2020-04-09,Plumas,063,18699,4,3,0,3,0
2020-04-09,Riverside,065,2383286,2466,1083,13,1096,29
2020-04-09,Sacramento,067,1510023,877,601,0,601,21
2020-04-09,San Benito,069,59416,36,32,0,32,2
2020-04-09,San Bernardino,071,2135413,1285,717,0,717,27
2020-04-09,San Diego,073,3302833,2222,1630,0,1630,40
2020-04-09,San Francisco,075,870044,1119,748,0,748,8
2020-04-09,San Joaquin,077,732212,382,223,3,226,14
2020-04-09,San Luis Obispo,079,281455,158,93,1,94,1
2020-04-09,San Mateo,081,765935,903,630,2,632,23
2020-04-09,Santa Barbara,083,443738,336,232,1,233,2
2020-04-09,Santa Clara,085,1922200,1873,1301,5,1306,49
2020-04-09,Santa Cruz,087,273765,101,73,0,73,1
2020-04-09,Shasta,089,179085,30,22,0,22,3
2020-04-09,Sierra,091,2930,0,0,0,0,0
2020-04-09,Siskiyou,093,43540,5,4,0,4,0
2020-04-09,Solano,095,438530,188,118,0,118,2
2020-04-09,Sonoma,097,501317,176,113,0,113,1
2020-04-09,Stanislaus,099,539301,219,93,3,96,0
2020-04-09,Sutter,101,95872,23,17,0,17,2
2020-04-09,Tehama,103,63373,1,1,0,1,0
2020-04-09,Trinity,105,12862,0,0,0,0,0
2020-04-09,Tulare,107,460477,395,147,5,152,9
2020-04-09,Tuolumne,109,53932,3,0,0,0,0
2020-04-09,Ventura,111,848112,435,273,0,273,9
2020-04-09,Yolo,113,214977,125,59,0,59,3
2020-04-09,Yuba,115,75493,14,13,0,13,0
2020-04-08,Alameda,001,1643700,1028,594,1,595,15
2020-04-08,Alpine,003,1148,1,1,0,1,0
2020-04-08,Amador,005,37829,7,2,0,2,0
2020-04-08,Butte,007,227075,18,11,1,12,0
2020-04-08,Calaveras,009,45235,10,5,0,5,0
2020-04-08,Colusa,011,21464,3,3,0,3,0
2020-04-08,Contra Costa,013,1133247,689,481,0,481,7
2020-04-08,Del Norte,015,27424,2,2,0,2,0
2020-04-08,El Dorado,017,186661,47,25,0,25,0
2020-04-08,Fresno,019,978130,408,151,4,155,3
2020-04-08,Glenn,021,27897,4,2,0,2,0
2020-04-08,Humboldt,023,135768,57,40,0,40,0
2020-04-08,Imperial,025,180216,147,59,0,59,2
2020-04-08,Inyo,027,18085,12,11,0,11,0
2020-04-08,Kern,029,883053,550,198,0,198,2
2020-04-08,Kings,031,150075,43,5,1,6,0
2020-04-08,Lake,033,64148,5,1,0,1,0
2020-04-08,Lassen,035,31185,3,0,2,2,0
2020-04-08,Los Angeles,037,10098052,12434,7505,12,7517,196
2020-04-08,Madera,039,155013,62,28,1,29,2
2020-04-08,Marin,041,260295,165,125,1,126,7
2020-04-08,Mariposa,043,17540,0,0,0,0,0
2020-04-08,Mendocino,045,87422,5,4,0,4,0
2020-04-08,Merced,047,269075,82,35,0,35,1
2020-04-08,Modoc,049,8938,0,0,0,0,0
2020-04-08,Mono,051,14174,29,19,0,19,1
2020-04-08,Monterey,053,433212,115,68,0,68,3
2020-04-08,Napa,055,140530,44,21,0,21,2
2020-04-08,Nevada,057,99092,36,21,1,22,1
2020-04-08,Orange,059,3164182,1747,1034,18,1052,19
2020-04-08,Placer,061,380077,144,102,0,102,4
2020-04-08,Plumas,063,18699,4,3,0,3,0
2020-04-08,Riverside,065,2383286,2309,974,13,987,28
2020-04-08,Sacramento,067,1510023,843,565,0,565,21
2020-04-08,San Benito,069,59416,36,31,0,31,2
2020-04-08,San Bernardino,071,2135413,1228,635,0,635,22
2020-04-08,San Diego,073,3302833,2148,1532,0,1532,36
2020-04-08,San Francisco,075,870044,1052,687,0,687,7
2020-04-08,San Joaquin,077,732212,365,211,3,214,12
2020-04-08,San Luis Obispo,079,281455,156,90,1,91,1
2020-04-08,San Mateo,081,765935,888,608,2,610,22
2020-04-08,Santa Barbara,083,443738,319,221,1,222,2
2020-04-08,Santa Clara,085,1922200,1828,1257,5,1262,47
2020-04-08,Santa Cruz,087,273765,100,69,0,69,1
2020-04-08,Shasta,089,179085,30,18,0,18,3
2020-04-08,Sierra,091,2930,0,0,0,0,0
2020-04-08,Siskiyou,093,43540,5,4,0,4,0
2020-04-08,Solano,095,438530,175,111,0,111,2
2020-04-08,Sonoma,097,501317,170,107,0,107,1
2020-04-08,Stanislaus,099,539301,203,86,3,89,0
2020-04-08,Sutter,101,95872,22,17,0,17,2
2020-04-08,Tehama,103,63373,1,1,0,1,0
2020-04-08,Trinity,105,12862,0,0,0,0,0
2020-04-08,Tulare,107,460477,364,145,5,150,6
2020-04-08,Tuolumne,109,53932,3,0,0,0,0
2020-04-08,Ventura,111,848112,426,263,0,263,7
2020-04-08,Yolo,113,214977,108,56,0,56,3
2020-04-08,Yuba,115,75493,14,10,0,10,0
2020-04-07,Alameda,001,1643700,993,560,1,561,14
2020-04-07,Alpine,003,1148,1,1,0,1,0
2020-04-07,Amador,005,37829,7,2,0,2,0
2020-04-07,Butte,007,227075,17,11,1,12,0
2020-04-07,Calaveras,009,45235,9,5,0,5,0
2020-04-07,Colusa,011,21464,3,2,0,2,0
2020-04-07,Contra Costa,013,1133247,669,471,0,471,7
2020-04-07,Del Norte,015,27424,2,2,0,2,0
2020-04-07,El Dorado,017,186661,46,22,0,22,0
2020-04-07,Fresno,019,978130,393,138,4,142,3
2020-04-07,Glenn,021,27897,4,2,0,2,0
2020-04-07,Humboldt,023,135768,56,40,0,40,0
2020-04-07,Imperial,025,180216,128,53,0,53,2
2020-04-07,Inyo,027,18085,12,11,0,11,0
2020-04-07,Kern,029,883053,507,134,0,134,2
2020-04-07,Kings,031,150075,40,5,1,6,0
2020-04-07,Lake,033,64148,4,1,0,1,0
2020-04-07,Lassen,035,31185,3,0,2,2,0
2020-04-07,Los Angeles,037,10098052,11785,6885,12,6897,170
2020-04-07,Madera,039,155013,60,28,0,28,2
2020-04-07,Marin,041,260295,163,122,1,123,7
2020-04-07,Mariposa,043,17540,0,0,0,0,0
2020-04-07,Mendocino,045,87422,5,4,0,4,0
2020-04-07,Merced,047,269075,67,27,0,27,1
2020-04-07,Modoc,049,8938,0,0,0,0,0
2020-04-07,Mono,051,14174,28,18,0,18,1
2020-04-07,Monterey,053,433212,106,63,0,63,2
2020-04-07,Napa,055,140530,42,18,0,18,2
2020-04-07,Nevada,057,99092,36,20,1,21,1
2020-04-07,Orange,059,3164182,1700,971,16,987,19
2020-04-07,Placer,061,380077,139,94,0,94,3
2020-04-07,Plumas,063,18699,4,3,0,3,0
2020-04-07,Riverside,065,2383286,2152,905,13,918,25
2020-04-07,Sacramento,067,1510023,813,513,0,513,18
2020-04-07,San Benito,069,59416,36,26,0,26,2
2020-04-07,San Bernardino,071,2135413,1161,554,0,554,19
2020-04-07,San Diego,073,3302833,2071,1456,0,1456,31
2020-04-07,San Francisco,075,870044,992,636,0,636,6
2020-04-07,San Joaquin,077,732212,347,198,3,201,12
2020-04-07,San Luis Obispo,079,281455,149,87,1,88,1
2020-04-07,San Mateo,081,765935,867,573,2,575,22
2020-04-07,Santa Barbara,083,443738,305,209,1,210,2
2020-04-07,Santa Clara,085,1922200,1759,1193,4,1197,46
2020-04-07,Santa Cruz,087,273765,100,67,0,67,1
2020-04-07,Shasta,089,179085,29,16,0,16,3
2020-04-07,Sierra,091,2930,0,0,0,0,0
2020-04-07,Siskiyou,093,43540,5,4,0,4,0
2020-04-07,Solano,095,438530,170,99,0,99,1
2020-04-07,Sonoma,097,501317,167,102,0,102,1
2020-04-07,Stanislaus,099,539301,186,83,3,86,0
2020-04-07,Sutter,101,95872,22,16,0,16,2
2020-04-07,Tehama,103,63373,1,1,0,1,0
2020-04-07,Trinity,105,12862,0,0,0,0,0
2020-04-07,Tulare,107,460477,335,144,5,149,5
2020-04-07,Tuolumne,109,53932,3,1,0,1,0
2020-04-07,Ventura,111,848112,409,247,0,247,6
2020-04-07,Yolo,113,214977,101,51,0,51,2
2020-04-07,Yuba,115,75493,14,10,0,10,0
2020-04-06,Alameda,001,1643700,962,527,1,528,13
2020-04-06,Alpine,003,1148,1,1,0,1,0
2020-04-06,Amador,005,37829,6,2,0,2,0
2020-04-06,Butte,007,227075,16,11,1,12,0
2020-04-06,Calaveras,009,45235,9,4,0,4,0
2020-04-06,Colusa,011,21464,3,1,0,1,0
2020-04-06,Contra Costa,013,1133247,644,447,0,447,7
2020-04-06,Del Norte,015,27424,2,2,0,2,0
2020-04-06,El Dorado,017,186661,44,23,0,23,0
2020-04-06,Fresno,019,978130,371,122,4,126,1
2020-04-06,Glenn,021,27897,4,2,0,2,0
2020-04-06,Humboldt,023,135768,55,37,0,37,0
2020-04-06,Imperial,025,180216,121,47,0,47,1
2020-04-06,Inyo,027,18085,11,11,0,11,0
2020-04-06,Kern,029,883053,470,117,0,117,2
2020-04-06,Kings,031,150075,40,3,1,4,0
2020-04-06,Lake,033,64148,4,1,0,1,0
2020-04-06,Lassen,035,31185,3,0,2,2,0
2020-04-06,Los Angeles,037,10098052,11052,6346,12,6358,145
2020-04-06,Madera,039,155013,58,29,0,29,2
2020-04-06,Marin,041,260295,160,119,1,120,7
2020-04-06,Mariposa,043,17540,0,0,0,0,0
2020-04-06,Mendocino,045,87422,5,4,0,4,0
2020-04-06,Merced,047,269075,60,25,0,25,1
2020-04-06,Modoc,049,8938,0,0,0,0,0
2020-04-06,Mono,051,14174,28,18,0,18,1
2020-04-06,Monterey,053,433212,101,62,0,62,2
2020-04-06,Napa,055,140530,42,18,0,18,2
2020-04-06,Nevada,057,99092,36,19,1,20,1
2020-04-06,Orange,059,3164182,1656,910,15,925,17
2020-04-06,Placer,061,380077,139,90,0,90,3
2020-04-06,Plumas,063,18699,4,2,0,2,0
2020-04-06,Riverside,065,2383286,2026,854,13,867,17
2020-04-06,Sacramento,067,1510023,783,448,0,448,15
2020-04-06,San Benito,069,59416,34,25,0,25,1
2020-04-06,San Bernardino,071,2135413,1102,550,0,550,13
2020-04-06,San Diego,073,3302833,1989,1406,0,1406,19
2020-04-06,San Francisco,075,870044,952,586,0,586,6
2020-04-06,San Joaquin,077,732212,332,191,3,194,10
2020-04-06,San Luis Obispo,079,281455,147,85,1,86,1
2020-04-06,San Mateo,081,765935,849,569,2,571,20
2020-04-06,Santa Barbara,083,443738,296,189,1,190,2
2020-04-06,Santa Clara,085,1922200,1706,1128,4,1132,43
2020-04-06,Santa Cruz,087,273765,98,65,0,65,1
2020-04-06,Shasta,089,179085,29,16,0,16,3
2020-04-06,Sierra,091,2930,0,0,0,0,0
2020-04-06,Siskiyou,093,43540,4,4,0,4,0
2020-04-06,Solano,095,438530,163,95,0,95,1
2020-04-06,Sonoma,097,501317,166,102,0,102,1
2020-04-06,Stanislaus,099,539301,170,72,3,75,0
2020-04-06,Sutter,101,95872,22,14,0,14,2
2020-04-06,Tehama,103,63373,1,1,0,1,0
2020-04-06,Trinity,105,12862,0,0,0,0,0
2020-04-06,Tulare,107,460477,319,126,5,131,5
2020-04-06,Tuolumne,109,53932,3,1,0,1,0
2020-04-06,Ventura,111,848112,391,234,0,234,6
2020-04-06,Yolo,113,214977,97,43,0,43,1
2020-04-06,Yuba,115,75493,14,8,0,8,0
2020-04-05,Alameda,001,1643700,920,475,1,476,12
2020-04-05,Alpine,003,1148,1,1,0,1,0
2020-04-05,Amador,005,37829,6,2,0,2,0
2020-04-05,Butte,007,227075,16,10,1,11,0
2020-04-05,Calaveras,009,45235,9,3,0,3,0
2020-04-05,Colusa,011,21464,3,1,0,1,0
2020-04-05,Contra Costa,013,1133247,627,415,0,415,6
2020-04-05,Del Norte,015,27424,2,1,0,1,0
2020-04-05,El Dorado,017,186661,42,19,0,19,0
2020-04-05,Fresno,019,978130,337,102,4,106,1
2020-04-05,Glenn,021,27897,4,2,0,2,0
2020-04-05,Humboldt,023,135768,55,29,0,29,0
2020-04-05,Imperial,025,180216,113,42,0,42,1
2020-04-05,Inyo,027,18085,11,10,0,10,0
2020-04-05,Kern,029,883053,415,109,0,109,2
2020-04-05,Kings,031,150075,39,4,1,5,0
2020-04-05,Lake,033,64148,4,0,0,0,0
2020-04-05,Lassen,035,31185,3,0,2,2,0
2020-04-05,Los Angeles,037,10098052,10481,5892,12,5904,130
2020-04-05,Madera,039,155013,57,27,0,27,2
2020-04-05,Marin,041,260295,160,113,1,114,6
2020-04-05,Mariposa,043,17540,0,0,0,0,0
2020-04-05,Mendocino,045,87422,5,4,0,4,0
2020-04-05,Merced,047,269075,53,16,0,16,0
2020-04-05,Modoc,049,8938,0,0,0,0,0
2020-04-05,Mono,051,14174,28,18,0,18,1
2020-04-05,Monterey,053,433212,94,61,0,61,2
2020-04-05,Napa,055,140530,40,15,0,15,2
2020-04-05,Nevada,057,99092,36,19,1,20,1
2020-04-05,Orange,059,3164182,1599,820,15,835,15
2020-04-05,Placer,061,380077,136,86,0,86,3
2020-04-05,Plumas,063,18699,3,2,0,2,0
2020-04-05,Riverside,065,2383286,1896,669,13,682,17
2020-04-05,Sacramento,067,1510023,752,393,0,393,11
2020-04-05,San Benito,069,59416,34,22,0,22,1
2020-04-05,San Bernardino,071,2135413,1029,375,0,375,13
2020-04-05,San Diego,073,3302833,1907,1328,0,1328,19
2020-04-05,San Francisco,075,870044,905,559,0,559,6
2020-04-05,San Joaquin,077,732212,317,179,3,182,10
2020-04-05,San Luis Obispo,079,281455,145,83,1,84,1
2020-04-05,San Mateo,081,765935,829,528,2,530,19
2020-04-05,Santa Barbara,083,443738,280,171,1,172,1
2020-04-05,Santa Clara,085,1922200,1659,1052,4,1056,42
2020-04-05,Santa Cruz,087,273765,98,59,0,59,1
2020-04-05,Shasta,089,179085,28,11,0,11,2
2020-04-05,Sierra,091,2930,0,0,0,0,0
2020-04-05,Siskiyou,093,43540,4,3,0,3,0
2020-04-05,Solano,095,438530,159,78,0,78,1
2020-04-05,Sonoma,097,501317,164,88,0,88,1
2020-04-05,Stanislaus,099,539301,156,51,3,54,0
2020-04-05,Sutter,101,95872,22,14,0,14,1
2020-04-05,Tehama,103,63373,1,1,0,1,0
2020-04-05,Trinity,105,12862,0,0,0,0,0
2020-04-05,Tulare,107,460477,282,81,5,86,4
2020-04-05,Tuolumne,109,53932,3,1,0,1,0
2020-04-05,Ventura,111,848112,377,196,0,196,6
2020-04-05,Yolo,113,214977,78,37,0,37,2
2020-04-05,Yuba,115,75493,14,7,0,7,0
2020-04-04,Alameda,001,1643700,897,468,1,469,12
2020-04-04,Alpine,003,1148,1,1,0,1,0
2020-04-04,Amador,005,37829,5,2,0,2,0
2020-04-04,Butte,007,227075,16,10,1,11,0
2020-04-04,Calaveras,009,45235,9,3,0,3,0
2020-04-04,Colusa,011,21464,3,1,0,1,0
2020-04-04,Contra Costa,013,1133247,619,382,0,382,5
2020-04-04,Del Norte,015,27424,2,1,0,1,0
2020-04-04,El Dorado,017,186661,42,19,0,19,0
2020-04-04,Fresno,019,978130,327,102,4,106,1
2020-04-04,Glenn,021,27897,4,2,0,2,0
2020-04-04,Humboldt,023,135768,55,29,0,29,0
2020-04-04,Imperial,025,180216,112,42,0,42,1
2020-04-04,Inyo,027,18085,11,10,0,10,0
2020-04-04,Kern,029,883053,385,103,0,103,2
2020-04-04,Kings,031,150075,39,3,1,4,0
2020-04-04,Lake,033,64148,4,0,0,0,0
2020-04-04,Lassen,035,31185,3,0,2,2,0
2020-04-04,Los Angeles,037,10098052,9867,5275,12,5287,117
2020-04-04,Madera,039,155013,55,27,0,27,2
2020-04-04,Marin,041,260295,158,111,0,111,6
2020-04-04,Mariposa,043,17540,0,0,0,0,0
2020-04-04,Mendocino,045,87422,5,4,0,4,0
2020-04-04,Merced,047,269075,49,11,0,11,0
2020-04-04,Modoc,049,8938,0,0,0,0,0
2020-04-04,Mono,051,14174,28,18,0,18,1
2020-04-04,Monterey,053,433212,91,61,0,61,2
2020-04-04,Napa,055,140530,40,15,0,15,2
2020-04-04,Nevada,057,99092,36,19,1,20,1
2020-04-04,Orange,059,3164182,1557,781,14,795,15
2020-04-04,Placer,061,380077,135,87,0,87,2
2020-04-04,Plumas,063,18699,3,2,0,2,0
2020-04-04,Riverside,065,2383286,1795,652,13,665,15
2020-04-04,Sacramento,067,1510023,734,393,0,393,11
2020-04-04,San Benito,069,59416,34,22,0,22,1
2020-04-04,San Bernardino,071,2135413,981,373,0,373,13
2020-04-04,San Diego,073,3302833,1859,1211,0,1211,18
2020-04-04,San Francisco,075,870044,867,537,0,537,6
2020-04-04,San Joaquin,077,732212,294,171,3,174,10
2020-04-04,San Luis Obispo,079,281455,145,82,1,83,0
2020-04-04,San Mateo,081,765935,817,520,2,522,17
2020-04-04,Santa Barbara,083,443738,271,167,1,168,1
2020-04-04,Santa Clara,085,1922200,1607,1045,4,1049,39
2020-04-04,Santa Cruz,087,273765,98,56,0,56,1
2020-04-04,Shasta,089,179085,27,11,0,11,2
2020-04-04,Sierra,091,2930,0,0,0,0,0
2020-04-04,Siskiyou,093,43540,4,3,0,3,0
2020-04-04,Solano,095,438530,154,79,0,79,1
2020-04-04,Sonoma,097,501317,161,88,0,88,1
2020-04-04,Stanislaus,099,539301,145,51,3,54,0
2020-04-04,Sutter,101,95872,22,14,0,14,1
2020-04-04,Tehama,103,63373,1,1,0,1,0
2020-04-04,Trinity,105,12862,0,0,0,0,0
2020-04-04,Tulare,107,460477,268,79,5,84,4
2020-04-04,Tuolumne,109,53932,3,1,0,1,0
2020-04-04,Ventura,111,848112,364,194,0,194,6
2020-04-04,Yolo,113,214977,76,40,0,40,2
2020-04-04,Yuba,115,75493,13,7,0,7,0
2020-04-03,Alameda,001,1643700,861,395,1,396,11
2020-04-03,Alpine,003,1148,1,1,0,1,0
2020-04-03,Amador,005,37829,5,2,0,2,0
2020-04-03,Butte,007,227075,16,8,1,9,0
2020-04-03,Calaveras,009,45235,9,3,0,3,0
2020-04-03,Colusa,011,21464,3,1,0,1,0
2020-04-03,Contra Costa,013,1133247,596,327,0,327,5
2020-04-03,Del Norte,015,27424,2,1,0,1,0
2020-04-03,El Dorado,017,186661,40,16,0,16,0
2020-04-03,Fresno,019,978130,315,98,4,102,1
2020-04-03,Glenn,021,27897,4,2,0,2,0
2020-04-03,Humboldt,023,135768,55,34,0,34,0
2020-04-03,Imperial,025,180216,103,35,0,35,0
2020-04-03,Inyo,027,18085,11,10,0,10,0
2020-04-03,Kern,029,883053,359,87,0,87,1
2020-04-03,Kings,031,150075,37,3,1,4,0
2020-04-03,Lake,033,64148,3,0,0,0,0
2020-04-03,Lassen,035,31185,3,0,2,2,0
2020-04-03,Los Angeles,037,10098052,9253,4566,12,4578,91
2020-04-03,Madera,039,155013,54,28,0,28,2
2020-04-03,Marin,041,260295,156,106,0,106,6
2020-04-03,Mariposa,043,17540,0,0,0,0,0
2020-04-03,Mendocino,045,87422,5,4,0,4,0
2020-04-03,Merced,047,269075,46,9,0,9,0
2020-04-03,Modoc,049,8938,0,0,0,0,0
2020-04-03,Mono,051,14174,28,18,0,18,1
2020-04-03,Monterey,053,433212,88,58,0,58,2
2020-04-03,Napa,055,140530,39,13,0,13,1
2020-04-03,Nevada,057,99092,36,19,1,20,1
2020-04-03,Orange,059,3164182,1518,713,14,727,13
2020-04-03,Placer,061,380077,131,76,0,76,2
2020-04-03,Plumas,063,18699,3,2,0,2,0
2020-04-03,Riverside,065,2383286,1715,540,13,553,14
2020-04-03,Sacramento,067,1510023,713,363,0,363,11
2020-04-03,San Benito,069,59416,34,22,0,22,1
2020-04-03,San Bernardino,071,2135413,936,356,0,356,11
2020-04-03,San Diego,073,3302833,1798,1114,0,1114,17
2020-04-03,San Francisco,075,870044,843,506,0,506,6
2020-04-03,San Joaquin,077,732212,282,162,3,165,10
2020-04-03,San Luis Obispo,079,281455,144,82,1,83,0
2020-04-03,San Mateo,081,765935,800,474,2,476,13
2020-04-03,Santa Barbara,083,443738,260,154,1,155,1
2020-04-03,Santa Clara,085,1922200,1571,983,4,987,39
2020-04-03,Santa Cruz,087,273765,98,52,0,52,1
2020-04-03,Shasta,089,179085,27,10,0,10,1
2020-04-03,Sierra,091,2930,0,0,0,0,0
2020-04-03,Siskiyou,093,43540,4,3,0,3,0
2020-04-03,Solano,095,438530,146,72,0,72,1
2020-04-03,Sonoma,097,501317,161,84,0,84,1
2020-04-03,Stanislaus,099,539301,139,48,3,51,0
2020-04-03,Sutter,101,95872,22,12,0,12,1
2020-04-03,Tehama,103,63373,1,1,0,1,0
2020-04-03,Trinity,105,12862,0,0,0,0,0
2020-04-03,Tulare,107,460477,254,73,5,78,3
2020-04-03,Tuolumne,109,53932,3,1,0,1,0
2020-04-03,Ventura,111,848112,354,186,0,186,6
2020-04-03,Yolo,113,214977,75,33,0,33,1
2020-04-03,Yuba,115,75493,13,6,0,6,0
2020-04-02,Alameda,001,1643700,810,345,1,346,10
2020-04-02,Alpine,003,1148,1,1,0,1,0
2020-04-02,Amador,005,37829,5,2,0,2,0
2020-04-02,Butte,007,227075,16,7,0,7,0
2020-04-02,Calaveras,009,45235,7,3,0,3,0
2020-04-02,Colusa,011,21464,3,1,0,1,0
2020-04-02,Contra Costa,013,1133247,566,297,0,297,3
2020-04-02,Del Norte,015,27424,2,0,0,0,0
2020-04-02,El Dorado,017,186661,38,16,0,16,0
2020-04-02,Fresno,019,978130,299,92,4,96,0
2020-04-02,Glenn,021,27897,3,2,0,2,0
2020-04-02,Humboldt,023,135768,51,23,0,23,0
2020-04-02,Imperial,025,180216,99,24,0,24,0
2020-04-02,Inyo,027,18085,10,8,0,8,0
2020-04-02,Kern,029,883053,332,74,0,74,0
2020-04-02,Kings,031,150075,37,3,1,4,0
2020-04-02,Lake,033,64148,3,0,0,0,0
2020-04-02,Lassen,035,31185,3,0,2,2,0
2020-04-02,Los Angeles,037,10098052,8419,4040,12,4052,79
2020-04-02,Madera,039,155013,52,25,0,25,1
2020-04-02,Marin,041,260295,150,102,0,102,1
2020-04-02,Mariposa,043,17540,0,0,0,0,0
2020-04-02,Mendocino,045,87422,5,4,0,4,0
2020-04-02,Merced,047,269075,41,9,0,9,0
2020-04-02,Modoc,049,8938,0,0,0,0,0
2020-04-02,Mono,051,14174,28,16,0,16,1
2020-04-02,Monterey,053,433212,86,50,0,50,2
2020-04-02,Napa,055,140530,39,13,0,13,0
2020-04-02,Nevada,057,99092,35,17,1,18,0
2020-04-02,Orange,059,3164182,1466,640,13,653,12
2020-04-02,Placer,061,380077,130,72,0,72,2
2020-04-02,Plumas,063,18699,3,1,0,1,0
2020-04-02,Riverside,065,2383286,1598,438,13,451,13
2020-04-02,Sacramento,067,1510023,695,322,0,322,9
2020-04-02,San Benito,069,59416,32,18,0,18,1
2020-04-02,San Bernardino,071,2135413,881,335,0,335,8
2020-04-02,San Diego,073,3302833,1731,968,0,968,16
2020-04-02,San Francisco,075,870044,817,473,0,473,6
2020-04-02,San Joaquin,077,732212,263,148,3,151,9
2020-04-02,San Luis Obispo,079,281455,139,79,1,80,0
2020-04-02,San Mateo,081,765935,779,423,2,425,13
2020-04-02,Santa Barbara,083,443738,249,125,1,126,1
2020-04-02,Santa Clara,085,1922200,1520,908,4,912,38
2020-04-02,Santa Cruz,087,273765,96,49,0,49,1
2020-04-02,Shasta,089,179085,26,7,0,7,1
2020-04-02,Sierra,091,2930,0,0,0,0,0
2020-04-02,Siskiyou,093,43540,4,3,0,3,0
2020-04-02,Solano,095,438530,136,65,0,65,0
2020-04-02,Sonoma,097,501317,157,76,0,76,1
2020-04-02,Stanislaus,099,539301,128,40,3,43,0
2020-04-02,Sutter,101,95872,21,10,0,10,1
2020-04-02,Tehama,103,63373,1,1,0,1,0
2020-04-02,Trinity,105,12862,0,0,0,0,0
2020-04-02,Tulare,107,460477,220,64,5,69,1
2020-04-02,Tuolumne,109,53932,3,1,0,1,0
2020-04-02,Ventura,111,848112,336,178,0,178,5
2020-04-02,Yolo,113,214977,73,29,0,29,1
2020-04-02,Yuba,115,75493,10,5,0,5,0
2020-04-01,Alameda,001,1643700,783,287,1,288,8
2020-04-01,Alpine,003,1148,1,1,0,1,0
2020-04-01,Amador,005,37829,5,1,0,1,0
2020-04-01,Butte,007,227075,16,6,0,6,0
2020-04-01,Calaveras,009,45235,6,3,0,3,0
2020-04-01,Colusa,011,21464,3,1,0,1,0
2020-04-01,Contra Costa,013,1133247,523,267,0,267,3
2020-04-01,Del Norte,015,27424,2,0,0,0,0
2020-04-01,El Dorado,017,186661,37,14,0,14,0
2020-04-01,Fresno,019,978130,277,75,3,78,0
2020-04-01,Glenn,021,27897,3,2,0,2,0
2020-04-01,Humboldt,023,135768,51,19,0,19,0
2020-04-01,Imperial,025,180216,93,25,0,25,0
2020-04-01,Inyo,027,18085,10,8,0,8,0
2020-04-01,Kern,029,883053,305,53,0,53,0
2020-04-01,Kings,031,150075,35,3,1,4,0
2020-04-01,Lake,033,64148,3,0,0,0,0
2020-04-01,Lassen,035,31185,3,0,2,2,0
2020-04-01,Los Angeles,037,10098052,7769,3502,12,3514,66
2020-04-01,Madera,039,155013,50,17,0,17,1
2020-04-01,Marin,041,260295,146,87,0,87,1
2020-04-01,Mariposa,043,17540,0,0,0,0,0
2020-04-01,Mendocino,045,87422,5,4,0,4,0
2020-04-01,Merced,047,269075,38,7,0,7,0
2020-04-01,Modoc,049,8938,0,0,0,0,0
2020-04-01,Mono,051,14174,28,12,0,12,1
2020-04-01,Monterey,053,433212,85,47,0,47,2
2020-04-01,Napa,055,140530,36,11,0,11,0
2020-04-01,Nevada,057,99092,35,15,1,16,0
2020-04-01,Orange,059,3164182,1414,579,13,592,11
2020-04-01,Placer,061,380077,128,52,0,52,2
2020-04-01,Plumas,063,18699,3,1,0,1,0
2020-04-01,Riverside,065,2383286,1430,306,12,318,11
2020-04-01,Sacramento,067,1510023,662,299,0,299,8
2020-04-01,San Benito,069,59416,29,14,0,14,1
2020-04-01,San Bernardino,071,2135413,832,245,0,245,5
2020-04-01,San Diego,073,3302833,1661,851,0,851,11
2020-04-01,San Francisco,075,870044,789,432,0,432,6
2020-04-01,San Joaquin,077,732212,251,132,3,135,8
2020-04-01,San Luis Obispo,079,281455,133,69,1,70,0
2020-04-01,San Mateo,081,765935,761,354,2,356,13
2020-04-01,Santa Barbara,083,443738,236,103,1,104,0
2020-04-01,Santa Clara,085,1922200,1478,805,4,809,33
2020-04-01,Santa Cruz,087,273765,91,44,0,44,1
2020-04-01,Shasta,089,179085,25,5,0,5,1
2020-04-01,Sierra,091,2930,0,0,0,0,0
2020-04-01,Siskiyou,093,43540,4,3,0,3,0
2020-04-01,Solano,095,438530,131,57,0,57,0
2020-04-01,Sonoma,097,501317,153,60,0,60,1
2020-04-01,Stanislaus,099,539301,117,29,3,32,0
2020-04-01,Sutter,101,95872,21,9,0,9,1
2020-04-01,Tehama,103,63373,1,0,0,0,0
2020-04-01,Trinity,105,12862,0,0,0,0,0
2020-04-01,Tulare,107,460477,182,43,5,48,1
2020-04-01,Tuolumne,109,53932,3,1,0,1,0
2020-04-01,Ventura,111,848112,323,154,0,154,5
2020-04-01,Yolo,113,214977,68,22,0,22,1
2020-04-01,Yuba,115,75493,9,5,0,5,0
2020-03-31,Alameda,001,1643700,717,269,1,270,7
2020-03-31,Alpine,003,1148,1,1,0,1,0
2020-03-31,Amador,005,37829,5,1,0,1,0
2020-03-31,Butte,007,227075,16,6,0,6,0
2020-03-31,Calaveras,009,45235,6,3,0,3,0
2020-03-31,Colusa,011,21464,3,1,0,1,0
2020-03-31,Contra Costa,013,1133247,498,246,0,246,3
2020-03-31,Del Norte,015,27424,1,0,0,0,0
2020-03-31,El Dorado,017,186661,33,14,0,14,0
2020-03-31,Fresno,019,978130,252,59,3,62,0
2020-03-31,Glenn,021,27897,3,2,0,2,0
2020-03-31,Humboldt,023,135768,51,18,0,18,0
2020-03-31,Imperial,025,180216,88,17,0,17,0
2020-03-31,Inyo,027,18085,10,8,0,8,0
2020-03-31,Kern,029,883053,281,47,0,47,0
2020-03-31,Kings,031,150075,33,2,1,3,0
2020-03-31,Lake,033,64148,1,0,0,0,0
2020-03-31,Lassen,035,31185,3,0,2,2,0
2020-03-31,Los Angeles,037,10098052,7108,3001,12,3013,53
2020-03-31,Madera,039,155013,49,17,0,17,1
2020-03-31,Marin,041,260295,137,85,0,85,1
2020-03-31,Mariposa,043,17540,0,0,0,0,0
2020-03-31,Mendocino,045,87422,5,4,0,4,0
2020-03-31,Merced,047,269075,33,6,0,6,0
2020-03-31,Modoc,049,8938,0,0,0,0,0
2020-03-31,Mono,051,14174,26,12,0,12,0
2020-03-31,Monterey,053,433212,83,43,0,43,2
2020-03-31,Napa,055,140530,35,9,0,9,0
2020-03-31,Nevada,057,99092,35,15,1,16,0
2020-03-31,Orange,059,3164182,1344,506,13,519,7
2020-03-31,Placer,061,380077,121,49,0,49,2
2020-03-31,Plumas,063,18699,1,0,0,0,0
2020-03-31,Riverside,065,2383286,1284,284,12,296,8
2020-03-31,Sacramento,067,1510023,610,271,0,271,8
2020-03-31,San Benito,069,59416,29,14,0,14,1
2020-03-31,San Bernardino,071,2135413,747,193,0,193,5
2020-03-31,San Diego,073,3302833,1579,736,0,736,9
2020-03-31,San Francisco,075,870044,754,404,0,404,5
2020-03-31,San Joaquin,077,732212,235,122,3,125,7
2020-03-31,San Luis Obispo,079,281455,129,67,1,68,0
2020-03-31,San Mateo,081,765935,742,297,2,299,12
2020-03-31,Santa Barbara,083,443738,221,89,1,90,0
2020-03-31,Santa Clara,085,1922200,1428,777,4,781,30
2020-03-31,Santa Cruz,087,273765,84,40,0,40,1
2020-03-31,Shasta,089,179085,22,5,0,5,1
2020-03-31,Sierra,091,2930,0,0,0,0,0
2020-03-31,Siskiyou,093,43540,4,3,0,3,0
2020-03-31,Solano,095,438530,117,56,0,56,0
2020-03-31,Sonoma,097,501317,148,58,0,58,1
2020-03-31,Stanislaus,099,539301,102,28,3,31,0
2020-03-31,Sutter,101,95872,21,8,0,8,0
2020-03-31,Tehama,103,63373,1,0,0,0,0
2020-03-31,Trinity,105,12862,0,0,0,0,0
2020-03-31,Tulare,107,460477,159,42,4,46,1
2020-03-31,Tuolumne,109,53932,3,1,0,1,0
2020-03-31,Ventura,111,848112,312,143,0,143,4
2020-03-31,Yolo,113,214977,61,21,0,21,1
2020-03-31,Yuba,115,75493,9,5,0,5,0
2020-03-30,Alameda,001,1643700,678,250,1,251,7
2020-03-30,Alpine,003,1148,1,1,0,1,0
2020-03-30,Amador,005,37829,5,1,0,1,0
2020-03-30,Butte,007,227075,14,5,0,5,0
2020-03-30,Calaveras,009,45235,6,3,0,3,0
2020-03-30,Colusa,011,21464,3,1,0,1,0
2020-03-30,Contra Costa,013,1133247,472,212,0,212,3
2020-03-30,Del Norte,015,27424,0,0,0,0,0
2020-03-30,El Dorado,017,186661,33,11,0,11,0
2020-03-30,Fresno,019,978130,227,46,3,49,0
2020-03-30,Glenn,021,27897,3,2,0,2,0
2020-03-30,Humboldt,023,135768,49,11,0,11,0
2020-03-30,Imperial,025,180216,85,9,0,9,0
2020-03-30,Inyo,027,18085,10,5,0,5,0
2020-03-30,Kern,029,883053,248,30,0,30,0
2020-03-30,Kings,031,150075,33,1,1,2,0
2020-03-30,Lake,033,64148,1,0,0,0,0
2020-03-30,Lassen,035,31185,3,0,1,1,0
2020-03-30,Los Angeles,037,10098052,6448,2467,12,2479,44
2020-03-30,Madera,039,155013,48,14,0,14,1
2020-03-30,Marin,041,260295,130,78,0,78,0
2020-03-30,Mariposa,043,17540,0,0,0,0,0
2020-03-30,Mendocino,045,87422,5,2,0,2,0
2020-03-30,Merced,047,269075,29,6,0,6,0
2020-03-30,Modoc,049,8938,0,0,0,0,0
2020-03-30,Mono,051,14174,26,11,0,11,0
2020-03-30,Monterey,053,433212,78,41,0,41,1
2020-03-30,Napa,055,140530,34,9,0,9,0
2020-03-30,Nevada,057,99092,34,14,1,15,0
2020-03-30,Orange,059,3164182,1279,418,13,431,5
2020-03-30,Placer,061,380077,118,44,0,44,2
2020-03-30,Plumas,063,18699,1,0,0,0,0
2020-03-30,Riverside,065,2383286,1203,204,12,216,7
2020-03-30,Sacramento,067,1510023,586,238,0,238,8
2020-03-30,San Benito,069,59416,29,11,0,11,1
2020-03-30,San Bernardino,071,2135413,703,145,0,145,4
2020-03-30,San Diego,073,3302833,1509,605,0,605,7
2020-03-30,San Francisco,075,870044,714,368,0,368,5
2020-03-30,San Joaquin,077,732212,228,112,3,115,5
2020-03-30,San Luis Obispo,079,281455,126,62,1,63,0
2020-03-30,San Mateo,081,765935,717,257,2,259,11
2020-03-30,Santa Barbara,083,443738,212,79,1,80,0
2020-03-30,Santa Clara,085,1922200,1397,745,3,748,31
2020-03-30,Santa Cruz,087,273765,81,36,0,36,1
2020-03-30,Shasta,089,179085,21,4,0,4,1
2020-03-30,Sierra,091,2930,0,0,0,0,0
2020-03-30,Siskiyou,093,43540,4,2,0,2,0
2020-03-30,Solano,095,438530,111,50,0,50,0
2020-03-30,Sonoma,097,501317,145,57,0,57,1
2020-03-30,Stanislaus,099,539301,95,28,3,31,0
2020-03-30,Sutter,101,95872,20,6,0,6,0
2020-03-30,Tehama,103,63373,1,0,0,0,0
2020-03-30,Trinity,105,12862,0,0,0,0,0
2020-03-30,Tulare,107,460477,147,40,3,43,1
2020-03-30,Tuolumne,109,53932,3,1,0,1,0
2020-03-30,Ventura,111,848112,301,118,0,118,2
2020-03-30,Yolo,113,214977,58,17,0,17,1
2020-03-30,Yuba,115,75493,8,5,0,5,0
2020-03-29,Alameda,001,1643700,644,207,1,208,6
2020-03-29,Alpine,003,1148,1,0,0,0,0
2020-03-29,Amador,005,37829,5,1,0,1,0
2020-03-29,Butte,007,227075,14,4,0,4,0
2020-03-29,Calaveras,009,45235,6,2,0,2,0
2020-03-29,Colusa,011,21464,3,1,0,1,0
2020-03-29,Contra Costa,013,1133247,442,187,0,187,3
2020-03-29,Del Norte,015,27424,0,0,0,0,0
2020-03-29,El Dorado,017,186661,32,9,0,9,0
2020-03-29,Fresno,019,978130,203,31,3,34,0
2020-03-29,Glenn,021,27897,2,1,0,1,0
2020-03-29,Humboldt,023,135768,46,9,0,9,0
2020-03-29,Imperial,025,180216,79,9,0,9,0
2020-03-29,Inyo,027,18085,9,0,0,0,0
2020-03-29,Kern,029,883053,230,20,0,20,0
2020-03-29,Kings,031,150075,30,1,1,2,0
2020-03-29,Lake,033,64148,0,0,0,0,0
2020-03-29,Lassen,035,31185,3,0,1,1,0
2020-03-29,Los Angeles,037,10098052,5800,2119,11,2130,37
2020-03-29,Madera,039,155013,43,11,0,11,1
2020-03-29,Marin,041,260295,125,60,0,60,0
2020-03-29,Mariposa,043,17540,0,0,0,0,0
2020-03-29,Mendocino,045,87422,5,2,0,2,0
2020-03-29,Merced,047,269075,28,4,0,4,0
2020-03-29,Modoc,049,8938,0,0,0,0,0
2020-03-29,Mono,051,14174,26,8,0,8,0
2020-03-29,Monterey,053,433212,73,36,0,36,1
2020-03-29,Napa,055,140530,32,5,0,5,0
2020-03-29,Nevada,057,99092,32,13,1,14,0
2020-03-29,Orange,059,3164182,1206,343,13,356,2
2020-03-29,Placer,061,380077,117,35,0,35,2
2020-03-29,Plumas,063,18699,1,0,0,0,0
2020-03-29,Riverside,065,2383286,1079,122,12,134,7
2020-03-29,Sacramento,067,1510023,546,217,0,217,7
2020-03-29,San Benito,069,59416,28,10,0,10,1
2020-03-29,San Bernardino,071,2135413,651,94,0,94,2
2020-03-29,San Diego,073,3302833,1437,521,0,521,7
2020-03-29,San Francisco,075,870044,670,333,0,333,5
2020-03-29,San Joaquin,077,732212,219,86,3,89,4
2020-03-29,San Luis Obispo,079,281455,119,55,0,55,0
2020-03-29,San Mateo,081,765935,692,234,2,236,12
2020-03-29,Santa Barbara,083,443738,204,52,1,53,0
2020-03-29,Santa Clara,085,1922200,1340,591,3,594,30
2020-03-29,Santa Cruz,087,273765,81,33,0,33,1
2020-03-29,Shasta,089,179085,20,4,0,4,1
2020-03-29,Sierra,091,2930,0,0,0,0,0
2020-03-29,Siskiyou,093,43540,4,2,0,2,0
2020-03-29,Solano,095,438530,103,48,0,48,0
2020-03-29,Sonoma,097,501317,143,35,0,35,1
2020-03-29,Stanislaus,099,539301,90,19,3,22,0
2020-03-29,Sutter,101,95872,17,6,0,6,0
2020-03-29,Tehama,103,63373,1,0,0,0,0
2020-03-29,Trinity,105,12862,0,0,0,0,0
2020-03-29,Tulare,107,460477,122,24,3,27,1
2020-03-29,Tuolumne,109,53932,2,1,0,1,0
2020-03-29,Ventura,111,848112,274,92,0,92,2
2020-03-29,Yolo,113,214977,53,13,0,13,1
2020-03-29,Yuba,115,75493,8,3,0,3,0
2020-03-28,Alameda,001,1643700,617,410,1,411,12
2020-03-28,Alpine,003,1148,1,0,0,0,0
2020-03-28,Amador,005,37829,5,2,0,2,0
2020-03-28,Butte,007,227075,14,8,0,8,0
2020-03-28,Calaveras,009,45235,6,4,0,4,0
2020-03-28,Colusa,011,21464,3,2,0,2,0
2020-03-28,Contra Costa,013,1133247,419,350,0,350,4
2020-03-28,Del Norte,015,27424,0,0,0,0,0
2020-03-28,El Dorado,017,186661,31,18,0,18,0
2020-03-28,Fresno,019,978130,193,62,3,65,0
2020-03-28,Glenn,021,27897,2,2,0,2,0
2020-03-28,Humboldt,023,135768,46,18,0,18,0
2020-03-28,Imperial,025,180216,74,18,0,18,0
2020-03-28,Inyo,027,18085,9,0,0,0,0
2020-03-28,Kern,029,883053,213,40,0,40,0
2020-03-28,Kings,031,150075,29,2,1,3,0
2020-03-28,Lake,033,64148,0,0,0,0,0
2020-03-28,Lassen,035,31185,3,0,1,1,0
2020-03-28,Los Angeles,037,10098052,5414,3600,10,3610,64
2020-03-28,Madera,039,155013,43,22,0,22,2
2020-03-28,Marin,041,260295,120,116,0,116,0
2020-03-28,Mariposa,043,17540,0,0,0,0,0
2020-03-28,Mendocino,045,87422,5,4,0,4,0
2020-03-28,Merced,047,269075,27,8,0,8,0
2020-03-28,Modoc,049,8938,0,0,0,0,0
2020-03-28,Mono,051,14174,24,12,0,12,0
2020-03-28,Monterey,053,433212,72,64,0,64,2
2020-03-28,Napa,055,140530,27,10,0,10,0
2020-03-28,Nevada,057,99092,32,22,1,23,0
2020-03-28,Orange,059,3164182,1170,656,13,669,4
2020-03-28,Placer,061,380077,112,70,0,70,2
2020-03-28,Plumas,063,18699,1,0,0,0,0
2020-03-28,Riverside,065,2383286,1011,242,12,254,14
2020-03-28,Sacramento,067,1510023,528,406,0,406,14
2020-03-28,San Benito,069,59416,28,20,0,20,2
2020-03-28,San Bernardino,071,2135413,603,162,0,162,4
2020-03-28,San Diego,073,3302833,1378,980,0,980,14
2020-03-28,San Francisco,075,870044,646,600,0,600,6
2020-03-28,San Joaquin,077,732212,212,166,3,169,8
2020-03-28,San Luis Obispo,079,281455,117,104,0,104,0
2020-03-28,San Mateo,081,765935,672,462,2,464,17
2020-03-28,Santa Barbara,083,443738,194,98,1,99,0
2020-03-28,Santa Clara,085,1922200,1321,1174,3,1177,54
2020-03-28,Santa Cruz,087,273765,80,62,0,62,0
2020-03-28,Shasta,089,179085,20,8,0,8,2
2020-03-28,Sierra,091,2930,0,0,0,0,0
2020-03-28,Siskiyou,093,43540,4,4,0,4,0
2020-03-28,Solano,095,438530,99,96,0,96,0
2020-03-28,Sonoma,097,501317,141,70,0,70,2
2020-03-28,Stanislaus,099,539301,85,34,3,37,0
2020-03-28,Sutter,101,95872,17,6,0,6,0
2020-03-28,Tehama,103,63373,1,0,0,0,0
2020-03-28,Trinity,105,12862,0,0,0,0,0
2020-03-28,Tulare,107,460477,114,46,3,49,0
2020-03-28,Tuolumne,109,53932,2,2,0,2,0
2020-03-28,Ventura,111,848112,270,178,0,178,4
2020-03-28,Yolo,113,214977,52,26,0,26,2
2020-03-28,Yuba,115,75493,8,6,0,6,0
2020-03-27,Alameda,001,1643700,598,185,1,186,4
2020-03-27,Alpine,003,1148,1,0,0,0,0
2020-03-27,Amador,005,37829,4,1,0,1,0
2020-03-27,Butte,007,227075,12,4,0,4,0
2020-03-27,Calaveras,009,45235,6,2,0,2,0
2020-03-27,Colusa,011,21464,3,0,0,0,0
2020-03-27,Contra Costa,013,1133247,398,161,0,161,2
2020-03-27,Del Norte,015,27424,0,0,0,0,0
2020-03-27,El Dorado,017,186661,29,9,0,9,0
2020-03-27,Fresno,019,978130,181,29,2,31,0
2020-03-27,Glenn,021,27897,2,0,0,0,0
2020-03-27,Humboldt,023,135768,42,9,0,9,0
2020-03-27,Imperial,025,180216,69,9,0,9,0
2020-03-27,Inyo,027,18085,9,0,0,0,0
2020-03-27,Kern,029,883053,200,20,0,20,0
2020-03-27,Kings,031,150075,28,0,1,1,0
2020-03-27,Lake,033,64148,0,0,0,0,0
2020-03-27,Lassen,035,31185,3,0,1,1,0
2020-03-27,Los Angeles,037,10098052,5008,1474,10,1484,26
2020-03-27,Madera,039,155013,41,10,0,10,1
2020-03-27,Marin,041,260295,115,58,0,58,0
2020-03-27,Mariposa,043,17540,0,0,0,0,0
2020-03-27,Mendocino,045,87422,5,2,0,2,0
2020-03-27,Merced,047,269075,26,3,0,3,0
2020-03-27,Modoc,049,8938,0,0,0,0,0
2020-03-27,Mono,051,14174,24,6,0,6,0
2020-03-27,Monterey,053,433212,69,26,0,26,1
2020-03-27,Napa,055,140530,27,5,0,5,0
2020-03-27,Nevada,057,99092,32,6,1,7,0
2020-03-27,Orange,059,3164182,1120,299,13,312,2
2020-03-27,Placer,061,380077,109,33,0,33,1
2020-03-27,Plumas,063,18699,0,0,0,0,0
2020-03-27,Riverside,065,2383286,955,121,12,133,7
2020-03-27,Sacramento,067,1510023,505,163,0,163,6
2020-03-27,San Benito,069,59416,27,9,0,9,1
2020-03-27,San Bernardino,071,2135413,513,77,0,77,2
2020-03-27,San Diego,073,3302833,1321,419,0,419,5
2020-03-27,San Francisco,075,870044,621,285,0,285,2
2020-03-27,San Joaquin,077,732212,201,73,3,76,3
2020-03-27,San Luis Obispo,079,281455,115,46,0,46,0
2020-03-27,San Mateo,081,765935,646,213,2,215,7
2020-03-27,Santa Barbara,083,443738,180,37,1,38,0
2020-03-27,Santa Clara,085,1922200,1283,557,3,560,25
2020-03-27,Santa Cruz,087,273765,79,31,0,31,0
2020-03-27,Shasta,089,179085,17,3,0,3,1
2020-03-27,Sierra,091,2930,0,0,0,0,0
2020-03-27,Siskiyou,093,43540,4,2,0,2,0
2020-03-27,Solano,095,438530,93,48,0,48,0
2020-03-27,Sonoma,097,501317,133,35,0,35,1
2020-03-27,Stanislaus,099,539301,83,16,3,19,0
2020-03-27,Sutter,101,95872,16,2,0,2,0
2020-03-27,Tehama,103,63373,1,0,0,0,0
2020-03-27,Trinity,105,12862,0,0,0,0,0
2020-03-27,Tulare,107,460477,106,15,3,18,0
2020-03-27,Tuolumne,109,53932,2,1,0,1,0
2020-03-27,Ventura,111,848112,261,80,0,80,2
2020-03-27,Yolo,113,214977,51,13,0,13,1
2020-03-27,Yuba,115,75493,7,3,0,3,0
2020-03-26,Alameda,001,1643700,558,172,1,173,4
2020-03-26,Alpine,003,1148,1,0,0,0,0
2020-03-26,Amador,005,37829,4,1,0,1,0
2020-03-26,Butte,007,227075,12,4,0,4,0
2020-03-26,Calaveras,009,45235,6,2,0,2,0
2020-03-26,Colusa,011,21464,3,0,0,0,0
2020-03-26,Contra Costa,013,1133247,387,147,0,147,2
2020-03-26,Del Norte,015,27424,0,0,0,0,0
2020-03-26,El Dorado,017,186661,27,7,0,7,0
2020-03-26,Fresno,019,978130,172,25,2,27,0
2020-03-26,Glenn,021,27897,2,0,0,0,0
2020-03-26,Humboldt,023,135768,38,8,0,8,0
2020-03-26,Imperial,025,180216,65,8,0,8,0
2020-03-26,Inyo,027,18085,8,0,0,0,0
2020-03-26,Kern,029,883053,184,20,0,20,0
2020-03-26,Kings,031,150075,28,0,1,1,0
2020-03-26,Lake,033,64148,0,0,0,0,0
2020-03-26,Lassen,035,31185,3,0,1,1,0
2020-03-26,Los Angeles,037,10098052,4601,1075,10,1085,19
2020-03-26,Madera,039,155013,39,8,0,8,0
2020-03-26,Marin,041,260295,106,56,0,56,0
2020-03-26,Mariposa,043,17540,0,0,0,0,0
2020-03-26,Mendocino,045,87422,4,1,0,1,0
2020-03-26,Merced,047,269075,23,1,0,1,0
2020-03-26,Modoc,049,8938,0,0,0,0,0
2020-03-26,Mono,051,14174,23,5,0,5,0
2020-03-26,Monterey,053,433212,66,25,0,25,1
2020-03-26,Napa,055,140530,26,5,0,5,0
2020-03-26,Nevada,057,99092,32,7,1,8,0
2020-03-26,Orange,059,3164182,1058,279,11,290,1
2020-03-26,Placer,061,380077,106,34,0,34,1
2020-03-26,Plumas,063,18699,0,0,0,0,0
2020-03-26,Riverside,065,2383286,884,118,12,130,7
2020-03-26,Sacramento,067,1510023,472,147,0,147,5
2020-03-26,San Benito,069,59416,27,8,0,8,1
2020-03-26,San Bernardino,071,2135413,447,57,0,57,1
2020-03-26,San Diego,073,3302833,1254,299,0,299,2
2020-03-26,San Francisco,075,870044,594,261,0,261,1
2020-03-26,San Joaquin,077,732212,190,69,3,72,3
2020-03-26,San Luis Obispo,079,281455,110,38,0,38,0
2020-03-26,San Mateo,081,765935,612,122,2,124,5
2020-03-26,Santa Barbara,083,443738,167,33,1,34,0
2020-03-26,Santa Clara,085,1922200,1238,487,2,489,20
2020-03-26,Santa Cruz,087,273765,75,30,0,30,0
2020-03-26,Shasta,089,179085,17,3,0,3,1
2020-03-26,Sierra,091,2930,0,0,0,0,0
2020-03-26,Siskiyou,093,43540,4,2,0,2,0
2020-03-26,Solano,095,438530,85,41,0,41,0
2020-03-26,Sonoma,097,501317,128,33,0,33,1
2020-03-26,Stanislaus,099,539301,81,15,3,18,0
2020-03-26,Sutter,101,95872,12,2,0,2,0
2020-03-26,Tehama,103,63373,1,0,0,0,0
2020-03-26,Trinity,105,12862,0,0,0,0,0
2020-03-26,Tulare,107,460477,97,15,3,18,0
2020-03-26,Tuolumne,109,53932,2,0,0,0,0
2020-03-26,Ventura,111,848112,245,70,0,70,1
2020-03-26,Yolo,113,214977,47,13,0,13,1
2020-03-26,Yuba,115,75493,7,3,0,3,0
2020-03-25,Alameda,001,1643700,537,134,1,135,3
2020-03-25,Alpine,003,1148,1,0,0,0,0
2020-03-25,Amador,005,37829,4,1,0,1,0
2020-03-25,Butte,007,227075,12,4,0,4,0
2020-03-25,Calaveras,009,45235,6,2,0,2,0
2020-03-25,Colusa,011,21464,2,0,0,0,0
2020-03-25,Contra Costa,013,1133247,373,131,0,131,1
2020-03-25,Del Norte,015,27424,0,0,0,0,0
2020-03-25,El Dorado,017,186661,27,5,0,5,0
2020-03-25,Fresno,019,978130,152,21,2,23,0
2020-03-25,Glenn,021,27897,2,0,0,0,0
2020-03-25,Humboldt,023,135768,35,3,0,3,0
2020-03-25,Imperial,025,180216,57,8,0,8,0
2020-03-25,Inyo,027,18085,5,0,0,0,0
2020-03-25,Kern,029,883053,164,13,0,13,0
2020-03-25,Kings,031,150075,26,0,1,1,0
2020-03-25,Lake,033,64148,0,0,0,0,0
2020-03-25,Lassen,035,31185,3,0,1,1,0
2020-03-25,Los Angeles,037,10098052,4202,725,10,735,10
2020-03-25,Madera,039,155013,37,6,0,6,0
2020-03-25,Marin,041,260295,100,47,0,47,0
2020-03-25,Mariposa,043,17540,0,0,0,0,0
2020-03-25,Mendocino,045,87422,3,1,0,1,0
2020-03-25,Merced,047,269075,19,0,0,0,0
2020-03-25,Modoc,049,8938,0,0,0,0,0
2020-03-25,Mono,051,14174,22,4,0,4,0
2020-03-25,Monterey,053,433212,63,23,0,23,1
2020-03-25,Napa,055,140530,26,5,0,5,0
2020-03-25,Nevada,057,99092,31,5,1,6,0
2020-03-25,Orange,059,3164182,1000,214,9,223,1
2020-03-25,Placer,061,380077,100,30,0,30,1
2020-03-25,Plumas,063,18699,0,1,0,1,0
2020-03-25,Riverside,065,2383286,813,87,12,99,5
2020-03-25,Sacramento,067,1510023,446,114,0,114,5
2020-03-25,San Benito,069,59416,26,4,0,4,1
2020-03-25,San Bernardino,071,2135413,408,46,0,46,1
2020-03-25,San Diego,073,3302833,1192,238,0,238,2
2020-03-25,San Francisco,075,870044,553,212,0,212,1
2020-03-25,San Joaquin,077,732212,177,64,3,67,2
2020-03-25,San Luis Obispo,079,281455,105,35,0,35,0
2020-03-25,San Mateo,081,765935,577,111,2,113,5
2020-03-25,Santa Barbara,083,443738,157,25,1,26,0
2020-03-25,Santa Clara,085,1922200,1194,452,2,454,20
2020-03-25,Santa Cruz,087,273765,72,26,0,26,0
2020-03-25,Shasta,089,179085,16,3,0,3,1
2020-03-25,Sierra,091,2930,0,0,0,0,0
2020-03-25,Siskiyou,093,43540,4,2,0,2,0
2020-03-25,Solano,095,438530,80,39,0,39,0
2020-03-25,Sonoma,097,501317,123,31,0,31,1
2020-03-25,Stanislaus,099,539301,74,14,3,17,0
2020-03-25,Sutter,101,95872,9,1,0,1,0
2020-03-25,Tehama,103,63373,1,0,0,0,0
2020-03-25,Trinity,105,12862,0,0,0,0,0
2020-03-25,Tulare,107,460477,87,11,3,14,0
2020-03-25,Tuolumne,109,53932,2,0,0,0,0
2020-03-25,Ventura,111,848112,229,53,0,53,1
2020-03-25,Yolo,113,214977,45,9,0,9,1
2020-03-25,Yuba,115,75493,7,2,0,2,0
2020-03-24,Alameda,001,1643700,505,96,1,97,2
2020-03-24,Alpine,003,1148,1,0,0,0,0
2020-03-24,Amador,005,37829,2,1,0,1,0
2020-03-24,Butte,007,227075,11,3,0,3,0
2020-03-24,Calaveras,009,45235,5,2,0,2,0
2020-03-24,Colusa,011,21464,2,0,0,0,0
2020-03-24,Contra Costa,013,1133247,360,108,0,108,1
2020-03-24,Del Norte,015,27424,0,0,0,0,0
2020-03-24,El Dorado,017,186661,27,3,0,3,0
2020-03-24,Fresno,019,978130,133,18,2,20,0
2020-03-24,Glenn,021,27897,2,0,0,0,0
2020-03-24,Humboldt,023,135768,33,2,0,2,0
2020-03-24,Imperial,025,180216,54,3,0,3,0
2020-03-24,Inyo,027,18085,5,0,0,0,0
2020-03-24,Kern,029,883053,144,5,0,5,0
2020-03-24,Kings,031,150075,25,0,1,1,0
2020-03-24,Lake,033,64148,0,0,0,0,0
2020-03-24,Lassen,035,31185,3,0,1,1,0
2020-03-24,Los Angeles,037,10098052,3758,633,10,643,7
2020-03-24,Madera,039,155013,36,6,0,6,0
2020-03-24,Marin,041,260295,89,44,0,44,0
2020-03-24,Mariposa,043,17540,0,0,0,0,0
2020-03-24,Mendocino,045,87422,3,1,0,1,0
2020-03-24,Merced,047,269075,17,0,0,0,0
2020-03-24,Modoc,049,8938,0,0,0,0,0
2020-03-24,Mono,051,14174,21,1,0,1,0
2020-03-24,Monterey,053,433212,59,23,0,23,1
2020-03-24,Napa,055,140530,23,2,0,2,0
2020-03-24,Nevada,057,99092,30,4,1,5,0
2020-03-24,Orange,059,3164182,938,166,9,175,0
2020-03-24,Placer,061,380077,93,22,0,22,1
2020-03-24,Plumas,063,18699,0,1,0,1,0
2020-03-24,Riverside,065,2383286,746,56,12,68,5
2020-03-24,Sacramento,067,1510023,426,93,0,93,4
2020-03-24,San Benito,069,59416,25,4,0,4,1
2020-03-24,San Bernardino,071,2135413,364,27,0,27,0
2020-03-24,San Diego,073,3302833,1125,231,0,231,2
2020-03-24,San Francisco,075,870044,521,181,0,181,1
2020-03-24,San Joaquin,077,732212,166,52,3,55,2
2020-03-24,San Luis Obispo,079,281455,102,32,0,32,0
2020-03-24,San Mateo,081,765935,536,100,2,102,2
2020-03-24,Santa Barbara,083,443738,151,20,1,21,0
2020-03-24,Santa Clara,085,1922200,1125,389,2,391,17
2020-03-24,Santa Cruz,087,273765,67,22,0,22,0
2020-03-24,Shasta,089,179085,15,3,0,3,0
2020-03-24,Sierra,091,2930,0,0,0,0,0
2020-03-24,Siskiyou,093,43540,4,2,0,2,0
2020-03-24,Solano,095,438530,78,34,0,34,0
2020-03-24,Sonoma,097,501317,116,27,0,27,1
2020-03-24,Stanislaus,099,539301,65,13,3,16,0
2020-03-24,Sutter,101,95872,9,0,0,0,0
2020-03-24,Tehama,103,63373,1,0,0,0,0
2020-03-24,Trinity,105,12862,0,0,0,0,0
2020-03-24,Tulare,107,460477,77,10,3,13,0
2020-03-24,Tuolumne,109,53932,2,0,0,0,0
2020-03-24,Ventura,111,848112,213,44,0,44,1
2020-03-24,Yolo,113,214977,41,8,0,8,0
2020-03-24,Yuba,115,75493,7,2,0,2,0
2020-03-23,Alameda,001,1643700,474,88,1,89,1
2020-03-23,Alpine,003,1148,1,0,0,0,0
2020-03-23,Amador,005,37829,2,1,0,1,0
2020-03-23,Butte,007,227075,11,2,0,2,0
2020-03-23,Calaveras,009,45235,5,2,0,2,0
2020-03-23,Colusa,011,21464,1,0,0,0,0
2020-03-23,Contra Costa,013,1133247,340,91,0,91,2
2020-03-23,Del Norte,015,27424,0,0,0,0,0
2020-03-23,El Dorado,017,186661,26,3,0,3,0
2020-03-23,Fresno,019,978130,123,10,2,12,0
2020-03-23,Glenn,021,27897,2,0,0,0,0
2020-03-23,Humboldt,023,135768,31,2,0,2,0
2020-03-23,Imperial,025,180216,50,2,0,2,0
2020-03-23,Inyo,027,18085,3,0,0,0,0
2020-03-23,Kern,029,883053,130,5,0,5,0
2020-03-23,Kings,031,150075,25,0,1,1,0
2020-03-23,Lake,033,64148,0,0,0,0,0
2020-03-23,Lassen,035,31185,3,0,1,1,0
2020-03-23,Los Angeles,037,10098052,3450,389,10,399,4
2020-03-23,Madera,039,155013,36,4,0,4,0
2020-03-23,Marin,041,260295,84,30,0,30,0
2020-03-23,Mariposa,043,17540,0,0,0,0,0
2020-03-23,Mendocino,045,87422,3,1,0,1,0
2020-03-23,Merced,047,269075,11,0,0,0,0
2020-03-23,Modoc,049,8938,0,0,0,0,0
2020-03-23,Mono,051,14174,19,1,0,1,0
2020-03-23,Monterey,053,433212,54,14,0,14,1
2020-03-23,Napa,055,140530,21,1,0,1,0
2020-03-23,Nevada,057,99092,27,2,1,3,0
2020-03-23,Orange,059,3164182,883,138,7,145,0
2020-03-23,Placer,061,380077,90,19,0,19,1
2020-03-23,Plumas,063,18699,0,0,0,0,0
2020-03-23,Riverside,065,2383286,703,39,12,51,5
2020-03-23,Sacramento,067,1510023,393,87,0,87,4
2020-03-23,San Benito,069,59416,24,4,0,4,1
2020-03-23,San Bernardino,071,2135413,334,17,0,17,0
2020-03-23,San Diego,073,3302833,1066,178,0,178,1
2020-03-23,San Francisco,075,870044,492,152,0,152,0
2020-03-23,San Joaquin,077,732212,154,37,3,40,2
2020-03-23,San Luis Obispo,079,281455,96,23,0,23,0
2020-03-23,San Mateo,081,765935,497,88,2,90,1
2020-03-23,Santa Barbara,083,443738,133,18,1,19,0
2020-03-23,Santa Clara,085,1922200,1076,336,2,338,13
2020-03-23,Santa Cruz,087,273765,65,21,0,21,0
2020-03-23,Shasta,089,179085,13,2,0,2,0
2020-03-23,Sierra,091,2930,0,0,0,0,0
2020-03-23,Siskiyou,093,43540,4,2,0,2,0
2020-03-23,Solano,095,438530,74,33,0,33,0
2020-03-23,Sonoma,097,501317,104,19,0,19,1
2020-03-23,Stanislaus,099,539301,57,10,3,13,0
2020-03-23,Sutter,101,95872,9,0,0,0,0
2020-03-23,Tehama,103,63373,1,0,0,0,0
2020-03-23,Trinity,105,12862,0,0,0,0,0
2020-03-23,Tulare,107,460477,68,9,3,12,0
2020-03-23,Tuolumne,109,53932,2,0,0,0,0
2020-03-23,Ventura,111,848112,196,30,0,30,0
2020-03-23,Yolo,113,214977,40,8,0,8,0
2020-03-23,Yuba,115,75493,7,2,0,2,0
2020-03-22,Alameda,001,1643700,435,72,1,73,1
2020-03-22,Alpine,003,1148,1,0,0,0,0
2020-03-22,Amador,005,37829,2,1,0,1,0
2020-03-22,Butte,007,227075,8,1,0,1,0
2020-03-22,Calaveras,009,45235,4,2,0,2,0
2020-03-22,Colusa,011,21464,1,0,0,0,0
2020-03-22,Contra Costa,013,1133247,313,79,0,79,1
2020-03-22,Del Norte,015,27424,0,0,0,0,0
2020-03-22,El Dorado,017,186661,24,1,0,1,0
2020-03-22,Fresno,019,978130,103,8,2,10,0
2020-03-22,Glenn,021,27897,2,0,0,0,0
2020-03-22,Humboldt,023,135768,28,1,0,1,0
2020-03-22,Imperial,025,180216,48,2,0,2,0
2020-03-22,Inyo,027,18085,1,0,0,0,0
2020-03-22,Kern,029,883053,114,3,0,3,0
2020-03-22,Kings,031,150075,22,0,1,1,0
2020-03-22,Lake,033,64148,0,0,0,0,0
2020-03-22,Lassen,035,31185,3,0,1,1,0
2020-03-22,Los Angeles,037,10098052,3120,384,10,394,3
2020-03-22,Madera,039,155013,33,4,0,4,0
2020-03-22,Marin,041,260295,74,30,0,30,0
2020-03-22,Mariposa,043,17540,0,0,0,0,0
2020-03-22,Mendocino,045,87422,3,1,0,1,0
2020-03-22,Merced,047,269075,7,0,0,0,0
2020-03-22,Modoc,049,8938,0,0,0,0,0
2020-03-22,Mono,051,14174,14,1,0,1,0
2020-03-22,Monterey,053,433212,51,14,0,14,1
2020-03-22,Napa,055,140530,17,1,0,1,0
2020-03-22,Nevada,057,99092,23,2,1,3,0
2020-03-22,Orange,059,3164182,810,102,4,106,0
2020-03-22,Placer,061,380077,88,18,0,18,1
2020-03-22,Plumas,063,18699,0,0,0,0,0
2020-03-22,Riverside,065,2383286,613,26,8,34,5
2020-03-22,Sacramento,067,1510023,361,82,0,82,4
2020-03-22,San Benito,069,59416,19,4,0,4,1
2020-03-22,San Bernardino,071,2135413,290,16,0,16,0
2020-03-22,San Diego,073,3302833,978,161,0,161,0
2020-03-22,San Francisco,075,870044,455,134,0,134,0
2020-03-22,San Joaquin,077,732212,140,30,3,33,2
2020-03-22,San Luis Obispo,079,281455,89,19,0,19,0
2020-03-22,San Mateo,081,765935,464,82,2,84,1
2020-03-22,Santa Barbara,083,443738,119,16,1,17,0
2020-03-22,Santa Clara,085,1922200,1012,284,2,286,13
2020-03-22,Santa Cruz,087,273765,64,19,0,19,0
2020-03-22,Shasta,089,179085,13,1,0,1,0
2020-03-22,Sierra,091,2930,0,0,0,0,0
2020-03-22,Siskiyou,093,43540,4,2,0,2,0
2020-03-22,Solano,095,438530,65,30,0,30,0
2020-03-22,Sonoma,097,501317,99,18,0,18,1
2020-03-22,Stanislaus,099,539301,51,8,3,11,0
2020-03-22,Sutter,101,95872,8,0,0,0,0
2020-03-22,Tehama,103,63373,0,0,0,0,0
2020-03-22,Trinity,105,12862,0,0,0,0,0
2020-03-22,Tulare,107,460477,62,5,3,8,0
2020-03-22,Tuolumne,109,53932,2,0,0,0,0
2020-03-22,Ventura,111,848112,174,26,0,26,0
2020-03-22,Yolo,113,214977,34,6,0,6,0
2020-03-22,Yuba,115,75493,7,2,0,2,0
2020-03-21,Alameda,001,1643700,411,62,1,63,0
2020-03-21,Alpine,003,1148,1,0,0,0,0
2020-03-21,Amador,005,37829,2,1,0,1,0
2020-03-21,Butte,007,227075,7,1,0,1,0
2020-03-21,Calaveras,009,45235,4,2,0,2,0
2020-03-21,Colusa,011,21464,1,0,0,0,0
2020-03-21,Contra Costa,013,1133247,302,62,0,62,1
2020-03-21,Del Norte,015,27424,0,0,0,0,0
2020-03-21,El Dorado,017,186661,21,1,0,1,0
2020-03-21,Fresno,019,978130,99,8,2,10,0
2020-03-21,Glenn,021,27897,2,0,0,0,0
2020-03-21,Humboldt,023,135768,25,1,0,1,0
2020-03-21,Imperial,025,180216,44,2,0,2,0
2020-03-21,Inyo,027,18085,1,0,0,0,0
2020-03-21,Kern,029,883053,108,3,0,3,0
2020-03-21,Kings,031,150075,22,0,1,1,0
2020-03-21,Lake,033,64148,0,0,0,0,0
2020-03-21,Lassen,035,31185,3,0,1,1,0
2020-03-21,Los Angeles,037,10098052,2843,322,10,332,2
2020-03-21,Madera,039,155013,33,4,0,4,0
2020-03-21,Marin,041,260295,69,30,0,30,0
2020-03-21,Mariposa,043,17540,0,0,0,0,0
2020-03-21,Mendocino,045,87422,3,1,0,1,0
2020-03-21,Merced,047,269075,6,0,0,0,0
2020-03-21,Modoc,049,8938,0,0,0,0,0
2020-03-21,Mono,051,14174,14,1,0,1,0
2020-03-21,Monterey,053,433212,48,8,0,8,1
2020-03-21,Napa,055,140530,17,0,0,0,0
2020-03-21,Nevada,057,99092,23,2,1,3,0
2020-03-21,Orange,059,3164182,761,85,4,89,0
2020-03-21,Placer,061,380077,78,11,0,11,1
2020-03-21,Plumas,063,18699,0,0,0,0,0
2020-03-21,Riverside,065,2383286,566,20,8,28,3
2020-03-21,Sacramento,067,1510023,334,66,0,66,3
2020-03-21,San Benito,069,59416,17,4,0,4,1
2020-03-21,San Bernardino,071,2135413,270,13,0,13,0
2020-03-21,San Diego,073,3302833,901,121,0,121,0
2020-03-21,San Francisco,075,870044,419,106,0,106,0
2020-03-21,San Joaquin,077,732212,131,26,3,29,2
2020-03-21,San Luis Obispo,079,281455,84,16,0,16,0
2020-03-21,San Mateo,081,765935,426,78,2,80,1
2020-03-21,Santa Barbara,083,443738,109,8,1,9,0
2020-03-21,Santa Clara,085,1922200,950,269,2,271,10
2020-03-21,Santa Cruz,087,273765,62,17,0,17,0
2020-03-21,Shasta,089,179085,12,1,0,1,0
2020-03-21,Sierra,091,2930,0,0,0,0,0
2020-03-21,Siskiyou,093,43540,4,0,0,0,0
2020-03-21,Solano,095,438530,63,30,0,30,0
2020-03-21,Sonoma,097,501317,98,15,0,15,1
2020-03-21,Stanislaus,099,539301,45,7,3,10,0
2020-03-21,Sutter,101,95872,7,0,0,0,0
2020-03-21,Tehama,103,63373,0,0,0,0,0
2020-03-21,Trinity,105,12862,0,0,0,0,0
2020-03-21,Tulare,107,460477,54,5,3,8,0
2020-03-21,Tuolumne,109,53932,2,0,0,0,0
2020-03-21,Ventura,111,848112,166,22,0,22,0
2020-03-21,Yolo,113,214977,34,6,0,6,0
2020-03-21,Yuba,115,75493,7,1,0,1,0
2020-03-20,Alameda,001,1643700,390,42,1,43,0
2020-03-20,Alpine,003,1148,1,0,0,0,0
2020-03-20,Amador,005,37829,1,0,0,0,0
2020-03-20,Butte,007,227075,7,0,0,0,0
2020-03-20,Calaveras,009,45235,4,2,0,2,0
2020-03-20,Colusa,011,21464,1,0,0,0,0
2020-03-20,Contra Costa,013,1133247,272,52,0,52,1
2020-03-20,Del Norte,015,27424,0,0,0,0,0
2020-03-20,El Dorado,017,186661,20,1,0,1,0
2020-03-20,Fresno,019,978130,96,7,2,9,0
2020-03-20,Glenn,021,27897,1,0,0,0,0
2020-03-20,Humboldt,023,135768,25,1,0,1,0
2020-03-20,Imperial,025,180216,43,2,0,2,0
2020-03-20,Inyo,027,18085,0,0,0,0,0
2020-03-20,Kern,029,883053,93,3,0,3,0
2020-03-20,Kings,031,150075,21,0,1,1,0
2020-03-20,Lake,033,64148,0,0,0,0,0
2020-03-20,Lassen,035,31185,3,0,1,1,0
2020-03-20,Los Angeles,037,10098052,2614,267,9,276,1
2020-03-20,Madera,039,155013,32,4,0,4,0
2020-03-20,Marin,041,260295,66,30,0,30,0
2020-03-20,Mariposa,043,17540,0,0,0,0,0
2020-03-20,Mendocino,045,87422,3,1,0,1,0
2020-03-20,Merced,047,269075,6,0,0,0,0
2020-03-20,Modoc,049,8938,0,0,0,0,0
2020-03-20,Mono,051,14174,14,0,0,0,0
2020-03-20,Monterey,053,433212,47,4,0,4,0
2020-03-20,Napa,055,140530,16,0,0,0,0
2020-03-20,Nevada,057,99092,20,2,1,3,0
2020-03-20,Orange,059,3164182,714,71,4,75,2
2020-03-20,Placer,061,380077,72,9,0,9,1
2020-03-20,Plumas,063,18699,0,0,0,0,0
2020-03-20,Riverside,065,2383286,507,19,8,27,3
2020-03-20,Sacramento,067,1510023,313,56,0,56,4
2020-03-20,San Benito,069,59416,17,4,0,4,1
2020-03-20,San Bernardino,071,2135413,243,9,0,9,0
2020-03-20,San Diego,073,3302833,849,98,0,98,0
2020-03-20,San Francisco,075,870044,387,87,0,87,0
2020-03-20,San Joaquin,077,732212,116,18,3,21,2
2020-03-20,San Luis Obispo,079,281455,80,11,0,11,0
2020-03-20,San Mateo,081,765935,396,71,2,73,1
2020-03-20,Santa Barbara,083,443738,97,7,1,8,0
2020-03-20,Santa Clara,085,1922200,914,246,2,248,8
2020-03-20,Santa Cruz,087,273765,60,13,0,13,0
2020-03-20,Shasta,089,179085,11,1,0,1,0
2020-03-20,Sierra,091,2930,0,0,0,0,0
2020-03-20,Siskiyou,093,43540,4,0,0,0,0
2020-03-20,Solano,095,438530,59,29,0,29,0
2020-03-20,Sonoma,097,501317,90,7,0,7,0
2020-03-20,Stanislaus,099,539301,39,7,3,10,0
2020-03-20,Sutter,101,95872,7,0,0,0,0
2020-03-20,Tehama,103,63373,0,0,0,0,0
2020-03-20,Trinity,105,12862,0,0,0,0,0
2020-03-20,Tulare,107,460477,50,4,3,7,0
2020-03-20,Tuolumne,109,53932,2,0,0,0,0
2020-03-20,Ventura,111,848112,156,18,0,18,0
2020-03-20,Yolo,113,214977,32,5,0,5,0
2020-03-20,Yuba,115,75493,6,0,0,0,0
2020-03-19,Alameda,001,1643700,354,36,1,37,0
2020-03-19,Alpine,003,1148,1,0,0,0,0
2020-03-19,Amador,005,37829,1,0,0,0,0
2020-03-19,Butte,007,227075,5,0,0,0,0
2020-03-19,Calaveras,009,45235,4,2,0,2,0
2020-03-19,Colusa,011,21464,0,0,0,0,0
2020-03-19,Contra Costa,013,1133247,256,46,0,46,0
2020-03-19,Del Norte,015,27424,0,0,0,0,0
2020-03-19,El Dorado,017,186661,18,0,0,0,0
2020-03-19,Fresno,019,978130,87,6,2,8,0
2020-03-19,Glenn,021,27897,1,0,0,0,0
2020-03-19,Humboldt,023,135768,23,1,0,1,0
2020-03-19,Imperial,025,180216,36,2,0,2,0
2020-03-19,Inyo,027,18085,0,0,0,0,0
2020-03-19,Kern,029,883053,81,3,0,3,0
2020-03-19,Kings,031,150075,17,0,1,1,0
2020-03-19,Lake,033,64148,0,0,0,0,0
2020-03-19,Lassen,035,31185,2,0,1,1,0
2020-03-19,Los Angeles,037,10098052,2323,233,9,242,0
2020-03-19,Madera,039,155013,31,3,0,3,0
2020-03-19,Marin,041,260295,63,19,0,19,0
2020-03-19,Mariposa,043,17540,0,0,0,0,0
2020-03-19,Mendocino,045,87422,2,1,0,1,0
2020-03-19,Merced,047,269075,5,0,0,0,0
2020-03-19,Modoc,049,8938,0,0,0,0,0
2020-03-19,Mono,051,14174,12,0,0,0,0
2020-03-19,Monterey,053,433212,39,3,0,3,0
2020-03-19,Napa,055,140530,14,0,0,0,0
2020-03-19,Nevada,057,99092,18,2,1,3,0
2020-03-19,Orange,059,3164182,633,59,4,63,0
2020-03-19,Placer,061,380077,64,8,0,8,1
2020-03-19,Plumas,063,18699,0,0,0,0,0
2020-03-19,Riverside,065,2383286,396,14,6,20,3
2020-03-19,Sacramento,067,1510023,280,52,0,52,3
2020-03-19,San Benito,069,59416,14,3,0,3,0
2020-03-19,San Bernardino,071,2135413,213,7,0,7,0
2020-03-19,San Diego,073,3302833,766,68,0,68,0
2020-03-19,San Francisco,075,870044,351,80,0,80,0
2020-03-19,San Joaquin,077,732212,102,15,3,18,2
2020-03-19,San Luis Obispo,079,281455,77,6,0,6,0
2020-03-19,San Mateo,081,765935,361,58,2,60,1
2020-03-19,Santa Barbara,083,443738,85,5,0,5,0
2020-03-19,Santa Clara,085,1922200,847,183,2,185,8
2020-03-19,Santa Cruz,087,273765,57,13,0,13,0
2020-03-19,Shasta,089,179085,10,1,0,1,0
2020-03-19,Sierra,091,2930,0,0,0,0,0
2020-03-19,Siskiyou,093,43540,3,0,0,0,0
2020-03-19,Solano,095,438530,55,26,0,26,0
2020-03-19,Sonoma,097,501317,87,8,0,8,0
2020-03-19,Stanislaus,099,539301,38,7,3,10,0
2020-03-19,Sutter,101,95872,7,0,0,0,0
2020-03-19,Tehama,103,63373,0,0,0,0,0
2020-03-19,Trinity,105,12862,0,0,0,0,0
2020-03-19,Tulare,107,460477,44,3,3,6,0
2020-03-19,Tuolumne,109,53932,2,0,0,0,0
2020-03-19,Ventura,111,848112,134,15,0,15,0
2020-03-19,Yolo,113,214977,28,5,0,5,0
2020-03-19,Yuba,115,75493,5,0,0,0,0
2020-03-18,Alameda,001,1643700,325,29,1,30,0
2020-03-18,Alpine,003,1148,1,0,0,0,0
2020-03-18,Amador,005,37829,1,0,0,0,0
2020-03-18,Butte,007,227075,4,0,0,0,0
2020-03-18,Calaveras,009,45235,4,2,0,2,0
2020-03-18,Colusa,011,21464,0,0,0,0,0
2020-03-18,Contra Costa,013,1133247,234,44,0,44,0
2020-03-18,Del Norte,015,27424,0,0,0,0,0
2020-03-18,El Dorado,017,186661,17,0,0,0,0
2020-03-18,Fresno,019,978130,78,3,1,4,0
2020-03-18,Glenn,021,27897,1,0,0,0,0
2020-03-18,Humboldt,023,135768,19,1,0,1,0
2020-03-18,Imperial,025,180216,30,2,0,2,0
2020-03-18,Inyo,027,18085,0,0,0,0,0
2020-03-18,Kern,029,883053,66,1,0,1,0
2020-03-18,Kings,031,150075,15,0,1,1,0
2020-03-18,Lake,033,64148,0,0,0,0,0
2020-03-18,Lassen,035,31185,1,0,1,1,0
2020-03-18,Los Angeles,037,10098052,2077,47,9,56,0
2020-03-18,Madera,039,155013,30,2,0,2,0
2020-03-18,Marin,041,260295,58,10,0,10,0
2020-03-18,Mariposa,043,17540,0,0,0,0,0
2020-03-18,Mendocino,045,87422,2,0,0,0,0
2020-03-18,Merced,047,269075,5,0,0,0,0
2020-03-18,Modoc,049,8938,0,0,0,0,0
2020-03-18,Mono,051,14174,11,0,0,0,0
2020-03-18,Monterey,053,433212,31,1,0,1,0
2020-03-18,Napa,055,140530,11,0,0,0,0
2020-03-18,Nevada,057,99092,16,2,1,3,0
2020-03-18,Orange,059,3164182,575,38,4,42,0
2020-03-18,Placer,061,380077,57,8,0,8,1
2020-03-18,Plumas,063,18699,0,0,0,0,0
2020-03-18,Riverside,065,2383286,333,11,5,16,2
2020-03-18,Sacramento,067,1510023,257,46,0,46,3
2020-03-18,San Benito,069,59416,13,3,0,3,0
2020-03-18,San Bernardino,071,2135413,191,3,0,3,0
2020-03-18,San Diego,073,3302833,681,40,0,40,0
2020-03-18,San Francisco,075,870044,332,65,0,65,0
2020-03-18,San Joaquin,077,732212,90,14,3,17,2
2020-03-18,San Luis Obispo,079,281455,70,5,0,5,0
2020-03-18,San Mateo,081,765935,340,57,2,59,1
2020-03-18,Santa Barbara,083,443738,77,2,0,2,0
2020-03-18,Santa Clara,085,1922200,796,151,2,153,6
2020-03-18,Santa Cruz,087,273765,55,11,0,11,0
2020-03-18,Shasta,089,179085,9,1,0,1,0
2020-03-18,Sierra,091,2930,0,0,0,0,0
2020-03-18,Siskiyou,093,43540,3,0,0,0,0
2020-03-18,Solano,095,438530,51,26,0,26,0
2020-03-18,Sonoma,097,501317,78,6,0,6,0
2020-03-18,Stanislaus,099,539301,34,5,2,7,0
2020-03-18,Sutter,101,95872,5,0,0,0,0
2020-03-18,Tehama,103,63373,0,0,0,0,0
2020-03-18,Trinity,105,12862,0,0,0,0,0
2020-03-18,Tulare,107,460477,34,3,3,6,0
2020-03-18,Tuolumne,109,53932,2,0,0,0,0
2020-03-18,Ventura,111,848112,115,11,0,11,0
2020-03-18,Yolo,113,214977,25,4,0,4,0
2020-03-18,Yuba,115,75493,4,0,0,0,0
2020-03-17,Alameda,001,1643700,293,19,0,19,0
2020-03-17,Alpine,003,1148,0,0,0,0,0
2020-03-17,Amador,005,37829,1,0,0,0,0
2020-03-17,Butte,007,227075,4,0,0,0,0
2020-03-17,Calaveras,009,45235,4,2,0,2,0
2020-03-17,Colusa,011,21464,0,0,0,0,0
2020-03-17,Contra Costa,013,1133247,212,37,0,37,0
2020-03-17,Del Norte,015,27424,0,0,0,0,0
2020-03-17,El Dorado,017,186661,16,0,0,0,0
2020-03-17,Fresno,019,978130,68,2,1,3,0
2020-03-17,Glenn,021,27897,1,0,0,0,0
2020-03-17,Humboldt,023,135768,17,1,0,1,0
2020-03-17,Imperial,025,180216,24,2,0,2,0
2020-03-17,Inyo,027,18085,0,0,0,0,0
2020-03-17,Kern,029,883053,52,0,0,0,0
2020-03-17,Kings,031,150075,12,0,1,1,0
2020-03-17,Lake,033,64148,0,0,0,0,0
2020-03-17,Lassen,035,31185,1,0,1,1,0
2020-03-17,Los Angeles,037,10098052,1868,41,9,50,0
2020-03-17,Madera,039,155013,22,2,0,2,0
2020-03-17,Marin,041,260295,51,4,0,4,0
2020-03-17,Mariposa,043,17540,0,0,0,0,0
2020-03-17,Mendocino,045,87422,2,0,0,0,0
2020-03-17,Merced,047,269075,5,0,0,0,0
2020-03-17,Modoc,049,8938,0,0,0,0,0
2020-03-17,Mono,051,14174,9,0,0,0,0
2020-03-17,Monterey,053,433212,29,0,0,0,0
2020-03-17,Napa,055,140530,8,0,0,0,0
2020-03-17,Nevada,057,99092,15,1,1,2,0
2020-03-17,Orange,059,3164182,497,24,3,27,0
2020-03-17,Placer,061,380077,47,7,0,7,1
2020-03-17,Plumas,063,18699,0,0,0,0,0
2020-03-17,Riverside,065,2383286,271,11,5,16,0
2020-03-17,Sacramento,067,1510023,237,36,0,36,1
2020-03-17,San Benito,069,59416,12,2,0,2,0
2020-03-17,San Bernardino,071,2135413,163,2,0,2,0
2020-03-17,San Diego,073,3302833,614,17,0,17,0
2020-03-17,San Francisco,075,870044,305,46,0,46,0
2020-03-17,San Joaquin,077,732212,84,11,3,14,0
2020-03-17,San Luis Obispo,079,281455,62,1,0,1,0
2020-03-17,San Mateo,081,765935,308,46,2,48,1
2020-03-17,Santa Barbara,083,443738,65,0,0,0,0
2020-03-17,Santa Clara,085,1922200,738,121,2,123,4
2020-03-17,Santa Cruz,087,273765,52,10,0,10,0
2020-03-17,Shasta,089,179085,5,1,0,1,0
2020-03-17,Sierra,091,2930,0,0,0,0,0
2020-03-17,Siskiyou,093,43540,3,0,0,0,0
2020-03-17,Solano,095,438530,48,27,0,27,0
2020-03-17,Sonoma,097,501317,70,4,0,4,0
2020-03-17,Stanislaus,099,539301,31,4,2,6,0
2020-03-17,Sutter,101,95872,5,0,0,0,0
2020-03-17,Tehama,103,63373,0,0,0,0,0
2020-03-17,Trinity,105,12862,0,0,0,0,0
2020-03-17,Tulare,107,460477,29,2,3,5,0
2020-03-17,Tuolumne,109,53932,2,0,0,0,0
2020-03-17,Ventura,111,848112,98,7,0,7,0
2020-03-17,Yolo,113,214977,21,2,0,2,0
2020-03-17,Yuba,115,75493,4,0,0,0,0
2020-03-16,Alameda,001,1643700,264,17,0,17,0
2020-03-16,Alpine,003,1148,0,0,0,0,0
2020-03-16,Amador,005,37829,1,0,0,0,0
2020-03-16,Butte,007,227075,3,0,0,0,0
2020-03-16,Calaveras,009,45235,4,2,0,2,0
2020-03-16,Colusa,011,21464,0,0,0,0,0
2020-03-16,Contra Costa,013,1133247,188,36,0,36,0
2020-03-16,Del Norte,015,27424,0,0,0,0,0
2020-03-16,El Dorado,017,186661,15,0,0,0,0
2020-03-16,Fresno,019,978130,53,2,1,3,0
2020-03-16,Glenn,021,27897,0,0,0,0,0
2020-03-16,Humboldt,023,135768,13,1,0,1,0
2020-03-16,Imperial,025,180216,19,2,0,2,0
2020-03-16,Inyo,027,18085,0,0,0,0,0
2020-03-16,Kern,029,883053,43,0,0,0,0
2020-03-16,Kings,031,150075,11,0,1,1,0
2020-03-16,Lake,033,64148,0,0,0,0,0
2020-03-16,Lassen,035,31185,1,0,0,0,0
2020-03-16,Los Angeles,037,10098052,1630,43,9,52,0
2020-03-16,Madera,039,155013,21,2,0,2,0
2020-03-16,Marin,041,260295,48,4,0,4,0
2020-03-16,Mariposa,043,17540,0,0,0,0,0
2020-03-16,Mendocino,045,87422,2,0,0,0,0
2020-03-16,Merced,047,269075,5,0,0,0,0
2020-03-16,Modoc,049,8938,0,0,0,0,0
2020-03-16,Mono,051,14174,7,0,0,0,0
2020-03-16,Monterey,053,433212,28,0,0,0,0
2020-03-16,Napa,055,140530,7,0,0,0,0
2020-03-16,Nevada,057,99092,11,1,1,2,0
2020-03-16,Orange,059,3164182,414,18,3,21,0
2020-03-16,Placer,061,380077,39,7,0,7,1
2020-03-16,Plumas,063,18699,0,0,0,0,0
2020-03-16,Riverside,065,2383286,235,10,5,15,0
2020-03-16,Sacramento,067,1510023,210,34,0,34,1
2020-03-16,San Benito,069,59416,8,2,0,2,0
2020-03-16,San Bernardino,071,2135413,143,1,0,1,0
2020-03-16,San Diego,073,3302833,523,17,0,17,0
2020-03-16,San Francisco,075,870044,267,40,0,40,0
2020-03-16,San Joaquin,077,732212,74,9,3,12,0
2020-03-16,San Luis Obispo,079,281455,55,1,0,1,0
2020-03-16,San Mateo,081,765935,269,42,2,44,1
2020-03-16,Santa Barbara,083,443738,55,0,0,0,0
2020-03-16,Santa Clara,085,1922200,658,115,1,116,2
2020-03-16,Santa Cruz,087,273765,45,9,0,9,0
2020-03-16,Shasta,089,179085,5,1,0,1,0
2020-03-16,Sierra,091,2930,0,0,0,0,0
2020-03-16,Siskiyou,093,43540,2,0,0,0,0
2020-03-16,Solano,095,438530,43,27,0,27,0
2020-03-16,Sonoma,097,501317,62,4,0,4,0
2020-03-16,Stanislaus,099,539301,27,2,2,4,0
2020-03-16,Sutter,101,95872,3,0,0,0,0
2020-03-16,Tehama,103,63373,0,0,0,0,0
2020-03-16,Trinity,105,12862,0,0,0,0,0
2020-03-16,Tulare,107,460477,25,2,3,5,0
2020-03-16,Tuolumne,109,53932,2,0,0,0,0
2020-03-16,Ventura,111,848112,88,7,0,7,0
2020-03-16,Yolo,113,214977,19,2,0,2,0
2020-03-16,Yuba,115,75493,3,0,0,0,0
2020-03-15,Alameda,001,1643700,216,17,0,17,0
2020-03-15,Alpine,003,1148,0,0,0,0,0
2020-03-15,Amador,005,37829,1,0,0,0,0
2020-03-15,Butte,007,227075,3,0,0,0,0
2020-03-15,Calaveras,009,45235,2,2,0,2,0
2020-03-15,Colusa,011,21464,0,0,0,0,0
2020-03-15,Contra Costa,013,1133247,163,34,0,34,0
2020-03-15,Del Norte,015,27424,0,0,0,0,0
2020-03-15,El Dorado,017,186661,14,0,0,0,0
2020-03-15,Fresno,019,978130,33,1,1,2,0
2020-03-15,Glenn,021,27897,0,0,0,0,0
2020-03-15,Humboldt,023,135768,11,1,0,1,0
2020-03-15,Imperial,025,180216,14,2,0,2,0
2020-03-15,Inyo,027,18085,0,0,0,0,0
2020-03-15,Kern,029,883053,37,0,0,0,0
2020-03-15,Kings,031,150075,11,0,1,1,0
2020-03-15,Lake,033,64148,0,0,0,0,0
2020-03-15,Lassen,035,31185,1,0,0,0,0
2020-03-15,Los Angeles,037,10098052,1381,41,9,50,0
2020-03-15,Madera,039,155013,20,2,0,2,0
2020-03-15,Marin,041,260295,41,3,0,3,0
2020-03-15,Mariposa,043,17540,0,0,0,0,0
2020-03-15,Mendocino,045,87422,2,0,0,0,0
2020-03-15,Merced,047,269075,3,0,0,0,0
2020-03-15,Modoc,049,8938,0,0,0,0,0
2020-03-15,Mono,051,14174,6,0,0,0,0
2020-03-15,Monterey,053,433212,21,0,0,0,0
2020-03-15,Napa,055,140530,7,0,0,0,0
2020-03-15,Nevada,057,99092,11,0,1,1,0
2020-03-15,Orange,059,3164182,346,16,1,17,0
2020-03-15,Placer,061,380077,33,7,0,7,1
2020-03-15,Plumas,063,18699,0,0,0,0,0
2020-03-15,Riverside,065,2383286,183,10,5,15,0
2020-03-15,Sacramento,067,1510023,174,30,0,30,1
2020-03-15,San Benito,069,59416,8,2,0,2,0
2020-03-15,San Bernardino,071,2135413,121,0,0,0,0
2020-03-15,San Diego,073,3302833,436,16,0,16,0
2020-03-15,San Francisco,075,870044,209,31,0,31,0
2020-03-15,San Joaquin,077,732212,63,6,3,9,0
2020-03-15,San Luis Obispo,079,281455,45,1,0,1,0
2020-03-15,San Mateo,081,765935,235,29,1,30,1
2020-03-15,Santa Barbara,083,443738,46,0,0,0,0
2020-03-15,Santa Clara,085,1922200,586,79,1,80,2
2020-03-15,Santa Cruz,087,273765,38,8,0,8,0
2020-03-15,Shasta,089,179085,5,1,0,1,0
2020-03-15,Sierra,091,2930,0,0,0,0,0
2020-03-15,Siskiyou,093,43540,2,0,0,0,0
2020-03-15,Solano,095,438530,42,26,0,26,0
2020-03-15,Sonoma,097,501317,53,4,0,4,0
2020-03-15,Stanislaus,099,539301,26,2,2,4,0
2020-03-15,Sutter,101,95872,2,0,0,0,0
2020-03-15,Tehama,103,63373,0,0,0,0,0
2020-03-15,Trinity,105,12862,0,0,0,0,0
2020-03-15,Tulare,107,460477,19,2,3,5,0
2020-03-15,Tuolumne,109,53932,1,0,0,0,0
2020-03-15,Ventura,111,848112,77,5,0,5,0
2020-03-15,Yolo,113,214977,15,2,0,2,0
2020-03-15,Yuba,115,75493,2,0,0,0,0
2020-03-14,Alameda,001,1643700,197,11,0,11,0
2020-03-14,Alpine,003,1148,0,0,0,0,0
2020-03-14,Amador,005,37829,1,0,0,0,0
2020-03-14,Butte,007,227075,2,0,0,0,0
2020-03-14,Calaveras,009,45235,2,2,0,2,0
2020-03-14,Colusa,011,21464,0,0,0,0,0
2020-03-14,Contra Costa,013,1133247,141,30,0,30,0
2020-03-14,Del Norte,015,27424,0,0,0,0,0
2020-03-14,El Dorado,017,186661,12,0,0,0,0
2020-03-14,Fresno,019,978130,25,1,1,2,0
2020-03-14,Glenn,021,27897,0,0,0,0,0
2020-03-14,Humboldt,023,135768,7,1,0,1,0
2020-03-14,Imperial,025,180216,10,2,0,2,0
2020-03-14,Inyo,027,18085,0,0,0,0,0
2020-03-14,Kern,029,883053,32,0,0,0,0
2020-03-14,Kings,031,150075,11,0,1,1,0
2020-03-14,Lake,033,64148,0,0,0,0,0
2020-03-14,Lassen,035,31185,1,0,0,0,0
2020-03-14,Los Angeles,037,10098052,1199,35,9,44,0
2020-03-14,Madera,039,155013,19,2,0,2,0
2020-03-14,Marin,041,260295,37,3,0,3,0
2020-03-14,Mariposa,043,17540,0,0,0,0,0
2020-03-14,Mendocino,045,87422,2,0,0,0,0
2020-03-14,Merced,047,269075,3,0,0,0,0
2020-03-14,Modoc,049,8938,0,0,0,0,0
2020-03-14,Mono,051,14174,5,0,0,0,0
2020-03-14,Monterey,053,433212,15,0,0,0,0
2020-03-14,Napa,055,140530,5,0,0,0,0
2020-03-14,Nevada,057,99092,8,0,1,1,0
2020-03-14,Orange,059,3164182,307,14,0,14,0
2020-03-14,Placer,061,380077,29,6,0,6,1
2020-03-14,Plumas,063,18699,0,0,0,0,0
2020-03-14,Riverside,065,2383286,163,10,5,15,0
2020-03-14,Sacramento,067,1510023,152,31,0,31,1
2020-03-14,San Benito,069,59416,8,2,0,2,0
2020-03-14,San Bernardino,071,2135413,102,0,0,0,0
2020-03-14,San Diego,073,3302833,361,10,0,10,0
2020-03-14,San Francisco,075,870044,188,29,0,29,0
2020-03-14,San Joaquin,077,732212,54,6,3,9,0
2020-03-14,San Luis Obispo,079,281455,40,0,0,0,0
2020-03-14,San Mateo,081,765935,212,27,1,28,0
2020-03-14,Santa Barbara,083,443738,37,0,0,0,0
2020-03-14,Santa Clara,085,1922200,531,62,1,63,2
2020-03-14,Santa Cruz,087,273765,33,8,0,8,0
2020-03-14,Shasta,089,179085,5,1,0,1,0
2020-03-14,Sierra,091,2930,0,0,0,0,0
2020-03-14,Siskiyou,093,43540,1,0,0,0,0
2020-03-14,Solano,095,438530,40,26,0,26,0
2020-03-14,Sonoma,097,501317,40,2,0,2,0
2020-03-14,Stanislaus,099,539301,22,2,2,4,0
2020-03-14,Sutter,101,95872,2,0,0,0,0
2020-03-14,Tehama,103,63373,0,0,0,0,0
2020-03-14,Trinity,105,12862,0,0,0,0,0
2020-03-14,Tulare,107,460477,17,2,2,4,0
2020-03-14,Tuolumne,109,53932,1,0,0,0,0
2020-03-14,Ventura,111,848112,68,5,0,5,0
2020-03-14,Yolo,113,214977,15,2,0,2,0
2020-03-14,Yuba,115,75493,1,0,0,0,0
2020-03-13,Alameda,001,1643700,178,12,0,12,0
2020-03-13,Alpine,003,1148,0,0,0,0,0
2020-03-13,Amador,005,37829,1,0,0,0,0
2020-03-13,Butte,007,227075,0,0,0,0,0
2020-03-13,Calaveras,009,45235,2,2,0,2,0
2020-03-13,Colusa,011,21464,0,0,0,0,0
2020-03-13,Contra Costa,013,1133247,127,22,0,22,0
2020-03-13,Del Norte,015,27424,0,0,0,0,0
2020-03-13,El Dorado,017,186661,11,0,0,0,0
2020-03-13,Fresno,019,978130,20,1,1,2,0
2020-03-13,Glenn,021,27897,0,0,0,0,0
2020-03-13,Humboldt,023,135768,7,1,0,1,0
2020-03-13,Imperial,025,180216,9,2,0,2,0
2020-03-13,Inyo,027,18085,0,0,0,0,0
2020-03-13,Kern,029,883053,27,0,0,0,0
2020-03-13,Kings,031,150075,10,0,1,1,0
2020-03-13,Lake,033,64148,0,0,0,0,0
2020-03-13,Lassen,035,31185,1,0,0,0,0
2020-03-13,Los Angeles,037,10098052,1042,30,7,37,0
2020-03-13,Madera,039,155013,18,1,0,1,0
2020-03-13,Marin,041,260295,34,3,0,3,0
2020-03-13,Mariposa,043,17540,0,0,0,0,0
2020-03-13,Mendocino,045,87422,2,0,0,0,0
2020-03-13,Merced,047,269075,2,0,0,0,0
2020-03-13,Modoc,049,8938,0,0,0,0,0
2020-03-13,Mono,051,14174,3,0,0,0,0
2020-03-13,Monterey,053,433212,10,0,0,0,0
2020-03-13,Napa,055,140530,3,0,0,0,0
2020-03-13,Nevada,057,99092,7,0,1,1,0
2020-03-13,Orange,059,3164182,267,10,0,10,0
2020-03-13,Placer,061,380077,27,6,0,6,1
2020-03-13,Plumas,063,18699,0,0,0,0,0
2020-03-13,Riverside,065,2383286,133,5,4,9,0
2020-03-13,Sacramento,067,1510023,130,18,0,18,1
2020-03-13,San Benito,069,59416,6,2,0,2,0
2020-03-13,San Bernardino,071,2135413,96,0,0,0,0
2020-03-13,San Diego,073,3302833,311,8,0,8,0
2020-03-13,San Francisco,075,870044,174,28,0,28,0
2020-03-13,San Joaquin,077,732212,50,6,3,9,0
2020-03-13,San Luis Obispo,079,281455,33,0,0,0,0
2020-03-13,San Mateo,081,765935,191,24,1,25,0
2020-03-13,Santa Barbara,083,443738,33,0,0,0,0
2020-03-13,Santa Clara,085,1922200,469,59,1,60,1
2020-03-13,Santa Cruz,087,273765,32,7,0,7,0
2020-03-13,Shasta,089,179085,3,1,0,1,0
2020-03-13,Sierra,091,2930,0,0,0,0,0
2020-03-13,Siskiyou,093,43540,0,0,0,0,0
2020-03-13,Solano,095,438530,39,26,0,26,0
2020-03-13,Sonoma,097,501317,39,2,0,2,0
2020-03-13,Stanislaus,099,539301,17,2,2,4,0
2020-03-13,Sutter,101,95872,2,0,0,0,0
2020-03-13,Tehama,103,63373,0,0,0,0,0
2020-03-13,Trinity,105,12862,0,0,0,0,0
2020-03-13,Tulare,107,460477,14,2,2,4,0
2020-03-13,Tuolumne,109,53932,1,0,0,0,0
2020-03-13,Ventura,111,848112,54,5,0,5,0
2020-03-13,Yolo,113,214977,14,1,0,1,0
2020-03-13,Yuba,115,75493,1,0,0,0,0
2020-03-12,Alameda,001,1643700,153,9,0,9,0
2020-03-12,Alpine,003,1148,0,0,0,0,0
2020-03-12,Amador,005,37829,1,0,0,0,0
2020-03-12,Butte,007,227075,0,0,0,0,0
2020-03-12,Calaveras,009,45235,2,2,0,2,0
2020-03-12,Colusa,011,21464,0,0,0,0,0
2020-03-12,Contra Costa,013,1133247,110,18,0,18,0
2020-03-12,Del Norte,015,27424,0,0,0,0,0
2020-03-12,El Dorado,017,186661,9,0,0,0,0
2020-03-12,Fresno,019,978130,12,1,1,2,0
2020-03-12,Glenn,021,27897,0,0,0,0,0
2020-03-12,Humboldt,023,135768,6,1,0,1,0
2020-03-12,Imperial,025,180216,8,2,0,2,0
2020-03-12,Inyo,027,18085,0,0,0,0,0
2020-03-12,Kern,029,883053,18,0,0,0,0
2020-03-12,Kings,031,150075,7,0,1,1,0
2020-03-12,Lake,033,64148,0,0,0,0,0
2020-03-12,Lassen,035,31185,1,0,0,0,0
2020-03-12,Los Angeles,037,10098052,878,30,7,37,0
2020-03-12,Madera,039,155013,15,1,0,1,0
2020-03-12,Marin,041,260295,24,1,0,1,0
2020-03-12,Mariposa,043,17540,0,0,0,0,0
2020-03-12,Mendocino,045,87422,2,0,0,0,0
2020-03-12,Merced,047,269075,2,0,0,0,0
2020-03-12,Modoc,049,8938,0,0,0,0,0
2020-03-12,Mono,051,14174,3,0,0,0,0
2020-03-12,Monterey,053,433212,8,0,0,0,0
2020-03-12,Napa,055,140530,3,0,0,0,0
2020-03-12,Nevada,057,99092,4,0,1,1,0
2020-03-12,Orange,059,3164182,230,7,0,7,0
2020-03-12,Placer,061,380077,23,6,0,6,1
2020-03-12,Plumas,063,18699,0,0,0,0,0
2020-03-12,Riverside,065,2383286,107,5,2,7,0
2020-03-12,Sacramento,067,1510023,106,17,0,17,1
2020-03-12,San Benito,069,59416,5,2,0,2,0
2020-03-12,San Bernardino,071,2135413,80,0,0,0,0
2020-03-12,San Diego,073,3302833,256,9,0,9,0
2020-03-12,San Francisco,075,870044,149,20,0,20,0
2020-03-12,San Joaquin,077,732212,44,3,3,6,1
2020-03-12,San Luis Obispo,079,281455,26,0,0,0,0
2020-03-12,San Mateo,081,765935,157,21,1,22,0
2020-03-12,Santa Barbara,083,443738,22,0,0,0,0
2020-03-12,Santa Clara,085,1922200,411,51,1,52,1
2020-03-12,Santa Cruz,087,273765,29,5,0,5,0
2020-03-12,Shasta,089,179085,2,1,0,1,0
2020-03-12,Sierra,091,2930,0,0,0,0,0
2020-03-12,Siskiyou,093,43540,0,0,0,0,0
2020-03-12,Solano,095,438530,34,26,0,26,0
2020-03-12,Sonoma,097,501317,34,2,0,2,0
2020-03-12,Stanislaus,099,539301,15,2,2,4,0
2020-03-12,Sutter,101,95872,0,0,0,0,0
2020-03-12,Tehama,103,63373,0,0,0,0,0
2020-03-12,Trinity,105,12862,0,0,0,0,0
2020-03-12,Tulare,107,460477,12,1,1,2,0
2020-03-12,Tuolumne,109,53932,1,0,0,0,0
2020-03-12,Ventura,111,848112,45,3,0,3,0
2020-03-12,Yolo,113,214977,13,1,0,1,0
2020-03-12,Yuba,115,75493,1,0,0,0,0
2020-03-11,Alameda,001,1643700,122,5,0,5,0
2020-03-11,Alpine,003,1148,0,0,0,0,0
2020-03-11,Amador,005,37829,1,0,0,0,0
2020-03-11,Butte,007,227075,0,0,0,0,0
2020-03-11,Calaveras,009,45235,2,2,0,2,0
2020-03-11,Colusa,011,21464,0,0,0,0,0
2020-03-11,Contra Costa,013,1133247,94,16,0,16,0
2020-03-11,Del Norte,015,27424,0,0,0,0,0
2020-03-11,El Dorado,017,186661,8,0,0,0,0
2020-03-11,Fresno,019,978130,9,1,1,2,0
2020-03-11,Glenn,021,27897,0,0,0,0,0
2020-03-11,Humboldt,023,135768,6,1,0,1,0
2020-03-11,Imperial,025,180216,6,0,0,0,0
2020-03-11,Inyo,027,18085,0,0,0,0,0
2020-03-11,Kern,029,883053,16,0,0,0,0
2020-03-11,Kings,031,150075,5,0,1,1,0
2020-03-11,Lake,033,64148,0,0,0,0,0
2020-03-11,Lassen,035,31185,1,0,0,0,0
2020-03-11,Los Angeles,037,10098052,706,21,7,28,0
2020-03-11,Madera,039,155013,12,1,0,1,0
2020-03-11,Marin,041,260295,17,1,0,1,0
2020-03-11,Mariposa,043,17540,0,0,0,0,0
2020-03-11,Mendocino,045,87422,1,0,0,0,0
2020-03-11,Merced,047,269075,2,0,0,0,0
2020-03-11,Modoc,049,8938,0,0,0,0,0
2020-03-11,Mono,051,14174,3,0,0,0,0
2020-03-11,Monterey,053,433212,7,0,0,0,0
2020-03-11,Napa,055,140530,2,0,0,0,0
2020-03-11,Nevada,057,99092,4,0,1,1,0
2020-03-11,Orange,059,3164182,201,6,0,6,0
2020-03-11,Placer,061,380077,18,6,0,6,1
2020-03-11,Plumas,063,18699,0,0,0,0,0
2020-03-11,Riverside,065,2383286,81,4,1,5,0
2020-03-11,Sacramento,067,1510023,88,9,0,9,1
2020-03-11,San Benito,069,59416,5,2,0,2,0
2020-03-11,San Bernardino,071,2135413,73,0,0,0,0
2020-03-11,San Diego,073,3302833,206,4,0,4,0
2020-03-11,San Francisco,075,870044,124,17,0,17,0
2020-03-11,San Joaquin,077,732212,33,1,3,4,0
2020-03-11,San Luis Obispo,079,281455,23,0,0,0,0
2020-03-11,San Mateo,081,765935,139,16,0,16,0
2020-03-11,Santa Barbara,083,443738,13,0,0,0,0
2020-03-11,Santa Clara,085,1922200,370,48,1,49,1
2020-03-11,Santa Cruz,087,273765,26,2,0,2,0
2020-03-11,Shasta,089,179085,2,1,0,1,0
2020-03-11,Sierra,091,2930,0,0,0,0,0
2020-03-11,Siskiyou,093,43540,0,0,0,0,0
2020-03-11,Solano,095,438530,29,26,0,26,0
2020-03-11,Sonoma,097,501317,30,2,0,2,0
2020-03-11,Stanislaus,099,539301,15,2,2,4,0
2020-03-11,Sutter,101,95872,0,0,0,0,0
2020-03-11,Tehama,103,63373,0,0,0,0,0
2020-03-11,Trinity,105,12862,0,0,0,0,0
2020-03-11,Tulare,107,460477,10,0,1,1,0
2020-03-11,Tuolumne,109,53932,1,0,0,0,0
2020-03-11,Ventura,111,848112,37,3,0,3,0
2020-03-11,Yolo,113,214977,9,1,0,1,0
2020-03-11,Yuba,115,75493,1,0,0,0,0
2020-03-10,Alameda,001,1643700,101,4,0,4,0
2020-03-10,Alpine,003,1148,0,0,0,0,0
2020-03-10,Amador,005,37829,1,0,0,0,0
2020-03-10,Butte,007,227075,0,0,0,0,0
2020-03-10,Calaveras,009,45235,2,2,0,2,0
2020-03-10,Colusa,011,21464,0,0,0,0,0
2020-03-10,Contra Costa,013,1133247,84,11,0,11,0
2020-03-10,Del Norte,015,27424,0,0,0,0,0
2020-03-10,El Dorado,017,186661,7,0,0,0,0
2020-03-10,Fresno,019,978130,7,1,1,2,0
2020-03-10,Glenn,021,27897,0,0,0,0,0
2020-03-10,Humboldt,023,135768,6,1,0,1,0
2020-03-10,Imperial,025,180216,5,0,0,0,0
2020-03-10,Inyo,027,18085,0,0,0,0,0
2020-03-10,Kern,029,883053,11,0,0,0,0
2020-03-10,Kings,031,150075,5,0,1,1,0
2020-03-10,Lake,033,64148,0,0,0,0,0
2020-03-10,Lassen,035,31185,1,0,0,0,0
2020-03-10,Los Angeles,037,10098052,570,20,7,27,0
2020-03-10,Madera,039,155013,7,1,0,1,0
2020-03-10,Marin,041,260295,16,1,0,1,0
2020-03-10,Mariposa,043,17540,0,0,0,0,0
2020-03-10,Mendocino,045,87422,0,0,0,0,0
2020-03-10,Merced,047,269075,2,0,0,0,0
2020-03-10,Modoc,049,8938,0,0,0,0,0
2020-03-10,Mono,051,14174,3,0,0,0,0
2020-03-10,Monterey,053,433212,5,0,0,0,0
2020-03-10,Napa,055,140530,2,0,0,0,0
2020-03-10,Nevada,057,99092,3,0,1,1,0
2020-03-10,Orange,059,3164182,181,5,0,5,1
2020-03-10,Placer,061,380077,14,7,0,7,1
2020-03-10,Plumas,063,18699,0,0,0,0,0
2020-03-10,Riverside,065,2383286,59,4,1,5,0
2020-03-10,Sacramento,067,1510023,79,8,0,8,0
2020-03-10,San Benito,069,59416,5,2,0,2,0
2020-03-10,San Bernardino,071,2135413,65,0,0,0,0
2020-03-10,San Diego,073,3302833,163,3,0,3,0
2020-03-10,San Francisco,075,870044,92,16,0,16,0
2020-03-10,San Joaquin,077,732212,30,1,3,4,0
2020-03-10,San Luis Obispo,079,281455,15,0,0,0,0
2020-03-10,San Mateo,081,765935,123,11,0,11,0
2020-03-10,Santa Barbara,083,443738,10,0,0,0,0
2020-03-10,Santa Clara,085,1922200,322,45,1,46,1
2020-03-10,Santa Cruz,087,273765,22,2,0,2,0
2020-03-10,Shasta,089,179085,2,1,0,1,0
2020-03-10,Sierra,091,2930,0,0,0,0,0
2020-03-10,Siskiyou,093,43540,0,0,0,0,0
2020-03-10,Solano,095,438530,27,26,0,26,0
2020-03-10,Sonoma,097,501317,27,2,0,2,0
2020-03-10,Stanislaus,099,539301,11,0,2,2,0
2020-03-10,Sutter,101,95872,0,0,0,0,0
2020-03-10,Tehama,103,63373,0,0,0,0,0
2020-03-10,Trinity,105,12862,0,0,0,0,0
2020-03-10,Tulare,107,460477,9,0,1,1,0
2020-03-10,Tuolumne,109,53932,1,0,0,0,0
2020-03-10,Ventura,111,848112,29,1,0,1,0
2020-03-10,Yolo,113,214977,6,2,0,2,0
2020-03-10,Yuba,115,75493,1,0,0,0,0
2020-03-09,Alameda,001,1643700,73,4,0,4,0
2020-03-09,Alpine,003,1148,0,0,0,0,0
2020-03-09,Amador,005,37829,0,0,0,0,0
2020-03-09,Butte,007,227075,0,0,0,0,0
2020-03-09,Calaveras,009,45235,2,0,0,0,0
2020-03-09,Colusa,011,21464,0,0,0,0,0
2020-03-09,Contra Costa,013,1133247,72,9,0,9,0
2020-03-09,Del Norte,015,27424,0,0,0,0,0
2020-03-09,El Dorado,017,186661,5,0,0,0,0
2020-03-09,Fresno,019,978130,7,1,1,2,0
2020-03-09,Glenn,021,27897,0,0,0,0,0
2020-03-09,Humboldt,023,135768,5,1,0,1,0
2020-03-09,Imperial,025,180216,5,0,0,0,0
2020-03-09,Inyo,027,18085,0,0,0,0,0
2020-03-09,Kern,029,883053,8,0,0,0,0
2020-03-09,Kings,031,150075,4,0,1,1,0
2020-03-09,Lake,033,64148,0,0,0,0,0
2020-03-09,Lassen,035,31185,1,0,0,0,0
2020-03-09,Los Angeles,037,10098052,465,17,6,23,0
2020-03-09,Madera,039,155013,7,1,0,1,0
2020-03-09,Marin,041,260295,15,1,0,1,0
2020-03-09,Mariposa,043,17540,0,0,0,0,0
2020-03-09,Mendocino,045,87422,0,0,0,0,0
2020-03-09,Merced,047,269075,2,0,0,0,0
2020-03-09,Modoc,049,8938,0,0,0,0,0
2020-03-09,Mono,051,14174,3,0,0,0,0
2020-03-09,Monterey,053,433212,3,0,0,0,0
2020-03-09,Napa,055,140530,2,0,0,0,0
2020-03-09,Nevada,057,99092,2,0,1,1,0
2020-03-09,Orange,059,3164182,153,4,0,4,0
2020-03-09,Placer,061,380077,12,7,0,7,1
2020-03-09,Plumas,063,18699,0,0,0,0,0
2020-03-09,Riverside,065,2383286,49,4,1,5,0
2020-03-09,Sacramento,067,1510023,75,8,0,8,0
2020-03-09,San Benito,069,59416,3,2,0,2,0
2020-03-09,San Bernardino,071,2135413,54,0,0,0,0
2020-03-09,San Diego,073,3302833,124,2,0,2,0
2020-03-09,San Francisco,075,870044,72,14,0,14,0
2020-03-09,San Joaquin,077,732212,21,0,3,3,0
2020-03-09,San Luis Obispo,079,281455,15,0,0,0,0
2020-03-09,San Mateo,081,765935,109,6,0,6,0
2020-03-09,Santa Barbara,083,443738,8,0,0,0,0
2020-03-09,Santa Clara,085,1922200,278,42,1,43,1
2020-03-09,Santa Cruz,087,273765,19,2,0,2,0
2020-03-09,Shasta,089,179085,2,1,0,1,0
2020-03-09,Sierra,091,2930,0,0,0,0,0
2020-03-09,Siskiyou,093,43540,0,0,0,0,0
2020-03-09,Solano,095,438530,25,26,0,26,0
2020-03-09,Sonoma,097,501317,22,2,0,2,0
2020-03-09,Stanislaus,099,539301,11,0,2,2,0
2020-03-09,Sutter,101,95872,0,0,0,0,0
2020-03-09,Tehama,103,63373,0,0,0,0,0
2020-03-09,Trinity,105,12862,0,0,0,0,0
2020-03-09,Tulare,107,460477,9,0,1,1,0
2020-03-09,Tuolumne,109,53932,1,0,0,0,0
2020-03-09,Ventura,111,848112,25,1,0,1,0
2020-03-09,Yolo,113,214977,5,2,0,2,0
2020-03-09,Yuba,115,75493,0,0,0,0,0
2020-03-08,Alameda,001,1643700,48,4,0,4,0
2020-03-08,Alpine,003,1148,0,0,0,0,0
2020-03-08,Amador,005,37829,0,0,0,0,0
2020-03-08,Butte,007,227075,0,0,0,0,0
2020-03-08,Calaveras,009,45235,2,0,0,0,0
2020-03-08,Colusa,011,21464,0,0,0,0,0
2020-03-08,Contra Costa,013,1133247,58,9,0,9,0
2020-03-08,Del Norte,015,27424,0,0,0,0,0
2020-03-08,El Dorado,017,186661,5,0,0,0,0
2020-03-08,Fresno,019,978130,5,1,1,2,0
2020-03-08,Glenn,021,27897,0,0,0,0,0
2020-03-08,Humboldt,023,135768,5,1,0,1,0
2020-03-08,Imperial,025,180216,5,0,0,0,0
2020-03-08,Inyo,027,18085,0,0,0,0,0
2020-03-08,Kern,029,883053,8,0,0,0,0
2020-03-08,Kings,031,150075,3,0,1,1,0
2020-03-08,Lake,033,64148,0,0,0,0,0
2020-03-08,Lassen,035,31185,0,0,0,0,0
2020-03-08,Los Angeles,037,10098052,370,14,6,20,0
2020-03-08,Madera,039,155013,7,1,0,1,0
2020-03-08,Marin,041,260295,13,1,0,1,0
2020-03-08,Mariposa,043,17540,0,0,0,0,0
2020-03-08,Mendocino,045,87422,0,0,0,0,0
2020-03-08,Merced,047,269075,2,0,0,0,0
2020-03-08,Modoc,049,8938,0,0,0,0,0
2020-03-08,Mono,051,14174,3,0,0,0,0
2020-03-08,Monterey,053,433212,3,0,0,0,0
2020-03-08,Napa,055,140530,2,0,0,0,0
2020-03-08,Nevada,057,99092,1,0,1,1,0
2020-03-08,Orange,059,3164182,128,4,0,4,0
2020-03-08,Placer,061,380077,11,7,0,7,1
2020-03-08,Plumas,063,18699,0,0,0,0,0
2020-03-08,Riverside,065,2383286,41,1,1,2,0
2020-03-08,Sacramento,067,1510023,65,5,0,5,0
2020-03-08,San Benito,069,59416,3,2,0,2,0
2020-03-08,San Bernardino,071,2135413,43,0,0,0,0
2020-03-08,San Diego,073,3302833,90,2,0,2,0
2020-03-08,San Francisco,075,870044,53,9,0,9,0
2020-03-08,San Joaquin,077,732212,18,0,3,3,0
2020-03-08,San Luis Obispo,079,281455,9,0,0,0,0
2020-03-08,San Mateo,081,765935,96,4,0,4,0
2020-03-08,Santa Barbara,083,443738,5,0,0,0,0
2020-03-08,Santa Clara,085,1922200,236,36,1,37,0
2020-03-08,Santa Cruz,087,273765,17,1,0,1,0
2020-03-08,Shasta,089,179085,2,0,0,0,0
2020-03-08,Sierra,091,2930,0,0,0,0,0
2020-03-08,Siskiyou,093,43540,0,0,0,0,0
2020-03-08,Solano,095,438530,24,26,0,26,0
2020-03-08,Sonoma,097,501317,17,2,0,2,0
2020-03-08,Stanislaus,099,539301,10,0,2,2,0
2020-03-08,Sutter,101,95872,0,0,0,0,0
2020-03-08,Tehama,103,63373,0,0,0,0,0
2020-03-08,Trinity,105,12862,0,0,0,0,0
2020-03-08,Tulare,107,460477,9,0,0,0,0
2020-03-08,Tuolumne,109,53932,1,0,0,0,0
2020-03-08,Ventura,111,848112,21,1,0,1,0
2020-03-08,Yolo,113,214977,2,2,0,2,0
2020-03-08,Yuba,115,75493,0,0,0,0,0
2020-03-07,Alameda,001,1643700,43,3,0,3,0
2020-03-07,Alpine,003,1148,0,0,0,0,0
2020-03-07,Amador,005,37829,0,0,0,0,0
2020-03-07,Butte,007,227075,0,0,0,0,0
2020-03-07,Calaveras,009,45235,2,0,0,0,0
2020-03-07,Colusa,011,21464,0,0,0,0,0
2020-03-07,Contra Costa,013,1133247,55,4,0,4,0
2020-03-07,Del Norte,015,27424,0,0,0,0,0
2020-03-07,El Dorado,017,186661,4,0,0,0,0
2020-03-07,Fresno,019,978130,4,1,1,2,0
2020-03-07,Glenn,021,27897,0,0,0,0,0
2020-03-07,Humboldt,023,135768,5,1,0,1,0
2020-03-07,Imperial,025,180216,4,0,0,0,0
2020-03-07,Inyo,027,18085,0,0,0,0,0
2020-03-07,Kern,029,883053,7,0,0,0,0
2020-03-07,Kings,031,150075,3,0,1,1,0
2020-03-07,Lake,033,64148,0,0,0,0,0
2020-03-07,Lassen,035,31185,0,0,0,0,0
2020-03-07,Los Angeles,037,10098052,319,14,6,20,0
2020-03-07,Madera,039,155013,6,1,0,1,0
2020-03-07,Marin,041,260295,11,0,0,0,0
2020-03-07,Mariposa,043,17540,0,0,0,0,0
2020-03-07,Mendocino,045,87422,0,0,0,0,0
2020-03-07,Merced,047,269075,2,0,0,0,0
2020-03-07,Modoc,049,8938,0,0,0,0,0
2020-03-07,Mono,051,14174,3,0,0,0,0
2020-03-07,Monterey,053,433212,3,0,0,0,0
2020-03-07,Napa,055,140530,1,0,0,0,0
2020-03-07,Nevada,057,99092,1,0,1,1,0
2020-03-07,Orange,059,3164182,120,4,0,4,0
2020-03-07,Placer,061,380077,11,6,0,6,1
2020-03-07,Plumas,063,18699,0,0,0,0,0
2020-03-07,Riverside,065,2383286,31,0,1,1,0
2020-03-07,Sacramento,067,1510023,52,4,0,4,0
2020-03-07,San Benito,069,59416,3,2,0,2,0
2020-03-07,San Bernardino,071,2135413,41,0,0,0,0
2020-03-07,San Diego,073,3302833,72,2,0,2,0
2020-03-07,San Francisco,075,870044,47,9,0,9,0
2020-03-07,San Joaquin,077,732212,16,0,3,3,0
2020-03-07,San Luis Obispo,079,281455,6,0,0,0,0
2020-03-07,San Mateo,081,765935,86,1,0,1,0
2020-03-07,Santa Barbara,083,443738,5,0,0,0,0
2020-03-07,Santa Clara,085,1922200,206,31,1,32,0
2020-03-07,Santa Cruz,087,273765,17,1,0,1,0
2020-03-07,Shasta,089,179085,2,0,0,0,0
2020-03-07,Sierra,091,2930,0,0,0,0,0
2020-03-07,Siskiyou,093,43540,0,0,0,0,0
2020-03-07,Solano,095,438530,23,25,0,25,0
2020-03-07,Sonoma,097,501317,13,2,0,2,0
2020-03-07,Stanislaus,099,539301,9,0,2,2,0
2020-03-07,Sutter,101,95872,0,0,0,0,0
2020-03-07,Tehama,103,63373,0,0,0,0,0
2020-03-07,Trinity,105,12862,0,0,0,0,0
2020-03-07,Tulare,107,460477,6,0,0,0,0
2020-03-07,Tuolumne,109,53932,1,0,0,0,0
2020-03-07,Ventura,111,848112,18,1,0,1,0
2020-03-07,Yolo,113,214977,2,2,0,2,0
2020-03-07,Yuba,115,75493,0,0,0,0,0
2020-03-06,Alameda,001,1643700,41,3,0,3,0
2020-03-06,Alpine,003,1148,0,0,0,0,0
2020-03-06,Amador,005,37829,0,0,0,0,0
2020-03-06,Butte,007,227075,0,0,0,0,0
2020-03-06,Calaveras,009,45235,2,0,0,0,0
2020-03-06,Colusa,011,21464,0,0,0,0,0
2020-03-06,Contra Costa,013,1133247,46,4,0,4,0
2020-03-06,Del Norte,015,27424,0,0,0,0,0
2020-03-06,El Dorado,017,186661,3,0,0,0,0
2020-03-06,Fresno,019,978130,3,0,1,1,0
2020-03-06,Glenn,021,27897,0,0,0,0,0
2020-03-06,Humboldt,023,135768,4,1,0,1,0
2020-03-06,Imperial,025,180216,3,0,0,0,0
2020-03-06,Inyo,027,18085,0,0,0,0,0
2020-03-06,Kern,029,883053,6,0,0,0,0
2020-03-06,Kings,031,150075,3,0,1,1,0
2020-03-06,Lake,033,64148,0,0,0,0,0
2020-03-06,Lassen,035,31185,0,0,0,0,0
2020-03-06,Los Angeles,037,10098052,276,13,6,19,0
2020-03-06,Madera,039,155013,5,0,0,0,0
2020-03-06,Marin,041,260295,10,0,0,0,0
2020-03-06,Mariposa,043,17540,0,0,0,0,0
2020-03-06,Mendocino,045,87422,0,0,0,0,0
2020-03-06,Merced,047,269075,2,0,0,0,0
2020-03-06,Modoc,049,8938,0,0,0,0,0
2020-03-06,Mono,051,14174,1,0,0,0,0
2020-03-06,Monterey,053,433212,3,0,0,0,0
2020-03-06,Napa,055,140530,1,0,0,0,0
2020-03-06,Nevada,057,99092,1,0,1,1,0
2020-03-06,Orange,059,3164182,94,4,0,4,0
2020-03-06,Placer,061,380077,10,5,0,5,1
2020-03-06,Plumas,063,18699,0,0,0,0,0
2020-03-06,Riverside,065,2383286,30,0,1,1,0
2020-03-06,Sacramento,067,1510023,43,2,0,2,0
2020-03-06,San Benito,069,59416,3,2,0,2,0
2020-03-06,San Bernardino,071,2135413,39,0,0,0,0
2020-03-06,San Diego,073,3302833,59,2,0,2,0
2020-03-06,San Francisco,075,870044,41,2,0,2,0
2020-03-06,San Joaquin,077,732212,13,0,3,3,0
2020-03-06,San Luis Obispo,079,281455,4,0,0,0,0
2020-03-06,San Mateo,081,765935,78,1,0,1,0
2020-03-06,Santa Barbara,083,443738,3,0,0,0,0
2020-03-06,Santa Clara,085,1922200,188,20,1,21,0
2020-03-06,Santa Cruz,087,273765,15,0,0,0,0
2020-03-06,Shasta,089,179085,2,0,0,0,0
2020-03-06,Sierra,091,2930,0,0,0,0,0
2020-03-06,Siskiyou,093,43540,0,0,0,0,0
2020-03-06,Solano,095,438530,22,25,0,25,0
2020-03-06,Sonoma,097,501317,13,2,0,2,0
2020-03-06,Stanislaus,099,539301,5,0,2,2,0
2020-03-06,Sutter,101,95872,0,0,0,0,0
2020-03-06,Tehama,103,63373,0,0,0,0,0
2020-03-06,Trinity,105,12862,0,0,0,0,0
2020-03-06,Tulare,107,460477,6,0,0,0,0
2020-03-06,Tuolumne,109,53932,1,0,0,0,0
2020-03-06,Ventura,111,848112,15,1,0,1,0
2020-03-06,Yolo,113,214977,2,1,0,1,0
2020-03-06,Yuba,115,75493,0,0,0,0,0
2020-03-05,Alameda,001,1643700,35,2,0,2,0
2020-03-05,Alpine,003,1148,0,0,0,0,0
2020-03-05,Amador,005,37829,0,0,0,0,0
2020-03-05,Butte,007,227075,0,0,0,0,0
2020-03-05,Calaveras,009,45235,2,0,0,0,0
2020-03-05,Colusa,011,21464,0,0,0,0,0
2020-03-05,Contra Costa,013,1133247,39,1,0,1,0
2020-03-05,Del Norte,015,27424,0,0,0,0,0
2020-03-05,El Dorado,017,186661,1,0,0,0,0
2020-03-05,Fresno,019,978130,3,0,1,1,0
2020-03-05,Glenn,021,27897,0,0,0,0,0
2020-03-05,Humboldt,023,135768,4,1,0,1,0
2020-03-05,Imperial,025,180216,2,0,0,0,0
2020-03-05,Inyo,027,18085,0,0,0,0,0
2020-03-05,Kern,029,883053,6,0,0,0,0
2020-03-05,Kings,031,150075,3,0,1,1,0
2020-03-05,Lake,033,64148,0,0,0,0,0
2020-03-05,Lassen,035,31185,0,0,0,0,0
2020-03-05,Los Angeles,037,10098052,229,11,6,17,0
2020-03-05,Madera,039,155013,5,0,0,0,0
2020-03-05,Marin,041,260295,10,0,0,0,0
2020-03-05,Mariposa,043,17540,0,0,0,0,0
2020-03-05,Mendocino,045,87422,0,0,0,0,0
2020-03-05,Merced,047,269075,2,0,0,0,0
2020-03-05,Modoc,049,8938,0,0,0,0,0
2020-03-05,Mono,051,14174,1,0,0,0,0
2020-03-05,Monterey,053,433212,3,0,0,0,0
2020-03-05,Napa,055,140530,1,0,0,0,0
2020-03-05,Nevada,057,99092,0,0,1,1,0
2020-03-05,Orange,059,3164182,79,3,0,3,0
2020-03-05,Placer,061,380077,10,2,0,2,1
2020-03-05,Plumas,063,18699,0,0,0,0,0
2020-03-05,Riverside,065,2383286,27,0,1,1,0
2020-03-05,Sacramento,067,1510023,37,2,0,2,0
2020-03-05,San Benito,069,59416,1,2,0,2,0
2020-03-05,San Bernardino,071,2135413,34,0,0,0,0
2020-03-05,San Diego,073,3302833,52,2,0,2,0
2020-03-05,San Francisco,075,870044,31,2,0,2,0
2020-03-05,San Joaquin,077,732212,10,0,3,3,0
2020-03-05,San Luis Obispo,079,281455,4,0,0,0,0
2020-03-05,San Mateo,081,765935,65,1,0,1,0
2020-03-05,Santa Barbara,083,443738,2,0,0,0,0
2020-03-05,Santa Clara,085,1922200,164,14,1,15,0
2020-03-05,Santa Cruz,087,273765,13,0,0,0,0
2020-03-05,Shasta,089,179085,2,0,0,0,0
2020-03-05,Sierra,091,2930,0,0,0,0,0
2020-03-05,Siskiyou,093,43540,0,0,0,0,0
2020-03-05,Solano,095,438530,22,24,0,24,0
2020-03-05,Sonoma,097,501317,12,2,0,2,0
2020-03-05,Stanislaus,099,539301,4,0,2,2,0
2020-03-05,Sutter,101,95872,0,0,0,0,0
2020-03-05,Tehama,103,63373,0,0,0,0,0
2020-03-05,Trinity,105,12862,0,0,0,0,0
2020-03-05,Tulare,107,460477,6,0,0,0,0
2020-03-05,Tuolumne,109,53932,1,0,0,0,0
2020-03-05,Ventura,111,848112,13,0,0,0,0
2020-03-05,Yolo,113,214977,2,0,0,0,0
2020-03-05,Yuba,115,75493,0,0,0,0,0
2020-03-04,Alameda,001,1643700,31,2,0,2,0
2020-03-04,Alpine,003,1148,0,0,0,0,0
2020-03-04,Amador,005,37829,0,0,0,0,0
2020-03-04,Butte,007,227075,0,0,0,0,0
2020-03-04,Calaveras,009,45235,0,0,0,0,0
2020-03-04,Colusa,011,21464,0,0,0,0,0
2020-03-04,Contra Costa,013,1133247,34,1,0,1,0
2020-03-04,Del Norte,015,27424,0,0,0,0,0
2020-03-04,El Dorado,017,186661,1,0,0,0,0
2020-03-04,Fresno,019,978130,3,0,1,1,0
2020-03-04,Glenn,021,27897,0,0,0,0,0
2020-03-04,Humboldt,023,135768,1,1,0,1,0
2020-03-04,Imperial,025,180216,2,0,0,0,0
2020-03-04,Inyo,027,18085,0,0,0,0,0
2020-03-04,Kern,029,883053,6,0,0,0,0
2020-03-04,Kings,031,150075,3,0,1,1,0
2020-03-04,Lake,033,64148,0,0,0,0,0
2020-03-04,Lassen,035,31185,0,0,0,0,0
2020-03-04,Los Angeles,037,10098052,193,7,6,13,0
2020-03-04,Madera,039,155013,5,0,0,0,0
2020-03-04,Marin,041,260295,10,0,0,0,0
2020-03-04,Mariposa,043,17540,0,0,0,0,0
2020-03-04,Mendocino,045,87422,0,0,0,0,0
2020-03-04,Merced,047,269075,2,0,0,0,0
2020-03-04,Modoc,049,8938,0,0,0,0,0
2020-03-04,Mono,051,14174,1,0,0,0,0
2020-03-04,Monterey,053,433212,3,0,0,0,0
2020-03-04,Napa,055,140530,1,0,0,0,0
2020-03-04,Nevada,057,99092,0,0,1,1,0
2020-03-04,Orange,059,3164182,76,3,0,3,0
2020-03-04,Placer,061,380077,9,2,0,2,1
2020-03-04,Plumas,063,18699,0,0,0,0,0
2020-03-04,Riverside,065,2383286,23,0,1,1,0
2020-03-04,Sacramento,067,1510023,32,1,0,1,0
2020-03-04,San Benito,069,59416,1,2,0,2,0
2020-03-04,San Bernardino,071,2135413,31,0,0,0,0
2020-03-04,San Diego,073,3302833,39,2,0,2,0
2020-03-04,San Francisco,075,870044,26,0,0,0,0
2020-03-04,San Joaquin,077,732212,9,0,3,3,0
2020-03-04,San Luis Obispo,079,281455,4,0,0,0,0
2020-03-04,San Mateo,081,765935,60,1,0,1,0
2020-03-04,Santa Barbara,083,443738,2,0,0,0,0
2020-03-04,Santa Clara,085,1922200,147,12,1,13,0
2020-03-04,Santa Cruz,087,273765,13,0,0,0,0
2020-03-04,Shasta,089,179085,2,0,0,0,0
2020-03-04,Sierra,091,2930,0,0,0,0,0
2020-03-04,Siskiyou,093,43540,0,0,0,0,0
2020-03-04,Solano,095,438530,21,24,0,24,0
2020-03-04,Sonoma,097,501317,11,2,0,2,0
2020-03-04,Stanislaus,099,539301,4,0,2,2,0
2020-03-04,Sutter,101,95872,0,0,0,0,0
2020-03-04,Tehama,103,63373,0,0,0,0,0
2020-03-04,Trinity,105,12862,0,0,0,0,0
2020-03-04,Tulare,107,460477,6,0,0,0,0
2020-03-04,Tuolumne,109,53932,0,0,0,0,0
2020-03-04,Ventura,111,848112,12,0,0,0,0
2020-03-04,Yolo,113,214977,2,0,0,0,0
2020-03-04,Yuba,115,75493,0,0,0,0,0
2020-03-03,Alameda,001,1643700,25,2,0,2,0
2020-03-03,Alpine,003,1148,0,0,0,0,0
2020-03-03,Amador,005,37829,0,0,0,0,0
2020-03-03,Butte,007,227075,0,0,0,0,0
2020-03-03,Calaveras,009,45235,0,0,0,0,0
2020-03-03,Colusa,011,21464,0,0,0,0,0
2020-03-03,Contra Costa,013,1133247,30,0,0,0,0
2020-03-03,Del Norte,015,27424,0,0,0,0,0
2020-03-03,El Dorado,017,186661,1,0,0,0,0
2020-03-03,Fresno,019,978130,2,0,1,1,0
2020-03-03,Glenn,021,27897,0,0,0,0,0
2020-03-03,Humboldt,023,135768,1,1,0,1,0
2020-03-03,Imperial,025,180216,2,0,0,0,0
2020-03-03,Inyo,027,18085,0,0,0,0,0
2020-03-03,Kern,029,883053,4,0,0,0,0
2020-03-03,Kings,031,150075,3,0,1,1,0
2020-03-03,Lake,033,64148,0,0,0,0,0
2020-03-03,Lassen,035,31185,0,0,0,0,0
2020-03-03,Los Angeles,037,10098052,174,5,6,11,0
2020-03-03,Madera,039,155013,4,0,0,0,0
2020-03-03,Marin,041,260295,6,0,0,0,0
2020-03-03,Mariposa,043,17540,0,0,0,0,0
2020-03-03,Mendocino,045,87422,0,0,0,0,0
2020-03-03,Merced,047,269075,2,0,0,0,0
2020-03-03,Modoc,049,8938,0,0,0,0,0
2020-03-03,Mono,051,14174,1,0,0,0,0
2020-03-03,Monterey,053,433212,2,0,0,0,0
2020-03-03,Napa,055,140530,1,0,0,0,0
2020-03-03,Nevada,057,99092,0,0,1,1,0
2020-03-03,Orange,059,3164182,68,1,0,1,0
2020-03-03,Placer,061,380077,8,2,0,2,0
2020-03-03,Plumas,063,18699,0,0,0,0,0
2020-03-03,Riverside,065,2383286,20,0,1,1,0
2020-03-03,Sacramento,067,1510023,31,1,0,1,0
2020-03-03,San Benito,069,59416,1,2,0,2,0
2020-03-03,San Bernardino,071,2135413,28,0,0,0,0
2020-03-03,San Diego,073,3302833,32,2,0,2,0
2020-03-03,San Francisco,075,870044,24,0,0,0,0
2020-03-03,San Joaquin,077,732212,8,0,3,3,0
2020-03-03,San Luis Obispo,079,281455,2,0,0,0,0
2020-03-03,San Mateo,081,765935,53,1,0,1,0
2020-03-03,Santa Barbara,083,443738,1,0,0,0,0
2020-03-03,Santa Clara,085,1922200,132,11,1,12,0
2020-03-03,Santa Cruz,087,273765,10,0,0,0,0
2020-03-03,Shasta,089,179085,2,0,0,0,0
2020-03-03,Sierra,091,2930,0,0,0,0,0
2020-03-03,Siskiyou,093,43540,0,0,0,0,0
2020-03-03,Solano,095,438530,20,24,0,24,0
2020-03-03,Sonoma,097,501317,11,1,0,1,0
2020-03-03,Stanislaus,099,539301,4,0,2,2,0
2020-03-03,Sutter,101,95872,0,0,0,0,0
2020-03-03,Tehama,103,63373,0,0,0,0,0
2020-03-03,Trinity,105,12862,0,0,0,0,0
2020-03-03,Tulare,107,460477,6,0,0,0,0
2020-03-03,Tuolumne,109,53932,0,0,0,0,0
2020-03-03,Ventura,111,848112,11,0,0,0,0
2020-03-03,Yolo,113,214977,1,0,0,0,0
2020-03-03,Yuba,115,75493,0,0,0,0,0
2020-03-02,Alameda,001,1643700,22,1,0,1,0
2020-03-02,Alpine,003,1148,0,0,0,0,0
2020-03-02,Amador,005,37829,0,0,0,0,0
2020-03-02,Butte,007,227075,0,0,0,0,0
2020-03-02,Calaveras,009,45235,0,0,0,0,0
2020-03-02,Colusa,011,21464,0,0,0,0,0
2020-03-02,Contra Costa,013,1133247,27,0,0,0,0
2020-03-02,Del Norte,015,27424,0,0,0,0,0
2020-03-02,El Dorado,017,186661,1,0,0,0,0
2020-03-02,Fresno,019,978130,2,0,1,1,0
2020-03-02,Glenn,021,27897,0,0,0,0,0
2020-03-02,Humboldt,023,135768,1,1,0,1,0
2020-03-02,Imperial,025,180216,2,0,0,0,0
2020-03-02,Inyo,027,18085,0,0,0,0,0
2020-03-02,Kern,029,883053,4,0,0,0,0
2020-03-02,Kings,031,150075,3,0,1,1,0
2020-03-02,Lake,033,64148,0,0,0,0,0
2020-03-02,Lassen,035,31185,0,0,0,0,0
2020-03-02,Los Angeles,037,10098052,159,1,6,7,0
2020-03-02,Madera,039,155013,4,0,0,0,0
2020-03-02,Marin,041,260295,6,0,0,0,0
2020-03-02,Mariposa,043,17540,0,0,0,0,0
2020-03-02,Mendocino,045,87422,0,0,0,0,0
2020-03-02,Merced,047,269075,1,0,0,0,0
2020-03-02,Modoc,049,8938,0,0,0,0,0
2020-03-02,Mono,051,14174,1,0,0,0,0
2020-03-02,Monterey,053,433212,2,0,0,0,0
2020-03-02,Napa,055,140530,1,0,0,0,0
2020-03-02,Nevada,057,99092,0,0,1,1,0
2020-03-02,Orange,059,3164182,63,1,0,1,0
2020-03-02,Placer,061,380077,8,1,0,1,0
2020-03-02,Plumas,063,18699,0,0,0,0,0
2020-03-02,Riverside,065,2383286,19,0,1,1,0
2020-03-02,Sacramento,067,1510023,25,1,0,1,0
2020-03-02,San Benito,069,59416,1,2,0,2,0
2020-03-02,San Bernardino,071,2135413,28,0,0,0,0
2020-03-02,San Diego,073,3302833,26,2,0,2,0
2020-03-02,San Francisco,075,870044,17,0,0,0,0
2020-03-02,San Joaquin,077,732212,7,0,3,3,0
2020-03-02,San Luis Obispo,079,281455,2,0,0,0,0
2020-03-02,San Mateo,081,765935,44,1,0,1,0
2020-03-02,Santa Barbara,083,443738,1,0,0,0,0
2020-03-02,Santa Clara,085,1922200,110,7,1,8,0
2020-03-02,Santa Cruz,087,273765,9,0,0,0,0
2020-03-02,Shasta,089,179085,2,0,0,0,0
2020-03-02,Sierra,091,2930,0,0,0,0,0
2020-03-02,Siskiyou,093,43540,0,0,0,0,0
2020-03-02,Solano,095,438530,19,24,0,24,0
2020-03-02,Sonoma,097,501317,10,1,0,1,0
2020-03-02,Stanislaus,099,539301,2,0,2,2,0
2020-03-02,Sutter,101,95872,0,0,0,0,0
2020-03-02,Tehama,103,63373,0,0,0,0,0
2020-03-02,Trinity,105,12862,0,0,0,0,0
2020-03-02,Tulare,107,460477,6,0,0,0,0
2020-03-02,Tuolumne,109,53932,0,0,0,0,0
2020-03-02,Ventura,111,848112,10,0,0,0,0
2020-03-02,Yolo,113,214977,1,0,0,0,0
2020-03-02,Yuba,115,75493,0,0,0,0,0
2020-03-01,Alameda,001,1643700,21,1,0,1,0
2020-03-01,Alpine,003,1148,0,0,0,0,0
2020-03-01,Amador,005,37829,0,0,0,0,0
2020-03-01,Butte,007,227075,0,0,0,0,0
2020-03-01,Calaveras,009,45235,0,0,0,0,0
2020-03-01,Colusa,011,21464,0,0,0,0,0
2020-03-01,Contra Costa,013,1133247,24,0,0,0,0
2020-03-01,Del Norte,015,27424,0,0,0,0,0
2020-03-01,El Dorado,017,186661,1,0,0,0,0
2020-03-01,Fresno,019,978130,1,0,1,1,0
2020-03-01,Glenn,021,27897,0,0,0,0,0
2020-03-01,Humboldt,023,135768,1,1,0,1,0
2020-03-01,Imperial,025,180216,2,0,0,0,0
2020-03-01,Inyo,027,18085,0,0,0,0,0
2020-03-01,Kern,029,883053,2,0,0,0,0
2020-03-01,Kings,031,150075,3,0,1,1,0
2020-03-01,Lake,033,64148,0,0,0,0,0
2020-03-01,Lassen,035,31185,0,0,0,0,0
2020-03-01,Los Angeles,037,10098052,140,1,6,7,0
2020-03-01,Madera,039,155013,2,0,0,0,0
2020-03-01,Marin,041,260295,5,0,0,0,0
2020-03-01,Mariposa,043,17540,0,0,0,0,0
2020-03-01,Mendocino,045,87422,0,0,0,0,0
2020-03-01,Merced,047,269075,1,0,0,0,0
2020-03-01,Modoc,049,8938,0,0,0,0,0
2020-03-01,Mono,051,14174,1,0,0,0,0
2020-03-01,Monterey,053,433212,1,0,0,0,0
2020-03-01,Napa,055,140530,1,0,0,0,0
2020-03-01,Nevada,057,99092,0,0,1,1,0
2020-03-01,Orange,059,3164182,60,1,0,1,0
2020-03-01,Placer,061,380077,8,0,0,0,0
2020-03-01,Plumas,063,18699,0,0,0,0,0
2020-03-01,Riverside,065,2383286,18,0,1,1,0
2020-03-01,Sacramento,067,1510023,21,1,0,1,0
2020-03-01,San Benito,069,59416,0,2,0,2,0
2020-03-01,San Bernardino,071,2135413,27,0,0,0,0
2020-03-01,San Diego,073,3302833,19,2,0,2,0
2020-03-01,San Francisco,075,870044,13,0,0,0,0
2020-03-01,San Joaquin,077,732212,7,0,3,3,0
2020-03-01,San Luis Obispo,079,281455,2,0,0,0,0
2020-03-01,San Mateo,081,765935,36,0,0,0,0
2020-03-01,Santa Barbara,083,443738,1,0,0,0,0
2020-03-01,Santa Clara,085,1922200,97,6,1,7,0
2020-03-01,Santa Cruz,087,273765,8,0,0,0,0
2020-03-01,Shasta,089,179085,2,0,0,0,0
2020-03-01,Sierra,091,2930,0,0,0,0,0
2020-03-01,Siskiyou,093,43540,0,0,0,0,0
2020-03-01,Solano,095,438530,19,24,0,24,0
2020-03-01,Sonoma,097,501317,9,0,0,0,0
2020-03-01,Stanislaus,099,539301,2,0,2,2,0
2020-03-01,Sutter,101,95872,0,0,0,0,0
2020-03-01,Tehama,103,63373,0,0,0,0,0
2020-03-01,Trinity,105,12862,0,0,0,0,0
2020-03-01,Tulare,107,460477,6,0,0,0,0
2020-03-01,Tuolumne,109,53932,0,0,0,0,0
2020-03-01,Ventura,111,848112,8,0,0,0,0
2020-03-01,Yolo,113,214977,1,0,0,0,0
2020-03-01,Yuba,115,75493,0,0,0,0,0
2020-02-29,Alameda,001,1643700,17,0,0,0,0
2020-02-29,Alpine,003,1148,0,0,0,0,0
2020-02-29,Amador,005,37829,0,0,0,0,0
2020-02-29,Butte,007,227075,0,0,0,0,0
2020-02-29,Calaveras,009,45235,0,0,0,0,0
2020-02-29,Colusa,011,21464,0,0,0,0,0
2020-02-29,Contra Costa,013,1133247,20,0,0,0,0
2020-02-29,Del Norte,015,27424,0,0,0,0,0
2020-02-29,El Dorado,017,186661,1,0,0,0,0
2020-02-29,Fresno,019,978130,1,0,0,0,0
2020-02-29,Glenn,021,27897,0,0,0,0,0
2020-02-29,Humboldt,023,135768,1,1,0,1,0
2020-02-29,Imperial,025,180216,1,0,0,0,0
2020-02-29,Inyo,027,18085,0,0,0,0,0
2020-02-29,Kern,029,883053,2,0,0,0,0
2020-02-29,Kings,031,150075,3,0,1,1,0
2020-02-29,Lake,033,64148,0,0,0,0,0
2020-02-29,Lassen,035,31185,0,0,0,0,0
2020-02-29,Los Angeles,037,10098052,111,1,6,7,0
2020-02-29,Madera,039,155013,2,0,0,0,0
2020-02-29,Marin,041,260295,4,0,0,0,0
2020-02-29,Mariposa,043,17540,0,0,0,0,0
2020-02-29,Mendocino,045,87422,0,0,0,0,0
2020-02-29,Merced,047,269075,1,0,0,0,0
2020-02-29,Modoc,049,8938,0,0,0,0,0
2020-02-29,Mono,051,14174,1,0,0,0,0
2020-02-29,Monterey,053,433212,1,0,0,0,0
2020-02-29,Napa,055,140530,1,0,0,0,0
2020-02-29,Nevada,057,99092,0,0,1,1,0
2020-02-29,Orange,059,3164182,55,1,0,1,0
2020-02-29,Placer,061,380077,7,0,0,0,0
2020-02-29,Plumas,063,18699,0,0,0,0,0
2020-02-29,Riverside,065,2383286,15,0,1,1,0
2020-02-29,Sacramento,067,1510023,16,1,0,1,0
2020-02-29,San Benito,069,59416,0,2,0,2,0
2020-02-29,San Bernardino,071,2135413,25,0,0,0,0
2020-02-29,San Diego,073,3302833,14,2,0,2,0
2020-02-29,San Francisco,075,870044,12,0,0,0,0
2020-02-29,San Joaquin,077,732212,6,0,3,3,0
2020-02-29,San Luis Obispo,079,281455,2,0,0,0,0
2020-02-29,San Mateo,081,765935,29,0,0,0,0
2020-02-29,Santa Barbara,083,443738,0,0,0,0,0
2020-02-29,Santa Clara,085,1922200,75,3,1,4,0
2020-02-29,Santa Cruz,087,273765,8,0,0,0,0
2020-02-29,Shasta,089,179085,2,0,0,0,0
2020-02-29,Sierra,091,2930,0,0,0,0,0
2020-02-29,Siskiyou,093,43540,0,0,0,0,0
2020-02-29,Solano,095,438530,18,23,0,23,0
2020-02-29,Sonoma,097,501317,6,0,0,0,0
2020-02-29,Stanislaus,099,539301,2,0,2,2,0
2020-02-29,Sutter,101,95872,0,0,0,0,0
2020-02-29,Tehama,103,63373,0,0,0,0,0
2020-02-29,Trinity,105,12862,0,0,0,0,0
2020-02-29,Tulare,107,460477,4,0,0,0,0
2020-02-29,Tuolumne,109,53932,0,0,0,0,0
2020-02-29,Ventura,111,848112,6,0,0,0,0
2020-02-29,Yolo,113,214977,1,0,0,0,0
2020-02-29,Yuba,115,75493,0,0,0,0,0
2020-02-28,Alameda,001,1643700,15,0,0,0,0
2020-02-28,Alpine,003,1148,0,0,0,0,0
2020-02-28,Amador,005,37829,0,0,0,0,0
2020-02-28,Butte,007,227075,0,0,0,0,0
2020-02-28,Calaveras,009,45235,0,0,0,0,0
2020-02-28,Colusa,011,21464,0,0,0,0,0
2020-02-28,Contra Costa,013,1133247,20,0,0,0,0
2020-02-28,Del Norte,015,27424,0,0,0,0,0
2020-02-28,El Dorado,017,186661,0,0,0,0,0
2020-02-28,Fresno,019,978130,1,0,0,0,0
2020-02-28,Glenn,021,27897,0,0,0,0,0
2020-02-28,Humboldt,023,135768,1,1,0,1,0
2020-02-28,Imperial,025,180216,1,0,0,0,0
2020-02-28,Inyo,027,18085,0,0,0,0,0
2020-02-28,Kern,029,883053,2,0,0,0,0
2020-02-28,Kings,031,150075,3,0,1,1,0
2020-02-28,Lake,033,64148,0,0,0,0,0
2020-02-28,Lassen,035,31185,0,0,0,0,0
2020-02-28,Los Angeles,037,10098052,103,1,6,7,0
2020-02-28,Madera,039,155013,2,0,0,0,0
2020-02-28,Marin,041,260295,2,0,0,0,0
2020-02-28,Mariposa,043,17540,0,0,0,0,0
2020-02-28,Mendocino,045,87422,0,0,0,0,0
2020-02-28,Merced,047,269075,1,0,0,0,0
2020-02-28,Modoc,049,8938,0,0,0,0,0
2020-02-28,Mono,051,14174,0,0,0,0,0
2020-02-28,Monterey,053,433212,1,0,0,0,0
2020-02-28,Napa,055,140530,1,0,0,0,0
2020-02-28,Nevada,057,99092,0,0,1,1,0
2020-02-28,Orange,059,3164182,53,1,0,1,0
2020-02-28,Placer,061,380077,7,0,0,0,0
2020-02-28,Plumas,063,18699,0,0,0,0,0
2020-02-28,Riverside,065,2383286,13,0,1,1,0
2020-02-28,Sacramento,067,1510023,10,1,0,1,0
2020-02-28,San Benito,069,59416,0,2,0,2,0
2020-02-28,San Bernardino,071,2135413,25,0,0,0,0
2020-02-28,San Diego,073,3302833,11,2,0,2,0
2020-02-28,San Francisco,075,870044,10,0,0,0,0
2020-02-28,San Joaquin,077,732212,6,0,3,3,0
2020-02-28,San Luis Obispo,079,281455,2,0,0,0,0
2020-02-28,San Mateo,081,765935,24,0,0,0,0
2020-02-28,Santa Barbara,083,443738,0,0,0,0,0
2020-02-28,Santa Clara,085,1922200,70,3,1,4,0
2020-02-28,Santa Cruz,087,273765,8,0,0,0,0
2020-02-28,Shasta,089,179085,2,0,0,0,0
2020-02-28,Sierra,091,2930,0,0,0,0,0
2020-02-28,Siskiyou,093,43540,0,0,0,0,0
2020-02-28,Solano,095,438530,17,23,0,23,0
2020-02-28,Sonoma,097,501317,6,0,0,0,0
2020-02-28,Stanislaus,099,539301,2,0,2,2,0
2020-02-28,Sutter,101,95872,0,0,0,0,0
2020-02-28,Tehama,103,63373,0,0,0,0,0
2020-02-28,Trinity,105,12862,0,0,0,0,0
2020-02-28,Tulare,107,460477,3,0,0,0,0
2020-02-28,Tuolumne,109,53932,0,0,0,0,0
2020-02-28,Ventura,111,848112,6,0,0,0,0
2020-02-28,Yolo,113,214977,1,0,0,0,0
2020-02-28,Yuba,115,75493,0,0,0,0,0
2020-02-27,Alameda,001,1643700,14,0,0,0,0
2020-02-27,Alpine,003,1148,0,0,0,0,0
2020-02-27,Amador,005,37829,0,0,0,0,0
2020-02-27,Butte,007,227075,0,0,0,0,0
2020-02-27,Calaveras,009,45235,0,0,0,0,0
2020-02-27,Colusa,011,21464,0,0,0,0,0
2020-02-27,Contra Costa,013,1133247,14,0,0,0,0
2020-02-27,Del Norte,015,27424,0,0,0,0,0
2020-02-27,El Dorado,017,186661,0,0,0,0,0
2020-02-27,Fresno,019,978130,1,0,0,0,0
2020-02-27,Glenn,021,27897,0,0,0,0,0
2020-02-27,Humboldt,023,135768,1,1,0,1,0
2020-02-27,Imperial,025,180216,1,0,0,0,0
2020-02-27,Inyo,027,18085,0,0,0,0,0
2020-02-27,Kern,029,883053,2,0,0,0,0
2020-02-27,Kings,031,150075,3,0,1,1,0
2020-02-27,Lake,033,64148,0,0,0,0,0
2020-02-27,Lassen,035,31185,0,0,0,0,0
2020-02-27,Los Angeles,037,10098052,95,1,6,7,0
2020-02-27,Madera,039,155013,2,0,0,0,0
2020-02-27,Marin,041,260295,1,0,0,0,0
2020-02-27,Mariposa,043,17540,0,0,0,0,0
2020-02-27,Mendocino,045,87422,0,0,0,0,0
2020-02-27,Merced,047,269075,1,0,0,0,0
2020-02-27,Modoc,049,8938,0,0,0,0,0
2020-02-27,Mono,051,14174,0,0,0,0,0
2020-02-27,Monterey,053,433212,1,0,0,0,0
2020-02-27,Napa,055,140530,1,0,0,0,0
2020-02-27,Nevada,057,99092,0,0,1,1,0
2020-02-27,Orange,059,3164182,47,1,0,1,0
2020-02-27,Placer,061,380077,6,0,0,0,0
2020-02-27,Plumas,063,18699,0,0,0,0,0
2020-02-27,Riverside,065,2383286,12,0,1,1,0
2020-02-27,Sacramento,067,1510023,10,1,0,1,0
2020-02-27,San Benito,069,59416,0,2,0,2,0
2020-02-27,San Bernardino,071,2135413,25,0,0,0,0
2020-02-27,San Diego,073,3302833,10,2,0,2,0
2020-02-27,San Francisco,075,870044,9,0,0,0,0
2020-02-27,San Joaquin,077,732212,5,0,3,3,0
2020-02-27,San Luis Obispo,079,281455,2,0,0,0,0
2020-02-27,San Mateo,081,765935,20,0,0,0,0
2020-02-27,Santa Barbara,083,443738,0,0,0,0,0
2020-02-27,Santa Clara,085,1922200,59,2,1,3,0
2020-02-27,Santa Cruz,087,273765,6,0,0,0,0
2020-02-27,Shasta,089,179085,0,0,0,0,0
2020-02-27,Sierra,091,2930,0,0,0,0,0
2020-02-27,Siskiyou,093,43540,0,0,0,0,0
2020-02-27,Solano,095,438530,17,23,0,23,0
2020-02-27,Sonoma,097,501317,5,0,0,0,0
2020-02-27,Stanislaus,099,539301,2,0,2,2,0
2020-02-27,Sutter,101,95872,0,0,0,0,0
2020-02-27,Tehama,103,63373,0,0,0,0,0
2020-02-27,Trinity,105,12862,0,0,0,0,0
2020-02-27,Tulare,107,460477,3,0,0,0,0
2020-02-27,Tuolumne,109,53932,0,0,0,0,0
2020-02-27,Ventura,111,848112,4,0,0,0,0
2020-02-27,Yolo,113,214977,1,0,0,0,0
2020-02-27,Yuba,115,75493,0,0,0,0,0
2020-02-26,Alameda,001,1643700,14,0,0,0,0
2020-02-26,Alpine,003,1148,0,0,0,0,0
2020-02-26,Amador,005,37829,0,0,0,0,0
2020-02-26,Butte,007,227075,0,0,0,0,0
2020-02-26,Calaveras,009,45235,0,0,0,0,0
2020-02-26,Colusa,011,21464,0,0,0,0,0
2020-02-26,Contra Costa,013,1133247,13,0,0,0,0
2020-02-26,Del Norte,015,27424,0,0,0,0,0
2020-02-26,El Dorado,017,186661,0,0,0,0,0
2020-02-26,Fresno,019,978130,1,0,0,0,0
2020-02-26,Glenn,021,27897,0,0,0,0,0
2020-02-26,Humboldt,023,135768,1,1,0,1,0
2020-02-26,Imperial,025,180216,1,0,0,0,0
2020-02-26,Inyo,027,18085,0,0,0,0,0
2020-02-26,Kern,029,883053,2,0,0,0,0
2020-02-26,Kings,031,150075,3,0,1,1,0
2020-02-26,Lake,033,64148,0,0,0,0,0
2020-02-26,Lassen,035,31185,0,0,0,0,0
2020-02-26,Los Angeles,037,10098052,89,1,6,7,0
2020-02-26,Madera,039,155013,2,0,0,0,0
2020-02-26,Marin,041,260295,1,0,0,0,0
2020-02-26,Mariposa,043,17540,0,0,0,0,0
2020-02-26,Mendocino,045,87422,0,0,0,0,0
2020-02-26,Merced,047,269075,1,0,0,0,0
2020-02-26,Modoc,049,8938,0,0,0,0,0
2020-02-26,Mono,051,14174,0,0,0,0,0
2020-02-26,Monterey,053,433212,1,0,0,0,0
2020-02-26,Napa,055,140530,0,0,0,0,0
2020-02-26,Nevada,057,99092,0,0,1,1,0
2020-02-26,Orange,059,3164182,46,1,0,1,0
2020-02-26,Placer,061,380077,5,0,0,0,0
2020-02-26,Plumas,063,18699,0,0,0,0,0
2020-02-26,Riverside,065,2383286,10,0,1,1,0
2020-02-26,Sacramento,067,1510023,10,1,0,1,0
2020-02-26,San Benito,069,59416,0,2,0,2,0
2020-02-26,San Bernardino,071,2135413,23,0,0,0,0
2020-02-26,San Diego,073,3302833,9,2,0,2,0
2020-02-26,San Francisco,075,870044,9,0,0,0,0
2020-02-26,San Joaquin,077,732212,5,0,3,3,0
2020-02-26,San Luis Obispo,079,281455,2,0,0,0,0
2020-02-26,San Mateo,081,765935,18,0,0,0,0
2020-02-26,Santa Barbara,083,443738,0,0,0,0,0
2020-02-26,Santa Clara,085,1922200,50,2,1,3,0
2020-02-26,Santa Cruz,087,273765,6,0,0,0,0
2020-02-26,Shasta,089,179085,0,0,0,0,0
2020-02-26,Sierra,091,2930,0,0,0,0,0
2020-02-26,Siskiyou,093,43540,0,0,0,0,0
2020-02-26,Solano,095,438530,17,23,0,23,0
2020-02-26,Sonoma,097,501317,5,0,0,0,0
2020-02-26,Stanislaus,099,539301,2,0,2,2,0
2020-02-26,Sutter,101,95872,0,0,0,0,0
2020-02-26,Tehama,103,63373,0,0,0,0,0
2020-02-26,Trinity,105,12862,0,0,0,0,0
2020-02-26,Tulare,107,460477,3,0,0,0,0
2020-02-26,Tuolumne,109,53932,0,0,0,0,0
2020-02-26,Ventura,111,848112,4,0,0,0,0
2020-02-26,Yolo,113,214977,1,0,0,0,0
2020-02-26,Yuba,115,75493,0,0,0,0,0
2020-02-25,Alameda,001,1643700,14,0,0,0,0
2020-02-25,Alpine,003,1148,0,0,0,0,0
2020-02-25,Amador,005,37829,0,0,0,0,0
2020-02-25,Butte,007,227075,0,0,0,0,0
2020-02-25,Calaveras,009,45235,0,0,0,0,0
2020-02-25,Colusa,011,21464,0,0,0,0,0
2020-02-25,Contra Costa,013,1133247,11,0,0,0,0
2020-02-25,Del Norte,015,27424,0,0,0,0,0
2020-02-25,El Dorado,017,186661,0,0,0,0,0
2020-02-25,Fresno,019,978130,1,0,0,0,0
2020-02-25,Glenn,021,27897,0,0,0,0,0
2020-02-25,Humboldt,023,135768,1,1,0,1,0
2020-02-25,Imperial,025,180216,1,0,0,0,0
2020-02-25,Inyo,027,18085,0,0,0,0,0
2020-02-25,Kern,029,883053,2,0,0,0,0
2020-02-25,Kings,031,150075,3,0,1,1,0
2020-02-25,Lake,033,64148,0,0,0,0,0
2020-02-25,Lassen,035,31185,0,0,0,0,0
2020-02-25,Los Angeles,037,10098052,77,1,6,7,0
2020-02-25,Madera,039,155013,2,0,0,0,0
2020-02-25,Marin,041,260295,1,0,0,0,0
2020-02-25,Mariposa,043,17540,0,0,0,0,0
2020-02-25,Mendocino,045,87422,0,0,0,0,0
2020-02-25,Merced,047,269075,0,0,0,0,0
2020-02-25,Modoc,049,8938,0,0,0,0,0
2020-02-25,Mono,051,14174,0,0,0,0,0
2020-02-25,Monterey,053,433212,1,0,0,0,0
2020-02-25,Napa,055,140530,0,0,0,0,0
2020-02-25,Nevada,057,99092,0,0,1,1,0
2020-02-25,Orange,059,3164182,45,1,0,1,0
2020-02-25,Placer,061,380077,5,0,0,0,0
2020-02-25,Plumas,063,18699,0,0,0,0,0
2020-02-25,Riverside,065,2383286,10,0,1,1,0
2020-02-25,Sacramento,067,1510023,8,1,0,1,0
2020-02-25,San Benito,069,59416,0,2,0,2,0
2020-02-25,San Bernardino,071,2135413,21,0,0,0,0
2020-02-25,San Diego,073,3302833,5,2,0,2,0
2020-02-25,San Francisco,075,870044,7,0,0,0,0
2020-02-25,San Joaquin,077,732212,5,0,2,2,0
2020-02-25,San Luis Obispo,079,281455,2,0,0,0,0
2020-02-25,San Mateo,081,765935,17,0,0,0,0
2020-02-25,Santa Barbara,083,443738,0,0,0,0,0
2020-02-25,Santa Clara,085,1922200,40,2,1,3,0
2020-02-25,Santa Cruz,087,273765,5,0,0,0,0
2020-02-25,Shasta,089,179085,0,0,0,0,0
2020-02-25,Sierra,091,2930,0,0,0,0,0
2020-02-25,Siskiyou,093,43540,0,0,0,0,0
2020-02-25,Solano,095,438530,16,21,0,21,0
2020-02-25,Sonoma,097,501317,5,0,0,0,0
2020-02-25,Stanislaus,099,539301,2,0,2,2,0
2020-02-25,Sutter,101,95872,0,0,0,0,0
2020-02-25,Tehama,103,63373,0,0,0,0,0
2020-02-25,Trinity,105,12862,0,0,0,0,0
2020-02-25,Tulare,107,460477,3,0,0,0,0
2020-02-25,Tuolumne,109,53932,0,0,0,0,0
2020-02-25,Ventura,111,848112,4,0,0,0,0
2020-02-25,Yolo,113,214977,1,0,0,0,0
2020-02-25,Yuba,115,75493,0,0,0,0,0
2020-02-24,Alameda,001,1643700,14,0,0,0,0
2020-02-24,Alpine,003,1148,0,0,0,0,0
2020-02-24,Amador,005,37829,0,0,0,0,0
2020-02-24,Butte,007,227075,0,0,0,0,0
2020-02-24,Calaveras,009,45235,0,0,0,0,0
2020-02-24,Colusa,011,21464,0,0,0,0,0
2020-02-24,Contra Costa,013,1133247,9,0,0,0,0
2020-02-24,Del Norte,015,27424,0,0,0,0,0
2020-02-24,El Dorado,017,186661,0,0,0,0,0
2020-02-24,Fresno,019,978130,1,0,0,0,0
2020-02-24,Glenn,021,27897,0,0,0,0,0
2020-02-24,Humboldt,023,135768,1,1,0,1,0
2020-02-24,Imperial,025,180216,1,0,0,0,0
2020-02-24,Inyo,027,18085,0,0,0,0,0
2020-02-24,Kern,029,883053,2,0,0,0,0
2020-02-24,Kings,031,150075,3,0,1,1,0
2020-02-24,Lake,033,64148,0,0,0,0,0
2020-02-24,Lassen,035,31185,0,0,0,0,0
2020-02-24,Los Angeles,037,10098052,71,1,6,7,0
2020-02-24,Madera,039,155013,1,0,0,0,0
2020-02-24,Marin,041,260295,1,0,0,0,0
2020-02-24,Mariposa,043,17540,0,0,0,0,0
2020-02-24,Mendocino,045,87422,0,0,0,0,0
2020-02-24,Merced,047,269075,0,0,0,0,0
2020-02-24,Modoc,049,8938,0,0,0,0,0
2020-02-24,Mono,051,14174,0,0,0,0,0
2020-02-24,Monterey,053,433212,1,0,0,0,0
2020-02-24,Napa,055,140530,0,0,0,0,0
2020-02-24,Nevada,057,99092,0,0,1,1,0
2020-02-24,Orange,059,3164182,43,1,0,1,0
2020-02-24,Placer,061,380077,3,0,0,0,0
2020-02-24,Plumas,063,18699,0,0,0,0,0
2020-02-24,Riverside,065,2383286,9,0,1,1,0
2020-02-24,Sacramento,067,1510023,7,1,0,1,0
2020-02-24,San Benito,069,59416,0,2,0,2,0
2020-02-24,San Bernardino,071,2135413,21,0,0,0,0
2020-02-24,San Diego,073,3302833,5,2,0,2,0
2020-02-24,San Francisco,075,870044,6,0,0,0,0
2020-02-24,San Joaquin,077,732212,5,0,1,1,0
2020-02-24,San Luis Obispo,079,281455,2,0,0,0,0
2020-02-24,San Mateo,081,765935,13,0,0,0,0
2020-02-24,Santa Barbara,083,443738,0,0,0,0,0
2020-02-24,Santa Clara,085,1922200,38,2,1,3,0
2020-02-24,Santa Cruz,087,273765,5,0,0,0,0
2020-02-24,Shasta,089,179085,0,0,0,0,0
2020-02-24,Sierra,091,2930,0,0,0,0,0
2020-02-24,Siskiyou,093,43540,0,0,0,0,0
2020-02-24,Solano,095,438530,13,15,0,15,0
2020-02-24,Sonoma,097,501317,5,0,0,0,0
2020-02-24,Stanislaus,099,539301,2,0,2,2,0
2020-02-24,Sutter,101,95872,0,0,0,0,0
2020-02-24,Tehama,103,63373,0,0,0,0,0
2020-02-24,Trinity,105,12862,0,0,0,0,0
2020-02-24,Tulare,107,460477,3,0,0,0,0
2020-02-24,Tuolumne,109,53932,0,0,0,0,0
2020-02-24,Ventura,111,848112,4,0,0,0,0
2020-02-24,Yolo,113,214977,1,0,0,0,0
2020-02-24,Yuba,115,75493,0,0,0,0,0
2020-02-23,Alameda,001,1643700,12,0,0,0,0
2020-02-23,Alpine,003,1148,0,0,0,0,0
2020-02-23,Amador,005,37829,0,0,0,0,0
2020-02-23,Butte,007,227075,0,0,0,0,0
2020-02-23,Calaveras,009,45235,0,0,0,0,0
2020-02-23,Colusa,011,21464,0,0,0,0,0
2020-02-23,Contra Costa,013,1133247,6,0,0,0,0
2020-02-23,Del Norte,015,27424,0,0,0,0,0
2020-02-23,El Dorado,017,186661,0,0,0,0,0
2020-02-23,Fresno,019,978130,1,0,0,0,0
2020-02-23,Glenn,021,27897,0,0,0,0,0
2020-02-23,Humboldt,023,135768,1,1,0,1,0
2020-02-23,Imperial,025,180216,1,0,0,0,0
2020-02-23,Inyo,027,18085,0,0,0,0,0
2020-02-23,Kern,029,883053,2,0,0,0,0
2020-02-23,Kings,031,150075,3,0,1,1,0
2020-02-23,Lake,033,64148,0,0,0,0,0
2020-02-23,Lassen,035,31185,0,0,0,0,0
2020-02-23,Los Angeles,037,10098052,63,1,6,7,0
2020-02-23,Madera,039,155013,1,0,0,0,0
2020-02-23,Marin,041,260295,1,0,0,0,0
2020-02-23,Mariposa,043,17540,0,0,0,0,0
2020-02-23,Mendocino,045,87422,0,0,0,0,0
2020-02-23,Merced,047,269075,0,0,0,0,0
2020-02-23,Modoc,049,8938,0,0,0,0,0
2020-02-23,Mono,051,14174,0,0,0,0,0
2020-02-23,Monterey,053,433212,1,0,0,0,0
2020-02-23,Napa,055,140530,0,0,0,0,0
2020-02-23,Nevada,057,99092,0,0,1,1,0
2020-02-23,Orange,059,3164182,43,1,0,1,0
2020-02-23,Placer,061,380077,3,0,0,0,0
2020-02-23,Plumas,063,18699,0,0,0,0,0
2020-02-23,Riverside,065,2383286,9,0,0,0,0
2020-02-23,Sacramento,067,1510023,6,1,0,1,0
2020-02-23,San Benito,069,59416,0,2,0,2,0
2020-02-23,San Bernardino,071,2135413,20,0,0,0,0
2020-02-23,San Diego,073,3302833,4,2,0,2,0
2020-02-23,San Francisco,075,870044,5,0,0,0,0
2020-02-23,San Joaquin,077,732212,4,0,1,1,0
2020-02-23,San Luis Obispo,079,281455,2,0,0,0,0
2020-02-23,San Mateo,081,765935,10,0,0,0,0
2020-02-23,Santa Barbara,083,443738,0,0,0,0,0
2020-02-23,Santa Clara,085,1922200,26,2,1,3,0
2020-02-23,Santa Cruz,087,273765,2,0,0,0,0
2020-02-23,Shasta,089,179085,0,0,0,0,0
2020-02-23,Sierra,091,2930,0,0,0,0,0
2020-02-23,Siskiyou,093,43540,0,0,0,0,0
2020-02-23,Solano,095,438530,11,15,0,15,0
2020-02-23,Sonoma,097,501317,5,0,0,0,0
2020-02-23,Stanislaus,099,539301,2,0,2,2,0
2020-02-23,Sutter,101,95872,0,0,0,0,0
2020-02-23,Tehama,103,63373,0,0,0,0,0
2020-02-23,Trinity,105,12862,0,0,0,0,0
2020-02-23,Tulare,107,460477,2,0,0,0,0
2020-02-23,Tuolumne,109,53932,0,0,0,0,0
2020-02-23,Ventura,111,848112,4,0,0,0,0
2020-02-23,Yolo,113,214977,1,0,0,0,0
2020-02-23,Yuba,115,75493,0,0,0,0,0
2020-02-22,Alameda,001,1643700,11,0,0,0,0
2020-02-22,Alpine,003,1148,0,0,0,0,0
2020-02-22,Amador,005,37829,0,0,0,0,0
2020-02-22,Butte,007,227075,0,0,0,0,0
2020-02-22,Calaveras,009,45235,0,0,0,0,0
2020-02-22,Colusa,011,21464,0,0,0,0,0
2020-02-22,Contra Costa,013,1133247,5,0,0,0,0
2020-02-22,Del Norte,015,27424,0,0,0,0,0
2020-02-22,El Dorado,017,186661,0,0,0,0,0
2020-02-22,Fresno,019,978130,1,0,0,0,0
2020-02-22,Glenn,021,27897,0,0,0,0,0
2020-02-22,Humboldt,023,135768,1,1,0,1,0
2020-02-22,Imperial,025,180216,0,0,0,0,0
2020-02-22,Inyo,027,18085,0,0,0,0,0
2020-02-22,Kern,029,883053,2,0,0,0,0
2020-02-22,Kings,031,150075,3,0,1,1,0
2020-02-22,Lake,033,64148,0,0,0,0,0
2020-02-22,Lassen,035,31185,0,0,0,0,0
2020-02-22,Los Angeles,037,10098052,61,1,6,7,0
2020-02-22,Madera,039,155013,0,0,0,0,0
2020-02-22,Marin,041,260295,1,0,0,0,0
2020-02-22,Mariposa,043,17540,0,0,0,0,0
2020-02-22,Mendocino,045,87422,0,0,0,0,0
2020-02-22,Merced,047,269075,0,0,0,0,0
2020-02-22,Modoc,049,8938,0,0,0,0,0
2020-02-22,Mono,051,14174,0,0,0,0,0
2020-02-22,Monterey,053,433212,1,0,0,0,0
2020-02-22,Napa,055,140530,0,0,0,0,0
2020-02-22,Nevada,057,99092,0,0,1,1,0
2020-02-22,Orange,059,3164182,42,1,0,1,0
2020-02-22,Placer,061,380077,3,0,0,0,0
2020-02-22,Plumas,063,18699,0,0,0,0,0
2020-02-22,Riverside,065,2383286,9,0,0,0,0
2020-02-22,Sacramento,067,1510023,6,1,0,1,0
2020-02-22,San Benito,069,59416,0,2,0,2,0
2020-02-22,San Bernardino,071,2135413,18,0,0,0,0
2020-02-22,San Diego,073,3302833,3,2,0,2,0
2020-02-22,San Francisco,075,870044,3,0,0,0,0
2020-02-22,San Joaquin,077,732212,4,0,1,1,0
2020-02-22,San Luis Obispo,079,281455,2,0,0,0,0
2020-02-22,San Mateo,081,765935,8,0,0,0,0
2020-02-22,Santa Barbara,083,443738,0,0,0,0,0
2020-02-22,Santa Clara,085,1922200,23,2,1,3,0
2020-02-22,Santa Cruz,087,273765,2,0,0,0,0
2020-02-22,Shasta,089,179085,0,0,0,0,0
2020-02-22,Sierra,091,2930,0,0,0,0,0
2020-02-22,Siskiyou,093,43540,0,0,0,0,0
2020-02-22,Solano,095,438530,11,11,0,11,0
2020-02-22,Sonoma,097,501317,4,0,0,0,0
2020-02-22,Stanislaus,099,539301,2,0,2,2,0
2020-02-22,Sutter,101,95872,0,0,0,0,0
2020-02-22,Tehama,103,63373,0,0,0,0,0
2020-02-22,Trinity,105,12862,0,0,0,0,0
2020-02-22,Tulare,107,460477,2,0,0,0,0
2020-02-22,Tuolumne,109,53932,0,0,0,0,0
2020-02-22,Ventura,111,848112,4,0,0,0,0
2020-02-22,Yolo,113,214977,0,0,0,0,0
2020-02-22,Yuba,115,75493,0,0,0,0,0
2020-02-21,Alameda,001,1643700,10,0,0,0,0
2020-02-21,Alpine,003,1148,0,0,0,0,0
2020-02-21,Amador,005,37829,0,0,0,0,0
2020-02-21,Butte,007,227075,0,0,0,0,0
2020-02-21,Calaveras,009,45235,0,0,0,0,0
2020-02-21,Colusa,011,21464,0,0,0,0,0
2020-02-21,Contra Costa,013,1133247,4,0,0,0,0
2020-02-21,Del Norte,015,27424,0,0,0,0,0
2020-02-21,El Dorado,017,186661,0,0,0,0,0
2020-02-21,Fresno,019,978130,1,0,0,0,0
2020-02-21,Glenn,021,27897,0,0,0,0,0
2020-02-21,Humboldt,023,135768,1,1,0,1,0
2020-02-21,Imperial,025,180216,0,0,0,0,0
2020-02-21,Inyo,027,18085,0,0,0,0,0
2020-02-21,Kern,029,883053,2,0,0,0,0
2020-02-21,Kings,031,150075,3,0,1,1,0
2020-02-21,Lake,033,64148,0,0,0,0,0
2020-02-21,Lassen,035,31185,0,0,0,0,0
2020-02-21,Los Angeles,037,10098052,57,1,6,7,0
2020-02-21,Madera,039,155013,0,0,0,0,0
2020-02-21,Marin,041,260295,1,0,0,0,0
2020-02-21,Mariposa,043,17540,0,0,0,0,0
2020-02-21,Mendocino,045,87422,0,0,0,0,0
2020-02-21,Merced,047,269075,0,0,0,0,0
2020-02-21,Modoc,049,8938,0,0,0,0,0
2020-02-21,Mono,051,14174,0,0,0,0,0
2020-02-21,Monterey,053,433212,1,0,0,0,0
2020-02-21,Napa,055,140530,0,0,0,0,0
2020-02-21,Nevada,057,99092,0,0,1,1,0
2020-02-21,Orange,059,3164182,40,1,0,1,0
2020-02-21,Placer,061,380077,2,0,0,0,0
2020-02-21,Plumas,063,18699,0,0,0,0,0
2020-02-21,Riverside,065,2383286,9,0,0,0,0
2020-02-21,Sacramento,067,1510023,5,1,0,1,0
2020-02-21,San Benito,069,59416,0,2,0,2,0
2020-02-21,San Bernardino,071,2135413,17,0,0,0,0
2020-02-21,San Diego,073,3302833,3,2,0,2,0
2020-02-21,San Francisco,075,870044,3,0,0,0,0
2020-02-21,San Joaquin,077,732212,2,0,1,1,0
2020-02-21,San Luis Obispo,079,281455,2,0,0,0,0
2020-02-21,San Mateo,081,765935,8,0,0,0,0
2020-02-21,Santa Barbara,083,443738,0,0,0,0,0
2020-02-21,Santa Clara,085,1922200,21,2,1,3,0
2020-02-21,Santa Cruz,087,273765,2,0,0,0,0
2020-02-21,Shasta,089,179085,0,0,0,0,0
2020-02-21,Sierra,091,2930,0,0,0,0,0
2020-02-21,Siskiyou,093,43540,0,0,0,0,0
2020-02-21,Solano,095,438530,10,11,0,11,0
2020-02-21,Sonoma,097,501317,3,0,0,0,0
2020-02-21,Stanislaus,099,539301,2,0,2,2,0
2020-02-21,Sutter,101,95872,0,0,0,0,0
2020-02-21,Tehama,103,63373,0,0,0,0,0
2020-02-21,Trinity,105,12862,0,0,0,0,0
2020-02-21,Tulare,107,460477,2,0,0,0,0
2020-02-21,Tuolumne,109,53932,0,0,0,0,0
2020-02-21,Ventura,111,848112,4,0,0,0,0
2020-02-21,Yolo,113,214977,0,0,0,0,0
2020-02-21,Yuba,115,75493,0,0,0,0,0
2020-02-20,Alameda,001,1643700,8,0,0,0,0
2020-02-20,Alpine,003,1148,0,0,0,0,0
2020-02-20,Amador,005,37829,0,0,0,0,0
2020-02-20,Butte,007,227075,0,0,0,0,0
2020-02-20,Calaveras,009,45235,0,0,0,0,0
2020-02-20,Colusa,011,21464,0,0,0,0,0
2020-02-20,Contra Costa,013,1133247,3,0,0,0,0
2020-02-20,Del Norte,015,27424,0,0,0,0,0
2020-02-20,El Dorado,017,186661,0,0,0,0,0
2020-02-20,Fresno,019,978130,1,0,0,0,0
2020-02-20,Glenn,021,27897,0,0,0,0,0
2020-02-20,Humboldt,023,135768,1,1,0,1,0
2020-02-20,Imperial,025,180216,0,0,0,0,0
2020-02-20,Inyo,027,18085,0,0,0,0,0
2020-02-20,Kern,029,883053,2,0,0,0,0
2020-02-20,Kings,031,150075,3,0,1,1,0
2020-02-20,Lake,033,64148,0,0,0,0,0
2020-02-20,Lassen,035,31185,0,0,0,0,0
2020-02-20,Los Angeles,037,10098052,56,1,5,6,0
2020-02-20,Madera,039,155013,0,0,0,0,0
2020-02-20,Marin,041,260295,0,0,0,0,0
2020-02-20,Mariposa,043,17540,0,0,0,0,0
2020-02-20,Mendocino,045,87422,0,0,0,0,0
2020-02-20,Merced,047,269075,0,0,0,0,0
2020-02-20,Modoc,049,8938,0,0,0,0,0
2020-02-20,Mono,051,14174,0,0,0,0,0
2020-02-20,Monterey,053,433212,1,0,0,0,0
2020-02-20,Napa,055,140530,0,0,0,0,0
2020-02-20,Nevada,057,99092,0,0,1,1,0
2020-02-20,Orange,059,3164182,40,1,0,1,0
2020-02-20,Placer,061,380077,2,0,0,0,0
2020-02-20,Plumas,063,18699,0,0,0,0,0
2020-02-20,Riverside,065,2383286,7,0,0,0,0
2020-02-20,Sacramento,067,1510023,2,1,0,1,0
2020-02-20,San Benito,069,59416,0,2,0,2,0
2020-02-20,San Bernardino,071,2135413,15,0,0,0,0
2020-02-20,San Diego,073,3302833,3,2,0,2,0
2020-02-20,San Francisco,075,870044,3,0,0,0,0
2020-02-20,San Joaquin,077,732212,2,0,1,1,0
2020-02-20,San Luis Obispo,079,281455,2,0,0,0,0
2020-02-20,San Mateo,081,765935,7,0,0,0,0
2020-02-20,Santa Barbara,083,443738,0,0,0,0,0
2020-02-20,Santa Clara,085,1922200,17,2,1,3,0
2020-02-20,Santa Cruz,087,273765,2,0,0,0,0
2020-02-20,Shasta,089,179085,0,0,0,0,0
2020-02-20,Sierra,091,2930,0,0,0,0,0
2020-02-20,Siskiyou,093,43540,0,0,0,0,0
2020-02-20,Solano,095,438530,8,7,0,7,0
2020-02-20,Sonoma,097,501317,2,0,0,0,0
2020-02-20,Stanislaus,099,539301,2,0,2,2,0
2020-02-20,Sutter,101,95872,0,0,0,0,0
2020-02-20,Tehama,103,63373,0,0,0,0,0
2020-02-20,Trinity,105,12862,0,0,0,0,0
2020-02-20,Tulare,107,460477,2,0,0,0,0
2020-02-20,Tuolumne,109,53932,0,0,0,0,0
2020-02-20,Ventura,111,848112,4,0,0,0,0
2020-02-20,Yolo,113,214977,0,0,0,0,0
2020-02-20,Yuba,115,75493,0,0,0,0,0
2020-02-19,Alameda,001,1643700,7,0,0,0,0
2020-02-19,Alpine,003,1148,0,0,0,0,0
2020-02-19,Amador,005,37829,0,0,0,0,0
2020-02-19,Butte,007,227075,0,0,0,0,0
2020-02-19,Calaveras,009,45235,0,0,0,0,0
2020-02-19,Colusa,011,21464,0,0,0,0,0
2020-02-19,Contra Costa,013,1133247,3,0,0,0,0
2020-02-19,Del Norte,015,27424,0,0,0,0,0
2020-02-19,El Dorado,017,186661,0,0,0,0,0
2020-02-19,Fresno,019,978130,1,0,0,0,0
2020-02-19,Glenn,021,27897,0,0,0,0,0
2020-02-19,Humboldt,023,135768,1,0,0,0,0
2020-02-19,Imperial,025,180216,0,0,0,0,0
2020-02-19,Inyo,027,18085,0,0,0,0,0
2020-02-19,Kern,029,883053,2,0,0,0,0
2020-02-19,Kings,031,150075,3,0,1,1,0
2020-02-19,Lake,033,64148,0,0,0,0,0
2020-02-19,Lassen,035,31185,0,0,0,0,0
2020-02-19,Los Angeles,037,10098052,53,1,5,6,0
2020-02-19,Madera,039,155013,0,0,0,0,0
2020-02-19,Marin,041,260295,0,0,0,0,0
2020-02-19,Mariposa,043,17540,0,0,0,0,0
2020-02-19,Mendocino,045,87422,0,0,0,0,0
2020-02-19,Merced,047,269075,0,0,0,0,0
2020-02-19,Modoc,049,8938,0,0,0,0,0
2020-02-19,Mono,051,14174,0,0,0,0,0
2020-02-19,Monterey,053,433212,1,0,0,0,0
2020-02-19,Napa,055,140530,0,0,0,0,0
2020-02-19,Nevada,057,99092,0,0,1,1,0
2020-02-19,Orange,059,3164182,39,1,0,1,0
2020-02-19,Placer,061,380077,2,0,0,0,0
2020-02-19,Plumas,063,18699,0,0,0,0,0
2020-02-19,Riverside,065,2383286,5,0,0,0,0
2020-02-19,Sacramento,067,1510023,2,0,0,0,0
2020-02-19,San Benito,069,59416,0,2,0,2,0
2020-02-19,San Bernardino,071,2135413,14,0,0,0,0
2020-02-19,San Diego,073,3302833,2,2,0,2,0
2020-02-19,San Francisco,075,870044,2,0,0,0,0
2020-02-19,San Joaquin,077,732212,2,0,1,1,0
2020-02-19,San Luis Obispo,079,281455,2,0,0,0,0
2020-02-19,San Mateo,081,765935,6,0,0,0,0
2020-02-19,Santa Barbara,083,443738,0,0,0,0,0
2020-02-19,Santa Clara,085,1922200,15,2,1,3,0
2020-02-19,Santa Cruz,087,273765,0,0,0,0,0
2020-02-19,Shasta,089,179085,0,0,0,0,0
2020-02-19,Sierra,091,2930,0,0,0,0,0
2020-02-19,Siskiyou,093,43540,0,0,0,0,0
2020-02-19,Solano,095,438530,5,7,0,7,0
2020-02-19,Sonoma,097,501317,2,0,0,0,0
2020-02-19,Stanislaus,099,539301,1,0,2,2,0
2020-02-19,Sutter,101,95872,0,0,0,0,0
2020-02-19,Tehama,103,63373,0,0,0,0,0
2020-02-19,Trinity,105,12862,0,0,0,0,0
2020-02-19,Tulare,107,460477,2,0,0,0,0
2020-02-19,Tuolumne,109,53932,0,0,0,0,0
2020-02-19,Ventura,111,848112,2,0,0,0,0
2020-02-19,Yolo,113,214977,0,0,0,0,0
2020-02-19,Yuba,115,75493,0,0,0,0,0
2020-02-18,Alameda,001,1643700,7,0,0,0,0
2020-02-18,Alpine,003,1148,0,0,0,0,0
2020-02-18,Amador,005,37829,0,0,0,0,0
2020-02-18,Butte,007,227075,0,0,0,0,0
2020-02-18,Calaveras,009,45235,0,0,0,0,0
2020-02-18,Colusa,011,21464,0,0,0,0,0
2020-02-18,Contra Costa,013,1133247,3,0,0,0,0
2020-02-18,Del Norte,015,27424,0,0,0,0,0
2020-02-18,El Dorado,017,186661,0,0,0,0,0
2020-02-18,Fresno,019,978130,0,0,0,0,0
2020-02-18,Glenn,021,27897,0,0,0,0,0
2020-02-18,Humboldt,023,135768,1,0,0,0,0
2020-02-18,Imperial,025,180216,0,0,0,0,0
2020-02-18,Inyo,027,18085,0,0,0,0,0
2020-02-18,Kern,029,883053,2,0,0,0,0
2020-02-18,Kings,031,150075,3,0,1,1,0
2020-02-18,Lake,033,64148,0,0,0,0,0
2020-02-18,Lassen,035,31185,0,0,0,0,0
2020-02-18,Los Angeles,037,10098052,50,1,4,5,0
2020-02-18,Madera,039,155013,0,0,0,0,0
2020-02-18,Marin,041,260295,0,0,0,0,0
2020-02-18,Mariposa,043,17540,0,0,0,0,0
2020-02-18,Mendocino,045,87422,0,0,0,0,0
2020-02-18,Merced,047,269075,0,0,0,0,0
2020-02-18,Modoc,049,8938,0,0,0,0,0
2020-02-18,Mono,051,14174,0,0,0,0,0
2020-02-18,Monterey,053,433212,1,0,0,0,0
2020-02-18,Napa,055,140530,0,0,0,0,0
2020-02-18,Nevada,057,99092,0,0,1,1,0
2020-02-18,Orange,059,3164182,38,1,0,1,0
2020-02-18,Placer,061,380077,0,0,0,0,0
2020-02-18,Plumas,063,18699,0,0,0,0,0
2020-02-18,Riverside,065,2383286,5,0,0,0,0
2020-02-18,Sacramento,067,1510023,2,0,0,0,0
2020-02-18,San Benito,069,59416,0,2,0,2,0
2020-02-18,San Bernardino,071,2135413,13,0,0,0,0
2020-02-18,San Diego,073,3302833,2,2,0,2,0
2020-02-18,San Francisco,075,870044,2,0,0,0,0
2020-02-18,San Joaquin,077,732212,1,0,1,1,0
2020-02-18,San Luis Obispo,079,281455,2,0,0,0,0
2020-02-18,San Mateo,081,765935,5,0,0,0,0
2020-02-18,Santa Barbara,083,443738,0,0,0,0,0
2020-02-18,Santa Clara,085,1922200,14,2,1,3,0
2020-02-18,Santa Cruz,087,273765,0,0,0,0,0
2020-02-18,Shasta,089,179085,0,0,0,0,0
2020-02-18,Sierra,091,2930,0,0,0,0,0
2020-02-18,Siskiyou,093,43540,0,0,0,0,0
2020-02-18,Solano,095,438530,5,7,0,7,0
2020-02-18,Sonoma,097,501317,1,0,0,0,0
2020-02-18,Stanislaus,099,539301,1,0,2,2,0
2020-02-18,Sutter,101,95872,0,0,0,0,0
2020-02-18,Tehama,103,63373,0,0,0,0,0
2020-02-18,Trinity,105,12862,0,0,0,0,0
2020-02-18,Tulare,107,460477,2,0,0,0,0
2020-02-18,Tuolumne,109,53932,0,0,0,0,0
2020-02-18,Ventura,111,848112,2,0,0,0,0
2020-02-18,Yolo,113,214977,0,0,0,0,0
2020-02-18,Yuba,115,75493,0,0,0,0,0
2020-02-17,Alameda,001,1643700,7,0,0,0,0
2020-02-17,Alpine,003,1148,0,0,0,0,0
2020-02-17,Amador,005,37829,0,0,0,0,0
2020-02-17,Butte,007,227075,0,0,0,0,0
2020-02-17,Calaveras,009,45235,0,0,0,0,0
2020-02-17,Colusa,011,21464,0,0,0,0,0
2020-02-17,Contra Costa,013,1133247,3,0,0,0,0
2020-02-17,Del Norte,015,27424,0,0,0,0,0
2020-02-17,El Dorado,017,186661,0,0,0,0,0
2020-02-17,Fresno,019,978130,0,0,0,0,0
2020-02-17,Glenn,021,27897,0,0,0,0,0
2020-02-17,Humboldt,023,135768,1,0,0,0,0
2020-02-17,Imperial,025,180216,0,0,0,0,0
2020-02-17,Inyo,027,18085,0,0,0,0,0
2020-02-17,Kern,029,883053,2,0,0,0,0
2020-02-17,Kings,031,150075,3,0,0,0,0
2020-02-17,Lake,033,64148,0,0,0,0,0
2020-02-17,Lassen,035,31185,0,0,0,0,0
2020-02-17,Los Angeles,037,10098052,47,1,4,5,0
2020-02-17,Madera,039,155013,0,0,0,0,0
2020-02-17,Marin,041,260295,0,0,0,0,0
2020-02-17,Mariposa,043,17540,0,0,0,0,0
2020-02-17,Mendocino,045,87422,0,0,0,0,0
2020-02-17,Merced,047,269075,0,0,0,0,0
2020-02-17,Modoc,049,8938,0,0,0,0,0
2020-02-17,Mono,051,14174,0,0,0,0,0
2020-02-17,Monterey,053,433212,1,0,0,0,0
2020-02-17,Napa,055,140530,0,0,0,0,0
2020-02-17,Nevada,057,99092,0,0,1,1,0
2020-02-17,Orange,059,3164182,38,1,0,1,0
2020-02-17,Placer,061,380077,0,0,0,0,0
2020-02-17,Plumas,063,18699,0,0,0,0,0
2020-02-17,Riverside,065,2383286,5,0,0,0,0
2020-02-17,Sacramento,067,1510023,2,0,0,0,0
2020-02-17,San Benito,069,59416,0,2,0,2,0
2020-02-17,San Bernardino,071,2135413,11,0,0,0,0
2020-02-17,San Diego,073,3302833,2,2,0,2,0
2020-02-17,San Francisco,075,870044,2,0,0,0,0
2020-02-17,San Joaquin,077,732212,1,0,1,1,0
2020-02-17,San Luis Obispo,079,281455,1,0,0,0,0
2020-02-17,San Mateo,081,765935,5,0,0,0,0
2020-02-17,Santa Barbara,083,443738,0,0,0,0,0
2020-02-17,Santa Clara,085,1922200,12,2,1,3,0
2020-02-17,Santa Cruz,087,273765,0,0,0,0,0
2020-02-17,Shasta,089,179085,0,0,0,0,0
2020-02-17,Sierra,091,2930,0,0,0,0,0
2020-02-17,Siskiyou,093,43540,0,0,0,0,0
2020-02-17,Solano,095,438530,3,5,0,5,0
2020-02-17,Sonoma,097,501317,1,0,0,0,0
2020-02-17,Stanislaus,099,539301,1,0,2,2,0
2020-02-17,Sutter,101,95872,0,0,0,0,0
2020-02-17,Tehama,103,63373,0,0,0,0,0
2020-02-17,Trinity,105,12862,0,0,0,0,0
2020-02-17,Tulare,107,460477,2,0,0,0,0
2020-02-17,Tuolumne,109,53932,0,0,0,0,0
2020-02-17,Ventura,111,848112,2,0,0,0,0
2020-02-17,Yolo,113,214977,0,0,0,0,0
2020-02-17,Yuba,115,75493,0,0,0,0,0
2020-02-16,Alameda,001,1643700,6,0,0,0,0
2020-02-16,Alpine,003,1148,0,0,0,0,0
2020-02-16,Amador,005,37829,0,0,0,0,0
2020-02-16,Butte,007,227075,0,0,0,0,0
2020-02-16,Calaveras,009,45235,0,0,0,0,0
2020-02-16,Colusa,011,21464,0,0,0,0,0
2020-02-16,Contra Costa,013,1133247,3,0,0,0,0
2020-02-16,Del Norte,015,27424,0,0,0,0,0
2020-02-16,El Dorado,017,186661,0,0,0,0,0
2020-02-16,Fresno,019,978130,0,0,0,0,0
2020-02-16,Glenn,021,27897,0,0,0,0,0
2020-02-16,Humboldt,023,135768,1,0,0,0,0
2020-02-16,Imperial,025,180216,0,0,0,0,0
2020-02-16,Inyo,027,18085,0,0,0,0,0
2020-02-16,Kern,029,883053,2,0,0,0,0
2020-02-16,Kings,031,150075,3,0,0,0,0
2020-02-16,Lake,033,64148,0,0,0,0,0
2020-02-16,Lassen,035,31185,0,0,0,0,0
2020-02-16,Los Angeles,037,10098052,42,1,4,5,0
2020-02-16,Madera,039,155013,0,0,0,0,0
2020-02-16,Marin,041,260295,0,0,0,0,0
2020-02-16,Mariposa,043,17540,0,0,0,0,0
2020-02-16,Mendocino,045,87422,0,0,0,0,0
2020-02-16,Merced,047,269075,0,0,0,0,0
2020-02-16,Modoc,049,8938,0,0,0,0,0
2020-02-16,Mono,051,14174,0,0,0,0,0
2020-02-16,Monterey,053,433212,1,0,0,0,0
2020-02-16,Napa,055,140530,0,0,0,0,0
2020-02-16,Nevada,057,99092,0,0,0,0,0
2020-02-16,Orange,059,3164182,37,1,0,1,0
2020-02-16,Placer,061,380077,0,0,0,0,0
2020-02-16,Plumas,063,18699,0,0,0,0,0
2020-02-16,Riverside,065,2383286,5,0,0,0,0
2020-02-16,Sacramento,067,1510023,2,0,0,0,0
2020-02-16,San Benito,069,59416,0,2,0,2,0
2020-02-16,San Bernardino,071,2135413,10,0,0,0,0
2020-02-16,San Diego,073,3302833,2,2,0,2,0
2020-02-16,San Francisco,075,870044,2,0,0,0,0
2020-02-16,San Joaquin,077,732212,1,0,1,1,0
2020-02-16,San Luis Obispo,079,281455,1,0,0,0,0
2020-02-16,San Mateo,081,765935,4,0,0,0,0
2020-02-16,Santa Barbara,083,443738,0,0,0,0,0
2020-02-16,Santa Clara,085,1922200,10,2,1,3,0
2020-02-16,Santa Cruz,087,273765,0,0,0,0,0
2020-02-16,Shasta,089,179085,0,0,0,0,0
2020-02-16,Sierra,091,2930,0,0,0,0,0
2020-02-16,Siskiyou,093,43540,0,0,0,0,0
2020-02-16,Solano,095,438530,1,0,0,0,0
2020-02-16,Sonoma,097,501317,1,0,0,0,0
2020-02-16,Stanislaus,099,539301,1,0,2,2,0
2020-02-16,Sutter,101,95872,0,0,0,0,0
2020-02-16,Tehama,103,63373,0,0,0,0,0
2020-02-16,Trinity,105,12862,0,0,0,0,0
2020-02-16,Tulare,107,460477,2,0,0,0,0
2020-02-16,Tuolumne,109,53932,0,0,0,0,0
2020-02-16,Ventura,111,848112,2,0,0,0,0
2020-02-16,Yolo,113,214977,0,0,0,0,0
2020-02-16,Yuba,115,75493,0,0,0,0,0
2020-02-15,Alameda,001,1643700,6,0,0,0,0
2020-02-15,Alpine,003,1148,0,0,0,0,0
2020-02-15,Amador,005,37829,0,0,0,0,0
2020-02-15,Butte,007,227075,0,0,0,0,0
2020-02-15,Calaveras,009,45235,0,0,0,0,0
2020-02-15,Colusa,011,21464,0,0,0,0,0
2020-02-15,Contra Costa,013,1133247,3,0,0,0,0
2020-02-15,Del Norte,015,27424,0,0,0,0,0
2020-02-15,El Dorado,017,186661,0,0,0,0,0
2020-02-15,Fresno,019,978130,0,0,0,0,0
2020-02-15,Glenn,021,27897,0,0,0,0,0
2020-02-15,Humboldt,023,135768,1,0,0,0,0
2020-02-15,Imperial,025,180216,0,0,0,0,0
2020-02-15,Inyo,027,18085,0,0,0,0,0
2020-02-15,Kern,029,883053,2,0,0,0,0
2020-02-15,Kings,031,150075,3,0,0,0,0
2020-02-15,Lake,033,64148,0,0,0,0,0
2020-02-15,Lassen,035,31185,0,0,0,0,0
2020-02-15,Los Angeles,037,10098052,39,1,4,5,0
2020-02-15,Madera,039,155013,0,0,0,0,0
2020-02-15,Marin,041,260295,0,0,0,0,0
2020-02-15,Mariposa,043,17540,0,0,0,0,0
2020-02-15,Mendocino,045,87422,0,0,0,0,0
2020-02-15,Merced,047,269075,0,0,0,0,0
2020-02-15,Modoc,049,8938,0,0,0,0,0
2020-02-15,Mono,051,14174,0,0,0,0,0
2020-02-15,Monterey,053,433212,1,0,0,0,0
2020-02-15,Napa,055,140530,0,0,0,0,0
2020-02-15,Nevada,057,99092,0,0,0,0,0
2020-02-15,Orange,059,3164182,36,1,0,1,0
2020-02-15,Placer,061,380077,0,0,0,0,0
2020-02-15,Plumas,063,18699,0,0,0,0,0
2020-02-15,Riverside,065,2383286,4,0,0,0,0
2020-02-15,Sacramento,067,1510023,2,0,0,0,0
2020-02-15,San Benito,069,59416,0,2,0,2,0
2020-02-15,San Bernardino,071,2135413,9,0,0,0,0
2020-02-15,San Diego,073,3302833,2,2,0,2,0
2020-02-15,San Francisco,075,870044,2,0,0,0,0
2020-02-15,San Joaquin,077,732212,1,0,1,1,0
2020-02-15,San Luis Obispo,079,281455,1,0,0,0,0
2020-02-15,San Mateo,081,765935,4,0,0,0,0
2020-02-15,Santa Barbara,083,443738,0,0,0,0,0
2020-02-15,Santa Clara,085,1922200,10,2,1,3,0
2020-02-15,Santa Cruz,087,273765,0,0,0,0,0
2020-02-15,Shasta,089,179085,0,0,0,0,0
2020-02-15,Sierra,091,2930,0,0,0,0,0
2020-02-15,Siskiyou,093,43540,0,0,0,0,0
2020-02-15,Solano,095,438530,1,0,0,0,0
2020-02-15,Sonoma,097,501317,0,0,0,0,0
2020-02-15,Stanislaus,099,539301,1,0,2,2,0
2020-02-15,Sutter,101,95872,0,0,0,0,0
2020-02-15,Tehama,103,63373,0,0,0,0,0
2020-02-15,Trinity,105,12862,0,0,0,0,0
2020-02-15,Tulare,107,460477,2,0,0,0,0
2020-02-15,Tuolumne,109,53932,0,0,0,0,0
2020-02-15,Ventura,111,848112,2,0,0,0,0
2020-02-15,Yolo,113,214977,0,0,0,0,0
2020-02-15,Yuba,115,75493,0,0,0,0,0
2020-02-14,Alameda,001,1643700,5,0,0,0,0
2020-02-14,Alpine,003,1148,0,0,0,0,0
2020-02-14,Amador,005,37829,0,0,0,0,0
2020-02-14,Butte,007,227075,0,0,0,0,0
2020-02-14,Calaveras,009,45235,0,0,0,0,0
2020-02-14,Colusa,011,21464,0,0,0,0,0
2020-02-14,Contra Costa,013,1133247,3,0,0,0,0
2020-02-14,Del Norte,015,27424,0,0,0,0,0
2020-02-14,El Dorado,017,186661,0,0,0,0,0
2020-02-14,Fresno,019,978130,0,0,0,0,0
2020-02-14,Glenn,021,27897,0,0,0,0,0
2020-02-14,Humboldt,023,135768,1,0,0,0,0
2020-02-14,Imperial,025,180216,0,0,0,0,0
2020-02-14,Inyo,027,18085,0,0,0,0,0
2020-02-14,Kern,029,883053,2,0,0,0,0
2020-02-14,Kings,031,150075,1,0,0,0,0
2020-02-14,Lake,033,64148,0,0,0,0,0
2020-02-14,Lassen,035,31185,0,0,0,0,0
2020-02-14,Los Angeles,037,10098052,34,1,4,5,0
2020-02-14,Madera,039,155013,0,0,0,0,0
2020-02-14,Marin,041,260295,0,0,0,0,0
2020-02-14,Mariposa,043,17540,0,0,0,0,0
2020-02-14,Mendocino,045,87422,0,0,0,0,0
2020-02-14,Merced,047,269075,0,0,0,0,0
2020-02-14,Modoc,049,8938,0,0,0,0,0
2020-02-14,Mono,051,14174,0,0,0,0,0
2020-02-14,Monterey,053,433212,1,0,0,0,0
2020-02-14,Napa,055,140530,0,0,0,0,0
2020-02-14,Nevada,057,99092,0,0,0,0,0
2020-02-14,Orange,059,3164182,36,1,0,1,0
2020-02-14,Placer,061,380077,0,0,0,0,0
2020-02-14,Plumas,063,18699,0,0,0,0,0
2020-02-14,Riverside,065,2383286,4,0,0,0,0
2020-02-14,Sacramento,067,1510023,1,0,0,0,0
2020-02-14,San Benito,069,59416,0,2,0,2,0
2020-02-14,San Bernardino,071,2135413,9,0,0,0,0
2020-02-14,San Diego,073,3302833,1,2,0,2,0
2020-02-14,San Francisco,075,870044,2,0,0,0,0
2020-02-14,San Joaquin,077,732212,1,0,1,1,0
2020-02-14,San Luis Obispo,079,281455,0,0,0,0,0
2020-02-14,San Mateo,081,765935,3,0,0,0,0
2020-02-14,Santa Barbara,083,443738,0,0,0,0,0
2020-02-14,Santa Clara,085,1922200,8,2,1,3,0
2020-02-14,Santa Cruz,087,273765,0,0,0,0,0
2020-02-14,Shasta,089,179085,0,0,0,0,0
2020-02-14,Sierra,091,2930,0,0,0,0,0
2020-02-14,Siskiyou,093,43540,0,0,0,0,0
2020-02-14,Solano,095,438530,1,0,0,0,0
2020-02-14,Sonoma,097,501317,0,0,0,0,0
2020-02-14,Stanislaus,099,539301,1,0,2,2,0
2020-02-14,Sutter,101,95872,0,0,0,0,0
2020-02-14,Tehama,103,63373,0,0,0,0,0
2020-02-14,Trinity,105,12862,0,0,0,0,0
2020-02-14,Tulare,107,460477,2,0,0,0,0
2020-02-14,Tuolumne,109,53932,0,0,0,0,0
2020-02-14,Ventura,111,848112,2,0,0,0,0
2020-02-14,Yolo,113,214977,0,0,0,0,0
2020-02-14,Yuba,115,75493,0,0,0,0,0
2020-02-13,Alameda,001,1643700,5,0,0,0,0
2020-02-13,Alpine,003,1148,0,0,0,0,0
2020-02-13,Amador,005,37829,0,0,0,0,0
2020-02-13,Butte,007,227075,0,0,0,0,0
2020-02-13,Calaveras,009,45235,0,0,0,0,0
2020-02-13,Colusa,011,21464,0,0,0,0,0
2020-02-13,Contra Costa,013,1133247,3,0,0,0,0
2020-02-13,Del Norte,015,27424,0,0,0,0,0
2020-02-13,El Dorado,017,186661,0,0,0,0,0
2020-02-13,Fresno,019,978130,0,0,0,0,0
2020-02-13,Glenn,021,27897,0,0,0,0,0
2020-02-13,Humboldt,023,135768,1,0,0,0,0
2020-02-13,Imperial,025,180216,0,0,0,0,0
2020-02-13,Inyo,027,18085,0,0,0,0,0
2020-02-13,Kern,029,883053,2,0,0,0,0
2020-02-13,Kings,031,150075,1,0,0,0,0
2020-02-13,Lake,033,64148,0,0,0,0,0
2020-02-13,Lassen,035,31185,0,0,0,0,0
2020-02-13,Los Angeles,037,10098052,31,1,3,4,0
2020-02-13,Madera,039,155013,0,0,0,0,0
2020-02-13,Marin,041,260295,0,0,0,0,0
2020-02-13,Mariposa,043,17540,0,0,0,0,0
2020-02-13,Mendocino,045,87422,0,0,0,0,0
2020-02-13,Merced,047,269075,0,0,0,0,0
2020-02-13,Modoc,049,8938,0,0,0,0,0
2020-02-13,Mono,051,14174,0,0,0,0,0
2020-02-13,Monterey,053,433212,1,0,0,0,0
2020-02-13,Napa,055,140530,0,0,0,0,0
2020-02-13,Nevada,057,99092,0,0,0,0,0
2020-02-13,Orange,059,3164182,35,1,0,1,0
2020-02-13,Placer,061,380077,0,0,0,0,0
2020-02-13,Plumas,063,18699,0,0,0,0,0
2020-02-13,Riverside,065,2383286,4,0,0,0,0
2020-02-13,Sacramento,067,1510023,1,0,0,0,0
2020-02-13,San Benito,069,59416,0,2,0,2,0
2020-02-13,San Bernardino,071,2135413,8,0,0,0,0
2020-02-13,San Diego,073,3302833,0,2,0,2,0
2020-02-13,San Francisco,075,870044,2,0,0,0,0
2020-02-13,San Joaquin,077,732212,1,0,1,1,0
2020-02-13,San Luis Obispo,079,281455,0,0,0,0,0
2020-02-13,San Mateo,081,765935,2,0,0,0,0
2020-02-13,Santa Barbara,083,443738,0,0,0,0,0
2020-02-13,Santa Clara,085,1922200,7,2,0,2,0
2020-02-13,Santa Cruz,087,273765,0,0,0,0,0
2020-02-13,Shasta,089,179085,0,0,0,0,0
2020-02-13,Sierra,091,2930,0,0,0,0,0
2020-02-13,Siskiyou,093,43540,0,0,0,0,0
2020-02-13,Solano,095,438530,0,0,0,0,0
2020-02-13,Sonoma,097,501317,0,0,0,0,0
2020-02-13,Stanislaus,099,539301,1,0,1,1,0
2020-02-13,Sutter,101,95872,0,0,0,0,0
2020-02-13,Tehama,103,63373,0,0,0,0,0
2020-02-13,Trinity,105,12862,0,0,0,0,0
2020-02-13,Tulare,107,460477,2,0,0,0,0
2020-02-13,Tuolumne,109,53932,0,0,0,0,0
2020-02-13,Ventura,111,848112,2,0,0,0,0
2020-02-13,Yolo,113,214977,0,0,0,0,0
2020-02-13,Yuba,115,75493,0,0,0,0,0
2020-02-12,Alameda,001,1643700,5,0,0,0,0
2020-02-12,Alpine,003,1148,0,0,0,0,0
2020-02-12,Amador,005,37829,0,0,0,0,0
2020-02-12,Butte,007,227075,0,0,0,0,0
2020-02-12,Calaveras,009,45235,0,0,0,0,0
2020-02-12,Colusa,011,21464,0,0,0,0,0
2020-02-12,Contra Costa,013,1133247,3,0,0,0,0
2020-02-12,Del Norte,015,27424,0,0,0,0,0
2020-02-12,El Dorado,017,186661,0,0,0,0,0
2020-02-12,Fresno,019,978130,0,0,0,0,0
2020-02-12,Glenn,021,27897,0,0,0,0,0
2020-02-12,Humboldt,023,135768,1,0,0,0,0
2020-02-12,Imperial,025,180216,0,0,0,0,0
2020-02-12,Inyo,027,18085,0,0,0,0,0
2020-02-12,Kern,029,883053,2,0,0,0,0
2020-02-12,Kings,031,150075,1,0,0,0,0
2020-02-12,Lake,033,64148,0,0,0,0,0
2020-02-12,Lassen,035,31185,0,0,0,0,0
2020-02-12,Los Angeles,037,10098052,30,1,3,4,0
2020-02-12,Madera,039,155013,0,0,0,0,0
2020-02-12,Marin,041,260295,0,0,0,0,0
2020-02-12,Mariposa,043,17540,0,0,0,0,0
2020-02-12,Mendocino,045,87422,0,0,0,0,0
2020-02-12,Merced,047,269075,0,0,0,0,0
2020-02-12,Modoc,049,8938,0,0,0,0,0
2020-02-12,Mono,051,14174,0,0,0,0,0
2020-02-12,Monterey,053,433212,1,0,0,0,0
2020-02-12,Napa,055,140530,0,0,0,0,0
2020-02-12,Nevada,057,99092,0,0,0,0,0
2020-02-12,Orange,059,3164182,35,1,0,1,0
2020-02-12,Placer,061,380077,0,0,0,0,0
2020-02-12,Plumas,063,18699,0,0,0,0,0
2020-02-12,Riverside,065,2383286,4,0,0,0,0
2020-02-12,Sacramento,067,1510023,1,0,0,0,0
2020-02-12,San Benito,069,59416,0,2,0,2,0
2020-02-12,San Bernardino,071,2135413,8,0,0,0,0
2020-02-12,San Diego,073,3302833,0,2,0,2,0
2020-02-12,San Francisco,075,870044,2,0,0,0,0
2020-02-12,San Joaquin,077,732212,1,0,1,1,0
2020-02-12,San Luis Obispo,079,281455,0,0,0,0,0
2020-02-12,San Mateo,081,765935,2,0,0,0,0
2020-02-12,Santa Barbara,083,443738,0,0,0,0,0
2020-02-12,Santa Clara,085,1922200,6,2,0,2,0
2020-02-12,Santa Cruz,087,273765,0,0,0,0,0
2020-02-12,Shasta,089,179085,0,0,0,0,0
2020-02-12,Sierra,091,2930,0,0,0,0,0
2020-02-12,Siskiyou,093,43540,0,0,0,0,0
2020-02-12,Solano,095,438530,0,0,0,0,0
2020-02-12,Sonoma,097,501317,0,0,0,0,0
2020-02-12,Stanislaus,099,539301,1,0,1,1,0
2020-02-12,Sutter,101,95872,0,0,0,0,0
2020-02-12,Tehama,103,63373,0,0,0,0,0
2020-02-12,Trinity,105,12862,0,0,0,0,0
2020-02-12,Tulare,107,460477,2,0,0,0,0
2020-02-12,Tuolumne,109,53932,0,0,0,0,0
2020-02-12,Ventura,111,848112,2,0,0,0,0
2020-02-12,Yolo,113,214977,0,0,0,0,0
2020-02-12,Yuba,115,75493,0,0,0,0,0
2020-02-11,Alameda,001,1643700,5,0,0,0,0
2020-02-11,Alpine,003,1148,0,0,0,0,0
2020-02-11,Amador,005,37829,0,0,0,0,0
2020-02-11,Butte,007,227075,0,0,0,0,0
2020-02-11,Calaveras,009,45235,0,0,0,0,0
2020-02-11,Colusa,011,21464,0,0,0,0,0
2020-02-11,Contra Costa,013,1133247,3,0,0,0,0
2020-02-11,Del Norte,015,27424,0,0,0,0,0
2020-02-11,El Dorado,017,186661,0,0,0,0,0
2020-02-11,Fresno,019,978130,0,0,0,0,0
2020-02-11,Glenn,021,27897,0,0,0,0,0
2020-02-11,Humboldt,023,135768,1,0,0,0,0
2020-02-11,Imperial,025,180216,0,0,0,0,0
2020-02-11,Inyo,027,18085,0,0,0,0,0
2020-02-11,Kern,029,883053,2,0,0,0,0
2020-02-11,Kings,031,150075,1,0,0,0,0
2020-02-11,Lake,033,64148,0,0,0,0,0
2020-02-11,Lassen,035,31185,0,0,0,0,0
2020-02-11,Los Angeles,037,10098052,30,1,3,4,0
2020-02-11,Madera,039,155013,0,0,0,0,0
2020-02-11,Marin,041,260295,0,0,0,0,0
2020-02-11,Mariposa,043,17540,0,0,0,0,0
2020-02-11,Mendocino,045,87422,0,0,0,0,0
2020-02-11,Merced,047,269075,0,0,0,0,0
2020-02-11,Modoc,049,8938,0,0,0,0,0
2020-02-11,Mono,051,14174,0,0,0,0,0
2020-02-11,Monterey,053,433212,1,0,0,0,0
2020-02-11,Napa,055,140530,0,0,0,0,0
2020-02-11,Nevada,057,99092,0,0,0,0,0
2020-02-11,Orange,059,3164182,34,1,0,1,0
2020-02-11,Placer,061,380077,0,0,0,0,0
2020-02-11,Plumas,063,18699,0,0,0,0,0
2020-02-11,Riverside,065,2383286,4,0,0,0,0
2020-02-11,Sacramento,067,1510023,1,0,0,0,0
2020-02-11,San Benito,069,59416,0,2,0,2,0
2020-02-11,San Bernardino,071,2135413,8,0,0,0,0
2020-02-11,San Diego,073,3302833,0,1,0,1,0
2020-02-11,San Francisco,075,870044,2,0,0,0,0
2020-02-11,San Joaquin,077,732212,0,0,1,1,0
2020-02-11,San Luis Obispo,079,281455,0,0,0,0,0
2020-02-11,San Mateo,081,765935,2,0,0,0,0
2020-02-11,Santa Barbara,083,443738,0,0,0,0,0
2020-02-11,Santa Clara,085,1922200,5,2,0,2,0
2020-02-11,Santa Cruz,087,273765,0,0,0,0,0
2020-02-11,Shasta,089,179085,0,0,0,0,0
2020-02-11,Sierra,091,2930,0,0,0,0,0
2020-02-11,Siskiyou,093,43540,0,0,0,0,0
2020-02-11,Solano,095,438530,0,0,0,0,0
2020-02-11,Sonoma,097,501317,0,0,0,0,0
2020-02-11,Stanislaus,099,539301,1,0,1,1,0
2020-02-11,Sutter,101,95872,0,0,0,0,0
2020-02-11,Tehama,103,63373,0,0,0,0,0
2020-02-11,Trinity,105,12862,0,0,0,0,0
2020-02-11,Tulare,107,460477,2,0,0,0,0
2020-02-11,Tuolumne,109,53932,0,0,0,0,0
2020-02-11,Ventura,111,848112,2,0,0,0,0
2020-02-11,Yolo,113,214977,0,0,0,0,0
2020-02-11,Yuba,115,75493,0,0,0,0,0
2020-02-10,Alameda,001,1643700,5,0,0,0,0
2020-02-10,Alpine,003,1148,0,0,0,0,0
2020-02-10,Amador,005,37829,0,0,0,0,0
2020-02-10,Butte,007,227075,0,0,0,0,0
2020-02-10,Calaveras,009,45235,0,0,0,0,0
2020-02-10,Colusa,011,21464,0,0,0,0,0
2020-02-10,Contra Costa,013,1133247,3,0,0,0,0
2020-02-10,Del Norte,015,27424,0,0,0,0,0
2020-02-10,El Dorado,017,186661,0,0,0,0,0
2020-02-10,Fresno,019,978130,0,0,0,0,0
2020-02-10,Glenn,021,27897,0,0,0,0,0
2020-02-10,Humboldt,023,135768,0,0,0,0,0
2020-02-10,Imperial,025,180216,0,0,0,0,0
2020-02-10,Inyo,027,18085,0,0,0,0,0
2020-02-10,Kern,029,883053,2,0,0,0,0
2020-02-10,Kings,031,150075,1,0,0,0,0
2020-02-10,Lake,033,64148,0,0,0,0,0
2020-02-10,Lassen,035,31185,0,0,0,0,0
2020-02-10,Los Angeles,037,10098052,28,1,3,4,0
2020-02-10,Madera,039,155013,0,0,0,0,0
2020-02-10,Marin,041,260295,0,0,0,0,0
2020-02-10,Mariposa,043,17540,0,0,0,0,0
2020-02-10,Mendocino,045,87422,0,0,0,0,0
2020-02-10,Merced,047,269075,0,0,0,0,0
2020-02-10,Modoc,049,8938,0,0,0,0,0
2020-02-10,Mono,051,14174,0,0,0,0,0
2020-02-10,Monterey,053,433212,1,0,0,0,0
2020-02-10,Napa,055,140530,0,0,0,0,0
2020-02-10,Nevada,057,99092,0,0,0,0,0
2020-02-10,Orange,059,3164182,34,1,0,1,0
2020-02-10,Placer,061,380077,0,0,0,0,0
2020-02-10,Plumas,063,18699,0,0,0,0,0
2020-02-10,Riverside,065,2383286,4,0,0,0,0
2020-02-10,Sacramento,067,1510023,1,0,0,0,0
2020-02-10,San Benito,069,59416,0,2,0,2,0
2020-02-10,San Bernardino,071,2135413,7,0,0,0,0
2020-02-10,San Diego,073,3302833,0,0,0,0,0
2020-02-10,San Francisco,075,870044,2,0,0,0,0
2020-02-10,San Joaquin,077,732212,0,0,1,1,0
2020-02-10,San Luis Obispo,079,281455,0,0,0,0,0
2020-02-10,San Mateo,081,765935,2,0,0,0,0
2020-02-10,Santa Barbara,083,443738,0,0,0,0,0
2020-02-10,Santa Clara,085,1922200,5,2,0,2,0
2020-02-10,Santa Cruz,087,273765,0,0,0,0,0
2020-02-10,Shasta,089,179085,0,0,0,0,0
2020-02-10,Sierra,091,2930,0,0,0,0,0
2020-02-10,Siskiyou,093,43540,0,0,0,0,0
2020-02-10,Solano,095,438530,0,0,0,0,0
2020-02-10,Sonoma,097,501317,0,0,0,0,0
2020-02-10,Stanislaus,099,539301,1,0,0,0,0
2020-02-10,Sutter,101,95872,0,0,0,0,0
2020-02-10,Tehama,103,63373,0,0,0,0,0
2020-02-10,Trinity,105,12862,0,0,0,0,0
2020-02-10,Tulare,107,460477,2,0,0,0,0
2020-02-10,Tuolumne,109,53932,0,0,0,0,0
2020-02-10,Ventura,111,848112,2,0,0,0,0
2020-02-10,Yolo,113,214977,0,0,0,0,0
2020-02-10,Yuba,115,75493,0,0,0,0,0
2020-02-09,Alameda,001,1643700,5,0,0,0,0
2020-02-09,Alpine,003,1148,0,0,0,0,0
2020-02-09,Amador,005,37829,0,0,0,0,0
2020-02-09,Butte,007,227075,0,0,0,0,0
2020-02-09,Calaveras,009,45235,0,0,0,0,0
2020-02-09,Colusa,011,21464,0,0,0,0,0
2020-02-09,Contra Costa,013,1133247,3,0,0,0,0
2020-02-09,Del Norte,015,27424,0,0,0,0,0
2020-02-09,El Dorado,017,186661,0,0,0,0,0
2020-02-09,Fresno,019,978130,0,0,0,0,0
2020-02-09,Glenn,021,27897,0,0,0,0,0
2020-02-09,Humboldt,023,135768,0,0,0,0,0
2020-02-09,Imperial,025,180216,0,0,0,0,0
2020-02-09,Inyo,027,18085,0,0,0,0,0
2020-02-09,Kern,029,883053,2,0,0,0,0
2020-02-09,Kings,031,150075,1,0,0,0,0
2020-02-09,Lake,033,64148,0,0,0,0,0
2020-02-09,Lassen,035,31185,0,0,0,0,0
2020-02-09,Los Angeles,037,10098052,27,1,3,4,0
2020-02-09,Madera,039,155013,0,0,0,0,0
2020-02-09,Marin,041,260295,0,0,0,0,0
2020-02-09,Mariposa,043,17540,0,0,0,0,0
2020-02-09,Mendocino,045,87422,0,0,0,0,0
2020-02-09,Merced,047,269075,0,0,0,0,0
2020-02-09,Modoc,049,8938,0,0,0,0,0
2020-02-09,Mono,051,14174,0,0,0,0,0
2020-02-09,Monterey,053,433212,1,0,0,0,0
2020-02-09,Napa,055,140530,0,0,0,0,0
2020-02-09,Nevada,057,99092,0,0,0,0,0
2020-02-09,Orange,059,3164182,34,1,0,1,0
2020-02-09,Placer,061,380077,0,0,0,0,0
2020-02-09,Plumas,063,18699,0,0,0,0,0
2020-02-09,Riverside,065,2383286,4,0,0,0,0
2020-02-09,Sacramento,067,1510023,0,0,0,0,0
2020-02-09,San Benito,069,59416,0,2,0,2,0
2020-02-09,San Bernardino,071,2135413,7,0,0,0,0
2020-02-09,San Diego,073,3302833,0,0,0,0,0
2020-02-09,San Francisco,075,870044,1,0,0,0,0
2020-02-09,San Joaquin,077,732212,0,0,1,1,0
2020-02-09,San Luis Obispo,079,281455,0,0,0,0,0
2020-02-09,San Mateo,081,765935,2,0,0,0,0
2020-02-09,Santa Barbara,083,443738,0,0,0,0,0
2020-02-09,Santa Clara,085,1922200,4,2,0,2,0
2020-02-09,Santa Cruz,087,273765,0,0,0,0,0
2020-02-09,Shasta,089,179085,0,0,0,0,0
2020-02-09,Sierra,091,2930,0,0,0,0,0
2020-02-09,Siskiyou,093,43540,0,0,0,0,0
2020-02-09,Solano,095,438530,0,0,0,0,0
2020-02-09,Sonoma,097,501317,0,0,0,0,0
2020-02-09,Stanislaus,099,539301,0,0,0,0,0
2020-02-09,Sutter,101,95872,0,0,0,0,0
2020-02-09,Tehama,103,63373,0,0,0,0,0
2020-02-09,Trinity,105,12862,0,0,0,0,0
2020-02-09,Tulare,107,460477,2,0,0,0,0
2020-02-09,Tuolumne,109,53932,0,0,0,0,0
2020-02-09,Ventura,111,848112,1,0,0,0,0
2020-02-09,Yolo,113,214977,0,0,0,0,0
2020-02-09,Yuba,115,75493,0,0,0,0,0
2020-02-08,Alameda,001,1643700,4,0,0,0,0
2020-02-08,Alpine,003,1148,0,0,0,0,0
2020-02-08,Amador,005,37829,0,0,0,0,0
2020-02-08,Butte,007,227075,0,0,0,0,0
2020-02-08,Calaveras,009,45235,0,0,0,0,0
2020-02-08,Colusa,011,21464,0,0,0,0,0
2020-02-08,Contra Costa,013,1133247,2,0,0,0,0
2020-02-08,Del Norte,015,27424,0,0,0,0,0
2020-02-08,El Dorado,017,186661,0,0,0,0,0
2020-02-08,Fresno,019,978130,0,0,0,0,0
2020-02-08,Glenn,021,27897,0,0,0,0,0
2020-02-08,Humboldt,023,135768,0,0,0,0,0
2020-02-08,Imperial,025,180216,0,0,0,0,0
2020-02-08,Inyo,027,18085,0,0,0,0,0
2020-02-08,Kern,029,883053,2,0,0,0,0
2020-02-08,Kings,031,150075,1,0,0,0,0
2020-02-08,Lake,033,64148,0,0,0,0,0
2020-02-08,Lassen,035,31185,0,0,0,0,0
2020-02-08,Los Angeles,037,10098052,24,1,1,2,0
2020-02-08,Madera,039,155013,0,0,0,0,0
2020-02-08,Marin,041,260295,0,0,0,0,0
2020-02-08,Mariposa,043,17540,0,0,0,0,0
2020-02-08,Mendocino,045,87422,0,0,0,0,0
2020-02-08,Merced,047,269075,0,0,0,0,0
2020-02-08,Modoc,049,8938,0,0,0,0,0
2020-02-08,Mono,051,14174,0,0,0,0,0
2020-02-08,Monterey,053,433212,1,0,0,0,0
2020-02-08,Napa,055,140530,0,0,0,0,0
2020-02-08,Nevada,057,99092,0,0,0,0,0
2020-02-08,Orange,059,3164182,34,1,0,1,0
2020-02-08,Placer,061,380077,0,0,0,0,0
2020-02-08,Plumas,063,18699,0,0,0,0,0
2020-02-08,Riverside,065,2383286,4,0,0,0,0
2020-02-08,Sacramento,067,1510023,0,0,0,0,0
2020-02-08,San Benito,069,59416,0,2,0,2,0
2020-02-08,San Bernardino,071,2135413,7,0,0,0,0
2020-02-08,San Diego,073,3302833,0,0,0,0,0
2020-02-08,San Francisco,075,870044,1,0,0,0,0
2020-02-08,San Joaquin,077,732212,0,0,1,1,0
2020-02-08,San Luis Obispo,079,281455,0,0,0,0,0
2020-02-08,San Mateo,081,765935,2,0,0,0,0
2020-02-08,Santa Barbara,083,443738,0,0,0,0,0
2020-02-08,Santa Clara,085,1922200,4,2,0,2,0
2020-02-08,Santa Cruz,087,273765,0,0,0,0,0
2020-02-08,Shasta,089,179085,0,0,0,0,0
2020-02-08,Sierra,091,2930,0,0,0,0,0
2020-02-08,Siskiyou,093,43540,0,0,0,0,0
2020-02-08,Solano,095,438530,0,0,0,0,0
2020-02-08,Sonoma,097,501317,0,0,0,0,0
2020-02-08,Stanislaus,099,539301,0,0,0,0,0
2020-02-08,Sutter,101,95872,0,0,0,0,0
2020-02-08,Tehama,103,63373,0,0,0,0,0
2020-02-08,Trinity,105,12862,0,0,0,0,0
2020-02-08,Tulare,107,460477,2,0,0,0,0
2020-02-08,Tuolumne,109,53932,0,0,0,0,0
2020-02-08,Ventura,111,848112,1,0,0,0,0
2020-02-08,Yolo,113,214977,0,0,0,0,0
2020-02-08,Yuba,115,75493,0,0,0,0,0
2020-02-07,Alameda,001,1643700,4,0,0,0,0
2020-02-07,Alpine,003,1148,0,0,0,0,0
2020-02-07,Amador,005,37829,0,0,0,0,0
2020-02-07,Butte,007,227075,0,0,0,0,0
2020-02-07,Calaveras,009,45235,0,0,0,0,0
2020-02-07,Colusa,011,21464,0,0,0,0,0
2020-02-07,Contra Costa,013,1133247,2,0,0,0,0
2020-02-07,Del Norte,015,27424,0,0,0,0,0
2020-02-07,El Dorado,017,186661,0,0,0,0,0
2020-02-07,Fresno,019,978130,0,0,0,0,0
2020-02-07,Glenn,021,27897,0,0,0,0,0
2020-02-07,Humboldt,023,135768,0,0,0,0,0
2020-02-07,Imperial,025,180216,0,0,0,0,0
2020-02-07,Inyo,027,18085,0,0,0,0,0
2020-02-07,Kern,029,883053,2,0,0,0,0
2020-02-07,Kings,031,150075,1,0,0,0,0
2020-02-07,Lake,033,64148,0,0,0,0,0
2020-02-07,Lassen,035,31185,0,0,0,0,0
2020-02-07,Los Angeles,037,10098052,23,1,0,1,0
2020-02-07,Madera,039,155013,0,0,0,0,0
2020-02-07,Marin,041,260295,0,0,0,0,0
2020-02-07,Mariposa,043,17540,0,0,0,0,0
2020-02-07,Mendocino,045,87422,0,0,0,0,0
2020-02-07,Merced,047,269075,0,0,0,0,0
2020-02-07,Modoc,049,8938,0,0,0,0,0
2020-02-07,Mono,051,14174,0,0,0,0,0
2020-02-07,Monterey,053,433212,1,0,0,0,0
2020-02-07,Napa,055,140530,0,0,0,0,0
2020-02-07,Nevada,057,99092,0,0,0,0,0
2020-02-07,Orange,059,3164182,32,1,0,1,0
2020-02-07,Placer,061,380077,0,0,0,0,0
2020-02-07,Plumas,063,18699,0,0,0,0,0
2020-02-07,Riverside,065,2383286,4,0,0,0,0
2020-02-07,Sacramento,067,1510023,0,0,0,0,0
2020-02-07,San Benito,069,59416,0,2,0,2,0
2020-02-07,San Bernardino,071,2135413,4,0,0,0,0
2020-02-07,San Diego,073,3302833,0,0,0,0,0
2020-02-07,San Francisco,075,870044,1,0,0,0,0
2020-02-07,San Joaquin,077,732212,0,0,1,1,0
2020-02-07,San Luis Obispo,079,281455,0,0,0,0,0
2020-02-07,San Mateo,081,765935,1,0,0,0,0
2020-02-07,Santa Barbara,083,443738,0,0,0,0,0
2020-02-07,Santa Clara,085,1922200,4,2,0,2,0
2020-02-07,Santa Cruz,087,273765,0,0,0,0,0
2020-02-07,Shasta,089,179085,0,0,0,0,0
2020-02-07,Sierra,091,2930,0,0,0,0,0
2020-02-07,Siskiyou,093,43540,0,0,0,0,0
2020-02-07,Solano,095,438530,0,0,0,0,0
2020-02-07,Sonoma,097,501317,0,0,0,0,0
2020-02-07,Stanislaus,099,539301,0,0,0,0,0
2020-02-07,Sutter,101,95872,0,0,0,0,0
2020-02-07,Tehama,103,63373,0,0,0,0,0
2020-02-07,Trinity,105,12862,0,0,0,0,0
2020-02-07,Tulare,107,460477,2,0,0,0,0
2020-02-07,Tuolumne,109,53932,0,0,0,0,0
2020-02-07,Ventura,111,848112,1,0,0,0,0
2020-02-07,Yolo,113,214977,0,0,0,0,0
2020-02-07,Yuba,115,75493,0,0,0,0,0
2020-02-06,Alameda,001,1643700,4,0,0,0,0
2020-02-06,Alpine,003,1148,0,0,0,0,0
2020-02-06,Amador,005,37829,0,0,0,0,0
2020-02-06,Butte,007,227075,0,0,0,0,0
2020-02-06,Calaveras,009,45235,0,0,0,0,0
2020-02-06,Colusa,011,21464,0,0,0,0,0
2020-02-06,Contra Costa,013,1133247,2,0,0,0,0
2020-02-06,Del Norte,015,27424,0,0,0,0,0
2020-02-06,El Dorado,017,186661,0,0,0,0,0
2020-02-06,Fresno,019,978130,0,0,0,0,0
2020-02-06,Glenn,021,27897,0,0,0,0,0
2020-02-06,Humboldt,023,135768,0,0,0,0,0
2020-02-06,Imperial,025,180216,0,0,0,0,0
2020-02-06,Inyo,027,18085,0,0,0,0,0
2020-02-06,Kern,029,883053,2,0,0,0,0
2020-02-06,Kings,031,150075,0,0,0,0,0
2020-02-06,Lake,033,64148,0,0,0,0,0
2020-02-06,Lassen,035,31185,0,0,0,0,0
2020-02-06,Los Angeles,037,10098052,22,1,0,1,0
2020-02-06,Madera,039,155013,0,0,0,0,0
2020-02-06,Marin,041,260295,0,0,0,0,0
2020-02-06,Mariposa,043,17540,0,0,0,0,0
2020-02-06,Mendocino,045,87422,0,0,0,0,0
2020-02-06,Merced,047,269075,0,0,0,0,0
2020-02-06,Modoc,049,8938,0,0,0,0,0
2020-02-06,Mono,051,14174,0,0,0,0,0
2020-02-06,Monterey,053,433212,1,0,0,0,0
2020-02-06,Napa,055,140530,0,0,0,0,0
2020-02-06,Nevada,057,99092,0,0,0,0,0
2020-02-06,Orange,059,3164182,2,1,0,1,0
2020-02-06,Placer,061,380077,0,0,0,0,0
2020-02-06,Plumas,063,18699,0,0,0,0,0
2020-02-06,Riverside,065,2383286,4,0,0,0,0
2020-02-06,Sacramento,067,1510023,0,0,0,0,0
2020-02-06,San Benito,069,59416,0,2,0,2,0
2020-02-06,San Bernardino,071,2135413,4,0,0,0,0
2020-02-06,San Diego,073,3302833,0,0,0,0,0
2020-02-06,San Francisco,075,870044,1,0,0,0,0
2020-02-06,San Joaquin,077,732212,0,0,1,1,0
2020-02-06,San Luis Obispo,079,281455,0,0,0,0,0
2020-02-06,San Mateo,081,765935,1,0,0,0,0
2020-02-06,Santa Barbara,083,443738,0,0,0,0,0
2020-02-06,Santa Clara,085,1922200,4,2,0,2,0
2020-02-06,Santa Cruz,087,273765,0,0,0,0,0
2020-02-06,Shasta,089,179085,0,0,0,0,0
2020-02-06,Sierra,091,2930,0,0,0,0,0
2020-02-06,Siskiyou,093,43540,0,0,0,0,0
2020-02-06,Solano,095,438530,0,0,0,0,0
2020-02-06,Sonoma,097,501317,0,0,0,0,0
2020-02-06,Stanislaus,099,539301,0,0,0,0,0
2020-02-06,Sutter,101,95872,0,0,0,0,0
2020-02-06,Tehama,103,63373,0,0,0,0,0
2020-02-06,Trinity,105,12862,0,0,0,0,0
2020-02-06,Tulare,107,460477,2,0,0,0,0
2020-02-06,Tuolumne,109,53932,0,0,0,0,0
2020-02-06,Ventura,111,848112,1,0,0,0,0
2020-02-06,Yolo,113,214977,0,0,0,0,0
2020-02-06,Yuba,115,75493,0,0,0,0,0
2020-02-05,Alameda,001,1643700,3,0,0,0,0
2020-02-05,Alpine,003,1148,0,0,0,0,0
2020-02-05,Amador,005,37829,0,0,0,0,0
2020-02-05,Butte,007,227075,0,0,0,0,0
2020-02-05,Calaveras,009,45235,0,0,0,0,0
2020-02-05,Colusa,011,21464,0,0,0,0,0
2020-02-05,Contra Costa,013,1133247,2,0,0,0,0
2020-02-05,Del Norte,015,27424,0,0,0,0,0
2020-02-05,El Dorado,017,186661,0,0,0,0,0
2020-02-05,Fresno,019,978130,0,0,0,0,0
2020-02-05,Glenn,021,27897,0,0,0,0,0
2020-02-05,Humboldt,023,135768,0,0,0,0,0
2020-02-05,Imperial,025,180216,0,0,0,0,0
2020-02-05,Inyo,027,18085,0,0,0,0,0
2020-02-05,Kern,029,883053,1,0,0,0,0
2020-02-05,Kings,031,150075,0,0,0,0,0
2020-02-05,Lake,033,64148,0,0,0,0,0
2020-02-05,Lassen,035,31185,0,0,0,0,0
2020-02-05,Los Angeles,037,10098052,22,1,0,1,0
2020-02-05,Madera,039,155013,0,0,0,0,0
2020-02-05,Marin,041,260295,0,0,0,0,0
2020-02-05,Mariposa,043,17540,0,0,0,0,0
2020-02-05,Mendocino,045,87422,0,0,0,0,0
2020-02-05,Merced,047,269075,0,0,0,0,0
2020-02-05,Modoc,049,8938,0,0,0,0,0
2020-02-05,Mono,051,14174,0,0,0,0,0
2020-02-05,Monterey,053,433212,1,0,0,0,0
2020-02-05,Napa,055,140530,0,0,0,0,0
2020-02-05,Nevada,057,99092,0,0,0,0,0
2020-02-05,Orange,059,3164182,1,1,0,1,0
2020-02-05,Placer,061,380077,0,0,0,0,0
2020-02-05,Plumas,063,18699,0,0,0,0,0
2020-02-05,Riverside,065,2383286,4,0,0,0,0
2020-02-05,Sacramento,067,1510023,0,0,0,0,0
2020-02-05,San Benito,069,59416,0,2,0,2,0
2020-02-05,San Bernardino,071,2135413,4,0,0,0,0
2020-02-05,San Diego,073,3302833,0,0,0,0,0
2020-02-05,San Francisco,075,870044,1,0,0,0,0
2020-02-05,San Joaquin,077,732212,0,0,1,1,0
2020-02-05,San Luis Obispo,079,281455,0,0,0,0,0
2020-02-05,San Mateo,081,765935,1,0,0,0,0
2020-02-05,Santa Barbara,083,443738,0,0,0,0,0
2020-02-05,Santa Clara,085,1922200,2,2,0,2,0
2020-02-05,Santa Cruz,087,273765,0,0,0,0,0
2020-02-05,Shasta,089,179085,0,0,0,0,0
2020-02-05,Sierra,091,2930,0,0,0,0,0
2020-02-05,Siskiyou,093,43540,0,0,0,0,0
2020-02-05,Solano,095,438530,0,0,0,0,0
2020-02-05,Sonoma,097,501317,0,0,0,0,0
2020-02-05,Stanislaus,099,539301,0,0,0,0,0
2020-02-05,Sutter,101,95872,0,0,0,0,0
2020-02-05,Tehama,103,63373,0,0,0,0,0
2020-02-05,Trinity,105,12862,0,0,0,0,0
2020-02-05,Tulare,107,460477,2,0,0,0,0
2020-02-05,Tuolumne,109,53932,0,0,0,0,0
2020-02-05,Ventura,111,848112,0,0,0,0,0
2020-02-05,Yolo,113,214977,0,0,0,0,0
2020-02-05,Yuba,115,75493,0,0,0,0,0
2020-02-04,Alameda,001,1643700,3,0,0,0,0
2020-02-04,Alpine,003,1148,0,0,0,0,0
2020-02-04,Amador,005,37829,0,0,0,0,0
2020-02-04,Butte,007,227075,0,0,0,0,0
2020-02-04,Calaveras,009,45235,0,0,0,0,0
2020-02-04,Colusa,011,21464,0,0,0,0,0
2020-02-04,Contra Costa,013,1133247,2,0,0,0,0
2020-02-04,Del Norte,015,27424,0,0,0,0,0
2020-02-04,El Dorado,017,186661,0,0,0,0,0
2020-02-04,Fresno,019,978130,0,0,0,0,0
2020-02-04,Glenn,021,27897,0,0,0,0,0
2020-02-04,Humboldt,023,135768,0,0,0,0,0
2020-02-04,Imperial,025,180216,0,0,0,0,0
2020-02-04,Inyo,027,18085,0,0,0,0,0
2020-02-04,Kern,029,883053,0,0,0,0,0
2020-02-04,Kings,031,150075,0,0,0,0,0
2020-02-04,Lake,033,64148,0,0,0,0,0
2020-02-04,Lassen,035,31185,0,0,0,0,0
2020-02-04,Los Angeles,037,10098052,22,1,0,1,0
2020-02-04,Madera,039,155013,0,0,0,0,0
2020-02-04,Marin,041,260295,0,0,0,0,0
2020-02-04,Mariposa,043,17540,0,0,0,0,0
2020-02-04,Mendocino,045,87422,0,0,0,0,0
2020-02-04,Merced,047,269075,0,0,0,0,0
2020-02-04,Modoc,049,8938,0,0,0,0,0
2020-02-04,Mono,051,14174,0,0,0,0,0
2020-02-04,Monterey,053,433212,1,0,0,0,0
2020-02-04,Napa,055,140530,0,0,0,0,0
2020-02-04,Nevada,057,99092,0,0,0,0,0
2020-02-04,Orange,059,3164182,1,1,0,1,0
2020-02-04,Placer,061,380077,0,0,0,0,0
2020-02-04,Plumas,063,18699,0,0,0,0,0
2020-02-04,Riverside,065,2383286,4,0,0,0,0
2020-02-04,Sacramento,067,1510023,0,0,0,0,0
2020-02-04,San Benito,069,59416,0,2,0,2,0
2020-02-04,San Bernardino,071,2135413,3,0,0,0,0
2020-02-04,San Diego,073,3302833,0,0,0,0,0
2020-02-04,San Francisco,075,870044,1,0,0,0,0
2020-02-04,San Joaquin,077,732212,0,0,1,1,0
2020-02-04,San Luis Obispo,079,281455,0,0,0,0,0
2020-02-04,San Mateo,081,765935,0,0,0,0,0
2020-02-04,Santa Barbara,083,443738,0,0,0,0,0
2020-02-04,Santa Clara,085,1922200,2,2,0,2,0
2020-02-04,Santa Cruz,087,273765,0,0,0,0,0
2020-02-04,Shasta,089,179085,0,0,0,0,0
2020-02-04,Sierra,091,2930,0,0,0,0,0
2020-02-04,Siskiyou,093,43540,0,0,0,0,0
2020-02-04,Solano,095,438530,0,0,0,0,0
2020-02-04,Sonoma,097,501317,0,0,0,0,0
2020-02-04,Stanislaus,099,539301,0,0,0,0,0
2020-02-04,Sutter,101,95872,0,0,0,0,0
2020-02-04,Tehama,103,63373,0,0,0,0,0
2020-02-04,Trinity,105,12862,0,0,0,0,0
2020-02-04,Tulare,107,460477,2,0,0,0,0
2020-02-04,Tuolumne,109,53932,0,0,0,0,0
2020-02-04,Ventura,111,848112,0,0,0,0,0
2020-02-04,Yolo,113,214977,0,0,0,0,0
2020-02-04,Yuba,115,75493,0,0,0,0,0
2020-02-03,Alameda,001,1643700,3,0,0,0,0
2020-02-03,Alpine,003,1148,0,0,0,0,0
2020-02-03,Amador,005,37829,0,0,0,0,0
2020-02-03,Butte,007,227075,0,0,0,0,0
2020-02-03,Calaveras,009,45235,0,0,0,0,0
2020-02-03,Colusa,011,21464,0,0,0,0,0
2020-02-03,Contra Costa,013,1133247,2,0,0,0,0
2020-02-03,Del Norte,015,27424,0,0,0,0,0
2020-02-03,El Dorado,017,186661,0,0,0,0,0
2020-02-03,Fresno,019,978130,0,0,0,0,0
2020-02-03,Glenn,021,27897,0,0,0,0,0
2020-02-03,Humboldt,023,135768,0,0,0,0,0
2020-02-03,Imperial,025,180216,0,0,0,0,0
2020-02-03,Inyo,027,18085,0,0,0,0,0
2020-02-03,Kern,029,883053,0,0,0,0,0
2020-02-03,Kings,031,150075,0,0,0,0,0
2020-02-03,Lake,033,64148,0,0,0,0,0
2020-02-03,Lassen,035,31185,0,0,0,0,0
2020-02-03,Los Angeles,037,10098052,21,1,0,1,0
2020-02-03,Madera,039,155013,0,0,0,0,0
2020-02-03,Marin,041,260295,0,0,0,0,0
2020-02-03,Mariposa,043,17540,0,0,0,0,0
2020-02-03,Mendocino,045,87422,0,0,0,0,0
2020-02-03,Merced,047,269075,0,0,0,0,0
2020-02-03,Modoc,049,8938,0,0,0,0,0
2020-02-03,Mono,051,14174,0,0,0,0,0
2020-02-03,Monterey,053,433212,1,0,0,0,0
2020-02-03,Napa,055,140530,0,0,0,0,0
2020-02-03,Nevada,057,99092,0,0,0,0,0
2020-02-03,Orange,059,3164182,1,1,0,1,0
2020-02-03,Placer,061,380077,0,0,0,0,0
2020-02-03,Plumas,063,18699,0,0,0,0,0
2020-02-03,Riverside,065,2383286,4,0,0,0,0
2020-02-03,Sacramento,067,1510023,0,0,0,0,0
2020-02-03,San Benito,069,59416,0,2,0,2,0
2020-02-03,San Bernardino,071,2135413,3,0,0,0,0
2020-02-03,San Diego,073,3302833,0,0,0,0,0
2020-02-03,San Francisco,075,870044,1,0,0,0,0
2020-02-03,San Joaquin,077,732212,0,0,1,1,0
2020-02-03,San Luis Obispo,079,281455,0,0,0,0,0
2020-02-03,San Mateo,081,765935,0,0,0,0,0
2020-02-03,Santa Barbara,083,443738,0,0,0,0,0
2020-02-03,Santa Clara,085,1922200,2,2,0,2,0
2020-02-03,Santa Cruz,087,273765,0,0,0,0,0
2020-02-03,Shasta,089,179085,0,0,0,0,0
2020-02-03,Sierra,091,2930,0,0,0,0,0
2020-02-03,Siskiyou,093,43540,0,0,0,0,0
2020-02-03,Solano,095,438530,0,0,0,0,0
2020-02-03,Sonoma,097,501317,0,0,0,0,0
2020-02-03,Stanislaus,099,539301,0,0,0,0,0
2020-02-03,Sutter,101,95872,0,0,0,0,0
2020-02-03,Tehama,103,63373,0,0,0,0,0
2020-02-03,Trinity,105,12862,0,0,0,0,0
2020-02-03,Tulare,107,460477,2,0,0,0,0
2020-02-03,Tuolumne,109,53932,0,0,0,0,0
2020-02-03,Ventura,111,848112,0,0,0,0,0
2020-02-03,Yolo,113,214977,0,0,0,0,0
2020-02-03,Yuba,115,75493,0,0,0,0,0
2020-02-02,Alameda,001,1643700,3,0,0,0,0
2020-02-02,Alpine,003,1148,0,0,0,0,0
2020-02-02,Amador,005,37829,0,0,0,0,0
2020-02-02,Butte,007,227075,0,0,0,0,0
2020-02-02,Calaveras,009,45235,0,0,0,0,0
2020-02-02,Colusa,011,21464,0,0,0,0,0
2020-02-02,Contra Costa,013,1133247,1,0,0,0,0
2020-02-02,Del Norte,015,27424,0,0,0,0,0
2020-02-02,El Dorado,017,186661,0,0,0,0,0
2020-02-02,Fresno,019,978130,0,0,0,0,0
2020-02-02,Glenn,021,27897,0,0,0,0,0
2020-02-02,Humboldt,023,135768,0,0,0,0,0
2020-02-02,Imperial,025,180216,0,0,0,0,0
2020-02-02,Inyo,027,18085,0,0,0,0,0
2020-02-02,Kern,029,883053,0,0,0,0,0
2020-02-02,Kings,031,150075,0,0,0,0,0
2020-02-02,Lake,033,64148,0,0,0,0,0
2020-02-02,Lassen,035,31185,0,0,0,0,0
2020-02-02,Los Angeles,037,10098052,17,1,0,1,0
2020-02-02,Madera,039,155013,0,0,0,0,0
2020-02-02,Marin,041,260295,0,0,0,0,0
2020-02-02,Mariposa,043,17540,0,0,0,0,0
2020-02-02,Mendocino,045,87422,0,0,0,0,0
2020-02-02,Merced,047,269075,0,0,0,0,0
2020-02-02,Modoc,049,8938,0,0,0,0,0
2020-02-02,Mono,051,14174,0,0,0,0,0
2020-02-02,Monterey,053,433212,1,0,0,0,0
2020-02-02,Napa,055,140530,0,0,0,0,0
2020-02-02,Nevada,057,99092,0,0,0,0,0
2020-02-02,Orange,059,3164182,1,1,0,1,0
2020-02-02,Placer,061,380077,0,0,0,0,0
2020-02-02,Plumas,063,18699,0,0,0,0,0
2020-02-02,Riverside,065,2383286,3,0,0,0,0
2020-02-02,Sacramento,067,1510023,0,0,0,0,0
2020-02-02,San Benito,069,59416,0,2,0,2,0
2020-02-02,San Bernardino,071,2135413,2,0,0,0,0
2020-02-02,San Diego,073,3302833,0,0,0,0,0
2020-02-02,San Francisco,075,870044,1,0,0,0,0
2020-02-02,San Joaquin,077,732212,0,0,1,1,0
2020-02-02,San Luis Obispo,079,281455,0,0,0,0,0
2020-02-02,San Mateo,081,765935,0,0,0,0,0
2020-02-02,Santa Barbara,083,443738,0,0,0,0,0
2020-02-02,Santa Clara,085,1922200,2,2,0,2,0
2020-02-02,Santa Cruz,087,273765,0,0,0,0,0
2020-02-02,Shasta,089,179085,0,0,0,0,0
2020-02-02,Sierra,091,2930,0,0,0,0,0
2020-02-02,Siskiyou,093,43540,0,0,0,0,0
2020-02-02,Solano,095,438530,0,0,0,0,0
2020-02-02,Sonoma,097,501317,0,0,0,0,0
2020-02-02,Stanislaus,099,539301,0,0,0,0,0
2020-02-02,Sutter,101,95872,0,0,0,0,0
2020-02-02,Tehama,103,63373,0,0,0,0,0
2020-02-02,Trinity,105,12862,0,0,0,0,0
2020-02-02,Tulare,107,460477,2,0,0,0,0
2020-02-02,Tuolumne,109,53932,0,0,0,0,0
2020-02-02,Ventura,111,848112,0,0,0,0,0
2020-02-02,Yolo,113,214977,0,0,0,0,0
2020-02-02,Yuba,115,75493,0,0,0,0,0
2020-02-01,Alameda,001,1643700,3,0,0,0,0
2020-02-01,Alpine,003,1148,0,0,0,0,0
2020-02-01,Amador,005,37829,0,0,0,0,0
2020-02-01,Butte,007,227075,0,0,0,0,0
2020-02-01,Calaveras,009,45235,0,0,0,0,0
2020-02-01,Colusa,011,21464,0,0,0,0,0
2020-02-01,Contra Costa,013,1133247,0,0,0,0,0
2020-02-01,Del Norte,015,27424,0,0,0,0,0
2020-02-01,El Dorado,017,186661,0,0,0,0,0
2020-02-01,Fresno,019,978130,0,0,0,0,0
2020-02-01,Glenn,021,27897,0,0,0,0,0
2020-02-01,Humboldt,023,135768,0,0,0,0,0
2020-02-01,Imperial,025,180216,0,0,0,0,0
2020-02-01,Inyo,027,18085,0,0,0,0,0
2020-02-01,Kern,029,883053,0,0,0,0,0
2020-02-01,Kings,031,150075,0,0,0,0,0
2020-02-01,Lake,033,64148,0,0,0,0,0
2020-02-01,Lassen,035,31185,0,0,0,0,0
2020-02-01,Los Angeles,037,10098052,13,1,0,1,0
2020-02-01,Madera,039,155013,0,0,0,0,0
2020-02-01,Marin,041,260295,0,0,0,0,0
2020-02-01,Mariposa,043,17540,0,0,0,0,0
2020-02-01,Mendocino,045,87422,0,0,0,0,0
2020-02-01,Merced,047,269075,0,0,0,0,0
2020-02-01,Modoc,049,8938,0,0,0,0,0
2020-02-01,Mono,051,14174,0,0,0,0,0
2020-02-01,Monterey,053,433212,0,0,0,0,0
2020-02-01,Napa,055,140530,0,0,0,0,0
2020-02-01,Nevada,057,99092,0,0,0,0,0
2020-02-01,Orange,059,3164182,1,1,0,1,0
2020-02-01,Placer,061,380077,0,0,0,0,0
2020-02-01,Plumas,063,18699,0,0,0,0,0
2020-02-01,Riverside,065,2383286,2,0,0,0,0
2020-02-01,Sacramento,067,1510023,0,0,0,0,0
2020-02-01,San Benito,069,59416,0,0,0,0,0
2020-02-01,San Bernardino,071,2135413,1,0,0,0,0
2020-02-01,San Diego,073,3302833,0,0,0,0,0
2020-02-01,San Francisco,075,870044,1,0,0,0,0
2020-02-01,San Joaquin,077,732212,0,0,1,1,0
2020-02-01,San Luis Obispo,079,281455,0,0,0,0,0
2020-02-01,San Mateo,081,765935,0,0,0,0,0
2020-02-01,Santa Barbara,083,443738,0,0,0,0,0
2020-02-01,Santa Clara,085,1922200,2,1,0,1,0
2020-02-01,Santa Cruz,087,273765,0,0,0,0,0
2020-02-01,Shasta,089,179085,0,0,0,0,0
2020-02-01,Sierra,091,2930,0,0,0,0,0
2020-02-01,Siskiyou,093,43540,0,0,0,0,0
2020-02-01,Solano,095,438530,0,0,0,0,0
2020-02-01,Sonoma,097,501317,0,0,0,0,0
2020-02-01,Stanislaus,099,539301,0,0,0,0,0
2020-02-01,Sutter,101,95872,0,0,0,0,0
2020-02-01,Tehama,103,63373,0,0,0,0,0
2020-02-01,Trinity,105,12862,0,0,0,0,0
2020-02-01,Tulare,107,460477,1,0,0,0,0
2020-02-01,Tuolumne,109,53932,0,0,0,0,0
2020-02-01,Ventura,111,848112,0,0,0,0,0
2020-02-01,Yolo,113,214977,0,0,0,0,0
2020-02-01,Yuba,115,75493,0,0,0,0,0
