date,county,fips,population,confirmed_cases,reported_cases,probable_cases,reported_and_probable_cases,reported_deaths
2022-05-12,Alameda,001,1643700,268987,268944,14534,283478,1857
2022-05-12,Alpine,003,1148,125,125,1,126,0
2022-05-12,Amador,005,37829,8614,8574,666,9240,86
2022-05-12,Butte,007,227075,33386,33377,6738,40115,424
2022-05-12,Calaveras,009,45235,7379,7378,365,7743,120
2022-05-12,Colusa,011,21464,3463,3463,1076,4539,21
2022-05-12,Contra Costa,013,1133247,195983,195925,13796,209721,1301
2022-05-12,Del Norte,015,27424,5921,5919,204,6123,50
2022-05-12,El Dorado,017,186661,27212,27216,3256,30472,212
2022-05-12,Fresno,019,978130,233314,233305,24017,257322,2757
2022-05-12,Glenn,021,27897,5003,5004,1626,6630,48
2022-05-12,Humboldt,023,135768,17633,17633,3073,20706,146
2022-05-12,Imperial,025,180216,55757,55756,10941,66697,917
2022-05-12,Inyo,027,18085,4115,4114,514,4628,56
2022-05-12,Kern,029,883053,193005,192939,46550,239489,2314
2022-05-12,Kings,031,150075,51787,51779,3633,55412,447
2022-05-12,Lake,033,64148,10794,10790,907,11697,137
2022-05-12,Lassen,035,31185,8988,8987,889,9876,65
2022-05-12,Los Angeles,037,10098052,2768470,2768726,128228,2896954,31768
2022-05-12,Madera,039,155013,37544,37520,6087,43607,365
2022-05-12,Marin,041,260295,35485,35486,2938,38424,293
2022-05-12,Mariposa,043,17540,2464,2463,205,2668,30
2022-05-12,Mendocino,045,87422,13350,13349,3142,16491,124
2022-05-12,Merced,047,269075,62639,62627,8823,71450,818
2022-05-12,Modoc,049,8938,747,747,253,1000,8
2022-05-12,Mono,051,14174,3002,3002,128,3130,6
2022-05-12,Monterey,053,433212,80717,80620,14331,94951,735
2022-05-12,Napa,055,140530,26700,26698,1047,27745,143
2022-05-12,Nevada,057,99092,16234,16240,1245,17485,127
2022-05-12,Orange,059,3164182,557164,557134,42683,599817,7017
2022-05-12,Placer,061,380077,63982,63963,7502,71465,626
2022-05-12,Plumas,063,18699,3005,3006,364,3370,13
2022-05-12,Riverside,065,2383286,597936,597914,28570,626484,6471
2022-05-12,Sacramento,067,1510023,286424,286403,27745,314148,3022
2022-05-12,San Benito,069,59416,13105,13106,527,13633,98
2022-05-12,San Bernardino,071,2135413,572076,572057,25165,597222,7423
2022-05-12,San Diego,073,3302833,770324,770323,53559,823882,5271
2022-05-12,San Francisco,075,870044,134893,134916,8833,143749,866
2022-05-12,San Joaquin,077,732212,168207,168174,9968,178142,2236
2022-05-12,San Luis Obispo,079,281455,53491,53502,3972,57474,478
2022-05-12,San Mateo,081,765935,129481,129480,7558,137038,709
2022-05-12,Santa Barbara,083,443738,87795,87773,4872,92645,693
2022-05-12,Santa Clara,085,1922200,328630,328609,13089,341698,2297
2022-05-12,Santa Cruz,087,273765,50276,50268,2229,52497,263
2022-05-12,Shasta,089,179085,30802,30799,6177,36976,557
2022-05-12,Sierra,091,2930,275,275,49,324,4
2022-05-12,Siskiyou,093,43540,4483,4482,2778,7260,81
2022-05-12,Solano,095,438530,83730,83669,5671,89340,451
2022-05-12,Sonoma,097,501317,87070,87070,2930,90000,488
2022-05-12,Stanislaus,099,539301,118577,118586,17554,136140,1645
2022-05-12,Sutter,101,95872,20684,20690,2162,22852,226
2022-05-12,Tehama,103,63373,12111,12115,2633,14748,201
2022-05-12,Trinity,105,12862,1188,1188,296,1484,20
2022-05-12,Tulare,107,460477,107109,107077,28937,136014,1469
2022-05-12,Tuolumne,109,53932,12846,12851,578,13429,182
2022-05-12,Ventura,111,848112,176324,176317,9473,185790,1497
2022-05-12,Yolo,113,214977,37722,37737,3277,41014,316
2022-05-12,Yuba,115,75493,16029,16028,1239,17267,122
2022-05-11,Alameda,001,1643700,268987,267982,14534,282516,1853
2022-05-11,Alpine,003,1148,125,125,1,126,0
2022-05-11,Amador,005,37829,8614,8564,666,9230,86
2022-05-11,Butte,007,227075,33386,33339,6738,40077,423
2022-05-11,Calaveras,009,45235,7379,7368,365,7733,120
2022-05-11,Colusa,011,21464,3463,3462,1076,4538,21
2022-05-11,Contra Costa,013,1133247,195983,195153,13796,208949,1302
2022-05-11,Del Norte,015,27424,5921,5911,204,6115,50
2022-05-11,El Dorado,017,186661,27212,27172,3256,30428,212
2022-05-11,Fresno,019,978130,233314,233021,24017,257038,2754
2022-05-11,Glenn,021,27897,5003,5001,1626,6627,48
2022-05-11,Humboldt,023,135768,17633,17585,3073,20658,146
2022-05-11,Imperial,025,180216,55757,55751,10941,66692,917
2022-05-11,Inyo,027,18085,4115,4093,514,4607,56
2022-05-11,Kern,029,883053,193005,192795,46550,239345,2292
2022-05-11,Kings,031,150075,51787,51752,3633,55385,447
2022-05-11,Lake,033,64148,10794,10786,907,11693,137
2022-05-11,Lassen,035,31185,8988,8984,889,9873,65
2022-05-11,Los Angeles,037,10098052,2768470,2761410,128228,2889638,31747
2022-05-11,Madera,039,155013,37544,37496,6087,43583,365
2022-05-11,Marin,041,260295,35485,35336,2938,38274,292
2022-05-11,Mariposa,043,17540,2464,2461,205,2666,30
2022-05-11,Mendocino,045,87422,13350,13320,3142,16462,124
2022-05-11,Merced,047,269075,62639,62567,8823,71390,818
2022-05-11,Modoc,049,8938,747,747,253,1000,8
2022-05-11,Mono,051,14174,3002,2999,128,3127,6
2022-05-11,Monterey,053,433212,80717,80534,14331,94865,733
2022-05-11,Napa,055,140530,26700,26660,1047,27707,143
2022-05-11,Nevada,057,99092,16234,16230,1245,17475,127
2022-05-11,Orange,059,3164182,557164,556265,42683,598948,7009
2022-05-11,Placer,061,380077,63982,63823,7502,71325,625
2022-05-11,Plumas,063,18699,3005,2998,364,3362,13
2022-05-11,Riverside,065,2383286,597936,597302,28570,625872,6468
2022-05-11,Sacramento,067,1510023,286424,285799,27745,313544,3020
2022-05-11,San Benito,069,59416,13105,13088,527,13615,98
2022-05-11,San Bernardino,071,2135413,572076,571372,25165,596537,7354
2022-05-11,San Diego,073,3302833,770324,768135,53559,821694,5257
2022-05-11,San Francisco,075,870044,134893,134027,8833,142860,864
2022-05-11,San Joaquin,077,732212,168207,167949,9968,177917,2233
2022-05-11,San Luis Obispo,079,281455,53491,53420,3972,57392,478
2022-05-11,San Mateo,081,765935,129481,128821,7558,136379,711
2022-05-11,Santa Barbara,083,443738,87795,87593,4872,92465,693
2022-05-11,Santa Clara,085,1922200,328630,327177,13089,340266,2294
2022-05-11,Santa Cruz,087,273765,50276,50031,2229,52260,263
2022-05-11,Shasta,089,179085,30802,30768,6177,36945,564
2022-05-11,Sierra,091,2930,275,275,49,324,4
2022-05-11,Siskiyou,093,43540,4483,4478,2778,7256,81
2022-05-11,Solano,095,438530,83730,83464,5671,89135,450
2022-05-11,Sonoma,097,501317,87070,86798,2930,89728,488
2022-05-11,Stanislaus,099,539301,118577,118445,17554,135999,1644
2022-05-11,Sutter,101,95872,20684,20668,2162,22830,225
2022-05-11,Tehama,103,63373,12111,12106,2633,14739,201
2022-05-11,Trinity,105,12862,1188,1188,296,1484,20
2022-05-11,Tulare,107,460477,107109,107068,28937,136005,1468
2022-05-11,Tuolumne,109,53932,12846,12829,578,13407,181
2022-05-11,Ventura,111,848112,176324,175955,9473,185428,1491
2022-05-11,Yolo,113,214977,37722,37654,3277,40931,316
2022-05-11,Yuba,115,75493,16029,15997,1239,17236,122
2022-05-10,Alameda,001,1643700,268987,267982,14534,282516,1853
2022-05-10,Alpine,003,1148,125,125,1,126,0
2022-05-10,Amador,005,37829,8614,8564,666,9230,86
2022-05-10,Butte,007,227075,33385,33339,6738,40077,423
2022-05-10,Calaveras,009,45235,7379,7368,365,7733,120
2022-05-10,Colusa,011,21464,3463,3462,1076,4538,21
2022-05-10,Contra Costa,013,1133247,195983,195153,13796,208949,1302
2022-05-10,Del Norte,015,27424,5921,5911,204,6115,50
2022-05-10,El Dorado,017,186661,27212,27172,3256,30428,212
2022-05-10,Fresno,019,978130,233314,233021,24017,257038,2754
2022-05-10,Glenn,021,27897,5003,5001,1626,6627,48
2022-05-10,Humboldt,023,135768,17633,17585,3073,20658,146
2022-05-10,Imperial,025,180216,55757,55751,10941,66692,917
2022-05-10,Inyo,027,18085,4115,4093,514,4607,56
2022-05-10,Kern,029,883053,193005,192795,46550,239345,2292
2022-05-10,Kings,031,150075,51787,51752,3633,55385,447
2022-05-10,Lake,033,64148,10794,10786,907,11693,137
2022-05-10,Lassen,035,31185,8988,8984,889,9873,65
2022-05-10,Los Angeles,037,10098052,2768445,2761410,128228,2889638,31747
2022-05-10,Madera,039,155013,37544,37496,6087,43583,365
2022-05-10,Marin,041,260295,35485,35336,2938,38274,292
2022-05-10,Mariposa,043,17540,2464,2461,205,2666,30
2022-05-10,Mendocino,045,87422,13350,13320,3142,16462,124
2022-05-10,Merced,047,269075,62630,62567,8823,71390,818
2022-05-10,Modoc,049,8938,747,747,253,1000,8
2022-05-10,Mono,051,14174,3002,2999,128,3127,6
2022-05-10,Monterey,053,433212,80717,80534,14331,94865,733
2022-05-10,Napa,055,140530,26699,26660,1047,27707,143
2022-05-10,Nevada,057,99092,16234,16230,1245,17475,127
2022-05-10,Orange,059,3164182,557164,556265,42683,598948,7009
2022-05-10,Placer,061,380077,63982,63823,7502,71325,625
2022-05-10,Plumas,063,18699,3005,2998,364,3362,13
2022-05-10,Riverside,065,2383286,597936,597302,28570,625872,6468
2022-05-10,Sacramento,067,1510023,286424,285799,27745,313544,3020
2022-05-10,San Benito,069,59416,13105,13088,527,13615,98
2022-05-10,San Bernardino,071,2135413,572069,571372,25165,596537,7354
2022-05-10,San Diego,073,3302833,770270,768135,53559,821694,5257
2022-05-10,San Francisco,075,870044,134893,134027,8833,142860,864
2022-05-10,San Joaquin,077,732212,168206,167949,9968,177917,2233
2022-05-10,San Luis Obispo,079,281455,53490,53420,3972,57392,478
2022-05-10,San Mateo,081,765935,129481,128821,7558,136379,711
2022-05-10,Santa Barbara,083,443738,87795,87593,4872,92465,693
2022-05-10,Santa Clara,085,1922200,328630,327177,13089,340266,2294
2022-05-10,Santa Cruz,087,273765,50276,50031,2229,52260,263
2022-05-10,Shasta,089,179085,30802,30768,6177,36945,564
2022-05-10,Sierra,091,2930,275,275,49,324,4
2022-05-10,Siskiyou,093,43540,4483,4478,2778,7256,81
2022-05-10,Solano,095,438530,83730,83464,5671,89135,450
2022-05-10,Sonoma,097,501317,87069,86798,2930,89728,488
2022-05-10,Stanislaus,099,539301,118574,118445,17554,135999,1644
2022-05-10,Sutter,101,95872,20684,20668,2162,22830,225
2022-05-10,Tehama,103,63373,12111,12106,2633,14739,201
2022-05-10,Trinity,105,12862,1188,1188,296,1484,20
2022-05-10,Tulare,107,460477,107109,107068,28937,136005,1468
2022-05-10,Tuolumne,109,53932,12846,12829,578,13407,181
2022-05-10,Ventura,111,848112,176321,175955,9473,185428,1491
2022-05-10,Yolo,113,214977,37722,37654,3277,40931,316
2022-05-10,Yuba,115,75493,16029,15997,1239,17236,122
2022-05-09,Alameda,001,1643700,268916,267982,14534,282516,1853
2022-05-09,Alpine,003,1148,125,125,1,126,0
2022-05-09,Amador,005,37829,8611,8564,666,9230,86
2022-05-09,Butte,007,227075,33380,33339,6738,40077,423
2022-05-09,Calaveras,009,45235,7375,7368,365,7733,120
2022-05-09,Colusa,011,21464,3463,3462,1076,4538,21
2022-05-09,Contra Costa,013,1133247,195945,195153,13796,208949,1302
2022-05-09,Del Norte,015,27424,5920,5911,204,6115,50
2022-05-09,El Dorado,017,186661,27205,27172,3256,30428,212
2022-05-09,Fresno,019,978130,233293,233021,24017,257038,2754
2022-05-09,Glenn,021,27897,5003,5001,1626,6627,48
2022-05-09,Humboldt,023,135768,17627,17585,3073,20658,146
2022-05-09,Imperial,025,180216,55750,55751,10941,66692,917
2022-05-09,Inyo,027,18085,4112,4093,514,4607,56
2022-05-09,Kern,029,883053,192992,192795,46550,239345,2292
2022-05-09,Kings,031,150075,51776,51752,3633,55385,447
2022-05-09,Lake,033,64148,10792,10786,907,11693,137
2022-05-09,Lassen,035,31185,8988,8984,889,9873,65
2022-05-09,Los Angeles,037,10098052,2767368,2761410,128228,2889638,31747
2022-05-09,Madera,039,155013,37539,37496,6087,43583,365
2022-05-09,Marin,041,260295,35460,35336,2938,38274,292
2022-05-09,Mariposa,043,17540,2464,2461,205,2666,30
2022-05-09,Mendocino,045,87422,13344,13320,3142,16462,124
2022-05-09,Merced,047,269075,62629,62567,8823,71390,818
2022-05-09,Modoc,049,8938,747,747,253,1000,8
2022-05-09,Mono,051,14174,3002,2999,128,3127,6
2022-05-09,Monterey,053,433212,80704,80534,14331,94865,733
2022-05-09,Napa,055,140530,26695,26660,1047,27707,143
2022-05-09,Nevada,057,99092,16234,16230,1245,17475,127
2022-05-09,Orange,059,3164182,557072,556265,42683,598948,7009
2022-05-09,Placer,061,380077,63976,63823,7502,71325,625
2022-05-09,Plumas,063,18699,2998,2998,364,3362,13
2022-05-09,Riverside,065,2383286,597891,597302,28570,625872,6468
2022-05-09,Sacramento,067,1510023,286401,285799,27745,313544,3020
2022-05-09,San Benito,069,59416,13103,13088,527,13615,98
2022-05-09,San Bernardino,071,2135413,572048,571372,25165,596537,7354
2022-05-09,San Diego,073,3302833,769848,768135,53559,821694,5257
2022-05-09,San Francisco,075,870044,134836,134027,8833,142860,864
2022-05-09,San Joaquin,077,732212,168185,167949,9968,177917,2233
2022-05-09,San Luis Obispo,079,281455,53474,53420,3972,57392,478
2022-05-09,San Mateo,081,765935,129441,128821,7558,136379,711
2022-05-09,Santa Barbara,083,443738,87767,87593,4872,92465,693
2022-05-09,Santa Clara,085,1922200,328541,327177,13089,340266,2294
2022-05-09,Santa Cruz,087,273765,50273,50031,2229,52260,263
2022-05-09,Shasta,089,179085,30801,30768,6177,36945,564
2022-05-09,Sierra,091,2930,275,275,49,324,4
2022-05-09,Siskiyou,093,43540,4482,4478,2778,7256,81
2022-05-09,Solano,095,438530,83719,83464,5671,89135,450
2022-05-09,Sonoma,097,501317,87057,86798,2930,89728,488
2022-05-09,Stanislaus,099,539301,118559,118445,17554,135999,1644
2022-05-09,Sutter,101,95872,20677,20668,2162,22830,225
2022-05-09,Tehama,103,63373,12111,12106,2633,14739,201
2022-05-09,Trinity,105,12862,1188,1188,296,1484,20
2022-05-09,Tulare,107,460477,107107,107068,28937,136005,1468
2022-05-09,Tuolumne,109,53932,12837,12829,578,13407,181
2022-05-09,Ventura,111,848112,176279,175955,9473,185428,1491
2022-05-09,Yolo,113,214977,37714,37654,3277,40931,316
2022-05-09,Yuba,115,75493,16026,15997,1239,17236,122
2022-05-08,Alameda,001,1643700,268578,265198,14534,279732,1855
2022-05-08,Alpine,003,1148,125,125,1,126,0
2022-05-08,Amador,005,37829,8607,8556,666,9222,86
2022-05-08,Butte,007,227075,33364,33269,6738,40007,421
2022-05-08,Calaveras,009,45235,7372,7353,365,7718,120
2022-05-08,Colusa,011,21464,3462,3459,1076,4535,21
2022-05-08,Contra Costa,013,1133247,195696,193961,13796,207757,1302
2022-05-08,Del Norte,015,27424,5918,5884,204,6088,50
2022-05-08,El Dorado,017,186661,27186,27081,3256,30337,210
2022-05-08,Fresno,019,978130,233206,232655,24017,256672,2754
2022-05-08,Glenn,021,27897,5001,4996,1626,6622,48
2022-05-08,Humboldt,023,135768,17616,17410,3073,20483,146
2022-05-08,Imperial,025,180216,55742,55683,10941,66624,917
2022-05-08,Inyo,027,18085,4104,4087,514,4601,56
2022-05-08,Kern,029,883053,192947,192590,46550,239140,2287
2022-05-08,Kings,031,150075,51771,51702,3633,55335,447
2022-05-08,Lake,033,64148,10790,10766,907,11673,137
2022-05-08,Lassen,035,31185,8985,8978,889,9867,65
2022-05-08,Los Angeles,037,10098052,2764752,2751478,128228,2879706,31738
2022-05-08,Madera,039,155013,37533,37420,6087,43507,365
2022-05-08,Marin,041,260295,35402,34934,2938,37872,292
2022-05-08,Mariposa,043,17540,2464,2438,205,2643,30
2022-05-08,Mendocino,045,87422,13337,13270,3142,16412,124
2022-05-08,Merced,047,269075,62605,62471,8823,71294,818
2022-05-08,Modoc,049,8938,747,745,253,998,8
2022-05-08,Mono,051,14174,3001,2997,128,3125,6
2022-05-08,Monterey,053,433212,80680,80246,14331,94577,733
2022-05-08,Napa,055,140530,26690,26524,1047,27571,143
2022-05-08,Nevada,057,99092,16231,16171,1245,17416,127
2022-05-08,Orange,059,3164182,556799,554411,42683,597094,7007
2022-05-08,Placer,061,380077,63938,63577,7502,71079,625
2022-05-08,Plumas,063,18699,2998,2996,364,3360,13
2022-05-08,Riverside,065,2383286,597716,596022,28570,624592,6467
2022-05-08,Sacramento,067,1510023,286172,284564,27745,312309,3016
2022-05-08,San Benito,069,59416,13098,13047,527,13574,98
2022-05-08,San Bernardino,071,2135413,571884,570381,25165,595546,7306
2022-05-08,San Diego,073,3302833,768962,765377,53559,818936,5244
2022-05-08,San Francisco,075,870044,134455,132659,8833,141492,861
2022-05-08,San Joaquin,077,732212,168114,167568,9968,177536,2229
2022-05-08,San Luis Obispo,079,281455,53444,53273,3972,57245,477
2022-05-08,San Mateo,081,765935,129224,127615,7558,135173,709
2022-05-08,Santa Barbara,083,443738,87686,87305,4872,92177,692
2022-05-08,Santa Clara,085,1922200,328084,324946,13089,338035,2287
2022-05-08,Santa Cruz,087,273765,50247,49605,2229,51834,262
2022-05-08,Shasta,089,179085,30784,30721,6177,36898,563
2022-05-08,Sierra,091,2930,275,275,49,324,4
2022-05-08,Siskiyou,093,43540,4480,4470,2778,7248,81
2022-05-08,Solano,095,438530,83668,83038,5671,88709,450
2022-05-08,Sonoma,097,501317,86992,86150,2930,89080,488
2022-05-08,Stanislaus,099,539301,118498,118235,17554,135789,1643
2022-05-08,Sutter,101,95872,20666,20694,2162,22856,225
2022-05-08,Tehama,103,63373,12108,12098,2633,14731,201
2022-05-08,Trinity,105,12862,1187,1180,296,1476,20
2022-05-08,Tulare,107,460477,107097,106987,28937,135924,1468
2022-05-08,Tuolumne,109,53932,12831,12793,578,13371,181
2022-05-08,Ventura,111,848112,176179,175454,9473,184927,1491
2022-05-08,Yolo,113,214977,37690,37456,3277,40733,315
2022-05-08,Yuba,115,75493,16013,15964,1239,17203,122
2022-05-07,Alameda,001,1643700,268346,265198,14534,279732,1855
2022-05-07,Alpine,003,1148,125,125,1,126,0
2022-05-07,Amador,005,37829,8606,8556,666,9222,86
2022-05-07,Butte,007,227075,33358,33269,6738,40007,421
2022-05-07,Calaveras,009,45235,7371,7353,365,7718,120
2022-05-07,Colusa,011,21464,3462,3459,1076,4535,21
2022-05-07,Contra Costa,013,1133247,195515,193961,13796,207757,1302
2022-05-07,Del Norte,015,27424,5917,5884,204,6088,50
2022-05-07,El Dorado,017,186661,27180,27081,3256,30337,210
2022-05-07,Fresno,019,978130,233180,232655,24017,256672,2754
2022-05-07,Glenn,021,27897,5001,4996,1626,6622,48
2022-05-07,Humboldt,023,135768,17610,17410,3073,20483,146
2022-05-07,Imperial,025,180216,55730,55683,10941,66624,917
2022-05-07,Inyo,027,18085,4101,4087,514,4601,56
2022-05-07,Kern,029,883053,192931,192590,46550,239140,2287
2022-05-07,Kings,031,150075,51764,51702,3633,55335,447
2022-05-07,Lake,033,64148,10790,10766,907,11673,137
2022-05-07,Lassen,035,31185,8985,8978,889,9867,65
2022-05-07,Los Angeles,037,10098052,2763621,2751478,128228,2879706,31738
2022-05-07,Madera,039,155013,37530,37420,6087,43507,365
2022-05-07,Marin,041,260295,35361,34934,2938,37872,292
2022-05-07,Mariposa,043,17540,2463,2438,205,2643,30
2022-05-07,Mendocino,045,87422,13336,13270,3142,16412,124
2022-05-07,Merced,047,269075,62603,62471,8823,71294,818
2022-05-07,Modoc,049,8938,747,745,253,998,8
2022-05-07,Mono,051,14174,3001,2997,128,3125,6
2022-05-07,Monterey,053,433212,80657,80246,14331,94577,733
2022-05-07,Napa,055,140530,26678,26524,1047,27571,143
2022-05-07,Nevada,057,99092,16228,16171,1245,17416,127
2022-05-07,Orange,059,3164182,556547,554411,42683,597094,7007
2022-05-07,Placer,061,380077,63900,63577,7502,71079,625
2022-05-07,Plumas,063,18699,2998,2996,364,3360,13
2022-05-07,Riverside,065,2383286,597592,596022,28570,624592,6467
2022-05-07,Sacramento,067,1510023,286063,284564,27745,312309,3016
2022-05-07,San Benito,069,59416,13089,13047,527,13574,98
2022-05-07,San Bernardino,071,2135413,571791,570381,25165,595546,7306
2022-05-07,San Diego,073,3302833,768551,765377,53559,818936,5244
2022-05-07,San Francisco,075,870044,134245,132659,8833,141492,861
2022-05-07,San Joaquin,077,732212,168080,167568,9968,177536,2229
2022-05-07,San Luis Obispo,079,281455,53433,53273,3972,57245,477
2022-05-07,San Mateo,081,765935,129045,127615,7558,135173,709
2022-05-07,Santa Barbara,083,443738,87644,87305,4872,92177,692
2022-05-07,Santa Clara,085,1922200,327706,324946,13089,338035,2287
2022-05-07,Santa Cruz,087,273765,50223,49605,2229,51834,262
2022-05-07,Shasta,089,179085,30783,30721,6177,36898,563
2022-05-07,Sierra,091,2930,275,275,49,324,4
2022-05-07,Siskiyou,093,43540,4479,4470,2778,7248,81
2022-05-07,Solano,095,438530,83624,83038,5671,88709,450
2022-05-07,Sonoma,097,501317,86927,86150,2930,89080,488
2022-05-07,Stanislaus,099,539301,118462,118235,17554,135789,1643
2022-05-07,Sutter,101,95872,20659,20694,2162,22856,225
2022-05-07,Tehama,103,63373,12107,12098,2633,14731,201
2022-05-07,Trinity,105,12862,1187,1180,296,1476,20
2022-05-07,Tulare,107,460477,107088,106987,28937,135924,1468
2022-05-07,Tuolumne,109,53932,12830,12793,578,13371,181
2022-05-07,Ventura,111,848112,176122,175454,9473,184927,1491
2022-05-07,Yolo,113,214977,37675,37456,3277,40733,315
2022-05-07,Yuba,115,75493,16008,15964,1239,17203,122
2022-05-06,Alameda,001,1643700,268066,265198,14534,279732,1855
2022-05-06,Alpine,003,1148,125,125,1,126,0
2022-05-06,Amador,005,37829,8606,8556,666,9222,86
2022-05-06,Butte,007,227075,33352,33269,6738,40007,421
2022-05-06,Calaveras,009,45235,7369,7353,365,7718,120
2022-05-06,Colusa,011,21464,3462,3459,1076,4535,21
2022-05-06,Contra Costa,013,1133247,195342,193961,13796,207757,1302
2022-05-06,Del Norte,015,27424,5909,5884,204,6088,50
2022-05-06,El Dorado,017,186661,27166,27081,3256,30337,210
2022-05-06,Fresno,019,978130,233127,232655,24017,256672,2754
2022-05-06,Glenn,021,27897,5001,4996,1626,6622,48
2022-05-06,Humboldt,023,135768,17597,17410,3073,20483,146
2022-05-06,Imperial,025,180216,55724,55683,10941,66624,917
2022-05-06,Inyo,027,18085,4094,4087,514,4601,56
2022-05-06,Kern,029,883053,192900,192590,46550,239140,2287
2022-05-06,Kings,031,150075,51759,51702,3633,55335,447
2022-05-06,Lake,033,64148,10788,10766,907,11673,137
2022-05-06,Lassen,035,31185,8985,8978,889,9867,65
2022-05-06,Los Angeles,037,10098052,2762136,2751478,128228,2879706,31738
2022-05-06,Madera,039,155013,37526,37420,6087,43507,365
2022-05-06,Marin,041,260295,35299,34934,2938,37872,292
2022-05-06,Mariposa,043,17540,2461,2438,205,2643,30
2022-05-06,Mendocino,045,87422,13328,13270,3142,16412,124
2022-05-06,Merced,047,269075,62590,62471,8823,71294,818
2022-05-06,Modoc,049,8938,747,745,253,998,8
2022-05-06,Mono,051,14174,3000,2997,128,3125,6
2022-05-06,Monterey,053,433212,80636,80246,14331,94577,733
2022-05-06,Napa,055,140530,26670,26524,1047,27571,143
2022-05-06,Nevada,057,99092,16227,16171,1245,17416,127
2022-05-06,Orange,059,3164182,556263,554411,42683,597094,7007
2022-05-06,Placer,061,380077,63858,63577,7502,71079,625
2022-05-06,Plumas,063,18699,2998,2996,364,3360,13
2022-05-06,Riverside,065,2383286,597440,596022,28570,624592,6467
2022-05-06,Sacramento,067,1510023,285840,284564,27745,312309,3016
2022-05-06,San Benito,069,59416,13085,13047,527,13574,98
2022-05-06,San Bernardino,071,2135413,571672,570381,25165,595546,7306
2022-05-06,San Diego,073,3302833,768085,765377,53559,818936,5244
2022-05-06,San Francisco,075,870044,134013,132659,8833,141492,861
2022-05-06,San Joaquin,077,732212,168030,167568,9968,177536,2229
2022-05-06,San Luis Obispo,079,281455,53417,53273,3972,57245,477
2022-05-06,San Mateo,081,765935,128874,127615,7558,135173,709
2022-05-06,Santa Barbara,083,443738,87619,87305,4872,92177,692
2022-05-06,Santa Clara,085,1922200,327228,324946,13089,338035,2287
2022-05-06,Santa Cruz,087,273765,50176,49605,2229,51834,262
2022-05-06,Shasta,089,179085,30780,30721,6177,36898,563
2022-05-06,Sierra,091,2930,275,275,49,324,4
2022-05-06,Siskiyou,093,43540,4479,4470,2778,7248,81
2022-05-06,Solano,095,438530,83551,83038,5671,88709,450
2022-05-06,Sonoma,097,501317,86842,86150,2930,89080,488
2022-05-06,Stanislaus,099,539301,118427,118235,17554,135789,1643
2022-05-06,Sutter,101,95872,20655,20694,2162,22856,225
2022-05-06,Tehama,103,63373,12105,12098,2633,14731,201
2022-05-06,Trinity,105,12862,1186,1180,296,1476,20
2022-05-06,Tulare,107,460477,107081,106987,28937,135924,1468
2022-05-06,Tuolumne,109,53932,12826,12793,578,13371,181
2022-05-06,Ventura,111,848112,176026,175454,9473,184927,1491
2022-05-06,Yolo,113,214977,37650,37456,3277,40733,315
2022-05-06,Yuba,115,75493,15999,15964,1239,17203,122
2022-05-05,Alameda,001,1643700,267529,265198,14534,279732,1855
2022-05-05,Alpine,003,1148,125,125,1,126,0
2022-05-05,Amador,005,37829,8605,8556,666,9222,86
2022-05-05,Butte,007,227075,33337,33269,6738,40007,421
2022-05-05,Calaveras,009,45235,7366,7353,365,7718,120
2022-05-05,Colusa,011,21464,3462,3459,1076,4535,21
2022-05-05,Contra Costa,013,1133247,195007,193961,13796,207757,1302
2022-05-05,Del Norte,015,27424,5908,5884,204,6088,50
2022-05-05,El Dorado,017,186661,27149,27081,3256,30337,210
2022-05-05,Fresno,019,978130,233050,232655,24017,256672,2754
2022-05-05,Glenn,021,27897,5000,4996,1626,6622,48
2022-05-05,Humboldt,023,135768,17568,17410,3073,20483,146
2022-05-05,Imperial,025,180216,55721,55683,10941,66624,917
2022-05-05,Inyo,027,18085,4092,4087,514,4601,56
2022-05-05,Kern,029,883053,192860,192590,46550,239140,2287
2022-05-05,Kings,031,150075,51748,51702,3633,55335,447
2022-05-05,Lake,033,64148,10785,10766,907,11673,137
2022-05-05,Lassen,035,31185,8985,8978,889,9867,65
2022-05-05,Los Angeles,037,10098052,2759851,2751478,128228,2879706,31738
2022-05-05,Madera,039,155013,37512,37420,6087,43507,365
2022-05-05,Marin,041,260295,35208,34934,2938,37872,292
2022-05-05,Mariposa,043,17540,2460,2438,205,2643,30
2022-05-05,Mendocino,045,87422,13320,13270,3142,16412,124
2022-05-05,Merced,047,269075,62564,62471,8823,71294,818
2022-05-05,Modoc,049,8938,747,745,253,998,8
2022-05-05,Mono,051,14174,3000,2997,128,3125,6
2022-05-05,Monterey,053,433212,80593,80246,14331,94577,733
2022-05-05,Napa,055,140530,26649,26524,1047,27571,143
2022-05-05,Nevada,057,99092,16220,16171,1245,17416,127
2022-05-05,Orange,059,3164182,555783,554411,42683,597094,7007
2022-05-05,Placer,061,380077,63817,63577,7502,71079,625
2022-05-05,Plumas,063,18699,2997,2996,364,3360,13
2022-05-05,Riverside,065,2383286,597178,596022,28570,624592,6467
2022-05-05,Sacramento,067,1510023,285553,284564,27745,312309,3016
2022-05-05,San Benito,069,59416,13074,13047,527,13574,98
2022-05-05,San Bernardino,071,2135413,571427,570381,25165,595546,7306
2022-05-05,San Diego,073,3302833,767387,765377,53559,818936,5244
2022-05-05,San Francisco,075,870044,133663,132659,8833,141492,861
2022-05-05,San Joaquin,077,732212,167957,167568,9968,177536,2229
2022-05-05,San Luis Obispo,079,281455,53382,53273,3972,57245,477
2022-05-05,San Mateo,081,765935,128579,127615,7558,135173,709
2022-05-05,Santa Barbara,083,443738,87557,87305,4872,92177,692
2022-05-05,Santa Clara,085,1922200,326544,324946,13089,338035,2287
2022-05-05,Santa Cruz,087,273765,50091,49605,2229,51834,262
2022-05-05,Shasta,089,179085,30773,30721,6177,36898,563
2022-05-05,Sierra,091,2930,275,275,49,324,4
2022-05-05,Siskiyou,093,43540,4478,4470,2778,7248,81
2022-05-05,Solano,095,438530,83445,83038,5671,88709,450
2022-05-05,Sonoma,097,501317,86696,86150,2930,89080,488
2022-05-05,Stanislaus,099,539301,118377,118235,17554,135789,1643
2022-05-05,Sutter,101,95872,20652,20694,2162,22856,225
2022-05-05,Tehama,103,63373,12101,12098,2633,14731,201
2022-05-05,Trinity,105,12862,1186,1180,296,1476,20
2022-05-05,Tulare,107,460477,107063,106987,28937,135924,1468
2022-05-05,Tuolumne,109,53932,12815,12793,578,13371,181
2022-05-05,Ventura,111,848112,175876,175454,9473,184927,1491
2022-05-05,Yolo,113,214977,37601,37456,3277,40733,315
2022-05-05,Yuba,115,75493,15989,15964,1239,17203,122
2022-05-04,Alameda,001,1643700,266922,263736,14534,278270,1850
2022-05-04,Alpine,003,1148,125,124,1,125,0
2022-05-04,Amador,005,37829,8603,8546,666,9212,86
2022-05-04,Butte,007,227075,33319,33220,6738,39958,417
2022-05-04,Calaveras,009,45235,7361,7344,365,7709,120
2022-05-04,Colusa,011,21464,3461,3460,1076,4536,21
2022-05-04,Contra Costa,013,1133247,194676,193175,13796,206971,1302
2022-05-04,Del Norte,015,27424,5900,5866,204,6070,50
2022-05-04,El Dorado,017,186661,27128,27021,3256,30277,210
2022-05-04,Fresno,019,978130,232953,232332,24017,256349,2751
2022-05-04,Glenn,021,27897,4999,4995,1626,6621,48
2022-05-04,Humboldt,023,135768,17535,17316,3073,20389,146
2022-05-04,Imperial,025,180216,55702,55548,10941,66489,910
2022-05-04,Inyo,027,18085,4092,4085,514,4599,56
2022-05-04,Kern,029,883053,192811,192432,46550,238982,2281
2022-05-04,Kings,031,150075,51730,51663,3633,55296,447
2022-05-04,Lake,033,64148,10781,10758,907,11665,137
2022-05-04,Lassen,035,31185,8984,8972,889,9861,65
2022-05-04,Los Angeles,037,10098052,2757281,2744894,128228,2873122,31722
2022-05-04,Madera,039,155013,37492,37395,6087,43482,365
2022-05-04,Marin,041,260295,35136,34727,2938,37665,291
2022-05-04,Mariposa,043,17540,2454,2435,205,2640,30
2022-05-04,Mendocino,045,87422,13311,13247,3142,16389,123
2022-05-04,Merced,047,269075,62539,62419,8823,71242,818
2022-05-04,Modoc,049,8938,747,746,253,999,8
2022-05-04,Mono,051,14174,3000,2993,128,3121,6
2022-05-04,Monterey,053,433212,80540,80038,14331,94369,732
2022-05-04,Napa,055,140530,26616,26434,1047,27481,143
2022-05-04,Nevada,057,99092,16202,16136,1245,17381,127
2022-05-04,Orange,059,3164182,555222,553177,42683,595860,7006
2022-05-04,Placer,061,380077,63749,63410,7502,70912,625
2022-05-04,Plumas,063,18699,2996,2947,364,3311,13
2022-05-04,Riverside,065,2383286,596885,594981,28570,623551,6457
2022-05-04,Sacramento,067,1510023,285255,283939,27745,311684,3013
2022-05-04,San Benito,069,59416,13064,13019,527,13546,98
2022-05-04,San Bernardino,071,2135413,571219,569570,25165,594735,7240
2022-05-04,San Diego,073,3302833,766683,763453,53559,817012,5239
2022-05-04,San Francisco,075,870044,133288,131599,8833,140432,860
2022-05-04,San Joaquin,077,732212,167855,167280,9968,177248,2225
2022-05-04,San Luis Obispo,079,281455,53341,53156,3972,57128,477
2022-05-04,San Mateo,081,765935,128283,126800,7558,134358,710
2022-05-04,Santa Barbara,083,443738,87469,87058,4872,91930,688
2022-05-04,Santa Clara,085,1922200,325799,322805,13089,335894,2285
2022-05-04,Santa Cruz,087,273765,49986,49230,2229,51459,262
2022-05-04,Shasta,089,179085,30758,30681,6177,36858,556
2022-05-04,Sierra,091,2930,275,275,49,324,4
2022-05-04,Siskiyou,093,43540,4476,4463,2778,7241,81
2022-05-04,Solano,095,438530,83296,82796,5671,88467,449
2022-05-04,Sonoma,097,501317,86536,85694,2930,88624,488
2022-05-04,Stanislaus,099,539301,118325,118123,17554,135677,1643
2022-05-04,Sutter,101,95872,20645,20672,2162,22834,224
2022-05-04,Tehama,103,63373,12100,12090,2633,14723,201
2022-05-04,Trinity,105,12862,1186,1180,296,1476,20
2022-05-04,Tulare,107,460477,107049,106935,28937,135872,1464
2022-05-04,Tuolumne,109,53932,12810,12757,578,13335,181
2022-05-04,Ventura,111,848112,175731,175066,9473,184539,1486
2022-05-04,Yolo,113,214977,37559,37344,3277,40621,315
2022-05-04,Yuba,115,75493,15981,15940,1239,17179,122
2022-05-03,Alameda,001,1643700,266378,263736,14534,278270,1850
2022-05-03,Alpine,003,1148,125,124,1,125,0
2022-05-03,Amador,005,37829,8600,8546,666,9212,86
2022-05-03,Butte,007,227075,33305,33220,6738,39958,417
2022-05-03,Calaveras,009,45235,7356,7344,365,7709,120
2022-05-03,Colusa,011,21464,3460,3460,1076,4536,21
2022-05-03,Contra Costa,013,1133247,194306,193175,13796,206971,1302
2022-05-03,Del Norte,015,27424,5894,5866,204,6070,50
2022-05-03,El Dorado,017,186661,27108,27021,3256,30277,210
2022-05-03,Fresno,019,978130,232843,232332,24017,256349,2751
2022-05-03,Glenn,021,27897,4998,4995,1626,6621,48
2022-05-03,Humboldt,023,135768,17499,17316,3073,20389,146
2022-05-03,Imperial,025,180216,55686,55548,10941,66489,910
2022-05-03,Inyo,027,18085,4090,4085,513,4598,56
2022-05-03,Kern,029,883053,192741,192432,46550,238982,2281
2022-05-03,Kings,031,150075,51720,51663,3633,55296,447
2022-05-03,Lake,033,64148,10776,10758,907,11665,137
2022-05-03,Lassen,035,31185,8984,8972,889,9861,65
2022-05-03,Los Angeles,037,10098052,2754371,2744894,128224,2873118,31722
2022-05-03,Madera,039,155013,37463,37395,6087,43482,365
2022-05-03,Marin,041,260295,35033,34727,2938,37665,291
2022-05-03,Mariposa,043,17540,2446,2435,205,2640,30
2022-05-03,Mendocino,045,87422,13297,13247,3142,16389,123
2022-05-03,Merced,047,269075,62514,62419,8814,71233,818
2022-05-03,Modoc,049,8938,746,746,253,999,8
2022-05-03,Mono,051,14174,2997,2993,128,3121,6
2022-05-03,Monterey,053,433212,80500,80038,14328,94366,732
2022-05-03,Napa,055,140530,26586,26434,1047,27481,143
2022-05-03,Nevada,057,99092,16192,16136,1245,17381,127
2022-05-03,Orange,059,3164182,554713,553177,42683,595860,7006
2022-05-03,Placer,061,380077,63667,63410,7502,70912,625
2022-05-03,Plumas,063,18699,2993,2947,364,3311,13
2022-05-03,Riverside,065,2383286,596546,594981,28570,623551,6457
2022-05-03,Sacramento,067,1510023,284963,283939,27745,311684,3013
2022-05-03,San Benito,069,59416,13050,13019,527,13546,98
2022-05-03,San Bernardino,071,2135413,570997,569570,25165,594735,7240
2022-05-03,San Diego,073,3302833,765875,763453,53514,816967,5239
2022-05-03,San Francisco,075,870044,132845,131599,8833,140432,860
2022-05-03,San Joaquin,077,732212,167780,167280,9938,177218,2225
2022-05-03,San Luis Obispo,079,281455,53295,53156,3972,57128,477
2022-05-03,San Mateo,081,765935,127953,126800,7558,134358,710
2022-05-03,Santa Barbara,083,443738,87391,87058,4872,91930,688
2022-05-03,Santa Clara,085,1922200,325032,322805,13089,335894,2285
2022-05-03,Santa Cruz,087,273765,49905,49230,2229,51459,262
2022-05-03,Shasta,089,179085,30742,30681,6177,36858,556
2022-05-03,Sierra,091,2930,275,275,49,324,4
2022-05-03,Siskiyou,093,43540,4476,4463,2778,7241,81
2022-05-03,Solano,095,438530,83122,82796,5671,88467,449
2022-05-03,Sonoma,097,501317,86369,85694,2930,88624,488
2022-05-03,Stanislaus,099,539301,118277,118123,17552,135675,1643
2022-05-03,Sutter,101,95872,20640,20672,2162,22834,224
2022-05-03,Tehama,103,63373,12096,12090,2633,14723,201
2022-05-03,Trinity,105,12862,1186,1180,296,1476,20
2022-05-03,Tulare,107,460477,107028,106935,28932,135867,1464
2022-05-03,Tuolumne,109,53932,12798,12757,578,13335,181
2022-05-03,Ventura,111,848112,175578,175066,9473,184539,1486
2022-05-03,Yolo,113,214977,37506,37344,3277,40621,315
2022-05-03,Yuba,115,75493,15971,15940,1239,17179,122
2022-05-02,Alameda,001,1643700,265801,263736,14534,278270,1850
2022-05-02,Alpine,003,1148,125,124,1,125,0
2022-05-02,Amador,005,37829,8598,8546,666,9212,86
2022-05-02,Butte,007,227075,33285,33220,6738,39958,417
2022-05-02,Calaveras,009,45235,7355,7344,365,7709,120
2022-05-02,Colusa,011,21464,3460,3460,1076,4536,21
2022-05-02,Contra Costa,013,1133247,193955,193175,13796,206971,1302
2022-05-02,Del Norte,015,27424,5889,5866,204,6070,50
2022-05-02,El Dorado,017,186661,27090,27021,3256,30277,210
2022-05-02,Fresno,019,978130,232752,232332,24016,256348,2751
2022-05-02,Glenn,021,27897,4996,4995,1626,6621,48
2022-05-02,Humboldt,023,135768,17452,17316,3073,20389,146
2022-05-02,Imperial,025,180216,55675,55548,10941,66489,910
2022-05-02,Inyo,027,18085,4089,4085,512,4597,56
2022-05-02,Kern,029,883053,192668,192432,46550,238982,2281
2022-05-02,Kings,031,150075,51705,51663,3633,55296,447
2022-05-02,Lake,033,64148,10772,10758,907,11665,137
2022-05-02,Lassen,035,31185,8982,8972,889,9861,65
2022-05-02,Los Angeles,037,10098052,2751645,2744894,128120,2873014,31722
2022-05-02,Madera,039,155013,37446,37395,6087,43482,365
2022-05-02,Marin,041,260295,34919,34727,2931,37658,291
2022-05-02,Mariposa,043,17540,2441,2435,205,2640,30
2022-05-02,Mendocino,045,87422,13281,13247,3142,16389,123
2022-05-02,Merced,047,269075,62489,62419,8814,71233,818
2022-05-02,Modoc,049,8938,745,746,253,999,8
2022-05-02,Mono,051,14174,2996,2993,128,3121,6
2022-05-02,Monterey,053,433212,80428,80038,14317,94355,732
2022-05-02,Napa,055,140530,26554,26434,1046,27480,143
2022-05-02,Nevada,057,99092,16178,16136,1245,17381,127
2022-05-02,Orange,059,3164182,554187,553177,42682,595859,7006
2022-05-02,Placer,061,380077,63616,63410,7502,70912,625
2022-05-02,Plumas,063,18699,2993,2947,364,3311,13
2022-05-02,Riverside,065,2383286,596181,594981,28570,623551,6457
2022-05-02,Sacramento,067,1510023,284693,283939,27745,311684,3013
2022-05-02,San Benito,069,59416,13038,13019,527,13546,98
2022-05-02,San Bernardino,071,2135413,570750,569570,25164,594734,7240
2022-05-02,San Diego,073,3302833,765041,763453,53438,816891,5239
2022-05-02,San Francisco,075,870044,132416,131599,8833,140432,860
2022-05-02,San Joaquin,077,732212,167671,167280,9935,177215,2225
2022-05-02,San Luis Obispo,079,281455,53246,53156,3952,57108,477
2022-05-02,San Mateo,081,765935,127639,126800,7558,134358,710
2022-05-02,Santa Barbara,083,443738,87290,87058,4872,91930,688
2022-05-02,Santa Clara,085,1922200,324185,322805,13089,335894,2285
2022-05-02,Santa Cruz,087,273765,49782,49230,2229,51459,262
2022-05-02,Shasta,089,179085,30724,30681,6177,36858,556
2022-05-02,Sierra,091,2930,275,275,49,324,4
2022-05-02,Siskiyou,093,43540,4473,4463,2778,7241,81
2022-05-02,Solano,095,438530,82997,82796,5671,88467,449
2022-05-02,Sonoma,097,501317,86195,85694,2927,88621,488
2022-05-02,Stanislaus,099,539301,118205,118123,17538,135661,1643
2022-05-02,Sutter,101,95872,20633,20672,2162,22834,224
2022-05-02,Tehama,103,63373,12091,12090,2633,14723,201
2022-05-02,Trinity,105,12862,1185,1180,296,1476,20
2022-05-02,Tulare,107,460477,107005,106935,28927,135862,1464
2022-05-02,Tuolumne,109,53932,12793,12757,578,13335,181
2022-05-02,Ventura,111,848112,175425,175066,9471,184537,1486
2022-05-02,Yolo,113,214977,37467,37344,3277,40621,315
2022-05-02,Yuba,115,75493,15966,15940,1238,17178,122
2022-05-01,Alameda,001,1643700,265142,262027,14534,276561,1851
2022-05-01,Alpine,003,1148,125,124,1,125,0
2022-05-01,Amador,005,37829,8598,8533,666,9199,86
2022-05-01,Butte,007,227075,33259,33172,6738,39910,418
2022-05-01,Calaveras,009,45235,7351,7328,365,7693,120
2022-05-01,Colusa,011,21464,3460,3457,1076,4533,21
2022-05-01,Contra Costa,013,1133247,193605,192136,13796,205932,1301
2022-05-01,Del Norte,015,27424,5880,5841,204,6045,50
2022-05-01,El Dorado,017,186661,27061,26946,3256,30202,210
2022-05-01,Fresno,019,978130,232652,232067,24016,256083,2748
2022-05-01,Glenn,021,27897,4996,4995,1626,6621,48
2022-05-01,Humboldt,023,135768,17396,17194,3073,20267,145
2022-05-01,Imperial,025,180216,55655,55503,10941,66444,910
2022-05-01,Inyo,027,18085,4088,4084,512,4596,56
2022-05-01,Kern,029,883053,192611,192250,46548,238798,2265
2022-05-01,Kings,031,150075,51684,51640,3632,55272,447
2022-05-01,Lake,033,64148,10767,10742,907,11649,137
2022-05-01,Lassen,035,31185,8982,8966,889,9855,65
2022-05-01,Los Angeles,037,10098052,2748999,2736900,127944,2864844,31712
2022-05-01,Madera,039,155013,37428,37360,6087,43447,365
2022-05-01,Marin,041,260295,34840,34519,2910,37429,291
2022-05-01,Mariposa,043,17540,2440,2430,205,2635,30
2022-05-01,Mendocino,045,87422,13262,13219,3142,16361,123
2022-05-01,Merced,047,269075,62464,62357,8813,71170,818
2022-05-01,Modoc,049,8938,745,745,253,998,8
2022-05-01,Mono,051,14174,2993,2989,128,3117,6
2022-05-01,Monterey,053,433212,80357,79881,14310,94191,731
2022-05-01,Napa,055,140530,26513,26319,1045,27364,143
2022-05-01,Nevada,057,99092,16160,16100,1245,17345,127
2022-05-01,Orange,059,3164182,553639,551822,42681,594503,6998
2022-05-01,Placer,061,380077,63548,63273,7502,70775,625
2022-05-01,Plumas,063,18699,2992,2946,364,3310,13
2022-05-01,Riverside,065,2383286,595749,593965,28568,622533,6457
2022-05-01,Sacramento,067,1510023,284378,283048,27745,310793,3007
2022-05-01,San Benito,069,59416,13030,12988,527,13515,98
2022-05-01,San Bernardino,071,2135413,570458,568758,25164,593922,7191
2022-05-01,San Diego,073,3302833,764173,761253,53358,814611,5238
2022-05-01,San Francisco,075,870044,131949,130241,8833,139074,860
2022-05-01,San Joaquin,077,732212,167540,167028,9887,176915,2225
2022-05-01,San Luis Obispo,079,281455,53174,53040,3936,56976,477
2022-05-01,San Mateo,081,765935,127281,125807,7557,133364,705
2022-05-01,Santa Barbara,083,443738,87188,86768,4872,91640,688
2022-05-01,Santa Clara,085,1922200,323278,320709,13089,333798,2281
2022-05-01,Santa Cruz,087,273765,49631,48798,2229,51027,262
2022-05-01,Shasta,089,179085,30708,30649,6176,36825,554
2022-05-01,Sierra,091,2930,275,274,49,323,4
2022-05-01,Siskiyou,093,43540,4472,4458,2777,7235,81
2022-05-01,Solano,095,438530,82879,82459,5671,88130,449
2022-05-01,Sonoma,097,501317,85998,85290,2908,88198,488
2022-05-01,Stanislaus,099,539301,118148,117943,17520,135463,1643
2022-05-01,Sutter,101,95872,20625,20644,2162,22806,224
2022-05-01,Tehama,103,63373,12090,12078,2633,14711,202
2022-05-01,Trinity,105,12862,1185,1179,296,1475,20
2022-05-01,Tulare,107,460477,106976,106856,28921,135777,1458
2022-05-01,Tuolumne,109,53932,12777,12713,578,13291,181
2022-05-01,Ventura,111,848112,175271,174679,9467,184146,1486
2022-05-01,Yolo,113,214977,37431,37173,3275,40448,314
2022-05-01,Yuba,115,75493,15956,15917,1236,17153,121
2022-04-30,Alameda,001,1643700,264791,262027,14529,276556,1851
2022-04-30,Alpine,003,1148,125,124,1,125,0
2022-04-30,Amador,005,37829,8597,8533,666,9199,86
2022-04-30,Butte,007,227075,33254,33172,6738,39910,418
2022-04-30,Calaveras,009,45235,7348,7328,365,7693,120
2022-04-30,Colusa,011,21464,3459,3457,1076,4533,21
2022-04-30,Contra Costa,013,1133247,193380,192136,13792,205928,1301
2022-04-30,Del Norte,015,27424,5875,5841,204,6045,50
2022-04-30,El Dorado,017,186661,27044,26946,3255,30201,210
2022-04-30,Fresno,019,978130,232612,232067,24014,256081,2748
2022-04-30,Glenn,021,27897,4996,4995,1626,6621,48
2022-04-30,Humboldt,023,135768,17359,17194,3072,20266,145
2022-04-30,Imperial,025,180216,55642,55503,10941,66444,910
2022-04-30,Inyo,027,18085,4088,4084,512,4596,56
2022-04-30,Kern,029,883053,192581,192250,46545,238795,2265
2022-04-30,Kings,031,150075,51679,51640,3632,55272,447
2022-04-30,Lake,033,64148,10764,10742,907,11649,137
2022-04-30,Lassen,035,31185,8982,8966,889,9855,65
2022-04-30,Los Angeles,037,10098052,2747822,2736900,127821,2864721,31712
2022-04-30,Madera,039,155013,37417,37360,6086,43446,365
2022-04-30,Marin,041,260295,34798,34519,2884,37403,291
2022-04-30,Mariposa,043,17540,2438,2430,205,2635,30
2022-04-30,Mendocino,045,87422,13257,13219,3142,16361,123
2022-04-30,Merced,047,269075,62452,62357,8812,71169,818
2022-04-30,Modoc,049,8938,745,745,253,998,8
2022-04-30,Mono,051,14174,2993,2989,128,3117,6
2022-04-30,Monterey,053,433212,80292,79881,14298,94179,731
2022-04-30,Napa,055,140530,26492,26319,1045,27364,143
2022-04-30,Nevada,057,99092,16152,16100,1244,17344,127
2022-04-30,Orange,059,3164182,553389,551822,42657,594479,6998
2022-04-30,Placer,061,380077,63502,63273,7501,70774,625
2022-04-30,Plumas,063,18699,2989,2946,364,3310,13
2022-04-30,Riverside,065,2383286,595524,593965,28565,622530,6457
2022-04-30,Sacramento,067,1510023,284264,283048,27743,310791,3007
2022-04-30,San Benito,069,59416,13028,12988,527,13515,98
2022-04-30,San Bernardino,071,2135413,570300,568758,25162,593920,7191
2022-04-30,San Diego,073,3302833,763819,761253,53337,814590,5238
2022-04-30,San Francisco,075,870044,131690,130241,8823,139064,860
2022-04-30,San Joaquin,077,732212,167487,167028,9885,176913,2225
2022-04-30,San Luis Obispo,079,281455,53164,53040,3933,56973,477
2022-04-30,San Mateo,081,765935,127082,125807,7545,133352,705
2022-04-30,Santa Barbara,083,443738,87137,86768,4870,91638,688
2022-04-30,Santa Clara,085,1922200,322748,320709,13083,333792,2281
2022-04-30,Santa Cruz,087,273765,49593,48798,2229,51027,262
2022-04-30,Shasta,089,179085,30703,30649,6176,36825,554
2022-04-30,Sierra,091,2930,275,274,49,323,4
2022-04-30,Siskiyou,093,43540,4470,4458,2777,7235,81
2022-04-30,Solano,095,438530,82862,82459,5669,88128,449
2022-04-30,Sonoma,097,501317,85892,85290,2902,88192,488
2022-04-30,Stanislaus,099,539301,118124,117943,17515,135458,1643
2022-04-30,Sutter,101,95872,20621,20644,2161,22805,224
2022-04-30,Tehama,103,63373,12088,12078,2633,14711,202
2022-04-30,Trinity,105,12862,1185,1179,296,1475,20
2022-04-30,Tulare,107,460477,106959,106856,28917,135773,1458
2022-04-30,Tuolumne,109,53932,12771,12713,578,13291,181
2022-04-30,Ventura,111,848112,175198,174679,9461,184140,1486
2022-04-30,Yolo,113,214977,37391,37173,3274,40447,314
2022-04-30,Yuba,115,75493,15950,15917,1235,17152,121
2022-04-29,Alameda,001,1643700,264506,262027,14519,276546,1851
2022-04-29,Alpine,003,1148,124,124,1,125,0
2022-04-29,Amador,005,37829,8590,8533,666,9199,86
2022-04-29,Butte,007,227075,33250,33172,6737,39909,418
2022-04-29,Calaveras,009,45235,7346,7328,365,7693,120
2022-04-29,Colusa,011,21464,3458,3457,1076,4533,21
2022-04-29,Contra Costa,013,1133247,193201,192136,13784,205920,1301
2022-04-29,Del Norte,015,27424,5871,5841,204,6045,50
2022-04-29,El Dorado,017,186661,27033,26946,3252,30198,210
2022-04-29,Fresno,019,978130,232564,232067,24014,256081,2748
2022-04-29,Glenn,021,27897,4996,4995,1626,6621,48
2022-04-29,Humboldt,023,135768,17337,17194,3072,20266,145
2022-04-29,Imperial,025,180216,55627,55503,10941,66444,910
2022-04-29,Inyo,027,18085,4088,4084,510,4594,56
2022-04-29,Kern,029,883053,192555,192250,46542,238792,2265
2022-04-29,Kings,031,150075,51674,51640,3632,55272,447
2022-04-29,Lake,033,64148,10763,10742,907,11649,137
2022-04-29,Lassen,035,31185,8981,8966,889,9855,65
2022-04-29,Los Angeles,037,10098052,2746604,2736900,127704,2864604,31712
2022-04-29,Madera,039,155013,37407,37360,6086,43446,365
2022-04-29,Marin,041,260295,34735,34519,2860,37379,291
2022-04-29,Mariposa,043,17540,2436,2430,205,2635,30
2022-04-29,Mendocino,045,87422,13253,13219,3142,16361,123
2022-04-29,Merced,047,269075,62441,62357,8812,71169,818
2022-04-29,Modoc,049,8938,745,745,253,998,8
2022-04-29,Mono,051,14174,2993,2989,128,3117,6
2022-04-29,Monterey,053,433212,80258,79881,14288,94169,731
2022-04-29,Napa,055,140530,26464,26319,1045,27364,143
2022-04-29,Nevada,057,99092,16145,16100,1243,17343,127
2022-04-29,Orange,059,3164182,553132,551822,42611,594433,6998
2022-04-29,Placer,061,380077,63476,63273,7500,70773,625
2022-04-29,Plumas,063,18699,2988,2946,364,3310,13
2022-04-29,Riverside,065,2383286,595307,593965,28552,622517,6457
2022-04-29,Sacramento,067,1510023,284119,283048,27739,310787,3007
2022-04-29,San Benito,069,59416,13023,12988,527,13515,98
2022-04-29,San Bernardino,071,2135413,570151,568758,25157,593915,7191
2022-04-29,San Diego,073,3302833,763407,761253,53322,814575,5238
2022-04-29,San Francisco,075,870044,131473,130241,8809,139050,860
2022-04-29,San Joaquin,077,732212,167436,167028,9881,176909,2225
2022-04-29,San Luis Obispo,079,281455,53150,53040,3929,56969,477
2022-04-29,San Mateo,081,765935,126885,125807,7534,133341,705
2022-04-29,Santa Barbara,083,443738,87098,86768,4869,91637,688
2022-04-29,Santa Clara,085,1922200,322266,320709,13067,333776,2281
2022-04-29,Santa Cruz,087,273765,49538,48798,2227,51025,262
2022-04-29,Shasta,089,179085,30701,30649,6176,36825,554
2022-04-29,Sierra,091,2930,275,274,49,323,4
2022-04-29,Siskiyou,093,43540,4469,4458,2777,7235,81
2022-04-29,Solano,095,438530,82810,82459,5662,88121,449
2022-04-29,Sonoma,097,501317,85792,85290,2896,88186,488
2022-04-29,Stanislaus,099,539301,118104,117943,17510,135453,1643
2022-04-29,Sutter,101,95872,20616,20644,2161,22805,224
2022-04-29,Tehama,103,63373,12086,12078,2633,14711,202
2022-04-29,Trinity,105,12862,1185,1179,296,1475,20
2022-04-29,Tulare,107,460477,106944,106856,28908,135764,1458
2022-04-29,Tuolumne,109,53932,12764,12713,578,13291,181
2022-04-29,Ventura,111,848112,175127,174679,9460,184139,1486
2022-04-29,Yolo,113,214977,37365,37173,3273,40446,314
2022-04-29,Yuba,115,75493,15945,15917,1235,17152,121
2022-04-28,Alameda,001,1643700,264073,262027,14491,276518,1851
2022-04-28,Alpine,003,1148,124,124,1,125,0
2022-04-28,Amador,005,37829,8589,8533,666,9199,86
2022-04-28,Butte,007,227075,33241,33172,6736,39908,418
2022-04-28,Calaveras,009,45235,7342,7328,365,7693,120
2022-04-28,Colusa,011,21464,3457,3457,1076,4533,21
2022-04-28,Contra Costa,013,1133247,192950,192136,13755,205891,1301
2022-04-28,Del Norte,015,27424,5866,5841,204,6045,50
2022-04-28,El Dorado,017,186661,27014,26946,3251,30197,210
2022-04-28,Fresno,019,978130,232507,232067,24008,256075,2748
2022-04-28,Glenn,021,27897,4993,4995,1626,6621,48
2022-04-28,Humboldt,023,135768,17306,17194,3066,20260,145
2022-04-28,Imperial,025,180216,55614,55503,10940,66443,910
2022-04-28,Inyo,027,18085,4088,4084,510,4594,56
2022-04-28,Kern,029,883053,192516,192250,46538,238788,2265
2022-04-28,Kings,031,150075,51668,51640,3632,55272,447
2022-04-28,Lake,033,64148,10759,10742,907,11649,137
2022-04-28,Lassen,035,31185,8981,8966,889,9855,65
2022-04-28,Los Angeles,037,10098052,2744620,2736900,127536,2864436,31712
2022-04-28,Madera,039,155013,37400,37360,6083,43443,365
2022-04-28,Marin,041,260295,34687,34519,2847,37366,291
2022-04-28,Mariposa,043,17540,2436,2430,205,2635,30
2022-04-28,Mendocino,045,87422,13244,13219,3128,16347,123
2022-04-28,Merced,047,269075,62424,62357,8805,71162,818
2022-04-28,Modoc,049,8938,745,745,253,998,8
2022-04-28,Mono,051,14174,2991,2989,128,3117,6
2022-04-28,Monterey,053,433212,80219,79881,14269,94150,731
2022-04-28,Napa,055,140530,26434,26319,1043,27362,143
2022-04-28,Nevada,057,99092,16137,16100,1240,17340,127
2022-04-28,Orange,059,3164182,552779,551822,42547,594369,6998
2022-04-28,Placer,061,380077,63428,63273,7497,70770,625
2022-04-28,Plumas,063,18699,2987,2946,364,3310,13
2022-04-28,Riverside,065,2383286,595029,593965,28541,622506,6457
2022-04-28,Sacramento,067,1510023,283937,283048,27709,310757,3007
2022-04-28,San Benito,069,59416,13014,12988,525,13513,98
2022-04-28,San Bernardino,071,2135413,569959,568758,25151,593909,7191
2022-04-28,San Diego,073,3302833,762880,761253,53266,814519,5238
2022-04-28,San Francisco,075,870044,131180,130241,8779,139020,860
2022-04-28,San Joaquin,077,732212,167369,167028,9844,176872,2225
2022-04-28,San Luis Obispo,079,281455,53123,53040,3912,56952,477
2022-04-28,San Mateo,081,765935,126648,125807,7507,133314,705
2022-04-28,Santa Barbara,083,443738,87046,86768,4867,91635,688
2022-04-28,Santa Clara,085,1922200,321729,320709,13044,333753,2281
2022-04-28,Santa Cruz,087,273765,49441,48798,2224,51022,262
2022-04-28,Shasta,089,179085,30692,30649,6176,36825,554
2022-04-28,Sierra,091,2930,275,274,49,323,4
2022-04-28,Siskiyou,093,43540,4466,4458,2777,7235,81
2022-04-28,Solano,095,438530,82730,82459,5656,88115,449
2022-04-28,Sonoma,097,501317,85675,85290,2887,88177,488
2022-04-28,Stanislaus,099,539301,118063,117943,17505,135448,1643
2022-04-28,Sutter,101,95872,20606,20644,2158,22802,224
2022-04-28,Tehama,103,63373,12085,12078,2632,14710,202
2022-04-28,Trinity,105,12862,1185,1179,296,1475,20
2022-04-28,Tulare,107,460477,106926,106856,28901,135757,1458
2022-04-28,Tuolumne,109,53932,12754,12713,578,13291,181
2022-04-28,Ventura,111,848112,175042,174679,9443,184122,1486
2022-04-28,Yolo,113,214977,37338,37173,3270,40443,314
2022-04-28,Yuba,115,75493,15936,15917,1235,17152,121
2022-04-27,Alameda,001,1643700,263607,260871,14450,275321,1843
2022-04-27,Alpine,003,1148,124,124,1,125,0
2022-04-27,Amador,005,37829,8588,8518,666,9184,86
2022-04-27,Butte,007,227075,33229,33118,6732,39850,411
2022-04-27,Calaveras,009,45235,7339,7307,365,7672,119
2022-04-27,Colusa,011,21464,3456,3457,1076,4533,21
2022-04-27,Contra Costa,013,1133247,192689,191412,13728,205140,1300
2022-04-27,Del Norte,015,27424,5861,5833,204,6037,50
2022-04-27,El Dorado,017,186661,27003,26898,3249,30147,209
2022-04-27,Fresno,019,978130,232444,231951,23998,255949,2744
2022-04-27,Glenn,021,27897,4993,4993,1626,6619,48
2022-04-27,Humboldt,023,135768,17276,17138,3057,20195,145
2022-04-27,Imperial,025,180216,55596,55480,10936,66416,910
2022-04-27,Inyo,027,18085,4087,4080,509,4589,56
2022-04-27,Kern,029,883053,192476,192157,46531,238688,2271
2022-04-27,Kings,031,150075,51663,51617,3631,55248,444
2022-04-27,Lake,033,64148,10755,10732,907,11639,135
2022-04-27,Lassen,035,31185,8980,8965,889,9854,65
2022-04-27,Los Angeles,037,10098052,2742378,2731988,127371,2859359,31691
2022-04-27,Madera,039,155013,37390,37339,6082,43421,354
2022-04-27,Marin,041,260295,34628,34354,2832,37186,288
2022-04-27,Mariposa,043,17540,2434,2427,205,2632,30
2022-04-27,Mendocino,045,87422,13238,13188,3122,16310,123
2022-04-27,Merced,047,269075,62410,62315,8801,71116,815
2022-04-27,Modoc,049,8938,745,745,253,998,8
2022-04-27,Mono,051,14174,2991,2989,128,3117,6
2022-04-27,Monterey,053,433212,80178,79695,14238,93933,729
2022-04-27,Napa,055,140530,26402,26210,1040,27250,143
2022-04-27,Nevada,057,99092,16123,16080,1237,17317,127
2022-04-27,Orange,059,3164182,552408,550859,42492,593351,6991
2022-04-27,Placer,061,380077,63391,63154,7492,70646,623
2022-04-27,Plumas,063,18699,2986,2934,364,3298,13
2022-04-27,Riverside,065,2383286,594768,593397,28521,621918,6453
2022-04-27,Sacramento,067,1510023,283744,281802,27672,309474,3001
2022-04-27,San Benito,069,59416,12999,12989,524,13513,98
2022-04-27,San Bernardino,071,2135413,569770,568018,25141,593159,7105
2022-04-27,San Diego,073,3302833,762325,759873,53209,813082,5236
2022-04-27,San Francisco,075,870044,130832,129284,8758,138042,857
2022-04-27,San Joaquin,077,732212,167298,166848,9829,176677,2225
2022-04-27,San Luis Obispo,079,281455,53080,52911,3904,56815,476
2022-04-27,San Mateo,081,765935,126419,125018,7451,132469,702
2022-04-27,Santa Barbara,083,443738,86981,86557,4861,91418,685
2022-04-27,Santa Clara,085,1922200,321167,319077,12996,332073,2282
2022-04-27,Santa Cruz,087,273765,49360,48500,2219,50719,262
2022-04-27,Shasta,089,179085,30681,30633,6175,36808,554
2022-04-27,Sierra,091,2930,274,276,49,325,4
2022-04-27,Siskiyou,093,43540,4466,4455,2776,7231,81
2022-04-27,Solano,095,438530,82629,82220,5645,87865,448
2022-04-27,Sonoma,097,501317,85568,84983,2862,87845,487
2022-04-27,Stanislaus,099,539301,118020,117841,17498,135339,1643
2022-04-27,Sutter,101,95872,20602,20627,2156,22783,224
2022-04-27,Tehama,103,63373,12085,12073,2632,14705,201
2022-04-27,Trinity,105,12862,1185,1179,296,1475,20
2022-04-27,Tulare,107,460477,106909,106580,28895,135475,1453
2022-04-27,Tuolumne,109,53932,12737,12684,578,13262,181
2022-04-27,Ventura,111,848112,174947,174425,9439,183864,1480
2022-04-27,Yolo,113,214977,37296,37096,3266,40362,314
2022-04-27,Yuba,115,75493,15933,15902,1231,17133,121
2022-04-26,Alameda,001,1643700,263106,260871,14412,275283,1843
2022-04-26,Alpine,003,1148,124,124,1,125,0
2022-04-26,Amador,005,37829,8585,8518,666,9184,86
2022-04-26,Butte,007,227075,33210,33118,6727,39845,411
2022-04-26,Calaveras,009,45235,7335,7307,364,7671,119
2022-04-26,Colusa,011,21464,3456,3457,1076,4533,21
2022-04-26,Contra Costa,013,1133247,192433,191412,13700,205112,1300
2022-04-26,Del Norte,015,27424,5853,5833,203,6036,50
2022-04-26,El Dorado,017,186661,26982,26898,3247,30145,209
2022-04-26,Fresno,019,978130,232369,231951,23990,255941,2744
2022-04-26,Glenn,021,27897,4993,4993,1625,6618,48
2022-04-26,Humboldt,023,135768,17245,17138,3052,20190,145
2022-04-26,Imperial,025,180216,55576,55480,10928,66408,910
2022-04-26,Inyo,027,18085,4087,4080,509,4589,56
2022-04-26,Kern,029,883053,192427,192157,46511,238668,2271
2022-04-26,Kings,031,150075,51657,51617,3631,55248,444
2022-04-26,Lake,033,64148,10748,10732,907,11639,135
2022-04-26,Lassen,035,31185,8975,8965,889,9854,65
2022-04-26,Los Angeles,037,10098052,2740081,2731988,127220,2859208,31691
2022-04-26,Madera,039,155013,37383,37339,6079,43418,354
2022-04-26,Marin,041,260295,34574,34354,2814,37168,288
2022-04-26,Mariposa,043,17540,2434,2427,205,2632,30
2022-04-26,Mendocino,045,87422,13234,13188,3118,16306,123
2022-04-26,Merced,047,269075,62387,62315,8782,71097,815
2022-04-26,Modoc,049,8938,745,745,253,998,8
2022-04-26,Mono,051,14174,2991,2989,127,3116,6
2022-04-26,Monterey,053,433212,80125,79695,14200,93895,729
2022-04-26,Napa,055,140530,26374,26210,1039,27249,143
2022-04-26,Nevada,057,99092,16113,16080,1237,17317,127
2022-04-26,Orange,059,3164182,552004,550859,42434,593293,6991
2022-04-26,Placer,061,380077,63361,63154,7491,70645,623
2022-04-26,Plumas,063,18699,2986,2934,364,3298,13
2022-04-26,Riverside,065,2383286,594467,593397,28499,621896,6453
2022-04-26,Sacramento,067,1510023,283512,281802,27652,309454,3001
2022-04-26,San Benito,069,59416,12995,12989,523,13512,98
2022-04-26,San Bernardino,071,2135413,569564,568018,25127,593145,7105
2022-04-26,San Diego,073,3302833,761688,759873,53124,812997,5236
2022-04-26,San Francisco,075,870044,130442,129284,8739,138023,857
2022-04-26,San Joaquin,077,732212,167236,166848,9814,176662,2225
2022-04-26,San Luis Obispo,079,281455,53050,52911,3891,56802,476
2022-04-26,San Mateo,081,765935,126151,125018,7416,132434,702
2022-04-26,Santa Barbara,083,443738,86919,86557,4857,91414,685
2022-04-26,Santa Clara,085,1922200,320614,319077,12952,332029,2282
2022-04-26,Santa Cruz,087,273765,49261,48500,2216,50716,262
2022-04-26,Shasta,089,179085,30668,30633,6175,36808,554
2022-04-26,Sierra,091,2930,274,276,49,325,4
2022-04-26,Siskiyou,093,43540,4463,4455,2774,7229,81
2022-04-26,Solano,095,438530,82532,82220,5636,87856,448
2022-04-26,Sonoma,097,501317,85466,84983,2843,87826,487
2022-04-26,Stanislaus,099,539301,117983,117841,17486,135327,1643
2022-04-26,Sutter,101,95872,20592,20627,2156,22783,224
2022-04-26,Tehama,103,63373,12075,12073,2632,14705,201
2022-04-26,Trinity,105,12862,1185,1179,296,1475,20
2022-04-26,Tulare,107,460477,106883,106580,28877,135457,1453
2022-04-26,Tuolumne,109,53932,12720,12684,577,13261,181
2022-04-26,Ventura,111,848112,174836,174425,9429,183854,1480
2022-04-26,Yolo,113,214977,37256,37096,3261,40357,314
2022-04-26,Yuba,115,75493,15930,15902,1231,17133,121
2022-04-25,Alameda,001,1643700,262607,260871,14377,275248,1843
2022-04-25,Alpine,003,1148,124,124,1,125,0
2022-04-25,Amador,005,37829,8582,8518,666,9184,86
2022-04-25,Butte,007,227075,33196,33118,6718,39836,411
2022-04-25,Calaveras,009,45235,7332,7307,364,7671,119
2022-04-25,Colusa,011,21464,3456,3457,1076,4533,21
2022-04-25,Contra Costa,013,1133247,192175,191412,13666,205078,1300
2022-04-25,Del Norte,015,27424,5848,5833,202,6035,50
2022-04-25,El Dorado,017,186661,26961,26898,3245,30143,209
2022-04-25,Fresno,019,978130,232280,231951,23979,255930,2744
2022-04-25,Glenn,021,27897,4992,4993,1625,6618,48
2022-04-25,Humboldt,023,135768,17204,17138,3048,20186,145
2022-04-25,Imperial,025,180216,55556,55480,10921,66401,910
2022-04-25,Inyo,027,18085,4087,4080,509,4589,56
2022-04-25,Kern,029,883053,192382,192157,46492,238649,2271
2022-04-25,Kings,031,150075,51648,51617,3630,55247,444
2022-04-25,Lake,033,64148,10745,10732,907,11639,135
2022-04-25,Lassen,035,31185,8974,8965,889,9854,65
2022-04-25,Los Angeles,037,10098052,2737759,2731988,127080,2859068,31691
2022-04-25,Madera,039,155013,37370,37339,6075,43414,354
2022-04-25,Marin,041,260295,34511,34354,2794,37148,288
2022-04-25,Mariposa,043,17540,2434,2427,205,2632,30
2022-04-25,Mendocino,045,87422,13224,13188,3109,16297,123
2022-04-25,Merced,047,269075,62374,62315,8777,71092,815
2022-04-25,Modoc,049,8938,745,745,253,998,8
2022-04-25,Mono,051,14174,2990,2989,127,3116,6
2022-04-25,Monterey,053,433212,80087,79695,14177,93872,729
2022-04-25,Napa,055,140530,26334,26210,1037,27247,143
2022-04-25,Nevada,057,99092,16107,16080,1236,17316,127
2022-04-25,Orange,059,3164182,551608,550859,42372,593231,6991
2022-04-25,Placer,061,380077,63326,63154,7489,70643,623
2022-04-25,Plumas,063,18699,2984,2934,364,3298,13
2022-04-25,Riverside,065,2383286,594208,593397,28484,621881,6453
2022-04-25,Sacramento,067,1510023,283346,281802,27620,309422,3001
2022-04-25,San Benito,069,59416,12988,12989,522,13511,98
2022-04-25,San Bernardino,071,2135413,569346,568018,25117,593135,7105
2022-04-25,San Diego,073,3302833,761021,759873,53066,812939,5236
2022-04-25,San Francisco,075,870044,130081,129284,8721,138005,857
2022-04-25,San Joaquin,077,732212,167153,166848,9800,176648,2225
2022-04-25,San Luis Obispo,079,281455,53003,52911,3884,56795,476
2022-04-25,San Mateo,081,765935,125882,125018,7393,132411,702
2022-04-25,Santa Barbara,083,443738,86854,86557,4853,91410,685
2022-04-25,Santa Clara,085,1922200,319977,319077,12918,331995,2282
2022-04-25,Santa Cruz,087,273765,49121,48500,2207,50707,262
2022-04-25,Shasta,089,179085,30657,30633,6172,36805,554
2022-04-25,Sierra,091,2930,274,276,49,325,4
2022-04-25,Siskiyou,093,43540,4463,4455,2773,7228,81
2022-04-25,Solano,095,438530,82425,82220,5626,87846,448
2022-04-25,Sonoma,097,501317,85344,84983,2826,87809,487
2022-04-25,Stanislaus,099,539301,117938,117841,17478,135319,1643
2022-04-25,Sutter,101,95872,20589,20627,2156,22783,224
2022-04-25,Tehama,103,63373,12075,12073,2632,14705,201
2022-04-25,Trinity,105,12862,1184,1179,296,1475,20
2022-04-25,Tulare,107,460477,106860,106580,28871,135451,1453
2022-04-25,Tuolumne,109,53932,12709,12684,577,13261,181
2022-04-25,Ventura,111,848112,174726,174425,9423,183848,1480
2022-04-25,Yolo,113,214977,37212,37096,3257,40353,314
2022-04-25,Yuba,115,75493,15920,15902,1230,17132,121
2022-04-24,Alameda,001,1643700,262027,259619,14327,273946,1837
2022-04-24,Alpine,003,1148,124,124,1,125,0
2022-04-24,Amador,005,37829,8573,8509,665,9174,86
2022-04-24,Butte,007,227075,33174,33105,6712,39817,411
2022-04-24,Calaveras,009,45235,7325,7296,362,7658,119
2022-04-24,Colusa,011,21464,3455,3453,1076,4529,21
2022-04-24,Contra Costa,013,1133247,191872,190611,13632,204243,1298
2022-04-24,Del Norte,015,27424,5839,5827,201,6028,50
2022-04-24,El Dorado,017,186661,26944,26837,3243,30080,209
2022-04-24,Fresno,019,978130,232199,231751,23966,255717,2744
2022-04-24,Glenn,021,27897,4992,4989,1623,6612,48
2022-04-24,Humboldt,023,135768,17178,17033,3040,20073,145
2022-04-24,Imperial,025,180216,55539,55434,10913,66347,910
2022-04-24,Inyo,027,18085,4083,4079,508,4587,56
2022-04-24,Kern,029,883053,192333,192012,46474,238486,2267
2022-04-24,Kings,031,150075,51639,51588,3630,55218,444
2022-04-24,Lake,033,64148,10737,10720,904,11624,134
2022-04-24,Lassen,035,31185,8973,8966,889,9855,65
2022-04-24,Los Angeles,037,10098052,2735469,2725630,126946,2852576,31667
2022-04-24,Madera,039,155013,37356,37333,6070,43403,354
2022-04-24,Marin,041,260295,34459,34150,2763,36913,288
2022-04-24,Mariposa,043,17540,2431,2422,205,2627,30
2022-04-24,Mendocino,045,87422,13219,13158,3097,16255,122
2022-04-24,Merced,047,269075,62350,62286,8770,71056,815
2022-04-24,Modoc,049,8938,745,745,253,998,8
2022-04-24,Mono,051,14174,2989,2986,127,3113,6
2022-04-24,Monterey,053,433212,80035,79560,14146,93706,729
2022-04-24,Napa,055,140530,26299,26093,1036,27129,143
2022-04-24,Nevada,057,99092,16091,16052,1232,17284,127
2022-04-24,Orange,059,3164182,551183,549765,42315,592080,6989
2022-04-24,Placer,061,380077,63273,63037,7484,70521,622
2022-04-24,Plumas,063,18699,2982,2934,364,3298,13
2022-04-24,Riverside,065,2383286,593930,592683,28445,621128,6450
2022-04-24,Sacramento,067,1510023,283143,280551,27588,308139,2993
2022-04-24,San Benito,069,59416,12983,12966,522,13488,98
2022-04-24,San Bernardino,071,2135413,569118,566806,25095,591901,7047
2022-04-24,San Diego,073,3302833,760393,758311,53007,811318,5233
2022-04-24,San Francisco,075,870044,129642,128323,8699,137022,857
2022-04-24,San Joaquin,077,732212,167066,166626,9756,176382,2224
2022-04-24,San Luis Obispo,079,281455,52928,52826,3874,56700,476
2022-04-24,San Mateo,081,765935,125575,124106,7365,131471,703
2022-04-24,Santa Barbara,083,443738,86785,86376,4852,91228,685
2022-04-24,Santa Clara,085,1922200,319298,317487,12868,330355,2277
2022-04-24,Santa Cruz,087,273765,49008,48255,2203,50458,261
2022-04-24,Shasta,089,179085,30647,30607,6171,36778,557
2022-04-24,Sierra,091,2930,274,276,49,325,4
2022-04-24,Siskiyou,093,43540,4462,4453,2771,7224,81
2022-04-24,Solano,095,438530,82331,81982,5617,87599,448
2022-04-24,Sonoma,097,501317,85210,84581,2808,87389,486
2022-04-24,Stanislaus,099,539301,117886,117737,17473,135210,1632
2022-04-24,Sutter,101,95872,20579,20605,2153,22758,224
2022-04-24,Tehama,103,63373,12072,12064,2632,14696,201
2022-04-24,Trinity,105,12862,1184,1177,296,1473,20
2022-04-24,Tulare,107,460477,106837,106354,28862,135216,1446
2022-04-24,Tuolumne,109,53932,12697,12664,576,13240,181
2022-04-24,Ventura,111,848112,174613,174091,9411,183502,1479
2022-04-24,Yolo,113,214977,37180,36990,3254,40244,314
2022-04-24,Yuba,115,75493,15915,15888,1229,17117,121
2022-04-23,Alameda,001,1643700,261786,259619,14319,273938,1837
2022-04-23,Alpine,003,1148,124,124,1,125,0
2022-04-23,Amador,005,37829,8567,8509,665,9174,86
2022-04-23,Butte,007,227075,33165,33105,6709,39814,411
2022-04-23,Calaveras,009,45235,7317,7296,362,7658,119
2022-04-23,Colusa,011,21464,3455,3453,1076,4529,21
2022-04-23,Contra Costa,013,1133247,191720,190611,13621,204232,1298
2022-04-23,Del Norte,015,27424,5837,5827,200,6027,50
2022-04-23,El Dorado,017,186661,26934,26837,3243,30080,209
2022-04-23,Fresno,019,978130,232167,231751,23964,255715,2744
2022-04-23,Glenn,021,27897,4992,4989,1623,6612,48
2022-04-23,Humboldt,023,135768,17163,17033,3038,20071,145
2022-04-23,Imperial,025,180216,55530,55434,10911,66345,910
2022-04-23,Inyo,027,18085,4083,4079,507,4586,56
2022-04-23,Kern,029,883053,192308,192012,46459,238471,2267
2022-04-23,Kings,031,150075,51634,51588,3630,55218,444
2022-04-23,Lake,033,64148,10736,10720,904,11624,134
2022-04-23,Lassen,035,31185,8973,8966,889,9855,65
2022-04-23,Los Angeles,037,10098052,2734558,2725630,126870,2852500,31667
2022-04-23,Madera,039,155013,37349,37333,6070,43403,354
2022-04-23,Marin,041,260295,34425,34150,2718,36868,288
2022-04-23,Mariposa,043,17540,2431,2422,205,2627,30
2022-04-23,Mendocino,045,87422,13213,13158,3097,16255,122
2022-04-23,Merced,047,269075,62338,62286,8770,71056,815
2022-04-23,Modoc,049,8938,745,745,253,998,8
2022-04-23,Mono,051,14174,2989,2986,127,3113,6
2022-04-23,Monterey,053,433212,79968,79560,14134,93694,729
2022-04-23,Napa,055,140530,26278,26093,1034,27127,143
2022-04-23,Nevada,057,99092,16085,16052,1230,17282,127
2022-04-23,Orange,059,3164182,550967,549765,42266,592031,6989
2022-04-23,Placer,061,380077,63243,63037,7484,70521,622
2022-04-23,Plumas,063,18699,2982,2934,364,3298,13
2022-04-23,Riverside,065,2383286,593797,592683,28434,621117,6450
2022-04-23,Sacramento,067,1510023,283053,280551,27583,308134,2993
2022-04-23,San Benito,069,59416,12982,12966,522,13488,98
2022-04-23,San Bernardino,071,2135413,569006,566806,25090,591896,7047
2022-04-23,San Diego,073,3302833,760141,758311,52989,811300,5233
2022-04-23,San Francisco,075,870044,129438,128323,8678,137001,857
2022-04-23,San Joaquin,077,732212,167026,166626,9747,176373,2224
2022-04-23,San Luis Obispo,079,281455,52913,52826,3870,56696,476
2022-04-23,San Mateo,081,765935,125416,124106,7356,131462,703
2022-04-23,Santa Barbara,083,443738,86749,86376,4851,91227,685
2022-04-23,Santa Clara,085,1922200,318920,317487,12844,330331,2277
2022-04-23,Santa Cruz,087,273765,48959,48255,2202,50457,261
2022-04-23,Shasta,089,179085,30644,30607,6171,36778,557
2022-04-23,Sierra,091,2930,274,276,49,325,4
2022-04-23,Siskiyou,093,43540,4460,4453,2771,7224,81
2022-04-23,Solano,095,438530,82305,81982,5614,87596,448
2022-04-23,Sonoma,097,501317,85142,84581,2800,87381,486
2022-04-23,Stanislaus,099,539301,117850,117737,17471,135208,1632
2022-04-23,Sutter,101,95872,20573,20605,2153,22758,224
2022-04-23,Tehama,103,63373,12071,12064,2632,14696,201
2022-04-23,Trinity,105,12862,1184,1177,296,1473,20
2022-04-23,Tulare,107,460477,106830,106354,28854,135208,1446
2022-04-23,Tuolumne,109,53932,12693,12664,576,13240,181
2022-04-23,Ventura,111,848112,174553,174091,9406,183497,1479
2022-04-23,Yolo,113,214977,37157,36990,3251,40241,314
2022-04-23,Yuba,115,75493,15913,15888,1229,17117,121
2022-04-22,Alameda,001,1643700,261547,259619,14300,273919,1837
2022-04-22,Alpine,003,1148,124,124,1,125,0
2022-04-22,Amador,005,37829,8566,8509,663,9172,86
2022-04-22,Butte,007,227075,33159,33105,6707,39812,411
2022-04-22,Calaveras,009,45235,7316,7296,362,7658,119
2022-04-22,Colusa,011,21464,3455,3453,1076,4529,21
2022-04-22,Contra Costa,013,1133247,191590,190611,13606,204217,1298
2022-04-22,Del Norte,015,27424,5837,5827,200,6027,50
2022-04-22,El Dorado,017,186661,26920,26837,3238,30075,209
2022-04-22,Fresno,019,978130,232137,231751,23963,255714,2744
2022-04-22,Glenn,021,27897,4991,4989,1623,6612,48
2022-04-22,Humboldt,023,135768,17147,17033,3033,20066,145
2022-04-22,Imperial,025,180216,55525,55434,10911,66345,910
2022-04-22,Inyo,027,18085,4083,4079,506,4585,56
2022-04-22,Kern,029,883053,192287,192012,46456,238468,2267
2022-04-22,Kings,031,150075,51630,51588,3630,55218,444
2022-04-22,Lake,033,64148,10735,10720,904,11624,134
2022-04-22,Lassen,035,31185,8973,8966,889,9855,65
2022-04-22,Los Angeles,037,10098052,2733498,2725630,126815,2852445,31667
2022-04-22,Madera,039,155013,37344,37333,6070,43403,354
2022-04-22,Marin,041,260295,34386,34150,2707,36857,288
2022-04-22,Mariposa,043,17540,2430,2422,205,2627,30
2022-04-22,Mendocino,045,87422,13206,13158,3095,16253,122
2022-04-22,Merced,047,269075,62332,62286,8757,71043,815
2022-04-22,Modoc,049,8938,745,745,253,998,8
2022-04-22,Mono,051,14174,2989,2986,127,3113,6
2022-04-22,Monterey,053,433212,79933,79560,14120,93680,729
2022-04-22,Napa,055,140530,26261,26093,1032,27125,143
2022-04-22,Nevada,057,99092,16085,16052,1230,17282,127
2022-04-22,Orange,059,3164182,550781,549765,42219,591984,6989
2022-04-22,Placer,061,380077,63220,63037,7481,70518,622
2022-04-22,Plumas,063,18699,2982,2934,364,3298,13
2022-04-22,Riverside,065,2383286,593657,592683,28419,621102,6450
2022-04-22,Sacramento,067,1510023,282965,280551,27571,308122,2993
2022-04-22,San Benito,069,59416,12977,12966,522,13488,98
2022-04-22,San Bernardino,071,2135413,568897,566806,25084,591890,7047
2022-04-22,San Diego,073,3302833,759830,758311,52970,811281,5233
2022-04-22,San Francisco,075,870044,129275,128323,8654,136977,857
2022-04-22,San Joaquin,077,732212,166997,166626,9746,176372,2224
2022-04-22,San Luis Obispo,079,281455,52907,52826,3869,56695,476
2022-04-22,San Mateo,081,765935,125254,124106,7342,131448,703
2022-04-22,Santa Barbara,083,443738,86704,86376,4851,91227,685
2022-04-22,Santa Clara,085,1922200,318575,317487,12831,330318,2277
2022-04-22,Santa Cruz,087,273765,48921,48255,2202,50457,261
2022-04-22,Shasta,089,179085,30640,30607,6170,36777,557
2022-04-22,Sierra,091,2930,274,276,48,324,4
2022-04-22,Siskiyou,093,43540,4460,4453,2771,7224,81
2022-04-22,Solano,095,438530,82248,81982,5611,87593,448
2022-04-22,Sonoma,097,501317,85078,84581,2795,87376,486
2022-04-22,Stanislaus,099,539301,117827,117737,17467,135204,1632
2022-04-22,Sutter,101,95872,20567,20605,2153,22758,224
2022-04-22,Tehama,103,63373,12066,12064,2631,14695,201
2022-04-22,Trinity,105,12862,1184,1177,295,1472,20
2022-04-22,Tulare,107,460477,106821,106354,28846,135200,1446
2022-04-22,Tuolumne,109,53932,12686,12664,574,13238,181
2022-04-22,Ventura,111,848112,174481,174091,9401,183492,1479
2022-04-22,Yolo,113,214977,37138,36990,3248,40238,314
2022-04-22,Yuba,115,75493,15911,15888,1228,17116,121
2022-04-21,Alameda,001,1643700,261188,259619,14260,273879,1837
2022-04-21,Alpine,003,1148,124,124,1,125,0
2022-04-21,Amador,005,37829,8563,8509,663,9172,86
2022-04-21,Butte,007,227075,33152,33105,6699,39804,411
2022-04-21,Calaveras,009,45235,7313,7296,362,7658,119
2022-04-21,Colusa,011,21464,3454,3453,1076,4529,21
2022-04-21,Contra Costa,013,1133247,191393,190611,13582,204193,1298
2022-04-21,Del Norte,015,27424,5836,5827,200,6027,50
2022-04-21,El Dorado,017,186661,26905,26837,3237,30074,209
2022-04-21,Fresno,019,978130,232096,231751,23958,255709,2744
2022-04-21,Glenn,021,27897,4991,4989,1622,6611,48
2022-04-21,Humboldt,023,135768,17123,17033,3027,20060,145
2022-04-21,Imperial,025,180216,55516,55434,10911,66345,910
2022-04-21,Inyo,027,18085,4083,4079,506,4585,56
2022-04-21,Kern,029,883053,192253,192012,46443,238455,2267
2022-04-21,Kings,031,150075,51622,51588,3630,55218,444
2022-04-21,Lake,033,64148,10732,10720,903,11623,134
2022-04-21,Lassen,035,31185,8973,8966,889,9855,65
2022-04-21,Los Angeles,037,10098052,2731895,2725630,126710,2852340,31667
2022-04-21,Madera,039,155013,37341,37333,6069,43402,354
2022-04-21,Marin,041,260295,34338,34150,2698,36848,288
2022-04-21,Mariposa,043,17540,2429,2422,205,2627,30
2022-04-21,Mendocino,045,87422,13200,13158,3091,16249,122
2022-04-21,Merced,047,269075,62316,62286,8754,71040,815
2022-04-21,Modoc,049,8938,745,745,253,998,8
2022-04-21,Mono,051,14174,2988,2986,127,3113,6
2022-04-21,Monterey,053,433212,79906,79560,14109,93669,729
2022-04-21,Napa,055,140530,26230,26093,1031,27124,143
2022-04-21,Nevada,057,99092,16082,16052,1230,17282,127
2022-04-21,Orange,059,3164182,550522,549765,42183,591948,6989
2022-04-21,Placer,061,380077,63184,63037,7477,70514,622
2022-04-21,Plumas,063,18699,2982,2934,364,3298,13
2022-04-21,Riverside,065,2383286,593498,592683,28400,621083,6450
2022-04-21,Sacramento,067,1510023,282818,280551,27547,308098,2993
2022-04-21,San Benito,069,59416,12971,12966,522,13488,98
2022-04-21,San Bernardino,071,2135413,568705,566806,25075,591881,7047
2022-04-21,San Diego,073,3302833,759410,758311,52935,811246,5233
2022-04-21,San Francisco,075,870044,129052,128323,8626,136949,857
2022-04-21,San Joaquin,077,732212,166942,166626,9728,176354,2224
2022-04-21,San Luis Obispo,079,281455,52887,52826,3863,56689,476
2022-04-21,San Mateo,081,765935,125050,124106,7322,131428,703
2022-04-21,Santa Barbara,083,443738,86644,86376,4847,91223,685
2022-04-21,Santa Clara,085,1922200,318122,317487,12808,330295,2277
2022-04-21,Santa Cruz,087,273765,48876,48255,2199,50454,261
2022-04-21,Shasta,089,179085,30631,30607,6170,36777,557
2022-04-21,Sierra,091,2930,274,276,48,324,4
2022-04-21,Siskiyou,093,43540,4460,4453,2771,7224,81
2022-04-21,Solano,095,438530,82188,81982,5604,87586,448
2022-04-21,Sonoma,097,501317,84968,84581,2776,87357,486
2022-04-21,Stanislaus,099,539301,117788,117737,17459,135196,1632
2022-04-21,Sutter,101,95872,20558,20605,2152,22757,224
2022-04-21,Tehama,103,63373,12066,12064,2631,14695,201
2022-04-21,Trinity,105,12862,1184,1177,295,1472,20
2022-04-21,Tulare,107,460477,106813,106354,28842,135196,1446
2022-04-21,Tuolumne,109,53932,12681,12664,573,13237,181
2022-04-21,Ventura,111,848112,174396,174091,9398,183489,1479
2022-04-21,Yolo,113,214977,37117,36990,3248,40238,314
2022-04-21,Yuba,115,75493,15909,15888,1228,17116,121
2022-04-20,Alameda,001,1643700,260822,258734,14235,272969,1832
2022-04-20,Alpine,003,1148,124,124,1,125,0
2022-04-20,Amador,005,37829,8561,8494,663,9157,86
2022-04-20,Butte,007,227075,33144,33083,6691,39774,408
2022-04-20,Calaveras,009,45235,7307,7288,361,7649,119
2022-04-20,Colusa,011,21464,3454,3453,1076,4529,21
2022-04-20,Contra Costa,013,1133247,191165,190042,13558,203600,1299
2022-04-20,Del Norte,015,27424,5831,5814,200,6014,50
2022-04-20,El Dorado,017,186661,26890,26821,3233,30054,209
2022-04-20,Fresno,019,978130,232045,231568,23956,255524,2740
2022-04-20,Glenn,021,27897,4990,4988,1619,6607,48
2022-04-20,Humboldt,023,135768,17099,16976,3022,19998,145
2022-04-20,Imperial,025,180216,55509,55405,10908,66313,910
2022-04-20,Inyo,027,18085,4083,4075,505,4580,56
2022-04-20,Kern,029,883053,192214,191915,46426,238341,2262
2022-04-20,Kings,031,150075,51613,51571,3628,55199,445
2022-04-20,Lake,033,64148,10731,10711,903,11614,134
2022-04-20,Lassen,035,31185,8973,8951,889,9840,65
2022-04-20,Los Angeles,037,10098052,2730196,2721699,126603,2848302,31630
2022-04-20,Madera,039,155013,37338,37333,6066,43399,354
2022-04-20,Marin,041,260295,34297,33985,2676,36661,288
2022-04-20,Mariposa,043,17540,2427,2412,205,2617,30
2022-04-20,Mendocino,045,87422,13194,13128,3081,16209,122
2022-04-20,Merced,047,269075,62306,62322,8738,71060,813
2022-04-20,Modoc,049,8938,745,744,253,997,8
2022-04-20,Mono,051,14174,2987,2984,127,3111,6
2022-04-20,Monterey,053,433212,79859,79419,14090,93509,727
2022-04-20,Napa,055,140530,26197,26016,1028,27044,143
2022-04-20,Nevada,057,99092,16072,16034,1228,17262,127
2022-04-20,Orange,059,3164182,550198,549136,42134,591270,6963
2022-04-20,Placer,061,380077,63157,62928,7473,70401,619
2022-04-20,Plumas,063,18699,2982,2932,364,3296,13
2022-04-20,Riverside,065,2383286,593307,592224,28381,620605,6447
2022-04-20,Sacramento,067,1510023,282675,279326,27529,306855,2987
2022-04-20,San Benito,069,59416,12965,12971,522,13493,98
2022-04-20,San Bernardino,071,2135413,568499,565405,25058,590463,6977
2022-04-20,San Diego,073,3302833,758972,757138,52881,810019,5231
2022-04-20,San Francisco,075,870044,128751,127594,8607,136201,854
2022-04-20,San Joaquin,077,732212,166872,166531,9705,176236,2222
2022-04-20,San Luis Obispo,079,281455,52860,52740,3855,56595,476
2022-04-20,San Mateo,081,765935,124831,123279,7290,130569,701
2022-04-20,Santa Barbara,083,443738,86608,86214,4842,91056,685
2022-04-20,Santa Clara,085,1922200,317719,316355,12776,329131,2274
2022-04-20,Santa Cruz,087,273765,48812,47997,2195,50192,261
2022-04-20,Shasta,089,179085,30627,30590,6169,36759,554
2022-04-20,Sierra,091,2930,274,276,48,324,4
2022-04-20,Siskiyou,093,43540,4459,4446,2771,7217,80
2022-04-20,Solano,095,438530,82119,81841,5602,87443,447
2022-04-20,Sonoma,097,501317,84883,84429,2753,87182,485
2022-04-20,Stanislaus,099,539301,117754,117540,17449,134989,1630
2022-04-20,Sutter,101,95872,20551,20632,2152,22784,224
2022-04-20,Tehama,103,63373,12063,12061,2630,14691,199
2022-04-20,Trinity,105,12862,1184,1178,295,1473,20
2022-04-20,Tulare,107,460477,106807,105974,28830,134804,1439
2022-04-20,Tuolumne,109,53932,12676,12648,571,13219,180
2022-04-20,Ventura,111,848112,174311,173904,9394,183298,1475
2022-04-20,Yolo,113,214977,37088,36785,3243,40028,311
2022-04-20,Yuba,115,75493,15906,15868,1226,17094,121
2022-04-19,Alameda,001,1643700,260470,258734,14200,272934,1832
2022-04-19,Alpine,003,1148,124,124,1,125,0
2022-04-19,Amador,005,37829,8557,8494,661,9155,86
2022-04-19,Butte,007,227075,33138,33083,6688,39771,408
2022-04-19,Calaveras,009,45235,7304,7288,361,7649,119
2022-04-19,Colusa,011,21464,3454,3453,1076,4529,21
2022-04-19,Contra Costa,013,1133247,190920,190042,13544,203586,1299
2022-04-19,Del Norte,015,27424,5829,5814,198,6012,50
2022-04-19,El Dorado,017,186661,26875,26821,3230,30051,209
2022-04-19,Fresno,019,978130,231989,231568,23948,255516,2740
2022-04-19,Glenn,021,27897,4989,4988,1618,6606,48
2022-04-19,Humboldt,023,135768,17064,16976,3011,19987,145
2022-04-19,Imperial,025,180216,55502,55405,10904,66309,910
2022-04-19,Inyo,027,18085,4080,4075,505,4580,56
2022-04-19,Kern,029,883053,192178,191915,46414,238329,2262
2022-04-19,Kings,031,150075,51599,51571,3627,55198,445
2022-04-19,Lake,033,64148,10727,10711,903,11614,134
2022-04-19,Lassen,035,31185,8973,8951,889,9840,65
2022-04-19,Los Angeles,037,10098052,2728440,2721699,126479,2848178,31630
2022-04-19,Madera,039,155013,37335,37333,6065,43398,354
2022-04-19,Marin,041,260295,34246,33985,2660,36645,288
2022-04-19,Mariposa,043,17540,2427,2412,205,2617,30
2022-04-19,Mendocino,045,87422,13187,13128,3072,16200,122
2022-04-19,Merced,047,269075,62286,62322,8735,71057,813
2022-04-19,Modoc,049,8938,745,744,253,997,8
2022-04-19,Mono,051,14174,2986,2984,127,3111,6
2022-04-19,Monterey,053,433212,79838,79419,14077,93496,727
2022-04-19,Napa,055,140530,26175,26016,1020,27036,143
2022-04-19,Nevada,057,99092,16067,16034,1226,17260,127
2022-04-19,Orange,059,3164182,549915,549136,42092,591228,6963
2022-04-19,Placer,061,380077,63126,62928,7468,70396,619
2022-04-19,Plumas,063,18699,2982,2932,364,3296,13
2022-04-19,Riverside,065,2383286,593124,592224,28365,620589,6447
2022-04-19,Sacramento,067,1510023,282505,279326,27505,306831,2987
2022-04-19,San Benito,069,59416,12959,12971,522,13493,98
2022-04-19,San Bernardino,071,2135413,568283,565405,25036,590441,6977
2022-04-19,San Diego,073,3302833,758514,757138,52833,809971,5231
2022-04-19,San Francisco,075,870044,128415,127594,8588,136182,854
2022-04-19,San Joaquin,077,732212,166820,166531,9696,176227,2222
2022-04-19,San Luis Obispo,079,281455,52826,52740,3847,56587,476
2022-04-19,San Mateo,081,765935,124597,123279,7271,130550,701
2022-04-19,Santa Barbara,083,443738,86552,86214,4835,91049,685
2022-04-19,Santa Clara,085,1922200,317303,316355,12746,329101,2274
2022-04-19,Santa Cruz,087,273765,48758,47997,2193,50190,261
2022-04-19,Shasta,089,179085,30615,30590,6168,36758,554
2022-04-19,Sierra,091,2930,274,276,48,324,4
2022-04-19,Siskiyou,093,43540,4458,4446,2769,7215,80
2022-04-19,Solano,095,438530,82041,81841,5597,87438,447
2022-04-19,Sonoma,097,501317,84779,84429,2730,87159,485
2022-04-19,Stanislaus,099,539301,117728,117540,17445,134985,1630
2022-04-19,Sutter,101,95872,20551,20632,2152,22784,224
2022-04-19,Tehama,103,63373,12062,12061,2630,14691,199
2022-04-19,Trinity,105,12862,1183,1178,295,1473,20
2022-04-19,Tulare,107,460477,106790,105974,28824,134798,1439
2022-04-19,Tuolumne,109,53932,12673,12648,571,13219,180
2022-04-19,Ventura,111,848112,174218,173904,9391,183295,1475
2022-04-19,Yolo,113,214977,37056,36785,3241,40026,311
2022-04-19,Yuba,115,75493,15899,15868,1226,17094,121
2022-04-18,Alameda,001,1643700,260091,258734,14177,272911,1832
2022-04-18,Alpine,003,1148,124,124,1,125,0
2022-04-18,Amador,005,37829,8556,8494,660,9154,86
2022-04-18,Butte,007,227075,33135,33083,6682,39765,408
2022-04-18,Calaveras,009,45235,7300,7288,360,7648,119
2022-04-18,Colusa,011,21464,3453,3453,1076,4529,21
2022-04-18,Contra Costa,013,1133247,190686,190042,13523,203565,1299
2022-04-18,Del Norte,015,27424,5824,5814,198,6012,50
2022-04-18,El Dorado,017,186661,26859,26821,3227,30048,209
2022-04-18,Fresno,019,978130,231943,231568,23938,255506,2740
2022-04-18,Glenn,021,27897,4988,4988,1617,6605,48
2022-04-18,Humboldt,023,135768,17033,16976,3009,19985,145
2022-04-18,Imperial,025,180216,55490,55405,10902,66307,910
2022-04-18,Inyo,027,18085,4080,4075,505,4580,56
2022-04-18,Kern,029,883053,192134,191915,46402,238317,2262
2022-04-18,Kings,031,150075,51594,51571,3627,55198,445
2022-04-18,Lake,033,64148,10723,10711,903,11614,134
2022-04-18,Lassen,035,31185,8973,8951,889,9840,65
2022-04-18,Los Angeles,037,10098052,2726662,2721699,126366,2848065,31630
2022-04-18,Madera,039,155013,37327,37333,6065,43398,354
2022-04-18,Marin,041,260295,34182,33985,2636,36621,288
2022-04-18,Mariposa,043,17540,2425,2412,205,2617,30
2022-04-18,Mendocino,045,87422,13171,13128,3066,16194,122
2022-04-18,Merced,047,269075,62274,62322,8729,71051,813
2022-04-18,Modoc,049,8938,744,744,253,997,8
2022-04-18,Mono,051,14174,2985,2984,127,3111,6
2022-04-18,Monterey,053,433212,79764,79419,14059,93478,727
2022-04-18,Napa,055,140530,26138,26016,1019,27035,143
2022-04-18,Nevada,057,99092,16057,16034,1224,17258,127
2022-04-18,Orange,059,3164182,549631,549136,42058,591194,6963
2022-04-18,Placer,061,380077,63096,62928,7466,70394,619
2022-04-18,Plumas,063,18699,2982,2932,364,3296,13
2022-04-18,Riverside,065,2383286,592911,592224,28345,620569,6447
2022-04-18,Sacramento,067,1510023,282346,279326,27493,306819,2987
2022-04-18,San Benito,069,59416,12953,12971,522,13493,98
2022-04-18,San Bernardino,071,2135413,568070,565405,25014,590419,6977
2022-04-18,San Diego,073,3302833,758050,757138,52782,809920,5231
2022-04-18,San Francisco,075,870044,128092,127594,8576,136170,854
2022-04-18,San Joaquin,077,732212,166763,166531,9689,176220,2222
2022-04-18,San Luis Obispo,079,281455,52798,52740,3842,56582,476
2022-04-18,San Mateo,081,765935,124366,123279,7253,130532,701
2022-04-18,Santa Barbara,083,443738,86486,86214,4833,91047,685
2022-04-18,Santa Clara,085,1922200,316854,316355,12723,329078,2274
2022-04-18,Santa Cruz,087,273765,48653,47997,2188,50185,261
2022-04-18,Shasta,089,179085,30610,30590,6166,36756,554
2022-04-18,Sierra,091,2930,274,276,48,324,4
2022-04-18,Siskiyou,093,43540,4457,4446,2768,7214,80
2022-04-18,Solano,095,438530,81982,81841,5593,87434,447
2022-04-18,Sonoma,097,501317,84681,84429,2717,87146,485
2022-04-18,Stanislaus,099,539301,117698,117540,17441,134981,1630
2022-04-18,Sutter,101,95872,20549,20632,2149,22781,224
2022-04-18,Tehama,103,63373,12058,12061,2630,14691,199
2022-04-18,Trinity,105,12862,1183,1178,295,1473,20
2022-04-18,Tulare,107,460477,106774,105974,28813,134787,1439
2022-04-18,Tuolumne,109,53932,12665,12648,570,13218,180
2022-04-18,Ventura,111,848112,174124,173904,9384,183288,1475
2022-04-18,Yolo,113,214977,37013,36785,3241,40026,311
2022-04-18,Yuba,115,75493,15891,15868,1223,17091,121
2022-04-17,Alameda,001,1643700,259696,257897,14149,272046,1829
2022-04-17,Alpine,003,1148,124,124,1,125,0
2022-04-17,Amador,005,37829,8550,8491,658,9149,86
2022-04-17,Butte,007,227075,33132,33053,6679,39732,405
2022-04-17,Calaveras,009,45235,7296,7275,358,7633,119
2022-04-17,Colusa,011,21464,3452,3450,1076,4526,21
2022-04-17,Contra Costa,013,1133247,190457,189742,13487,203229,1298
2022-04-17,Del Norte,015,27424,5819,5809,198,6007,50
2022-04-17,El Dorado,017,186661,26848,26796,3226,30022,209
2022-04-17,Fresno,019,978130,231867,231455,23932,255387,2739
2022-04-17,Glenn,021,27897,4988,4991,1617,6608,48
2022-04-17,Humboldt,023,135768,17000,16929,3005,19934,143
2022-04-17,Imperial,025,180216,55482,55371,10900,66271,910
2022-04-17,Inyo,027,18085,4077,4075,505,4580,56
2022-04-17,Kern,029,883053,192099,191866,46387,238253,2258
2022-04-17,Kings,031,150075,51583,51544,3625,55169,445
2022-04-17,Lake,033,64148,10722,10702,903,11605,134
2022-04-17,Lassen,035,31185,8973,8950,889,9839,65
2022-04-17,Los Angeles,037,10098052,2724725,2717479,126247,2843726,31598
2022-04-17,Madera,039,155013,37321,37362,6065,43427,354
2022-04-17,Marin,041,260295,34116,33829,2606,36435,288
2022-04-17,Mariposa,043,17540,2417,2406,205,2611,30
2022-04-17,Mendocino,045,87422,13156,13107,3062,16169,122
2022-04-17,Merced,047,269075,62256,62295,8726,71021,813
2022-04-17,Modoc,049,8938,744,743,253,996,8
2022-04-17,Mono,051,14174,2985,2977,127,3104,6
2022-04-17,Monterey,053,433212,79734,79311,14037,93348,727
2022-04-17,Napa,055,140530,26097,25929,1013,26942,143
2022-04-17,Nevada,057,99092,16042,16014,1222,17236,123
2022-04-17,Orange,059,3164182,549264,548311,42008,590319,6945
2022-04-17,Placer,061,380077,63058,62882,7461,70343,618
2022-04-17,Plumas,063,18699,2982,2929,364,3293,13
2022-04-17,Riverside,065,2383286,592688,591772,28323,620095,6443
2022-04-17,Sacramento,067,1510023,282183,278523,27468,305991,2978
2022-04-17,San Benito,069,59416,12950,12926,521,13447,98
2022-04-17,San Bernardino,071,2135413,567830,564397,24999,589396,6948
2022-04-17,San Diego,073,3302833,757575,756165,52712,808877,5229
2022-04-17,San Francisco,075,870044,127777,126976,8560,135536,854
2022-04-17,San Joaquin,077,732212,166713,166645,9682,176327,2220
2022-04-17,San Luis Obispo,079,281455,52729,52698,3838,56536,476
2022-04-17,San Mateo,081,765935,124128,122652,7238,129890,699
2022-04-17,Santa Barbara,083,443738,86428,86030,4826,90856,684
2022-04-17,Santa Clara,085,1922200,316358,315296,12695,327991,2268
2022-04-17,Santa Cruz,087,273765,48531,47895,2185,50080,261
2022-04-17,Shasta,089,179085,30599,30578,6162,36740,554
2022-04-17,Sierra,091,2930,274,276,48,324,4
2022-04-17,Siskiyou,093,43540,4452,4444,2767,7211,80
2022-04-17,Solano,095,438530,81919,81781,5590,87371,447
2022-04-17,Sonoma,097,501317,84571,84172,2708,86880,485
2022-04-17,Stanislaus,099,539301,117667,117567,17434,135001,1619
2022-04-17,Sutter,101,95872,20543,20621,2148,22769,224
2022-04-17,Tehama,103,63373,12057,12061,2630,14691,199
2022-04-17,Trinity,105,12862,1182,1178,295,1473,20
2022-04-17,Tulare,107,460477,106760,105757,28803,134560,1428
2022-04-17,Tuolumne,109,53932,12659,12640,570,13210,180
2022-04-17,Ventura,111,848112,174028,173665,9373,183038,1474
2022-04-17,Yolo,113,214977,36984,36752,3239,39991,311
2022-04-17,Yuba,115,75493,15883,15857,1223,17080,121
2022-04-16,Alameda,001,1643700,259549,257897,14141,272038,1829
2022-04-16,Alpine,003,1148,124,124,1,125,0
2022-04-16,Amador,005,37829,8549,8491,658,9149,86
2022-04-16,Butte,007,227075,33129,33053,6677,39730,405
2022-04-16,Calaveras,009,45235,7295,7275,358,7633,119
2022-04-16,Colusa,011,21464,3452,3450,1076,4526,21
2022-04-16,Contra Costa,013,1133247,190369,189742,13482,203224,1298
2022-04-16,Del Norte,015,27424,5819,5809,198,6007,50
2022-04-16,El Dorado,017,186661,26837,26796,3226,30022,209
2022-04-16,Fresno,019,978130,231841,231455,23931,255386,2739
2022-04-16,Glenn,021,27897,4988,4991,1617,6608,48
2022-04-16,Humboldt,023,135768,16993,16929,3000,19929,143
2022-04-16,Imperial,025,180216,55476,55371,10899,66270,910
2022-04-16,Inyo,027,18085,4077,4075,505,4580,56
2022-04-16,Kern,029,883053,192089,191866,46375,238241,2258
2022-04-16,Kings,031,150075,51580,51544,3625,55169,445
2022-04-16,Lake,033,64148,10721,10702,903,11605,134
2022-04-16,Lassen,035,31185,8973,8950,889,9839,65
2022-04-16,Los Angeles,037,10098052,2724036,2717479,126198,2843677,31598
2022-04-16,Madera,039,155013,37320,37362,6065,43427,354
2022-04-16,Marin,041,260295,34079,33829,2580,36409,288
2022-04-16,Mariposa,043,17540,2416,2406,205,2611,30
2022-04-16,Mendocino,045,87422,13150,13107,3061,16168,122
2022-04-16,Merced,047,269075,62253,62295,8726,71021,813
2022-04-16,Modoc,049,8938,744,743,253,996,8
2022-04-16,Mono,051,14174,2985,2977,127,3104,6
2022-04-16,Monterey,053,433212,79718,79311,14028,93339,727
2022-04-16,Napa,055,140530,26074,25929,1010,26939,143
2022-04-16,Nevada,057,99092,16039,16014,1221,17235,123
2022-04-16,Orange,059,3164182,549149,548311,41978,590289,6945
2022-04-16,Placer,061,380077,63043,62882,7459,70341,618
2022-04-16,Plumas,063,18699,2980,2929,364,3293,13
2022-04-16,Riverside,065,2383286,592611,591772,28317,620089,6443
2022-04-16,Sacramento,067,1510023,282133,278523,27460,305983,2978
2022-04-16,San Benito,069,59416,12949,12926,521,13447,98
2022-04-16,San Bernardino,071,2135413,567732,564397,24995,589392,6948
2022-04-16,San Diego,073,3302833,757431,756165,52700,808865,5229
2022-04-16,San Francisco,075,870044,127622,126976,8551,135527,854
2022-04-16,San Joaquin,077,732212,166676,166645,9677,176322,2220
2022-04-16,San Luis Obispo,079,281455,52723,52698,3837,56535,476
2022-04-16,San Mateo,081,765935,124032,122652,7233,129885,699
2022-04-16,Santa Barbara,083,443738,86399,86030,4826,90856,684
2022-04-16,Santa Clara,085,1922200,316125,315296,12686,327982,2268
2022-04-16,Santa Cruz,087,273765,48504,47895,2184,50079,261
2022-04-16,Shasta,089,179085,30595,30578,6162,36740,554
2022-04-16,Sierra,091,2930,274,276,48,324,4
2022-04-16,Siskiyou,093,43540,4452,4444,2767,7211,80
2022-04-16,Solano,095,438530,81904,81781,5587,87368,447
2022-04-16,Sonoma,097,501317,84520,84172,2700,86872,485
2022-04-16,Stanislaus,099,539301,117647,117567,17429,134996,1619
2022-04-16,Sutter,101,95872,20540,20621,2148,22769,224
2022-04-16,Tehama,103,63373,12056,12061,2630,14691,199
2022-04-16,Trinity,105,12862,1182,1178,295,1473,20
2022-04-16,Tulare,107,460477,106749,105757,28800,134557,1428
2022-04-16,Tuolumne,109,53932,12658,12640,570,13210,180
2022-04-16,Ventura,111,848112,174001,173665,9371,183036,1474
2022-04-16,Yolo,113,214977,36975,36752,3238,39990,311
2022-04-16,Yuba,115,75493,15881,15857,1223,17080,121
2022-04-15,Alameda,001,1643700,259367,257897,14133,272030,1829
2022-04-15,Alpine,003,1148,124,124,1,125,0
2022-04-15,Amador,005,37829,8548,8491,657,9148,86
2022-04-15,Butte,007,227075,33127,33053,6674,39727,405
2022-04-15,Calaveras,009,45235,7293,7275,358,7633,119
2022-04-15,Colusa,011,21464,3452,3450,1076,4526,21
2022-04-15,Contra Costa,013,1133247,190255,189742,13478,203220,1298
2022-04-15,Del Norte,015,27424,5819,5809,198,6007,50
2022-04-15,El Dorado,017,186661,26823,26796,3225,30021,209
2022-04-15,Fresno,019,978130,231812,231455,23931,255386,2739
2022-04-15,Glenn,021,27897,4988,4991,1617,6608,48
2022-04-15,Humboldt,023,135768,16981,16929,2999,19928,143
2022-04-15,Imperial,025,180216,55474,55371,10899,66270,910
2022-04-15,Inyo,027,18085,4077,4075,504,4579,56
2022-04-15,Kern,029,883053,192075,191866,46367,238233,2258
2022-04-15,Kings,031,150075,51576,51544,3625,55169,445
2022-04-15,Lake,033,64148,10716,10702,903,11605,134
2022-04-15,Lassen,035,31185,8973,8950,889,9839,65
2022-04-15,Los Angeles,037,10098052,2723277,2717479,126131,2843610,31598
2022-04-15,Madera,039,155013,37318,37362,6065,43427,354
2022-04-15,Marin,041,260295,34045,33829,2559,36388,288
2022-04-15,Mariposa,043,17540,2415,2406,205,2611,30
2022-04-15,Mendocino,045,87422,13144,13107,3060,16167,122
2022-04-15,Merced,047,269075,62249,62295,8726,71021,813
2022-04-15,Modoc,049,8938,744,743,253,996,8
2022-04-15,Mono,051,14174,2981,2977,127,3104,6
2022-04-15,Monterey,053,433212,79693,79311,14021,93332,727
2022-04-15,Napa,055,140530,26057,25929,1008,26937,143
2022-04-15,Nevada,057,99092,16037,16014,1220,17234,123
2022-04-15,Orange,059,3164182,549031,548311,41950,590261,6945
2022-04-15,Placer,061,380077,63029,62882,7458,70340,618
2022-04-15,Plumas,063,18699,2980,2929,364,3293,13
2022-04-15,Riverside,065,2383286,592512,591772,28312,620084,6443
2022-04-15,Sacramento,067,1510023,282055,278523,27456,305979,2978
2022-04-15,San Benito,069,59416,12947,12926,520,13446,98
2022-04-15,San Bernardino,071,2135413,567652,564397,24992,589389,6948
2022-04-15,San Diego,073,3302833,757240,756165,52688,808853,5229
2022-04-15,San Francisco,075,870044,127473,126976,8538,135514,854
2022-04-15,San Joaquin,077,732212,166653,166645,9674,176319,2220
2022-04-15,San Luis Obispo,079,281455,52715,52698,3837,56535,476
2022-04-15,San Mateo,081,765935,123899,122652,7223,129875,699
2022-04-15,Santa Barbara,083,443738,86365,86030,4825,90855,684
2022-04-15,Santa Clara,085,1922200,315835,315296,12678,327974,2268
2022-04-15,Santa Cruz,087,273765,48475,47895,2183,50078,261
2022-04-15,Shasta,089,179085,30586,30578,6162,36740,554
2022-04-15,Sierra,091,2930,274,276,48,324,4
2022-04-15,Siskiyou,093,43540,4450,4444,2767,7211,80
2022-04-15,Solano,095,438530,81879,81781,5587,87368,447
2022-04-15,Sonoma,097,501317,84471,84172,2690,86862,485
2022-04-15,Stanislaus,099,539301,117628,117567,17427,134994,1619
2022-04-15,Sutter,101,95872,20537,20621,2148,22769,224
2022-04-15,Tehama,103,63373,12056,12061,2630,14691,199
2022-04-15,Trinity,105,12862,1182,1178,295,1473,20
2022-04-15,Tulare,107,460477,106743,105757,28795,134552,1428
2022-04-15,Tuolumne,109,53932,12656,12640,569,13209,180
2022-04-15,Ventura,111,848112,173972,173665,9365,183030,1474
2022-04-15,Yolo,113,214977,36965,36752,3238,39990,311
2022-04-15,Yuba,115,75493,15878,15857,1223,17080,121
2022-04-14,Alameda,001,1643700,259103,257897,14122,272019,1829
2022-04-14,Alpine,003,1148,124,124,1,125,0
2022-04-14,Amador,005,37829,8548,8491,657,9148,86
2022-04-14,Butte,007,227075,33122,33053,6668,39721,405
2022-04-14,Calaveras,009,45235,7292,7275,358,7633,119
2022-04-14,Colusa,011,21464,3452,3450,1076,4526,21
2022-04-14,Contra Costa,013,1133247,190099,189742,13468,203210,1298
2022-04-14,Del Norte,015,27424,5817,5809,198,6007,50
2022-04-14,El Dorado,017,186661,26820,26796,3223,30019,209
2022-04-14,Fresno,019,978130,231786,231455,23930,255385,2739
2022-04-14,Glenn,021,27897,4987,4991,1615,6606,48
2022-04-14,Humboldt,023,135768,16968,16929,2997,19926,143
2022-04-14,Imperial,025,180216,55464,55371,10899,66270,910
2022-04-14,Inyo,027,18085,4077,4075,503,4578,56
2022-04-14,Kern,029,883053,192055,191866,46360,238226,2258
2022-04-14,Kings,031,150075,51568,51544,3625,55169,445
2022-04-14,Lake,033,64148,10714,10702,903,11605,134
2022-04-14,Lassen,035,31185,8973,8950,888,9838,65
2022-04-14,Los Angeles,037,10098052,2722204,2717479,126038,2843517,31598
2022-04-14,Madera,039,155013,37316,37362,6065,43427,354
2022-04-14,Marin,041,260295,34010,33829,2532,36361,288
2022-04-14,Mariposa,043,17540,2414,2406,205,2611,30
2022-04-14,Mendocino,045,87422,13139,13107,3060,16167,122
2022-04-14,Merced,047,269075,62244,62295,8726,71021,813
2022-04-14,Modoc,049,8938,743,743,253,996,8
2022-04-14,Mono,051,14174,2981,2977,125,3102,6
2022-04-14,Monterey,053,433212,79668,79311,14015,93326,727
2022-04-14,Napa,055,140530,26034,25929,1007,26936,143
2022-04-14,Nevada,057,99092,16030,16014,1219,17233,123
2022-04-14,Orange,059,3164182,548844,548311,41922,590233,6945
2022-04-14,Placer,061,380077,63012,62882,7453,70335,618
2022-04-14,Plumas,063,18699,2980,2929,364,3293,13
2022-04-14,Riverside,065,2383286,592396,591772,28302,620074,6443
2022-04-14,Sacramento,067,1510023,281933,278523,27442,305965,2978
2022-04-14,San Benito,069,59416,12942,12926,520,13446,98
2022-04-14,San Bernardino,071,2135413,567477,564397,24988,589385,6948
2022-04-14,San Diego,073,3302833,756966,756165,52655,808820,5229
2022-04-14,San Francisco,075,870044,127266,126976,8525,135501,854
2022-04-14,San Joaquin,077,732212,166625,166645,9671,176316,2220
2022-04-14,San Luis Obispo,079,281455,52699,52698,3834,56532,476
2022-04-14,San Mateo,081,765935,123743,122652,7202,129854,699
2022-04-14,Santa Barbara,083,443738,86319,86030,4824,90854,684
2022-04-14,Santa Clara,085,1922200,315535,315296,12669,327965,2268
2022-04-14,Santa Cruz,087,273765,48445,47895,2182,50077,261
2022-04-14,Shasta,089,179085,30584,30578,6161,36739,554
2022-04-14,Sierra,091,2930,274,276,48,324,4
2022-04-14,Siskiyou,093,43540,4450,4444,2766,7210,80
2022-04-14,Solano,095,438530,81843,81781,5585,87366,447
2022-04-14,Sonoma,097,501317,84382,84172,2685,86857,485
2022-04-14,Stanislaus,099,539301,117610,117567,17424,134991,1619
2022-04-14,Sutter,101,95872,20535,20621,2139,22760,224
2022-04-14,Tehama,103,63373,12055,12061,2629,14690,199
2022-04-14,Trinity,105,12862,1182,1178,295,1473,20
2022-04-14,Tulare,107,460477,106729,105757,28791,134548,1428
2022-04-14,Tuolumne,109,53932,12652,12640,569,13209,180
2022-04-14,Ventura,111,848112,173921,173665,9358,183023,1474
2022-04-14,Yolo,113,214977,36954,36752,3234,39986,311
2022-04-14,Yuba,115,75493,15875,15857,1223,17080,121
2022-04-13,Alameda,001,1643700,258852,257440,14104,271544,1833
2022-04-13,Alpine,003,1148,124,124,1,125,0
2022-04-13,Amador,005,37829,8546,8490,657,9147,86
2022-04-13,Butte,007,227075,33114,33044,6668,39712,402
2022-04-13,Calaveras,009,45235,7291,7270,358,7628,119
2022-04-13,Colusa,011,21464,3452,3451,1076,4527,21
2022-04-13,Contra Costa,013,1133247,189971,189471,13454,202925,1298
2022-04-13,Del Norte,015,27424,5815,5812,198,6010,50
2022-04-13,El Dorado,017,186661,26816,26794,3223,30017,208
2022-04-13,Fresno,019,978130,231754,231325,23918,255243,2738
2022-04-13,Glenn,021,27897,4986,4989,1615,6604,48
2022-04-13,Humboldt,023,135768,16956,16922,2996,19918,143
2022-04-13,Imperial,025,180216,55452,55353,10895,66248,910
2022-04-13,Inyo,027,18085,4077,4074,501,4575,56
2022-04-13,Kern,029,883053,192031,191859,46354,238213,2249
2022-04-13,Kings,031,150075,51562,51535,3625,55160,443
2022-04-13,Lake,033,64148,10712,10695,903,11598,134
2022-04-13,Lassen,035,31185,8972,8949,888,9837,65
2022-04-13,Los Angeles,037,10098052,2720950,2715722,125966,2841688,31578
2022-04-13,Madera,039,155013,37313,37361,6064,43425,354
2022-04-13,Marin,041,260295,33971,33747,2502,36249,288
2022-04-13,Mariposa,043,17540,2408,2402,205,2607,29
2022-04-13,Mendocino,045,87422,13130,13101,3058,16159,120
2022-04-13,Merced,047,269075,62233,62276,8725,71001,811
2022-04-13,Modoc,049,8938,743,743,253,996,8
2022-04-13,Mono,051,14174,2979,2971,125,3096,6
2022-04-13,Monterey,053,433212,79654,79179,14005,93184,727
2022-04-13,Napa,055,140530,26018,25892,1004,26896,143
2022-04-13,Nevada,057,99092,16024,16002,1219,17221,123
2022-04-13,Orange,059,3164182,548642,547783,41895,589678,6935
2022-04-13,Placer,061,380077,62984,62851,7448,70299,615
2022-04-13,Plumas,063,18699,2979,2923,364,3287,13
2022-04-13,Riverside,065,2383286,592266,591659,28294,619953,6437
2022-04-13,Sacramento,067,1510023,281844,277866,27439,305305,2974
2022-04-13,San Benito,069,59416,12936,12927,520,13447,98
2022-04-13,San Bernardino,071,2135413,567335,563709,24981,588690,6905
2022-04-13,San Diego,073,3302833,756684,755584,52626,808210,5223
2022-04-13,San Francisco,075,870044,127093,126608,8509,135117,850
2022-04-13,San Joaquin,077,732212,166591,166654,9668,176322,2219
2022-04-13,San Luis Obispo,079,281455,52675,52660,3834,56494,476
2022-04-13,San Mateo,081,765935,123593,122167,7180,129347,699
2022-04-13,Santa Barbara,083,443738,86280,85938,4820,90758,684
2022-04-13,Santa Clara,085,1922200,315268,314863,12653,327516,2267
2022-04-13,Santa Cruz,087,273765,48391,47765,2181,49946,260
2022-04-13,Shasta,089,179085,30582,30569,6161,36730,551
2022-04-13,Sierra,091,2930,274,276,48,324,4
2022-04-13,Siskiyou,093,43540,4449,4444,2765,7209,80
2022-04-13,Solano,095,438530,81805,81843,5583,87426,448
2022-04-13,Sonoma,097,501317,84316,84033,2670,86703,485
2022-04-13,Stanislaus,099,539301,117593,117573,17421,134994,1577
2022-04-13,Sutter,101,95872,20531,20610,2139,22749,223
2022-04-13,Tehama,103,63373,12054,12062,2628,14690,200
2022-04-13,Trinity,105,12862,1182,1177,295,1472,20
2022-04-13,Tulare,107,460477,106722,105519,28786,134305,1426
2022-04-13,Tuolumne,109,53932,12646,12639,569,13208,180
2022-04-13,Ventura,111,848112,173865,173558,9354,182912,1474
2022-04-13,Yolo,113,214977,36933,36684,3232,39916,311
2022-04-13,Yuba,115,75493,15871,15851,1223,17074,121
2022-04-12,Alameda,001,1643700,258607,257440,14094,271534,1833
2022-04-12,Alpine,003,1148,124,124,1,125,0
2022-04-12,Amador,005,37829,8545,8490,657,9147,86
2022-04-12,Butte,007,227075,33102,33044,6663,39707,402
2022-04-12,Calaveras,009,45235,7286,7270,357,7627,119
2022-04-12,Colusa,011,21464,3452,3451,1076,4527,21
2022-04-12,Contra Costa,013,1133247,189812,189471,13440,202911,1298
2022-04-12,Del Norte,015,27424,5812,5812,198,6010,50
2022-04-12,El Dorado,017,186661,26804,26794,3223,30017,208
2022-04-12,Fresno,019,978130,231724,231325,23911,255236,2738
2022-04-12,Glenn,021,27897,4986,4989,1615,6604,48
2022-04-12,Humboldt,023,135768,16948,16922,2995,19917,143
2022-04-12,Imperial,025,180216,55447,55353,10891,66244,910
2022-04-12,Inyo,027,18085,4077,4074,500,4574,56
2022-04-12,Kern,029,883053,192012,191859,46345,238204,2249
2022-04-12,Kings,031,150075,51554,51535,3623,55158,443
2022-04-12,Lake,033,64148,10708,10695,902,11597,134
2022-04-12,Lassen,035,31185,8972,8949,888,9837,65
2022-04-12,Los Angeles,037,10098052,2719717,2715722,125866,2841588,31578
2022-04-12,Madera,039,155013,37312,37361,6064,43425,354
2022-04-12,Marin,041,260295,33926,33747,2475,36222,288
2022-04-12,Mariposa,043,17540,2408,2402,205,2607,29
2022-04-12,Mendocino,045,87422,13121,13101,3053,16154,120
2022-04-12,Merced,047,269075,62219,62276,8722,70998,811
2022-04-12,Modoc,049,8938,743,743,253,996,8
2022-04-12,Mono,051,14174,2979,2971,125,3096,6
2022-04-12,Monterey,053,433212,79630,79179,13999,93178,727
2022-04-12,Napa,055,140530,25995,25892,994,26886,143
2022-04-12,Nevada,057,99092,16021,16002,1218,17220,123
2022-04-12,Orange,059,3164182,548390,547783,41860,589643,6935
2022-04-12,Placer,061,380077,62961,62851,7442,70293,615
2022-04-12,Plumas,063,18699,2977,2923,364,3287,13
2022-04-12,Riverside,065,2383286,592121,591659,28271,619930,6437
2022-04-12,Sacramento,067,1510023,281726,277866,27437,305303,2974
2022-04-12,San Benito,069,59416,12932,12927,519,13446,98
2022-04-12,San Bernardino,071,2135413,567163,563709,24976,588685,6905
2022-04-12,San Diego,073,3302833,756355,755584,52586,808170,5223
2022-04-12,San Francisco,075,870044,126882,126608,8494,135102,850
2022-04-12,San Joaquin,077,732212,166560,166654,9666,176320,2219
2022-04-12,San Luis Obispo,079,281455,52642,52660,3829,56489,476
2022-04-12,San Mateo,081,765935,123434,122167,7153,129320,699
2022-04-12,Santa Barbara,083,443738,86229,85938,4817,90755,684
2022-04-12,Santa Clara,085,1922200,314974,314863,12645,327508,2267
2022-04-12,Santa Cruz,087,273765,48313,47765,2179,49944,260
2022-04-12,Shasta,089,179085,30582,30569,6160,36729,551
2022-04-12,Sierra,091,2930,274,276,48,324,4
2022-04-12,Siskiyou,093,43540,4449,4444,2763,7207,80
2022-04-12,Solano,095,438530,81769,81843,5581,87424,448
2022-04-12,Sonoma,097,501317,84258,84033,2664,86697,485
2022-04-12,Stanislaus,099,539301,117574,117573,17415,134988,1577
2022-04-12,Sutter,101,95872,20528,20610,2139,22749,223
2022-04-12,Tehama,103,63373,12053,12062,2628,14690,200
2022-04-12,Trinity,105,12862,1182,1177,295,1472,20
2022-04-12,Tulare,107,460477,106708,105519,28782,134301,1426
2022-04-12,Tuolumne,109,53932,12644,12639,567,13206,180
2022-04-12,Ventura,111,848112,173819,173558,9350,182908,1474
2022-04-12,Yolo,113,214977,36919,36684,3225,39909,311
2022-04-12,Yuba,115,75493,15866,15851,1223,17074,121
2022-04-11,Alameda,001,1643700,258319,256649,14077,270726,1826
2022-04-11,Alpine,003,1148,124,124,1,125,0
2022-04-11,Amador,005,37829,8544,8489,657,9146,86
2022-04-11,Butte,007,227075,33089,33031,6660,39691,399
2022-04-11,Calaveras,009,45235,7283,7260,357,7617,119
2022-04-11,Colusa,011,21464,3450,3449,1076,4525,21
2022-04-11,Contra Costa,013,1133247,189641,189154,13424,202578,1296
2022-04-11,Del Norte,015,27424,5811,5811,198,6009,50
2022-04-11,El Dorado,017,186661,26792,26757,3222,29979,207
2022-04-11,Fresno,019,978130,231704,231090,23910,255000,2731
2022-04-11,Glenn,021,27897,4985,4988,1614,6602,47
2022-04-11,Humboldt,023,135768,16932,16913,2995,19908,141
2022-04-11,Imperial,025,180216,55442,55267,10889,66156,910
2022-04-11,Inyo,027,18085,4077,4071,500,4571,56
2022-04-11,Kern,029,883053,191988,191542,46341,237883,2244
2022-04-11,Kings,031,150075,51550,51519,3623,55142,443
2022-04-11,Lake,033,64148,10707,10690,901,11591,134
2022-04-11,Lassen,035,31185,8972,8948,888,9836,65
2022-04-11,Los Angeles,037,10098052,2718478,2709735,125794,2835529,31509
2022-04-11,Madera,039,155013,37305,37356,6064,43420,354
2022-04-11,Marin,041,260295,33870,33648,2456,36104,288
2022-04-11,Mariposa,043,17540,2407,2394,205,2599,29
2022-04-11,Mendocino,045,87422,13117,13087,3051,16138,120
2022-04-11,Merced,047,269075,62209,62231,8720,70951,811
2022-04-11,Modoc,049,8938,743,743,253,996,8
2022-04-11,Mono,051,14174,2978,2967,124,3091,6
2022-04-11,Monterey,053,433212,79611,79103,13988,93091,727
2022-04-11,Napa,055,140530,25979,25824,992,26816,144
2022-04-11,Nevada,057,99092,16017,15976,1218,17194,123
2022-04-11,Orange,059,3164182,548187,546983,41826,588809,6912
2022-04-11,Placer,061,380077,62939,62831,7439,70270,616
2022-04-11,Plumas,063,18699,2975,2887,364,3251,13
2022-04-11,Riverside,065,2383286,591993,591268,28253,619521,6429
2022-04-11,Sacramento,067,1510023,281626,277125,27434,304559,2972
2022-04-11,San Benito,069,59416,12930,12917,519,13436,98
2022-04-11,San Bernardino,071,2135413,567008,562571,24967,587538,6892
2022-04-11,San Diego,073,3302833,756030,754281,52551,806832,5210
2022-04-11,San Francisco,075,870044,126653,125963,8480,134443,844
2022-04-11,San Joaquin,077,732212,166522,166547,9660,176207,2212
2022-04-11,San Luis Obispo,079,281455,52619,52609,3828,56437,476
2022-04-11,San Mateo,081,765935,123246,121514,7144,128658,698
2022-04-11,Santa Barbara,083,443738,86183,85754,4812,90566,680
2022-04-11,Santa Clara,085,1922200,314626,313965,12629,326594,2266
2022-04-11,Santa Cruz,087,273765,48218,47624,2170,49794,259
2022-04-11,Shasta,089,179085,30577,30586,6159,36745,549
2022-04-11,Sierra,091,2930,274,272,48,320,4
2022-04-11,Siskiyou,093,43540,4449,4444,2761,7205,80
2022-04-11,Solano,095,438530,81745,81886,5580,87466,448
2022-04-11,Sonoma,097,501317,84186,83600,2656,86256,485
2022-04-11,Stanislaus,099,539301,117539,117528,17407,134935,1578
2022-04-11,Sutter,101,95872,20525,20591,2139,22730,223
2022-04-11,Tehama,103,63373,12052,12059,2628,14687,201
2022-04-11,Trinity,105,12862,1182,1177,295,1472,20
2022-04-11,Tulare,107,460477,106697,105278,28774,134052,1415
2022-04-11,Tuolumne,109,53932,12641,12632,567,13199,180
2022-04-11,Ventura,111,848112,173761,173343,9349,182692,1467
2022-04-11,Yolo,113,214977,36900,36587,3222,39809,312
2022-04-11,Yuba,115,75493,15863,15848,1222,17070,121
2022-04-10,Alameda,001,1643700,257983,256649,14064,270713,1826
2022-04-10,Alpine,003,1148,124,124,1,125,0
2022-04-10,Amador,005,37829,8542,8489,657,9146,86
2022-04-10,Butte,007,227075,33084,33031,6657,39688,399
2022-04-10,Calaveras,009,45235,7280,7260,357,7617,119
2022-04-10,Colusa,011,21464,3449,3449,1076,4525,21
2022-04-10,Contra Costa,013,1133247,189479,189154,13407,202561,1296
2022-04-10,Del Norte,015,27424,5808,5811,198,6009,50
2022-04-10,El Dorado,017,186661,26786,26757,3220,29977,207
2022-04-10,Fresno,019,978130,231666,231090,23908,254998,2731
2022-04-10,Glenn,021,27897,4985,4988,1614,6602,47
2022-04-10,Humboldt,023,135768,16922,16913,2994,19907,141
2022-04-10,Imperial,025,180216,55439,55267,10885,66152,910
2022-04-10,Inyo,027,18085,4077,4071,498,4569,56
2022-04-10,Kern,029,883053,191969,191542,46336,237878,2244
2022-04-10,Kings,031,150075,51548,51519,3623,55142,443
2022-04-10,Lake,033,64148,10703,10690,899,11589,134
2022-04-10,Lassen,035,31185,8971,8948,888,9836,65
2022-04-10,Los Angeles,037,10098052,2717185,2709735,125702,2835437,31509
2022-04-10,Madera,039,155013,37300,37356,6063,43419,354
2022-04-10,Marin,041,260295,33830,33648,2428,36076,288
2022-04-10,Mariposa,043,17540,2405,2394,205,2599,29
2022-04-10,Mendocino,045,87422,13109,13087,3050,16137,120
2022-04-10,Merced,047,269075,62197,62231,8717,70948,811
2022-04-10,Modoc,049,8938,743,743,253,996,8
2022-04-10,Mono,051,14174,2973,2967,124,3091,6
2022-04-10,Monterey,053,433212,79596,79103,13978,93081,727
2022-04-10,Napa,055,140530,25957,25824,990,26814,144
2022-04-10,Nevada,057,99092,16000,15976,1218,17194,123
2022-04-10,Orange,059,3164182,547935,546983,41786,588769,6912
2022-04-10,Placer,061,380077,62909,62831,7438,70269,616
2022-04-10,Plumas,063,18699,2973,2887,364,3251,13
2022-04-10,Riverside,065,2383286,591856,591268,28242,619510,6429
2022-04-10,Sacramento,067,1510023,281531,277125,27423,304548,2972
2022-04-10,San Benito,069,59416,12927,12917,519,13436,98
2022-04-10,San Bernardino,071,2135413,566775,562571,24958,587529,6892
2022-04-10,San Diego,073,3302833,755707,754281,52509,806790,5210
2022-04-10,San Francisco,075,870044,126415,125963,8464,134427,844
2022-04-10,San Joaquin,077,732212,166473,166547,9653,176200,2212
2022-04-10,San Luis Obispo,079,281455,52585,52609,3825,56434,476
2022-04-10,San Mateo,081,765935,123078,121514,7132,128646,698
2022-04-10,Santa Barbara,083,443738,86100,85754,4803,90557,680
2022-04-10,Santa Clara,085,1922200,314294,313965,12614,326579,2266
2022-04-10,Santa Cruz,087,273765,48129,47624,2167,49791,259
2022-04-10,Shasta,089,179085,30570,30586,6159,36745,549
2022-04-10,Sierra,091,2930,274,272,48,320,4
2022-04-10,Siskiyou,093,43540,4449,4444,2759,7203,80
2022-04-10,Solano,095,438530,81700,81886,5576,87462,448
2022-04-10,Sonoma,097,501317,84085,83600,2651,86251,485
2022-04-10,Stanislaus,099,539301,117515,117528,17400,134928,1578
2022-04-10,Sutter,101,95872,20521,20591,2135,22726,223
2022-04-10,Tehama,103,63373,12050,12059,2628,14687,201
2022-04-10,Trinity,105,12862,1182,1177,295,1472,20
2022-04-10,Tulare,107,460477,106681,105278,28769,134047,1415
2022-04-10,Tuolumne,109,53932,12634,12632,567,13199,180
2022-04-10,Ventura,111,848112,173683,173343,9346,182689,1467
2022-04-10,Yolo,113,214977,36881,36587,3217,39804,312
2022-04-10,Yuba,115,75493,15862,15848,1222,17070,121
2022-04-09,Alameda,001,1643700,257810,256649,14059,270708,1826
2022-04-09,Alpine,003,1148,124,124,1,125,0
2022-04-09,Amador,005,37829,8542,8489,656,9145,86
2022-04-09,Butte,007,227075,33081,33031,6656,39687,399
2022-04-09,Calaveras,009,45235,7279,7260,357,7617,119
2022-04-09,Colusa,011,21464,3448,3449,1076,4525,21
2022-04-09,Contra Costa,013,1133247,189385,189154,13399,202553,1296
2022-04-09,Del Norte,015,27424,5807,5811,198,6009,50
2022-04-09,El Dorado,017,186661,26779,26757,3220,29977,207
2022-04-09,Fresno,019,978130,231645,231090,23908,254998,2731
2022-04-09,Glenn,021,27897,4985,4988,1614,6602,47
2022-04-09,Humboldt,023,135768,16915,16913,2994,19907,141
2022-04-09,Imperial,025,180216,55435,55267,10884,66151,910
2022-04-09,Inyo,027,18085,4077,4071,498,4569,56
2022-04-09,Kern,029,883053,191958,191542,46331,237873,2244
2022-04-09,Kings,031,150075,51542,51519,3623,55142,443
2022-04-09,Lake,033,64148,10702,10690,899,11589,134
2022-04-09,Lassen,035,31185,8971,8948,888,9836,65
2022-04-09,Los Angeles,037,10098052,2716516,2709735,125633,2835368,31509
2022-04-09,Madera,039,155013,37297,37356,6063,43419,354
2022-04-09,Marin,041,260295,33796,33648,2385,36033,288
2022-04-09,Mariposa,043,17540,2405,2394,205,2599,29
2022-04-09,Mendocino,045,87422,13108,13087,3050,16137,120
2022-04-09,Merced,047,269075,62180,62231,8715,70946,811
2022-04-09,Modoc,049,8938,743,743,253,996,8
2022-04-09,Mono,051,14174,2972,2967,124,3091,6
2022-04-09,Monterey,053,433212,79587,79103,13974,93077,727
2022-04-09,Napa,055,140530,25933,25824,990,26814,144
2022-04-09,Nevada,057,99092,15997,15976,1218,17194,123
2022-04-09,Orange,059,3164182,547814,546983,41766,588749,6912
2022-04-09,Placer,061,380077,62893,62831,7436,70267,616
2022-04-09,Plumas,063,18699,2973,2887,364,3251,13
2022-04-09,Riverside,065,2383286,591767,591268,28233,619501,6429
2022-04-09,Sacramento,067,1510023,281484,277125,27421,304546,2972
2022-04-09,San Benito,069,59416,12926,12917,519,13436,98
2022-04-09,San Bernardino,071,2135413,566713,562571,24953,587524,6892
2022-04-09,San Diego,073,3302833,755558,754281,52493,806774,5210
2022-04-09,San Francisco,075,870044,126296,125963,8457,134420,844
2022-04-09,San Joaquin,077,732212,166459,166547,9650,176197,2212
2022-04-09,San Luis Obispo,079,281455,52585,52609,3822,56431,476
2022-04-09,San Mateo,081,765935,122986,121514,7126,128640,698
2022-04-09,Santa Barbara,083,443738,86069,85754,4803,90557,680
2022-04-09,Santa Clara,085,1922200,314101,313965,12609,326574,2266
2022-04-09,Santa Cruz,087,273765,48096,47624,2165,49789,259
2022-04-09,Shasta,089,179085,30568,30586,6159,36745,549
2022-04-09,Sierra,091,2930,274,272,48,320,4
2022-04-09,Siskiyou,093,43540,4448,4444,2758,7202,80
2022-04-09,Solano,095,438530,81682,81886,5575,87461,448
2022-04-09,Sonoma,097,501317,84047,83600,2647,86247,485
2022-04-09,Stanislaus,099,539301,117503,117528,17398,134926,1578
2022-04-09,Sutter,101,95872,20520,20591,2135,22726,223
2022-04-09,Tehama,103,63373,12050,12059,2628,14687,201
2022-04-09,Trinity,105,12862,1182,1177,295,1472,20
2022-04-09,Tulare,107,460477,106678,105278,28767,134045,1415
2022-04-09,Tuolumne,109,53932,12632,12632,567,13199,180
2022-04-09,Ventura,111,848112,173648,173343,9343,182686,1467
2022-04-09,Yolo,113,214977,36864,36587,3217,39804,312
2022-04-09,Yuba,115,75493,15860,15848,1222,17070,121
2022-04-08,Alameda,001,1643700,257649,256649,14053,270702,1826
2022-04-08,Alpine,003,1148,124,124,1,125,0
2022-04-08,Amador,005,37829,8540,8489,655,9144,86
2022-04-08,Butte,007,227075,33076,33031,6653,39684,399
2022-04-08,Calaveras,009,45235,7277,7260,357,7617,119
2022-04-08,Colusa,011,21464,3448,3449,1076,4525,21
2022-04-08,Contra Costa,013,1133247,189309,189154,13389,202543,1296
2022-04-08,Del Norte,015,27424,5805,5811,198,6009,50
2022-04-08,El Dorado,017,186661,26777,26757,3220,29977,207
2022-04-08,Fresno,019,978130,231624,231090,23907,254997,2731
2022-04-08,Glenn,021,27897,4985,4988,1614,6602,47
2022-04-08,Humboldt,023,135768,16911,16913,2992,19905,141
2022-04-08,Imperial,025,180216,55430,55267,10884,66151,910
2022-04-08,Inyo,027,18085,4076,4071,497,4568,56
2022-04-08,Kern,029,883053,191940,191542,46330,237872,2244
2022-04-08,Kings,031,150075,51537,51519,3623,55142,443
2022-04-08,Lake,033,64148,10702,10690,899,11589,134
2022-04-08,Lassen,035,31185,8971,8948,888,9836,65
2022-04-08,Los Angeles,037,10098052,2715897,2709735,125579,2835314,31509
2022-04-08,Madera,039,155013,37295,37356,6062,43418,354
2022-04-08,Marin,041,260295,33778,33648,2369,36017,288
2022-04-08,Mariposa,043,17540,2405,2394,205,2599,29
2022-04-08,Mendocino,045,87422,13106,13087,3050,16137,120
2022-04-08,Merced,047,269075,62173,62231,8713,70944,811
2022-04-08,Modoc,049,8938,743,743,253,996,8
2022-04-08,Mono,051,14174,2971,2967,124,3091,6
2022-04-08,Monterey,053,433212,79577,79103,13973,93076,727
2022-04-08,Napa,055,140530,25921,25824,983,26807,144
2022-04-08,Nevada,057,99092,15994,15976,1217,17193,123
2022-04-08,Orange,059,3164182,547696,546983,41752,588735,6912
2022-04-08,Placer,061,380077,62875,62831,7434,70265,616
2022-04-08,Plumas,063,18699,2970,2887,364,3251,13
2022-04-08,Riverside,065,2383286,591688,591268,28230,619498,6429
2022-04-08,Sacramento,067,1510023,281438,277125,27419,304544,2972
2022-04-08,San Benito,069,59416,12926,12917,519,13436,98
2022-04-08,San Bernardino,071,2135413,566660,562571,24950,587521,6892
2022-04-08,San Diego,073,3302833,755390,754281,52485,806766,5210
2022-04-08,San Francisco,075,870044,126199,125963,8453,134416,844
2022-04-08,San Joaquin,077,732212,166442,166547,9648,176195,2212
2022-04-08,San Luis Obispo,079,281455,52580,52609,3822,56431,476
2022-04-08,San Mateo,081,765935,122881,121514,7121,128635,698
2022-04-08,Santa Barbara,083,443738,86048,85754,4803,90557,680
2022-04-08,Santa Clara,085,1922200,313920,313965,12602,326567,2266
2022-04-08,Santa Cruz,087,273765,48079,47624,2162,49786,259
2022-04-08,Shasta,089,179085,30565,30586,6159,36745,549
2022-04-08,Sierra,091,2930,274,272,48,320,4
2022-04-08,Siskiyou,093,43540,4448,4444,2758,7202,80
2022-04-08,Solano,095,438530,81663,81886,5574,87460,448
2022-04-08,Sonoma,097,501317,83996,83600,2643,86243,485
2022-04-08,Stanislaus,099,539301,117488,117528,17397,134925,1578
2022-04-08,Sutter,101,95872,20520,20591,2135,22726,223
2022-04-08,Tehama,103,63373,12050,12059,2628,14687,201
2022-04-08,Trinity,105,12862,1182,1177,295,1472,20
2022-04-08,Tulare,107,460477,106674,105278,28763,134041,1415
2022-04-08,Tuolumne,109,53932,12631,12632,567,13199,180
2022-04-08,Ventura,111,848112,173618,173343,9341,182684,1467
2022-04-08,Yolo,113,214977,36855,36587,3216,39803,312
2022-04-08,Yuba,115,75493,15859,15848,1222,17070,121
2022-04-07,Alameda,001,1643700,257458,256649,14045,270694,1826
2022-04-07,Alpine,003,1148,124,124,1,125,0
2022-04-07,Amador,005,37829,8539,8489,653,9142,86
2022-04-07,Butte,007,227075,33073,33031,6652,39683,399
2022-04-07,Calaveras,009,45235,7275,7260,357,7617,119
2022-04-07,Colusa,011,21464,3447,3449,1076,4525,21
2022-04-07,Contra Costa,013,1133247,189188,189154,13378,202532,1296
2022-04-07,Del Norte,015,27424,5804,5811,198,6009,50
2022-04-07,El Dorado,017,186661,26765,26757,3218,29975,207
2022-04-07,Fresno,019,978130,231598,231090,23905,254995,2731
2022-04-07,Glenn,021,27897,4983,4988,1613,6601,47
2022-04-07,Humboldt,023,135768,16904,16913,2990,19903,141
2022-04-07,Imperial,025,180216,55428,55267,10881,66148,910
2022-04-07,Inyo,027,18085,4076,4071,497,4568,56
2022-04-07,Kern,029,883053,191916,191542,46326,237868,2244
2022-04-07,Kings,031,150075,51529,51519,3623,55142,443
2022-04-07,Lake,033,64148,10698,10690,899,11589,134
2022-04-07,Lassen,035,31185,8971,8948,888,9836,65
2022-04-07,Los Angeles,037,10098052,2714994,2709735,125504,2835239,31509
2022-04-07,Madera,039,155013,37290,37356,6062,43418,354
2022-04-07,Marin,041,260295,33760,33648,2350,35998,288
2022-04-07,Mariposa,043,17540,2402,2394,204,2598,29
2022-04-07,Mendocino,045,87422,13102,13087,3049,16136,120
2022-04-07,Merced,047,269075,62164,62231,8709,70940,811
2022-04-07,Modoc,049,8938,743,743,253,996,8
2022-04-07,Mono,051,14174,2971,2967,123,3090,6
2022-04-07,Monterey,053,433212,79558,79103,13969,93072,727
2022-04-07,Napa,055,140530,25904,25824,979,26803,144
2022-04-07,Nevada,057,99092,15987,15976,1216,17192,123
2022-04-07,Orange,059,3164182,547541,546983,41722,588705,6912
2022-04-07,Placer,061,380077,62858,62831,7431,70262,616
2022-04-07,Plumas,063,18699,2970,2887,364,3251,13
2022-04-07,Riverside,065,2383286,591582,591268,28217,619485,6429
2022-04-07,Sacramento,067,1510023,281374,277125,27412,304537,2972
2022-04-07,San Benito,069,59416,12925,12917,519,13436,98
2022-04-07,San Bernardino,071,2135413,566499,562571,24938,587509,6892
2022-04-07,San Diego,073,3302833,755124,754281,52460,806741,5210
2022-04-07,San Francisco,075,870044,126043,125963,8437,134400,844
2022-04-07,San Joaquin,077,732212,166405,166547,9645,176192,2212
2022-04-07,San Luis Obispo,079,281455,52562,52609,3820,56429,476
2022-04-07,San Mateo,081,765935,122761,121514,7106,128620,698
2022-04-07,Santa Barbara,083,443738,86005,85754,4801,90555,680
2022-04-07,Santa Clara,085,1922200,313699,313965,12590,326555,2266
2022-04-07,Santa Cruz,087,273765,48060,47624,2158,49782,259
2022-04-07,Shasta,089,179085,30564,30586,6159,36745,549
2022-04-07,Sierra,091,2930,274,272,48,320,4
2022-04-07,Siskiyou,093,43540,4448,4444,2756,7200,80
2022-04-07,Solano,095,438530,81637,81886,5573,87459,448
2022-04-07,Sonoma,097,501317,83954,83600,2637,86237,485
2022-04-07,Stanislaus,099,539301,117466,117528,17393,134921,1578
2022-04-07,Sutter,101,95872,20517,20591,2134,22725,223
2022-04-07,Tehama,103,63373,12047,12059,2628,14687,201
2022-04-07,Trinity,105,12862,1182,1177,295,1472,20
2022-04-07,Tulare,107,460477,106668,105278,28761,134039,1415
2022-04-07,Tuolumne,109,53932,12629,12632,566,13198,180
2022-04-07,Ventura,111,848112,173589,173343,9339,182682,1467
2022-04-07,Yolo,113,214977,36842,36587,3216,39803,312
2022-04-07,Yuba,115,75493,15857,15848,1222,17070,121
2022-04-06,Alameda,001,1643700,257271,256143,14038,270181,1814
2022-04-06,Alpine,003,1148,124,124,1,125,0
2022-04-06,Amador,005,37829,8538,8488,653,9141,86
2022-04-06,Butte,007,227075,33068,32997,6650,39647,396
2022-04-06,Calaveras,009,45235,7273,7258,357,7615,120
2022-04-06,Colusa,011,21464,3447,3447,1076,4523,21
2022-04-06,Contra Costa,013,1133247,189120,188850,13364,202214,1296
2022-04-06,Del Norte,015,27424,5803,5809,198,6007,50
2022-04-06,El Dorado,017,186661,26762,26744,3218,29962,205
2022-04-06,Fresno,019,978130,231560,230942,23903,254845,2725
2022-04-06,Glenn,021,27897,4983,4986,1612,6598,47
2022-04-06,Humboldt,023,135768,16900,16904,2989,19893,140
2022-04-06,Imperial,025,180216,55421,55294,10881,66175,908
2022-04-06,Inyo,027,18085,4075,4068,495,4563,56
2022-04-06,Kern,029,883053,191894,191449,46323,237772,2234
2022-04-06,Kings,031,150075,51528,51491,3622,55113,443
2022-04-06,Lake,033,64148,10694,10679,899,11578,136
2022-04-06,Lassen,035,31185,8971,8945,888,9833,65
2022-04-06,Los Angeles,037,10098052,2713958,2707306,125441,2832747,31465
2022-04-06,Madera,039,155013,37285,37349,6062,43411,354
2022-04-06,Marin,041,260295,33740,33566,2342,35908,288
2022-04-06,Mariposa,043,17540,2401,2392,204,2596,29
2022-04-06,Mendocino,045,87422,13098,13074,3048,16122,119
2022-04-06,Merced,047,269075,62155,62195,8706,70901,810
2022-04-06,Modoc,049,8938,743,741,253,994,8
2022-04-06,Mono,051,14174,2970,2967,123,3090,6
2022-04-06,Monterey,053,433212,79544,79019,13959,92978,727
2022-04-06,Napa,055,140530,25887,25790,976,26766,143
2022-04-06,Nevada,057,99092,15985,15974,1216,17190,123
2022-04-06,Orange,059,3164182,547371,546491,41695,588186,6887
2022-04-06,Placer,061,380077,62852,62787,7430,70217,615
2022-04-06,Plumas,063,18699,2970,2850,364,3214,13
2022-04-06,Riverside,065,2383286,591485,590826,28212,619038,6424
2022-04-06,Sacramento,067,1510023,281295,276567,27408,303975,2953
2022-04-06,San Benito,069,59416,12924,12908,519,13427,98
2022-04-06,San Bernardino,071,2135413,566364,561648,24936,586584,6883
2022-04-06,San Diego,073,3302833,754827,753402,52425,805827,5192
2022-04-06,San Francisco,075,870044,125885,125536,8430,133966,843
2022-04-06,San Joaquin,077,732212,166374,166415,9642,176057,2207
2022-04-06,San Luis Obispo,079,281455,52540,52557,3818,56375,475
2022-04-06,San Mateo,081,765935,122653,121041,7094,128135,693
2022-04-06,Santa Barbara,083,443738,85964,85630,4797,90427,679
2022-04-06,Santa Clara,085,1922200,313501,313278,12567,325845,2265
2022-04-06,Santa Cruz,087,273765,48004,47446,2152,49598,259
2022-04-06,Shasta,089,179085,30563,30565,6159,36724,529
2022-04-06,Sierra,091,2930,274,272,48,320,4
2022-04-06,Siskiyou,093,43540,4448,4442,2756,7198,80
2022-04-06,Solano,095,438530,81604,81789,5568,87357,447
2022-04-06,Sonoma,097,501317,83894,83361,2630,85991,485
2022-04-06,Stanislaus,099,539301,117450,117534,17387,134921,1578
2022-04-06,Sutter,101,95872,20512,20581,2134,22715,222
2022-04-06,Tehama,103,63373,12047,12049,2628,14677,198
2022-04-06,Trinity,105,12862,1182,1173,295,1468,20
2022-04-06,Tulare,107,460477,106663,104826,28756,133582,1414
2022-04-06,Tuolumne,109,53932,12627,12621,566,13187,180
2022-04-06,Ventura,111,848112,173536,173179,9335,182514,1460
2022-04-06,Yolo,113,214977,36820,36393,3215,39608,314
2022-04-06,Yuba,115,75493,15853,15839,1222,17061,121
2022-04-05,Alameda,001,1643700,257057,256143,14029,270172,1814
2022-04-05,Alpine,003,1148,124,124,1,125,0
2022-04-05,Amador,005,37829,8536,8488,653,9141,86
2022-04-05,Butte,007,227075,33062,32997,6646,39643,396
2022-04-05,Calaveras,009,45235,7270,7258,357,7615,120
2022-04-05,Colusa,011,21464,3445,3447,1075,4522,21
2022-04-05,Contra Costa,013,1133247,189026,188850,13359,202209,1296
2022-04-05,Del Norte,015,27424,5801,5809,198,6007,50
2022-04-05,El Dorado,017,186661,26750,26744,3218,29962,205
2022-04-05,Fresno,019,978130,231528,230942,23896,254838,2725
2022-04-05,Glenn,021,27897,4983,4986,1611,6597,47
2022-04-05,Humboldt,023,135768,16894,16904,2989,19893,140
2022-04-05,Imperial,025,180216,55419,55294,10881,66175,908
2022-04-05,Inyo,027,18085,4074,4068,494,4562,56
2022-04-05,Kern,029,883053,191873,191449,46320,237769,2234
2022-04-05,Kings,031,150075,51525,51491,3622,55113,443
2022-04-05,Lake,033,64148,10691,10679,899,11578,136
2022-04-05,Lassen,035,31185,8971,8945,888,9833,65
2022-04-05,Los Angeles,037,10098052,2712910,2707306,125367,2832673,31465
2022-04-05,Madera,039,155013,37278,37349,6060,43409,354
2022-04-05,Marin,041,260295,33685,33566,2327,35893,288
2022-04-05,Mariposa,043,17540,2401,2392,204,2596,29
2022-04-05,Mendocino,045,87422,13092,13074,3047,16121,119
2022-04-05,Merced,047,269075,62144,62195,8699,70894,810
2022-04-05,Modoc,049,8938,743,741,253,994,8
2022-04-05,Mono,051,14174,2969,2967,123,3090,6
2022-04-05,Monterey,053,433212,79520,79019,13947,92966,727
2022-04-05,Napa,055,140530,25878,25790,971,26761,143
2022-04-05,Nevada,057,99092,15977,15974,1216,17190,123
2022-04-05,Orange,059,3164182,547187,546491,41668,588159,6887
2022-04-05,Placer,061,380077,62828,62787,7430,70217,615
2022-04-05,Plumas,063,18699,2970,2850,364,3214,13
2022-04-05,Riverside,065,2383286,591367,590826,28200,619026,6424
2022-04-05,Sacramento,067,1510023,281217,276567,27403,303970,2953
2022-04-05,San Benito,069,59416,12916,12908,519,13427,98
2022-04-05,San Bernardino,071,2135413,566233,561648,24924,586572,6883
2022-04-05,San Diego,073,3302833,754516,753402,52382,805784,5192
2022-04-05,San Francisco,075,870044,125681,125536,8422,133958,843
2022-04-05,San Joaquin,077,732212,166331,166415,9639,176054,2207
2022-04-05,San Luis Obispo,079,281455,52523,52557,3813,56370,475
2022-04-05,San Mateo,081,765935,122536,121041,7082,128123,693
2022-04-05,Santa Barbara,083,443738,85928,85630,4795,90425,679
2022-04-05,Santa Clara,085,1922200,313242,313278,12553,325831,2265
2022-04-05,Santa Cruz,087,273765,47937,47446,2149,49595,259
2022-04-05,Shasta,089,179085,30563,30565,6157,36722,529
2022-04-05,Sierra,091,2930,274,272,48,320,4
2022-04-05,Siskiyou,093,43540,4448,4442,2756,7198,80
2022-04-05,Solano,095,438530,81555,81789,5565,87354,447
2022-04-05,Sonoma,097,501317,83831,83361,2621,85982,485
2022-04-05,Stanislaus,099,539301,117436,117534,17378,134912,1578
2022-04-05,Sutter,101,95872,20508,20581,2133,22714,222
2022-04-05,Tehama,103,63373,12045,12049,2627,14676,198
2022-04-05,Trinity,105,12862,1182,1173,295,1468,20
2022-04-05,Tulare,107,460477,106652,104826,28753,133579,1414
2022-04-05,Tuolumne,109,53932,12625,12621,566,13187,180
2022-04-05,Ventura,111,848112,173481,173179,9329,182508,1460
2022-04-05,Yolo,113,214977,36807,36393,3212,39605,314
2022-04-05,Yuba,115,75493,15851,15839,1222,17061,121
2022-04-04,Alameda,001,1643700,256825,256143,14015,270158,1814
2022-04-04,Alpine,003,1148,124,124,1,125,0
2022-04-04,Amador,005,37829,8535,8488,652,9140,86
2022-04-04,Butte,007,227075,33057,32997,6643,39640,396
2022-04-04,Calaveras,009,45235,7270,7258,357,7615,120
2022-04-04,Colusa,011,21464,3444,3447,1075,4522,21
2022-04-04,Contra Costa,013,1133247,188926,188850,13355,202205,1296
2022-04-04,Del Norte,015,27424,5801,5809,198,6007,50
2022-04-04,El Dorado,017,186661,26745,26744,3217,29961,205
2022-04-04,Fresno,019,978130,231511,230942,23893,254835,2725
2022-04-04,Glenn,021,27897,4982,4986,1611,6597,47
2022-04-04,Humboldt,023,135768,16886,16904,2984,19888,140
2022-04-04,Imperial,025,180216,55415,55294,10881,66175,908
2022-04-04,Inyo,027,18085,4074,4068,492,4560,56
2022-04-04,Kern,029,883053,191850,191449,46314,237763,2234
2022-04-04,Kings,031,150075,51518,51491,3622,55113,443
2022-04-04,Lake,033,64148,10686,10679,899,11578,136
2022-04-04,Lassen,035,31185,8971,8945,888,9833,65
2022-04-04,Los Angeles,037,10098052,2711821,2707306,125323,2832629,31465
2022-04-04,Madera,039,155013,37274,37349,6060,43409,354
2022-04-04,Marin,041,260295,33668,33566,2318,35884,288
2022-04-04,Mariposa,043,17540,2400,2392,204,2596,29
2022-04-04,Mendocino,045,87422,13086,13074,3047,16121,119
2022-04-04,Merced,047,269075,62134,62195,8695,70890,810
2022-04-04,Modoc,049,8938,743,741,253,994,8
2022-04-04,Mono,051,14174,2969,2967,123,3090,6
2022-04-04,Monterey,053,433212,79504,79019,13941,92960,727
2022-04-04,Napa,055,140530,25860,25790,971,26761,143
2022-04-04,Nevada,057,99092,15972,15974,1216,17190,123
2022-04-04,Orange,059,3164182,547023,546491,41645,588136,6887
2022-04-04,Placer,061,380077,62818,62787,7429,70216,615
2022-04-04,Plumas,063,18699,2969,2850,364,3214,13
2022-04-04,Riverside,065,2383286,591273,590826,28188,619014,6424
2022-04-04,Sacramento,067,1510023,281123,276567,27394,303961,2953
2022-04-04,San Benito,069,59416,12914,12908,519,13427,98
2022-04-04,San Bernardino,071,2135413,566101,561648,24917,586565,6883
2022-04-04,San Diego,073,3302833,754195,753402,52349,805751,5192
2022-04-04,San Francisco,075,870044,125479,125536,8413,133949,843
2022-04-04,San Joaquin,077,732212,166305,166415,9636,176051,2207
2022-04-04,San Luis Obispo,079,281455,52500,52557,3811,56368,475
2022-04-04,San Mateo,081,765935,122402,121041,7068,128109,693
2022-04-04,Santa Barbara,083,443738,85883,85630,4794,90424,679
2022-04-04,Santa Clara,085,1922200,312974,313278,12544,325822,2265
2022-04-04,Santa Cruz,087,273765,47890,47446,2148,49594,259
2022-04-04,Shasta,089,179085,30560,30565,6156,36721,529
2022-04-04,Sierra,091,2930,274,272,48,320,4
2022-04-04,Siskiyou,093,43540,4448,4442,2756,7198,80
2022-04-04,Solano,095,438530,81516,81789,5562,87351,447
2022-04-04,Sonoma,097,501317,83779,83361,2614,85975,485
2022-04-04,Stanislaus,099,539301,117415,117534,17371,134905,1578
2022-04-04,Sutter,101,95872,20505,20581,2133,22714,222
2022-04-04,Tehama,103,63373,12043,12049,2627,14676,198
2022-04-04,Trinity,105,12862,1182,1173,295,1468,20
2022-04-04,Tulare,107,460477,106643,104826,28749,133575,1414
2022-04-04,Tuolumne,109,53932,12619,12621,566,13187,180
2022-04-04,Ventura,111,848112,173438,173179,9327,182506,1460
2022-04-04,Yolo,113,214977,36797,36393,3209,39602,314
2022-04-04,Yuba,115,75493,15849,15839,1222,17061,121
2022-04-03,Alameda,001,1643700,256572,255650,14014,269664,1813
2022-04-03,Alpine,003,1148,124,124,1,125,0
2022-04-03,Amador,005,37829,8535,8485,652,9137,86
2022-04-03,Butte,007,227075,33050,32981,6641,39622,396
2022-04-03,Calaveras,009,45235,7270,7254,357,7611,119
2022-04-03,Colusa,011,21464,3444,3445,1075,4520,21
2022-04-03,Contra Costa,013,1133247,188821,188658,13346,202004,1291
2022-04-03,Del Norte,015,27424,5801,5812,198,6010,50
2022-04-03,El Dorado,017,186661,26731,26732,3216,29948,200
2022-04-03,Fresno,019,978130,231478,230559,23890,254449,2722
2022-04-03,Glenn,021,27897,4982,4982,1611,6593,47
2022-04-03,Humboldt,023,135768,16881,16898,2984,19882,140
2022-04-03,Imperial,025,180216,55412,55266,10878,66144,908
2022-04-03,Inyo,027,18085,4072,4063,492,4555,56
2022-04-03,Kern,029,883053,191824,191384,46309,237693,2224
2022-04-03,Kings,031,150075,51512,51470,3620,55090,443
2022-04-03,Lake,033,64148,10684,10674,899,11573,136
2022-04-03,Lassen,035,31185,8970,8943,888,9831,65
2022-04-03,Los Angeles,037,10098052,2710628,2703576,125240,2828816,31410
2022-04-03,Madera,039,155013,37272,37333,6058,43391,354
2022-04-03,Marin,041,260295,33633,33493,2309,35802,287
2022-04-03,Mariposa,043,17540,2399,2391,204,2595,29
2022-04-03,Mendocino,045,87422,13080,13058,3045,16103,119
2022-04-03,Merced,047,269075,62119,62149,8691,70840,808
2022-04-03,Modoc,049,8938,742,741,253,994,8
2022-04-03,Mono,051,14174,2969,2967,123,3090,6
2022-04-03,Monterey,053,433212,79487,78964,13917,92881,726
2022-04-03,Napa,055,140530,25840,25757,970,26727,143
2022-04-03,Nevada,057,99092,15964,15962,1216,17178,123
2022-04-03,Orange,059,3164182,546822,546047,41619,587666,6880
2022-04-03,Placer,061,380077,62792,62740,7425,70165,614
2022-04-03,Plumas,063,18699,2968,2803,364,3167,14
2022-04-03,Riverside,065,2383286,591116,590563,28171,618734,6418
2022-04-03,Sacramento,067,1510023,281049,276218,27380,303598,2950
2022-04-03,San Benito,069,59416,12910,12901,519,13420,98
2022-04-03,San Bernardino,071,2135413,565956,561362,24912,586274,6865
2022-04-03,San Diego,073,3302833,753865,752281,52310,804591,5178
2022-04-03,San Francisco,075,870044,125250,125075,8407,133482,843
2022-04-03,San Joaquin,077,732212,166253,166336,9631,175967,2202
2022-04-03,San Luis Obispo,079,281455,52481,52512,3810,56322,475
2022-04-03,San Mateo,081,765935,122264,120717,7061,127778,693
2022-04-03,Santa Barbara,083,443738,85839,85611,4792,90403,678
2022-04-03,Santa Clara,085,1922200,312674,312517,12534,325051,2258
2022-04-03,Santa Cruz,087,273765,47835,47371,2146,49517,259
2022-04-03,Shasta,089,179085,30550,30556,6155,36711,530
2022-04-03,Sierra,091,2930,274,273,48,321,4
2022-04-03,Siskiyou,093,43540,4448,4439,2756,7195,80
2022-04-03,Solano,095,438530,81480,81848,5557,87405,446
2022-04-03,Sonoma,097,501317,83700,83235,2608,85843,485
2022-04-03,Stanislaus,099,539301,117385,117536,17366,134902,1581
2022-04-03,Sutter,101,95872,20502,20570,2133,22703,222
2022-04-03,Tehama,103,63373,12040,12046,2627,14673,198
2022-04-03,Trinity,105,12862,1182,1173,295,1468,20
2022-04-03,Tulare,107,460477,106636,104736,28738,133474,1410
2022-04-03,Tuolumne,109,53932,12618,12618,566,13184,180
2022-04-03,Ventura,111,848112,173387,173044,9325,182369,1460
2022-04-03,Yolo,113,214977,36779,36347,3207,39554,313
2022-04-03,Yuba,115,75493,15847,15835,1222,17057,120
2022-04-02,Alameda,001,1643700,256467,255650,14013,269663,1813
2022-04-02,Alpine,003,1148,124,124,1,125,0
2022-04-02,Amador,005,37829,8535,8485,652,9137,86
2022-04-02,Butte,007,227075,33046,32981,6641,39622,396
2022-04-02,Calaveras,009,45235,7270,7254,357,7611,119
2022-04-02,Colusa,011,21464,3444,3445,1075,4520,21
2022-04-02,Contra Costa,013,1133247,188765,188658,13343,202001,1291
2022-04-02,Del Norte,015,27424,5800,5812,198,6010,50
2022-04-02,El Dorado,017,186661,26728,26732,3216,29948,200
2022-04-02,Fresno,019,978130,231449,230559,23890,254449,2722
2022-04-02,Glenn,021,27897,4982,4982,1611,6593,47
2022-04-02,Humboldt,023,135768,16877,16898,2984,19882,140
2022-04-02,Imperial,025,180216,55408,55266,10878,66144,908
2022-04-02,Inyo,027,18085,4072,4063,492,4555,56
2022-04-02,Kern,029,883053,191810,191384,46306,237690,2224
2022-04-02,Kings,031,150075,51509,51470,3620,55090,443
2022-04-02,Lake,033,64148,10683,10674,899,11573,136
2022-04-02,Lassen,035,31185,8970,8943,888,9831,65
2022-04-02,Los Angeles,037,10098052,2710134,2703576,125200,2828776,31410
2022-04-02,Madera,039,155013,37269,37333,6058,43391,354
2022-04-02,Marin,041,260295,33609,33493,2301,35794,287
2022-04-02,Mariposa,043,17540,2398,2391,204,2595,29
2022-04-02,Mendocino,045,87422,13078,13058,3045,16103,119
2022-04-02,Merced,047,269075,62116,62149,8691,70840,808
2022-04-02,Modoc,049,8938,742,741,253,994,8
2022-04-02,Mono,051,14174,2969,2967,122,3089,6
2022-04-02,Monterey,053,433212,79474,78964,13912,92876,726
2022-04-02,Napa,055,140530,25826,25757,969,26726,143
2022-04-02,Nevada,057,99092,15961,15962,1215,17177,123
2022-04-02,Orange,059,3164182,546718,546047,41608,587655,6880
2022-04-02,Placer,061,380077,62783,62740,7423,70163,614
2022-04-02,Plumas,063,18699,2968,2803,364,3167,14
2022-04-02,Riverside,065,2383286,591042,590563,28166,618729,6418
2022-04-02,Sacramento,067,1510023,281013,276218,27379,303597,2950
2022-04-02,San Benito,069,59416,12909,12901,519,13420,98
2022-04-02,San Bernardino,071,2135413,565905,561362,24908,586270,6865
2022-04-02,San Diego,073,3302833,753739,752281,52301,804582,5178
2022-04-02,San Francisco,075,870044,125149,125075,8397,133472,843
2022-04-02,San Joaquin,077,732212,166233,166336,9629,175965,2202
2022-04-02,San Luis Obispo,079,281455,52476,52512,3810,56322,475
2022-04-02,San Mateo,081,765935,122171,120717,7052,127769,693
2022-04-02,Santa Barbara,083,443738,85820,85611,4791,90402,678
2022-04-02,Santa Clara,085,1922200,312511,312517,12530,325047,2258
2022-04-02,Santa Cruz,087,273765,47823,47371,2145,49516,259
2022-04-02,Shasta,089,179085,30549,30556,6155,36711,530
2022-04-02,Sierra,091,2930,274,273,48,321,4
2022-04-02,Siskiyou,093,43540,4447,4439,2755,7194,80
2022-04-02,Solano,095,438530,81465,81848,5557,87405,446
2022-04-02,Sonoma,097,501317,83653,83235,2602,85837,485
2022-04-02,Stanislaus,099,539301,117375,117536,17364,134900,1581
2022-04-02,Sutter,101,95872,20497,20570,2133,22703,222
2022-04-02,Tehama,103,63373,12040,12046,2627,14673,198
2022-04-02,Trinity,105,12862,1182,1173,295,1468,20
2022-04-02,Tulare,107,460477,106633,104736,28738,133474,1410
2022-04-02,Tuolumne,109,53932,12616,12618,566,13184,180
2022-04-02,Ventura,111,848112,173348,173044,9325,182369,1460
2022-04-02,Yolo,113,214977,36770,36347,3205,39552,313
2022-04-02,Yuba,115,75493,15846,15835,1222,17057,120
2022-04-01,Alameda,001,1643700,256353,255650,14009,269659,1813
2022-04-01,Alpine,003,1148,124,124,1,125,0
2022-04-01,Amador,005,37829,8535,8485,652,9137,86
2022-04-01,Butte,007,227075,33042,32981,6637,39618,396
2022-04-01,Calaveras,009,45235,7268,7254,357,7611,119
2022-04-01,Colusa,011,21464,3443,3445,1075,4520,21
2022-04-01,Contra Costa,013,1133247,188714,188658,13342,202000,1291
2022-04-01,Del Norte,015,27424,5798,5812,198,6010,50
2022-04-01,El Dorado,017,186661,26725,26732,3215,29947,200
2022-04-01,Fresno,019,978130,231423,230559,23888,254447,2722
2022-04-01,Glenn,021,27897,4982,4982,1611,6593,47
2022-04-01,Humboldt,023,135768,16875,16898,2984,19882,140
2022-04-01,Imperial,025,180216,55406,55266,10878,66144,908
2022-04-01,Inyo,027,18085,4070,4063,491,4554,56
2022-04-01,Kern,029,883053,191799,191384,46303,237687,2224
2022-04-01,Kings,031,150075,51506,51470,3620,55090,443
2022-04-01,Lake,033,64148,10681,10674,899,11573,136
2022-04-01,Lassen,035,31185,8969,8943,888,9831,65
2022-04-01,Los Angeles,037,10098052,2709637,2703576,125157,2828733,31410
2022-04-01,Madera,039,155013,37268,37333,6058,43391,354
2022-04-01,Marin,041,260295,33591,33493,2294,35787,287
2022-04-01,Mariposa,043,17540,2395,2391,204,2595,29
2022-04-01,Mendocino,045,87422,13075,13058,3045,16103,119
2022-04-01,Merced,047,269075,62108,62149,8689,70838,808
2022-04-01,Modoc,049,8938,742,741,253,994,8
2022-04-01,Mono,051,14174,2969,2967,122,3089,6
2022-04-01,Monterey,053,433212,79457,78964,13909,92873,726
2022-04-01,Napa,055,140530,25818,25757,969,26726,143
2022-04-01,Nevada,057,99092,15961,15962,1214,17176,123
2022-04-01,Orange,059,3164182,546610,546047,41598,587645,6880
2022-04-01,Placer,061,380077,62769,62740,7423,70163,614
2022-04-01,Plumas,063,18699,2968,2803,363,3166,14
2022-04-01,Riverside,065,2383286,590979,590563,28152,618715,6418
2022-04-01,Sacramento,067,1510023,280975,276218,27375,303593,2950
2022-04-01,San Benito,069,59416,12908,12901,519,13420,98
2022-04-01,San Bernardino,071,2135413,565850,561362,24904,586266,6865
2022-04-01,San Diego,073,3302833,753590,752281,52289,804570,5178
2022-04-01,San Francisco,075,870044,125040,125075,8390,133465,843
2022-04-01,San Joaquin,077,732212,166214,166336,9628,175964,2202
2022-04-01,San Luis Obispo,079,281455,52470,52512,3809,56321,475
2022-04-01,San Mateo,081,765935,122109,120717,7046,127763,693
2022-04-01,Santa Barbara,083,443738,85798,85611,4790,90401,678
2022-04-01,Santa Clara,085,1922200,312361,312517,12529,325046,2258
2022-04-01,Santa Cruz,087,273765,47807,47371,2143,49514,259
2022-04-01,Shasta,089,179085,30548,30556,6155,36711,530
2022-04-01,Sierra,091,2930,274,273,48,321,4
2022-04-01,Siskiyou,093,43540,4447,4439,2754,7193,80
2022-04-01,Solano,095,438530,81451,81848,5557,87405,446
2022-04-01,Sonoma,097,501317,83609,83235,2601,85836,485
2022-04-01,Stanislaus,099,539301,117364,117536,17361,134897,1581
2022-04-01,Sutter,101,95872,20497,20570,2133,22703,222
2022-04-01,Tehama,103,63373,12039,12046,2627,14673,198
2022-04-01,Trinity,105,12862,1182,1173,295,1468,20
2022-04-01,Tulare,107,460477,106628,104736,28734,133470,1410
2022-04-01,Tuolumne,109,53932,12615,12618,566,13184,180
2022-04-01,Ventura,111,848112,173317,173044,9322,182366,1460
2022-04-01,Yolo,113,214977,36760,36347,3204,39551,313
2022-04-01,Yuba,115,75493,15845,15835,1222,17057,120
2022-03-31,Alameda,001,1643700,256182,255650,13997,269647,1813
2022-03-31,Alpine,003,1148,124,124,1,125,0
2022-03-31,Amador,005,37829,8535,8485,652,9137,86
2022-03-31,Butte,007,227075,33038,32981,6634,39615,396
2022-03-31,Calaveras,009,45235,7265,7254,357,7611,119
2022-03-31,Colusa,011,21464,3442,3445,1075,4520,21
2022-03-31,Contra Costa,013,1133247,188622,188658,13336,201994,1291
2022-03-31,Del Norte,015,27424,5797,5812,198,6010,50
2022-03-31,El Dorado,017,186661,26717,26732,3215,29947,200
2022-03-31,Fresno,019,978130,231387,230559,23864,254423,2722
2022-03-31,Glenn,021,27897,4980,4982,1611,6593,47
2022-03-31,Humboldt,023,135768,16871,16898,2984,19882,140
2022-03-31,Imperial,025,180216,55403,55266,10877,66143,908
2022-03-31,Inyo,027,18085,4069,4063,488,4551,56
2022-03-31,Kern,029,883053,191785,191384,46295,237679,2224
2022-03-31,Kings,031,150075,51497,51470,3620,55090,443
2022-03-31,Lake,033,64148,10680,10674,898,11572,136
2022-03-31,Lassen,035,31185,8967,8943,888,9831,65
2022-03-31,Los Angeles,037,10098052,2708883,2703576,125105,2828681,31410
2022-03-31,Madera,039,155013,37265,37333,6058,43391,354
2022-03-31,Marin,041,260295,33567,33493,2283,35776,287
2022-03-31,Mariposa,043,17540,2394,2391,204,2595,29
2022-03-31,Mendocino,045,87422,13071,13058,3045,16103,119
2022-03-31,Merced,047,269075,62103,62149,8686,70835,808
2022-03-31,Modoc,049,8938,742,741,253,994,8
2022-03-31,Mono,051,14174,2969,2967,122,3089,6
2022-03-31,Monterey,053,433212,79439,78964,13897,92861,726
2022-03-31,Napa,055,140530,25809,25757,967,26724,143
2022-03-31,Nevada,057,99092,15954,15962,1213,17175,123
2022-03-31,Orange,059,3164182,546462,546047,41582,587629,6880
2022-03-31,Placer,061,380077,62745,62740,7421,70161,614
2022-03-31,Plumas,063,18699,2968,2803,362,3165,14
2022-03-31,Riverside,065,2383286,590872,590563,28148,618711,6418
2022-03-31,Sacramento,067,1510023,280903,276218,27367,303585,2950
2022-03-31,San Benito,069,59416,12907,12901,519,13420,98
2022-03-31,San Bernardino,071,2135413,565750,561362,24892,586254,6865
2022-03-31,San Diego,073,3302833,753344,752281,52263,804544,5178
2022-03-31,San Francisco,075,870044,124880,125075,8378,133453,843
2022-03-31,San Joaquin,077,732212,166180,166336,9614,175950,2202
2022-03-31,San Luis Obispo,079,281455,52456,52512,3808,56320,475
2022-03-31,San Mateo,081,765935,121998,120717,7044,127761,693
2022-03-31,Santa Barbara,083,443738,85770,85611,4789,90400,678
2022-03-31,Santa Clara,085,1922200,312135,312517,12516,325033,2258
2022-03-31,Santa Cruz,087,273765,47788,47371,2141,49512,259
2022-03-31,Shasta,089,179085,30542,30556,6155,36711,530
2022-03-31,Sierra,091,2930,271,273,48,321,4
2022-03-31,Siskiyou,093,43540,4445,4439,2754,7193,80
2022-03-31,Solano,095,438530,81424,81848,5554,87402,446
2022-03-31,Sonoma,097,501317,83565,83235,2595,85830,485
2022-03-31,Stanislaus,099,539301,117345,117536,17356,134892,1581
2022-03-31,Sutter,101,95872,20494,20570,2132,22702,222
2022-03-31,Tehama,103,63373,12039,12046,2626,14672,198
2022-03-31,Trinity,105,12862,1182,1173,295,1468,20
2022-03-31,Tulare,107,460477,106618,104736,28726,133462,1410
2022-03-31,Tuolumne,109,53932,12614,12618,566,13184,180
2022-03-31,Ventura,111,848112,173276,173044,9319,182363,1460
2022-03-31,Yolo,113,214977,36748,36347,3204,39551,313
2022-03-31,Yuba,115,75493,15845,15835,1218,17053,120
2022-03-30,Alameda,001,1643700,256051,255467,13988,269455,1812
2022-03-30,Alpine,003,1148,124,124,1,125,0
2022-03-30,Amador,005,37829,8535,8485,652,9137,86
2022-03-30,Butte,007,227075,33032,32968,6628,39596,396
2022-03-30,Calaveras,009,45235,7263,7253,356,7609,119
2022-03-30,Colusa,011,21464,3442,3445,1075,4520,21
2022-03-30,Contra Costa,013,1133247,188561,188496,13327,201823,1291
2022-03-30,Del Norte,015,27424,5795,5808,198,6006,50
2022-03-30,El Dorado,017,186661,26709,26722,3215,29937,200
2022-03-30,Fresno,019,978130,231376,230448,23858,254306,2720
2022-03-30,Glenn,021,27897,4980,4982,1611,6593,47
2022-03-30,Humboldt,023,135768,16868,16894,2984,19878,140
2022-03-30,Imperial,025,180216,55399,55252,10874,66126,908
2022-03-30,Inyo,027,18085,4068,4062,486,4548,56
2022-03-30,Kern,029,883053,191757,191363,46290,237653,2219
2022-03-30,Kings,031,150075,51491,51446,3618,55064,443
2022-03-30,Lake,033,64148,10678,10674,898,11572,136
2022-03-30,Lassen,035,31185,8967,8943,888,9831,65
2022-03-30,Los Angeles,037,10098052,2708071,2702536,125051,2827587,31384
2022-03-30,Madera,039,155013,37260,37330,6057,43387,354
2022-03-30,Marin,041,260295,33547,33453,2263,35716,287
2022-03-30,Mariposa,043,17540,2394,2390,204,2594,27
2022-03-30,Mendocino,045,87422,13067,13055,3042,16097,118
2022-03-30,Merced,047,269075,62096,62136,8680,70816,808
2022-03-30,Modoc,049,8938,742,739,253,992,8
2022-03-30,Mono,051,14174,2968,2967,122,3089,6
2022-03-30,Monterey,053,433212,79422,78911,13891,92802,726
2022-03-30,Napa,055,140530,25797,25745,966,26711,141
2022-03-30,Nevada,057,99092,15951,15960,1211,17171,123
2022-03-30,Orange,059,3164182,546308,545895,41559,587454,6876
2022-03-30,Placer,061,380077,62730,62705,7417,70122,614
2022-03-30,Plumas,063,18699,2968,2762,360,3122,13
2022-03-30,Riverside,065,2383286,590792,590437,28134,618571,6411
2022-03-30,Sacramento,067,1510023,280833,276081,27360,303441,2949
2022-03-30,San Benito,069,59416,12903,12898,519,13417,98
2022-03-30,San Bernardino,071,2135413,565668,561153,24887,586040,6863
2022-03-30,San Diego,073,3302833,753110,751684,52238,803922,5169
2022-03-30,San Francisco,075,870044,124771,124930,8367,133297,841
2022-03-30,San Joaquin,077,732212,166152,166299,9608,175907,2201
2022-03-30,San Luis Obispo,079,281455,52443,52484,3804,56288,475
2022-03-30,San Mateo,081,765935,121896,120548,7044,127592,693
2022-03-30,Santa Barbara,083,443738,85748,85488,4786,90274,677
2022-03-30,Santa Clara,085,1922200,311955,312253,12495,324748,2258
2022-03-30,Santa Cruz,087,273765,47731,47340,2141,49481,259
2022-03-30,Shasta,089,179085,30539,30555,6155,36710,530
2022-03-30,Sierra,091,2930,271,273,48,321,4
2022-03-30,Siskiyou,093,43540,4445,4439,2754,7193,80
2022-03-30,Solano,095,438530,81407,81816,5551,87367,443
2022-03-30,Sonoma,097,501317,83528,83163,2594,85757,485
2022-03-30,Stanislaus,099,539301,117332,117593,17353,134946,1559
2022-03-30,Sutter,101,95872,20489,20565,2132,22697,222
2022-03-30,Tehama,103,63373,12038,12045,2625,14670,198
2022-03-30,Trinity,105,12862,1181,1173,295,1468,20
2022-03-30,Tulare,107,460477,106612,104667,28720,133387,1410
2022-03-30,Tuolumne,109,53932,12612,12616,566,13182,180
2022-03-30,Ventura,111,848112,173236,172984,9311,182295,1460
2022-03-30,Yolo,113,214977,36741,36325,3201,39526,313
2022-03-30,Yuba,115,75493,15843,15830,1218,17048,120
2022-03-29,Alameda,001,1643700,255928,255261,13977,269238,1810
2022-03-29,Alpine,003,1148,124,124,1,125,0
2022-03-29,Amador,005,37829,8535,8483,652,9135,86
2022-03-29,Butte,007,227075,33030,32954,6627,39581,396
2022-03-29,Calaveras,009,45235,7262,7250,355,7605,119
2022-03-29,Colusa,011,21464,3442,3445,1075,4520,21
2022-03-29,Contra Costa,013,1133247,188472,188359,13320,201679,1290
2022-03-29,Del Norte,015,27424,5794,5806,197,6003,50
2022-03-29,El Dorado,017,186661,26705,26706,3215,29921,200
2022-03-29,Fresno,019,978130,231347,230256,23853,254109,2718
2022-03-29,Glenn,021,27897,4979,4983,1611,6594,47
2022-03-29,Humboldt,023,135768,16865,16892,2981,19873,140
2022-03-29,Imperial,025,180216,55383,55233,10873,66106,908
2022-03-29,Inyo,027,18085,4066,4062,485,4547,56
2022-03-29,Kern,029,883053,191725,191338,46283,237621,2220
2022-03-29,Kings,031,150075,51483,51416,3617,55033,443
2022-03-29,Lake,033,64148,10674,10674,898,11572,136
2022-03-29,Lassen,035,31185,8966,8943,888,9831,65
2022-03-29,Los Angeles,037,10098052,2707242,2702005,125004,2827009,31378
2022-03-29,Madera,039,155013,37251,37325,6055,43380,354
2022-03-29,Marin,041,260295,33527,33431,2258,35689,287
2022-03-29,Mariposa,043,17540,2394,2388,203,2591,23
2022-03-29,Mendocino,045,87422,13064,13053,3041,16094,119
2022-03-29,Merced,047,269075,62084,62123,8679,70802,806
2022-03-29,Modoc,049,8938,740,737,253,990,8
2022-03-29,Mono,051,14174,2968,2966,122,3088,5
2022-03-29,Monterey,053,433212,79409,78774,13883,92657,725
2022-03-29,Napa,055,140530,25790,25732,966,26698,141
2022-03-29,Nevada,057,99092,15943,15956,1211,17167,123
2022-03-29,Orange,059,3164182,546162,545832,41543,587375,6871
2022-03-29,Placer,061,380077,62711,62687,7412,70099,614
2022-03-29,Plumas,063,18699,2966,2761,360,3121,13
2022-03-29,Riverside,065,2383286,590692,590359,28126,618485,6403
2022-03-29,Sacramento,067,1510023,280766,276040,27347,303387,2946
2022-03-29,San Benito,069,59416,12901,12892,519,13411,97
2022-03-29,San Bernardino,071,2135413,565576,561026,24878,585904,6860
2022-03-29,San Diego,073,3302833,752863,751240,52215,803455,5159
2022-03-29,San Francisco,075,870044,124620,124789,8361,133150,840
2022-03-29,San Joaquin,077,732212,166114,166241,9600,175841,2198
2022-03-29,San Luis Obispo,079,281455,52427,52455,3800,56255,472
2022-03-29,San Mateo,081,765935,121803,120435,7041,127476,686
2022-03-29,Santa Barbara,083,443738,85726,85464,4786,90250,676
2022-03-29,Santa Clara,085,1922200,311705,312067,12478,324545,2259
2022-03-29,Santa Cruz,087,273765,47711,47323,2140,49463,259
2022-03-29,Shasta,089,179085,30532,30552,6152,36704,529
2022-03-29,Sierra,091,2930,271,273,48,321,4
2022-03-29,Siskiyou,093,43540,4445,4439,2753,7192,80
2022-03-29,Solano,095,438530,81387,81713,5548,87261,441
2022-03-29,Sonoma,097,501317,83494,83130,2587,85717,485
2022-03-29,Stanislaus,099,539301,117313,117683,17347,135030,1559
2022-03-29,Sutter,101,95872,20487,20556,2131,22687,221
2022-03-29,Tehama,103,63373,12036,12045,2625,14670,198
2022-03-29,Trinity,105,12862,1181,1173,295,1468,20
2022-03-29,Tulare,107,460477,106607,104622,28714,133336,1406
2022-03-29,Tuolumne,109,53932,12609,12615,566,13181,180
2022-03-29,Ventura,111,848112,173180,172946,9310,182256,1460
2022-03-29,Yolo,113,214977,36732,36296,3200,39496,313
2022-03-29,Yuba,115,75493,15839,15824,1217,17041,117
2022-03-28,Alameda,001,1643700,255775,255192,13967,269159,1808
2022-03-28,Alpine,003,1148,124,124,1,125,0
2022-03-28,Amador,005,37829,8534,8480,652,9132,86
2022-03-28,Butte,007,227075,33013,32947,6626,39573,392
2022-03-28,Calaveras,009,45235,7262,7247,355,7602,119
2022-03-28,Colusa,011,21464,3442,3445,1075,4520,21
2022-03-28,Contra Costa,013,1133247,188388,188305,13315,201620,1290
2022-03-28,Del Norte,015,27424,5792,5834,197,6031,50
2022-03-28,El Dorado,017,186661,26698,26703,3213,29916,200
2022-03-28,Fresno,019,978130,231321,230144,23836,253980,2717
2022-03-28,Glenn,021,27897,4979,4983,1611,6594,47
2022-03-28,Humboldt,023,135768,16864,16916,2981,19897,140
2022-03-28,Imperial,025,180216,55371,55245,10873,66118,909
2022-03-28,Inyo,027,18085,4065,4062,485,4547,56
2022-03-28,Kern,029,883053,191701,191333,46273,237606,2212
2022-03-28,Kings,031,150075,51470,51405,3617,55022,443
2022-03-28,Lake,033,64148,10672,10673,898,11571,136
2022-03-28,Lassen,035,31185,8966,8946,888,9834,63
2022-03-28,Los Angeles,037,10098052,2706353,2700997,124965,2825962,31349
2022-03-28,Madera,039,155013,37248,37324,6055,43379,354
2022-03-28,Marin,041,260295,33502,33391,2253,35644,287
2022-03-28,Mariposa,043,17540,2393,2388,203,2591,23
2022-03-28,Mendocino,045,87422,13062,13046,3040,16086,118
2022-03-28,Merced,047,269075,62075,62116,8674,70790,805
2022-03-28,Modoc,049,8938,739,736,253,989,7
2022-03-28,Mono,051,14174,2968,2966,122,3088,5
2022-03-28,Monterey,053,433212,79374,78784,13878,92662,724
2022-03-28,Napa,055,140530,25784,25723,965,26688,140
2022-03-28,Nevada,057,99092,15941,15969,1211,17180,123
2022-03-28,Orange,059,3164182,546030,545700,41515,587215,6860
2022-03-28,Placer,061,380077,62690,62687,7411,70098,613
2022-03-28,Plumas,063,18699,2965,2760,360,3120,13
2022-03-28,Riverside,065,2383286,590596,590298,28116,618414,6397
2022-03-28,Sacramento,067,1510023,280694,275889,27336,303225,2946
2022-03-28,San Benito,069,59416,12901,12889,519,13408,97
2022-03-28,San Bernardino,071,2135413,565493,560836,24865,585701,6858
2022-03-28,San Diego,073,3302833,752616,750659,52182,802841,5155
2022-03-28,San Francisco,075,870044,124478,124678,8350,133028,839
2022-03-28,San Joaquin,077,732212,166082,166247,9596,175843,2196
2022-03-28,San Luis Obispo,079,281455,52402,52434,3797,56231,470
2022-03-28,San Mateo,081,765935,121687,120337,7034,127371,686
2022-03-28,Santa Barbara,083,443738,85698,85442,4784,90226,675
2022-03-28,Santa Clara,085,1922200,311468,311953,12469,324422,2257
2022-03-28,Santa Cruz,087,273765,47676,47324,2140,49464,259
2022-03-28,Shasta,089,179085,30531,30550,6151,36701,527
2022-03-28,Sierra,091,2930,271,273,48,321,4
2022-03-28,Siskiyou,093,43540,4444,4438,2753,7191,80
2022-03-28,Solano,095,438530,81363,81704,5543,87247,441
2022-03-28,Sonoma,097,501317,83449,83105,2582,85687,485
2022-03-28,Stanislaus,099,539301,117301,117783,17342,135125,1562
2022-03-28,Sutter,101,95872,20482,20549,2131,22680,221
2022-03-28,Tehama,103,63373,12035,12041,2624,14665,200
2022-03-28,Trinity,105,12862,1181,1173,295,1468,20
2022-03-28,Tulare,107,460477,106594,104576,28707,133283,1404
2022-03-28,Tuolumne,109,53932,12609,12627,566,13193,180
2022-03-28,Ventura,111,848112,173140,172867,9309,182176,1455
2022-03-28,Yolo,113,214977,36722,36282,3198,39480,312
2022-03-28,Yuba,115,75493,15838,15821,1215,17036,117
2022-03-27,Alameda,001,1643700,255592,255132,13958,269090,1809
2022-03-27,Alpine,003,1148,124,124,1,125,0
2022-03-27,Amador,005,37829,8531,8480,652,9132,86
2022-03-27,Butte,007,227075,33000,32943,6619,39562,392
2022-03-27,Calaveras,009,45235,7260,7245,355,7600,119
2022-03-27,Colusa,011,21464,3442,3445,1074,4519,21
2022-03-27,Contra Costa,013,1133247,188271,188251,13299,201550,1290
2022-03-27,Del Norte,015,27424,5791,5836,197,6033,50
2022-03-27,El Dorado,017,186661,26684,26699,3210,29909,200
2022-03-27,Fresno,019,978130,231275,230049,23819,253868,2717
2022-03-27,Glenn,021,27897,4978,4983,1611,6594,47
2022-03-27,Humboldt,023,135768,16860,16920,2981,19901,140
2022-03-27,Imperial,025,180216,55359,55240,10870,66110,909
2022-03-27,Inyo,027,18085,4064,4062,483,4545,56
2022-03-27,Kern,029,883053,191663,191332,46267,237599,2213
2022-03-27,Kings,031,150075,51461,51400,3617,55017,443
2022-03-27,Lake,033,64148,10671,10672,897,11569,136
2022-03-27,Lassen,035,31185,8966,8946,888,9834,63
2022-03-27,Los Angeles,037,10098052,2705552,2700983,124917,2825900,31348
2022-03-27,Madera,039,155013,37244,37323,6053,43376,354
2022-03-27,Marin,041,260295,33465,33391,2243,35634,287
2022-03-27,Mariposa,043,17540,2393,2390,203,2593,23
2022-03-27,Mendocino,045,87422,13056,13046,3038,16084,118
2022-03-27,Merced,047,269075,62064,62110,8672,70782,805
2022-03-27,Modoc,049,8938,738,736,251,987,7
2022-03-27,Mono,051,14174,2968,2966,122,3088,5
2022-03-27,Monterey,053,433212,79353,78778,13865,92643,724
2022-03-27,Napa,055,140530,25770,25723,965,26688,140
2022-03-27,Nevada,057,99092,15937,15967,1209,17176,123
2022-03-27,Orange,059,3164182,545896,545644,41479,587123,6860
2022-03-27,Placer,061,380077,62671,62680,7411,70091,613
2022-03-27,Plumas,063,18699,2964,2760,358,3118,13
2022-03-27,Riverside,065,2383286,590511,590251,28105,618356,6395
2022-03-27,Sacramento,067,1510023,280611,275854,27329,303183,2941
2022-03-27,San Benito,069,59416,12896,12889,518,13407,97
2022-03-27,San Bernardino,071,2135413,565378,560853,24861,585714,6862
2022-03-27,San Diego,073,3302833,752362,750659,52159,802818,5155
2022-03-27,San Francisco,075,870044,124293,124619,8338,132957,839
2022-03-27,San Joaquin,077,732212,166045,166238,9593,175831,2196
2022-03-27,San Luis Obispo,079,281455,52381,52430,3795,56225,470
2022-03-27,San Mateo,081,765935,121579,120324,7028,127352,686
2022-03-27,Santa Barbara,083,443738,85663,85434,4782,90216,675
2022-03-27,Santa Clara,085,1922200,311252,311822,12461,324283,2257
2022-03-27,Santa Cruz,087,273765,47643,47321,2135,49456,259
2022-03-27,Shasta,089,179085,30526,30550,6149,36699,527
2022-03-27,Sierra,091,2930,271,273,48,321,4
2022-03-27,Siskiyou,093,43540,4444,4436,2752,7188,80
2022-03-27,Solano,095,438530,81325,81691,5540,87231,441
2022-03-27,Sonoma,097,501317,83391,83088,2578,85666,485
2022-03-27,Stanislaus,099,539301,117280,117778,17339,135117,1562
2022-03-27,Sutter,101,95872,20476,20545,2131,22676,221
2022-03-27,Tehama,103,63373,12035,12040,2624,14664,200
2022-03-27,Trinity,105,12862,1181,1173,295,1468,20
2022-03-27,Tulare,107,460477,106585,104582,28698,133280,1404
2022-03-27,Tuolumne,109,53932,12607,12628,566,13194,180
2022-03-27,Ventura,111,848112,173092,172831,9307,182138,1455
2022-03-27,Yolo,113,214977,36710,36232,3195,39427,312
2022-03-27,Yuba,115,75493,15835,15821,1208,17029,117
2022-03-26,Alameda,001,1643700,255513,254691,13956,268647,1803
2022-03-26,Alpine,003,1148,124,124,1,125,0
2022-03-26,Amador,005,37829,8531,8476,652,9128,86
2022-03-26,Butte,007,227075,32995,32929,6617,39546,391
2022-03-26,Calaveras,009,45235,7258,7240,355,7595,120
2022-03-26,Colusa,011,21464,3440,3445,1074,4519,21
2022-03-26,Contra Costa,013,1133247,188211,187990,13296,201286,1285
2022-03-26,Del Norte,015,27424,5789,5831,197,6028,50
2022-03-26,El Dorado,017,186661,26676,26674,3208,29882,200
2022-03-26,Fresno,019,978130,231252,229799,23818,253617,2710
2022-03-26,Glenn,021,27897,4978,4978,1611,6589,47
2022-03-26,Humboldt,023,135768,16856,16911,2981,19892,139
2022-03-26,Imperial,025,180216,55353,55230,10869,66099,913
2022-03-26,Inyo,027,18085,4064,4060,482,4542,56
2022-03-26,Kern,029,883053,191649,191288,46262,237550,2201
2022-03-26,Kings,031,150075,51460,51397,3617,55014,444
2022-03-26,Lake,033,64148,10671,10659,897,11556,136
2022-03-26,Lassen,035,31185,8966,8944,888,9832,63
2022-03-26,Los Angeles,037,10098052,2705106,2698028,124875,2822903,31291
2022-03-26,Madera,039,155013,37241,37321,6051,43372,354
2022-03-26,Marin,041,260295,33455,33317,2239,35556,287
2022-03-26,Mariposa,043,17540,2393,2386,203,2589,23
2022-03-26,Mendocino,045,87422,13053,13038,3038,16076,118
2022-03-26,Merced,047,269075,62058,62083,8670,70753,805
2022-03-26,Modoc,049,8938,738,736,251,987,7
2022-03-26,Mono,051,14174,2968,2966,122,3088,5
2022-03-26,Monterey,053,433212,79345,78688,13863,92551,724
2022-03-26,Napa,055,140530,25767,25701,965,26666,139
2022-03-26,Nevada,057,99092,15933,15960,1209,17169,123
2022-03-26,Orange,059,3164182,545820,545294,41468,586762,6853
2022-03-26,Placer,061,380077,62657,62634,7407,70041,613
2022-03-26,Plumas,063,18699,2964,2758,357,3115,13
2022-03-26,Riverside,065,2383286,590442,590060,28104,618164,6397
2022-03-26,Sacramento,067,1510023,280578,275529,27327,302856,2935
2022-03-26,San Benito,069,59416,12896,12885,518,13403,97
2022-03-26,San Bernardino,071,2135413,565326,560742,24857,585599,6840
2022-03-26,San Diego,073,3302833,752234,750170,52152,802322,5146
2022-03-26,San Francisco,075,870044,124187,124265,8329,132594,839
2022-03-26,San Joaquin,077,732212,166024,166079,9592,175671,2195
2022-03-26,San Luis Obispo,079,281455,52375,52369,3795,56164,469
2022-03-26,San Mateo,081,765935,121522,120165,7020,127185,684
2022-03-26,Santa Barbara,083,443738,85643,85477,4780,90257,674
2022-03-26,Santa Clara,085,1922200,311084,311189,12452,323641,2250
2022-03-26,Santa Cruz,087,273765,47632,47329,2135,49464,259
2022-03-26,Shasta,089,179085,30524,30542,6148,36690,527
2022-03-26,Sierra,091,2930,271,273,48,321,4
2022-03-26,Siskiyou,093,43540,4443,4433,2752,7185,80
2022-03-26,Solano,095,438530,81315,81659,5540,87199,441
2022-03-26,Sonoma,097,501317,83362,83113,2574,85687,485
2022-03-26,Stanislaus,099,539301,117273,117962,17338,135300,1565
2022-03-26,Sutter,101,95872,20474,20536,2131,22667,221
2022-03-26,Tehama,103,63373,12035,12036,2623,14659,195
2022-03-26,Trinity,105,12862,1181,1174,295,1469,20
2022-03-26,Tulare,107,460477,106578,104538,28697,133235,1400
2022-03-26,Tuolumne,109,53932,12605,12628,566,13194,180
2022-03-26,Ventura,111,848112,173052,172690,9303,181993,1455
2022-03-26,Yolo,113,214977,36705,36234,3195,39429,311
2022-03-26,Yuba,115,75493,15834,15807,1208,17015,117
2022-03-25,Alameda,001,1643700,255445,254691,13954,268645,1803
2022-03-25,Alpine,003,1148,124,124,1,125,0
2022-03-25,Amador,005,37829,8530,8476,652,9128,86
2022-03-25,Butte,007,227075,32989,32929,6616,39545,391
2022-03-25,Calaveras,009,45235,7257,7240,355,7595,120
2022-03-25,Colusa,011,21464,3440,3445,1074,4519,21
2022-03-25,Contra Costa,013,1133247,188159,187990,13292,201282,1285
2022-03-25,Del Norte,015,27424,5789,5831,197,6028,50
2022-03-25,El Dorado,017,186661,26672,26674,3208,29882,200
2022-03-25,Fresno,019,978130,231224,229799,23809,253608,2710
2022-03-25,Glenn,021,27897,4978,4978,1611,6589,47
2022-03-25,Humboldt,023,135768,16856,16911,2981,19892,139
2022-03-25,Imperial,025,180216,55348,55230,10868,66098,913
2022-03-25,Inyo,027,18085,4063,4060,482,4542,56
2022-03-25,Kern,029,883053,191639,191288,46261,237549,2201
2022-03-25,Kings,031,150075,51459,51397,3617,55014,444
2022-03-25,Lake,033,64148,10671,10659,897,11556,136
2022-03-25,Lassen,035,31185,8965,8944,888,9832,63
2022-03-25,Los Angeles,037,10098052,2704693,2698028,124843,2822871,31291
2022-03-25,Madera,039,155013,37239,37321,6050,43371,354
2022-03-25,Marin,041,260295,33440,33317,2230,35547,287
2022-03-25,Mariposa,043,17540,2393,2386,203,2589,23
2022-03-25,Mendocino,045,87422,13053,13038,3038,16076,118
2022-03-25,Merced,047,269075,62051,62083,8669,70752,805
2022-03-25,Modoc,049,8938,738,736,251,987,7
2022-03-25,Mono,051,14174,2967,2966,122,3088,5
2022-03-25,Monterey,053,433212,79334,78688,13860,92548,724
2022-03-25,Napa,055,140530,25760,25701,965,26666,139
2022-03-25,Nevada,057,99092,15932,15960,1209,17169,123
2022-03-25,Orange,059,3164182,545745,545294,41452,586746,6853
2022-03-25,Placer,061,380077,62651,62634,7404,70038,613
2022-03-25,Plumas,063,18699,2963,2758,357,3115,13
2022-03-25,Riverside,065,2383286,590381,590060,28093,618153,6397
2022-03-25,Sacramento,067,1510023,280537,275529,27325,302854,2935
2022-03-25,San Benito,069,59416,12896,12885,518,13403,97
2022-03-25,San Bernardino,071,2135413,565287,560742,24855,585597,6840
2022-03-25,San Diego,073,3302833,752109,750170,52142,802312,5146
2022-03-25,San Francisco,075,870044,124105,124265,8315,132580,839
2022-03-25,San Joaquin,077,732212,166010,166079,9590,175669,2195
2022-03-25,San Luis Obispo,079,281455,52372,52369,3794,56163,469
2022-03-25,San Mateo,081,765935,121468,120165,7020,127185,684
2022-03-25,Santa Barbara,083,443738,85628,85477,4778,90255,674
2022-03-25,Santa Clara,085,1922200,310925,311189,12448,323637,2250
2022-03-25,Santa Cruz,087,273765,47624,47329,2135,49464,259
2022-03-25,Shasta,089,179085,30522,30542,6147,36689,527
2022-03-25,Sierra,091,2930,271,273,48,321,4
2022-03-25,Siskiyou,093,43540,4441,4433,2750,7183,80
2022-03-25,Solano,095,438530,81299,81659,5538,87197,441
2022-03-25,Sonoma,097,501317,83324,83113,2574,85687,485
2022-03-25,Stanislaus,099,539301,117258,117962,17337,135299,1565
2022-03-25,Sutter,101,95872,20469,20536,2131,22667,221
2022-03-25,Tehama,103,63373,12033,12036,2623,14659,195
2022-03-25,Trinity,105,12862,1181,1174,295,1469,20
2022-03-25,Tulare,107,460477,106573,104538,28693,133231,1400
2022-03-25,Tuolumne,109,53932,12604,12628,566,13194,180
2022-03-25,Ventura,111,848112,173014,172690,9303,181993,1455
2022-03-25,Yolo,113,214977,36692,36234,3195,39429,311
2022-03-25,Yuba,115,75493,15829,15807,1207,17014,117
2022-03-24,Alameda,001,1643700,255328,254691,13938,268629,1803
2022-03-24,Alpine,003,1148,124,124,1,125,0
2022-03-24,Amador,005,37829,8530,8476,652,9128,86
2022-03-24,Butte,007,227075,32982,32929,6616,39545,391
2022-03-24,Calaveras,009,45235,7254,7240,355,7595,120
2022-03-24,Colusa,011,21464,3440,3445,1074,4519,21
2022-03-24,Contra Costa,013,1133247,188074,187990,13291,201281,1285
2022-03-24,Del Norte,015,27424,5786,5831,197,6028,50
2022-03-24,El Dorado,017,186661,26661,26674,3208,29882,200
2022-03-24,Fresno,019,978130,231182,229799,23797,253596,2710
2022-03-24,Glenn,021,27897,4977,4978,1611,6589,47
2022-03-24,Humboldt,023,135768,16851,16911,2979,19890,139
2022-03-24,Imperial,025,180216,55341,55230,10868,66098,913
2022-03-24,Inyo,027,18085,4062,4060,482,4542,56
2022-03-24,Kern,029,883053,191628,191288,46258,237546,2201
2022-03-24,Kings,031,150075,51450,51397,3615,55012,444
2022-03-24,Lake,033,64148,10670,10659,897,11556,136
2022-03-24,Lassen,035,31185,8964,8944,888,9832,63
2022-03-24,Los Angeles,037,10098052,2704127,2698028,124799,2822827,31291
2022-03-24,Madera,039,155013,37237,37321,6048,43369,354
2022-03-24,Marin,041,260295,33417,33317,2221,35538,287
2022-03-24,Mariposa,043,17540,2393,2386,203,2589,23
2022-03-24,Mendocino,045,87422,13048,13038,3035,16073,118
2022-03-24,Merced,047,269075,62045,62083,8668,70751,805
2022-03-24,Modoc,049,8938,738,736,251,987,7
2022-03-24,Mono,051,14174,2967,2966,122,3088,5
2022-03-24,Monterey,053,433212,79308,78688,13846,92534,724
2022-03-24,Napa,055,140530,25751,25701,965,26666,139
2022-03-24,Nevada,057,99092,15928,15960,1208,17168,123
2022-03-24,Orange,059,3164182,545643,545294,41435,586729,6853
2022-03-24,Placer,061,380077,62631,62634,7403,70037,613
2022-03-24,Plumas,063,18699,2963,2758,357,3115,13
2022-03-24,Riverside,065,2383286,590305,590060,28084,618144,6397
2022-03-24,Sacramento,067,1510023,280466,275529,27320,302849,2935
2022-03-24,San Benito,069,59416,12895,12885,517,13402,97
2022-03-24,San Bernardino,071,2135413,565206,560742,24851,585593,6840
2022-03-24,San Diego,073,3302833,751896,750170,52131,802301,5146
2022-03-24,San Francisco,075,870044,124025,124265,8309,132574,839
2022-03-24,San Joaquin,077,732212,165983,166079,9589,175668,2195
2022-03-24,San Luis Obispo,079,281455,52357,52369,3793,56162,469
2022-03-24,San Mateo,081,765935,121420,120165,7015,127180,684
2022-03-24,Santa Barbara,083,443738,85613,85477,4775,90252,674
2022-03-24,Santa Clara,085,1922200,310781,311189,12430,323619,2250
2022-03-24,Santa Cruz,087,273765,47607,47329,2134,49463,259
2022-03-24,Shasta,089,179085,30514,30542,6147,36689,527
2022-03-24,Sierra,091,2930,271,273,48,321,4
2022-03-24,Siskiyou,093,43540,4438,4433,2750,7183,80
2022-03-24,Solano,095,438530,81275,81659,5537,87196,441
2022-03-24,Sonoma,097,501317,83288,83113,2572,85685,485
2022-03-24,Stanislaus,099,539301,117250,117962,17334,135296,1565
2022-03-24,Sutter,101,95872,20464,20536,2131,22667,221
2022-03-24,Tehama,103,63373,12032,12036,2621,14657,195
2022-03-24,Trinity,105,12862,1181,1174,295,1469,20
2022-03-24,Tulare,107,460477,106563,104538,28688,133226,1400
2022-03-24,Tuolumne,109,53932,12602,12628,566,13194,180
2022-03-24,Ventura,111,848112,172971,172690,9302,181992,1455
2022-03-24,Yolo,113,214977,36684,36234,3191,39425,311
2022-03-24,Yuba,115,75493,15824,15807,1204,17011,117
2022-03-23,Alameda,001,1643700,255195,254559,13926,268485,1802
2022-03-23,Alpine,003,1148,124,124,1,125,0
2022-03-23,Amador,005,37829,8530,8475,652,9127,86
2022-03-23,Butte,007,227075,32969,32920,6615,39535,387
2022-03-23,Calaveras,009,45235,7249,7237,355,7592,120
2022-03-23,Colusa,011,21464,3439,3444,1074,4518,21
2022-03-23,Contra Costa,013,1133247,187976,187898,13279,201177,1279
2022-03-23,Del Norte,015,27424,5785,5830,196,6026,50
2022-03-23,El Dorado,017,186661,26655,26670,3208,29878,200
2022-03-23,Fresno,019,978130,231146,229656,23781,253437,2710
2022-03-23,Glenn,021,27897,4977,4975,1611,6586,47
2022-03-23,Humboldt,023,135768,16850,16908,2977,19885,139
2022-03-23,Imperial,025,180216,55336,55211,10867,66078,909
2022-03-23,Inyo,027,18085,4062,4060,482,4542,56
2022-03-23,Kern,029,883053,191611,191241,46253,237494,2196
2022-03-23,Kings,031,150075,51438,51384,3614,54998,442
2022-03-23,Lake,033,64148,10666,10658,896,11554,135
2022-03-23,Lassen,035,31185,8963,8944,887,9831,63
2022-03-23,Los Angeles,037,10098052,2703451,2697227,124767,2821994,31267
2022-03-23,Madera,039,155013,37232,37317,6044,43361,354
2022-03-23,Marin,041,260295,33392,33274,2216,35490,287
2022-03-23,Mariposa,043,17540,2391,2382,202,2584,11
2022-03-23,Mendocino,045,87422,13044,13033,3034,16067,118
2022-03-23,Merced,047,269075,62035,62056,8664,70720,805
2022-03-23,Modoc,049,8938,738,736,251,987,7
2022-03-23,Mono,051,14174,2967,2966,122,3088,5
2022-03-23,Monterey,053,433212,79290,78655,13821,92476,724
2022-03-23,Napa,055,140530,25738,25691,963,26654,139
2022-03-23,Nevada,057,99092,15926,15958,1208,17166,123
2022-03-23,Orange,059,3164182,545514,545158,41422,586580,6852
2022-03-23,Placer,061,380077,62612,62622,7401,70023,613
2022-03-23,Plumas,063,18699,2963,2747,357,3104,13
2022-03-23,Riverside,065,2383286,590231,589947,28079,618026,6388
2022-03-23,Sacramento,067,1510023,280403,275398,27313,302711,2934
2022-03-23,San Benito,069,59416,12894,12884,517,13401,97
2022-03-23,San Bernardino,071,2135413,565132,560550,24846,585396,6828
2022-03-23,San Diego,073,3302833,751698,749871,52108,801979,5143
2022-03-23,San Francisco,075,870044,123911,124110,8303,132413,838
2022-03-23,San Joaquin,077,732212,165947,166041,9583,175624,2187
2022-03-23,San Luis Obispo,079,281455,52340,52344,3787,56131,469
2022-03-23,San Mateo,081,765935,121337,120080,7005,127085,685
2022-03-23,Santa Barbara,083,443738,85594,85464,4774,90238,673
2022-03-23,Santa Clara,085,1922200,310617,310956,12418,323374,2250
2022-03-23,Santa Cruz,087,273765,47586,47314,2128,49442,259
2022-03-23,Shasta,089,179085,30510,30524,6146,36670,526
2022-03-23,Sierra,091,2930,271,273,48,321,4
2022-03-23,Siskiyou,093,43540,4437,4433,2750,7183,80
2022-03-23,Solano,095,438530,81241,81615,5536,87151,441
2022-03-23,Sonoma,097,501317,83255,83074,2570,85644,482
2022-03-23,Stanislaus,099,539301,117233,118041,17331,135372,1568
2022-03-23,Sutter,101,95872,20461,20532,2131,22663,218
2022-03-23,Tehama,103,63373,12030,12035,2621,14656,195
2022-03-23,Trinity,105,12862,1181,1174,295,1469,20
2022-03-23,Tulare,107,460477,106544,104489,28682,133171,1394
2022-03-23,Tuolumne,109,53932,12601,12629,566,13195,180
2022-03-23,Ventura,111,848112,172922,172647,9300,181947,1455
2022-03-23,Yolo,113,214977,36668,36197,3189,39386,308
2022-03-23,Yuba,115,75493,15818,15801,1203,17004,117
2022-03-22,Alameda,001,1643700,255074,254467,13549,268016,1802
2022-03-22,Alpine,003,1148,124,122,1,123,0
2022-03-22,Amador,005,37829,8529,8462,651,9113,86
2022-03-22,Butte,007,227075,32959,32907,6611,39518,387
2022-03-22,Calaveras,009,45235,7247,7237,355,7592,120
2022-03-22,Colusa,011,21464,3438,3445,1074,4519,21
2022-03-22,Contra Costa,013,1133247,187899,187813,13257,201070,1279
2022-03-22,Del Norte,015,27424,5780,5824,196,6020,50
2022-03-22,El Dorado,017,186661,26648,26661,3208,29869,200
2022-03-22,Fresno,019,978130,231098,229551,23773,253324,2708
2022-03-22,Glenn,021,27897,4974,4971,1611,6582,47
2022-03-22,Humboldt,023,135768,16847,16911,2977,19888,139
2022-03-22,Imperial,025,180216,55325,55170,10864,66034,908
2022-03-22,Inyo,027,18085,4062,4060,482,4542,56
2022-03-22,Kern,029,883053,191587,191213,46244,237457,2195
2022-03-22,Kings,031,150075,51426,51369,3613,54982,442
2022-03-22,Lake,033,64148,10664,10657,895,11552,135
2022-03-22,Lassen,035,31185,8963,8940,886,9826,63
2022-03-22,Los Angeles,037,10098052,2702789,2696746,124718,2821464,31250
2022-03-22,Madera,039,155013,37228,37304,6041,43345,354
2022-03-22,Marin,041,260295,33367,33253,2212,35465,287
2022-03-22,Mariposa,043,17540,2389,2382,202,2584,6
2022-03-22,Mendocino,045,87422,13039,13030,3032,16062,118
2022-03-22,Merced,047,269075,62025,62056,8660,70716,805
2022-03-22,Modoc,049,8938,738,735,251,986,7
2022-03-22,Mono,051,14174,2967,2963,122,3085,5
2022-03-22,Monterey,053,433212,79274,78614,13811,92425,724
2022-03-22,Napa,055,140530,25728,25688,962,26650,139
2022-03-22,Nevada,057,99092,15918,15950,1208,17158,123
2022-03-22,Orange,059,3164182,545370,545075,41403,586478,6843
2022-03-22,Placer,061,380077,62599,62604,7399,70003,610
2022-03-22,Plumas,063,18699,2962,2744,357,3101,13
2022-03-22,Riverside,065,2383286,590157,589816,28076,617892,6383
2022-03-22,Sacramento,067,1510023,280326,275374,27300,302674,2927
2022-03-22,San Benito,069,59416,12893,12884,516,13400,97
2022-03-22,San Bernardino,071,2135413,565051,560371,24826,585197,6811
2022-03-22,San Diego,073,3302833,751490,749647,52088,801735,5141
2022-03-22,San Francisco,075,870044,123803,123998,8297,132295,838
2022-03-22,San Joaquin,077,732212,165919,165992,9579,175571,2187
2022-03-22,San Luis Obispo,079,281455,52332,52257,3787,56044,465
2022-03-22,San Mateo,081,765935,121266,119975,7001,126976,686
2022-03-22,Santa Barbara,083,443738,85578,85457,4773,90230,672
2022-03-22,Santa Clara,085,1922200,310443,310787,12408,323195,2249
2022-03-22,Santa Cruz,087,273765,47567,47287,2127,49414,259
2022-03-22,Shasta,089,179085,30504,30528,6145,36673,525
2022-03-22,Sierra,091,2930,271,273,48,321,4
2022-03-22,Siskiyou,093,43540,4437,4429,2749,7178,80
2022-03-22,Solano,095,438530,81218,81587,5535,87122,440
2022-03-22,Sonoma,097,501317,83227,83042,2566,85608,482
2022-03-22,Stanislaus,099,539301,117216,118025,17328,135353,1568
2022-03-22,Sutter,101,95872,20460,20525,2127,22652,218
2022-03-22,Tehama,103,63373,12028,12034,2621,14655,162
2022-03-22,Trinity,105,12862,1181,1174,295,1469,20
2022-03-22,Tulare,107,460477,106532,104431,28673,133104,1391
2022-03-22,Tuolumne,109,53932,12601,12628,566,13194,180
2022-03-22,Ventura,111,848112,172874,172590,9298,181888,1455
2022-03-22,Yolo,113,214977,36651,36184,3188,39372,308
2022-03-22,Yuba,115,75493,15815,15795,1202,16997,117
2022-03-21,Alameda,001,1643700,254858,254354,13541,267895,1799
2022-03-21,Alpine,003,1148,124,122,1,123,0
2022-03-21,Amador,005,37829,8526,8461,650,9111,85
2022-03-21,Butte,007,227075,32948,32895,6607,39502,385
2022-03-21,Calaveras,009,45235,7246,7237,355,7592,119
2022-03-21,Colusa,011,21464,3438,3445,1074,4519,21
2022-03-21,Contra Costa,013,1133247,187835,187509,13240,200749,1276
2022-03-21,Del Norte,015,27424,5779,5824,196,6020,50
2022-03-21,El Dorado,017,186661,26636,26610,3206,29816,199
2022-03-21,Fresno,019,978130,231049,229374,23764,253138,2707
2022-03-21,Glenn,021,27897,4972,4972,1605,6577,46
2022-03-21,Humboldt,023,135768,16837,16912,2964,19876,139
2022-03-21,Imperial,025,180216,55310,55133,10863,65996,908
2022-03-21,Inyo,027,18085,4061,4060,482,4542,56
2022-03-21,Kern,029,883053,191553,191184,46238,237422,2187
2022-03-21,Kings,031,150075,51412,51366,3611,54977,441
2022-03-21,Lake,033,64148,10662,10655,895,11550,135
2022-03-21,Lassen,035,31185,8962,8939,886,9825,63
2022-03-21,Los Angeles,037,10098052,2701926,2694711,124668,2819379,31218
2022-03-21,Madera,039,155013,37222,37288,6037,43325,354
2022-03-21,Marin,041,260295,33323,33242,2207,35449,287
2022-03-21,Mariposa,043,17540,2388,2383,201,2584,6
2022-03-21,Mendocino,045,87422,13031,13028,3030,16058,118
2022-03-21,Merced,047,269075,62011,62048,8655,70703,803
2022-03-21,Modoc,049,8938,736,734,251,985,7
2022-03-21,Mono,051,14174,2967,2962,122,3084,5
2022-03-21,Monterey,053,433212,79226,78572,13797,92369,724
2022-03-21,Napa,055,140530,25720,25684,960,26644,138
2022-03-21,Nevada,057,99092,15914,15963,1207,17170,123
2022-03-21,Orange,059,3164182,545215,544943,41386,586329,6841
2022-03-21,Placer,061,380077,62580,62550,7398,69948,610
2022-03-21,Plumas,063,18699,2962,2744,357,3101,13
2022-03-21,Riverside,065,2383286,590075,589707,28070,617777,6376
2022-03-21,Sacramento,067,1510023,280231,275334,27286,302620,2925
2022-03-21,San Benito,069,59416,12887,12872,516,13388,97
2022-03-21,San Bernardino,071,2135413,564961,560210,24814,585024,6807
2022-03-21,San Diego,073,3302833,751257,748833,52067,800900,5138
2022-03-21,San Francisco,075,870044,123635,123912,8288,132200,835
2022-03-21,San Joaquin,077,732212,165893,165939,9576,175515,2185
2022-03-21,San Luis Obispo,079,281455,52307,52219,3782,56001,463
2022-03-21,San Mateo,081,765935,121106,119899,6999,126898,684
2022-03-21,Santa Barbara,083,443738,85562,85416,4771,90187,672
2022-03-21,Santa Clara,085,1922200,310171,310509,12405,322914,2245
2022-03-21,Santa Cruz,087,273765,47531,47267,2126,49393,259
2022-03-21,Shasta,089,179085,30498,30523,6143,36666,525
2022-03-21,Sierra,091,2930,271,273,48,321,4
2022-03-21,Siskiyou,093,43540,4437,4426,2749,7175,80
2022-03-21,Solano,095,438530,81190,81399,5535,86934,441
2022-03-21,Sonoma,097,501317,83189,82979,2561,85540,482
2022-03-21,Stanislaus,099,539301,117183,118144,17325,135469,1571
2022-03-21,Sutter,101,95872,20457,20523,2114,22637,218
2022-03-21,Tehama,103,63373,12024,12030,2621,14651,160
2022-03-21,Trinity,105,12862,1181,1174,295,1469,20
2022-03-21,Tulare,107,460477,106512,104350,28668,133018,1389
2022-03-21,Tuolumne,109,53932,12601,12620,566,13186,180
2022-03-21,Ventura,111,848112,172805,172537,9294,181831,1452
2022-03-21,Yolo,113,214977,36636,36141,3186,39327,307
2022-03-21,Yuba,115,75493,15812,15790,1201,16991,117
2022-03-20,Alameda,001,1643700,254718,254293,13530,267823,1801
2022-03-20,Alpine,003,1148,122,122,1,123,0
2022-03-20,Amador,005,37829,8523,8460,650,9110,85
2022-03-20,Butte,007,227075,32934,32892,6603,39495,385
2022-03-20,Calaveras,009,45235,7245,7233,352,7585,119
2022-03-20,Colusa,011,21464,3438,3446,1074,4520,21
2022-03-20,Contra Costa,013,1133247,187732,187467,13228,200695,1276
2022-03-20,Del Norte,015,27424,5776,5821,196,6017,50
2022-03-20,El Dorado,017,186661,26629,26608,3206,29814,199
2022-03-20,Fresno,019,978130,230972,229297,23757,253054,2707
2022-03-20,Glenn,021,27897,4970,4972,1605,6577,46
2022-03-20,Humboldt,023,135768,16835,16913,2962,19875,139
2022-03-20,Imperial,025,180216,55299,55133,10862,65995,908
2022-03-20,Inyo,027,18085,4061,4060,482,4542,56
2022-03-20,Kern,029,883053,191508,191170,46233,237403,2187
2022-03-20,Kings,031,150075,51400,51360,3611,54971,441
2022-03-20,Lake,033,64148,10658,10652,895,11547,135
2022-03-20,Lassen,035,31185,8960,8938,886,9824,63
2022-03-20,Los Angeles,037,10098052,2701135,2694698,124620,2819318,31219
2022-03-20,Madera,039,155013,37217,37284,6033,43317,354
2022-03-20,Marin,041,260295,33307,33232,2206,35438,275
2022-03-20,Mariposa,043,17540,2388,2383,201,2584,6
2022-03-20,Mendocino,045,87422,13024,13027,3025,16052,118
2022-03-20,Merced,047,269075,62000,62041,8649,70690,803
2022-03-20,Modoc,049,8938,736,734,251,985,7
2022-03-20,Mono,051,14174,2965,2962,122,3084,5
2022-03-20,Monterey,053,433212,79193,78566,13786,92352,723
2022-03-20,Napa,055,140530,25708,25682,959,26641,138
2022-03-20,Nevada,057,99092,15910,15964,1207,17171,123
2022-03-20,Orange,059,3164182,545093,544862,41367,586229,6841
2022-03-20,Placer,061,380077,62559,62525,7398,69923,610
2022-03-20,Plumas,063,18699,2962,2744,357,3101,13
2022-03-20,Riverside,065,2383286,589978,589657,28065,617722,6376
2022-03-20,Sacramento,067,1510023,280150,275317,27271,302588,2927
2022-03-20,San Benito,069,59416,12887,12869,515,13384,97
2022-03-20,San Bernardino,071,2135413,564882,560220,24806,585026,6805
2022-03-20,San Diego,073,3302833,751010,748833,52034,800867,5138
2022-03-20,San Francisco,075,870044,123484,123858,8275,132133,835
2022-03-20,San Joaquin,077,732212,165859,165927,9572,175499,2185
2022-03-20,San Luis Obispo,079,281455,52283,52217,3779,55996,463
2022-03-20,San Mateo,081,765935,121046,119901,6993,126894,684
2022-03-20,Santa Barbara,083,443738,85537,85412,4769,90181,672
2022-03-20,Santa Clara,085,1922200,309954,310412,12398,322810,2243
2022-03-20,Santa Cruz,087,273765,47504,47265,2125,49390,259
2022-03-20,Shasta,089,179085,30487,30522,6142,36664,525
2022-03-20,Sierra,091,2930,271,273,48,321,4
2022-03-20,Siskiyou,093,43540,4436,4426,2749,7175,80
2022-03-20,Solano,095,438530,81160,81393,5533,86926,441
2022-03-20,Sonoma,097,501317,83146,82965,2560,85525,481
2022-03-20,Stanislaus,099,539301,117158,118146,17321,135467,1572
2022-03-20,Sutter,101,95872,20450,20519,2104,22623,218
2022-03-20,Tehama,103,63373,12022,12030,2621,14651,160
2022-03-20,Trinity,105,12862,1181,1174,295,1469,20
2022-03-20,Tulare,107,460477,106490,104353,28653,133006,1389
2022-03-20,Tuolumne,109,53932,12596,12617,566,13183,180
2022-03-20,Ventura,111,848112,172752,172514,9289,181803,1451
2022-03-20,Yolo,113,214977,36616,36135,3185,39320,307
2022-03-20,Yuba,115,75493,15804,15787,1199,16986,117
2022-03-19,Alameda,001,1643700,254635,253936,13528,267464,1797
2022-03-19,Alpine,003,1148,122,122,1,123,0
2022-03-19,Amador,005,37829,8520,8456,650,9106,85
2022-03-19,Butte,007,227075,32927,32856,6603,39459,385
2022-03-19,Calaveras,009,45235,7244,7229,352,7581,119
2022-03-19,Colusa,011,21464,3436,3445,1074,4519,21
2022-03-19,Contra Costa,013,1133247,187696,187225,13227,200452,1276
2022-03-19,Del Norte,015,27424,5773,5815,196,6011,48
2022-03-19,El Dorado,017,186661,26625,26618,3206,29824,199
2022-03-19,Fresno,019,978130,230949,228965,23757,252722,2694
2022-03-19,Glenn,021,27897,4970,4971,1605,6576,44
2022-03-19,Humboldt,023,135768,16829,16901,2962,19863,138
2022-03-19,Imperial,025,180216,55298,55038,10861,65899,898
2022-03-19,Inyo,027,18085,4061,4061,482,4543,56
2022-03-19,Kern,029,883053,191495,190943,46225,237168,2184
2022-03-19,Kings,031,150075,51395,51334,3611,54945,441
2022-03-19,Lake,033,64148,10658,10641,895,11536,135
2022-03-19,Lassen,035,31185,8960,8925,886,9811,63
2022-03-19,Los Angeles,037,10098052,2700770,2686759,124586,2811345,31133
2022-03-19,Madera,039,155013,37217,37273,6033,43306,354
2022-03-19,Marin,041,260295,33289,33163,2202,35365,272
2022-03-19,Mariposa,043,17540,2387,2378,201,2579,6
2022-03-19,Mendocino,045,87422,13024,13012,3025,16037,117
2022-03-19,Merced,047,269075,61994,61985,8647,70632,800
2022-03-19,Modoc,049,8938,736,734,251,985,7
2022-03-19,Mono,051,14174,2965,2961,122,3083,5
2022-03-19,Monterey,053,433212,79181,78483,13779,92262,720
2022-03-19,Napa,055,140530,25705,25654,959,26613,138
2022-03-19,Nevada,057,99092,15908,15960,1207,17167,123
2022-03-19,Orange,059,3164182,545022,543907,41351,585258,6817
2022-03-19,Placer,061,380077,62544,62483,7398,69881,605
2022-03-19,Plumas,063,18699,2962,2724,357,3081,13
2022-03-19,Riverside,065,2383286,589926,589017,28057,617074,6359
2022-03-19,Sacramento,067,1510023,280108,274855,27267,302122,2913
2022-03-19,San Benito,069,59416,12886,12859,515,13374,97
2022-03-19,San Bernardino,071,2135413,564836,559935,24805,584740,6778
2022-03-19,San Diego,073,3302833,750906,747344,52022,799366,5133
2022-03-19,San Francisco,075,870044,123416,123587,8272,131859,833
2022-03-19,San Joaquin,077,732212,165833,165765,9569,175334,2181
2022-03-19,San Luis Obispo,079,281455,52277,52174,3779,55953,463
2022-03-19,San Mateo,081,765935,121010,119782,6992,126774,667
2022-03-19,Santa Barbara,083,443738,85523,85336,4768,90104,671
2022-03-19,Santa Clara,085,1922200,309830,309918,12390,322308,2225
2022-03-19,Santa Cruz,087,273765,47496,47203,2121,49324,256
2022-03-19,Shasta,089,179085,30483,30495,6142,36637,525
2022-03-19,Sierra,091,2930,271,273,48,321,4
2022-03-19,Siskiyou,093,43540,4435,4422,2749,7171,76
2022-03-19,Solano,095,438530,81151,81340,5530,86870,441
2022-03-19,Sonoma,097,501317,83128,82838,2557,85395,472
2022-03-19,Stanislaus,099,539301,117148,118138,17319,135457,1568
2022-03-19,Sutter,101,95872,20447,20503,2104,22607,218
2022-03-19,Tehama,103,63373,12022,12007,2621,14628,160
2022-03-19,Trinity,105,12862,1181,1173,295,1468,20
2022-03-19,Tulare,107,460477,106481,104290,28648,132938,1384
2022-03-19,Tuolumne,109,53932,12596,12617,566,13183,180
2022-03-19,Ventura,111,848112,172721,172380,9288,181668,1451
2022-03-19,Yolo,113,214977,36607,36086,3185,39271,306
2022-03-19,Yuba,115,75493,15800,15768,1198,16966,117
2022-03-18,Alameda,001,1643700,254575,253936,13524,267460,1797
2022-03-18,Alpine,003,1148,122,122,1,123,0
2022-03-18,Amador,005,37829,8520,8456,650,9106,85
2022-03-18,Butte,007,227075,32922,32856,6601,39457,385
2022-03-18,Calaveras,009,45235,7244,7229,352,7581,119
2022-03-18,Colusa,011,21464,3436,3445,1074,4519,21
2022-03-18,Contra Costa,013,1133247,187662,187225,13225,200450,1276
2022-03-18,Del Norte,015,27424,5771,5815,195,6010,48
2022-03-18,El Dorado,017,186661,26620,26618,3204,29822,199
2022-03-18,Fresno,019,978130,230916,228965,23757,252722,2694
2022-03-18,Glenn,021,27897,4970,4971,1605,6576,44
2022-03-18,Humboldt,023,135768,16826,16901,2961,19862,138
2022-03-18,Imperial,025,180216,55296,55038,10861,65899,898
2022-03-18,Inyo,027,18085,4061,4061,482,4543,56
2022-03-18,Kern,029,883053,191484,190943,46222,237165,2184
2022-03-18,Kings,031,150075,51389,51334,3611,54945,441
2022-03-18,Lake,033,64148,10656,10641,894,11535,135
2022-03-18,Lassen,035,31185,8959,8925,886,9811,63
2022-03-18,Los Angeles,037,10098052,2700424,2686759,124560,2811319,31133
2022-03-18,Madera,039,155013,37212,37273,6033,43306,354
2022-03-18,Marin,041,260295,33275,33163,2202,35365,272
2022-03-18,Mariposa,043,17540,2386,2378,201,2579,6
2022-03-18,Mendocino,045,87422,13019,13012,3025,16037,117
2022-03-18,Merced,047,269075,61984,61985,8647,70632,800
2022-03-18,Modoc,049,8938,736,734,251,985,7
2022-03-18,Mono,051,14174,2964,2961,122,3083,5
2022-03-18,Monterey,053,433212,79162,78483,13776,92259,720
2022-03-18,Napa,055,140530,25702,25654,959,26613,138
2022-03-18,Nevada,057,99092,15905,15960,1206,17166,123
2022-03-18,Orange,059,3164182,544954,543907,41342,585249,6817
2022-03-18,Placer,061,380077,62536,62483,7398,69881,605
2022-03-18,Plumas,063,18699,2962,2724,357,3081,13
2022-03-18,Riverside,065,2383286,589869,589017,28053,617070,6359
2022-03-18,Sacramento,067,1510023,280072,274855,27262,302117,2913
2022-03-18,San Benito,069,59416,12884,12859,515,13374,97
2022-03-18,San Bernardino,071,2135413,564797,559935,24803,584738,6778
2022-03-18,San Diego,073,3302833,750796,747344,52007,799351,5133
2022-03-18,San Francisco,075,870044,123336,123587,8265,131852,833
2022-03-18,San Joaquin,077,732212,165819,165765,9564,175329,2181
2022-03-18,San Luis Obispo,079,281455,52271,52174,3779,55953,463
2022-03-18,San Mateo,081,765935,120974,119782,6989,126771,667
2022-03-18,Santa Barbara,083,443738,85514,85336,4767,90103,671
2022-03-18,Santa Clara,085,1922200,309725,309918,12387,322305,2225
2022-03-18,Santa Cruz,087,273765,47484,47203,2120,49323,256
2022-03-18,Shasta,089,179085,30482,30495,6142,36637,525
2022-03-18,Sierra,091,2930,271,273,48,321,4
2022-03-18,Siskiyou,093,43540,4435,4422,2749,7171,76
2022-03-18,Solano,095,438530,81140,81340,5524,86864,441
2022-03-18,Sonoma,097,501317,83108,82838,2556,85394,472
2022-03-18,Stanislaus,099,539301,117135,118138,17319,135457,1568
2022-03-18,Sutter,101,95872,20444,20503,2104,22607,218
2022-03-18,Tehama,103,63373,12021,12007,2621,14628,160
2022-03-18,Trinity,105,12862,1181,1173,295,1468,20
2022-03-18,Tulare,107,460477,106475,104290,28641,132931,1384
2022-03-18,Tuolumne,109,53932,12595,12617,566,13183,180
2022-03-18,Ventura,111,848112,172701,172380,9284,181664,1451
2022-03-18,Yolo,113,214977,36596,36086,3185,39271,306
2022-03-18,Yuba,115,75493,15798,15768,1198,16966,117
2022-03-17,Alameda,001,1643700,254476,253936,13517,267453,1797
2022-03-17,Alpine,003,1148,122,122,1,123,0
2022-03-17,Amador,005,37829,8513,8456,650,9106,85
2022-03-17,Butte,007,227075,32908,32856,6599,39455,385
2022-03-17,Calaveras,009,45235,7241,7229,352,7581,119
2022-03-17,Colusa,011,21464,3436,3445,1074,4519,21
2022-03-17,Contra Costa,013,1133247,187598,187225,13215,200440,1276
2022-03-17,Del Norte,015,27424,5769,5815,195,6010,48
2022-03-17,El Dorado,017,186661,26613,26618,3204,29822,199
2022-03-17,Fresno,019,978130,230867,228965,23754,252719,2694
2022-03-17,Glenn,021,27897,4970,4971,1605,6576,44
2022-03-17,Humboldt,023,135768,16822,16901,2959,19860,138
2022-03-17,Imperial,025,180216,55285,55038,10861,65899,898
2022-03-17,Inyo,027,18085,4061,4061,482,4543,56
2022-03-17,Kern,029,883053,191454,190943,46219,237162,2184
2022-03-17,Kings,031,150075,51386,51334,3610,54944,441
2022-03-17,Lake,033,64148,10653,10641,894,11535,135
2022-03-17,Lassen,035,31185,8957,8925,886,9811,63
2022-03-17,Los Angeles,037,10098052,2699769,2686759,124523,2811282,31133
2022-03-17,Madera,039,155013,37208,37273,6032,43305,354
2022-03-17,Marin,041,260295,33263,33163,2201,35364,272
2022-03-17,Mariposa,043,17540,2386,2378,201,2579,6
2022-03-17,Mendocino,045,87422,13016,13012,3022,16034,117
2022-03-17,Merced,047,269075,61978,61985,8645,70630,800
2022-03-17,Modoc,049,8938,736,734,251,985,7
2022-03-17,Mono,051,14174,2964,2961,121,3082,5
2022-03-17,Monterey,053,433212,79140,78483,13771,92254,720
2022-03-17,Napa,055,140530,25697,25654,959,26613,138
2022-03-17,Nevada,057,99092,15902,15960,1206,17166,123
2022-03-17,Orange,059,3164182,544860,543907,41331,585238,6817
2022-03-17,Placer,061,380077,62520,62483,7396,69879,605
2022-03-17,Plumas,063,18699,2961,2724,357,3081,13
2022-03-17,Riverside,065,2383286,589790,589017,28046,617063,6359
2022-03-17,Sacramento,067,1510023,280005,274855,27254,302109,2913
2022-03-17,San Benito,069,59416,12883,12859,515,13374,97
2022-03-17,San Bernardino,071,2135413,564731,559935,24800,584735,6778
2022-03-17,San Diego,073,3302833,750619,747344,51993,799337,5133
2022-03-17,San Francisco,075,870044,123256,123587,8260,131847,833
2022-03-17,San Joaquin,077,732212,165796,165765,9562,175327,2181
2022-03-17,San Luis Obispo,079,281455,52257,52174,3777,55951,463
2022-03-17,San Mateo,081,765935,120928,119782,6985,126767,667
2022-03-17,Santa Barbara,083,443738,85497,85336,4767,90103,671
2022-03-17,Santa Clara,085,1922200,309604,309918,12382,322300,2225
2022-03-17,Santa Cruz,087,273765,47468,47203,2118,49321,256
2022-03-17,Shasta,089,179085,30479,30495,6140,36635,525
2022-03-17,Sierra,091,2930,271,273,48,321,4
2022-03-17,Siskiyou,093,43540,4434,4422,2749,7171,76
2022-03-17,Solano,095,438530,81111,81340,5521,86861,441
2022-03-17,Sonoma,097,501317,83078,82838,2554,85392,472
2022-03-17,Stanislaus,099,539301,117122,118138,17314,135452,1568
2022-03-17,Sutter,101,95872,20434,20503,2090,22593,218
2022-03-17,Tehama,103,63373,12021,12007,2620,14627,160
2022-03-17,Trinity,105,12862,1181,1173,295,1468,20
2022-03-17,Tulare,107,460477,106460,104290,28630,132920,1384
2022-03-17,Tuolumne,109,53932,12592,12617,565,13182,180
2022-03-17,Ventura,111,848112,172654,172380,9282,181662,1451
2022-03-17,Yolo,113,214977,36583,36086,3185,39271,306
2022-03-17,Yuba,115,75493,15796,15768,1197,16965,117
2022-03-16,Alameda,001,1643700,254377,253792,13513,267305,1794
2022-03-16,Alpine,003,1148,122,122,1,123,0
2022-03-16,Amador,005,37829,8505,8449,650,9099,85
2022-03-16,Butte,007,227075,32895,32837,6594,39431,385
2022-03-16,Calaveras,009,45235,7239,7229,352,7581,120
2022-03-16,Colusa,011,21464,3436,3445,1073,4518,22
2022-03-16,Contra Costa,013,1133247,187540,187100,13206,200306,1266
2022-03-16,Del Norte,015,27424,5768,5811,193,6004,48
2022-03-16,El Dorado,017,186661,26601,26602,3203,29805,199
2022-03-16,Fresno,019,978130,230819,228786,23742,252528,2689
2022-03-16,Glenn,021,27897,4970,4969,1604,6573,44
2022-03-16,Humboldt,023,135768,16819,16893,2959,19852,138
2022-03-16,Imperial,025,180216,55273,55002,10860,65862,897
2022-03-16,Inyo,027,18085,4060,4061,482,4543,56
2022-03-16,Kern,029,883053,191411,190835,46212,237047,2170
2022-03-16,Kings,031,150075,51371,51321,3610,54931,437
2022-03-16,Lake,033,64148,10651,10633,893,11526,133
2022-03-16,Lassen,035,31185,8954,8924,886,9810,62
2022-03-16,Los Angeles,037,10098052,2699141,2685789,124482,2810271,31102
2022-03-16,Madera,039,155013,37200,37262,6031,43293,354
2022-03-16,Marin,041,260295,33242,33136,2199,35335,272
2022-03-16,Mariposa,043,17540,2384,2376,201,2577,6
2022-03-16,Mendocino,045,87422,13013,13011,3021,16032,117
2022-03-16,Merced,047,269075,61962,61959,8639,70598,798
2022-03-16,Modoc,049,8938,735,734,251,985,7
2022-03-16,Mono,051,14174,2964,2960,121,3081,5
2022-03-16,Monterey,053,433212,79118,78416,13766,92182,720
2022-03-16,Napa,055,140530,25688,25638,958,26596,138
2022-03-16,Nevada,057,99092,15900,15960,1206,17166,123
2022-03-16,Orange,059,3164182,544738,543326,41308,584634,6791
2022-03-16,Placer,061,380077,62505,62435,7394,69829,605
2022-03-16,Plumas,063,18699,2961,2723,357,3080,13
2022-03-16,Riverside,065,2383286,589690,588761,28043,616804,6351
2022-03-16,Sacramento,067,1510023,279938,274709,27248,301957,2910
2022-03-16,San Benito,069,59416,12878,12854,515,13369,97
2022-03-16,San Bernardino,071,2135413,564651,559746,24795,584541,6775
2022-03-16,San Diego,073,3302833,750408,746970,51969,798939,5126
2022-03-16,San Francisco,075,870044,123156,123446,8252,131698,831
2022-03-16,San Joaquin,077,732212,165749,165703,9559,175262,2169
2022-03-16,San Luis Obispo,079,281455,52239,52132,3774,55906,462
2022-03-16,San Mateo,081,765935,120866,119680,6976,126656,660
2022-03-16,Santa Barbara,083,443738,85464,85322,4762,90084,670
2022-03-16,Santa Clara,085,1922200,309420,309689,12366,322055,2224
2022-03-16,Santa Cruz,087,273765,47439,47161,2118,49279,255
2022-03-16,Shasta,089,179085,30470,30489,6136,36625,527
2022-03-16,Sierra,091,2930,271,273,48,321,4
2022-03-16,Siskiyou,093,43540,4431,4419,2747,7166,76
2022-03-16,Solano,095,438530,81088,81277,5519,86796,440
2022-03-16,Sonoma,097,501317,83033,82791,2546,85337,472
2022-03-16,Stanislaus,099,539301,117096,118072,17312,135384,1567
2022-03-16,Sutter,101,95872,20432,20494,2089,22583,218
2022-03-16,Tehama,103,63373,12019,11999,2620,14619,160
2022-03-16,Trinity,105,12862,1181,1173,295,1468,20
2022-03-16,Tulare,107,460477,106446,104217,28623,132840,1377
2022-03-16,Tuolumne,109,53932,12587,12610,565,13175,180
2022-03-16,Ventura,111,848112,172614,172212,9278,181490,1451
2022-03-16,Yolo,113,214977,36561,36079,3183,39262,307
2022-03-16,Yuba,115,75493,15791,15758,1197,16955,117
2022-03-15,Alameda,001,1643700,254245,253694,13503,267197,1793
2022-03-15,Alpine,003,1148,122,122,1,123,0
2022-03-15,Amador,005,37829,8502,8448,650,9098,85
2022-03-15,Butte,007,227075,32882,32822,6592,39414,385
2022-03-15,Calaveras,009,45235,7237,7236,352,7588,118
2022-03-15,Colusa,011,21464,3436,3445,1073,4518,21
2022-03-15,Contra Costa,013,1133247,187460,187021,13197,200218,1265
2022-03-15,Del Norte,015,27424,5765,5806,190,5996,48
2022-03-15,El Dorado,017,186661,26598,26596,3202,29798,199
2022-03-15,Fresno,019,978130,230776,228631,23732,252363,2689
2022-03-15,Glenn,021,27897,4968,4966,1604,6570,44
2022-03-15,Humboldt,023,135768,16813,16889,2958,19847,138
2022-03-15,Imperial,025,180216,55263,54981,10856,65837,896
2022-03-15,Inyo,027,18085,4060,4062,481,4543,56
2022-03-15,Kern,029,883053,191382,190645,46202,236847,2168
2022-03-15,Kings,031,150075,51351,51317,3606,54923,437
2022-03-15,Lake,033,64148,10647,10631,893,11524,131
2022-03-15,Lassen,035,31185,8952,8926,885,9811,62
2022-03-15,Los Angeles,037,10098052,2698469,2685071,124421,2809492,31077
2022-03-15,Madera,039,155013,37190,37258,6030,43288,354
2022-03-15,Marin,041,260295,33219,33111,2198,35309,272
2022-03-15,Mariposa,043,17540,2382,2377,201,2578,6
2022-03-15,Mendocino,045,87422,13008,13005,3020,16025,117
2022-03-15,Merced,047,269075,61944,61916,8630,70546,798
2022-03-15,Modoc,049,8938,735,733,251,984,7
2022-03-15,Mono,051,14174,2964,2961,121,3082,5
2022-03-15,Monterey,053,433212,79087,78400,13758,92158,718
2022-03-15,Napa,055,140530,25680,25657,956,26613,138
2022-03-15,Nevada,057,99092,15898,15960,1204,17164,123
2022-03-15,Orange,059,3164182,544596,543197,41301,584498,6780
2022-03-15,Placer,061,380077,62487,62398,7390,69788,604
2022-03-15,Plumas,063,18699,2960,2722,357,3079,13
2022-03-15,Riverside,065,2383286,589590,588622,28035,616657,6333
2022-03-15,Sacramento,067,1510023,279856,274633,27241,301874,2907
2022-03-15,San Benito,069,59416,12874,12849,515,13364,95
2022-03-15,San Bernardino,071,2135413,564576,559605,24790,584395,6770
2022-03-15,San Diego,073,3302833,750159,746474,51947,798421,5116
2022-03-15,San Francisco,075,870044,123040,123526,8243,131769,831
2022-03-15,San Joaquin,077,732212,165706,165664,9553,175217,2161
2022-03-15,San Luis Obispo,079,281455,52229,52060,3770,55830,458
2022-03-15,San Mateo,081,765935,120815,119586,6970,126556,649
2022-03-15,Santa Barbara,083,443738,85439,85353,4758,90111,668
2022-03-15,Santa Clara,085,1922200,309259,309535,12354,321889,2224
2022-03-15,Santa Cruz,087,273765,47386,47117,2118,49235,255
2022-03-15,Shasta,089,179085,30461,30476,6133,36609,524
2022-03-15,Sierra,091,2930,271,273,48,321,4
2022-03-15,Siskiyou,093,43540,4431,4420,2747,7167,76
2022-03-15,Solano,095,438530,81053,81260,5518,86778,440
2022-03-15,Sonoma,097,501317,82990,82737,2546,85283,472
2022-03-15,Stanislaus,099,539301,117077,118085,17309,135394,1567
2022-03-15,Sutter,101,95872,20429,20480,2079,22559,217
2022-03-15,Tehama,103,63373,12016,11997,2619,14616,160
2022-03-15,Trinity,105,12862,1181,1173,295,1468,20
2022-03-15,Tulare,107,460477,106427,104153,28611,132764,1375
2022-03-15,Tuolumne,109,53932,12583,12602,565,13167,180
2022-03-15,Ventura,111,848112,172569,172150,9274,181424,1451
2022-03-15,Yolo,113,214977,36548,36079,3177,39256,308
2022-03-15,Yuba,115,75493,15782,15756,1197,16953,116
2022-03-14,Alameda,001,1643700,254128,253629,13498,267127,1791
2022-03-14,Alpine,003,1148,122,122,1,123,0
2022-03-14,Amador,005,37829,8497,8448,650,9098,85
2022-03-14,Butte,007,227075,32864,32812,6591,39403,385
2022-03-14,Calaveras,009,45235,7236,7245,352,7597,118
2022-03-14,Colusa,011,21464,3435,3445,1073,4518,21
2022-03-14,Contra Costa,013,1133247,187367,186969,13188,200157,1265
2022-03-14,Del Norte,015,27424,5759,5807,190,5997,48
2022-03-14,El Dorado,017,186661,26593,26570,3202,29772,199
2022-03-14,Fresno,019,978130,230700,228470,23723,252193,2682
2022-03-14,Glenn,021,27897,4966,4966,1603,6569,44
2022-03-14,Humboldt,023,135768,16806,16890,2956,19846,137
2022-03-14,Imperial,025,180216,55250,54933,10855,65788,897
2022-03-14,Inyo,027,18085,4060,4062,481,4543,56
2022-03-14,Kern,029,883053,191349,190526,46191,236717,2166
2022-03-14,Kings,031,150075,51333,51293,3605,54898,437
2022-03-14,Lake,033,64148,10644,10631,893,11524,131
2022-03-14,Lassen,035,31185,8952,8927,884,9811,62
2022-03-14,Los Angeles,037,10098052,2697848,2683369,124353,2807722,31034
2022-03-14,Madera,039,155013,37184,37255,6029,43284,354
2022-03-14,Marin,041,260295,33190,33099,2198,35297,272
2022-03-14,Mariposa,043,17540,2381,2376,201,2577,6
2022-03-14,Mendocino,045,87422,13002,12992,3012,16004,117
2022-03-14,Merced,047,269075,61926,61905,8628,70533,795
2022-03-14,Modoc,049,8938,734,731,251,982,7
2022-03-14,Mono,051,14174,2963,2961,121,3082,5
2022-03-14,Monterey,053,433212,79073,78376,13721,92097,718
2022-03-14,Napa,055,140530,25665,25649,956,26605,138
2022-03-14,Nevada,057,99092,15896,15954,1204,17158,123
2022-03-14,Orange,059,3164182,544456,543099,41293,584392,6775
2022-03-14,Placer,061,380077,62469,62389,7388,69777,601
2022-03-14,Plumas,063,18699,2960,2711,357,3068,13
2022-03-14,Riverside,065,2383286,589453,588531,28023,616554,6332
2022-03-14,Sacramento,067,1510023,279776,274682,27236,301918,2899
2022-03-14,San Benito,069,59416,12869,12846,514,13360,95
2022-03-14,San Bernardino,071,2135413,564492,559505,24784,584289,6767
2022-03-14,San Diego,073,3302833,749849,745515,51920,797435,5108
2022-03-14,San Francisco,075,870044,122950,123575,8237,131812,824
2022-03-14,San Joaquin,077,732212,165668,165662,9552,175214,2142
2022-03-14,San Luis Obispo,079,281455,52202,52046,3767,55813,458
2022-03-14,San Mateo,081,765935,120742,119564,6967,126531,649
2022-03-14,Santa Barbara,083,443738,85402,85396,4757,90153,667
2022-03-14,Santa Clara,085,1922200,309070,309600,12351,321951,2223
2022-03-14,Santa Cruz,087,273765,47347,47107,2115,49222,255
2022-03-14,Shasta,089,179085,30456,30462,6130,36592,520
2022-03-14,Sierra,091,2930,271,273,48,321,4
2022-03-14,Siskiyou,093,43540,4426,4419,2746,7165,76
2022-03-14,Solano,095,438530,81005,81233,5513,86746,440
2022-03-14,Sonoma,097,501317,82956,82731,2542,85273,473
2022-03-14,Stanislaus,099,539301,117039,118088,17306,135394,1567
2022-03-14,Sutter,101,95872,20422,20478,2079,22557,217
2022-03-14,Tehama,103,63373,12014,11996,2619,14615,160
2022-03-14,Trinity,105,12862,1181,1172,295,1467,20
2022-03-14,Tulare,107,460477,106397,104121,28600,132721,1365
2022-03-14,Tuolumne,109,53932,12582,12567,564,13131,180
2022-03-14,Ventura,111,848112,172516,172107,9272,181379,1442
2022-03-14,Yolo,113,214977,36533,36059,3175,39234,308
2022-03-14,Yuba,115,75493,15771,15748,1197,16945,116
2022-03-13,Alameda,001,1643700,254002,253547,13489,267036,1792
2022-03-13,Alpine,003,1148,122,122,1,123,0
2022-03-13,Amador,005,37829,8495,8444,650,9094,85
2022-03-13,Butte,007,227075,32845,32806,6587,39393,384
2022-03-13,Calaveras,009,45235,7231,7253,352,7605,118
2022-03-13,Colusa,011,21464,3435,3444,1071,4515,21
2022-03-13,Contra Costa,013,1133247,187273,186911,13173,200084,1265
2022-03-13,Del Norte,015,27424,5755,5808,190,5998,48
2022-03-13,El Dorado,017,186661,26588,26563,3201,29764,199
2022-03-13,Fresno,019,978130,230620,228421,23710,252131,2683
2022-03-13,Glenn,021,27897,4962,4966,1602,6568,44
2022-03-13,Humboldt,023,135768,16798,16883,2956,19839,137
2022-03-13,Imperial,025,180216,55240,54934,10853,65787,897
2022-03-13,Inyo,027,18085,4060,4062,480,4542,56
2022-03-13,Kern,029,883053,191295,190495,46177,236672,2166
2022-03-13,Kings,031,150075,51325,51273,3604,54877,437
2022-03-13,Lake,033,64148,10641,10626,893,11519,131
2022-03-13,Lassen,035,31185,8951,8929,883,9812,62
2022-03-13,Los Angeles,037,10098052,2697122,2683351,124309,2807660,31034
2022-03-13,Madera,039,155013,37176,37248,6029,43277,354
2022-03-13,Marin,041,260295,33165,33083,2196,35279,272
2022-03-13,Mariposa,043,17540,2379,2376,201,2577,6
2022-03-13,Mendocino,045,87422,12996,12987,3007,15994,117
2022-03-13,Merced,047,269075,61902,61895,8617,70512,795
2022-03-13,Modoc,049,8938,734,731,251,982,7
2022-03-13,Mono,051,14174,2963,2961,121,3082,5
2022-03-13,Monterey,053,433212,79037,78366,13671,92037,718
2022-03-13,Napa,055,140530,25650,25639,955,26594,138
2022-03-13,Nevada,057,99092,15889,15959,1204,17163,123
2022-03-13,Orange,059,3164182,544335,543036,41269,584305,6774
2022-03-13,Placer,061,380077,62442,62372,7385,69757,601
2022-03-13,Plumas,063,18699,2960,2711,357,3068,13
2022-03-13,Riverside,065,2383286,589319,588487,28017,616504,6332
2022-03-13,Sacramento,067,1510023,279674,274715,27224,301939,2899
2022-03-13,San Benito,069,59416,12863,12844,512,13356,95
2022-03-13,San Bernardino,071,2135413,564396,559450,24775,584225,6767
2022-03-13,San Diego,073,3302833,749499,745515,51886,797401,5108
2022-03-13,San Francisco,075,870044,122827,123622,8231,131853,824
2022-03-13,San Joaquin,077,732212,165620,165641,9550,175191,2142
2022-03-13,San Luis Obispo,079,281455,52172,52040,3764,55804,458
2022-03-13,San Mateo,081,765935,120664,119521,6958,126479,649
2022-03-13,Santa Barbara,083,443738,85360,85453,4755,90208,667
2022-03-13,Santa Clara,085,1922200,308900,309493,12341,321834,2225
2022-03-13,Santa Cruz,087,273765,47296,47087,2114,49201,255
2022-03-13,Shasta,089,179085,30439,30457,6128,36585,520
2022-03-13,Sierra,091,2930,271,273,48,321,4
2022-03-13,Siskiyou,093,43540,4426,4418,2746,7164,76
2022-03-13,Solano,095,438530,80970,81217,5509,86726,440
2022-03-13,Sonoma,097,501317,82919,82711,2539,85250,473
2022-03-13,Stanislaus,099,539301,117007,118075,17303,135378,1567
2022-03-13,Sutter,101,95872,20418,20474,2078,22552,217
2022-03-13,Tehama,103,63373,12013,11997,2618,14615,160
2022-03-13,Trinity,105,12862,1181,1172,295,1467,20
2022-03-13,Tulare,107,460477,106359,104119,28588,132707,1365
2022-03-13,Tuolumne,109,53932,12579,12565,564,13129,180
2022-03-13,Ventura,111,848112,172458,172080,9266,181346,1442
2022-03-13,Yolo,113,214977,36517,36019,3171,39190,308
2022-03-13,Yuba,115,75493,15766,15741,1197,16938,116
2022-03-12,Alameda,001,1643700,253937,253079,13484,266563,1783
2022-03-12,Alpine,003,1148,122,122,1,123,0
2022-03-12,Amador,005,37829,8491,8427,650,9077,84
2022-03-12,Butte,007,227075,32841,32774,6585,39359,380
2022-03-12,Calaveras,009,45235,7230,7253,352,7605,118
2022-03-12,Colusa,011,21464,3435,3440,1071,4511,21
2022-03-12,Contra Costa,013,1133247,187229,186618,13172,199790,1256
2022-03-12,Del Norte,015,27424,5754,5791,190,5981,48
2022-03-12,El Dorado,017,186661,26584,26538,3201,29739,199
2022-03-12,Fresno,019,978130,230597,228041,23710,251751,2653
2022-03-12,Glenn,021,27897,4962,4955,1602,6557,44
2022-03-12,Humboldt,023,135768,16794,16862,2955,19817,137
2022-03-12,Imperial,025,180216,55236,54837,10849,65686,896
2022-03-12,Inyo,027,18085,4060,4056,480,4536,56
2022-03-12,Kern,029,883053,191278,190330,46172,236502,2162
2022-03-12,Kings,031,150075,51319,51145,3604,54749,436
2022-03-12,Lake,033,64148,10638,10594,892,11486,131
2022-03-12,Lassen,035,31185,8950,8915,883,9798,62
2022-03-12,Los Angeles,037,10098052,2696803,2678858,124290,2803148,30901
2022-03-12,Madera,039,155013,37172,37223,6029,43252,354
2022-03-12,Marin,041,260295,33141,33015,2195,35210,272
2022-03-12,Mariposa,043,17540,2379,2372,201,2573,6
2022-03-12,Mendocino,045,87422,12991,12965,3007,15972,117
2022-03-12,Merced,047,269075,61897,61840,8616,70456,795
2022-03-12,Modoc,049,8938,734,730,251,981,7
2022-03-12,Mono,051,14174,2963,2960,120,3080,5
2022-03-12,Monterey,053,433212,79030,78285,13669,91954,716
2022-03-12,Napa,055,140530,25640,25584,954,26538,138
2022-03-12,Nevada,057,99092,15882,15947,1204,17151,123
2022-03-12,Orange,059,3164182,544270,542354,41260,583614,6718
2022-03-12,Placer,061,380077,62433,62282,7385,69667,598
2022-03-12,Plumas,063,18699,2960,2707,357,3064,13
2022-03-12,Riverside,065,2383286,589256,588022,28012,616034,6317
2022-03-12,Sacramento,067,1510023,279634,274519,27220,301739,2886
2022-03-12,San Benito,069,59416,12860,12868,512,13380,95
2022-03-12,San Bernardino,071,2135413,564354,559013,24774,583787,6734
2022-03-12,San Diego,073,3302833,749369,744386,51864,796250,5090
2022-03-12,San Francisco,075,870044,122763,123610,8225,131835,823
2022-03-12,San Joaquin,077,732212,165603,165516,9547,175063,2117
2022-03-12,San Luis Obispo,079,281455,52163,51947,3761,55708,457
2022-03-12,San Mateo,081,765935,120627,119288,6957,126245,641
2022-03-12,Santa Barbara,083,443738,85342,85421,4755,90176,664
2022-03-12,Santa Clara,085,1922200,308802,308989,12335,321324,2208
2022-03-12,Santa Cruz,087,273765,47283,46982,2113,49095,254
2022-03-12,Shasta,089,179085,30427,30419,6126,36545,517
2022-03-12,Sierra,091,2930,271,273,48,321,4
2022-03-12,Siskiyou,093,43540,4426,4405,2746,7151,75
2022-03-12,Solano,095,438530,80956,81058,5509,86567,436
2022-03-12,Sonoma,097,501317,82902,82622,2537,85159,473
2022-03-12,Stanislaus,099,539301,116993,117884,17302,135186,1564
2022-03-12,Sutter,101,95872,20416,20429,2078,22507,217
2022-03-12,Tehama,103,63373,12013,11983,2618,14601,159
2022-03-12,Trinity,105,12862,1180,1172,295,1467,20
2022-03-12,Tulare,107,460477,106353,103994,28583,132577,1358
2022-03-12,Tuolumne,109,53932,12578,12476,564,13040,180
2022-03-12,Ventura,111,848112,172433,171932,9264,181196,1442
2022-03-12,Yolo,113,214977,36510,35982,3169,39151,308
2022-03-12,Yuba,115,75493,15766,15722,1197,16919,116
2022-03-11,Alameda,001,1643700,253871,253079,13484,266563,1783
2022-03-11,Alpine,003,1148,122,122,1,123,0
2022-03-11,Amador,005,37829,8489,8427,650,9077,84
2022-03-11,Butte,007,227075,32837,32774,6584,39358,380
2022-03-11,Calaveras,009,45235,7230,7253,352,7605,118
2022-03-11,Colusa,011,21464,3435,3440,1071,4511,21
2022-03-11,Contra Costa,013,1133247,187181,186618,13170,199788,1256
2022-03-11,Del Norte,015,27424,5750,5791,190,5981,48
2022-03-11,El Dorado,017,186661,26580,26538,3201,29739,199
2022-03-11,Fresno,019,978130,230541,228041,23707,251748,2653
2022-03-11,Glenn,021,27897,4962,4955,1602,6557,44
2022-03-11,Humboldt,023,135768,16789,16862,2953,19815,137
2022-03-11,Imperial,025,180216,55229,54837,10848,65685,896
2022-03-11,Inyo,027,18085,4060,4056,480,4536,56
2022-03-11,Kern,029,883053,191257,190330,46167,236497,2162
2022-03-11,Kings,031,150075,51299,51145,3604,54749,436
2022-03-11,Lake,033,64148,10634,10594,892,11486,131
2022-03-11,Lassen,035,31185,8949,8915,883,9798,62
2022-03-11,Los Angeles,037,10098052,2696480,2678858,124265,2803123,30901
2022-03-11,Madera,039,155013,37167,37223,6029,43252,354
2022-03-11,Marin,041,260295,33125,33015,2194,35209,272
2022-03-11,Mariposa,043,17540,2379,2372,201,2573,6
2022-03-11,Mendocino,045,87422,12985,12965,3007,15972,117
2022-03-11,Merced,047,269075,61887,61840,8614,70454,795
2022-03-11,Modoc,049,8938,734,730,251,981,7
2022-03-11,Mono,051,14174,2962,2960,120,3080,5
2022-03-11,Monterey,053,433212,79017,78285,13663,91948,716
2022-03-11,Napa,055,140530,25630,25584,954,26538,138
2022-03-11,Nevada,057,99092,15879,15947,1204,17151,123
2022-03-11,Orange,059,3164182,544200,542354,41246,583600,6718
2022-03-11,Placer,061,380077,62423,62282,7384,69666,598
2022-03-11,Plumas,063,18699,2958,2707,357,3064,13
2022-03-11,Riverside,065,2383286,589183,588022,28008,616030,6317
2022-03-11,Sacramento,067,1510023,279567,274519,27217,301736,2886
2022-03-11,San Benito,069,59416,12859,12868,512,13380,95
2022-03-11,San Bernardino,071,2135413,564298,559013,24768,583781,6734
2022-03-11,San Diego,073,3302833,749202,744386,51850,796236,5090
2022-03-11,San Francisco,075,870044,122713,123610,8221,131831,823
2022-03-11,San Joaquin,077,732212,165570,165516,9544,175060,2117
2022-03-11,San Luis Obispo,079,281455,52155,51947,3760,55707,457
2022-03-11,San Mateo,081,765935,120578,119288,6954,126242,641
2022-03-11,Santa Barbara,083,443738,85322,85421,4754,90175,664
2022-03-11,Santa Clara,085,1922200,308701,308989,12331,321320,2208
2022-03-11,Santa Cruz,087,273765,47268,46982,2113,49095,254
2022-03-11,Shasta,089,179085,30422,30419,6123,36542,517
2022-03-11,Sierra,091,2930,271,273,48,321,4
2022-03-11,Siskiyou,093,43540,4424,4405,2744,7149,75
2022-03-11,Solano,095,438530,80942,81058,5508,86566,436
2022-03-11,Sonoma,097,501317,82877,82622,2535,85157,473
2022-03-11,Stanislaus,099,539301,116980,117884,17301,135185,1564
2022-03-11,Sutter,101,95872,20414,20429,2078,22507,217
2022-03-11,Tehama,103,63373,12011,11983,2618,14601,159
2022-03-11,Trinity,105,12862,1180,1172,295,1467,20
2022-03-11,Tulare,107,460477,106340,103994,28577,132571,1358
2022-03-11,Tuolumne,109,53932,12576,12476,564,13040,180
2022-03-11,Ventura,111,848112,172397,171932,9259,181191,1442
2022-03-11,Yolo,113,214977,36498,35982,3169,39151,308
2022-03-11,Yuba,115,75493,15763,15722,1197,16919,116
2022-03-10,Alameda,001,1643700,253759,253079,13477,266556,1783
2022-03-10,Alpine,003,1148,122,122,1,123,0
2022-03-10,Amador,005,37829,8488,8427,650,9077,84
2022-03-10,Butte,007,227075,32823,32774,6582,39356,380
2022-03-10,Calaveras,009,45235,7229,7253,351,7604,118
2022-03-10,Colusa,011,21464,3435,3440,1071,4511,21
2022-03-10,Contra Costa,013,1133247,187096,186618,13160,199778,1256
2022-03-10,Del Norte,015,27424,5741,5791,190,5981,48
2022-03-10,El Dorado,017,186661,26568,26538,3200,29738,199
2022-03-10,Fresno,019,978130,230466,228041,23698,251739,2653
2022-03-10,Glenn,021,27897,4960,4955,1602,6557,44
2022-03-10,Humboldt,023,135768,16780,16862,2952,19814,137
2022-03-10,Imperial,025,180216,55219,54837,10847,65684,896
2022-03-10,Inyo,027,18085,4059,4056,480,4536,56
2022-03-10,Kern,029,883053,191223,190330,46152,236482,2162
2022-03-10,Kings,031,150075,51270,51145,3603,54748,436
2022-03-10,Lake,033,64148,10624,10594,891,11485,131
2022-03-10,Lassen,035,31185,8949,8915,883,9798,62
2022-03-10,Los Angeles,037,10098052,2695928,2678858,124226,2803084,30901
2022-03-10,Madera,039,155013,37160,37223,6022,43245,354
2022-03-10,Marin,041,260295,33111,33015,2190,35205,272
2022-03-10,Mariposa,043,17540,2379,2372,201,2573,6
2022-03-10,Mendocino,045,87422,12981,12965,3007,15972,117
2022-03-10,Merced,047,269075,61870,61840,8608,70448,795
2022-03-10,Modoc,049,8938,733,730,251,981,7
2022-03-10,Mono,051,14174,2962,2960,120,3080,5
2022-03-10,Monterey,053,433212,78994,78285,13637,91922,716
2022-03-10,Napa,055,140530,25621,25584,953,26537,138
2022-03-10,Nevada,057,99092,15872,15947,1204,17151,123
2022-03-10,Orange,059,3164182,544077,542354,41230,583584,6718
2022-03-10,Placer,061,380077,62402,62282,7379,69661,598
2022-03-10,Plumas,063,18699,2957,2707,357,3064,13
2022-03-10,Riverside,065,2383286,589069,588022,28001,616023,6317
2022-03-10,Sacramento,067,1510023,279488,274519,27211,301730,2886
2022-03-10,San Benito,069,59416,12858,12868,511,13379,95
2022-03-10,San Bernardino,071,2135413,564227,559013,24760,583773,6734
2022-03-10,San Diego,073,3302833,748938,744386,51818,796204,5090
2022-03-10,San Francisco,075,870044,122646,123610,8214,131824,823
2022-03-10,San Joaquin,077,732212,165542,165516,9542,175058,2117
2022-03-10,San Luis Obispo,079,281455,52132,51947,3757,55704,457
2022-03-10,San Mateo,081,765935,120514,119288,6951,126239,641
2022-03-10,Santa Barbara,083,443738,85290,85421,4753,90174,664
2022-03-10,Santa Clara,085,1922200,308573,308989,12321,321310,2208
2022-03-10,Santa Cruz,087,273765,47235,46982,2113,49095,254
2022-03-10,Shasta,089,179085,30415,30419,6121,36540,517
2022-03-10,Sierra,091,2930,271,273,48,321,4
2022-03-10,Siskiyou,093,43540,4424,4405,2744,7149,75
2022-03-10,Solano,095,438530,80906,81058,5507,86565,436
2022-03-10,Sonoma,097,501317,82850,82622,2535,85157,473
2022-03-10,Stanislaus,099,539301,116941,117884,17299,135183,1564
2022-03-10,Sutter,101,95872,20409,20429,2078,22507,217
2022-03-10,Tehama,103,63373,12010,11983,2618,14601,159
2022-03-10,Trinity,105,12862,1180,1172,295,1467,20
2022-03-10,Tulare,107,460477,106320,103994,28571,132565,1358
2022-03-10,Tuolumne,109,53932,12573,12476,564,13040,180
2022-03-10,Ventura,111,848112,172356,171932,9256,181188,1442
2022-03-10,Yolo,113,214977,36483,35982,3168,39150,308
2022-03-10,Yuba,115,75493,15753,15722,1196,16918,116
2022-03-09,Alameda,001,1643700,253633,252893,13470,266363,1781
2022-03-09,Alpine,003,1148,122,125,1,126,0
2022-03-09,Amador,005,37829,8482,8409,650,9059,84
2022-03-09,Butte,007,227075,32814,32767,6577,39344,380
2022-03-09,Calaveras,009,45235,7227,7249,351,7600,117
2022-03-09,Colusa,011,21464,3434,3439,1071,4510,21
2022-03-09,Contra Costa,013,1133247,187003,186483,13144,199627,1256
2022-03-09,Del Norte,015,27424,5737,5765,190,5955,48
2022-03-09,El Dorado,017,186661,26563,26515,3200,29715,198
2022-03-09,Fresno,019,978130,230368,227885,23689,251574,2653
2022-03-09,Glenn,021,27897,4958,4953,1601,6554,44
2022-03-09,Humboldt,023,135768,16775,16854,2949,19803,137
2022-03-09,Imperial,025,180216,55212,54764,10845,65609,894
2022-03-09,Inyo,027,18085,4059,4056,480,4536,56
2022-03-09,Kern,029,883053,191172,190254,46139,236393,2159
2022-03-09,Kings,031,150075,51250,51122,3603,54725,435
2022-03-09,Lake,033,64148,10618,10586,891,11477,130
2022-03-09,Lassen,035,31185,8949,8901,883,9784,62
2022-03-09,Los Angeles,037,10098052,2695284,2677901,124186,2802087,30842
2022-03-09,Madera,039,155013,37153,37207,6021,43228,354
2022-03-09,Marin,041,260295,33093,32967,2190,35157,272
2022-03-09,Mariposa,043,17540,2376,2372,201,2573,6
2022-03-09,Mendocino,045,87422,12977,12957,3002,15959,117
2022-03-09,Merced,047,269075,61854,61792,8602,70394,792
2022-03-09,Modoc,049,8938,732,730,250,980,7
2022-03-09,Mono,051,14174,2962,2962,120,3082,5
2022-03-09,Monterey,053,433212,78970,78258,13590,91848,716
2022-03-09,Napa,055,140530,25600,25561,952,26513,138
2022-03-09,Nevada,057,99092,15863,15938,1203,17141,123
2022-03-09,Orange,059,3164182,543944,542278,41217,583495,6700
2022-03-09,Placer,061,380077,62379,62242,7375,69617,598
2022-03-09,Plumas,063,18699,2956,2708,357,3065,13
2022-03-09,Riverside,065,2383286,588972,587833,27991,615824,6305
2022-03-09,Sacramento,067,1510023,279404,274373,27194,301567,2877
2022-03-09,San Benito,069,59416,12855,12864,511,13375,95
2022-03-09,San Bernardino,071,2135413,564134,558795,24748,583543,6723
2022-03-09,San Diego,073,3302833,748661,743956,51791,795747,5083
2022-03-09,San Francisco,075,870044,122558,123676,8209,131885,812
2022-03-09,San Joaquin,077,732212,165503,165444,9536,174980,2113
2022-03-09,San Luis Obispo,079,281455,52113,51923,3754,55677,457
2022-03-09,San Mateo,081,765935,120456,119194,6939,126133,639
2022-03-09,Santa Barbara,083,443738,85273,85382,4751,90133,661
2022-03-09,Santa Clara,085,1922200,308443,308765,12310,321075,2206
2022-03-09,Santa Cruz,087,273765,47195,46917,2112,49029,254
2022-03-09,Shasta,089,179085,30395,30407,6120,36527,493
2022-03-09,Sierra,091,2930,271,273,48,321,4
2022-03-09,Siskiyou,093,43540,4422,4403,2743,7146,75
2022-03-09,Solano,095,438530,80870,80984,5505,86489,436
2022-03-09,Sonoma,097,501317,82817,82574,2533,85107,473
2022-03-09,Stanislaus,099,539301,116904,117827,17294,135121,1541
2022-03-09,Sutter,101,95872,20398,20409,2074,22483,217
2022-03-09,Tehama,103,63373,12006,11980,2618,14598,159
2022-03-09,Trinity,105,12862,1180,1174,295,1469,20
2022-03-09,Tulare,107,460477,106292,103932,28556,132488,1350
2022-03-09,Tuolumne,109,53932,12571,12444,564,13008,180
2022-03-09,Ventura,111,848112,172306,171852,9253,181105,1448
2022-03-09,Yolo,113,214977,36464,35973,3153,39126,308
2022-03-09,Yuba,115,75493,15748,15714,1195,16909,115
2022-03-08,Alameda,001,1643700,253478,252744,13458,266202,1769
2022-03-08,Alpine,003,1148,122,125,1,126,0
2022-03-08,Amador,005,37829,8468,8407,650,9057,84
2022-03-08,Butte,007,227075,32800,32759,6572,39331,380
2022-03-08,Calaveras,009,45235,7223,7245,351,7596,117
2022-03-08,Colusa,011,21464,3431,3439,1070,4509,21
2022-03-08,Contra Costa,013,1133247,186917,186396,13130,199526,1256
2022-03-08,Del Norte,015,27424,5732,5763,190,5953,48
2022-03-08,El Dorado,017,186661,26553,26503,3194,29697,197
2022-03-08,Fresno,019,978130,230268,227808,23681,251489,2653
2022-03-08,Glenn,021,27897,4957,4944,1600,6544,43
2022-03-08,Humboldt,023,135768,16763,16837,2936,19773,137
2022-03-08,Imperial,025,180216,55196,54721,10843,65564,890
2022-03-08,Inyo,027,18085,4056,4056,480,4536,56
2022-03-08,Kern,029,883053,191110,190208,46124,236332,2154
2022-03-08,Kings,031,150075,51208,51089,3600,54689,434
2022-03-08,Lake,033,64148,10607,10571,891,11462,130
2022-03-08,Lassen,035,31185,8948,8897,883,9780,62
2022-03-08,Los Angeles,037,10098052,2694592,2677166,124147,2801313,30803
2022-03-08,Madera,039,155013,37141,37185,6020,43205,354
2022-03-08,Marin,041,260295,33054,32943,2189,35132,272
2022-03-08,Mariposa,043,17540,2374,2371,201,2572,6
2022-03-08,Mendocino,045,87422,12973,12950,3001,15951,117
2022-03-08,Merced,047,269075,61834,61767,8591,70358,791
2022-03-08,Modoc,049,8938,731,729,250,979,7
2022-03-08,Mono,051,14174,2961,2961,120,3081,5
2022-03-08,Monterey,053,433212,78950,78247,13550,91797,711
2022-03-08,Napa,055,140530,25575,25528,951,26479,137
2022-03-08,Nevada,057,99092,15853,15939,1202,17141,122
2022-03-08,Orange,059,3164182,543794,542164,41196,583360,6692
2022-03-08,Placer,061,380077,62351,62221,7374,69595,594
2022-03-08,Plumas,063,18699,2956,2703,357,3060,13
2022-03-08,Riverside,065,2383286,588863,587686,27982,615668,6294
2022-03-08,Sacramento,067,1510023,279311,274276,27174,301450,2872
2022-03-08,San Benito,069,59416,12852,12855,511,13366,94
2022-03-08,San Bernardino,071,2135413,564043,558512,24738,583250,6715
2022-03-08,San Diego,073,3302833,748306,743604,51774,795378,5077
2022-03-08,San Francisco,075,870044,122468,123675,8204,131879,807
2022-03-08,San Joaquin,077,732212,165466,165381,9532,174913,2104
2022-03-08,San Luis Obispo,079,281455,52087,51900,3751,55651,451
2022-03-08,San Mateo,081,765935,120374,119103,6929,126032,638
2022-03-08,Santa Barbara,083,443738,85241,85363,4751,90114,659
2022-03-08,Santa Clara,085,1922200,308235,308528,12301,320829,2206
2022-03-08,Santa Cruz,087,273765,47159,46875,2111,48986,254
2022-03-08,Shasta,089,179085,30376,30372,6117,36489,493
2022-03-08,Sierra,091,2930,271,273,48,321,4
2022-03-08,Siskiyou,093,43540,4418,4404,2743,7147,74
2022-03-08,Solano,095,438530,80842,80924,5501,86425,434
2022-03-08,Sonoma,097,501317,82772,82571,2532,85103,473
2022-03-08,Stanislaus,099,539301,116860,117782,17285,135067,1541
2022-03-08,Sutter,101,95872,20389,20403,2074,22477,217
2022-03-08,Tehama,103,63373,12002,11972,2617,14589,158
2022-03-08,Trinity,105,12862,1180,1174,295,1469,20
2022-03-08,Tulare,107,460477,106252,103893,28544,132437,1334
2022-03-08,Tuolumne,109,53932,12566,12427,562,12989,180
2022-03-08,Ventura,111,848112,172243,171806,9246,181052,1447
2022-03-08,Yolo,113,214977,36439,35946,3152,39098,306
2022-03-08,Yuba,115,75493,15741,15705,1194,16899,115
2022-03-07,Alameda,001,1643700,253276,252578,13442,266020,1766
2022-03-07,Alpine,003,1148,122,125,1,126,0
2022-03-07,Amador,005,37829,8465,8368,650,9018,84
2022-03-07,Butte,007,227075,32785,32734,6569,39303,378
2022-03-07,Calaveras,009,45235,7219,7242,351,7593,116
2022-03-07,Colusa,011,21464,3429,3437,1070,4507,21
2022-03-07,Contra Costa,013,1133247,186819,186087,13106,199193,1256
2022-03-07,Del Norte,015,27424,5728,5758,190,5948,48
2022-03-07,El Dorado,017,186661,26546,26487,3193,29680,196
2022-03-07,Fresno,019,978130,230179,227670,23659,251329,2653
2022-03-07,Glenn,021,27897,4951,4939,1600,6539,43
2022-03-07,Humboldt,023,135768,16750,16829,2931,19760,137
2022-03-07,Imperial,025,180216,55173,54712,10838,65550,890
2022-03-07,Inyo,027,18085,4054,4054,480,4534,56
2022-03-07,Kern,029,883053,191050,190163,46099,236262,2152
2022-03-07,Kings,031,150075,51178,51065,3594,54659,433
2022-03-07,Lake,033,64148,10597,10562,890,11452,130
2022-03-07,Lassen,035,31185,8947,8896,883,9779,62
2022-03-07,Los Angeles,037,10098052,2693776,2675497,124106,2799603,30759
2022-03-07,Madera,039,155013,37131,37164,6017,43181,354
2022-03-07,Marin,041,260295,33016,32919,2186,35105,272
2022-03-07,Mariposa,043,17540,2373,2369,201,2570,6
2022-03-07,Mendocino,045,87422,12965,12940,3000,15940,117
2022-03-07,Merced,047,269075,61795,61751,8584,70335,791
2022-03-07,Modoc,049,8938,731,729,250,979,7
2022-03-07,Mono,051,14174,2961,2960,120,3080,5
2022-03-07,Monterey,053,433212,78915,78161,13501,91662,706
2022-03-07,Napa,055,140530,25545,25500,951,26451,136
2022-03-07,Nevada,057,99092,15846,15935,1196,17131,122
2022-03-07,Orange,059,3164182,543619,542028,41170,583198,6687
2022-03-07,Placer,061,380077,62322,62215,7372,69587,591
2022-03-07,Plumas,063,18699,2956,2702,357,3059,13
2022-03-07,Riverside,065,2383286,588731,587537,27974,615511,6279
2022-03-07,Sacramento,067,1510023,279208,274079,27162,301241,2866
2022-03-07,San Benito,069,59416,12846,12843,511,13354,94
2022-03-07,San Bernardino,071,2135413,563935,558265,24726,582991,6703
2022-03-07,San Diego,073,3302833,747960,742287,51731,794018,5068
2022-03-07,San Francisco,075,870044,122366,123655,8198,131853,807
2022-03-07,San Joaquin,077,732212,165414,165343,9524,174867,2091
2022-03-07,San Luis Obispo,079,281455,52046,51874,3746,55620,448
2022-03-07,San Mateo,081,765935,120299,119035,6922,125957,630
2022-03-07,Santa Barbara,083,443738,85203,85345,4750,90095,659
2022-03-07,Santa Clara,085,1922200,308048,308517,12295,320812,2202
2022-03-07,Santa Cruz,087,273765,47108,46823,2110,48933,254
2022-03-07,Shasta,089,179085,30364,30352,6114,36466,493
2022-03-07,Sierra,091,2930,271,273,48,321,4
2022-03-07,Siskiyou,093,43540,4414,4398,2742,7140,74
2022-03-07,Solano,095,438530,80785,80886,5499,86385,435
2022-03-07,Sonoma,097,501317,82729,82530,2531,85061,473
2022-03-07,Stanislaus,099,539301,116823,117713,17277,134990,1537
2022-03-07,Sutter,101,95872,20378,20400,2073,22473,217
2022-03-07,Tehama,103,63373,11996,11966,2614,14580,158
2022-03-07,Trinity,105,12862,1178,1173,295,1468,20
2022-03-07,Tulare,107,460477,106215,103834,28532,132366,1316
2022-03-07,Tuolumne,109,53932,12558,12408,561,12969,179
2022-03-07,Ventura,111,848112,172192,171886,9244,181130,1436
2022-03-07,Yolo,113,214977,36415,35934,3146,39080,306
2022-03-07,Yuba,115,75493,15735,15701,1193,16894,115
2022-03-06,Alameda,001,1643700,253093,252460,13433,265893,1766
2022-03-06,Alpine,003,1148,122,125,1,126,0
2022-03-06,Amador,005,37829,8462,8367,648,9015,84
2022-03-06,Butte,007,227075,32776,32714,6565,39279,376
2022-03-06,Calaveras,009,45235,7217,7236,350,7586,116
2022-03-06,Colusa,011,21464,3429,3435,1069,4504,21
2022-03-06,Contra Costa,013,1133247,186703,185974,13080,199054,1256
2022-03-06,Del Norte,015,27424,5713,5744,188,5932,48
2022-03-06,El Dorado,017,186661,26537,26478,3191,29669,196
2022-03-06,Fresno,019,978130,230035,227514,23648,251162,2653
2022-03-06,Glenn,021,27897,4946,4939,1600,6539,43
2022-03-06,Humboldt,023,135768,16738,16813,2928,19741,137
2022-03-06,Imperial,025,180216,55157,54719,10826,65545,890
2022-03-06,Inyo,027,18085,4051,4053,480,4533,56
2022-03-06,Kern,029,883053,190994,190088,46077,236165,2152
2022-03-06,Kings,031,150075,51109,51050,3591,54641,432
2022-03-06,Lake,033,64148,10583,10539,889,11428,130
2022-03-06,Lassen,035,31185,8934,8887,882,9769,62
2022-03-06,Los Angeles,037,10098052,2692845,2675456,124051,2799507,30759
2022-03-06,Madera,039,155013,37103,37135,6009,43144,354
2022-03-06,Marin,041,260295,32990,32879,2185,35064,272
2022-03-06,Mariposa,043,17540,2372,2365,200,2565,6
2022-03-06,Mendocino,045,87422,12953,12923,2996,15919,116
2022-03-06,Merced,047,269075,61763,61722,8567,70289,791
2022-03-06,Modoc,049,8938,731,729,250,979,7
2022-03-06,Mono,051,14174,2961,2959,120,3079,5
2022-03-06,Monterey,053,433212,78868,78154,13469,91623,706
2022-03-06,Napa,055,140530,25510,25457,949,26406,136
2022-03-06,Nevada,057,99092,15835,15924,1195,17119,122
2022-03-06,Orange,059,3164182,543460,541903,41122,583025,6688
2022-03-06,Placer,061,380077,62290,62185,7368,69553,591
2022-03-06,Plumas,063,18699,2951,2704,357,3061,13
2022-03-06,Riverside,065,2383286,588569,587388,27952,615340,6279
2022-03-06,Sacramento,067,1510023,279071,273935,27138,301073,2869
2022-03-06,San Benito,069,59416,12835,12835,510,13345,94
2022-03-06,San Bernardino,071,2135413,563808,558139,24712,582851,6701
2022-03-06,San Diego,073,3302833,747562,742287,51682,793969,5068
2022-03-06,San Francisco,075,870044,122242,123742,8195,131937,806
2022-03-06,San Joaquin,077,732212,165331,165252,9518,174770,2091
2022-03-06,San Luis Obispo,079,281455,52008,51828,3743,55571,448
2022-03-06,San Mateo,081,765935,120216,118916,6913,125829,630
2022-03-06,Santa Barbara,083,443738,85162,85317,4745,90062,659
2022-03-06,Santa Clara,085,1922200,307790,308250,12293,320543,2201
2022-03-06,Santa Cruz,087,273765,47055,46755,2109,48864,254
2022-03-06,Shasta,089,179085,30339,30332,6097,36429,493
2022-03-06,Sierra,091,2930,271,273,48,321,4
2022-03-06,Siskiyou,093,43540,4410,4398,2740,7138,74
2022-03-06,Solano,095,438530,80729,80833,5493,86326,435
2022-03-06,Sonoma,097,501317,82690,82458,2526,84984,473
2022-03-06,Stanislaus,099,539301,116772,117680,17267,134947,1536
2022-03-06,Sutter,101,95872,20363,20390,2069,22459,217
2022-03-06,Tehama,103,63373,11988,11963,2614,14577,158
2022-03-06,Trinity,105,12862,1178,1172,294,1466,20
2022-03-06,Tulare,107,460477,106152,103794,28517,132311,1316
2022-03-06,Tuolumne,109,53932,12553,12379,559,12938,179
2022-03-06,Ventura,111,848112,172123,171819,9242,181061,1436
2022-03-06,Yolo,113,214977,36391,35882,3142,39024,306
2022-03-06,Yuba,115,75493,15730,15694,1192,16886,115
2022-03-05,Alameda,001,1643700,252978,251988,13428,265416,1760
2022-03-05,Alpine,003,1148,122,125,1,126,0
2022-03-05,Amador,005,37829,8459,8344,648,8992,83
2022-03-05,Butte,007,227075,32769,32663,6560,39223,372
2022-03-05,Calaveras,009,45235,7214,7236,350,7586,116
2022-03-05,Colusa,011,21464,3429,3433,1069,4502,21
2022-03-05,Contra Costa,013,1133247,186643,185734,13074,198808,1235
2022-03-05,Del Norte,015,27424,5710,5725,188,5913,48
2022-03-05,El Dorado,017,186661,26530,26446,3188,29634,193
2022-03-05,Fresno,019,978130,229983,227154,23646,250800,2640
2022-03-05,Glenn,021,27897,4945,4927,1600,6527,43
2022-03-05,Humboldt,023,135768,16731,16781,2926,19707,136
2022-03-05,Imperial,025,180216,55147,54650,10824,65474,880
2022-03-05,Inyo,027,18085,4050,4043,479,4522,56
2022-03-05,Kern,029,883053,190962,189817,46059,235876,2141
2022-03-05,Kings,031,150075,51102,50926,3589,54515,431
2022-03-05,Lake,033,64148,10575,10512,888,11400,130
2022-03-05,Lassen,035,31185,8925,8818,882,9700,62
2022-03-05,Los Angeles,037,10098052,2692492,2671564,124013,2795577,30608
2022-03-05,Madera,039,155013,37089,37100,6009,43109,354
2022-03-05,Marin,041,260295,32978,32829,2185,35014,272
2022-03-05,Mariposa,043,17540,2372,2363,200,2563,6
2022-03-05,Mendocino,045,87422,12950,12845,2995,15840,113
2022-03-05,Merced,047,269075,61753,61653,8567,70220,789
2022-03-05,Modoc,049,8938,731,729,250,979,7
2022-03-05,Mono,051,14174,2961,2961,120,3081,5
2022-03-05,Monterey,053,433212,78849,78028,13462,91490,704
2022-03-05,Napa,055,140530,25492,25405,949,26354,134
2022-03-05,Nevada,057,99092,15831,15907,1195,17102,122
2022-03-05,Orange,059,3164182,543336,541463,41111,582574,6638
2022-03-05,Placer,061,380077,62276,62117,7361,69478,591
2022-03-05,Plumas,063,18699,2950,2701,357,3058,13
2022-03-05,Riverside,065,2383286,588478,586785,27948,614733,6239
2022-03-05,Sacramento,067,1510023,279009,273487,27133,300620,2847
2022-03-05,San Benito,069,59416,12833,12820,510,13330,94
2022-03-05,San Bernardino,071,2135413,563753,557421,24706,582127,6641
2022-03-05,San Diego,073,3302833,747364,740747,51671,792418,5045
2022-03-05,San Francisco,075,870044,122178,123537,8190,131727,798
2022-03-05,San Joaquin,077,732212,165290,165085,9510,174595,2069
2022-03-05,San Luis Obispo,079,281455,52001,51739,3740,55479,446
2022-03-05,San Mateo,081,765935,120160,118646,6910,125556,621
2022-03-05,Santa Barbara,083,443738,85147,85249,4745,89994,655
2022-03-05,Santa Clara,085,1922200,307672,307689,12290,319979,2195
2022-03-05,Santa Cruz,087,273765,47035,46622,2109,48731,253
2022-03-05,Shasta,089,179085,30327,30282,6096,36378,492
2022-03-05,Sierra,091,2930,271,273,47,320,4
2022-03-05,Siskiyou,093,43540,4409,4389,2739,7128,74
2022-03-05,Solano,095,438530,80712,80690,5493,86183,435
2022-03-05,Sonoma,097,501317,82667,82313,2526,84839,473
2022-03-05,Stanislaus,099,539301,116747,117501,17265,134766,1531
2022-03-05,Sutter,101,95872,20356,20346,2069,22415,217
2022-03-05,Tehama,103,63373,11986,11939,2614,14553,158
2022-03-05,Trinity,105,12862,1178,1170,292,1462,20
2022-03-05,Tulare,107,460477,106139,103534,28507,132041,1305
2022-03-05,Tuolumne,109,53932,12549,12325,558,12883,178
2022-03-05,Ventura,111,848112,172081,171666,9240,180906,1436
2022-03-05,Yolo,113,214977,36377,35856,3142,38998,306
2022-03-05,Yuba,115,75493,15722,15666,1192,16858,115
2022-03-04,Alameda,001,1643700,252888,251988,13420,265408,1760
2022-03-04,Alpine,003,1148,122,125,1,126,0
2022-03-04,Amador,005,37829,8458,8344,648,8992,83
2022-03-04,Butte,007,227075,32763,32663,6554,39217,372
2022-03-04,Calaveras,009,45235,7213,7236,350,7586,116
2022-03-04,Colusa,011,21464,3427,3433,1069,4502,21
2022-03-04,Contra Costa,013,1133247,186576,185734,13072,198806,1235
2022-03-04,Del Norte,015,27424,5700,5725,188,5913,48
2022-03-04,El Dorado,017,186661,26526,26446,3188,29634,193
2022-03-04,Fresno,019,978130,229919,227154,23640,250794,2640
2022-03-04,Glenn,021,27897,4944,4927,1600,6527,43
2022-03-04,Humboldt,023,135768,16728,16781,2926,19707,136
2022-03-04,Imperial,025,180216,55140,54650,10820,65470,880
2022-03-04,Inyo,027,18085,4050,4043,479,4522,56
2022-03-04,Kern,029,883053,190921,189817,46047,235864,2141
2022-03-04,Kings,031,150075,51089,50926,3589,54515,431
2022-03-04,Lake,033,64148,10574,10512,888,11400,130
2022-03-04,Lassen,035,31185,8923,8818,882,9700,62
2022-03-04,Los Angeles,037,10098052,2691999,2671564,123984,2795548,30608
2022-03-04,Madera,039,155013,37079,37100,6009,43109,354
2022-03-04,Marin,041,260295,32956,32829,2183,35012,272
2022-03-04,Mariposa,043,17540,2367,2363,200,2563,6
2022-03-04,Mendocino,045,87422,12944,12845,2995,15840,113
2022-03-04,Merced,047,269075,61741,61653,8565,70218,789
2022-03-04,Modoc,049,8938,731,729,250,979,7
2022-03-04,Mono,051,14174,2961,2961,120,3081,5
2022-03-04,Monterey,053,433212,78829,78028,13455,91483,704
2022-03-04,Napa,055,140530,25477,25405,948,26353,134
2022-03-04,Nevada,057,99092,15826,15907,1195,17102,122
2022-03-04,Orange,059,3164182,543217,541463,41092,582555,6638
2022-03-04,Placer,061,380077,62265,62117,7357,69474,591
2022-03-04,Plumas,063,18699,2950,2701,356,3057,13
2022-03-04,Riverside,065,2383286,588390,586785,27947,614732,6239
2022-03-04,Sacramento,067,1510023,278939,273487,27129,300616,2847
2022-03-04,San Benito,069,59416,12829,12820,510,13330,94
2022-03-04,San Bernardino,071,2135413,563672,557421,24705,582126,6641
2022-03-04,San Diego,073,3302833,747125,740747,51654,792401,5045
2022-03-04,San Francisco,075,870044,122119,123537,8183,131720,798
2022-03-04,San Joaquin,077,732212,165259,165085,9509,174594,2069
2022-03-04,San Luis Obispo,079,281455,51993,51739,3739,55478,446
2022-03-04,San Mateo,081,765935,120102,118646,6908,125554,621
2022-03-04,Santa Barbara,083,443738,85125,85249,4745,89994,655
2022-03-04,Santa Clara,085,1922200,307524,307689,12287,319976,2195
2022-03-04,Santa Cruz,087,273765,47013,46622,2109,48731,253
2022-03-04,Shasta,089,179085,30319,30282,6093,36375,492
2022-03-04,Sierra,091,2930,271,273,47,320,4
2022-03-04,Siskiyou,093,43540,4407,4389,2735,7124,74
2022-03-04,Solano,095,438530,80679,80690,5490,86180,435
2022-03-04,Sonoma,097,501317,82638,82313,2525,84838,473
2022-03-04,Stanislaus,099,539301,116728,117501,17263,134764,1531
2022-03-04,Sutter,101,95872,20352,20346,2069,22415,217
2022-03-04,Tehama,103,63373,11983,11939,2614,14553,158
2022-03-04,Trinity,105,12862,1178,1170,292,1462,20
2022-03-04,Tulare,107,460477,106121,103534,28502,132036,1305
2022-03-04,Tuolumne,109,53932,12544,12325,558,12883,178
2022-03-04,Ventura,111,848112,172035,171666,9237,180903,1436
2022-03-04,Yolo,113,214977,36360,35856,3142,38998,306
2022-03-04,Yuba,115,75493,15717,15666,1191,16857,115
2022-03-03,Alameda,001,1643700,252768,251988,13408,265396,1760
2022-03-03,Alpine,003,1148,122,125,1,126,0
2022-03-03,Amador,005,37829,8457,8344,648,8992,83
2022-03-03,Butte,007,227075,32746,32663,6548,39211,372
2022-03-03,Calaveras,009,45235,7200,7236,350,7586,116
2022-03-03,Colusa,011,21464,3427,3433,1069,4502,21
2022-03-03,Contra Costa,013,1133247,186502,185734,13059,198793,1235
2022-03-03,Del Norte,015,27424,5693,5725,188,5913,48
2022-03-03,El Dorado,017,186661,26509,26446,3187,29633,193
2022-03-03,Fresno,019,978130,229789,227154,23631,250785,2640
2022-03-03,Glenn,021,27897,4942,4927,1599,6526,43
2022-03-03,Humboldt,023,135768,16714,16781,2925,19706,136
2022-03-03,Imperial,025,180216,55124,54650,10818,65468,880
2022-03-03,Inyo,027,18085,4049,4043,479,4522,56
2022-03-03,Kern,029,883053,190853,189817,46028,235845,2141
2022-03-03,Kings,031,150075,51066,50926,3586,54512,431
2022-03-03,Lake,033,64148,10568,10512,886,11398,130
2022-03-03,Lassen,035,31185,8915,8818,882,9700,62
2022-03-03,Los Angeles,037,10098052,2691278,2671564,123943,2795507,30608
2022-03-03,Madera,039,155013,37062,37100,6004,43104,354
2022-03-03,Marin,041,260295,32929,32829,2183,35012,272
2022-03-03,Mariposa,043,17540,2366,2363,200,2563,6
2022-03-03,Mendocino,045,87422,12933,12845,2992,15837,113
2022-03-03,Merced,047,269075,61724,61653,8559,70212,789
2022-03-03,Modoc,049,8938,731,729,250,979,7
2022-03-03,Mono,051,14174,2960,2961,120,3081,5
2022-03-03,Monterey,053,433212,78801,78028,13437,91465,704
2022-03-03,Napa,055,140530,25454,25405,947,26352,134
2022-03-03,Nevada,057,99092,15821,15907,1190,17097,122
2022-03-03,Orange,059,3164182,543040,541463,41066,582529,6638
2022-03-03,Placer,061,380077,62243,62117,7353,69470,591
2022-03-03,Plumas,063,18699,2949,2701,356,3057,13
2022-03-03,Riverside,065,2383286,588258,586785,27942,614727,6239
2022-03-03,Sacramento,067,1510023,278827,273487,27111,300598,2847
2022-03-03,San Benito,069,59416,12826,12820,510,13330,94
2022-03-03,San Bernardino,071,2135413,563563,557421,24699,582120,6641
2022-03-03,San Diego,073,3302833,746777,740747,51636,792383,5045
2022-03-03,San Francisco,075,870044,122046,123537,8172,131709,798
2022-03-03,San Joaquin,077,732212,165186,165085,9506,174591,2069
2022-03-03,San Luis Obispo,079,281455,51938,51739,3731,55470,446
2022-03-03,San Mateo,081,765935,120027,118646,6898,125544,621
2022-03-03,Santa Barbara,083,443738,85105,85249,4736,89985,655
2022-03-03,Santa Clara,085,1922200,307340,307689,12273,319962,2195
2022-03-03,Santa Cruz,087,273765,46965,46622,2107,48729,253
2022-03-03,Shasta,089,179085,30302,30282,6089,36371,492
2022-03-03,Sierra,091,2930,271,273,47,320,4
2022-03-03,Siskiyou,093,43540,4404,4389,2735,7124,74
2022-03-03,Solano,095,438530,80630,80690,5488,86178,435
2022-03-03,Sonoma,097,501317,82590,82313,2520,84833,473
2022-03-03,Stanislaus,099,539301,116695,117501,17256,134757,1531
2022-03-03,Sutter,101,95872,20344,20346,2069,22415,217
2022-03-03,Tehama,103,63373,11979,11939,2614,14553,158
2022-03-03,Trinity,105,12862,1177,1170,292,1462,20
2022-03-03,Tulare,107,460477,106075,103534,28492,132026,1305
2022-03-03,Tuolumne,109,53932,12534,12325,558,12883,178
2022-03-03,Ventura,111,848112,171982,171666,9235,180901,1436
2022-03-03,Yolo,113,214977,36337,35856,3135,38991,306
2022-03-03,Yuba,115,75493,15711,15666,1186,16852,115
2022-03-02,Alameda,001,1643700,252588,251886,13392,265278,1759
2022-03-02,Alpine,003,1148,122,125,1,126,0
2022-03-02,Amador,005,37829,8445,8341,648,8989,83
2022-03-02,Butte,007,227075,32734,32636,6543,39179,372
2022-03-02,Calaveras,009,45235,7199,7225,350,7575,116
2022-03-02,Colusa,011,21464,3424,3428,1069,4497,21
2022-03-02,Contra Costa,013,1133247,186410,185589,13042,198631,1236
2022-03-02,Del Norte,015,27424,5686,5708,186,5894,47
2022-03-02,El Dorado,017,186661,26495,26433,3184,29617,192
2022-03-02,Fresno,019,978130,229656,226932,23620,250552,2629
2022-03-02,Glenn,021,27897,4942,4922,1598,6520,43
2022-03-02,Humboldt,023,135768,16704,16747,2918,19665,135
2022-03-02,Imperial,025,180216,55097,54629,10813,65442,878
2022-03-02,Inyo,027,18085,4047,4041,478,4519,56
2022-03-02,Kern,029,883053,190787,189656,46008,235664,2136
2022-03-02,Kings,031,150075,51040,50819,3583,54402,431
2022-03-02,Lake,033,64148,10554,10495,884,11379,130
2022-03-02,Lassen,035,31185,8912,8811,881,9692,62
2022-03-02,Los Angeles,037,10098052,2690398,2670287,123896,2794183,30535
2022-03-02,Madera,039,155013,37045,37077,6003,43080,354
2022-03-02,Marin,041,260295,32912,32794,2182,34976,272
2022-03-02,Mariposa,043,17540,2366,2359,200,2559,6
2022-03-02,Mendocino,045,87422,12920,12832,2987,15819,112
2022-03-02,Merced,047,269075,61697,61606,8549,70155,785
2022-03-02,Modoc,049,8938,731,729,250,979,7
2022-03-02,Mono,051,14174,2960,2961,120,3081,5
2022-03-02,Monterey,053,433212,78765,77963,13414,91377,703
2022-03-02,Napa,055,140530,25403,25382,945,26327,134
2022-03-02,Nevada,057,99092,15810,15920,1189,17109,122
2022-03-02,Orange,059,3164182,542835,541230,41039,582269,6623
2022-03-02,Placer,061,380077,62221,62066,7350,69416,589
2022-03-02,Plumas,063,18699,2949,2700,355,3055,13
2022-03-02,Riverside,065,2383286,588106,586513,27931,614444,6229
2022-03-02,Sacramento,067,1510023,278711,273291,27100,300391,2837
2022-03-02,San Benito,069,59416,12815,12814,510,13324,94
2022-03-02,San Bernardino,071,2135413,563455,557082,24693,581775,6619
2022-03-02,San Diego,073,3302833,746410,739803,51587,791390,5034
2022-03-02,San Francisco,075,870044,121953,123442,8170,131612,792
2022-03-02,San Joaquin,077,732212,165124,164968,9501,174469,2063
2022-03-02,San Luis Obispo,079,281455,51900,51686,3726,55412,446
2022-03-02,San Mateo,081,765935,119940,118518,6882,125400,617
2022-03-02,Santa Barbara,083,443738,85080,85183,4735,89918,655
2022-03-02,Santa Clara,085,1922200,307119,307354,12259,319613,2184
2022-03-02,Santa Cruz,087,273765,46896,46534,2106,48640,253
2022-03-02,Shasta,089,179085,30280,30253,6079,36332,490
2022-03-02,Sierra,091,2930,271,273,47,320,4
2022-03-02,Siskiyou,093,43540,4402,4384,2732,7116,74
2022-03-02,Solano,095,438530,80564,80626,5485,86111,433
2022-03-02,Sonoma,097,501317,82544,82208,2516,84724,473
2022-03-02,Stanislaus,099,539301,116659,117411,17228,134639,1519
2022-03-02,Sutter,101,95872,20322,20317,2051,22368,216
2022-03-02,Tehama,103,63373,11974,11930,2613,14543,158
2022-03-02,Trinity,105,12862,1175,1160,292,1452,20
2022-03-02,Tulare,107,460477,106032,103451,28475,131926,1302
2022-03-02,Tuolumne,109,53932,12529,12297,558,12855,179
2022-03-02,Ventura,111,848112,171929,171770,9231,181001,1427
2022-03-02,Yolo,113,214977,36319,35799,3129,38928,305
2022-03-02,Yuba,115,75493,15697,15653,1181,16834,115
2022-03-01,Alameda,001,1643700,252423,251830,13381,265211,1749
2022-03-01,Alpine,003,1148,122,125,1,126,0
2022-03-01,Amador,005,37829,8397,8334,646,8980,83
2022-03-01,Butte,007,227075,32710,32575,6539,39114,372
2022-03-01,Calaveras,009,45235,7196,7223,349,7572,116
2022-03-01,Colusa,011,21464,3423,3423,1069,4492,21
2022-03-01,Contra Costa,013,1133247,186299,185378,13028,198406,1231
2022-03-01,Del Norte,015,27424,5683,5701,184,5885,45
2022-03-01,El Dorado,017,186661,26477,26413,3182,29595,192
2022-03-01,Fresno,019,978130,229514,226594,23607,250201,2628
2022-03-01,Glenn,021,27897,4941,4919,1596,6515,40
2022-03-01,Humboldt,023,135768,16683,16727,2911,19638,135
2022-03-01,Imperial,025,180216,55079,54570,10807,65377,875
2022-03-01,Inyo,027,18085,4043,4041,477,4518,56
2022-03-01,Kern,029,883053,190711,189365,45984,235349,2120
2022-03-01,Kings,031,150075,51018,50763,3579,54342,427
2022-03-01,Lake,033,64148,10542,10471,882,11353,128
2022-03-01,Lassen,035,31185,8908,8801,881,9682,61
2022-03-01,Los Angeles,037,10098052,2689451,2669489,123838,2793327,30486
2022-03-01,Madera,039,155013,37025,37046,5996,43042,354
2022-03-01,Marin,041,260295,32887,32764,2180,34944,272
2022-03-01,Mariposa,043,17540,2365,2357,199,2556,6
2022-03-01,Mendocino,045,87422,12908,12818,2985,15803,112
2022-03-01,Merced,047,269075,61669,61549,8534,70083,781
2022-03-01,Modoc,049,8938,731,729,250,979,7
2022-03-01,Mono,051,14174,2959,2960,120,3080,6
2022-03-01,Monterey,053,433212,78739,77911,13402,91313,696
2022-03-01,Napa,055,140530,25370,25344,945,26289,134
2022-03-01,Nevada,057,99092,15802,15916,1186,17102,121
2022-03-01,Orange,059,3164182,542612,541054,41003,582057,6612
2022-03-01,Placer,061,380077,62194,62021,7344,69365,583
2022-03-01,Plumas,063,18699,2949,2694,355,3049,13
2022-03-01,Riverside,065,2383286,587939,586184,27930,614114,6198
2022-03-01,Sacramento,067,1510023,278580,273089,27086,300175,2831
2022-03-01,San Benito,069,59416,12811,12806,510,13316,94
2022-03-01,San Bernardino,071,2135413,563320,556743,24690,581433,6588
2022-03-01,San Diego,073,3302833,745970,739136,51546,790682,5029
2022-03-01,San Francisco,075,870044,121850,123481,8164,131645,792
2022-03-01,San Joaquin,077,732212,165057,164894,9496,174390,2062
2022-03-01,San Luis Obispo,079,281455,51864,51592,3722,55314,445
2022-03-01,San Mateo,081,765935,119864,118358,6875,125233,613
2022-03-01,Santa Barbara,083,443738,85041,85134,4731,89865,654
2022-03-01,Santa Clara,085,1922200,306871,306978,12246,319224,2190
2022-03-01,Santa Cruz,087,273765,46846,46471,2103,48574,253
2022-03-01,Shasta,089,179085,30250,30227,6076,36303,489
2022-03-01,Sierra,091,2930,271,274,47,321,5
2022-03-01,Siskiyou,093,43540,4398,4384,2727,7111,74
2022-03-01,Solano,095,438530,80501,80556,5482,86038,434
2022-03-01,Sonoma,097,501317,82473,82103,2510,84613,477
2022-03-01,Stanislaus,099,539301,116606,117308,17203,134511,1521
2022-03-01,Sutter,101,95872,20308,20288,2047,22335,217
2022-03-01,Tehama,103,63373,11967,11923,2610,14533,158
2022-03-01,Trinity,105,12862,1174,1159,292,1451,20
2022-03-01,Tulare,107,460477,105951,103371,28455,131826,1302
2022-03-01,Tuolumne,109,53932,12522,12276,556,12832,175
2022-03-01,Ventura,111,848112,171860,171672,9224,180896,1427
2022-03-01,Yolo,113,214977,36294,35801,3123,38924,299
2022-03-01,Yuba,115,75493,15689,15637,1181,16818,116
2022-02-28,Alameda,001,1643700,252206,251714,13367,265081,1742
2022-02-28,Alpine,003,1148,122,125,1,126,0
2022-02-28,Amador,005,37829,8391,8308,645,8953,83
2022-02-28,Butte,007,227075,32686,32550,6534,39084,368
2022-02-28,Calaveras,009,45235,7193,7220,348,7568,110
2022-02-28,Colusa,011,21464,3420,3422,1067,4489,21
2022-02-28,Contra Costa,013,1133247,186193,185272,13008,198280,1231
2022-02-28,Del Norte,015,27424,5679,5699,183,5882,45
2022-02-28,El Dorado,017,186661,26469,26409,3177,29586,191
2022-02-28,Fresno,019,978130,229317,226519,23585,250104,2622
2022-02-28,Glenn,021,27897,4937,4918,1596,6514,40
2022-02-28,Humboldt,023,135768,16668,16717,2907,19624,135
2022-02-28,Imperial,025,180216,55054,54517,10802,65319,875
2022-02-28,Inyo,027,18085,4043,4041,476,4517,56
2022-02-28,Kern,029,883053,190616,189245,45953,235198,2115
2022-02-28,Kings,031,150075,50979,50741,3578,54319,427
2022-02-28,Lake,033,64148,10531,10468,878,11346,128
2022-02-28,Lassen,035,31185,8851,8794,881,9675,55
2022-02-28,Los Angeles,037,10098052,2688275,2666804,123742,2790546,30410
2022-02-28,Madera,039,155013,36998,37023,5980,43003,354
2022-02-28,Marin,041,260295,32861,32775,2180,34955,272
2022-02-28,Mariposa,043,17540,2362,2354,197,2551,6
2022-02-28,Mendocino,045,87422,12900,12800,2977,15777,112
2022-02-28,Merced,047,269075,61625,61519,8516,70035,781
2022-02-28,Modoc,049,8938,731,727,250,977,7
2022-02-28,Mono,051,14174,2959,2961,120,3081,5
2022-02-28,Monterey,053,433212,78672,77865,13379,91244,693
2022-02-28,Napa,055,140530,25346,25317,945,26262,129
2022-02-28,Nevada,057,99092,15796,15908,1180,17088,121
2022-02-28,Orange,059,3164182,542358,540839,40989,581828,6605
2022-02-28,Placer,061,380077,62162,61976,7338,69314,577
2022-02-28,Plumas,063,18699,2949,2691,354,3045,13
2022-02-28,Riverside,065,2383286,587741,585891,27897,613788,6179
2022-02-28,Sacramento,067,1510023,278444,273038,27060,300098,2825
2022-02-28,San Benito,069,59416,12807,12798,510,13308,94
2022-02-28,San Bernardino,071,2135413,563125,556540,24676,581216,6576
2022-02-28,San Diego,073,3302833,745571,737760,51517,789277,5018
2022-02-28,San Francisco,075,870044,121691,123402,8156,131558,792
2022-02-28,San Joaquin,077,732212,164973,164833,9487,174320,2060
2022-02-28,San Luis Obispo,079,281455,51805,51565,3714,55279,440
2022-02-28,San Mateo,081,765935,119762,118301,6869,125170,611
2022-02-28,Santa Barbara,083,443738,84998,85076,4726,89802,653
2022-02-28,Santa Clara,085,1922200,306595,306930,12224,319154,2180
2022-02-28,Santa Cruz,087,273765,46775,46447,2102,48549,253
2022-02-28,Shasta,089,179085,30225,30213,6072,36285,488
2022-02-28,Sierra,091,2930,271,273,47,320,4
2022-02-28,Siskiyou,093,43540,4395,4382,2721,7103,74
2022-02-28,Solano,095,438530,80436,80544,5471,86015,430
2022-02-28,Sonoma,097,501317,82409,82058,2507,84565,477
2022-02-28,Stanislaus,099,539301,116539,117231,17187,134418,1521
2022-02-28,Sutter,101,95872,20295,20285,2044,22329,214
2022-02-28,Tehama,103,63373,11954,11917,2609,14526,158
2022-02-28,Trinity,105,12862,1174,1160,292,1452,20
2022-02-28,Tulare,107,460477,105901,103304,28437,131741,1300
2022-02-28,Tuolumne,109,53932,12511,12247,555,12802,175
2022-02-28,Ventura,111,848112,171776,171614,9223,180837,1423
2022-02-28,Yolo,113,214977,36257,35754,3116,38870,299
2022-02-28,Yuba,115,75493,15675,15625,1180,16805,115
2022-02-27,Alameda,001,1643700,251927,251624,13358,264982,1744
2022-02-27,Alpine,003,1148,122,125,1,126,0
2022-02-27,Amador,005,37829,8387,8305,642,8947,83
2022-02-27,Butte,007,227075,32649,32551,6522,39073,368
2022-02-27,Calaveras,009,45235,7186,7214,348,7562,110
2022-02-27,Colusa,011,21464,3419,3422,1067,4489,21
2022-02-27,Contra Costa,013,1133247,186065,185185,12988,198173,1230
2022-02-27,Del Norte,015,27424,5661,5691,181,5872,45
2022-02-27,El Dorado,017,186661,26450,26410,3175,29585,191
2022-02-27,Fresno,019,978130,229117,226397,23558,249955,2621
2022-02-27,Glenn,021,27897,4935,4915,1596,6511,40
2022-02-27,Humboldt,023,135768,16646,16713,2900,19613,135
2022-02-27,Imperial,025,180216,55005,54509,10786,65295,875
2022-02-27,Inyo,027,18085,4042,4041,472,4513,56
2022-02-27,Kern,029,883053,190495,189219,45913,235132,2115
2022-02-27,Kings,031,150075,50950,50733,3576,54309,428
2022-02-27,Lake,033,64148,10512,10463,878,11341,128
2022-02-27,Lassen,035,31185,8843,8786,881,9667,55
2022-02-27,Los Angeles,037,10098052,2686977,2666789,123658,2790447,30410
2022-02-27,Madera,039,155013,36972,37009,5972,42981,354
2022-02-27,Marin,041,260295,32823,32756,2178,34934,272
2022-02-27,Mariposa,043,17540,2359,2352,197,2549,6
2022-02-27,Mendocino,045,87422,12881,12798,2964,15762,112
2022-02-27,Merced,047,269075,61574,61491,8499,69990,779
2022-02-27,Modoc,049,8938,730,727,250,977,7
2022-02-27,Mono,051,14174,2958,2960,120,3080,5
2022-02-27,Monterey,053,433212,78612,77851,13354,91205,693
2022-02-27,Napa,055,140530,25307,25316,945,26261,129
2022-02-27,Nevada,057,99092,15788,15900,1176,17076,121
2022-02-27,Orange,059,3164182,542111,540659,40959,581618,6605
2022-02-27,Placer,061,380077,62120,61965,7334,69299,577
2022-02-27,Plumas,063,18699,2946,2691,354,3045,13
2022-02-27,Riverside,065,2383286,587502,585833,27871,613704,6179
2022-02-27,Sacramento,067,1510023,278259,272927,27028,299955,2822
2022-02-27,San Benito,069,59416,12800,12798,510,13308,94
2022-02-27,San Bernardino,071,2135413,562938,556457,24666,581123,6572
2022-02-27,San Diego,073,3302833,745085,737760,51475,789235,5018
2022-02-27,San Francisco,075,870044,121569,123327,8145,131472,791
2022-02-27,San Joaquin,077,732212,164866,164814,9483,174297,2060
2022-02-27,San Luis Obispo,079,281455,51713,51564,3707,55271,439
2022-02-27,San Mateo,081,765935,119647,118244,6864,125108,611
2022-02-27,Santa Barbara,083,443738,84958,85050,4722,89772,653
2022-02-27,Santa Clara,085,1922200,306304,306756,12193,318949,2180
2022-02-27,Santa Cruz,087,273765,46714,46411,2101,48512,253
2022-02-27,Shasta,089,179085,30193,30206,6066,36272,488
2022-02-27,Sierra,091,2930,271,273,47,320,4
2022-02-27,Siskiyou,093,43540,4390,4378,2708,7086,74
2022-02-27,Solano,095,438530,80360,80515,5460,85975,430
2022-02-27,Sonoma,097,501317,82327,82041,2501,84542,476
2022-02-27,Stanislaus,099,539301,116470,117200,17169,134369,1522
2022-02-27,Sutter,101,95872,20278,20280,2038,22318,214
2022-02-27,Tehama,103,63373,11942,11915,2608,14523,158
2022-02-27,Trinity,105,12862,1173,1158,292,1450,20
2022-02-27,Tulare,107,460477,105827,103270,28383,131653,1300
2022-02-27,Tuolumne,109,53932,12497,12243,554,12797,175
2022-02-27,Ventura,111,848112,171700,171660,9221,180881,1423
2022-02-27,Yolo,113,214977,36229,35744,3111,38855,299
2022-02-27,Yuba,115,75493,15664,15619,1178,16797,113
2022-02-26,Alameda,001,1643700,251818,250867,13353,264220,1716
2022-02-26,Alpine,003,1148,122,125,1,126,0
2022-02-26,Amador,005,37829,8384,8282,641,8923,83
2022-02-26,Butte,007,227075,32635,32466,6520,38986,368
2022-02-26,Calaveras,009,45235,7185,7192,348,7540,110
2022-02-26,Colusa,011,21464,3419,3414,1067,4481,21
2022-02-26,Contra Costa,013,1133247,185995,184686,12969,197655,1209
2022-02-26,Del Norte,015,27424,5656,5639,181,5820,45
2022-02-26,El Dorado,017,186661,26439,26355,3171,29526,191
2022-02-26,Fresno,019,978130,229027,225679,23558,249237,2597
2022-02-26,Glenn,021,27897,4933,4909,1595,6504,40
2022-02-26,Humboldt,023,135768,16621,16619,2899,19518,133
2022-02-26,Imperial,025,180216,54978,54367,10784,65151,871
2022-02-26,Inyo,027,18085,4041,4034,467,4501,56
2022-02-26,Kern,029,883053,190446,188584,45894,234478,2106
2022-02-26,Kings,031,150075,50937,50579,3576,54155,423
2022-02-26,Lake,033,64148,10506,10383,878,11261,128
2022-02-26,Lassen,035,31185,8842,8761,881,9642,55
2022-02-26,Los Angeles,037,10098052,2686418,2660973,123617,2784590,30202
2022-02-26,Madera,039,155013,36958,36933,5970,42903,330
2022-02-26,Marin,041,260295,32809,32651,2176,34827,267
2022-02-26,Mariposa,043,17540,2358,2332,197,2529,6
2022-02-26,Mendocino,045,87422,12875,12762,2964,15726,111
2022-02-26,Merced,047,269075,61553,61348,8498,69846,775
2022-02-26,Modoc,049,8938,730,726,250,976,7
2022-02-26,Mono,051,14174,2958,2959,119,3078,5
2022-02-26,Monterey,053,433212,78581,77610,13348,90958,692
2022-02-26,Napa,055,140530,25292,25221,944,26165,130
2022-02-26,Nevada,057,99092,15784,15850,1174,17024,121
2022-02-26,Orange,059,3164182,542001,539992,40942,580934,6540
2022-02-26,Placer,061,380077,62101,61803,7331,69134,573
2022-02-26,Plumas,063,18699,2946,2673,354,3027,13
2022-02-26,Riverside,065,2383286,587384,584835,27862,612697,6143
2022-02-26,Sacramento,067,1510023,278165,272339,27015,299354,2793
2022-02-26,San Benito,069,59416,12796,12770,510,13280,92
2022-02-26,San Bernardino,071,2135413,562851,555668,24661,580329,6505
2022-02-26,San Diego,073,3302833,744852,736049,51455,787504,5002
2022-02-26,San Francisco,075,870044,121500,123079,8137,131216,769
2022-02-26,San Joaquin,077,732212,164831,164418,9482,173900,2048
2022-02-26,San Luis Obispo,079,281455,51699,51358,3704,55062,438
2022-02-26,San Mateo,081,765935,119593,117860,6863,124723,603
2022-02-26,Santa Barbara,083,443738,84927,84830,4722,89552,652
2022-02-26,Santa Clara,085,1922200,306152,305895,12190,318085,2166
2022-02-26,Santa Cruz,087,273765,46692,46186,2101,48287,251
2022-02-26,Shasta,089,179085,30185,30108,6060,36168,485
2022-02-26,Sierra,091,2930,271,270,47,317,1
2022-02-26,Siskiyou,093,43540,4390,4359,2706,7065,72
2022-02-26,Solano,095,438530,80326,80225,5457,85682,428
2022-02-26,Sonoma,097,501317,82291,81702,2499,84201,432
2022-02-26,Stanislaus,099,539301,116432,116896,17164,134060,1503
2022-02-26,Sutter,101,95872,20269,20230,2038,22268,214
2022-02-26,Tehama,103,63373,11936,11878,2606,14484,158
2022-02-26,Trinity,105,12862,1172,1156,292,1448,20
2022-02-26,Tulare,107,460477,105790,102983,28368,131351,1295
2022-02-26,Tuolumne,109,53932,12495,12169,554,12723,175
2022-02-26,Ventura,111,848112,171667,171292,9219,180511,1411
2022-02-26,Yolo,113,214977,36208,35615,3108,38723,296
2022-02-26,Yuba,115,75493,15653,15587,1178,16765,113
2022-02-25,Alameda,001,1643700,251693,250867,13343,264210,1716
2022-02-25,Alpine,003,1148,122,125,1,126,0
2022-02-25,Amador,005,37829,8373,8282,641,8923,83
2022-02-25,Butte,007,227075,32623,32466,6518,38984,368
2022-02-25,Calaveras,009,45235,7183,7192,348,7540,110
2022-02-25,Colusa,011,21464,3419,3414,1067,4481,21
2022-02-25,Contra Costa,013,1133247,185909,184686,12947,197633,1209
2022-02-25,Del Norte,015,27424,5646,5639,181,5820,45
2022-02-25,El Dorado,017,186661,26430,26355,3171,29526,191
2022-02-25,Fresno,019,978130,228930,225679,23552,249231,2597
2022-02-25,Glenn,021,27897,4931,4909,1595,6504,40
2022-02-25,Humboldt,023,135768,16610,16619,2899,19518,133
2022-02-25,Imperial,025,180216,54960,54367,10783,65150,871
2022-02-25,Inyo,027,18085,4040,4034,467,4501,56
2022-02-25,Kern,029,883053,190380,188584,45881,234465,2106
2022-02-25,Kings,031,150075,50923,50579,3575,54154,423
2022-02-25,Lake,033,64148,10491,10383,878,11261,128
2022-02-25,Lassen,035,31185,8839,8761,881,9642,55
2022-02-25,Los Angeles,037,10098052,2685829,2660973,123587,2784560,30202
2022-02-25,Madera,039,155013,36938,36933,5969,42902,330
2022-02-25,Marin,041,260295,32795,32651,2176,34827,267
2022-02-25,Mariposa,043,17540,2355,2332,197,2529,6
2022-02-25,Mendocino,045,87422,12872,12762,2964,15726,111
2022-02-25,Merced,047,269075,61521,61348,8493,69841,775
2022-02-25,Modoc,049,8938,730,726,250,976,7
2022-02-25,Mono,051,14174,2957,2959,119,3078,5
2022-02-25,Monterey,053,433212,78554,77610,13342,90952,692
2022-02-25,Napa,055,140530,25283,25221,944,26165,130
2022-02-25,Nevada,057,99092,15773,15850,1171,17021,121
2022-02-25,Orange,059,3164182,541868,539992,40919,580911,6540
2022-02-25,Placer,061,380077,62085,61803,7325,69128,573
2022-02-25,Plumas,063,18699,2944,2673,353,3026,13
2022-02-25,Riverside,065,2383286,587226,584835,27850,612685,6143
2022-02-25,Sacramento,067,1510023,278066,272339,27010,299349,2793
2022-02-25,San Benito,069,59416,12794,12770,510,13280,92
2022-02-25,San Bernardino,071,2135413,562746,555668,24654,580322,6505
2022-02-25,San Diego,073,3302833,744552,736049,51436,787485,5002
2022-02-25,San Francisco,075,870044,121420,123079,8134,131213,769
2022-02-25,San Joaquin,077,732212,164791,164418,9477,173895,2048
2022-02-25,San Luis Obispo,079,281455,51695,51358,3695,55053,438
2022-02-25,San Mateo,081,765935,119532,117860,6859,124719,603
2022-02-25,Santa Barbara,083,443738,84892,84830,4722,89552,652
2022-02-25,Santa Clara,085,1922200,305966,305895,12187,318082,2166
2022-02-25,Santa Cruz,087,273765,46658,46186,2099,48285,251
2022-02-25,Shasta,089,179085,30175,30108,6058,36166,485
2022-02-25,Sierra,091,2930,271,270,47,317,1
2022-02-25,Siskiyou,093,43540,4390,4359,2705,7064,72
2022-02-25,Solano,095,438530,80297,80225,5456,85681,428
2022-02-25,Sonoma,097,501317,82241,81702,2497,84199,432
2022-02-25,Stanislaus,099,539301,116405,116896,17160,134056,1503
2022-02-25,Sutter,101,95872,20260,20230,2038,22268,214
2022-02-25,Tehama,103,63373,11934,11878,2606,14484,158
2022-02-25,Trinity,105,12862,1172,1156,292,1448,20
2022-02-25,Tulare,107,460477,105754,102983,28345,131328,1295
2022-02-25,Tuolumne,109,53932,12493,12169,554,12723,175
2022-02-25,Ventura,111,848112,171616,171292,9219,180511,1411
2022-02-25,Yolo,113,214977,36193,35615,3108,38723,296
2022-02-25,Yuba,115,75493,15645,15587,1178,16765,113
2022-02-24,Alameda,001,1643700,251487,250867,13334,264201,1716
2022-02-24,Alpine,003,1148,122,125,1,126,0
2022-02-24,Amador,005,37829,8368,8282,640,8922,83
2022-02-24,Butte,007,227075,32602,32466,6513,38979,368
2022-02-24,Calaveras,009,45235,7180,7192,346,7538,110
2022-02-24,Colusa,011,21464,3418,3414,1066,4480,21
2022-02-24,Contra Costa,013,1133247,185781,184686,12939,197625,1209
2022-02-24,Del Norte,015,27424,5631,5639,180,5819,45
2022-02-24,El Dorado,017,186661,26416,26355,3171,29526,191
2022-02-24,Fresno,019,978130,228733,225679,23537,249216,2597
2022-02-24,Glenn,021,27897,4929,4909,1594,6503,40
2022-02-24,Humboldt,023,135768,16592,16619,2898,19517,133
2022-02-24,Imperial,025,180216,54922,54367,10773,65140,871
2022-02-24,Inyo,027,18085,4039,4034,466,4500,56
2022-02-24,Kern,029,883053,190236,188584,45847,234431,2106
2022-02-24,Kings,031,150075,50893,50579,3570,54149,423
2022-02-24,Lake,033,64148,10472,10383,878,11261,128
2022-02-24,Lassen,035,31185,8835,8761,880,9641,55
2022-02-24,Los Angeles,037,10098052,2684678,2660973,123531,2784504,30202
2022-02-24,Madera,039,155013,36911,36933,5967,42900,330
2022-02-24,Marin,041,260295,32774,32651,2175,34826,267
2022-02-24,Mariposa,043,17540,2349,2332,196,2528,6
2022-02-24,Mendocino,045,87422,12865,12762,2960,15722,111
2022-02-24,Merced,047,269075,61491,61348,8484,69832,775
2022-02-24,Modoc,049,8938,729,726,250,976,7
2022-02-24,Mono,051,14174,2956,2959,119,3078,5
2022-02-24,Monterey,053,433212,78501,77610,13333,90943,692
2022-02-24,Napa,055,140530,25242,25221,940,26161,130
2022-02-24,Nevada,057,99092,15759,15850,1171,17021,121
2022-02-24,Orange,059,3164182,541620,539992,40885,580877,6540
2022-02-24,Placer,061,380077,62047,61803,7323,69126,573
2022-02-24,Plumas,063,18699,2939,2673,352,3025,13
2022-02-24,Riverside,065,2383286,586972,584835,27824,612659,6143
2022-02-24,Sacramento,067,1510023,277892,272339,26992,299331,2793
2022-02-24,San Benito,069,59416,12783,12770,509,13279,92
2022-02-24,San Bernardino,071,2135413,562554,555668,24644,580312,6505
2022-02-24,San Diego,073,3302833,744115,736049,51393,787442,5002
2022-02-24,San Francisco,075,870044,121297,123079,8127,131206,769
2022-02-24,San Joaquin,077,732212,164659,164418,9472,173890,2048
2022-02-24,San Luis Obispo,079,281455,51649,51358,3693,55051,438
2022-02-24,San Mateo,081,765935,119440,117860,6852,124712,603
2022-02-24,Santa Barbara,083,443738,84828,84830,4721,89551,652
2022-02-24,Santa Clara,085,1922200,305722,305895,12173,318068,2166
2022-02-24,Santa Cruz,087,273765,46576,46186,2097,48283,251
2022-02-24,Shasta,089,179085,30156,30108,6052,36160,485
2022-02-24,Sierra,091,2930,271,270,47,317,1
2022-02-24,Siskiyou,093,43540,4387,4359,2701,7060,72
2022-02-24,Solano,095,438530,80218,80225,5453,85678,428
2022-02-24,Sonoma,097,501317,82187,81702,2492,84194,432
2022-02-24,Stanislaus,099,539301,116327,116896,17150,134046,1503
2022-02-24,Sutter,101,95872,20246,20230,2022,22252,214
2022-02-24,Tehama,103,63373,11928,11878,2605,14483,158
2022-02-24,Trinity,105,12862,1170,1156,292,1448,20
2022-02-24,Tulare,107,460477,105697,102983,28312,131295,1295
2022-02-24,Tuolumne,109,53932,12482,12169,552,12721,175
2022-02-24,Ventura,111,848112,171537,171292,9216,180508,1411
2022-02-24,Yolo,113,214977,36168,35615,3106,38721,296
2022-02-24,Yuba,115,75493,15632,15587,1178,16765,113
2022-02-23,Alameda,001,1643700,251259,247686,13316,261002,1713
2022-02-23,Alpine,003,1148,122,125,1,126,0
2022-02-23,Amador,005,37829,8351,8274,640,8914,79
2022-02-23,Butte,007,227075,32574,32417,6510,38927,367
2022-02-23,Calaveras,009,45235,7170,7182,345,7527,107
2022-02-23,Colusa,011,21464,3414,3411,1066,4477,21
2022-02-23,Contra Costa,013,1133247,185636,184013,12925,196938,1209
2022-02-23,Del Norte,015,27424,5619,5625,179,5804,45
2022-02-23,El Dorado,017,186661,26400,26317,3167,29484,189
2022-02-23,Fresno,019,978130,228543,225308,23514,248822,2596
2022-02-23,Glenn,021,27897,4925,4909,1592,6501,40
2022-02-23,Humboldt,023,135768,16576,16601,2895,19496,132
2022-02-23,Imperial,025,180216,54886,54292,10759,65051,871
2022-02-23,Inyo,027,18085,4038,4031,463,4494,54
2022-02-23,Kern,029,883053,190129,188432,45797,234229,2106
2022-02-23,Kings,031,150075,50860,50416,3568,53984,423
2022-02-23,Lake,033,64148,10454,10368,877,11245,126
2022-02-23,Lassen,035,31185,8819,8749,880,9629,55
2022-02-23,Los Angeles,037,10098052,2683312,2659569,123485,2783054,30167
2022-02-23,Madera,039,155013,36879,36876,5957,42833,330
2022-02-23,Marin,041,260295,32751,32625,2174,34799,267
2022-02-23,Mariposa,043,17540,2344,2325,195,2520,6
2022-02-23,Mendocino,045,87422,12857,12747,2956,15703,111
2022-02-23,Merced,047,269075,61462,61295,8479,69774,772
2022-02-23,Modoc,049,8938,729,723,249,972,7
2022-02-23,Mono,051,14174,2955,2960,119,3079,5
2022-02-23,Monterey,053,433212,78462,77472,13310,90782,691
2022-02-23,Napa,055,140530,25219,25185,935,26120,128
2022-02-23,Nevada,057,99092,15753,15825,1168,16993,121
2022-02-23,Orange,059,3164182,541312,539631,40862,580493,6520
2022-02-23,Placer,061,380077,62000,61758,7315,69073,573
2022-02-23,Plumas,063,18699,2935,2663,352,3015,13
2022-02-23,Riverside,065,2383286,586679,584381,27787,612168,6119
2022-02-23,Sacramento,067,1510023,277730,272057,26969,299026,2796
2022-02-23,San Benito,069,59416,12776,12756,508,13264,92
2022-02-23,San Bernardino,071,2135413,562390,555238,24627,579865,6479
2022-02-23,San Diego,073,3302833,743592,735406,51351,786757,4988
2022-02-23,San Francisco,075,870044,121170,122127,8125,130252,769
2022-02-23,San Joaquin,077,732212,164568,164257,9467,173724,2042
2022-02-23,San Luis Obispo,079,281455,51601,51264,3692,54956,434
2022-02-23,San Mateo,081,765935,119348,117585,6843,124428,603
2022-02-23,Santa Barbara,083,443738,84768,84760,4717,89477,651
2022-02-23,Santa Clara,085,1922200,305462,305484,12164,317648,2157
2022-02-23,Santa Cruz,087,273765,46507,46059,2096,48155,251
2022-02-23,Shasta,089,179085,30129,30066,6049,36115,481
2022-02-23,Sierra,091,2930,271,270,47,317,1
2022-02-23,Siskiyou,093,43540,4384,4356,2699,7055,71
2022-02-23,Solano,095,438530,80129,80103,5451,85554,427
2022-02-23,Sonoma,097,501317,82134,81594,2490,84084,432
2022-02-23,Stanislaus,099,539301,116252,116789,17141,133930,1482
2022-02-23,Sutter,101,95872,20229,20194,2018,22212,213
2022-02-23,Tehama,103,63373,11918,11863,2605,14468,154
2022-02-23,Trinity,105,12862,1170,1156,292,1448,20
2022-02-23,Tulare,107,460477,105630,102812,28284,131096,1290
2022-02-23,Tuolumne,109,53932,12472,12158,551,12709,175
2022-02-23,Ventura,111,848112,171451,171163,9209,180372,1401
2022-02-23,Yolo,113,214977,36131,35590,3099,38689,296
2022-02-23,Yuba,115,75493,15629,15571,1176,16747,113
2022-02-22,Alameda,001,1643700,251021,247434,13301,260735,1706
2022-02-22,Alpine,003,1148,122,124,1,125,0
2022-02-22,Amador,005,37829,8341,8243,640,8883,79
2022-02-22,Butte,007,227075,32539,32359,6505,38864,366
2022-02-22,Calaveras,009,45235,7161,7178,345,7523,107
2022-02-22,Colusa,011,21464,3414,3402,1064,4466,21
2022-02-22,Contra Costa,013,1133247,185483,183812,12906,196718,1201
2022-02-22,Del Norte,015,27424,5611,5611,178,5789,45
2022-02-22,El Dorado,017,186661,26390,26289,3167,29456,189
2022-02-22,Fresno,019,978130,228312,225104,23484,248588,2592
2022-02-22,Glenn,021,27897,4924,4900,1591,6491,40
2022-02-22,Humboldt,023,135768,16555,16559,2891,19450,132
2022-02-22,Imperial,025,180216,54850,54227,10755,64982,864
2022-02-22,Inyo,027,18085,4037,4026,461,4487,54
2022-02-22,Kern,029,883053,189987,188237,45760,233997,2102
2022-02-22,Kings,031,150075,50797,50359,3565,53924,423
2022-02-22,Lake,033,64148,10443,10353,875,11228,126
2022-02-22,Lassen,035,31185,8815,8730,880,9610,55
2022-02-22,Los Angeles,037,10098052,2681848,2658230,123397,2781627,30129
2022-02-22,Madera,039,155013,36847,36833,5947,42780,330
2022-02-22,Marin,041,260295,32726,32591,2173,34764,267
2022-02-22,Mariposa,043,17540,2336,2322,195,2517,6
2022-02-22,Mendocino,045,87422,12843,12714,2946,15660,110
2022-02-22,Merced,047,269075,61402,61241,8472,69713,770
2022-02-22,Modoc,049,8938,726,720,249,969,6
2022-02-22,Mono,051,14174,2955,2961,119,3080,5
2022-02-22,Monterey,053,433212,78408,77359,13290,90649,690
2022-02-22,Napa,055,140530,25190,25151,934,26085,128
2022-02-22,Nevada,057,99092,15737,15815,1167,16982,121
2022-02-22,Orange,059,3164182,541024,539390,40829,580219,6502
2022-02-22,Placer,061,380077,61962,61709,7310,69019,572
2022-02-22,Plumas,063,18699,2929,2659,350,3009,13
2022-02-22,Riverside,065,2383286,586421,583969,27765,611734,6097
2022-02-22,Sacramento,067,1510023,277538,271789,26945,298734,2775
2022-02-22,San Benito,069,59416,12765,12742,507,13249,92
2022-02-22,San Bernardino,071,2135413,562192,554903,24609,579512,6451
2022-02-22,San Diego,073,3302833,743058,734536,51301,785837,4974
2022-02-22,San Francisco,075,870044,121041,121954,8121,130075,769
2022-02-22,San Joaquin,077,732212,164448,164111,9456,173567,2040
2022-02-22,San Luis Obispo,079,281455,51516,51193,3686,54879,431
2022-02-22,San Mateo,081,765935,119253,117418,6838,124256,603
2022-02-22,Santa Barbara,083,443738,84705,84701,4711,89412,650
2022-02-22,Santa Clara,085,1922200,305180,305045,12158,317203,2155
2022-02-22,Santa Cruz,087,273765,46442,45958,2096,48054,251
2022-02-22,Shasta,089,179085,30105,30024,6044,36068,479
2022-02-22,Sierra,091,2930,271,269,46,315,0
2022-02-22,Siskiyou,093,43540,4381,4350,2694,7044,70
2022-02-22,Solano,095,438530,80053,79968,5449,85417,425
2022-02-22,Sonoma,097,501317,82067,81412,2486,83898,431
2022-02-22,Stanislaus,099,539301,116173,116676,17123,133799,1475
2022-02-22,Sutter,101,95872,20213,20164,2015,22179,210
2022-02-22,Tehama,103,63373,11910,11852,2604,14456,152
2022-02-22,Trinity,105,12862,1170,1147,291,1438,20
2022-02-22,Tulare,107,460477,105519,102717,28248,130965,1287
2022-02-22,Tuolumne,109,53932,12452,12136,550,12686,175
2022-02-22,Ventura,111,848112,171366,171064,9203,180267,1401
2022-02-22,Yolo,113,214977,36094,35527,3093,38620,292
2022-02-22,Yuba,115,75493,15619,15550,1175,16725,110
2022-02-21,Alameda,001,1643700,250732,247434,13285,260719,1704
2022-02-21,Alpine,003,1148,122,124,1,125,0
2022-02-21,Amador,005,37829,8335,8246,640,8886,79
2022-02-21,Butte,007,227075,32497,32356,6482,38838,366
2022-02-21,Calaveras,009,45235,7153,7175,345,7520,107
2022-02-21,Colusa,011,21464,3412,3401,1062,4463,21
2022-02-21,Contra Costa,013,1133247,185257,183701,12892,196593,1201
2022-02-21,Del Norte,015,27424,5593,5601,177,5778,45
2022-02-21,El Dorado,017,186661,26364,26273,3162,29435,189
2022-02-21,Fresno,019,978130,227992,224923,23425,248348,2592
2022-02-21,Glenn,021,27897,4920,4897,1591,6488,40
2022-02-21,Humboldt,023,135768,16511,16548,2883,19431,132
2022-02-21,Imperial,025,180216,54794,54208,10738,64946,864
2022-02-21,Inyo,027,18085,4033,4023,461,4484,54
2022-02-21,Kern,029,883053,189794,188188,45707,233895,2102
2022-02-21,Kings,031,150075,50731,50188,3562,53750,422
2022-02-21,Lake,033,64148,10421,10334,873,11207,126
2022-02-21,Lassen,035,31185,8807,8705,875,9580,55
2022-02-21,Los Angeles,037,10098052,2680051,2656873,123298,2780171,30108
2022-02-21,Madera,039,155013,36807,36796,5926,42722,330
2022-02-21,Marin,041,260295,32703,32570,2173,34743,258
2022-02-21,Mariposa,043,17540,2333,2321,195,2516,6
2022-02-21,Mendocino,045,87422,12817,12706,2934,15640,110
2022-02-21,Merced,047,269075,61345,61209,8455,69664,770
2022-02-21,Modoc,049,8938,725,718,249,967,6
2022-02-21,Mono,051,14174,2954,2960,119,3079,5
2022-02-21,Monterey,053,433212,78314,77354,13248,90602,690
2022-02-21,Napa,055,140530,25149,25126,934,26060,128
2022-02-21,Nevada,057,99092,15725,15810,1164,16974,121
2022-02-21,Orange,059,3164182,540668,539068,40804,579872,6502
2022-02-21,Placer,061,380077,61908,61727,7306,69033,572
2022-02-21,Plumas,063,18699,2925,2657,345,3002,13
2022-02-21,Riverside,065,2383286,586049,583712,27716,611428,6097
2022-02-21,Sacramento,067,1510023,277277,271588,26912,298500,2769
2022-02-21,San Benito,069,59416,12752,12731,507,13238,92
2022-02-21,San Bernardino,071,2135413,561949,554662,24587,579249,6441
2022-02-21,San Diego,073,3302833,742427,732298,51230,783528,4974
2022-02-21,San Francisco,075,870044,120860,121865,8117,129982,769
2022-02-21,San Joaquin,077,732212,164305,164036,9445,173481,2040
2022-02-21,San Luis Obispo,079,281455,51424,51184,3679,54863,429
2022-02-21,San Mateo,081,765935,119162,117259,6830,124089,605
2022-02-21,Santa Barbara,083,443738,84629,84626,4703,89329,650
2022-02-21,Santa Clara,085,1922200,304843,304858,12152,317010,2158
2022-02-21,Santa Cruz,087,273765,46317,45941,2095,48036,251
2022-02-21,Shasta,089,179085,30058,30004,6036,36040,479
2022-02-21,Sierra,091,2930,271,269,46,315,0
2022-02-21,Siskiyou,093,43540,4369,4337,2689,7026,70
2022-02-21,Solano,095,438530,79960,79906,5443,85349,425
2022-02-21,Sonoma,097,501317,81954,81361,2480,83841,431
2022-02-21,Stanislaus,099,539301,116065,116597,17099,133696,1475
2022-02-21,Sutter,101,95872,20187,20152,2013,22165,210
2022-02-21,Tehama,103,63373,11897,11842,2603,14445,152
2022-02-21,Trinity,105,12862,1169,1147,291,1438,20
2022-02-21,Tulare,107,460477,105421,102614,28197,130811,1287
2022-02-21,Tuolumne,109,53932,12443,12126,547,12673,175
2022-02-21,Ventura,111,848112,171226,170939,9194,180133,1401
2022-02-21,Yolo,113,214977,36051,35518,3084,38602,292
2022-02-21,Yuba,115,75493,15599,15546,1166,16712,110
2022-02-20,Alameda,001,1643700,250507,246028,13275,259303,1700
2022-02-20,Alpine,003,1148,122,124,1,125,0
2022-02-20,Amador,005,37829,8324,8203,640,8843,79
2022-02-20,Butte,007,227075,32467,32173,6477,38650,364
2022-02-20,Calaveras,009,45235,7150,7136,344,7480,107
2022-02-20,Colusa,011,21464,3409,3389,1061,4450,21
2022-02-20,Contra Costa,013,1133247,185131,182797,12887,195684,1190
2022-02-20,Del Norte,015,27424,5578,5511,177,5688,45
2022-02-20,El Dorado,017,186661,26342,26101,3161,29262,189
2022-02-20,Fresno,019,978130,227800,223594,23412,247006,2544
2022-02-20,Glenn,021,27897,4917,4881,1591,6472,39
2022-02-20,Humboldt,023,135768,16499,16393,2879,19272,132
2022-02-20,Imperial,025,180216,54734,53967,10725,64692,862
2022-02-20,Inyo,027,18085,4032,4018,460,4478,52
2022-02-20,Kern,029,883053,189661,187158,45663,232821,2095
2022-02-20,Kings,031,150075,50703,49724,3558,53282,421
2022-02-20,Lake,033,64148,10388,10184,872,11056,126
2022-02-20,Lassen,035,31185,8795,8640,875,9515,55
2022-02-20,Los Angeles,037,10098052,2678727,2642878,123212,2766090,29842
2022-02-20,Madera,039,155013,36776,36526,5922,42448,330
2022-02-20,Marin,041,260295,32686,32441,2172,34613,258
2022-02-20,Mariposa,043,17540,2327,2310,193,2503,6
2022-02-20,Mendocino,045,87422,12807,12625,2931,15556,110
2022-02-20,Merced,047,269075,61317,60886,8453,69339,769
2022-02-20,Modoc,049,8938,724,714,249,963,6
2022-02-20,Mono,051,14174,2954,2956,119,3075,5
2022-02-20,Monterey,053,433212,78255,76765,13234,89999,682
2022-02-20,Napa,055,140530,25129,24970,932,25902,127
2022-02-20,Nevada,057,99092,15714,15715,1163,16878,121
2022-02-20,Orange,059,3164182,540348,538019,40769,578788,6416
2022-02-20,Placer,061,380077,61876,61417,7298,68715,560
2022-02-20,Plumas,063,18699,2921,2646,343,2989,13
2022-02-20,Riverside,065,2383286,585775,581788,27688,609476,6087
2022-02-20,Sacramento,067,1510023,277098,270080,26887,296967,2747
2022-02-20,San Benito,069,59416,12749,12665,507,13172,92
2022-02-20,San Bernardino,071,2135413,561742,553151,24569,577720,6400
2022-02-20,San Diego,073,3302833,741828,729549,51176,780725,4947
2022-02-20,San Francisco,075,870044,120720,121197,8107,129304,756
2022-02-20,San Joaquin,077,732212,164182,163083,9434,172517,2033
2022-02-20,San Luis Obispo,079,281455,51393,50823,3675,54498,424
2022-02-20,San Mateo,081,765935,119090,116648,6822,123470,598
2022-02-20,Santa Barbara,083,443738,84584,83988,4702,88690,642
2022-02-20,Santa Clara,085,1922200,304564,303077,12144,315221,2138
2022-02-20,Santa Cruz,087,273765,46251,45532,2092,47624,250
2022-02-20,Shasta,089,179085,30026,29847,6029,35876,479
2022-02-20,Sierra,091,2930,271,269,46,315,0
2022-02-20,Siskiyou,093,43540,4363,4307,2688,6995,70
2022-02-20,Solano,095,438530,79885,78914,5439,84353,424
2022-02-20,Sonoma,097,501317,81878,80843,2477,83320,431
2022-02-20,Stanislaus,099,539301,115998,115976,17082,133058,1454
2022-02-20,Sutter,101,95872,20174,20060,2010,22070,210
2022-02-20,Tehama,103,63373,11885,11760,2600,14360,152
2022-02-20,Trinity,105,12862,1168,1130,291,1421,20
2022-02-20,Tulare,107,460477,105330,101996,28170,130166,1286
2022-02-20,Tuolumne,109,53932,12421,12036,546,12582,175
2022-02-20,Ventura,111,848112,171128,170331,9189,179520,1384
2022-02-20,Yolo,113,214977,36025,35363,3081,38444,293
2022-02-20,Yuba,115,75493,15583,15449,1165,16614,112
2022-02-19,Alameda,001,1643700,250335,246028,13273,259301,1700
2022-02-19,Alpine,003,1148,122,124,1,125,0
2022-02-19,Amador,005,37829,8320,8203,640,8843,79
2022-02-19,Butte,007,227075,32443,32173,6474,38647,364
2022-02-19,Calaveras,009,45235,7150,7136,344,7480,107
2022-02-19,Colusa,011,21464,3408,3389,1059,4448,21
2022-02-19,Contra Costa,013,1133247,185034,182797,12886,195683,1190
2022-02-19,Del Norte,015,27424,5568,5511,176,5687,45
2022-02-19,El Dorado,017,186661,26326,26101,3159,29260,189
2022-02-19,Fresno,019,978130,227682,223594,23405,246999,2544
2022-02-19,Glenn,021,27897,4913,4881,1591,6472,39
2022-02-19,Humboldt,023,135768,16484,16393,2879,19272,132
2022-02-19,Imperial,025,180216,54718,53967,10719,64686,862
2022-02-19,Inyo,027,18085,4031,4018,459,4477,52
2022-02-19,Kern,029,883053,189562,187158,45638,232796,2095
2022-02-19,Kings,031,150075,50680,49724,3556,53280,421
2022-02-19,Lake,033,64148,10380,10184,872,11056,126
2022-02-19,Lassen,035,31185,8783,8640,874,9514,55
2022-02-19,Los Angeles,037,10098052,2677946,2642878,123171,2766049,29842
2022-02-19,Madera,039,155013,36754,36526,5921,42447,330
2022-02-19,Marin,041,260295,32663,32441,2171,34612,258
2022-02-19,Mariposa,043,17540,2324,2310,193,2503,6
2022-02-19,Mendocino,045,87422,12797,12625,2931,15556,110
2022-02-19,Merced,047,269075,61272,60886,8449,69335,769
2022-02-19,Modoc,049,8938,724,714,248,962,6
2022-02-19,Mono,051,14174,2953,2956,119,3075,5
2022-02-19,Monterey,053,433212,78166,76765,13223,89988,682
2022-02-19,Napa,055,140530,25119,24970,932,25902,127
2022-02-19,Nevada,057,99092,15706,15715,1163,16878,121
2022-02-19,Orange,059,3164182,540148,538019,40745,578764,6416
2022-02-19,Placer,061,380077,61830,61417,7297,68714,560
2022-02-19,Plumas,063,18699,2920,2646,343,2989,13
2022-02-19,Riverside,065,2383286,585596,581788,27675,609463,6087
2022-02-19,Sacramento,067,1510023,276958,270080,26876,296956,2747
2022-02-19,San Benito,069,59416,12736,12665,506,13171,92
2022-02-19,San Bernardino,071,2135413,561579,553151,24562,577713,6400
2022-02-19,San Diego,073,3302833,741471,729549,51134,780683,4947
2022-02-19,San Francisco,075,870044,120634,121197,8103,129300,756
2022-02-19,San Joaquin,077,732212,164106,163083,9423,172506,2033
2022-02-19,San Luis Obispo,079,281455,51381,50823,3671,54494,424
2022-02-19,San Mateo,081,765935,119050,116648,6820,123468,598
2022-02-19,Santa Barbara,083,443738,84515,83988,4701,88689,642
2022-02-19,Santa Clara,085,1922200,304367,303077,12142,315219,2138
2022-02-19,Santa Cruz,087,273765,46213,45532,2090,47622,250
2022-02-19,Shasta,089,179085,30012,29847,6026,35873,479
2022-02-19,Sierra,091,2930,271,269,46,315,0
2022-02-19,Siskiyou,093,43540,4361,4307,2688,6995,70
2022-02-19,Solano,095,438530,79843,78914,5438,84352,424
2022-02-19,Sonoma,097,501317,81833,80843,2477,83320,431
2022-02-19,Stanislaus,099,539301,115928,115976,17076,133052,1454
2022-02-19,Sutter,101,95872,20166,20060,2010,22070,210
2022-02-19,Tehama,103,63373,11878,11760,2600,14360,152
2022-02-19,Trinity,105,12862,1166,1130,291,1421,20
2022-02-19,Tulare,107,460477,105280,101996,28143,130139,1286
2022-02-19,Tuolumne,109,53932,12413,12036,546,12582,175
2022-02-19,Ventura,111,848112,171053,170331,9186,179517,1384
2022-02-19,Yolo,113,214977,35994,35363,3077,38440,293
2022-02-19,Yuba,115,75493,15574,15449,1165,16614,112
2022-02-18,Alameda,001,1643700,250170,246028,13265,259293,1700
2022-02-18,Alpine,003,1148,121,124,1,125,0
2022-02-18,Amador,005,37829,8312,8203,638,8841,79
2022-02-18,Butte,007,227075,32423,32173,6469,38642,364
2022-02-18,Calaveras,009,45235,7145,7136,343,7479,107
2022-02-18,Colusa,011,21464,3406,3389,1059,4448,21
2022-02-18,Contra Costa,013,1133247,184927,182797,12880,195677,1190
2022-02-18,Del Norte,015,27424,5557,5511,176,5687,45
2022-02-18,El Dorado,017,186661,26315,26101,3158,29259,189
2022-02-18,Fresno,019,978130,227495,223594,23395,246989,2544
2022-02-18,Glenn,021,27897,4912,4881,1590,6471,39
2022-02-18,Humboldt,023,135768,16467,16393,2874,19267,132
2022-02-18,Imperial,025,180216,54695,53967,10708,64675,862
2022-02-18,Inyo,027,18085,4030,4018,459,4477,52
2022-02-18,Kern,029,883053,189447,187158,45593,232751,2095
2022-02-18,Kings,031,150075,50592,49724,3556,53280,421
2022-02-18,Lake,033,64148,10363,10184,870,11054,126
2022-02-18,Lassen,035,31185,8763,8640,873,9513,55
2022-02-18,Los Angeles,037,10098052,2676974,2642878,123116,2765994,29842
2022-02-18,Madera,039,155013,36731,36526,5919,42445,330
2022-02-18,Marin,041,260295,32645,32441,2169,34610,258
2022-02-18,Mariposa,043,17540,2322,2310,193,2503,6
2022-02-18,Mendocino,045,87422,12786,12625,2931,15556,110
2022-02-18,Merced,047,269075,61228,60886,8439,69325,769
2022-02-18,Modoc,049,8938,724,714,248,962,6
2022-02-18,Mono,051,14174,2953,2956,119,3075,5
2022-02-18,Monterey,053,433212,78094,76765,13215,89980,682
2022-02-18,Napa,055,140530,25101,24970,932,25902,127
2022-02-18,Nevada,057,99092,15698,15715,1163,16878,121
2022-02-18,Orange,059,3164182,539911,538019,40706,578725,6416
2022-02-18,Placer,061,380077,61800,61417,7289,68706,560
2022-02-18,Plumas,063,18699,2917,2646,343,2989,13
2022-02-18,Riverside,065,2383286,585413,581788,27666,609454,6087
2022-02-18,Sacramento,067,1510023,276763,270080,26868,296948,2747
2022-02-18,San Benito,069,59416,12728,12665,506,13171,92
2022-02-18,San Bernardino,071,2135413,561397,553151,24557,577708,6400
2022-02-18,San Diego,073,3302833,741038,729549,51112,780661,4947
2022-02-18,San Francisco,075,870044,120546,121197,8095,129292,756
2022-02-18,San Joaquin,077,732212,164039,163083,9415,172498,2033
2022-02-18,San Luis Obispo,079,281455,51365,50823,3668,54491,424
2022-02-18,San Mateo,081,765935,118985,116648,6817,123465,598
2022-02-18,Santa Barbara,083,443738,84475,83988,4699,88687,642
2022-02-18,Santa Clara,085,1922200,304127,303077,12141,315218,2138
2022-02-18,Santa Cruz,087,273765,46179,45532,2089,47621,250
2022-02-18,Shasta,089,179085,30000,29847,6025,35872,479
2022-02-18,Sierra,091,2930,271,269,46,315,0
2022-02-18,Siskiyou,093,43540,4358,4307,2686,6993,70
2022-02-18,Solano,095,438530,79773,78914,5437,84351,424
2022-02-18,Sonoma,097,501317,81775,80843,2476,83319,431
2022-02-18,Stanislaus,099,539301,115879,115976,17062,133038,1454
2022-02-18,Sutter,101,95872,20155,20060,2010,22070,210
2022-02-18,Tehama,103,63373,11867,11760,2600,14360,152
2022-02-18,Trinity,105,12862,1165,1130,290,1420,20
2022-02-18,Tulare,107,460477,105238,101996,28099,130095,1286
2022-02-18,Tuolumne,109,53932,12407,12036,545,12581,175
2022-02-18,Ventura,111,848112,170963,170331,9182,179513,1384
2022-02-18,Yolo,113,214977,35966,35363,3075,38438,293
2022-02-18,Yuba,115,75493,15561,15449,1165,16614,112
2022-02-17,Alameda,001,1643700,249908,246028,13244,259272,1700
2022-02-17,Alpine,003,1148,121,124,1,125,0
2022-02-17,Amador,005,37829,8308,8203,636,8839,79
2022-02-17,Butte,007,227075,32385,32173,6464,38637,364
2022-02-17,Calaveras,009,45235,7136,7136,340,7476,107
2022-02-17,Colusa,011,21464,3403,3389,1059,4448,21
2022-02-17,Contra Costa,013,1133247,184733,182797,12846,195643,1190
2022-02-17,Del Norte,015,27424,5536,5511,176,5687,45
2022-02-17,El Dorado,017,186661,26290,26101,3148,29249,189
2022-02-17,Fresno,019,978130,227205,223594,23365,246959,2544
2022-02-17,Glenn,021,27897,4910,4881,1587,6468,39
2022-02-17,Humboldt,023,135768,16426,16393,2873,19266,132
2022-02-17,Imperial,025,180216,54627,53967,10691,64658,862
2022-02-17,Inyo,027,18085,4029,4018,458,4476,52
2022-02-17,Kern,029,883053,189293,187158,45542,232700,2095
2022-02-17,Kings,031,150075,50527,49724,3550,53274,421
2022-02-17,Lake,033,64148,10333,10184,866,11050,126
2022-02-17,Lassen,035,31185,8753,8640,871,9511,55
2022-02-17,Los Angeles,037,10098052,2675138,2642878,123035,2765913,29842
2022-02-17,Madera,039,155013,36688,36526,5913,42439,330
2022-02-17,Marin,041,260295,32619,32441,2167,34608,258
2022-02-17,Mariposa,043,17540,2319,2310,192,2502,6
2022-02-17,Mendocino,045,87422,12769,12625,2928,15553,110
2022-02-17,Merced,047,269075,61152,60886,8421,69307,769
2022-02-17,Modoc,049,8938,723,714,248,962,6
2022-02-17,Mono,051,14174,2951,2956,119,3075,5
2022-02-17,Monterey,053,433212,77982,76765,13173,89938,682
2022-02-17,Napa,055,140530,25070,24970,930,25900,127
2022-02-17,Nevada,057,99092,15686,15715,1162,16877,121
2022-02-17,Orange,059,3164182,539575,538019,40678,578697,6416
2022-02-17,Placer,061,380077,61759,61417,7281,68698,560
2022-02-17,Plumas,063,18699,2914,2646,343,2989,13
2022-02-17,Riverside,065,2383286,585026,581788,27639,609427,6087
2022-02-17,Sacramento,067,1510023,276473,270080,26820,296900,2747
2022-02-17,San Benito,069,59416,12717,12665,506,13171,92
2022-02-17,San Bernardino,071,2135413,561098,553151,24543,577694,6400
2022-02-17,San Diego,073,3302833,740420,729549,51066,780615,4947
2022-02-17,San Francisco,075,870044,120411,121197,8084,129281,756
2022-02-17,San Joaquin,077,732212,163877,163083,9401,172484,2033
2022-02-17,San Luis Obispo,079,281455,51260,50823,3660,54483,424
2022-02-17,San Mateo,081,765935,118891,116648,6808,123456,598
2022-02-17,Santa Barbara,083,443738,84373,83988,4691,88679,642
2022-02-17,Santa Clara,085,1922200,303763,303077,12126,315203,2138
2022-02-17,Santa Cruz,087,273765,46098,45532,2087,47619,250
2022-02-17,Shasta,089,179085,29972,29847,6022,35869,479
2022-02-17,Sierra,091,2930,271,269,46,315,0
2022-02-17,Siskiyou,093,43540,4349,4307,2682,6989,70
2022-02-17,Solano,095,438530,79692,78914,5430,84344,424
2022-02-17,Sonoma,097,501317,81708,80843,2469,83312,431
2022-02-17,Stanislaus,099,539301,115775,115976,17045,133021,1454
2022-02-17,Sutter,101,95872,20140,20060,2002,22062,210
2022-02-17,Tehama,103,63373,11858,11760,2599,14359,152
2022-02-17,Trinity,105,12862,1163,1130,288,1418,20
2022-02-17,Tulare,107,460477,105123,101996,28072,130068,1286
2022-02-17,Tuolumne,109,53932,12396,12036,545,12581,175
2022-02-17,Ventura,111,848112,170823,170331,9181,179512,1384
2022-02-17,Yolo,113,214977,35928,35363,3074,38437,293
2022-02-17,Yuba,115,75493,15546,15449,1165,16614,112
2022-02-16,Alameda,001,1643700,249592,245662,13205,258867,1691
2022-02-16,Alpine,003,1148,121,124,1,125,0
2022-02-16,Amador,005,37829,8290,8197,634,8831,77
2022-02-16,Butte,007,227075,32343,32095,6452,38547,363
2022-02-16,Calaveras,009,45235,7130,7129,337,7466,107
2022-02-16,Colusa,011,21464,3398,3384,1059,4443,21
2022-02-16,Contra Costa,013,1133247,184497,182423,12809,195232,1179
2022-02-16,Del Norte,015,27424,5514,5473,172,5645,45
2022-02-16,El Dorado,017,186661,26262,26061,3144,29205,189
2022-02-16,Fresno,019,978130,226843,223056,23316,246372,2542
2022-02-16,Glenn,021,27897,4906,4873,1582,6455,39
2022-02-16,Humboldt,023,135768,16401,16342,2862,19204,132
2022-02-16,Imperial,025,180216,54556,53901,10661,64562,861
2022-02-16,Inyo,027,18085,4025,4013,455,4468,52
2022-02-16,Kern,029,883053,189075,186740,45451,232191,2084
2022-02-16,Kings,031,150075,50474,49575,3541,53116,420
2022-02-16,Lake,033,64148,10306,10145,866,11011,125
2022-02-16,Lassen,035,31185,8720,8618,871,9489,55
2022-02-16,Los Angeles,037,10098052,2673038,2640005,122922,2762927,29749
2022-02-16,Madera,039,155013,36620,36382,5898,42280,330
2022-02-16,Marin,041,260295,32583,32381,2164,34545,257
2022-02-16,Mariposa,043,17540,2317,2305,192,2497,6
2022-02-16,Mendocino,045,87422,12747,12605,2918,15523,108
2022-02-16,Merced,047,269075,61086,60776,8388,69164,767
2022-02-16,Modoc,049,8938,723,711,244,955,6
2022-02-16,Mono,051,14174,2949,2953,119,3072,5
2022-02-16,Monterey,053,433212,77834,76624,13132,89756,682
2022-02-16,Napa,055,140530,25031,24897,927,25824,128
2022-02-16,Nevada,057,99092,15670,15677,1158,16835,121
2022-02-16,Orange,059,3164182,539173,537934,40633,578567,6392
2022-02-16,Placer,061,380077,61716,61278,7268,68546,556
2022-02-16,Plumas,063,18699,2911,2644,341,2985,13
2022-02-16,Riverside,065,2383286,584632,580828,27592,608420,6064
2022-02-16,Sacramento,067,1510023,276148,269416,26764,296180,2736
2022-02-16,San Benito,069,59416,12691,12644,506,13150,92
2022-02-16,San Bernardino,071,2135413,560824,552353,24518,576871,6379
2022-02-16,San Diego,073,3302833,739634,728610,50992,779602,4931
2022-02-16,San Francisco,075,870044,120239,120987,8079,129066,756
2022-02-16,San Joaquin,077,732212,163709,162752,9391,172143,2032
2022-02-16,San Luis Obispo,079,281455,51190,50704,3647,54351,425
2022-02-16,San Mateo,081,765935,118773,116438,6790,123228,595
2022-02-16,Santa Barbara,083,443738,84298,83968,4678,88646,642
2022-02-16,Santa Clara,085,1922200,303379,302439,12090,314529,2130
2022-02-16,Santa Cruz,087,273765,46008,45274,2085,47359,250
2022-02-16,Shasta,089,179085,29933,29767,6010,35777,477
2022-02-16,Sierra,091,2930,270,269,46,315,0
2022-02-16,Siskiyou,093,43540,4342,4302,2676,6978,71
2022-02-16,Solano,095,438530,79577,78742,5423,84165,422
2022-02-16,Sonoma,097,501317,81587,80642,2459,83101,431
2022-02-16,Stanislaus,099,539301,115658,115751,17014,132765,1443
2022-02-16,Sutter,101,95872,20123,20020,1999,22019,210
2022-02-16,Tehama,103,63373,11840,11738,2597,14335,152
2022-02-16,Trinity,105,12862,1163,1130,287,1417,20
2022-02-16,Tulare,107,460477,104999,101817,28018,129835,1281
2022-02-16,Tuolumne,109,53932,12384,11991,544,12535,171
2022-02-16,Ventura,111,848112,170688,170117,9173,179290,1372
2022-02-16,Yolo,113,214977,35877,35284,3071,38355,292
2022-02-16,Yuba,115,75493,15524,15405,1162,16567,110
2022-02-15,Alameda,001,1643700,249244,245265,13176,258441,1683
2022-02-15,Alpine,003,1148,121,124,1,125,0
2022-02-15,Amador,005,37829,8279,8183,633,8816,77
2022-02-15,Butte,007,227075,32292,32011,6438,38449,361
2022-02-15,Calaveras,009,45235,7121,7115,337,7452,106
2022-02-15,Colusa,011,21464,3390,3374,1058,4432,21
2022-02-15,Contra Costa,013,1133247,184240,182041,12777,194818,1179
2022-02-15,Del Norte,015,27424,5488,5439,170,5609,45
2022-02-15,El Dorado,017,186661,26243,25988,3139,29127,189
2022-02-15,Fresno,019,978130,226460,222673,23251,245924,2543
2022-02-15,Glenn,021,27897,4897,4862,1581,6443,39
2022-02-15,Humboldt,023,135768,16358,16297,2847,19144,132
2022-02-15,Imperial,025,180216,54491,53813,10646,64459,860
2022-02-15,Inyo,027,18085,4024,4009,454,4463,52
2022-02-15,Kern,029,883053,188857,186324,45360,231684,2072
2022-02-15,Kings,031,150075,50380,49473,3532,53005,418
2022-02-15,Lake,033,64148,10273,10112,860,10972,123
2022-02-15,Lassen,035,31185,8705,8587,869,9456,55
2022-02-15,Los Angeles,037,10098052,2670787,2638266,122786,2761052,29691
2022-02-15,Madera,039,155013,36555,36260,5878,42138,330
2022-02-15,Marin,041,260295,32541,32355,2162,34517,255
2022-02-15,Mariposa,043,17540,2316,2302,192,2494,6
2022-02-15,Mendocino,045,87422,12730,12580,2899,15479,108
2022-02-15,Merced,047,269075,61003,60674,8357,69031,763
2022-02-15,Modoc,049,8938,721,710,241,951,6
2022-02-15,Mono,051,14174,2948,2952,119,3071,5
2022-02-15,Monterey,053,433212,77708,75530,13072,88602,682
2022-02-15,Napa,055,140530,24981,24832,920,25752,127
2022-02-15,Nevada,057,99092,15643,15643,1157,16800,121
2022-02-15,Orange,059,3164182,538713,537478,40588,578066,6374
2022-02-15,Placer,061,380077,61655,61170,7257,68427,554
2022-02-15,Plumas,063,18699,2907,2638,341,2979,13
2022-02-15,Riverside,065,2383286,584139,579940,27532,607472,6049
2022-02-15,Sacramento,067,1510023,275763,268950,26679,295629,2721
2022-02-15,San Benito,069,59416,12672,12616,506,13122,91
2022-02-15,San Bernardino,071,2135413,560453,551803,24495,576298,6372
2022-02-15,San Diego,073,3302833,738647,727486,50901,778387,4914
2022-02-15,San Francisco,075,870044,120067,120759,8067,128826,756
2022-02-15,San Joaquin,077,732212,163492,162518,9377,171895,2021
2022-02-15,San Luis Obispo,079,281455,51089,50534,3632,54166,419
2022-02-15,San Mateo,081,765935,118637,116253,6768,123021,595
2022-02-15,Santa Barbara,083,443738,84160,83734,4664,88398,640
2022-02-15,Santa Clara,085,1922200,302880,301831,12051,313882,2130
2022-02-15,Santa Cruz,087,273765,45904,45171,2080,47251,250
2022-02-15,Shasta,089,179085,29884,29684,5996,35680,477
2022-02-15,Sierra,091,2930,270,269,46,315,0
2022-02-15,Siskiyou,093,43540,4335,4288,2669,6957,70
2022-02-15,Solano,095,438530,79443,78626,5416,84042,426
2022-02-15,Sonoma,097,501317,81467,80433,2453,82886,431
2022-02-15,Stanislaus,099,539301,115519,115549,16981,132530,1429
2022-02-15,Sutter,101,95872,20095,19980,1994,21974,208
2022-02-15,Tehama,103,63373,11823,11717,2595,14312,151
2022-02-15,Trinity,105,12862,1157,1125,284,1409,20
2022-02-15,Tulare,107,460477,104845,101645,27960,129605,1278
2022-02-15,Tuolumne,109,53932,12364,11945,542,12487,171
2022-02-15,Ventura,111,848112,170516,169942,9164,179106,1372
2022-02-15,Yolo,113,214977,35826,35241,3061,38302,289
2022-02-15,Yuba,115,75493,15495,15372,1157,16529,109
2022-02-14,Alameda,001,1643700,248805,244315,13143,257458,1677
2022-02-14,Alpine,003,1148,121,125,1,126,0
2022-02-14,Amador,005,37829,8264,8164,630,8794,77
2022-02-14,Butte,007,227075,32232,31946,6424,38370,360
2022-02-14,Calaveras,009,45235,7109,7097,335,7432,106
2022-02-14,Colusa,011,21464,3387,3367,1054,4421,21
2022-02-14,Contra Costa,013,1133247,183952,181753,12738,194491,1167
2022-02-14,Del Norte,015,27424,5466,5426,169,5595,45
2022-02-14,El Dorado,017,186661,26209,25915,3131,29046,188
2022-02-14,Fresno,019,978130,225972,222360,23162,245522,2538
2022-02-14,Glenn,021,27897,4891,4854,1581,6435,39
2022-02-14,Humboldt,023,135768,16317,16264,2822,19086,132
2022-02-14,Imperial,025,180216,54422,53765,10616,64381,860
2022-02-14,Inyo,027,18085,4023,4010,453,4463,52
2022-02-14,Kern,029,883053,188511,186037,45251,231288,2063
2022-02-14,Kings,031,150075,50276,49395,3523,52918,419
2022-02-14,Lake,033,64148,10238,10090,857,10947,123
2022-02-14,Lassen,035,31185,8694,8539,867,9406,55
2022-02-14,Los Angeles,037,10098052,2668206,2636064,122656,2758720,29650
2022-02-14,Madera,039,155013,36490,36194,5855,42049,330
2022-02-14,Marin,041,260295,32505,32304,2159,34463,255
2022-02-14,Mariposa,043,17540,2310,2295,192,2487,6
2022-02-14,Mendocino,045,87422,12703,12541,2867,15408,108
2022-02-14,Merced,047,269075,60913,60591,8312,68903,758
2022-02-14,Modoc,049,8938,716,707,241,948,6
2022-02-14,Mono,051,14174,2947,2954,119,3073,5
2022-02-14,Monterey,053,433212,77533,75407,12988,88395,678
2022-02-14,Napa,055,140530,24922,24776,920,25696,127
2022-02-14,Nevada,057,99092,15624,15629,1156,16785,121
2022-02-14,Orange,059,3164182,538209,536924,40522,577446,6355
2022-02-14,Placer,061,380077,61585,61123,7242,68365,554
2022-02-14,Plumas,063,18699,2905,2631,341,2972,13
2022-02-14,Riverside,065,2383286,583587,579174,27462,606636,5994
2022-02-14,Sacramento,067,1510023,275317,268547,26565,295112,2717
2022-02-14,San Benito,069,59416,12648,12598,505,13103,91
2022-02-14,San Bernardino,071,2135413,560021,551338,24475,575813,6372
2022-02-14,San Diego,073,3302833,737658,723902,50808,774710,4894
2022-02-14,San Francisco,075,870044,119877,120581,8057,128638,756
2022-02-14,San Joaquin,077,732212,163252,162363,9354,171717,2018
2022-02-14,San Luis Obispo,079,281455,50977,50465,3622,54087,416
2022-02-14,San Mateo,081,765935,118469,116129,6759,122888,592
2022-02-14,Santa Barbara,083,443738,84014,83697,4654,88351,636
2022-02-14,Santa Clara,085,1922200,302336,301319,12027,313346,2127
2022-02-14,Santa Cruz,087,273765,45740,45042,2076,47118,250
2022-02-14,Shasta,089,179085,29799,29595,5978,35573,474
2022-02-14,Sierra,091,2930,270,269,46,315,0
2022-02-14,Siskiyou,093,43540,4322,4278,2655,6933,69
2022-02-14,Solano,095,438530,79266,78533,5404,83937,427
2022-02-14,Sonoma,097,501317,81321,80336,2443,82779,431
2022-02-14,Stanislaus,099,539301,115342,115426,16937,132363,1406
2022-02-14,Sutter,101,95872,20066,19957,1988,21945,209
2022-02-14,Tehama,103,63373,11800,11686,2594,14280,151
2022-02-14,Trinity,105,12862,1154,1123,284,1407,20
2022-02-14,Tulare,107,460477,104637,101448,27858,129306,1276
2022-02-14,Tuolumne,109,53932,12333,11920,539,12459,170
2022-02-14,Ventura,111,848112,170339,169725,9152,178877,1361
2022-02-14,Yolo,113,214977,35768,35112,3051,38163,286
2022-02-14,Yuba,115,75493,15465,15375,1153,16528,108
2022-02-13,Alameda,001,1643700,248304,243681,13110,256791,1677
2022-02-13,Alpine,003,1148,121,125,1,126,0
2022-02-13,Amador,005,37829,8235,8146,627,8773,77
2022-02-13,Butte,007,227075,32156,31865,6401,38266,360
2022-02-13,Calaveras,009,45235,7101,7083,332,7415,106
2022-02-13,Colusa,011,21464,3383,3366,1052,4418,21
2022-02-13,Contra Costa,013,1133247,183585,181313,12673,193986,1159
2022-02-13,Del Norte,015,27424,5434,5379,169,5548,45
2022-02-13,El Dorado,017,186661,26173,25871,3122,28993,188
2022-02-13,Fresno,019,978130,225428,221686,23104,244790,2537
2022-02-13,Glenn,021,27897,4881,4847,1578,6425,39
2022-02-13,Humboldt,023,135768,16271,16210,2794,19004,132
2022-02-13,Imperial,025,180216,54331,53658,10578,64236,860
2022-02-13,Inyo,027,18085,4020,4006,451,4457,52
2022-02-13,Kern,029,883053,188265,185640,45164,230804,2063
2022-02-13,Kings,031,150075,50149,49243,3509,52752,416
2022-02-13,Lake,033,64148,10176,10042,849,10891,123
2022-02-13,Lassen,035,31185,8663,8503,865,9368,55
2022-02-13,Los Angeles,037,10098052,2665040,2631267,122514,2753781,29595
2022-02-13,Madera,039,155013,36372,36054,5826,41880,330
2022-02-13,Marin,041,260295,32434,32222,2152,34374,255
2022-02-13,Mariposa,043,17540,2304,2292,190,2482,6
2022-02-13,Mendocino,045,87422,12672,12521,2826,15347,108
2022-02-13,Merced,047,269075,60769,60460,8258,68718,758
2022-02-13,Modoc,049,8938,714,704,234,938,6
2022-02-13,Mono,051,14174,2945,2949,119,3068,5
2022-02-13,Monterey,053,433212,77325,75295,12913,88208,678
2022-02-13,Napa,055,140530,24844,24743,917,25660,127
2022-02-13,Nevada,057,99092,15589,15590,1149,16739,121
2022-02-13,Orange,059,3164182,537578,536134,40460,576594,6355
2022-02-13,Placer,061,380077,61508,61020,7218,68238,554
2022-02-13,Plumas,063,18699,2896,2626,338,2964,13
2022-02-13,Riverside,065,2383286,582991,578363,27417,605780,5995
2022-02-13,Sacramento,067,1510023,274807,267947,26432,294379,2699
2022-02-13,San Benito,069,59416,12615,12578,504,13082,91
2022-02-13,San Bernardino,071,2135413,559508,550632,24441,575073,6367
2022-02-13,San Diego,073,3302833,736488,723902,50700,774602,4894
2022-02-13,San Francisco,075,870044,119622,120295,8045,128340,756
2022-02-13,San Joaquin,077,732212,162940,162028,9325,171353,2018
2022-02-13,San Luis Obispo,079,281455,50832,50384,3614,53998,415
2022-02-13,San Mateo,081,765935,118245,115876,6734,122610,592
2022-02-13,Santa Barbara,083,443738,83849,83547,4646,88193,635
2022-02-13,Santa Clara,085,1922200,301684,300412,11990,312402,2114
2022-02-13,Santa Cruz,087,273765,45584,44887,2074,46961,240
2022-02-13,Shasta,089,179085,29717,29531,5953,35484,474
2022-02-13,Sierra,091,2930,270,269,46,315,0
2022-02-13,Siskiyou,093,43540,4315,4264,2639,6903,69
2022-02-13,Solano,095,438530,79111,78424,5380,83804,426
2022-02-13,Sonoma,097,501317,81152,80172,2431,82603,431
2022-02-13,Stanislaus,099,539301,115140,115156,16896,132052,1406
2022-02-13,Sutter,101,95872,20025,19900,1988,21888,209
2022-02-13,Tehama,103,63373,11772,11644,2589,14233,151
2022-02-13,Trinity,105,12862,1151,1120,281,1401,20
2022-02-13,Tulare,107,460477,104414,101135,27764,128899,1276
2022-02-13,Tuolumne,109,53932,12308,11891,534,12425,170
2022-02-13,Ventura,111,848112,170144,169422,9132,178554,1361
2022-02-13,Yolo,113,214977,35701,35057,3039,38096,286
2022-02-13,Yuba,115,75493,15431,15346,1151,16497,107
2022-02-12,Alameda,001,1643700,248084,242137,13096,255233,1668
2022-02-12,Alpine,003,1148,121,124,1,125,0
2022-02-12,Amador,005,37829,8229,8091,627,8718,76
2022-02-12,Butte,007,227075,32130,31601,6396,37997,360
2022-02-12,Calaveras,009,45235,7098,7022,331,7353,106
2022-02-12,Colusa,011,21464,3379,3345,1052,4397,21
2022-02-12,Contra Costa,013,1133247,183395,180270,12666,192936,1141
2022-02-12,Del Norte,015,27424,5414,5262,169,5431,45
2022-02-12,El Dorado,017,186661,26157,25692,3122,28814,188
2022-02-12,Fresno,019,978130,225214,219909,23091,243000,2509
2022-02-12,Glenn,021,27897,4880,4818,1577,6395,39
2022-02-12,Humboldt,023,135768,16248,16058,2790,18848,132
2022-02-12,Imperial,025,180216,54286,53304,10567,63871,860
2022-02-12,Inyo,027,18085,4018,3991,451,4442,52
2022-02-12,Kern,029,883053,188158,184639,45127,229766,2037
2022-02-12,Kings,031,150075,50109,48893,3502,52395,415
2022-02-12,Lake,033,64148,10155,9926,844,10770,123
2022-02-12,Lassen,035,31185,8640,8477,864,9341,55
2022-02-12,Los Angeles,037,10098052,2663905,2616426,122437,2738863,29364
2022-02-12,Madera,039,155013,36339,35710,5819,41529,330
2022-02-12,Marin,041,260295,32401,32048,2149,34197,255
2022-02-12,Mariposa,043,17540,2304,2286,190,2476,6
2022-02-12,Mendocino,045,87422,12656,12439,2826,15265,107
2022-02-12,Merced,047,269075,60717,60187,8253,68440,758
2022-02-12,Modoc,049,8938,714,697,234,931,6
2022-02-12,Mono,051,14174,2945,2939,119,3058,5
2022-02-12,Monterey,053,433212,77265,74842,12888,87730,672
2022-02-12,Napa,055,140530,24816,24530,917,25447,124
2022-02-12,Nevada,057,99092,15577,15499,1147,16646,119
2022-02-12,Orange,059,3164182,537289,534503,40424,574927,6305
2022-02-12,Placer,061,380077,61449,60636,7215,67851,554
2022-02-12,Plumas,063,18699,2895,2617,337,2954,13
2022-02-12,Riverside,065,2383286,582635,575566,27393,602959,5961
2022-02-12,Sacramento,067,1510023,274571,266347,26423,292770,2686
2022-02-12,San Benito,069,59416,12603,12526,504,13030,91
2022-02-12,San Bernardino,071,2135413,559274,548822,24428,573250,6360
2022-02-12,San Diego,073,3302833,735963,720287,50654,770941,4854
2022-02-12,San Francisco,075,870044,119501,119113,8034,127147,740
2022-02-12,San Joaquin,077,732212,162812,161234,9319,170553,2014
2022-02-12,San Luis Obispo,079,281455,50796,50064,3610,53674,416
2022-02-12,San Mateo,081,765935,118155,115235,6726,121961,589
2022-02-12,Santa Barbara,083,443738,83761,83390,4636,88026,631
2022-02-12,Santa Clara,085,1922200,301340,298176,11982,310158,2093
2022-02-12,Santa Cruz,087,273765,45548,44447,2072,46519,239
2022-02-12,Shasta,089,179085,29689,29370,5949,35319,473
2022-02-12,Sierra,091,2930,270,268,46,314,0
2022-02-12,Siskiyou,093,43540,4308,4231,2636,6867,68
2022-02-12,Solano,095,438530,79069,77865,5377,83242,424
2022-02-12,Sonoma,097,501317,81047,79533,2429,81962,431
2022-02-12,Stanislaus,099,539301,115015,114531,16884,131415,1406
2022-02-12,Sutter,101,95872,20010,19800,1988,21788,211
2022-02-12,Tehama,103,63373,11758,11580,2589,14169,151
2022-02-12,Trinity,105,12862,1150,1115,281,1396,20
2022-02-12,Tulare,107,460477,104317,100434,27725,128159,1273
2022-02-12,Tuolumne,109,53932,12290,11754,534,12288,125
2022-02-12,Ventura,111,848112,170036,168736,9127,177863,1340
2022-02-12,Yolo,113,214977,35660,34773,3036,37809,286
2022-02-12,Yuba,115,75493,15415,15242,1150,16392,107
2022-02-11,Alameda,001,1643700,247803,242137,13082,255219,1668
2022-02-11,Alpine,003,1148,121,124,1,125,0
2022-02-11,Amador,005,37829,8216,8091,627,8718,76
2022-02-11,Butte,007,227075,32086,31601,6385,37986,360
2022-02-11,Calaveras,009,45235,7095,7022,331,7353,106
2022-02-11,Colusa,011,21464,3377,3345,1051,4396,21
2022-02-11,Contra Costa,013,1133247,183191,180270,12646,192916,1141
2022-02-11,Del Norte,015,27424,5399,5262,168,5430,45
2022-02-11,El Dorado,017,186661,26137,25692,3121,28813,188
2022-02-11,Fresno,019,978130,224919,219909,23076,242985,2509
2022-02-11,Glenn,021,27897,4876,4818,1577,6395,39
2022-02-11,Humboldt,023,135768,16218,16058,2785,18843,132
2022-02-11,Imperial,025,180216,54256,53304,10556,63860,860
2022-02-11,Inyo,027,18085,4015,3991,446,4437,52
2022-02-11,Kern,029,883053,187996,184639,45073,229712,2037
2022-02-11,Kings,031,150075,50070,48893,3501,52394,415
2022-02-11,Lake,033,64148,10129,9926,842,10768,123
2022-02-11,Lassen,035,31185,8600,8477,864,9341,55
2022-02-11,Los Angeles,037,10098052,2662272,2616426,122347,2738773,29364
2022-02-11,Madera,039,155013,36297,35710,5814,41524,330
2022-02-11,Marin,041,260295,32368,32048,2146,34194,255
2022-02-11,Mariposa,043,17540,2299,2286,190,2476,6
2022-02-11,Mendocino,045,87422,12640,12439,2826,15265,107
2022-02-11,Merced,047,269075,60668,60187,8246,68433,758
2022-02-11,Modoc,049,8938,712,697,234,931,6
2022-02-11,Mono,051,14174,2944,2939,119,3058,5
2022-02-11,Monterey,053,433212,77146,74842,12874,87716,672
2022-02-11,Napa,055,140530,24788,24530,917,25447,124
2022-02-11,Nevada,057,99092,15562,15499,1144,16643,119
2022-02-11,Orange,059,3164182,536938,534503,40359,574862,6305
2022-02-11,Placer,061,380077,61397,60636,7213,67849,554
2022-02-11,Plumas,063,18699,2891,2617,335,2952,13
2022-02-11,Riverside,065,2383286,582214,575566,27376,602942,5961
2022-02-11,Sacramento,067,1510023,274306,266347,26410,292757,2686
2022-02-11,San Benito,069,59416,12598,12526,504,13030,91
2022-02-11,San Bernardino,071,2135413,558956,548822,24413,573235,6360
2022-02-11,San Diego,073,3302833,735244,720287,50598,770885,4854
2022-02-11,San Francisco,075,870044,119381,119113,8018,127131,740
2022-02-11,San Joaquin,077,732212,162643,161234,9307,170541,2014
2022-02-11,San Luis Obispo,079,281455,50759,50064,3606,53670,416
2022-02-11,San Mateo,081,765935,118038,115235,6717,121952,589
2022-02-11,Santa Barbara,083,443738,83677,83390,4635,88025,631
2022-02-11,Santa Clara,085,1922200,300915,298176,11963,310139,2093
2022-02-11,Santa Cruz,087,273765,45456,44447,2072,46519,239
2022-02-11,Shasta,089,179085,29658,29370,5941,35311,473
2022-02-11,Sierra,091,2930,269,268,45,313,0
2022-02-11,Siskiyou,093,43540,4297,4231,2630,6861,68
2022-02-11,Solano,095,438530,78945,77865,5372,83237,424
2022-02-11,Sonoma,097,501317,80957,79533,2424,81957,431
2022-02-11,Stanislaus,099,539301,114914,114531,16871,131402,1406
2022-02-11,Sutter,101,95872,19987,19800,1986,21786,211
2022-02-11,Tehama,103,63373,11745,11580,2588,14168,151
2022-02-11,Trinity,105,12862,1149,1115,280,1395,20
2022-02-11,Tulare,107,460477,104200,100434,27671,128105,1273
2022-02-11,Tuolumne,109,53932,12275,11754,532,12286,125
2022-02-11,Ventura,111,848112,169896,168736,9122,177858,1340
2022-02-11,Yolo,113,214977,35627,34773,3034,37807,286
2022-02-11,Yuba,115,75493,15399,15242,1149,16391,107
2022-02-10,Alameda,001,1643700,247267,242137,13036,255173,1668
2022-02-10,Alpine,003,1148,121,124,1,125,0
2022-02-10,Amador,005,37829,8205,8091,620,8711,76
2022-02-10,Butte,007,227075,32033,31601,6373,37974,360
2022-02-10,Calaveras,009,45235,7083,7022,329,7351,106
2022-02-10,Colusa,011,21464,3371,3345,1049,4394,21
2022-02-10,Contra Costa,013,1133247,182826,180270,12581,192851,1141
2022-02-10,Del Norte,015,27424,5369,5262,166,5428,45
2022-02-10,El Dorado,017,186661,26092,25692,3114,28806,188
2022-02-10,Fresno,019,978130,224328,219909,22989,242898,2509
2022-02-10,Glenn,021,27897,4871,4818,1575,6393,39
2022-02-10,Humboldt,023,135768,16168,16058,2763,18821,132
2022-02-10,Imperial,025,180216,54185,53304,10514,63818,860
2022-02-10,Inyo,027,18085,4011,3991,446,4437,52
2022-02-10,Kern,029,883053,187688,184639,44960,229599,2037
2022-02-10,Kings,031,150075,49958,48893,3490,52383,415
2022-02-10,Lake,033,64148,10098,9926,840,10766,123
2022-02-10,Lassen,035,31185,8586,8477,862,9339,55
2022-02-10,Los Angeles,037,10098052,2659119,2616426,122159,2738585,29364
2022-02-10,Madera,039,155013,36199,35710,5782,41492,330
2022-02-10,Marin,041,260295,32310,32048,2134,34182,255
2022-02-10,Mariposa,043,17540,2295,2286,189,2475,6
2022-02-10,Mendocino,045,87422,12619,12439,2801,15240,107
2022-02-10,Merced,047,269075,60540,60187,8191,68378,758
2022-02-10,Modoc,049,8938,711,697,233,930,6
2022-02-10,Mono,051,14174,2942,2939,118,3057,5
2022-02-10,Monterey,053,433212,76963,74842,12787,87629,672
2022-02-10,Napa,055,140530,24721,24530,915,25445,124
2022-02-10,Nevada,057,99092,15537,15499,1143,16642,119
2022-02-10,Orange,059,3164182,536287,534503,40290,574793,6305
2022-02-10,Placer,061,380077,61316,60636,7204,67840,554
2022-02-10,Plumas,063,18699,2888,2617,328,2945,13
2022-02-10,Riverside,065,2383286,581479,575566,27318,602884,5961
2022-02-10,Sacramento,067,1510023,273825,266347,26319,292666,2686
2022-02-10,San Benito,069,59416,12577,12526,502,13028,91
2022-02-10,San Bernardino,071,2135413,558406,548822,24381,573203,6360
2022-02-10,San Diego,073,3302833,734095,720287,50477,770764,4854
2022-02-10,San Francisco,075,870044,119168,119113,8000,127113,740
2022-02-10,San Joaquin,077,732212,162328,161234,9299,170533,2014
2022-02-10,San Luis Obispo,079,281455,50660,50064,3595,53659,416
2022-02-10,San Mateo,081,765935,117813,115235,6700,121935,589
2022-02-10,Santa Barbara,083,443738,83493,83390,4628,88018,631
2022-02-10,Santa Clara,085,1922200,300231,298176,11905,310081,2093
2022-02-10,Santa Cruz,087,273765,45311,44447,2071,46518,239
2022-02-10,Shasta,089,179085,29596,29370,5921,35291,473
2022-02-10,Sierra,091,2930,269,268,45,313,0
2022-02-10,Siskiyou,093,43540,4292,4231,2617,6848,68
2022-02-10,Solano,095,438530,78754,77865,5354,83219,424
2022-02-10,Sonoma,097,501317,80822,79533,2408,81941,431
2022-02-10,Stanislaus,099,539301,114735,114531,16827,131358,1406
2022-02-10,Sutter,101,95872,19948,19800,1971,21771,211
2022-02-10,Tehama,103,63373,11712,11580,2585,14165,151
2022-02-10,Trinity,105,12862,1146,1115,279,1394,20
2022-02-10,Tulare,107,460477,103995,100434,27589,128023,1273
2022-02-10,Tuolumne,109,53932,12253,11754,527,12281,125
2022-02-10,Ventura,111,848112,169616,168736,9108,177844,1340
2022-02-10,Yolo,113,214977,35548,34773,3028,37801,286
2022-02-10,Yuba,115,75493,15368,15242,1143,16385,107
2022-02-09,Alameda,001,1643700,246738,241141,12977,254118,1668
2022-02-09,Alpine,003,1148,120,124,1,125,0
2022-02-09,Amador,005,37829,8191,8069,615,8684,76
2022-02-09,Butte,007,227075,31941,31433,6357,37790,359
2022-02-09,Calaveras,009,45235,7065,7005,325,7330,106
2022-02-09,Colusa,011,21464,3368,3331,1048,4379,21
2022-02-09,Contra Costa,013,1133247,182473,179695,12534,192229,1132
2022-02-09,Del Norte,015,27424,5322,5204,165,5369,45
2022-02-09,El Dorado,017,186661,26056,25572,3103,28675,186
2022-02-09,Fresno,019,978130,223716,218989,22907,241896,2502
2022-02-09,Glenn,021,27897,4859,4804,1574,6378,39
2022-02-09,Humboldt,023,135768,16121,15929,2738,18667,131
2022-02-09,Imperial,025,180216,54080,53102,10441,63543,858
2022-02-09,Inyo,027,18085,4005,3989,445,4434,52
2022-02-09,Kern,029,883053,187311,184068,44845,228913,2021
2022-02-09,Kings,031,150075,49846,48718,3484,52202,410
2022-02-09,Lake,033,64148,10058,9880,835,10715,124
2022-02-09,Lassen,035,31185,8558,8459,861,9320,55
2022-02-09,Los Angeles,037,10098052,2655447,2611611,122023,2733634,29263
2022-02-09,Madera,039,155013,36101,35559,5752,41311,330
2022-02-09,Marin,041,260295,32259,31965,2127,34092,255
2022-02-09,Mariposa,043,17540,2292,2279,189,2468,6
2022-02-09,Mendocino,045,87422,12585,12378,2772,15150,107
2022-02-09,Merced,047,269075,60410,59952,8139,68091,755
2022-02-09,Modoc,049,8938,707,691,232,923,6
2022-02-09,Mono,051,14174,2940,2937,118,3055,5
2022-02-09,Monterey,053,433212,76762,74500,12696,87196,670
2022-02-09,Napa,055,140530,24676,24429,910,25339,123
2022-02-09,Nevada,057,99092,15517,15446,1141,16587,119
2022-02-09,Orange,059,3164182,535654,534316,40210,574526,6263
2022-02-09,Placer,061,380077,61219,60490,7184,67674,553
2022-02-09,Plumas,063,18699,2883,2609,324,2933,13
2022-02-09,Riverside,065,2383286,580739,573907,27271,601178,5911
2022-02-09,Sacramento,067,1510023,273251,265624,26192,291816,2673
2022-02-09,San Benito,069,59416,12553,12492,502,12994,91
2022-02-09,San Bernardino,071,2135413,557800,547768,24352,572120,6349
2022-02-09,San Diego,073,3302833,732723,717896,50369,768265,4832
2022-02-09,San Francisco,075,870044,118919,118550,7989,126539,731
2022-02-09,San Joaquin,077,732212,162026,160618,9289,169907,2014
2022-02-09,San Luis Obispo,079,281455,50515,49833,3590,53423,414
2022-02-09,San Mateo,081,765935,117624,114890,6659,121549,589
2022-02-09,Santa Barbara,083,443738,83314,82830,4622,87452,629
2022-02-09,Santa Clara,085,1922200,299505,297157,11847,309004,2090
2022-02-09,Santa Cruz,087,273765,45128,44200,2064,46264,239
2022-02-09,Shasta,089,179085,29526,29215,5900,35115,471
2022-02-09,Sierra,091,2930,268,268,44,312,0
2022-02-09,Siskiyou,093,43540,4278,4217,2611,6828,68
2022-02-09,Solano,095,438530,78563,77299,5342,82641,423
2022-02-09,Sonoma,097,501317,80648,79165,2401,81566,431
2022-02-09,Stanislaus,099,539301,114487,114039,16579,130618,1406
2022-02-09,Sutter,101,95872,19906,19758,1958,21716,207
2022-02-09,Tehama,103,63373,11685,11542,2581,14123,149
2022-02-09,Trinity,105,12862,1142,1110,278,1388,20
2022-02-09,Tulare,107,460477,103782,100049,27489,127538,1271
2022-02-09,Tuolumne,109,53932,12216,11702,524,12226,95
2022-02-09,Ventura,111,848112,169380,168253,9096,177349,1325
2022-02-09,Yolo,113,214977,35476,34588,3013,37601,285
2022-02-09,Yuba,115,75493,15338,15187,1131,16318,105
2022-02-08,Alameda,001,1643700,246108,240587,12903,253490,1651
2022-02-08,Alpine,003,1148,120,124,1,125,0
2022-02-08,Amador,005,37829,8183,8050,608,8658,76
2022-02-08,Butte,007,227075,31857,31353,6334,37687,359
2022-02-08,Calaveras,009,45235,7049,6981,323,7304,101
2022-02-08,Colusa,011,21464,3359,3320,1047,4367,21
2022-02-08,Contra Costa,013,1133247,182046,179078,12457,191535,1132
2022-02-08,Del Norte,015,27424,5296,5156,160,5316,44
2022-02-08,El Dorado,017,186661,26010,25446,3092,28538,186
2022-02-08,Fresno,019,978130,222982,218416,22800,241216,2502
2022-02-08,Glenn,021,27897,4842,4784,1570,6354,39
2022-02-08,Humboldt,023,135768,16061,15865,2705,18570,130
2022-02-08,Imperial,025,180216,53952,52977,10396,63373,855
2022-02-08,Inyo,027,18085,4000,3983,445,4428,52
2022-02-08,Kern,029,883053,186983,183519,44712,228231,2010
2022-02-08,Kings,031,150075,49696,48479,3472,51951,411
2022-02-08,Lake,033,64148,10028,9806,829,10635,125
2022-02-08,Lassen,035,31185,8549,8423,857,9280,55
2022-02-08,Los Angeles,037,10098052,2651155,2611204,121832,2733036,29259
2022-02-08,Madera,039,155013,35994,35381,5697,41078,330
2022-02-08,Marin,041,260295,32184,31878,2122,34000,255
2022-02-08,Mariposa,043,17540,2290,2266,181,2447,6
2022-02-08,Mendocino,045,87422,12552,12336,2741,15077,107
2022-02-08,Merced,047,269075,60302,59789,8080,67869,751
2022-02-08,Modoc,049,8938,703,684,232,916,6
2022-02-08,Mono,051,14174,2939,2932,118,3050,5
2022-02-08,Monterey,053,433212,76555,74316,12602,86918,670
2022-02-08,Napa,055,140530,24602,24346,903,25249,121
2022-02-08,Nevada,057,99092,15490,15383,1138,16521,117
2022-02-08,Orange,059,3164182,534969,533507,40123,573630,6205
2022-02-08,Placer,061,380077,61111,60301,7171,67472,553
2022-02-08,Plumas,063,18699,2872,2596,318,2914,13
2022-02-08,Riverside,065,2383286,579914,571892,27195,599087,5908
2022-02-08,Sacramento,067,1510023,272582,264479,26015,290494,2664
2022-02-08,San Benito,069,59416,12529,12434,500,12934,91
2022-02-08,San Bernardino,071,2135413,557112,544658,24308,568966,6335
2022-02-08,San Diego,073,3302833,731126,717896,50240,768136,4832
2022-02-08,San Francisco,075,870044,118607,117942,7980,125922,731
2022-02-08,San Joaquin,077,732212,161648,160147,9271,169418,2005
2022-02-08,San Luis Obispo,079,281455,50348,49556,3558,53114,410
2022-02-08,San Mateo,081,765935,117403,114541,6629,121170,589
2022-02-08,Santa Barbara,083,443738,83147,82461,4596,87057,627
2022-02-08,Santa Clara,085,1922200,298624,295679,11797,307476,2091
2022-02-08,Santa Cruz,087,273765,44976,43884,2059,45943,239
2022-02-08,Shasta,089,179085,29440,29084,5871,34955,470
2022-02-08,Sierra,091,2930,268,267,44,311,0
2022-02-08,Siskiyou,093,43540,4268,4191,2601,6792,68
2022-02-08,Solano,095,438530,78332,77031,5328,82359,421
2022-02-08,Sonoma,097,501317,80431,78798,2379,81177,431
2022-02-08,Stanislaus,099,539301,114233,113733,16503,130236,1406
2022-02-08,Sutter,101,95872,19867,19717,1946,21663,203
2022-02-08,Tehama,103,63373,11661,11491,2573,14064,149
2022-02-08,Trinity,105,12862,1136,1110,278,1388,20
2022-02-08,Tulare,107,460477,103497,99694,27353,127047,1267
2022-02-08,Tuolumne,109,53932,12193,11665,522,12187,92
2022-02-08,Ventura,111,848112,169146,167830,9080,176910,1325
2022-02-08,Yolo,113,214977,35394,34462,2999,37461,281
2022-02-08,Yuba,115,75493,15293,15126,1109,16235,107
2022-02-07,Alameda,001,1643700,245403,238678,12835,251513,1643
2022-02-07,Alpine,003,1148,120,124,1,125,0
2022-02-07,Amador,005,37829,8155,7980,600,8580,75
2022-02-07,Butte,007,227075,31771,31184,6308,37492,355
2022-02-07,Calaveras,009,45235,7027,6910,322,7232,100
2022-02-07,Colusa,011,21464,3349,3283,1041,4324,21
2022-02-07,Contra Costa,013,1133247,181590,177767,12388,190155,1130
2022-02-07,Del Norte,015,27424,5257,5093,155,5248,44
2022-02-07,El Dorado,017,186661,25948,25257,3080,28337,185
2022-02-07,Fresno,019,978130,222134,216495,22667,239162,2493
2022-02-07,Glenn,021,27897,4836,4762,1566,6328,39
2022-02-07,Humboldt,023,135768,15987,15764,2680,18444,129
2022-02-07,Imperial,025,180216,53841,52689,10328,63017,853
2022-02-07,Inyo,027,18085,3995,3976,439,4415,51
2022-02-07,Kern,029,883053,186515,182047,44541,226588,1998
2022-02-07,Kings,031,150075,49515,48147,3456,51603,403
2022-02-07,Lake,033,64148,9982,9519,821,10340,125
2022-02-07,Lassen,035,31185,8530,8362,851,9213,55
2022-02-07,Los Angeles,037,10098052,2646732,2607438,121621,2729059,29210
2022-02-07,Madera,039,155013,35869,35083,5649,40732,330
2022-02-07,Marin,041,260295,32118,31670,2111,33781,255
2022-02-07,Mariposa,043,17540,2285,2253,177,2430,6
2022-02-07,Mendocino,045,87422,12494,12237,2703,14940,107
2022-02-07,Merced,047,269075,60177,59472,7988,67460,748
2022-02-07,Modoc,049,8938,699,679,232,911,6
2022-02-07,Mono,051,14174,2937,2917,118,3035,5
2022-02-07,Monterey,053,433212,76304,69433,12495,81928,670
2022-02-07,Napa,055,140530,24516,23237,893,24130,120
2022-02-07,Nevada,057,99092,15456,15268,1132,16400,113
2022-02-07,Orange,059,3164182,534209,531442,40041,571483,6179
2022-02-07,Placer,061,380077,60987,59894,7156,67050,546
2022-02-07,Plumas,063,18699,2861,2573,310,2883,13
2022-02-07,Riverside,065,2383286,578978,568874,27108,595982,5868
2022-02-07,Sacramento,067,1510023,271907,262834,25821,288655,2631
2022-02-07,San Benito,069,59416,12491,12285,498,12783,90
2022-02-07,San Bernardino,071,2135413,556323,542846,24269,567115,6335
2022-02-07,San Diego,073,3302833,729380,716244,50056,766300,4811
2022-02-07,San Francisco,075,870044,118269,113945,7955,121900,727
2022-02-07,San Joaquin,077,732212,161268,159358,9252,168610,1998
2022-02-07,San Luis Obispo,079,281455,50181,48994,3537,52531,406
2022-02-07,San Mateo,081,765935,117119,107060,6600,113660,589
2022-02-07,Santa Barbara,083,443738,82960,81608,4581,86189,624
2022-02-07,Santa Clara,085,1922200,297669,293360,11749,305109,2085
2022-02-07,Santa Cruz,087,273765,44761,43244,2055,45299,239
2022-02-07,Shasta,089,179085,29352,28900,5844,34744,468
2022-02-07,Sierra,091,2930,268,265,44,309,0
2022-02-07,Siskiyou,093,43540,4257,4157,2585,6742,68
2022-02-07,Solano,095,438530,78075,73934,5302,79236,420
2022-02-07,Sonoma,097,501317,80172,78296,2368,80664,431
2022-02-07,Stanislaus,099,539301,113974,113029,16349,129378,1406
2022-02-07,Sutter,101,95872,19835,19599,1918,21517,203
2022-02-07,Tehama,103,63373,11623,11418,2565,13983,146
2022-02-07,Trinity,105,12862,1132,1109,275,1384,20
2022-02-07,Tulare,107,460477,103139,98774,27206,125980,1263
2022-02-07,Tuolumne,109,53932,12145,11578,518,12096,92
2022-02-07,Ventura,111,848112,168829,166904,9067,175971,1324
2022-02-07,Yolo,113,214977,35285,34007,2984,36991,281
2022-02-07,Yuba,115,75493,15247,14998,1102,16100,105
2022-02-06,Alameda,001,1643700,244501,237188,12752,249940,1643
2022-02-06,Alpine,003,1148,120,123,1,124,0
2022-02-06,Amador,005,37829,8126,7922,588,8510,73
2022-02-06,Butte,007,227075,31644,31021,6262,37283,355
2022-02-06,Calaveras,009,45235,7000,6870,317,7187,99
2022-02-06,Colusa,011,21464,3340,3282,1040,4322,21
2022-02-06,Contra Costa,013,1133247,180967,176863,12231,189094,1128
2022-02-06,Del Norte,015,27424,5201,5038,153,5191,44
2022-02-06,El Dorado,017,186661,25885,25165,3068,28233,185
2022-02-06,Fresno,019,978130,221293,214726,22410,237136,2489
2022-02-06,Glenn,021,27897,4823,4738,1556,6294,39
2022-02-06,Humboldt,023,135768,15900,15658,2640,18298,128
2022-02-06,Imperial,025,180216,53650,52396,10279,62675,853
2022-02-06,Inyo,027,18085,3993,3970,436,4406,51
2022-02-06,Kern,029,883053,185965,181188,44300,225488,1996
2022-02-06,Kings,031,150075,49293,47669,3430,51099,401
2022-02-06,Lake,033,64148,9914,9468,803,10271,125
2022-02-06,Lassen,035,31185,8511,8326,846,9172,55
2022-02-06,Los Angeles,037,10098052,2641228,2602620,121354,2723974,29180
2022-02-06,Madera,039,155013,35684,34901,5556,40457,330
2022-02-06,Marin,041,260295,32021,31488,2098,33586,255
2022-02-06,Mariposa,043,17540,2277,2244,166,2410,6
2022-02-06,Mendocino,045,87422,12451,12169,2633,14802,107
2022-02-06,Merced,047,269075,59958,59112,7826,66938,748
2022-02-06,Modoc,049,8938,694,675,231,906,6
2022-02-06,Mono,051,14174,2932,2901,116,3017,5
2022-02-06,Monterey,053,433212,75939,67912,12331,80243,670
2022-02-06,Napa,055,140530,24397,23230,885,24115,120
2022-02-06,Nevada,057,99092,15391,15192,1119,16311,113
2022-02-06,Orange,059,3164182,533264,527906,39940,567846,6171
2022-02-06,Placer,061,380077,60811,59507,7130,66637,544
2022-02-06,Plumas,063,18699,2847,2559,301,2860,13
2022-02-06,Riverside,065,2383286,577844,568276,27029,595305,5865
2022-02-06,Sacramento,067,1510023,271032,261353,25550,286903,2631
2022-02-06,San Benito,069,59416,12436,12186,490,12676,90
2022-02-06,San Bernardino,071,2135413,555361,541103,24199,565302,6334
2022-02-06,San Diego,073,3302833,727300,709938,49817,759755,4786
2022-02-06,San Francisco,075,870044,117887,113115,7928,121043,728
2022-02-06,San Joaquin,077,732212,160707,158510,9212,167722,1997
2022-02-06,San Luis Obispo,079,281455,49957,48843,3480,52323,405
2022-02-06,San Mateo,081,765935,116779,105556,6560,112116,587
2022-02-06,Santa Barbara,083,443738,82643,81118,4542,85660,623
2022-02-06,Santa Clara,085,1922200,296549,291732,11627,303359,2075
2022-02-06,Santa Cruz,087,273765,44447,42952,2040,44992,239
2022-02-06,Shasta,089,179085,29224,28762,5794,34556,468
2022-02-06,Sierra,091,2930,268,265,44,309,0
2022-02-06,Siskiyou,093,43540,4236,4118,2559,6677,68
2022-02-06,Solano,095,438530,77776,73475,5262,78737,419
2022-02-06,Sonoma,097,501317,79836,77887,2353,80240,431
2022-02-06,Stanislaus,099,539301,113576,112521,16205,128726,1406
2022-02-06,Sutter,101,95872,19791,19523,1875,21398,203
2022-02-06,Tehama,103,63373,11583,11366,2545,13911,146
2022-02-06,Trinity,105,12862,1131,1102,274,1376,20
2022-02-06,Tulare,107,460477,102694,98260,27001,125261,1262
2022-02-06,Tuolumne,109,53932,12094,11507,501,12008,92
2022-02-06,Ventura,111,848112,168453,166235,9056,175291,1323
2022-02-06,Yolo,113,214977,35146,33784,2968,36752,281
2022-02-06,Yuba,115,75493,15200,14917,1093,16010,104
2022-02-05,Alameda,001,1643700,244092,235698,12743,248441,1638
2022-02-05,Alpine,003,1148,120,124,1,125,0
2022-02-05,Amador,005,37829,8117,7855,585,8440,71
2022-02-05,Butte,007,227075,31591,30733,6248,36981,355
2022-02-05,Calaveras,009,45235,6984,6789,317,7106,99
2022-02-05,Colusa,011,21464,3333,3234,1038,4272,21
2022-02-05,Contra Costa,013,1133247,180698,175871,12215,188086,1115
2022-02-05,Del Norte,015,27424,5161,4978,151,5129,44
2022-02-05,El Dorado,017,186661,25855,24813,3066,27879,185
2022-02-05,Fresno,019,978130,220950,213539,22395,235934,2477
2022-02-05,Glenn,021,27897,4821,4691,1549,6240,39
2022-02-05,Humboldt,023,135768,15853,15514,2636,18150,127
2022-02-05,Imperial,025,180216,53589,52153,10266,62419,853
2022-02-05,Inyo,027,18085,3990,3948,436,4384,51
2022-02-05,Kern,029,883053,185758,180296,44195,224491,1987
2022-02-05,Kings,031,150075,49209,47538,3423,50961,402
2022-02-05,Lake,033,64148,9895,9289,796,10085,124
2022-02-05,Lassen,035,31185,8500,8288,844,9132,55
2022-02-05,Los Angeles,037,10098052,2639058,2572702,121227,2693929,28947
2022-02-05,Madera,039,155013,35631,34471,5544,40015,329
2022-02-05,Marin,041,260295,31974,31299,2094,33393,255
2022-02-05,Mariposa,043,17540,2276,2222,165,2387,6
2022-02-05,Mendocino,045,87422,12423,12066,2631,14697,107
2022-02-05,Merced,047,269075,59865,58908,7818,66726,744
2022-02-05,Modoc,049,8938,693,664,231,895,6
2022-02-05,Mono,051,14174,2931,2904,116,3020,5
2022-02-05,Monterey,053,433212,75823,67342,12290,79632,666
2022-02-05,Napa,055,140530,24342,22973,884,23857,118
2022-02-05,Nevada,057,99092,15370,15002,1114,16116,113
2022-02-05,Orange,059,3164182,532823,527516,39849,567365,6134
2022-02-05,Placer,061,380077,60686,59043,7116,66159,533
2022-02-05,Plumas,063,18699,2846,2550,300,2850,13
2022-02-05,Riverside,065,2383286,577247,563991,26958,590949,5827
2022-02-05,Sacramento,067,1510023,270635,259437,25512,284949,2610
2022-02-05,San Benito,069,59416,12391,12142,490,12632,90
2022-02-05,San Bernardino,071,2135413,554857,539312,24177,563489,6322
2022-02-05,San Diego,073,3302833,726431,703957,49743,753700,4735
2022-02-05,San Francisco,075,870044,117678,112481,7899,120380,720
2022-02-05,San Joaquin,077,732212,160521,157420,9201,166621,1989
2022-02-05,San Luis Obispo,079,281455,49920,48361,3478,51839,404
2022-02-05,San Mateo,081,765935,116592,104810,6552,111362,587
2022-02-05,Santa Barbara,083,443738,82481,80478,4530,85008,617
2022-02-05,Santa Clara,085,1922200,295890,289262,11611,300873,2067
2022-02-05,Santa Cruz,087,273765,44374,42553,2037,44590,239
2022-02-05,Shasta,089,179085,29182,28604,5784,34388,466
2022-02-05,Sierra,091,2930,268,262,44,306,0
2022-02-05,Siskiyou,093,43540,4229,4106,2546,6652,67
2022-02-05,Solano,095,438530,77701,73112,5254,78366,415
2022-02-05,Sonoma,097,501317,79673,77213,2349,79562,431
2022-02-05,Stanislaus,099,539301,113374,111783,16185,127968,1406
2022-02-05,Sutter,101,95872,19762,19406,1869,21275,203
2022-02-05,Tehama,103,63373,11564,11259,2538,13797,146
2022-02-05,Trinity,105,12862,1129,1085,274,1359,20
2022-02-05,Tulare,107,460477,102529,97414,26918,124332,1254
2022-02-05,Tuolumne,109,53932,12069,11409,498,11907,91
2022-02-05,Ventura,111,848112,168229,165532,9040,174572,1308
2022-02-05,Yolo,113,214977,35063,33614,2954,36568,281
2022-02-05,Yuba,115,75493,15170,14801,1085,15886,105
2022-02-04,Alameda,001,1643700,243607,235698,12733,248431,1638
2022-02-04,Alpine,003,1148,120,124,1,125,0
2022-02-04,Amador,005,37829,8101,7855,581,8436,71
2022-02-04,Butte,007,227075,31531,30733,6237,36970,355
2022-02-04,Calaveras,009,45235,6974,6789,315,7104,99
2022-02-04,Colusa,011,21464,3328,3234,1036,4270,21
2022-02-04,Contra Costa,013,1133247,180374,175871,12186,188057,1115
2022-02-04,Del Norte,015,27424,5141,4978,151,5129,44
2022-02-04,El Dorado,017,186661,25819,24813,3061,27874,185
2022-02-04,Fresno,019,978130,220468,213539,22367,235906,2477
2022-02-04,Glenn,021,27897,4812,4691,1546,6237,39
2022-02-04,Humboldt,023,135768,15828,15514,2633,18147,127
2022-02-04,Imperial,025,180216,53517,52153,10249,62402,853
2022-02-04,Inyo,027,18085,3987,3948,435,4383,51
2022-02-04,Kern,029,883053,185534,180296,44067,224363,1987
2022-02-04,Kings,031,150075,49133,47538,3416,50954,402
2022-02-04,Lake,033,64148,9873,9289,793,10082,124
2022-02-04,Lassen,035,31185,8477,8288,844,9132,55
2022-02-04,Los Angeles,037,10098052,2636427,2572702,121098,2693800,28947
2022-02-04,Madera,039,155013,35547,34471,5536,40007,329
2022-02-04,Marin,041,260295,31909,31299,2085,33384,255
2022-02-04,Mariposa,043,17540,2274,2222,163,2385,6
2022-02-04,Mendocino,045,87422,12392,12066,2629,14695,107
2022-02-04,Merced,047,269075,59786,58908,7808,66716,744
2022-02-04,Modoc,049,8938,693,664,231,895,6
2022-02-04,Mono,051,14174,2929,2904,116,3020,5
2022-02-04,Monterey,053,433212,75632,67342,12249,79591,666
2022-02-04,Napa,055,140530,24295,22973,880,23853,118
2022-02-04,Nevada,057,99092,15336,15002,1110,16112,113
2022-02-04,Orange,059,3164182,532274,527516,39791,567307,6134
2022-02-04,Placer,061,380077,60584,59043,7105,66148,533
2022-02-04,Plumas,063,18699,2840,2550,299,2849,13
2022-02-04,Riverside,065,2383286,576542,563991,26945,590936,5827
2022-02-04,Sacramento,067,1510023,270135,259437,25489,284926,2610
2022-02-04,San Benito,069,59416,12372,12142,488,12630,90
2022-02-04,San Bernardino,071,2135413,554281,539312,24155,563467,6322
2022-02-04,San Diego,073,3302833,725297,703957,49668,753625,4735
2022-02-04,San Francisco,075,870044,117435,112481,7874,120355,720
2022-02-04,San Joaquin,077,732212,160292,157420,9190,166610,1989
2022-02-04,San Luis Obispo,079,281455,49859,48361,3471,51832,404
2022-02-04,San Mateo,081,765935,116364,104810,6538,111348,587
2022-02-04,Santa Barbara,083,443738,82331,80478,4529,85007,617
2022-02-04,Santa Clara,085,1922200,295217,289262,11590,300852,2067
2022-02-04,Santa Cruz,087,273765,44169,42553,2033,44586,239
2022-02-04,Shasta,089,179085,29133,28604,5773,34377,466
2022-02-04,Sierra,091,2930,268,262,44,306,0
2022-02-04,Siskiyou,093,43540,4221,4106,2539,6645,67
2022-02-04,Solano,095,438530,77509,73112,5218,78330,415
2022-02-04,Sonoma,097,501317,79519,77213,2268,79481,431
2022-02-04,Stanislaus,099,539301,113191,111783,16158,127941,1406
2022-02-04,Sutter,101,95872,19738,19406,1862,21268,203
2022-02-04,Tehama,103,63373,11549,11259,2537,13796,146
2022-02-04,Trinity,105,12862,1128,1085,273,1358,20
2022-02-04,Tulare,107,460477,102343,97414,26835,124249,1254
2022-02-04,Tuolumne,109,53932,12056,11409,497,11906,91
2022-02-04,Ventura,111,848112,167960,165532,9032,174564,1308
2022-02-04,Yolo,113,214977,34972,33614,2947,36561,281
2022-02-04,Yuba,115,75493,15152,14801,1085,15886,105
2022-02-03,Alameda,001,1643700,242839,235698,12671,248369,1638
2022-02-03,Alpine,003,1148,120,124,1,125,0
2022-02-03,Amador,005,37829,8081,7855,576,8431,71
2022-02-03,Butte,007,227075,31422,30733,6209,36942,355
2022-02-03,Calaveras,009,45235,6943,6789,311,7100,99
2022-02-03,Colusa,011,21464,3315,3234,1034,4268,21
2022-02-03,Contra Costa,013,1133247,179779,175871,12085,187956,1115
2022-02-03,Del Norte,015,27424,5100,4978,148,5126,44
2022-02-03,El Dorado,017,186661,25746,24813,3055,27868,185
2022-02-03,Fresno,019,978130,219534,213539,22199,235738,2477
2022-02-03,Glenn,021,27897,4795,4691,1528,6219,39
2022-02-03,Humboldt,023,135768,15751,15514,2597,18111,127
2022-02-03,Imperial,025,180216,53375,52153,10200,62353,853
2022-02-03,Inyo,027,18085,3984,3948,431,4379,51
2022-02-03,Kern,029,883053,185070,180296,43851,224147,1987
2022-02-03,Kings,031,150075,48973,47538,3408,50946,402
2022-02-03,Lake,033,64148,9820,9289,787,10076,124
2022-02-03,Lassen,035,31185,8450,8288,843,9131,55
2022-02-03,Los Angeles,037,10098052,2631003,2572702,120828,2693530,28947
2022-02-03,Madera,039,155013,35408,34471,5492,39963,329
2022-02-03,Marin,041,260295,31813,31299,2080,33379,255
2022-02-03,Mariposa,043,17540,2262,2222,160,2382,6
2022-02-03,Mendocino,045,87422,12348,12066,2605,14671,107
2022-02-03,Merced,047,269075,59637,58908,7712,66620,744
2022-02-03,Modoc,049,8938,690,664,231,895,6
2022-02-03,Mono,051,14174,2924,2904,115,3019,5
2022-02-03,Monterey,053,433212,75345,67342,12049,79391,666
2022-02-03,Napa,055,140530,24162,22973,880,23853,118
2022-02-03,Nevada,057,99092,15295,15002,1099,16101,113
2022-02-03,Orange,059,3164182,531351,527516,39698,567214,6134
2022-02-03,Placer,061,380077,60382,59043,7082,66125,533
2022-02-03,Plumas,063,18699,2826,2550,296,2846,13
2022-02-03,Riverside,065,2383286,575347,563991,26874,590865,5827
2022-02-03,Sacramento,067,1510023,269180,259437,25293,284730,2610
2022-02-03,San Benito,069,59416,12345,12142,485,12627,90
2022-02-03,San Bernardino,071,2135413,553271,539312,24117,563429,6322
2022-02-03,San Diego,073,3302833,723285,703957,49505,753462,4735
2022-02-03,San Francisco,075,870044,117100,112481,7843,120324,720
2022-02-03,San Joaquin,077,732212,159810,157420,9161,166581,1989
2022-02-03,San Luis Obispo,079,281455,49660,48361,3454,51815,404
2022-02-03,San Mateo,081,765935,116013,104810,6504,111314,587
2022-02-03,Santa Barbara,083,443738,81973,80478,4500,84978,617
2022-02-03,Santa Clara,085,1922200,294047,289262,11480,300742,2067
2022-02-03,Santa Cruz,087,273765,43828,42553,2026,44579,239
2022-02-03,Shasta,089,179085,29026,28604,5745,34349,466
2022-02-03,Sierra,091,2930,268,262,44,306,0
2022-02-03,Siskiyou,093,43540,4206,4106,2522,6628,67
2022-02-03,Solano,095,438530,77180,73112,5200,78312,415
2022-02-03,Sonoma,097,501317,79222,77213,2261,79474,431
2022-02-03,Stanislaus,099,539301,112822,111783,16075,127858,1406
2022-02-03,Sutter,101,95872,19686,19406,1843,21249,203
2022-02-03,Tehama,103,63373,11518,11259,2529,13788,146
2022-02-03,Trinity,105,12862,1126,1085,272,1357,20
2022-02-03,Tulare,107,460477,101930,97414,26687,124101,1254
2022-02-03,Tuolumne,109,53932,12015,11409,486,11895,91
2022-02-03,Ventura,111,848112,167575,165532,9022,174554,1308
2022-02-03,Yolo,113,214977,34867,33614,2934,36548,281
2022-02-03,Yuba,115,75493,15101,14801,1069,15870,105
2022-02-02,Alameda,001,1643700,241897,234300,12567,246867,1632
2022-02-02,Alpine,003,1148,120,123,1,124,0
2022-02-02,Amador,005,37829,8051,7781,566,8347,71
2022-02-02,Butte,007,227075,31313,30550,6178,36728,355
2022-02-02,Calaveras,009,45235,6914,6753,307,7060,99
2022-02-02,Colusa,011,21464,3300,3211,1033,4244,21
2022-02-02,Contra Costa,013,1133247,179190,174876,11987,186863,1113
2022-02-02,Del Norte,015,27424,5060,4924,143,5067,44
2022-02-02,El Dorado,017,186661,25679,24690,3036,27726,185
2022-02-02,Fresno,019,978130,218516,211976,22077,234053,2463
2022-02-02,Glenn,021,27897,4771,4667,1518,6185,39
2022-02-02,Humboldt,023,135768,15690,15392,2558,17950,127
2022-02-02,Imperial,025,180216,53176,51875,10071,61946,853
2022-02-02,Inyo,027,18085,3978,3944,430,4374,51
2022-02-02,Kern,029,883053,184474,179386,43632,223018,1974
2022-02-02,Kings,031,150075,48783,47061,3382,50443,401
2022-02-02,Lake,033,64148,9761,9235,780,10015,120
2022-02-02,Lassen,035,31185,8432,8258,834,9092,55
2022-02-02,Los Angeles,037,10098052,2624794,2561902,120439,2682341,28850
2022-02-02,Madera,039,155013,35237,34265,5419,39684,329
2022-02-02,Marin,041,260295,31713,31149,2070,33219,255
2022-02-02,Mariposa,043,17540,2251,2215,156,2371,6
2022-02-02,Mendocino,045,87422,12295,11996,2566,14562,105
2022-02-02,Merced,047,269075,59463,58532,7626,66158,744
2022-02-02,Modoc,049,8938,684,662,231,893,6
2022-02-02,Mono,051,14174,2913,2887,115,3002,5
2022-02-02,Monterey,053,433212,74953,66852,11861,78713,666
2022-02-02,Napa,055,140530,24041,22859,866,23725,117
2022-02-02,Nevada,057,99092,15238,14895,1075,15970,112
2022-02-02,Orange,059,3164182,530295,524418,39604,564022,6127
2022-02-02,Placer,061,380077,60188,58654,7051,65705,533
2022-02-02,Plumas,063,18699,2810,2540,292,2832,12
2022-02-02,Riverside,065,2383286,574064,561220,26826,588046,5827
2022-02-02,Sacramento,067,1510023,268168,258078,25078,283156,2602
2022-02-02,San Benito,069,59416,12306,12058,481,12539,90
2022-02-02,San Bernardino,071,2135413,552261,537485,24052,561537,6317
2022-02-02,San Diego,073,3302833,721045,703957,49324,753281,4735
2022-02-02,San Francisco,075,870044,116731,112008,7827,119835,714
2022-02-02,San Joaquin,077,732212,159236,156537,9137,165674,1986
2022-02-02,San Luis Obispo,079,281455,49461,48119,3441,51560,403
2022-02-02,San Mateo,081,765935,115642,104201,6436,110637,587
2022-02-02,Santa Barbara,083,443738,81629,79979,4469,84448,612
2022-02-02,Santa Clara,085,1922200,292893,287443,11365,298808,2051
2022-02-02,Santa Cruz,087,273765,43539,42127,2014,44141,239
2022-02-02,Shasta,089,179085,28926,28429,5700,34129,465
2022-02-02,Sierra,091,2930,268,262,44,306,0
2022-02-02,Siskiyou,093,43540,4196,4078,2495,6573,67
2022-02-02,Solano,095,438530,76826,72711,5177,77888,414
2022-02-02,Sonoma,097,501317,78911,76681,2248,78929,431
2022-02-02,Stanislaus,099,539301,112425,111167,15943,127110,1403
2022-02-02,Sutter,101,95872,19623,19290,1814,21104,203
2022-02-02,Tehama,103,63373,11463,11193,2510,13703,146
2022-02-02,Trinity,105,12862,1123,1074,270,1344,20
2022-02-02,Tulare,107,460477,101537,96820,26508,123328,1249
2022-02-02,Tuolumne,109,53932,11939,11342,483,11825,91
2022-02-02,Ventura,111,848112,167177,164905,9003,173908,1292
2022-02-02,Yolo,113,214977,34749,33332,2912,36244,281
2022-02-02,Yuba,115,75493,15036,14720,1061,15781,104
2022-02-01,Alameda,001,1643700,240822,233782,12461,246243,1620
2022-02-01,Alpine,003,1148,120,123,1,124,0
2022-02-01,Amador,005,37829,8005,7783,560,8343,73
2022-02-01,Butte,007,227075,31175,30496,6139,36635,355
2022-02-01,Calaveras,009,45235,6877,6749,303,7052,98
2022-02-01,Colusa,011,21464,3281,3202,1011,4213,21
2022-02-01,Contra Costa,013,1133247,178460,174379,11846,186225,1115
2022-02-01,Del Norte,015,27424,5013,4907,140,5047,44
2022-02-01,El Dorado,017,186661,25620,24664,3019,27683,184
2022-02-01,Fresno,019,978130,217350,211352,21927,233279,2464
2022-02-01,Glenn,021,27897,4757,4649,1508,6157,39
2022-02-01,Humboldt,023,135768,15609,15354,2528,17882,127
2022-02-01,Imperial,025,180216,52960,51675,10003,61678,846
2022-02-01,Inyo,027,18085,3968,3928,427,4355,51
2022-02-01,Kern,029,883053,183834,178987,43385,222372,1967
2022-02-01,Kings,031,150075,48526,46959,3358,50317,400
2022-02-01,Lake,033,64148,9704,9211,773,9984,119
2022-02-01,Lassen,035,31185,8413,8231,829,9060,55
2022-02-01,Los Angeles,037,10098052,2617630,2548794,120058,2668852,28752
2022-02-01,Madera,039,155013,35014,34124,5342,39466,329
2022-02-01,Marin,041,260295,31592,31099,2054,33153,255
2022-02-01,Mariposa,043,17540,2244,2210,155,2365,6
2022-02-01,Mendocino,045,87422,12233,11978,2529,14507,105
2022-02-01,Merced,047,269075,59278,58362,7501,65863,743
2022-02-01,Modoc,049,8938,677,664,231,895,6
2022-02-01,Mono,051,14174,2907,2888,115,3003,5
2022-02-01,Monterey,053,433212,74532,66553,11661,78214,665
2022-02-01,Napa,055,140530,23943,22795,849,23644,116
2022-02-01,Nevada,057,99092,15175,14863,1062,15925,112
2022-02-01,Orange,059,3164182,529147,523741,39461,563202,6108
2022-02-01,Placer,061,380077,59944,58486,7011,65497,532
2022-02-01,Plumas,063,18699,2795,2526,289,2815,12
2022-02-01,Riverside,065,2383286,572688,560010,26777,586787,5825
2022-02-01,Sacramento,067,1510023,267121,257504,24788,282292,2593
2022-02-01,San Benito,069,59416,12240,12053,478,12531,90
2022-02-01,San Bernardino,071,2135413,551013,536591,23989,560580,6311
2022-02-01,San Diego,073,3302833,718526,701009,49108,750117,4710
2022-02-01,San Francisco,075,870044,116264,111606,7808,119414,713
2022-02-01,San Joaquin,077,732212,158708,156300,9114,165414,1987
2022-02-01,San Luis Obispo,079,281455,49231,47842,3379,51221,403
2022-02-01,San Mateo,081,765935,115173,103868,6394,110262,589
2022-02-01,Santa Barbara,083,443738,81185,79659,4433,84092,608
2022-02-01,Santa Clara,085,1922200,291362,286109,11259,297368,2070
2022-02-01,Santa Cruz,087,273765,43241,41782,1998,43780,239
2022-02-01,Shasta,089,179085,28801,28382,5647,34029,465
2022-02-01,Sierra,091,2930,266,262,44,306,0
2022-02-01,Siskiyou,093,43540,4182,4072,2468,6540,66
2022-02-01,Solano,095,438530,76553,72494,5161,77655,415
2022-02-01,Sonoma,097,501317,78552,76379,2224,78603,431
2022-02-01,Stanislaus,099,539301,112011,110925,15841,126766,1403
2022-02-01,Sutter,101,95872,19555,19256,1781,21037,202
2022-02-01,Tehama,103,63373,11406,11165,2496,13661,146
2022-02-01,Trinity,105,12862,1119,1073,270,1343,19
2022-02-01,Tulare,107,460477,101041,96467,26287,122754,1247
2022-02-01,Tuolumne,109,53932,11890,11318,474,11792,91
2022-02-01,Ventura,111,848112,166674,164721,8980,173701,1293
2022-02-01,Yolo,113,214977,34613,33257,2883,36140,275
2022-02-01,Yuba,115,75493,14975,14693,1054,15747,103
2022-01-31,Alameda,001,1643700,239477,232743,12343,245086,1607
2022-01-31,Alpine,003,1148,119,123,1,124,0
2022-01-31,Amador,005,37829,7951,7682,543,8225,73
2022-01-31,Butte,007,227075,31011,30371,6100,36471,354
2022-01-31,Calaveras,009,45235,6845,6700,292,6992,96
2022-01-31,Colusa,011,21464,3270,3187,1002,4189,21
2022-01-31,Contra Costa,013,1133247,177661,173466,11718,185184,1115
2022-01-31,Del Norte,015,27424,4980,4879,136,5015,43
2022-01-31,El Dorado,017,186661,25517,24545,2989,27534,184
2022-01-31,Fresno,019,978130,215865,210589,21731,232320,2464
2022-01-31,Glenn,021,27897,4721,4641,1496,6137,39
2022-01-31,Humboldt,023,135768,15521,15308,2495,17803,126
2022-01-31,Imperial,025,180216,52746,51472,9885,61357,846
2022-01-31,Inyo,027,18085,3957,3922,421,4343,50
2022-01-31,Kern,029,883053,183055,178375,43058,221433,1967
2022-01-31,Kings,031,150075,48168,46845,3324,50169,398
2022-01-31,Lake,033,64148,9632,9141,761,9902,119
2022-01-31,Lassen,035,31185,8384,8162,823,8985,55
2022-01-31,Los Angeles,037,10098052,2609386,2541189,119648,2660837,28718
2022-01-31,Madera,039,155013,34803,33886,5251,39137,329
2022-01-31,Marin,041,260295,31469,31023,2037,33060,253
2022-01-31,Mariposa,043,17540,2234,2203,146,2349,6
2022-01-31,Mendocino,045,87422,12167,11896,2486,14382,104
2022-01-31,Merced,047,269075,59000,58198,7308,65506,740
2022-01-31,Modoc,049,8938,674,661,231,892,6
2022-01-31,Mono,051,14174,2893,2889,115,3004,5
2022-01-31,Monterey,053,433212,74082,66117,11440,77557,661
2022-01-31,Napa,055,140530,23776,22707,833,23540,113
2022-01-31,Nevada,057,99092,15098,14813,1049,15862,112
2022-01-31,Orange,059,3164182,527823,522358,39325,561683,6098
2022-01-31,Placer,061,380077,59697,58252,6979,65231,523
2022-01-31,Plumas,063,18699,2782,2513,287,2800,12
2022-01-31,Riverside,065,2383286,570876,558166,26710,584876,5785
2022-01-31,Sacramento,067,1510023,265825,256594,24513,281107,2571
2022-01-31,San Benito,069,59416,12181,11976,477,12453,90
2022-01-31,San Bernardino,071,2135413,549386,535276,23903,559179,6302
2022-01-31,San Diego,073,3302833,715602,698571,48850,747421,4686
2022-01-31,San Francisco,075,870044,115854,111119,7774,118893,712
2022-01-31,San Joaquin,077,732212,157954,155736,9080,164816,1985
2022-01-31,San Luis Obispo,079,281455,48978,47656,3320,50976,395
2022-01-31,San Mateo,081,765935,114660,103313,6334,109647,589
2022-01-31,Santa Barbara,083,443738,80678,79267,4391,83658,606
2022-01-31,Santa Clara,085,1922200,289681,284562,11151,295713,2041
2022-01-31,Santa Cruz,087,273765,42863,41630,1991,43621,239
2022-01-31,Shasta,089,179085,28672,28190,5606,33796,462
2022-01-31,Sierra,091,2930,266,261,44,305,0
2022-01-31,Siskiyou,093,43540,4166,4054,2452,6506,66
2022-01-31,Solano,095,438530,75847,72258,5115,77373,414
2022-01-31,Sonoma,097,501317,78096,76199,2194,78393,431
2022-01-31,Stanislaus,099,539301,111482,110493,15676,126169,1403
2022-01-31,Sutter,101,95872,19475,19189,1728,20917,202
2022-01-31,Tehama,103,63373,11344,11112,2466,13578,145
2022-01-31,Trinity,105,12862,1114,1071,267,1338,19
2022-01-31,Tulare,107,460477,100393,96053,26026,122079,1245
2022-01-31,Tuolumne,109,53932,11798,11278,467,11745,91
2022-01-31,Ventura,111,848112,166138,164060,8956,173016,1286
2022-01-31,Yolo,113,214977,34460,33175,2858,36033,274
2022-01-31,Yuba,115,75493,14913,14652,1034,15686,103
2022-01-30,Alameda,001,1643700,237942,231838,12191,244029,1607
2022-01-30,Alpine,003,1148,119,123,1,124,0
2022-01-30,Amador,005,37829,7900,7644,519,8163,73
2022-01-30,Butte,007,227075,30813,30255,6036,36291,354
2022-01-30,Calaveras,009,45235,6791,6676,278,6954,96
2022-01-30,Colusa,011,21464,3249,3168,990,4158,21
2022-01-30,Contra Costa,013,1133247,176709,172902,11514,184416,1102
2022-01-30,Del Norte,015,27424,4939,4833,133,4966,43
2022-01-30,El Dorado,017,186661,25397,24491,2962,27453,184
2022-01-30,Fresno,019,978130,214297,209645,21477,231122,2463
2022-01-30,Glenn,021,27897,4690,4619,1486,6105,39
2022-01-30,Humboldt,023,135768,15408,15247,2438,17685,126
2022-01-30,Imperial,025,180216,52422,51415,9709,61124,846
2022-01-30,Inyo,027,18085,3940,3921,418,4339,50
2022-01-30,Kern,029,883053,182195,177924,42734,220658,1967
2022-01-30,Kings,031,150075,47816,46654,3265,49919,398
2022-01-30,Lake,033,64148,9545,9080,740,9820,119
2022-01-30,Lassen,035,31185,8362,8158,815,8973,55
2022-01-30,Los Angeles,037,10098052,2599254,2530739,119168,2649907,28678
2022-01-30,Madera,039,155013,34508,33752,5064,38816,329
2022-01-30,Marin,041,260295,31322,30875,2023,32898,253
2022-01-30,Mariposa,043,17540,2222,2177,140,2317,6
2022-01-30,Mendocino,045,87422,12094,11860,2380,14240,104
2022-01-30,Merced,047,269075,58638,58006,7014,65020,740
2022-01-30,Modoc,049,8938,671,661,231,892,6
2022-01-30,Mono,051,14174,2887,2888,115,3003,5
2022-01-30,Monterey,053,433212,73495,65996,11154,77150,661
2022-01-30,Napa,055,140530,23608,22588,816,23404,114
2022-01-30,Nevada,057,99092,15010,14741,1033,15774,112
2022-01-30,Orange,059,3164182,526192,521334,39178,560512,6098
2022-01-30,Placer,061,380077,59361,58030,6938,64968,523
2022-01-30,Plumas,063,18699,2757,2510,273,2783,12
2022-01-30,Riverside,065,2383286,568825,557088,26608,583696,5767
2022-01-30,Sacramento,067,1510023,264366,255715,24007,279722,2572
2022-01-30,San Benito,069,59416,12116,11945,472,12417,90
2022-01-30,San Bernardino,071,2135413,547662,534050,23793,557843,6302
2022-01-30,San Diego,073,3302833,712016,687145,48427,735572,4665
2022-01-30,San Francisco,075,870044,115307,110772,7739,118511,712
2022-01-30,San Joaquin,077,732212,156972,155165,9045,164210,1985
2022-01-30,San Luis Obispo,079,281455,48580,47599,3282,50881,394
2022-01-30,San Mateo,081,765935,114087,102979,6287,109266,589
2022-01-30,Santa Barbara,083,443738,80000,79072,4330,83402,606
2022-01-30,Santa Clara,085,1922200,287691,282846,11020,293866,2035
2022-01-30,Santa Cruz,087,273765,42419,41330,1981,43311,239
2022-01-30,Shasta,089,179085,28509,28105,5520,33625,462
2022-01-30,Sierra,091,2930,266,261,44,305,0
2022-01-30,Siskiyou,093,43540,4136,4039,2405,6444,66
2022-01-30,Solano,095,438530,75323,71857,5068,76925,414
2022-01-30,Sonoma,097,501317,77580,75890,2169,78059,431
2022-01-30,Stanislaus,099,539301,110825,110111,15476,125587,1403
2022-01-30,Sutter,101,95872,19382,19108,1631,20739,202
2022-01-30,Tehama,103,63373,11271,11071,2436,13507,145
2022-01-30,Trinity,105,12862,1108,1068,267,1335,19
2022-01-30,Tulare,107,460477,99646,95676,25730,121406,1245
2022-01-30,Tuolumne,109,53932,11690,11242,430,11672,91
2022-01-30,Ventura,111,848112,165556,163521,8926,172447,1286
2022-01-30,Yolo,113,214977,34258,33043,2824,35867,274
2022-01-30,Yuba,115,75493,14823,14584,1014,15598,103
2022-01-29,Alameda,001,1643700,237268,225602,12174,237776,1605
2022-01-29,Alpine,003,1148,119,123,1,124,0
2022-01-29,Amador,005,37829,7878,7505,516,8021,73
2022-01-29,Butte,007,227075,30728,29557,6012,35569,353
2022-01-29,Calaveras,009,45235,6772,6484,278,6762,96
2022-01-29,Colusa,011,21464,3243,3107,986,4093,21
2022-01-29,Contra Costa,013,1133247,176187,168003,11485,179488,1101
2022-01-29,Del Norte,015,27424,4921,4589,130,4719,43
2022-01-29,El Dorado,017,186661,25354,24008,2955,26963,184
2022-01-29,Fresno,019,978130,213838,202691,21442,224133,2457
2022-01-29,Glenn,021,27897,4683,4516,1479,5995,39
2022-01-29,Humboldt,023,135768,15361,14812,2431,17243,126
2022-01-29,Imperial,025,180216,52307,50153,9653,59806,845
2022-01-29,Inyo,027,18085,3938,3895,410,4305,50
2022-01-29,Kern,029,883053,181855,174456,42567,217023,1962
2022-01-29,Kings,031,150075,47699,45047,3258,48305,397
2022-01-29,Lake,033,64148,9512,8747,736,9483,119
2022-01-29,Lassen,035,31185,8344,7961,812,8773,55
2022-01-29,Los Angeles,037,10098052,2595359,2473332,118900,2592232,28467
2022-01-29,Madera,039,155013,34399,32753,5040,37793,329
2022-01-29,Marin,041,260295,31256,30137,2021,32158,253
2022-01-29,Mariposa,043,17540,2220,2117,138,2255,6
2022-01-29,Mendocino,045,87422,12070,11591,2364,13955,104
2022-01-29,Merced,047,269075,58532,56472,7009,63481,735
2022-01-29,Modoc,049,8938,671,654,231,885,6
2022-01-29,Mono,051,14174,2885,2860,115,2975,5
2022-01-29,Monterey,053,433212,73341,64090,11089,75179,658
2022-01-29,Napa,055,140530,23551,22121,814,22935,113
2022-01-29,Nevada,057,99092,14976,14337,1030,15367,112
2022-01-29,Orange,059,3164182,525488,511255,39071,550326,6038
2022-01-29,Placer,061,380077,59167,56562,6922,63484,523
2022-01-29,Plumas,063,18699,2747,2463,269,2732,12
2022-01-29,Riverside,065,2383286,567806,548121,26566,574687,5726
2022-01-29,Sacramento,067,1510023,263724,249130,23952,273082,2558
2022-01-29,San Benito,069,59416,12059,11670,471,12141,90
2022-01-29,San Bernardino,071,2135413,546916,525249,23748,548997,6297
2022-01-29,San Diego,073,3302833,710684,683027,48329,731356,4643
2022-01-29,San Francisco,075,870044,115032,108265,7691,115956,712
2022-01-29,San Joaquin,077,732212,156727,150849,9023,159872,1971
2022-01-29,San Luis Obispo,079,281455,48491,46374,3278,49652,391
2022-01-29,San Mateo,081,765935,113750,100306,6264,106570,586
2022-01-29,Santa Barbara,083,443738,79778,76546,4323,80869,604
2022-01-29,Santa Clara,085,1922200,286746,273879,10992,284871,2019
2022-01-29,Santa Cruz,087,273765,42290,39228,1979,41207,240
2022-01-29,Shasta,089,179085,28452,27504,5506,33010,452
2022-01-29,Sierra,091,2930,266,260,43,303,0
2022-01-29,Siskiyou,093,43540,4126,3987,2398,6385,66
2022-01-29,Solano,095,438530,75180,69862,5056,74918,407
2022-01-29,Sonoma,097,501317,77366,73439,2164,75603,427
2022-01-29,Stanislaus,099,539301,110576,107668,15429,123097,1403
2022-01-29,Sutter,101,95872,19333,18797,1614,20411,202
2022-01-29,Tehama,103,63373,11237,10880,2427,13307,145
2022-01-29,Trinity,105,12862,1105,1033,266,1299,19
2022-01-29,Tulare,107,460477,99391,93154,25652,118806,1237
2022-01-29,Tuolumne,109,53932,11665,10806,422,11228,91
2022-01-29,Ventura,111,848112,165226,160466,8909,169375,1271
2022-01-29,Yolo,113,214977,34148,32123,2808,34931,275
2022-01-29,Yuba,115,75493,14782,14295,1012,15307,103
2022-01-28,Alameda,001,1643700,236326,225602,12156,237758,1605
2022-01-28,Alpine,003,1148,119,123,1,124,0
2022-01-28,Amador,005,37829,7852,7505,515,8020,73
2022-01-28,Butte,007,227075,30652,29557,5993,35550,353
2022-01-28,Calaveras,009,45235,6755,6484,277,6761,96
2022-01-28,Colusa,011,21464,3238,3107,984,4091,21
2022-01-28,Contra Costa,013,1133247,175663,168003,11448,179451,1101
2022-01-28,Del Norte,015,27424,4897,4589,129,4718,43
2022-01-28,El Dorado,017,186661,25309,24008,2949,26957,184
2022-01-28,Fresno,019,978130,212969,202691,21386,224077,2457
2022-01-28,Glenn,021,27897,4670,4516,1477,5993,39
2022-01-28,Humboldt,023,135768,15325,14812,2421,17233,126
2022-01-28,Imperial,025,180216,52178,50153,9621,59774,845
2022-01-28,Inyo,027,18085,3934,3895,407,4302,50
2022-01-28,Kern,029,883053,181444,174456,42408,216864,1962
2022-01-28,Kings,031,150075,47568,45047,3248,48295,397
2022-01-28,Lake,033,64148,9480,8747,734,9481,119
2022-01-28,Lassen,035,31185,8275,7961,810,8771,55
2022-01-28,Los Angeles,037,10098052,2589620,2473332,118686,2592018,28467
2022-01-28,Madera,039,155013,34271,32753,5023,37776,329
2022-01-28,Marin,041,260295,31164,30137,1999,32136,253
2022-01-28,Mariposa,043,17540,2210,2117,136,2253,6
2022-01-28,Mendocino,045,87422,12026,11591,2362,13953,104
2022-01-28,Merced,047,269075,58434,56472,6994,63466,735
2022-01-28,Modoc,049,8938,670,654,231,885,6
2022-01-28,Mono,051,14174,2880,2860,114,2974,5
2022-01-28,Monterey,053,433212,73139,64090,11040,75130,658
2022-01-28,Napa,055,140530,23473,22121,812,22933,113
2022-01-28,Nevada,057,99092,14939,14337,1028,15365,112
2022-01-28,Orange,059,3164182,524417,511255,38981,550236,6038
2022-01-28,Placer,061,380077,58962,56562,6899,63461,523
2022-01-28,Plumas,063,18699,2739,2463,267,2730,12
2022-01-28,Riverside,065,2383286,566478,548121,26525,574646,5726
2022-01-28,Sacramento,067,1510023,262940,249130,23893,273023,2558
2022-01-28,San Benito,069,59416,12037,11670,466,12136,90
2022-01-28,San Bernardino,071,2135413,545877,525249,23712,548961,6297
2022-01-28,San Diego,073,3302833,708851,683027,48253,731280,4643
2022-01-28,San Francisco,075,870044,114677,108265,7642,115907,712
2022-01-28,San Joaquin,077,732212,156439,150849,9009,159858,1971
2022-01-28,San Luis Obispo,079,281455,48407,46374,3270,49644,391
2022-01-28,San Mateo,081,765935,113398,100306,6242,106548,586
2022-01-28,Santa Barbara,083,443738,79530,76546,4321,80867,604
2022-01-28,Santa Clara,085,1922200,285547,273879,10942,284821,2019
2022-01-28,Santa Cruz,087,273765,42108,39228,1966,41194,240
2022-01-28,Shasta,089,179085,28395,27504,5492,32996,452
2022-01-28,Sierra,091,2930,266,260,43,303,0
2022-01-28,Siskiyou,093,43540,4116,3987,2394,6381,66
2022-01-28,Solano,095,438530,74628,69862,4989,74851,407
2022-01-28,Sonoma,097,501317,77163,73439,2156,75595,427
2022-01-28,Stanislaus,099,539301,110304,107668,15387,123055,1403
2022-01-28,Sutter,101,95872,19289,18797,1612,20409,202
2022-01-28,Tehama,103,63373,11205,10880,2420,13300,145
2022-01-28,Trinity,105,12862,1096,1033,266,1299,19
2022-01-28,Tulare,107,460477,99112,93154,25542,118696,1237
2022-01-28,Tuolumne,109,53932,11632,10806,418,11224,91
2022-01-28,Ventura,111,848112,164772,160466,8890,169356,1271
2022-01-28,Yolo,113,214977,34044,32123,2801,34924,275
2022-01-28,Yuba,115,75493,14742,14295,1007,15302,103
2022-01-27,Alameda,001,1643700,234748,225602,12020,237622,1605
2022-01-27,Alpine,003,1148,119,123,1,124,0
2022-01-27,Amador,005,37829,7805,7505,503,8008,73
2022-01-27,Butte,007,227075,30501,29557,5941,35498,353
2022-01-27,Calaveras,009,45235,6730,6484,261,6745,96
2022-01-27,Colusa,011,21464,3224,3107,980,4087,21
2022-01-27,Contra Costa,013,1133247,174657,168003,11272,179275,1101
2022-01-27,Del Norte,015,27424,4853,4589,125,4714,43
2022-01-27,El Dorado,017,186661,25198,24008,2929,26937,184
2022-01-27,Fresno,019,978130,211339,202691,21180,223871,2457
2022-01-27,Glenn,021,27897,4638,4516,1469,5985,39
2022-01-27,Humboldt,023,135768,15236,14812,2384,17196,126
2022-01-27,Imperial,025,180216,51907,50153,9505,59658,845
2022-01-27,Inyo,027,18085,3927,3895,397,4292,50
2022-01-27,Kern,029,883053,180667,174456,42042,216498,1962
2022-01-27,Kings,031,150075,47224,45047,3209,48256,397
2022-01-27,Lake,033,64148,9427,8747,717,9464,119
2022-01-27,Lassen,035,31185,8232,7961,804,8765,55
2022-01-27,Los Angeles,037,10098052,2578469,2473332,118171,2591503,28467
2022-01-27,Madera,039,155013,34062,32753,4919,37672,329
2022-01-27,Marin,041,260295,31002,30137,1984,32121,253
2022-01-27,Mariposa,043,17540,2187,2117,133,2250,6
2022-01-27,Mendocino,045,87422,11975,11591,2313,13904,104
2022-01-27,Merced,047,269075,58175,56472,6829,63301,735
2022-01-27,Modoc,049,8938,668,654,230,884,6
2022-01-27,Mono,051,14174,2875,2860,114,2974,5
2022-01-27,Monterey,053,433212,72517,64090,10787,74877,658
2022-01-27,Napa,055,140530,23314,22121,784,22905,113
2022-01-27,Nevada,057,99092,14866,14337,1000,15337,112
2022-01-27,Orange,059,3164182,522697,511255,38845,550100,6038
2022-01-27,Placer,061,380077,58644,56562,6845,63407,523
2022-01-27,Plumas,063,18699,2728,2463,255,2718,12
2022-01-27,Riverside,065,2383286,564313,548121,26456,574577,5726
2022-01-27,Sacramento,067,1510023,261662,249130,23556,272686,2558
2022-01-27,San Benito,069,59416,11981,11670,461,12131,90
2022-01-27,San Bernardino,071,2135413,543995,525249,23612,548861,6297
2022-01-27,San Diego,073,3302833,705478,683027,47903,730930,4643
2022-01-27,San Francisco,075,870044,114173,108265,7581,115846,712
2022-01-27,San Joaquin,077,732212,155584,150849,8941,159790,1971
2022-01-27,San Luis Obispo,079,281455,48135,46374,3232,49606,391
2022-01-27,San Mateo,081,765935,112814,100306,6173,106479,586
2022-01-27,Santa Barbara,083,443738,79050,76546,4265,80811,604
2022-01-27,Santa Clara,085,1922200,283462,273879,10794,284673,2019
2022-01-27,Santa Cruz,087,273765,41457,39228,1946,41174,240
2022-01-27,Shasta,089,179085,28262,27504,5443,32947,452
2022-01-27,Sierra,091,2930,265,260,42,302,0
2022-01-27,Siskiyou,093,43540,4095,3987,2357,6344,66
2022-01-27,Solano,095,438530,73990,69862,4940,74802,407
2022-01-27,Sonoma,097,501317,76697,73439,2144,75583,427
2022-01-27,Stanislaus,099,539301,109777,107668,15245,122913,1403
2022-01-27,Sutter,101,95872,19184,18797,1586,20383,202
2022-01-27,Tehama,103,63373,11153,10880,2404,13284,145
2022-01-27,Trinity,105,12862,1092,1033,265,1298,19
2022-01-27,Tulare,107,460477,98442,93154,25256,118410,1237
2022-01-27,Tuolumne,109,53932,11580,10806,409,11215,91
2022-01-27,Ventura,111,848112,164121,160466,8858,169324,1271
2022-01-27,Yolo,113,214977,33902,32123,2784,34907,275
2022-01-27,Yuba,115,75493,14663,14295,991,15286,103
2022-01-26,Alameda,001,1643700,232867,222680,11847,234527,1596
2022-01-26,Alpine,003,1148,119,123,1,124,0
2022-01-26,Amador,005,37829,7729,7427,488,7915,73
2022-01-26,Butte,007,227075,30304,29229,5886,35115,353
2022-01-26,Calaveras,009,45235,6692,6387,254,6641,96
2022-01-26,Colusa,011,21464,3208,3094,973,4067,21
2022-01-26,Contra Costa,013,1133247,173530,165972,11109,177081,1095
2022-01-26,Del Norte,015,27424,4796,4542,124,4666,43
2022-01-26,El Dorado,017,186661,25076,23819,2906,26725,181
2022-01-26,Fresno,019,978130,209490,199689,20964,220653,2452
2022-01-26,Glenn,021,27897,4605,4472,1464,5936,39
2022-01-26,Humboldt,023,135768,15137,14715,2339,17054,126
2022-01-26,Imperial,025,180216,51550,49477,9355,58832,839
2022-01-26,Inyo,027,18085,3924,3889,366,4255,50
2022-01-26,Kern,029,883053,179748,173052,41697,214749,1953
2022-01-26,Kings,031,150075,46820,44367,3179,47546,396
2022-01-26,Lake,033,64148,9346,8645,707,9352,119
2022-01-26,Lassen,035,31185,8196,7888,804,8692,55
2022-01-26,Los Angeles,037,10098052,2566255,2450620,117719,2568339,28382
2022-01-26,Madera,039,155013,33822,32323,4793,37116,329
2022-01-26,Marin,041,260295,30820,29813,1967,31780,253
2022-01-26,Mariposa,043,17540,2170,2108,126,2234,6
2022-01-26,Mendocino,045,87422,11928,11453,2262,13715,103
2022-01-26,Merced,047,269075,57809,56060,6652,62712,733
2022-01-26,Modoc,049,8938,667,652,229,881,6
2022-01-26,Mono,051,14174,2872,2852,114,2966,4
2022-01-26,Monterey,053,433212,71960,63264,10491,73755,659
2022-01-26,Napa,055,140530,23158,21864,774,22638,112
2022-01-26,Nevada,057,99092,14773,14128,989,15117,112
2022-01-26,Orange,059,3164182,520710,506419,38681,545100,6007
2022-01-26,Placer,061,380077,58308,55892,6781,62673,524
2022-01-26,Plumas,063,18699,2701,2425,253,2678,12
2022-01-26,Riverside,065,2383286,561795,543788,26337,570125,5701
2022-01-26,Sacramento,067,1510023,259965,246416,23196,269612,2559
2022-01-26,San Benito,069,59416,11910,11563,449,12012,90
2022-01-26,San Bernardino,071,2135413,541780,521699,23502,545201,6291
2022-01-26,San Diego,073,3302833,701264,676392,47545,723937,4622
2022-01-26,San Francisco,075,870044,113536,107174,7547,114721,704
2022-01-26,San Joaquin,077,732212,154600,148770,8892,157662,1971
2022-01-26,San Luis Obispo,079,281455,47832,45716,3205,48921,391
2022-01-26,San Mateo,081,765935,112147,99016,6044,105060,586
2022-01-26,Santa Barbara,083,443738,78521,75548,4204,79752,600
2022-01-26,Santa Clara,085,1922200,281344,270470,10616,281086,2015
2022-01-26,Santa Cruz,087,273765,40942,38298,1931,40229,239
2022-01-26,Shasta,089,179085,28114,27255,5396,32651,452
2022-01-26,Sierra,091,2930,264,260,41,301,0
2022-01-26,Siskiyou,093,43540,4079,3971,2332,6303,66
2022-01-26,Solano,095,438530,73295,69150,4880,74030,401
2022-01-26,Sonoma,097,501317,76138,72509,2111,74620,423
2022-01-26,Stanislaus,099,539301,109219,106582,15029,121611,1396
2022-01-26,Sutter,101,95872,19073,18670,1540,20210,202
2022-01-26,Tehama,103,63373,11099,10749,2387,13136,145
2022-01-26,Trinity,105,12862,1087,1008,265,1273,19
2022-01-26,Tulare,107,460477,97629,91904,25005,116909,1234
2022-01-26,Tuolumne,109,53932,11397,10699,398,11097,91
2022-01-26,Ventura,111,848112,163408,159077,8818,167895,1263
2022-01-26,Yolo,113,214977,33686,31913,2748,34661,275
2022-01-26,Yuba,115,75493,14578,14171,969,15140,103
2022-01-25,Alameda,001,1643700,230979,219753,11665,231418,1589
2022-01-25,Alpine,003,1148,119,122,1,123,0
2022-01-25,Amador,005,37829,7652,7352,477,7829,73
2022-01-25,Butte,007,227075,30096,28887,5814,34701,351
2022-01-25,Calaveras,009,45235,6634,6266,240,6506,95
2022-01-25,Colusa,011,21464,3188,3074,971,4045,21
2022-01-25,Contra Costa,013,1133247,172213,163792,10895,174687,1092
2022-01-25,Del Norte,015,27424,4726,4514,118,4632,43
2022-01-25,El Dorado,017,186661,24940,23339,2880,26219,179
2022-01-25,Fresno,019,978130,207349,198262,20679,218941,2434
2022-01-25,Glenn,021,27897,4573,4418,1448,5866,39
2022-01-25,Humboldt,023,135768,15045,14574,2313,16887,126
2022-01-25,Imperial,025,180216,51092,48913,9123,58036,832
2022-01-25,Inyo,027,18085,3909,3857,321,4178,50
2022-01-25,Kern,029,883053,178739,171695,41237,212932,1947
2022-01-25,Kings,031,150075,46346,43853,3134,46987,396
2022-01-25,Lake,033,64148,9267,8543,695,9238,118
2022-01-25,Lassen,035,31185,8165,7834,793,8627,55
2022-01-25,Los Angeles,037,10098052,2551327,2433516,117079,2550595,28293
2022-01-25,Madera,039,155013,33499,31794,4658,36452,329
2022-01-25,Marin,041,260295,30641,29589,1954,31543,253
2022-01-25,Mariposa,043,17540,2158,2069,120,2189,6
2022-01-25,Mendocino,045,87422,11808,11280,2159,13439,103
2022-01-25,Merced,047,269075,57433,55555,6508,62063,733
2022-01-25,Modoc,049,8938,665,652,229,881,6
2022-01-25,Mono,051,14174,2862,2826,113,2939,4
2022-01-25,Monterey,053,433212,71387,62498,10083,72581,654
2022-01-25,Napa,055,140530,22963,21668,738,22406,111
2022-01-25,Nevada,057,99092,14658,13944,965,14909,112
2022-01-25,Orange,059,3164182,518434,504274,38489,542763,5980
2022-01-25,Placer,061,380077,57907,55465,6708,62173,518
2022-01-25,Plumas,063,18699,2674,2397,249,2646,12
2022-01-25,Riverside,065,2383286,558708,540723,26168,566891,5686
2022-01-25,Sacramento,067,1510023,258012,244468,22647,267115,2545
2022-01-25,San Benito,069,59416,11811,11446,445,11891,88
2022-01-25,San Bernardino,071,2135413,539237,519150,23386,542536,6288
2022-01-25,San Diego,073,3302833,696250,670110,47092,717202,4604
2022-01-25,San Francisco,075,870044,112774,106254,7503,113757,703
2022-01-25,San Joaquin,077,732212,153624,147271,8829,156100,1972
2022-01-25,San Luis Obispo,079,281455,47470,45130,3157,48287,391
2022-01-25,San Mateo,081,765935,111315,98010,5933,103943,586
2022-01-25,Santa Barbara,083,443738,77852,74686,4122,78808,594
2022-01-25,Santa Clara,085,1922200,278704,268031,10410,278441,2006
2022-01-25,Santa Cruz,087,273765,40271,37850,1916,39766,237
2022-01-25,Shasta,089,179085,27951,27090,5329,32419,452
2022-01-25,Sierra,091,2930,264,260,37,297,0
2022-01-25,Siskiyou,093,43540,4055,3958,2297,6255,65
2022-01-25,Solano,095,438530,72728,68657,4828,73485,399
2022-01-25,Sonoma,097,501317,75445,71633,2072,73705,423
2022-01-25,Stanislaus,099,539301,108552,105965,14804,120769,1396
2022-01-25,Sutter,101,95872,18971,18508,1498,20006,200
2022-01-25,Tehama,103,63373,11036,10669,2361,13030,145
2022-01-25,Trinity,105,12862,1080,999,263,1262,19
2022-01-25,Tulare,107,460477,96755,91237,24653,115890,1229
2022-01-25,Tuolumne,109,53932,11217,10516,374,10890,91
2022-01-25,Ventura,111,848112,162554,157971,8774,166745,1263
2022-01-25,Yolo,113,214977,33426,31677,2701,34378,274
2022-01-25,Yuba,115,75493,14494,14038,941,14979,103
2022-01-24,Alameda,001,1643700,228535,216252,11392,227644,1581
2022-01-24,Alpine,003,1148,119,120,1,121,0
2022-01-24,Amador,005,37829,7601,7166,439,7605,73
2022-01-24,Butte,007,227075,29865,28607,5751,34358,350
2022-01-24,Calaveras,009,45235,6586,6172,226,6398,95
2022-01-24,Colusa,011,21464,3169,3052,955,4007,21
2022-01-24,Contra Costa,013,1133247,170727,162161,10675,172836,1092
2022-01-24,Del Norte,015,27424,4666,4460,118,4578,43
2022-01-24,El Dorado,017,186661,24774,23128,2850,25978,179
2022-01-24,Fresno,019,978130,205042,196092,20375,216467,2430
2022-01-24,Glenn,021,27897,4531,4367,1438,5805,39
2022-01-24,Humboldt,023,135768,14933,14416,2267,16683,126
2022-01-24,Imperial,025,180216,50551,48228,8833,57061,824
2022-01-24,Inyo,027,18085,3903,3805,296,4101,50
2022-01-24,Kern,029,883053,177431,169892,40759,210651,1946
2022-01-24,Kings,031,150075,45768,43260,3061,46321,396
2022-01-24,Lake,033,64148,9158,8423,680,9103,118
2022-01-24,Lassen,035,31185,8081,7732,774,8506,55
2022-01-24,Los Angeles,037,10098052,2534811,2391045,116300,2507345,28230
2022-01-24,Madera,039,155013,33060,31339,4473,35812,329
2022-01-24,Marin,041,260295,30412,29301,1917,31218,253
2022-01-24,Mariposa,043,17540,2133,2033,116,2149,6
2022-01-24,Mendocino,045,87422,11704,11002,2078,13080,103
2022-01-24,Merced,047,269075,56940,54970,6225,61195,730
2022-01-24,Modoc,049,8938,662,648,228,876,6
2022-01-24,Mono,051,14174,2852,2802,112,2914,4
2022-01-24,Monterey,053,433212,70525,61975,9720,71695,654
2022-01-24,Napa,055,140530,22783,21494,725,22219,111
2022-01-24,Nevada,057,99092,14530,13774,942,14716,112
2022-01-24,Orange,059,3164182,515860,501634,38227,539861,5969
2022-01-24,Placer,061,380077,57427,54933,6657,61590,518
2022-01-24,Plumas,063,18699,2643,2370,235,2605,12
2022-01-24,Riverside,065,2383286,554990,535962,25959,561921,5661
2022-01-24,Sacramento,067,1510023,255647,241522,22064,263586,2526
2022-01-24,San Benito,069,59416,11714,11331,432,11763,88
2022-01-24,San Bernardino,071,2135413,536339,515604,23225,538829,6285
2022-01-24,San Diego,073,3302833,690576,663580,46541,710121,4586
2022-01-24,San Francisco,075,870044,111812,105418,7407,112825,703
2022-01-24,San Joaquin,077,732212,152335,145984,8756,154740,1959
2022-01-24,San Luis Obispo,079,281455,46997,44616,3102,47718,387
2022-01-24,San Mateo,081,765935,110351,96968,5815,102783,586
2022-01-24,Santa Barbara,083,443738,77040,73866,4026,77892,591
2022-01-24,Santa Clara,085,1922200,275801,265341,10200,275541,2006
2022-01-24,Santa Cruz,087,273765,39475,37188,1896,39084,237
2022-01-24,Shasta,089,179085,27763,26871,5241,32112,452
2022-01-24,Sierra,091,2930,264,258,37,295,0
2022-01-24,Siskiyou,093,43540,4045,3934,2258,6192,64
2022-01-24,Solano,095,438530,72045,68094,4749,72843,400
2022-01-24,Sonoma,097,501317,74530,70733,2046,72779,423
2022-01-24,Stanislaus,099,539301,107798,104933,14530,119463,1395
2022-01-24,Sutter,101,95872,18856,18336,1409,19745,200
2022-01-24,Tehama,103,63373,10965,10567,2341,12908,145
2022-01-24,Trinity,105,12862,1071,978,261,1239,19
2022-01-24,Tulare,107,460477,95677,90089,24252,114341,1219
2022-01-24,Tuolumne,109,53932,11097,10374,365,10739,91
2022-01-24,Ventura,111,848112,161530,156551,8729,165280,1261
2022-01-24,Yolo,113,214977,33135,31480,2666,34146,273
2022-01-24,Yuba,115,75493,14387,13862,900,14762,103
2022-01-23,Alameda,001,1643700,225857,214003,11051,225054,1583
2022-01-23,Alpine,003,1148,119,120,1,121,0
2022-01-23,Amador,005,37829,7546,7090,399,7489,73
2022-01-23,Butte,007,227075,29573,28340,5644,33984,350
2022-01-23,Calaveras,009,45235,6521,6095,203,6298,95
2022-01-23,Colusa,011,21464,3143,3040,948,3988,21
2022-01-23,Contra Costa,013,1133247,168879,160798,10305,171103,1092
2022-01-23,Del Norte,015,27424,4600,4419,112,4531,43
2022-01-23,El Dorado,017,186661,24583,22925,2801,25726,179
2022-01-23,Fresno,019,978130,202570,193642,19906,213548,2430
2022-01-23,Glenn,021,27897,4480,4340,1414,5754,39
2022-01-23,Humboldt,023,135768,14814,14296,2185,16481,126
2022-01-23,Imperial,025,180216,49951,47935,8542,56477,824
2022-01-23,Inyo,027,18085,3876,3781,282,4063,50
2022-01-23,Kern,029,883053,176069,168585,40230,208815,1946
2022-01-23,Kings,031,150075,45131,42622,2957,45579,397
2022-01-23,Lake,033,64148,8988,8363,653,9016,118
2022-01-23,Lassen,035,31185,8030,7710,750,8460,55
2022-01-23,Los Angeles,037,10098052,2514503,2390590,115141,2505731,28231
2022-01-23,Madera,039,155013,32699,30962,4231,35193,329
2022-01-23,Marin,041,260295,30159,29025,1879,30904,253
2022-01-23,Mariposa,043,17540,2118,2011,113,2124,6
2022-01-23,Mendocino,045,87422,11579,10889,1951,12840,103
2022-01-23,Merced,047,269075,56390,54644,5777,60421,730
2022-01-23,Modoc,049,8938,660,645,225,870,6
2022-01-23,Mono,051,14174,2844,2788,110,2898,4
2022-01-23,Monterey,053,433212,69686,61522,9275,70797,654
2022-01-23,Napa,055,140530,22520,21281,712,21993,111
2022-01-23,Nevada,057,99092,14367,13629,914,14543,112
2022-01-23,Orange,059,3164182,512763,498968,37934,536902,5970
2022-01-23,Placer,061,380077,56855,54568,6567,61135,518
2022-01-23,Plumas,063,18699,2610,2368,206,2574,12
2022-01-23,Riverside,065,2383286,550558,532273,25652,557925,5661
2022-01-23,Sacramento,067,1510023,252996,239589,21093,260682,2530
2022-01-23,San Benito,069,59416,11591,11225,421,11646,88
2022-01-23,San Bernardino,071,2135413,532927,512657,22967,535624,6281
2022-01-23,San Diego,073,3302833,683922,640215,45741,685956,4566
2022-01-23,San Francisco,075,870044,110743,104485,7299,111784,704
2022-01-23,San Joaquin,077,732212,150743,144621,8679,153300,1959
2022-01-23,San Luis Obispo,079,281455,46305,44183,3023,47206,386
2022-01-23,San Mateo,081,765935,109232,95940,5667,101607,586
2022-01-23,Santa Barbara,083,443738,75914,73041,3899,76940,590
2022-01-23,Santa Clara,085,1922200,272470,261991,9873,271864,2005
2022-01-23,Santa Cruz,087,273765,38943,36547,1864,38411,237
2022-01-23,Shasta,089,179085,27465,26732,5119,31851,452
2022-01-23,Sierra,091,2930,263,252,37,289,0
2022-01-23,Siskiyou,093,43540,4019,3916,2200,6116,64
2022-01-23,Solano,095,438530,71249,67457,4653,72110,400
2022-01-23,Sonoma,097,501317,73572,69791,1996,71787,423
2022-01-23,Stanislaus,099,539301,106936,104067,14253,118320,1395
2022-01-23,Sutter,101,95872,18699,18175,1294,19469,200
2022-01-23,Tehama,103,63373,10866,10481,2309,12790,145
2022-01-23,Trinity,105,12862,1068,961,259,1220,19
2022-01-23,Tulare,107,460477,94414,89120,23804,112924,1219
2022-01-23,Tuolumne,109,53932,10906,10243,347,10590,91
2022-01-23,Ventura,111,848112,160347,155052,8655,163707,1261
2022-01-23,Yolo,113,214977,32758,30908,2624,33532,273
2022-01-23,Yuba,115,75493,14261,13762,845,14607,103
2022-01-22,Alameda,001,1643700,224763,203927,11017,214944,1575
2022-01-22,Alpine,003,1148,118,119,1,120,0
2022-01-22,Amador,005,37829,7513,6845,394,7239,73
2022-01-22,Butte,007,227075,29455,27232,5620,32852,350
2022-01-22,Calaveras,009,45235,6491,5835,202,6037,95
2022-01-22,Colusa,011,21464,3126,2954,945,3899,21
2022-01-22,Contra Costa,013,1133247,167953,154111,10275,164386,1091
2022-01-22,Del Norte,015,27424,4564,4269,108,4377,43
2022-01-22,El Dorado,017,186661,24513,22273,2791,25064,179
2022-01-22,Fresno,019,978130,201756,185292,19841,205133,2429
2022-01-22,Glenn,021,27897,4474,4174,1411,5585,39
2022-01-22,Humboldt,023,135768,14747,13628,2172,15800,125
2022-01-22,Imperial,025,180216,49759,45741,8481,54222,820
2022-01-22,Inyo,027,18085,3872,3706,258,3964,50
2022-01-22,Kern,029,883053,175444,162902,39925,202827,1946
2022-01-22,Kings,031,150075,44924,40580,2945,43525,396
2022-01-22,Lake,033,64148,8954,8056,645,8701,118
2022-01-22,Lassen,035,31185,7997,7545,743,8288,55
2022-01-22,Los Angeles,037,10098052,2507101,2286280,114632,2400912,28038
2022-01-22,Madera,039,155013,32581,29595,4216,33811,329
2022-01-22,Marin,041,260295,30033,27893,1874,29767,253
2022-01-22,Mariposa,043,17540,2114,1920,113,2033,6
2022-01-22,Mendocino,045,87422,11529,10395,1929,12324,103
2022-01-22,Merced,047,269075,56241,53025,5768,58793,727
2022-01-22,Modoc,049,8938,659,639,225,864,6
2022-01-22,Mono,051,14174,2843,2723,106,2829,4
2022-01-22,Monterey,053,433212,69479,59038,9232,68270,651
2022-01-22,Napa,055,140530,22425,20402,702,21104,111
2022-01-22,Nevada,057,99092,14299,12957,906,13863,112
2022-01-22,Orange,059,3164182,511167,480329,37685,518014,5946
2022-01-22,Placer,061,380077,56588,52557,6528,59085,512
2022-01-22,Plumas,063,18699,2593,2289,202,2491,12
2022-01-22,Riverside,065,2383286,548643,513567,25579,539146,5623
2022-01-22,Sacramento,067,1510023,251948,230206,20987,251193,2510
2022-01-22,San Benito,069,59416,11532,10743,416,11159,88
2022-01-22,San Bernardino,071,2135413,531444,495209,22882,518091,6267
2022-01-22,San Diego,073,3302833,681433,628904,45530,674434,4559
2022-01-22,San Francisco,075,870044,110087,100238,7150,107388,702
2022-01-22,San Joaquin,077,732212,150309,138264,8635,146899,1960
2022-01-22,San Luis Obispo,079,281455,46187,42154,3016,45170,385
2022-01-22,San Mateo,081,765935,108648,91440,5604,97044,585
2022-01-22,Santa Barbara,083,443738,75493,69555,3893,73448,589
2022-01-22,Santa Clara,085,1922200,270772,249205,9806,259011,1993
2022-01-22,Santa Cruz,087,273765,38763,33741,1857,35598,237
2022-01-22,Shasta,089,179085,27372,25919,5097,31016,450
2022-01-22,Sierra,091,2930,263,248,36,284,0
2022-01-22,Siskiyou,093,43540,4001,3845,2179,6024,62
2022-01-22,Solano,095,438530,71026,63882,4614,68496,391
2022-01-22,Sonoma,097,501317,73147,66013,1986,67999,422
2022-01-22,Stanislaus,099,539301,106481,100092,14162,114254,1393
2022-01-22,Sutter,101,95872,18631,17616,1281,18897,199
2022-01-22,Tehama,103,63373,10831,10171,2299,12470,142
2022-01-22,Trinity,105,12862,1066,925,259,1184,19
2022-01-22,Tulare,107,460477,94030,85223,23674,108897,1211
2022-01-22,Tuolumne,109,53932,10838,9731,341,10072,91
2022-01-22,Ventura,111,848112,159655,148742,8624,157366,1250
2022-01-22,Yolo,113,214977,32581,30061,2607,32668,273
2022-01-22,Yuba,115,75493,14171,13288,840,14128,103
2022-01-21,Alameda,001,1643700,223189,203927,10986,214913,1575
2022-01-21,Alpine,003,1148,118,119,1,120,0
2022-01-21,Amador,005,37829,7456,6845,391,7236,73
2022-01-21,Butte,007,227075,29326,27232,5578,32810,350
2022-01-21,Calaveras,009,45235,6446,5835,202,6037,95
2022-01-21,Colusa,011,21464,3119,2954,940,3894,21
2022-01-21,Contra Costa,013,1133247,166903,154111,10195,164306,1091
2022-01-21,Del Norte,015,27424,4523,4269,108,4377,43
2022-01-21,El Dorado,017,186661,24431,22273,2774,25047,179
2022-01-21,Fresno,019,978130,200513,185292,19747,205039,2429
2022-01-21,Glenn,021,27897,4456,4174,1406,5580,39
2022-01-21,Humboldt,023,135768,14678,13628,2153,15781,125
2022-01-21,Imperial,025,180216,49568,45741,8403,54144,820
2022-01-21,Inyo,027,18085,3859,3706,252,3958,50
2022-01-21,Kern,029,883053,174724,162902,39550,202452,1946
2022-01-21,Kings,031,150075,44727,40580,2937,43517,396
2022-01-21,Lake,033,64148,8897,8056,632,8688,118
2022-01-21,Lassen,035,31185,7945,7545,739,8284,55
2022-01-21,Los Angeles,037,10098052,2495803,2286280,114177,2400457,28038
2022-01-21,Madera,039,155013,32290,29595,4188,33783,329
2022-01-21,Marin,041,260295,29856,27893,1853,29746,253
2022-01-21,Mariposa,043,17540,2102,1920,112,2032,6
2022-01-21,Mendocino,045,87422,11448,10395,1926,12321,103
2022-01-21,Merced,047,269075,56082,53025,5764,58789,727
2022-01-21,Modoc,049,8938,658,639,225,864,6
2022-01-21,Mono,051,14174,2829,2723,103,2826,4
2022-01-21,Monterey,053,433212,69008,59038,9100,68138,651
2022-01-21,Napa,055,140530,22305,20402,694,21096,111
2022-01-21,Nevada,057,99092,14202,12957,902,13859,112
2022-01-21,Orange,059,3164182,508924,480329,37440,517769,5946
2022-01-21,Placer,061,380077,56195,52557,6465,59022,512
2022-01-21,Plumas,063,18699,2581,2289,197,2486,12
2022-01-21,Riverside,065,2383286,545991,513567,25500,539067,5623
2022-01-21,Sacramento,067,1510023,250498,230206,20884,251090,2510
2022-01-21,San Benito,069,59416,11497,10743,413,11156,88
2022-01-21,San Bernardino,071,2135413,529436,495209,22812,518021,6267
2022-01-21,San Diego,073,3302833,677234,628904,45370,674274,4559
2022-01-21,San Francisco,075,870044,109327,100238,7062,107300,702
2022-01-21,San Joaquin,077,732212,149725,138264,8588,146852,1960
2022-01-21,San Luis Obispo,079,281455,46061,42154,3013,45167,385
2022-01-21,San Mateo,081,765935,107975,91440,5563,97003,585
2022-01-21,Santa Barbara,083,443738,74991,69555,3883,73438,589
2022-01-21,Santa Clara,085,1922200,268932,249205,9699,258904,1993
2022-01-21,Santa Cruz,087,273765,38047,33741,1844,35585,237
2022-01-21,Shasta,089,179085,27284,25919,5050,30969,450
2022-01-21,Sierra,091,2930,261,248,35,283,0
2022-01-21,Siskiyou,093,43540,3993,3845,2161,6006,62
2022-01-21,Solano,095,438530,70615,63882,4532,68414,391
2022-01-21,Sonoma,097,501317,72622,66013,1976,67989,422
2022-01-21,Stanislaus,099,539301,105977,100092,14101,114193,1393
2022-01-21,Sutter,101,95872,18544,17616,1267,18883,199
2022-01-21,Tehama,103,63373,10795,10171,2297,12468,142
2022-01-21,Trinity,105,12862,1060,925,258,1183,19
2022-01-21,Tulare,107,460477,93552,85223,23508,108731,1211
2022-01-21,Tuolumne,109,53932,10755,9731,334,10065,91
2022-01-21,Ventura,111,848112,158846,148742,8595,157337,1250
2022-01-21,Yolo,113,214977,32416,30061,2584,32645,273
2022-01-21,Yuba,115,75493,14099,13288,833,14121,103
2022-01-20,Alameda,001,1643700,220124,203927,10741,214668,1575
2022-01-20,Alpine,003,1148,118,119,1,120,0
2022-01-20,Amador,005,37829,7391,6845,373,7218,73
2022-01-20,Butte,007,227075,29066,27232,5500,32732,350
2022-01-20,Calaveras,009,45235,6341,5835,193,6028,95
2022-01-20,Colusa,011,21464,3088,2954,928,3882,21
2022-01-20,Contra Costa,013,1133247,164940,154111,9927,164038,1091
2022-01-20,Del Norte,015,27424,4483,4269,105,4374,43
2022-01-20,El Dorado,017,186661,24228,22273,2731,25004,179
2022-01-20,Fresno,019,978130,197906,185292,19373,204665,2429
2022-01-20,Glenn,021,27897,4421,4174,1397,5571,39
2022-01-20,Humboldt,023,135768,14549,13628,2101,15729,125
2022-01-20,Imperial,025,180216,49048,45741,8222,53963,820
2022-01-20,Inyo,027,18085,3847,3706,241,3947,50
2022-01-20,Kern,029,883053,173194,162902,39003,201905,1946
2022-01-20,Kings,031,150075,44172,40580,2894,43474,396
2022-01-20,Lake,033,64148,8802,8056,604,8660,118
2022-01-20,Lassen,035,31185,7894,7545,724,8269,55
2022-01-20,Los Angeles,037,10098052,2471067,2286280,113194,2399474,28038
2022-01-20,Madera,039,155013,31901,29595,4062,33657,329
2022-01-20,Marin,041,260295,29561,27893,1816,29709,253
2022-01-20,Mariposa,043,17540,2075,1920,109,2029,6
2022-01-20,Mendocino,045,87422,11351,10395,1848,12243,103
2022-01-20,Merced,047,269075,55652,53025,5535,58560,727
2022-01-20,Modoc,049,8938,656,639,225,864,6
2022-01-20,Mono,051,14174,2821,2723,102,2825,4
2022-01-20,Monterey,053,433212,68242,59038,8680,67718,651
2022-01-20,Napa,055,140530,22039,20402,655,21057,111
2022-01-20,Nevada,057,99092,14055,12957,879,13836,112
2022-01-20,Orange,059,3164182,504980,480329,37067,517396,5946
2022-01-20,Placer,061,380077,55704,52557,6404,58961,512
2022-01-20,Plumas,063,18699,2554,2289,193,2482,12
2022-01-20,Riverside,065,2383286,541419,513567,25262,538829,5623
2022-01-20,Sacramento,067,1510023,248192,230206,20233,250439,2510
2022-01-20,San Benito,069,59416,11386,10743,400,11143,88
2022-01-20,San Bernardino,071,2135413,525322,495209,22530,517739,6267
2022-01-20,San Diego,073,3302833,670141,628904,44677,673581,4559
2022-01-20,San Francisco,075,870044,108174,100238,6921,107159,702
2022-01-20,San Joaquin,077,732212,148086,138264,8466,146730,1960
2022-01-20,San Luis Obispo,079,281455,45551,42154,2979,45133,385
2022-01-20,San Mateo,081,765935,106747,91440,5357,96797,585
2022-01-20,Santa Barbara,083,443738,74094,69555,3770,73325,589
2022-01-20,Santa Clara,085,1922200,265588,249205,9368,258573,1993
2022-01-20,Santa Cruz,087,273765,37161,33741,1821,35562,237
2022-01-20,Shasta,089,179085,27094,25919,4983,30902,450
2022-01-20,Sierra,091,2930,261,248,33,281,0
2022-01-20,Siskiyou,093,43540,3981,3845,2128,5973,62
2022-01-20,Solano,095,438530,69668,63882,4443,68325,391
2022-01-20,Sonoma,097,501317,71590,66013,1929,67942,422
2022-01-20,Stanislaus,099,539301,105025,100092,13896,113988,1393
2022-01-20,Sutter,101,95872,18379,17616,1238,18854,199
2022-01-20,Tehama,103,63373,10720,10171,2279,12450,142
2022-01-20,Trinity,105,12862,1046,925,257,1182,19
2022-01-20,Tulare,107,460477,92491,85223,23193,108416,1211
2022-01-20,Tuolumne,109,53932,10613,9731,322,10053,91
2022-01-20,Ventura,111,848112,157459,148742,8522,157264,1250
2022-01-20,Yolo,113,214977,32131,30061,2551,32612,273
2022-01-20,Yuba,115,75493,13992,13288,800,14088,103
2022-01-19,Alameda,001,1643700,216762,199739,10401,210140,1571
2022-01-19,Alpine,003,1148,117,119,1,120,0
2022-01-19,Amador,005,37829,7310,6789,331,7120,73
2022-01-19,Butte,007,227075,28762,26839,5425,32264,351
2022-01-19,Calaveras,009,45235,6250,5765,184,5949,95
2022-01-19,Colusa,011,21464,3063,2938,920,3858,21
2022-01-19,Contra Costa,013,1133247,162631,151543,9682,161225,1091
2022-01-19,Del Norte,015,27424,4444,4240,104,4344,43
2022-01-19,El Dorado,017,186661,23975,21953,2689,24642,177
2022-01-19,Fresno,019,978130,195001,181526,19042,200568,2430
2022-01-19,Glenn,021,27897,4370,4127,1387,5514,39
2022-01-19,Humboldt,023,135768,14390,13391,2048,15439,125
2022-01-19,Imperial,025,180216,48320,45156,8012,53168,820
2022-01-19,Inyo,027,18085,3824,3680,202,3882,49
2022-01-19,Kern,029,883053,171435,160747,38318,199065,1946
2022-01-19,Kings,031,150075,43473,40027,2815,42842,395
2022-01-19,Lake,033,64148,8676,7972,591,8563,118
2022-01-19,Lassen,035,31185,7836,7507,702,8209,55
2022-01-19,Los Angeles,037,10098052,2442671,2251718,111756,2363474,27934
2022-01-19,Madera,039,155013,31520,29021,3888,32909,329
2022-01-19,Marin,041,260295,29265,27375,1773,29148,251
2022-01-19,Mariposa,043,17540,2050,1896,103,1999,6
2022-01-19,Mendocino,045,87422,11179,10252,1754,12006,103
2022-01-19,Merced,047,269075,55109,52355,5179,57534,724
2022-01-19,Modoc,049,8938,654,635,224,859,6
2022-01-19,Mono,051,14174,2799,2677,100,2777,4
2022-01-19,Monterey,053,433212,67332,58426,8217,66643,651
2022-01-19,Napa,055,140530,21786,20090,628,20718,110
2022-01-19,Nevada,057,99092,13901,12703,849,13552,112
2022-01-19,Orange,059,3164182,500496,468460,36694,505154,5943
2022-01-19,Placer,061,380077,55135,51545,6333,57878,511
2022-01-19,Plumas,063,18699,2514,2239,186,2425,12
2022-01-19,Riverside,065,2383286,535890,503575,25021,528596,5604
2022-01-19,Sacramento,067,1510023,245306,226035,19481,245516,2512
2022-01-19,San Benito,069,59416,11245,10639,388,11027,88
2022-01-19,San Bernardino,071,2135413,520717,487846,22158,510004,6265
2022-01-19,San Diego,073,3302833,661364,614709,43971,658680,4553
2022-01-19,San Francisco,075,870044,106803,98652,6842,105494,694
2022-01-19,San Joaquin,077,732212,146194,135953,8334,144287,1959
2022-01-19,San Luis Obispo,079,281455,44953,41374,2913,44287,382
2022-01-19,San Mateo,081,765935,105326,89715,5090,94805,585
2022-01-19,Santa Barbara,083,443738,73094,68531,3669,72200,586
2022-01-19,Santa Clara,085,1922200,261835,244922,9006,253928,1991
2022-01-19,Santa Cruz,087,273765,35857,33026,1796,34822,237
2022-01-19,Shasta,089,179085,26828,25355,4911,30266,450
2022-01-19,Sierra,091,2930,261,245,32,277,0
2022-01-19,Siskiyou,093,43540,3957,3821,2072,5893,62
2022-01-19,Solano,095,438530,68826,63003,4315,67318,392
2022-01-19,Sonoma,097,501317,70484,64689,1887,66576,420
2022-01-19,Stanislaus,099,539301,103977,98952,13606,112558,1381
2022-01-19,Sutter,101,95872,18211,17436,1146,18582,199
2022-01-19,Tehama,103,63373,10607,10064,2230,12294,142
2022-01-19,Trinity,105,12862,1034,916,256,1172,19
2022-01-19,Tulare,107,460477,91189,83743,22704,106447,1200
2022-01-19,Tuolumne,109,53932,10456,9613,298,9911,91
2022-01-19,Ventura,111,848112,155945,144738,8451,153189,1234
2022-01-19,Yolo,113,214977,31764,29392,2515,31907,273
2022-01-19,Yuba,115,75493,13828,13114,787,13901,104
2022-01-18,Alameda,001,1643700,213404,195728,10084,205812,1566
2022-01-18,Alpine,003,1148,117,118,1,119,0
2022-01-18,Amador,005,37829,7172,6691,294,6985,73
2022-01-18,Butte,007,227075,28370,26514,5348,31862,347
2022-01-18,Calaveras,009,45235,6162,5684,169,5853,94
2022-01-18,Colusa,011,21464,3019,2903,915,3818,21
2022-01-18,Contra Costa,013,1133247,160624,149446,9309,158755,1085
2022-01-18,Del Norte,015,27424,4374,4229,99,4328,43
2022-01-18,El Dorado,017,186661,23593,21707,2643,24350,175
2022-01-18,Fresno,019,978130,191523,178922,18610,197532,2425
2022-01-18,Glenn,021,27897,4337,4070,1375,5445,39
2022-01-18,Humboldt,023,135768,14222,13218,1976,15194,125
2022-01-18,Imperial,025,180216,47624,44742,7824,52566,819
2022-01-18,Inyo,027,18085,3783,3654,191,3845,49
2022-01-18,Kern,029,883053,169414,158864,37554,196418,1943
2022-01-18,Kings,031,150075,42595,39440,2732,42172,392
2022-01-18,Lake,033,64148,8563,7919,571,8490,117
2022-01-18,Lassen,035,31185,7752,7461,663,8124,55
2022-01-18,Los Angeles,037,10098052,2409248,2227360,110317,2337677,27871
2022-01-18,Madera,039,155013,30998,28717,3699,32416,329
2022-01-18,Marin,041,260295,28963,27036,1730,28766,251
2022-01-18,Mariposa,043,17540,2025,1872,99,1971,6
2022-01-18,Mendocino,045,87422,11009,10114,1666,11780,103
2022-01-18,Merced,047,269075,54497,51746,4897,56643,718
2022-01-18,Modoc,049,8938,652,633,219,852,6
2022-01-18,Mono,051,14174,2778,2643,99,2742,4
2022-01-18,Monterey,053,433212,66556,57846,7734,65580,650
2022-01-18,Napa,055,140530,21453,19911,611,20522,109
2022-01-18,Nevada,057,99092,13718,12584,806,13390,111
2022-01-18,Orange,059,3164182,495150,461324,36184,497508,5938
2022-01-18,Placer,061,380077,54494,50983,6257,57240,508
2022-01-18,Plumas,063,18699,2476,2218,180,2398,12
2022-01-18,Riverside,065,2383286,529912,497278,24712,521990,5599
2022-01-18,Sacramento,067,1510023,242218,223745,18457,242202,2496
2022-01-18,San Benito,069,59416,11103,10520,374,10894,88
2022-01-18,San Bernardino,071,2135413,515406,483753,21726,505479,6258
2022-01-18,San Diego,073,3302833,651147,605137,42956,648093,4547
2022-01-18,San Francisco,075,870044,105339,96505,6726,103231,694
2022-01-18,San Joaquin,077,732212,144258,134365,8160,142525,1957
2022-01-18,San Luis Obispo,079,281455,44268,40848,2826,43674,381
2022-01-18,San Mateo,081,765935,103807,88225,4892,93117,585
2022-01-18,Santa Barbara,083,443738,71873,67216,3496,70712,581
2022-01-18,Santa Clara,085,1922200,257684,240281,8604,248885,1986
2022-01-18,Santa Cruz,087,273765,35207,32203,1761,33964,237
2022-01-18,Shasta,089,179085,26545,25162,4817,29979,448
2022-01-18,Sierra,091,2930,257,244,32,276,0
2022-01-18,Siskiyou,093,43540,3923,3799,2018,5817,62
2022-01-18,Solano,095,438530,67976,62204,4206,66410,391
2022-01-18,Sonoma,097,501317,69100,63714,1832,65546,419
2022-01-18,Stanislaus,099,539301,102757,98000,13257,111257,1379
2022-01-18,Sutter,101,95872,18020,17295,1073,18368,198
2022-01-18,Tehama,103,63373,10508,9975,2177,12152,142
2022-01-18,Trinity,105,12862,1021,907,255,1162,19
2022-01-18,Tulare,107,460477,89717,82667,22270,104937,1196
2022-01-18,Tuolumne,109,53932,10287,9528,286,9814,91
2022-01-18,Ventura,111,848112,154236,143384,8377,151761,1233
2022-01-18,Yolo,113,214977,31367,28786,2464,31250,270
2022-01-18,Yuba,115,75493,13667,12971,761,13732,101
2022-01-17,Alameda,001,1643700,208721,193276,9476,202752,1565
2022-01-17,Alpine,003,1148,116,118,0,118,0
2022-01-17,Amador,005,37829,7058,6640,236,6876,73
2022-01-17,Butte,007,227075,27992,26303,5243,31546,348
2022-01-17,Calaveras,009,45235,6030,5584,141,5725,94
2022-01-17,Colusa,011,21464,2996,2905,908,3813,21
2022-01-17,Contra Costa,013,1133247,157865,147993,8820,156813,1086
2022-01-17,Del Norte,015,27424,4323,4209,92,4301,43
2022-01-17,El Dorado,017,186661,23341,21540,2561,24101,175
2022-01-17,Fresno,019,978130,187825,176959,18103,195062,2426
2022-01-17,Glenn,021,27897,4284,4055,1361,5416,39
2022-01-17,Humboldt,023,135768,14016,13120,1809,14929,125
2022-01-17,Imperial,025,180216,46937,44412,7650,52062,821
2022-01-17,Inyo,027,18085,3761,3650,165,3815,49
2022-01-17,Kern,029,883053,166865,157645,36669,194314,1944
2022-01-17,Kings,031,150075,41462,39143,2609,41752,392
2022-01-17,Lake,033,64148,8414,7864,531,8395,117
2022-01-17,Lassen,035,31185,7649,7417,625,8042,55
2022-01-17,Los Angeles,037,10098052,2370039,2205740,108351,2314091,27832
2022-01-17,Madera,039,155013,30342,28568,3513,32081,329
2022-01-17,Marin,041,260295,28556,26633,1674,28307,251
2022-01-17,Mariposa,043,17540,1999,1862,93,1955,6
2022-01-17,Mendocino,045,87422,10785,10030,1524,11554,103
2022-01-17,Merced,047,269075,53818,51227,4334,55561,718
2022-01-17,Modoc,049,8938,648,630,219,849,6
2022-01-17,Mono,051,14174,2755,2642,98,2740,4
2022-01-17,Monterey,053,433212,65435,57318,7309,64627,647
2022-01-17,Napa,055,140530,21109,19647,588,20235,109
2022-01-17,Nevada,057,99092,13530,12414,768,13182,111
2022-01-17,Orange,059,3164182,489189,457418,35714,493132,5933
2022-01-17,Placer,061,380077,53759,50511,6111,56622,508
2022-01-17,Plumas,063,18699,2430,2205,150,2355,12
2022-01-17,Riverside,065,2383286,523106,491322,24255,515577,5600
2022-01-17,Sacramento,067,1510023,238145,221143,17066,238209,2497
2022-01-17,San Benito,069,59416,10936,10432,346,10778,88
2022-01-17,San Bernardino,071,2135413,509107,480243,21180,501423,6259
2022-01-17,San Diego,073,3302833,638946,569241,41757,610998,4545
2022-01-17,San Francisco,075,870044,103713,95292,6532,101824,694
2022-01-17,San Joaquin,077,732212,141419,133414,7983,141397,1958
2022-01-17,San Luis Obispo,079,281455,43438,40425,2724,43149,379
2022-01-17,San Mateo,081,765935,101837,87013,4634,91647,585
2022-01-17,Santa Barbara,083,443738,70549,66704,3295,69999,581
2022-01-17,Santa Clara,085,1922200,253172,237934,8163,246097,1985
2022-01-17,Santa Cruz,087,273765,34429,31714,1722,33436,237
2022-01-17,Shasta,089,179085,26257,25025,4695,29720,448
2022-01-17,Sierra,091,2930,256,242,32,274,0
2022-01-17,Siskiyou,093,43540,3884,3764,1938,5702,62
2022-01-17,Solano,095,438530,66937,61497,3944,65441,391
2022-01-17,Sonoma,097,501317,67590,62763,1770,64533,419
2022-01-17,Stanislaus,099,539301,101441,96951,12783,109734,1379
2022-01-17,Sutter,101,95872,17813,17159,934,18093,198
2022-01-17,Tehama,103,63373,10386,9912,2117,12029,142
2022-01-17,Trinity,105,12862,1008,906,251,1157,19
2022-01-17,Tulare,107,460477,87952,81741,21698,103439,1199
2022-01-17,Tuolumne,109,53932,10153,9416,252,9668,91
2022-01-17,Ventura,111,848112,152118,142070,8265,150335,1234
2022-01-17,Yolo,113,214977,30839,28638,2399,31037,270
2022-01-17,Yuba,115,75493,13469,12871,705,13576,101
2022-01-16,Alameda,001,1643700,205659,190691,9213,199904,1564
2022-01-16,Alpine,003,1148,116,118,0,118,0
2022-01-16,Amador,005,37829,6984,6618,228,6846,73
2022-01-16,Butte,007,227075,27655,26139,5194,31333,348
2022-01-16,Calaveras,009,45235,5929,5537,137,5674,94
2022-01-16,Colusa,011,21464,2979,2886,896,3782,21
2022-01-16,Contra Costa,013,1133247,155956,146307,8617,154924,1086
2022-01-16,Del Norte,015,27424,4280,4177,90,4267,43
2022-01-16,El Dorado,017,186661,23066,21303,2522,23825,175
2022-01-16,Fresno,019,978130,185119,174818,17744,192562,2425
2022-01-16,Glenn,021,27897,4229,4049,1339,5388,39
2022-01-16,Humboldt,023,135768,13869,13075,1790,14865,125
2022-01-16,Imperial,025,180216,46360,44035,7483,51518,821
2022-01-16,Inyo,027,18085,3724,3602,143,3745,49
2022-01-16,Kern,029,883053,165591,156655,35877,192532,1944
2022-01-16,Kings,031,150075,41089,38861,2582,41443,392
2022-01-16,Lake,033,64148,8310,7823,496,8319,117
2022-01-16,Lassen,035,31185,7606,7391,611,8002,55
2022-01-16,Los Angeles,037,10098052,2346869,2174403,106814,2281217,27805
2022-01-16,Madera,039,155013,29971,28313,3462,31775,329
2022-01-16,Marin,041,260295,28261,26292,1660,27952,251
2022-01-16,Mariposa,043,17540,1972,1851,88,1939,6
2022-01-16,Mendocino,045,87422,10639,9992,1407,11399,102
2022-01-16,Merced,047,269075,53230,50882,4312,55194,718
2022-01-16,Modoc,049,8938,645,629,219,848,6
2022-01-16,Mono,051,14174,2751,2614,96,2710,4
2022-01-16,Monterey,053,433212,64667,57012,7160,64172,647
2022-01-16,Napa,055,140530,20842,19521,577,20098,109
2022-01-16,Nevada,057,99092,13313,12307,749,13056,111
2022-01-16,Orange,059,3164182,483792,451962,35158,487120,5932
2022-01-16,Placer,061,380077,53046,50076,5997,56073,508
2022-01-16,Plumas,063,18699,2395,2204,140,2344,12
2022-01-16,Riverside,065,2383286,517620,485191,24027,509218,5600
2022-01-16,Sacramento,067,1510023,235172,218819,16324,235143,2491
2022-01-16,San Benito,069,59416,10778,10377,344,10721,88
2022-01-16,San Bernardino,071,2135413,505270,474425,20936,495361,6259
2022-01-16,San Diego,073,3302833,631350,569241,41325,610566,4545
2022-01-16,San Francisco,075,870044,102185,94139,6393,100532,694
2022-01-16,San Joaquin,077,732212,139639,132214,7877,140091,1958
2022-01-16,San Luis Obispo,079,281455,42781,40113,2684,42797,379
2022-01-16,San Mateo,081,765935,100311,85966,4539,90505,585
2022-01-16,Santa Barbara,083,443738,69522,66111,3255,69366,582
2022-01-16,Santa Clara,085,1922200,249495,234293,8010,242303,1984
2022-01-16,Santa Cruz,087,273765,33791,31469,1698,33167,237
2022-01-16,Shasta,089,179085,26012,24980,4627,29607,449
2022-01-16,Sierra,091,2930,252,238,31,269,0
2022-01-16,Siskiyou,093,43540,3857,3748,1898,5646,62
2022-01-16,Solano,095,438530,66262,60885,3812,64697,391
2022-01-16,Sonoma,097,501317,66515,61842,1750,63592,419
2022-01-16,Stanislaus,099,539301,100375,96370,12643,109013,1379
2022-01-16,Sutter,101,95872,17612,16996,911,17907,198
2022-01-16,Tehama,103,63373,10303,9868,2095,11963,142
2022-01-16,Trinity,105,12862,1003,889,249,1138,19
2022-01-16,Tulare,107,460477,86624,80867,21424,102291,1199
2022-01-16,Tuolumne,109,53932,10048,9369,243,9612,91
2022-01-16,Ventura,111,848112,150543,140715,8192,148907,1234
2022-01-16,Yolo,113,214977,30448,28481,2344,30825,270
2022-01-16,Yuba,115,75493,13293,12760,699,13459,101
2022-01-15,Alameda,001,1643700,204304,177768,9161,186929,1561
2022-01-15,Alpine,003,1148,116,117,0,117,0
2022-01-15,Amador,005,37829,6952,6434,214,6648,72
2022-01-15,Butte,007,227075,27502,25032,5145,30177,348
2022-01-15,Calaveras,009,45235,5897,5258,137,5395,93
2022-01-15,Colusa,011,21464,2966,2796,888,3684,21
2022-01-15,Contra Costa,013,1133247,154747,137643,8564,146207,1082
2022-01-15,Del Norte,015,27424,4265,4065,88,4153,43
2022-01-15,El Dorado,017,186661,22968,20434,2505,22939,175
2022-01-15,Fresno,019,978130,184192,167361,17657,185018,2415
2022-01-15,Glenn,021,27897,4222,3906,1332,5238,39
2022-01-15,Humboldt,023,135768,13766,12419,1774,14193,123
2022-01-15,Imperial,025,180216,46219,42508,7371,49879,817
2022-01-15,Inyo,027,18085,3714,3395,143,3538,49
2022-01-15,Kern,029,883053,164750,150085,35485,185570,1938
2022-01-15,Kings,031,150075,40840,37221,2570,39791,391
2022-01-15,Lake,033,64148,8271,7641,483,8124,117
2022-01-15,Lassen,035,31185,7565,7274,605,7879,55
2022-01-15,Los Angeles,037,10098052,2335331,2047927,105859,2153786,27641
2022-01-15,Madera,039,155013,29824,27294,3439,30733,329
2022-01-15,Marin,041,260295,28074,25248,1653,26901,251
2022-01-15,Mariposa,043,17540,1965,1762,88,1850,6
2022-01-15,Mendocino,045,87422,10566,9534,1402,10936,102
2022-01-15,Merced,047,269075,53065,48904,4301,53205,715
2022-01-15,Modoc,049,8938,643,628,219,847,6
2022-01-15,Mono,051,14174,2746,2508,95,2603,4
2022-01-15,Monterey,053,433212,64153,55315,7091,62406,647
2022-01-15,Napa,055,140530,20721,17648,572,18220,109
2022-01-15,Nevada,057,99092,13255,11773,735,12508,111
2022-01-15,Orange,059,3164182,481198,433141,34883,468024,5914
2022-01-15,Placer,061,380077,52762,47780,5963,53743,501
2022-01-15,Plumas,063,18699,2374,2158,135,2293,12
2022-01-15,Riverside,065,2383286,514941,466381,23892,490273,5578
2022-01-15,Sacramento,067,1510023,234012,208156,16222,224378,2491
2022-01-15,San Benito,069,59416,10679,9868,338,10206,87
2022-01-15,San Bernardino,071,2135413,502992,454395,20789,475184,6233
2022-01-15,San Diego,073,3302833,627558,559385,41072,600457,4540
2022-01-15,San Francisco,075,870044,101193,88004,6257,94261,692
2022-01-15,San Joaquin,077,732212,139078,125136,7784,132920,1954
2022-01-15,San Luis Obispo,079,281455,42592,38231,2671,40902,374
2022-01-15,San Mateo,081,765935,99355,80494,4498,84992,582
2022-01-15,Santa Barbara,083,443738,68923,62312,3244,65556,579
2022-01-15,Santa Clara,085,1922200,247290,218986,7891,226877,1974
2022-01-15,Santa Cruz,087,273765,33437,29414,1690,31104,235
2022-01-15,Shasta,089,179085,25924,24482,4595,29077,445
2022-01-15,Sierra,091,2930,251,232,30,262,0
2022-01-15,Siskiyou,093,43540,3845,3661,1887,5548,62
2022-01-15,Solano,095,438530,65983,58061,3761,61822,389
2022-01-15,Sonoma,097,501317,65931,58181,1744,59925,418
2022-01-15,Stanislaus,099,539301,99792,92986,12544,105530,1379
2022-01-15,Sutter,101,95872,17522,16345,901,17246,197
2022-01-15,Tehama,103,63373,10254,9572,2076,11648,141
2022-01-15,Trinity,105,12862,1000,872,249,1121,19
2022-01-15,Tulare,107,460477,86178,77769,21299,99068,1192
2022-01-15,Tuolumne,109,53932,9949,9042,238,9280,91
2022-01-15,Ventura,111,848112,149770,134736,8156,142892,1227
2022-01-15,Yolo,113,214977,30269,27311,2324,29635,270
2022-01-15,Yuba,115,75493,13231,12200,695,12895,101
2022-01-14,Alameda,001,1643700,202262,177768,9108,186876,1561
2022-01-14,Alpine,003,1148,116,117,0,117,0
2022-01-14,Amador,005,37829,6876,6434,205,6639,72
2022-01-14,Butte,007,227075,27318,25032,5117,30149,348
2022-01-14,Calaveras,009,45235,5860,5258,136,5394,93
2022-01-14,Colusa,011,21464,2957,2796,878,3674,21
2022-01-14,Contra Costa,013,1133247,153304,137643,8463,146106,1082
2022-01-14,Del Norte,015,27424,4239,4065,87,4152,43
2022-01-14,El Dorado,017,186661,22813,20434,2487,22921,175
2022-01-14,Fresno,019,978130,182541,167361,17582,184943,2415
2022-01-14,Glenn,021,27897,4200,3906,1323,5229,39
2022-01-14,Humboldt,023,135768,13661,12419,1741,14160,123
2022-01-14,Imperial,025,180216,46047,42508,7351,49859,817
2022-01-14,Inyo,027,18085,3689,3395,139,3534,49
2022-01-14,Kern,029,883053,163754,150085,35048,185133,1938
2022-01-14,Kings,031,150075,40591,37221,2561,39782,391
2022-01-14,Lake,033,64148,8215,7641,470,8111,117
2022-01-14,Lassen,035,31185,7535,7274,593,7867,55
2022-01-14,Los Angeles,037,10098052,2316008,2047927,104819,2152746,27641
2022-01-14,Madera,039,155013,29587,27294,3414,30708,329
2022-01-14,Marin,041,260295,27813,25248,1617,26865,251
2022-01-14,Mariposa,043,17540,1950,1762,88,1850,6
2022-01-14,Mendocino,045,87422,10455,9534,1389,10923,102
2022-01-14,Merced,047,269075,52885,48904,4281,53185,715
2022-01-14,Modoc,049,8938,642,628,219,847,6
2022-01-14,Mono,051,14174,2725,2508,93,2601,4
2022-01-14,Monterey,053,433212,63458,55315,7000,62315,647
2022-01-14,Napa,055,140530,20551,17648,566,18214,109
2022-01-14,Nevada,057,99092,13132,11773,722,12495,111
2022-01-14,Orange,059,3164182,477466,433141,34562,467703,5914
2022-01-14,Placer,061,380077,52327,47780,5878,53658,501
2022-01-14,Plumas,063,18699,2366,2158,128,2286,12
2022-01-14,Riverside,065,2383286,511421,466381,23749,490130,5578
2022-01-14,Sacramento,067,1510023,232063,208156,16067,224223,2491
2022-01-14,San Benito,069,59416,10627,9868,337,10205,87
2022-01-14,San Bernardino,071,2135413,499888,454395,20603,474998,6233
2022-01-14,San Diego,073,3302833,621907,559385,40768,600153,4540
2022-01-14,San Francisco,075,870044,100024,88004,6080,94084,692
2022-01-14,San Joaquin,077,732212,138235,125136,7724,132860,1954
2022-01-14,San Luis Obispo,079,281455,42426,38231,2648,40879,374
2022-01-14,San Mateo,081,765935,98128,80494,4469,84963,582
2022-01-14,Santa Barbara,083,443738,68406,62312,3234,65546,579
2022-01-14,Santa Clara,085,1922200,244709,218986,7784,226770,1974
2022-01-14,Santa Cruz,087,273765,33062,29414,1679,31093,235
2022-01-14,Shasta,089,179085,25809,24482,4561,29043,445
2022-01-14,Sierra,091,2930,249,232,28,260,0
2022-01-14,Siskiyou,093,43540,3834,3661,1874,5535,62
2022-01-14,Solano,095,438530,65140,58061,3671,61732,389
2022-01-14,Sonoma,097,501317,65396,58181,1717,59898,418
2022-01-14,Stanislaus,099,539301,99186,92986,12443,105429,1379
2022-01-14,Sutter,101,95872,17396,16345,892,17237,197
2022-01-14,Tehama,103,63373,10201,9572,2064,11636,141
2022-01-14,Trinity,105,12862,995,872,247,1119,19
2022-01-14,Tulare,107,460477,85646,77769,21124,98893,1192
2022-01-14,Tuolumne,109,53932,9826,9042,233,9275,91
2022-01-14,Ventura,111,848112,148665,134736,8098,142834,1227
2022-01-14,Yolo,113,214977,30032,27311,2291,29602,270
2022-01-14,Yuba,115,75493,13128,12200,690,12890,101
2022-01-13,Alameda,001,1643700,197947,177768,8748,186516,1561
2022-01-13,Alpine,003,1148,115,117,0,117,0
2022-01-13,Amador,005,37829,6816,6434,184,6618,72
2022-01-13,Butte,007,227075,27019,25032,5005,30037,348
2022-01-13,Calaveras,009,45235,5769,5258,132,5390,93
2022-01-13,Colusa,011,21464,2926,2796,868,3664,21
2022-01-13,Contra Costa,013,1133247,150778,137643,8001,145644,1082
2022-01-13,Del Norte,015,27424,4204,4065,86,4151,43
2022-01-13,El Dorado,017,186661,22566,20434,2442,22876,175
2022-01-13,Fresno,019,978130,179743,167361,17214,184575,2415
2022-01-13,Glenn,021,27897,4152,3906,1297,5203,39
2022-01-13,Humboldt,023,135768,13508,12419,1679,14098,123
2022-01-13,Imperial,025,180216,45499,42508,7126,49634,817
2022-01-13,Inyo,027,18085,3633,3395,122,3517,49
2022-01-13,Kern,029,883053,162162,150085,34450,184535,1938
2022-01-13,Kings,031,150075,40108,37221,2516,39737,391
2022-01-13,Lake,033,64148,8115,7641,449,8090,117
2022-01-13,Lassen,035,31185,7506,7274,577,7851,55
2022-01-13,Los Angeles,037,10098052,2279530,2047927,103028,2150955,27641
2022-01-13,Madera,039,155013,29127,27294,3320,30614,329
2022-01-13,Marin,041,260295,27467,25248,1573,26821,251
2022-01-13,Mariposa,043,17540,1927,1762,85,1847,6
2022-01-13,Mendocino,045,87422,10364,9534,1321,10855,102
2022-01-13,Merced,047,269075,52227,48904,4018,52922,715
2022-01-13,Modoc,049,8938,639,628,219,847,6
2022-01-13,Mono,051,14174,2702,2508,90,2598,4
2022-01-13,Monterey,053,433212,62519,55315,6712,62027,647
2022-01-13,Napa,055,140530,20254,17648,556,18204,109
2022-01-13,Nevada,057,99092,12944,11773,692,12465,111
2022-01-13,Orange,059,3164182,471013,433141,34105,467246,5914
2022-01-13,Placer,061,380077,51694,47780,5763,53543,501
2022-01-13,Plumas,063,18699,2346,2158,118,2276,12
2022-01-13,Riverside,065,2383286,505133,466381,23418,489799,5578
2022-01-13,Sacramento,067,1510023,228967,208156,15255,223411,2491
2022-01-13,San Benito,069,59416,10524,9868,329,10197,87
2022-01-13,San Bernardino,071,2135413,494202,454395,20134,474529,6233
2022-01-13,San Diego,073,3302833,613382,559385,39898,599283,4540
2022-01-13,San Francisco,075,870044,98286,88004,5882,93886,692
2022-01-13,San Joaquin,077,732212,136168,125136,7595,132731,1954
2022-01-13,San Luis Obispo,079,281455,41823,38231,2543,40774,374
2022-01-13,San Mateo,081,765935,96340,80494,4228,84722,582
2022-01-13,Santa Barbara,083,443738,67409,62312,3048,65360,579
2022-01-13,Santa Clara,085,1922200,240440,218986,7447,226433,1974
2022-01-13,Santa Cruz,087,273765,32249,29414,1657,31071,235
2022-01-13,Shasta,089,179085,25602,24482,4488,28970,445
2022-01-13,Sierra,091,2930,248,232,28,260,0
2022-01-13,Siskiyou,093,43540,3812,3661,1833,5494,62
2022-01-13,Solano,095,438530,64010,58061,3559,61620,389
2022-01-13,Sonoma,097,501317,64330,58181,1658,59839,418
2022-01-13,Stanislaus,099,539301,98072,92986,12174,105160,1379
2022-01-13,Sutter,101,95872,17200,16345,827,17172,197
2022-01-13,Tehama,103,63373,10102,9572,2015,11587,141
2022-01-13,Trinity,105,12862,987,872,247,1119,19
2022-01-13,Tulare,107,460477,84361,77769,20805,98574,1192
2022-01-13,Tuolumne,109,53932,9686,9042,215,9257,91
2022-01-13,Ventura,111,848112,146879,134736,8010,142746,1227
2022-01-13,Yolo,113,214977,29629,27311,2244,29555,270
2022-01-13,Yuba,115,75493,12992,12200,661,12861,101
2022-01-12,Alameda,001,1643700,193318,173001,8279,181280,1563
2022-01-12,Alpine,003,1148,115,117,0,117,0
2022-01-12,Amador,005,37829,6768,6354,170,6524,71
2022-01-12,Butte,007,227075,26694,24631,4917,29548,348
2022-01-12,Calaveras,009,45235,5690,5151,126,5277,93
2022-01-12,Colusa,011,21464,2886,2772,855,3627,21
2022-01-12,Contra Costa,013,1133247,148237,134579,7634,142213,1077
2022-01-12,Del Norte,015,27424,4177,4019,84,4103,43
2022-01-12,El Dorado,017,186661,22243,20092,2402,22494,175
2022-01-12,Fresno,019,978130,177007,165316,16792,182108,2413
2022-01-12,Glenn,021,27897,4100,3859,1275,5134,39
2022-01-12,Humboldt,023,135768,13336,12081,1597,13678,122
2022-01-12,Imperial,025,180216,44839,41985,6813,48798,814
2022-01-12,Inyo,027,18085,3587,3334,106,3440,49
2022-01-12,Kern,029,883053,160023,148435,33712,182147,1933
2022-01-12,Kings,031,150075,39473,36780,2474,39254,391
2022-01-12,Lake,033,64148,7999,7535,405,7940,117
2022-01-12,Lassen,035,31185,7463,7223,550,7773,55
2022-01-12,Los Angeles,037,10098052,2239824,2005065,100781,2105846,27601
2022-01-12,Madera,039,155013,28812,26952,3229,30181,329
2022-01-12,Marin,041,260295,26976,24704,1522,26226,251
2022-01-12,Mariposa,043,17540,1898,1725,83,1808,6
2022-01-12,Mendocino,045,87422,10200,9379,1221,10600,103
2022-01-12,Merced,047,269075,51527,48441,3743,52184,710
2022-01-12,Modoc,049,8938,637,627,219,846,6
2022-01-12,Mono,051,14174,2666,2466,86,2552,4
2022-01-12,Monterey,053,433212,61535,54524,6345,60869,647
2022-01-12,Napa,055,140530,19996,17347,533,17880,109
2022-01-12,Nevada,057,99092,12728,11552,643,12195,111
2022-01-12,Orange,059,3164182,464227,425737,33514,459251,5912
2022-01-12,Placer,061,380077,51038,47004,5650,52654,501
2022-01-12,Plumas,063,18699,2307,2135,107,2242,12
2022-01-12,Riverside,065,2383286,497926,458881,23075,481956,5565
2022-01-12,Sacramento,067,1510023,225379,204696,14346,219042,2479
2022-01-12,San Benito,069,59416,10393,9737,317,10054,87
2022-01-12,San Bernardino,071,2135413,487918,447869,19512,467381,6222
2022-01-12,San Diego,073,3302833,602877,551669,39040,590709,4529
2022-01-12,San Francisco,075,870044,96452,85700,5769,91469,691
2022-01-12,San Joaquin,077,732212,133883,122850,7474,130324,1948
2022-01-12,San Luis Obispo,079,281455,41092,37727,2460,40187,373
2022-01-12,San Mateo,081,765935,94306,78476,3850,82326,582
2022-01-12,Santa Barbara,083,443738,66265,60815,2943,63758,578
2022-01-12,Santa Clara,085,1922200,235939,213177,7064,220241,1971
2022-01-12,Santa Cruz,087,273765,31598,28463,1608,30071,235
2022-01-12,Shasta,089,179085,25385,24324,4422,28746,446
2022-01-12,Sierra,091,2930,247,228,28,256,0
2022-01-12,Siskiyou,093,43540,3785,3639,1786,5425,62
2022-01-12,Solano,095,438530,62962,57052,3437,60489,386
2022-01-12,Sonoma,097,501317,63044,56394,1574,57968,417
2022-01-12,Stanislaus,099,539301,96838,91738,11851,103589,1373
2022-01-12,Sutter,101,95872,17004,16135,794,16929,197
2022-01-12,Tehama,103,63373,10013,9475,1954,11429,141
2022-01-12,Trinity,105,12862,983,868,246,1114,19
2022-01-12,Tulare,107,460477,83223,76943,20392,97335,1192
2022-01-12,Tuolumne,109,53932,9555,8870,197,9067,91
2022-01-12,Ventura,111,848112,144968,132180,7931,140111,1220
2022-01-12,Yolo,113,214977,29230,26888,2170,29058,270
2022-01-12,Yuba,115,75493,12833,12015,634,12649,101
2022-01-11,Alameda,001,1643700,188797,169181,7881,177062,1561
2022-01-11,Alpine,003,1148,115,116,0,116,0
2022-01-11,Amador,005,37829,6684,6317,155,6472,71
2022-01-11,Butte,007,227075,26299,24479,4827,29306,347
2022-01-11,Calaveras,009,45235,5560,5083,112,5195,93
2022-01-11,Colusa,011,21464,2864,2766,841,3607,21
2022-01-11,Contra Costa,013,1133247,145266,132410,7150,139560,1077
2022-01-11,Del Norte,015,27424,4143,4006,82,4088,43
2022-01-11,El Dorado,017,186661,21896,19842,2330,22172,174
2022-01-11,Fresno,019,978130,173970,163509,16442,179951,2404
2022-01-11,Glenn,021,27897,4038,3844,1230,5074,39
2022-01-11,Humboldt,023,135768,13115,11960,1504,13464,122
2022-01-11,Imperial,025,180216,44232,41444,6606,48050,813
2022-01-11,Inyo,027,18085,3489,3278,99,3377,49
2022-01-11,Kern,029,883053,157737,146942,32880,179822,1929
2022-01-11,Kings,031,150075,38886,36524,2443,38967,389
2022-01-11,Lake,033,64148,7922,7494,389,7883,117
2022-01-11,Lassen,035,31185,7414,7210,536,7746,55
2022-01-11,Los Angeles,037,10098052,2197392,1966319,98553,2064872,27563
2022-01-11,Madera,039,155013,28398,26688,3150,29838,329
2022-01-11,Marin,041,260295,26619,24387,1477,25864,251
2022-01-11,Mariposa,043,17540,1876,1718,79,1797,6
2022-01-11,Mendocino,045,87422,10039,9301,1123,10424,102
2022-01-11,Merced,047,269075,50763,48068,3560,51628,708
2022-01-11,Modoc,049,8938,636,626,218,844,6
2022-01-11,Mono,051,14174,2623,2425,85,2510,4
2022-01-11,Monterey,053,433212,60492,53911,5989,59900,646
2022-01-11,Napa,055,140530,19555,17020,485,17505,109
2022-01-11,Nevada,057,99092,12501,11467,608,12075,110
2022-01-11,Orange,059,3164182,456547,417703,32877,450580,5909
2022-01-11,Placer,061,380077,50289,46459,5506,51965,500
2022-01-11,Plumas,063,18699,2272,2099,100,2199,12
2022-01-11,Riverside,065,2383286,490203,453766,22756,476522,5551
2022-01-11,Sacramento,067,1510023,221200,201058,13287,214345,2489
2022-01-11,San Benito,069,59416,10256,9624,304,9928,83
2022-01-11,San Bernardino,071,2135413,480269,442960,18908,461868,6198
2022-01-11,San Diego,073,3302833,590859,536954,37935,574889,4520
2022-01-11,San Francisco,075,870044,94252,83678,5608,89286,691
2022-01-11,San Joaquin,077,732212,131509,121139,7346,128485,1944
2022-01-11,San Luis Obispo,079,281455,40314,37183,2341,39524,372
2022-01-11,San Mateo,081,765935,92009,76756,3628,80384,582
2022-01-11,Santa Barbara,083,443738,64962,59758,2804,62562,578
2022-01-11,Santa Clara,085,1922200,230550,208425,6607,215032,1971
2022-01-11,Santa Cruz,087,273765,31092,27709,1557,29266,232
2022-01-11,Shasta,089,179085,25131,24132,4327,28459,446
2022-01-11,Sierra,091,2930,245,228,28,256,0
2022-01-11,Siskiyou,093,43540,3760,3621,1736,5357,62
2022-01-11,Solano,095,438530,61566,56349,3281,59630,388
2022-01-11,Sonoma,097,501317,61525,55411,1494,56905,416
2022-01-11,Stanislaus,099,539301,95475,90998,11502,102500,1372
2022-01-11,Sutter,101,95872,16803,15993,738,16731,197
2022-01-11,Tehama,103,63373,9882,9406,1906,11312,140
2022-01-11,Trinity,105,12862,971,858,244,1102,19
2022-01-11,Tulare,107,460477,81911,76267,19979,96246,1188
2022-01-11,Tuolumne,109,53932,9397,8811,190,9001,91
2022-01-11,Ventura,111,848112,142736,129548,7795,137343,1220
2022-01-11,Yolo,113,214977,28682,26482,2108,28590,270
2022-01-11,Yuba,115,75493,12659,11912,613,12525,101
2022-01-10,Alameda,001,1643700,183692,165657,7354,173011,1559
2022-01-10,Alpine,003,1148,115,116,0,116,0
2022-01-10,Amador,005,37829,6580,6279,138,6417,71
2022-01-10,Butte,007,227075,25957,24217,4737,28954,347
2022-01-10,Calaveras,009,45235,5461,5025,106,5131,93
2022-01-10,Colusa,011,21464,2836,2758,831,3589,21
2022-01-10,Contra Costa,013,1133247,142542,129951,6634,136585,1077
2022-01-10,Del Norte,015,27424,4120,3970,82,4052,43
2022-01-10,El Dorado,017,186661,21331,19606,2273,21879,172
2022-01-10,Fresno,019,978130,170924,161593,16046,177639,2404
2022-01-10,Glenn,021,27897,3979,3807,1216,5023,39
2022-01-10,Humboldt,023,135768,12871,11778,1369,13147,121
2022-01-10,Imperial,025,180216,43508,41080,6381,47461,811
2022-01-10,Inyo,027,18085,3434,3227,87,3314,49
2022-01-10,Kern,029,883053,155166,145744,32126,177870,1929
2022-01-10,Kings,031,150075,38256,36286,2407,38693,389
2022-01-10,Lake,033,64148,7833,7416,365,7781,117
2022-01-10,Lassen,035,31185,7377,7192,513,7705,55
2022-01-10,Los Angeles,037,10098052,2151865,1932475,96059,2028534,27546
2022-01-10,Madera,039,155013,27946,26501,3048,29549,328
2022-01-10,Marin,041,260295,26131,24023,1403,25426,251
2022-01-10,Mariposa,043,17540,1836,1684,73,1757,6
2022-01-10,Mendocino,045,87422,9866,9163,1035,10198,101
2022-01-10,Merced,047,269075,49963,47632,3269,50901,707
2022-01-10,Modoc,049,8938,635,622,216,838,6
2022-01-10,Mono,051,14174,2557,2415,80,2495,4
2022-01-10,Monterey,053,433212,59536,53485,5671,59156,645
2022-01-10,Napa,055,140530,19177,16775,470,17245,109
2022-01-10,Nevada,057,99092,12278,11300,570,11870,110
2022-01-10,Orange,059,3164182,447859,406170,32022,438192,5906
2022-01-10,Placer,061,380077,49439,45642,5344,50986,498
2022-01-10,Plumas,063,18699,2237,2086,98,2184,12
2022-01-10,Riverside,065,2383286,481951,445536,22303,467839,5546
2022-01-10,Sacramento,067,1510023,216683,198023,12211,210234,2474
2022-01-10,San Benito,069,59416,10084,9467,294,9761,83
2022-01-10,San Bernardino,071,2135413,472114,437207,18189,455396,6184
2022-01-10,San Diego,073,3302833,578149,530506,36796,567302,4500
2022-01-10,San Francisco,075,870044,92461,82209,5347,87556,690
2022-01-10,San Joaquin,077,732212,128839,119587,7072,126659,1927
2022-01-10,San Luis Obispo,079,281455,39500,36618,2243,38861,371
2022-01-10,San Mateo,081,765935,89365,75210,3370,78580,582
2022-01-10,Santa Barbara,083,443738,63702,58957,2614,61571,578
2022-01-10,Santa Clara,085,1922200,224765,203540,6124,209664,1971
2022-01-10,Santa Cruz,087,273765,30250,26906,1518,28424,232
2022-01-10,Shasta,089,179085,24932,23983,4250,28233,446
2022-01-10,Sierra,091,2930,242,223,28,251,0
2022-01-10,Siskiyou,093,43540,3727,3592,1692,5284,62
2022-01-10,Solano,095,438530,60525,55663,3072,58735,385
2022-01-10,Sonoma,097,501317,59980,54478,1449,55927,412
2022-01-10,Stanislaus,099,539301,94144,89997,11185,101182,1372
2022-01-10,Sutter,101,95872,16558,15823,691,16514,196
2022-01-10,Tehama,103,63373,9770,9360,1850,11210,140
2022-01-10,Trinity,105,12862,967,849,242,1091,19
2022-01-10,Tulare,107,460477,80408,75498,19562,95060,1186
2022-01-10,Tuolumne,109,53932,9271,8685,178,8863,91
2022-01-10,Ventura,111,848112,140133,126240,7654,133894,1217
2022-01-10,Yolo,113,214977,28104,26065,2056,28121,270
2022-01-10,Yuba,115,75493,12410,11776,578,12354,101
2022-01-09,Alameda,001,1643700,179202,162701,6674,169375,1561
2022-01-09,Alpine,003,1148,115,116,0,116,0
2022-01-09,Amador,005,37829,6492,6215,126,6341,71
2022-01-09,Butte,007,227075,25568,24018,4622,28640,347
2022-01-09,Calaveras,009,45235,5331,4976,97,5073,93
2022-01-09,Colusa,011,21464,2809,2750,809,3559,21
2022-01-09,Contra Costa,013,1133247,139691,128050,5976,134026,1077
2022-01-09,Del Norte,015,27424,4081,3950,78,4028,43
2022-01-09,El Dorado,017,186661,20970,19430,2207,21637,172
2022-01-09,Fresno,019,978130,168338,159989,15666,175655,2405
2022-01-09,Glenn,021,27897,3924,3797,1195,4992,39
2022-01-09,Humboldt,023,135768,12627,11582,1246,12828,121
2022-01-09,Imperial,025,180216,42665,40608,6110,46718,811
2022-01-09,Inyo,027,18085,3331,3149,78,3227,49
2022-01-09,Kern,029,883053,152706,144819,31377,176196,1927
2022-01-09,Kings,031,150075,37573,36041,2368,38409,389
2022-01-09,Lake,033,64148,7722,7393,320,7713,117
2022-01-09,Lassen,035,31185,7312,7172,484,7656,55
2022-01-09,Los Angeles,037,10098052,2103818,1887830,93049,1980879,27532
2022-01-09,Madera,039,155013,27564,26325,2948,29273,328
2022-01-09,Marin,041,260295,25679,23708,1311,25019,251
2022-01-09,Mariposa,043,17540,1786,1660,72,1732,6
2022-01-09,Mendocino,045,87422,9657,9097,923,10020,101
2022-01-09,Merced,047,269075,49094,47294,2998,50292,706
2022-01-09,Modoc,049,8938,633,619,216,835,6
2022-01-09,Mono,051,14174,2522,2390,73,2463,4
2022-01-09,Monterey,053,433212,58476,53251,5395,58646,645
2022-01-09,Napa,055,140530,18682,16614,454,17068,109
2022-01-09,Nevada,057,99092,12017,11152,508,11660,110
2022-01-09,Orange,059,3164182,437866,400563,31066,431629,5905
2022-01-09,Placer,061,380077,48459,45081,5193,50274,498
2022-01-09,Plumas,063,18699,2198,2081,78,2159,12
2022-01-09,Riverside,065,2383286,472980,440413,21755,462168,5546
2022-01-09,Sacramento,067,1510023,211870,195444,11063,206507,2475
2022-01-09,San Benito,069,59416,9898,9363,266,9629,83
2022-01-09,San Bernardino,071,2135413,464071,430257,17373,447630,6180
2022-01-09,San Diego,073,3302833,564983,478206,34941,513147,4500
2022-01-09,San Francisco,075,870044,90598,80463,5098,85561,690
2022-01-09,San Joaquin,077,732212,125762,118422,6907,125329,1927
2022-01-09,San Luis Obispo,079,281455,38692,36291,2135,38426,371
2022-01-09,San Mateo,081,765935,86854,73867,3040,76907,582
2022-01-09,Santa Barbara,083,443738,62015,58280,2351,60631,578
2022-01-09,Santa Clara,085,1922200,218711,199889,5579,205468,1976
2022-01-09,Santa Cruz,087,273765,29500,26513,1486,27999,232
2022-01-09,Shasta,089,179085,24697,23926,4162,28088,446
2022-01-09,Sierra,091,2930,239,223,26,249,0
2022-01-09,Siskiyou,093,43540,3699,3580,1631,5211,62
2022-01-09,Solano,095,438530,59369,54985,2785,57770,384
2022-01-09,Sonoma,097,501317,58306,53543,1411,54954,412
2022-01-09,Stanislaus,099,539301,92779,89248,10926,100174,1372
2022-01-09,Sutter,101,95872,16270,15695,609,16304,196
2022-01-09,Tehama,103,63373,9650,9306,1798,11104,140
2022-01-09,Trinity,105,12862,963,848,240,1088,19
2022-01-09,Tulare,107,460477,78985,75085,19165,94250,1186
2022-01-09,Tuolumne,109,53932,9116,8595,159,8754,91
2022-01-09,Ventura,111,848112,137076,124269,7423,131692,1217
2022-01-09,Yolo,113,214977,27497,25632,2012,27644,270
2022-01-09,Yuba,115,75493,12213,11666,547,12213,101
2022-01-08,Alameda,001,1643700,177304,148560,6528,155088,1558
2022-01-08,Alpine,003,1148,115,114,0,114,0
2022-01-08,Amador,005,37829,6459,6091,121,6212,71
2022-01-08,Butte,007,227075,25387,23429,4584,28013,347
2022-01-08,Calaveras,009,45235,5285,4823,93,4916,93
2022-01-08,Colusa,011,21464,2800,2713,806,3519,21
2022-01-08,Contra Costa,013,1133247,138187,119907,5897,125804,1077
2022-01-08,Del Norte,015,27424,4064,3902,78,3980,43
2022-01-08,El Dorado,017,186661,20789,18599,2173,20772,172
2022-01-08,Fresno,019,978130,167454,155394,15539,170933,2393
2022-01-08,Glenn,021,27897,3916,3732,1190,4922,39
2022-01-08,Humboldt,023,135768,12507,11149,1220,12369,121
2022-01-08,Imperial,025,180216,42479,39429,5965,45394,800
2022-01-08,Inyo,027,18085,3317,3020,75,3095,49
2022-01-08,Kern,029,883053,151570,140410,30942,171352,1921
2022-01-08,Kings,031,150075,37334,35275,2350,37625,390
2022-01-08,Lake,033,64148,7682,7209,312,7521,117
2022-01-08,Lassen,035,31185,7286,7127,468,7595,55
2022-01-08,Los Angeles,037,10098052,2085439,1765787,91296,1857083,27476
2022-01-08,Madera,039,155013,27396,25767,2910,28677,328
2022-01-08,Marin,041,260295,25393,22377,1300,23677,251
2022-01-08,Mariposa,043,17540,1776,1588,72,1660,6
2022-01-08,Mendocino,045,87422,9583,8792,921,9713,101
2022-01-08,Merced,047,269075,48922,46094,2977,49071,703
2022-01-08,Modoc,049,8938,633,610,216,826,6
2022-01-08,Mono,051,14174,2511,2240,68,2308,4
2022-01-08,Monterey,053,433212,58088,51721,5302,57023,644
2022-01-08,Napa,055,140530,18528,15819,428,16247,109
2022-01-08,Nevada,057,99092,11935,10765,495,11260,110
2022-01-08,Orange,059,3164182,434070,375124,30211,405335,5903
2022-01-08,Placer,061,380077,48019,43172,5151,48323,495
2022-01-08,Plumas,063,18699,2188,2053,73,2126,12
2022-01-08,Riverside,065,2383286,469464,422591,21481,444072,5535
2022-01-08,Sacramento,067,1510023,210434,185118,10898,196016,2470
2022-01-08,San Benito,069,59416,9735,9016,263,9279,83
2022-01-08,San Bernardino,071,2135413,460765,411724,16975,428699,6122
2022-01-08,San Diego,073,3302833,560083,472273,34399,506672,4495
2022-01-08,San Francisco,075,870044,89401,73660,4817,78477,690
2022-01-08,San Joaquin,077,732212,124797,112514,6811,119325,1916
2022-01-08,San Luis Obispo,079,281455,38491,34489,2092,36581,369
2022-01-08,San Mateo,081,765935,85472,67918,2953,70871,582
2022-01-08,Santa Barbara,083,443738,61319,54617,2317,56934,575
2022-01-08,Santa Clara,085,1922200,215676,183842,5371,189213,1966
2022-01-08,Santa Cruz,087,273765,29074,24678,1465,26143,230
2022-01-08,Shasta,089,179085,24610,23585,4130,27715,445
2022-01-08,Sierra,091,2930,235,215,25,240,0
2022-01-08,Siskiyou,093,43540,3687,3545,1617,5162,62
2022-01-08,Solano,095,438530,58960,52452,2716,55168,383
2022-01-08,Sonoma,097,501317,57784,50130,1377,51507,411
2022-01-08,Stanislaus,099,539301,92140,87049,10818,97867,1372
2022-01-08,Sutter,101,95872,16152,15261,596,15857,195
2022-01-08,Tehama,103,63373,9619,9109,1790,10899,140
2022-01-08,Trinity,105,12862,957,836,240,1076,19
2022-01-08,Tulare,107,460477,78591,73600,19026,92626,1185
2022-01-08,Tuolumne,109,53932,9009,8360,156,8516,91
2022-01-08,Ventura,111,848112,135908,117229,7292,124521,1216
2022-01-08,Yolo,113,214977,27205,24006,1982,25988,270
2022-01-08,Yuba,115,75493,12126,11277,544,11821,101
2022-01-07,Alameda,001,1643700,174610,148560,6416,154976,1558
2022-01-07,Alpine,003,1148,115,114,0,114,0
2022-01-07,Amador,005,37829,6410,6091,119,6210,71
2022-01-07,Butte,007,227075,25182,23429,4552,27981,347
2022-01-07,Calaveras,009,45235,5247,4823,93,4916,93
2022-01-07,Colusa,011,21464,2791,2713,795,3508,21
2022-01-07,Contra Costa,013,1133247,136320,119907,5775,125682,1077
2022-01-07,Del Norte,015,27424,4048,3902,77,3979,43
2022-01-07,El Dorado,017,186661,20627,18599,2159,20758,172
2022-01-07,Fresno,019,978130,166093,155394,15440,170834,2393
2022-01-07,Glenn,021,27897,3896,3732,1187,4919,39
2022-01-07,Humboldt,023,135768,12365,11149,1192,12341,121
2022-01-07,Imperial,025,180216,42319,39429,5881,45310,800
2022-01-07,Inyo,027,18085,3298,3020,73,3093,49
2022-01-07,Kern,029,883053,150600,140410,30497,170907,1921
2022-01-07,Kings,031,150075,37154,35275,2336,37611,390
2022-01-07,Lake,033,64148,7635,7209,286,7495,117
2022-01-07,Lassen,035,31185,7272,7127,465,7592,55
2022-01-07,Los Angeles,037,10098052,2054258,1765787,89826,1855613,27476
2022-01-07,Madera,039,155013,27215,25767,2875,28642,328
2022-01-07,Marin,041,260295,25013,22377,1282,23659,251
2022-01-07,Mariposa,043,17540,1760,1588,72,1660,6
2022-01-07,Mendocino,045,87422,9490,8792,920,9712,101
2022-01-07,Merced,047,269075,48757,46094,2953,49047,703
2022-01-07,Modoc,049,8938,632,610,216,826,6
2022-01-07,Mono,051,14174,2473,2240,62,2302,4
2022-01-07,Monterey,053,433212,57667,51721,5209,56930,644
2022-01-07,Napa,055,140530,18301,15819,407,16226,109
2022-01-07,Nevada,057,99092,11808,10765,474,11239,110
2022-01-07,Orange,059,3164182,429260,375124,29590,404714,5903
2022-01-07,Placer,061,380077,47514,43172,5103,48275,495
2022-01-07,Plumas,063,18699,2179,2053,72,2125,12
2022-01-07,Riverside,065,2383286,465644,422591,21251,443842,5535
2022-01-07,Sacramento,067,1510023,208154,185118,10738,195856,2470
2022-01-07,San Benito,069,59416,9690,9016,262,9278,83
2022-01-07,San Bernardino,071,2135413,456886,411724,16748,428472,6122
2022-01-07,San Diego,073,3302833,552947,472273,33851,506124,4495
2022-01-07,San Francisco,075,870044,87967,73660,4557,78217,690
2022-01-07,San Joaquin,077,732212,123842,112514,6751,119265,1916
2022-01-07,San Luis Obispo,079,281455,38276,34489,2037,36526,369
2022-01-07,San Mateo,081,765935,84006,67918,2894,70812,582
2022-01-07,Santa Barbara,083,443738,60619,54617,2295,56912,575
2022-01-07,Santa Clara,085,1922200,212431,183842,5261,189103,1966
2022-01-07,Santa Cruz,087,273765,28596,24678,1449,26127,230
2022-01-07,Shasta,089,179085,24516,23585,4096,27681,445
2022-01-07,Sierra,091,2930,232,215,25,240,0
2022-01-07,Siskiyou,093,43540,3677,3545,1605,5150,62
2022-01-07,Solano,095,438530,58268,52452,2675,55127,383
2022-01-07,Sonoma,097,501317,57182,50130,1289,51419,411
2022-01-07,Stanislaus,099,539301,91617,87049,10731,97780,1372
2022-01-07,Sutter,101,95872,16001,15261,583,15844,195
2022-01-07,Tehama,103,63373,9583,9109,1777,10886,140
2022-01-07,Trinity,105,12862,950,836,239,1075,19
2022-01-07,Tulare,107,460477,78158,73600,18880,92480,1185
2022-01-07,Tuolumne,109,53932,8921,8360,152,8512,91
2022-01-07,Ventura,111,848112,134283,117229,7164,124393,1216
2022-01-07,Yolo,113,214977,26833,24006,1963,25969,270
2022-01-07,Yuba,115,75493,12022,11277,539,11816,101
2022-01-06,Alameda,001,1643700,169244,148560,6002,154562,1558
2022-01-06,Alpine,003,1148,114,114,0,114,0
2022-01-06,Amador,005,37829,6358,6091,113,6204,71
2022-01-06,Butte,007,227075,24891,23429,4467,27896,347
2022-01-06,Calaveras,009,45235,5126,4823,91,4914,93
2022-01-06,Colusa,011,21464,2770,2713,786,3499,21
2022-01-06,Contra Costa,013,1133247,133455,119907,5361,125268,1077
2022-01-06,Del Norte,015,27424,4014,3902,75,3977,43
2022-01-06,El Dorado,017,186661,20294,18599,2118,20717,172
2022-01-06,Fresno,019,978130,163970,155394,15178,170572,2393
2022-01-06,Glenn,021,27897,3869,3732,1161,4893,39
2022-01-06,Humboldt,023,135768,12139,11149,1151,12300,121
2022-01-06,Imperial,025,180216,41733,39429,5676,45105,800
2022-01-06,Inyo,027,18085,3260,3020,73,3093,49
2022-01-06,Kern,029,883053,148929,140410,29819,170229,1921
2022-01-06,Kings,031,150075,36816,35275,2311,37586,390
2022-01-06,Lake,033,64148,7561,7209,274,7483,117
2022-01-06,Lassen,035,31185,7250,7127,459,7586,55
2022-01-06,Los Angeles,037,10098052,2000121,1765787,87456,1853243,27476
2022-01-06,Madera,039,155013,26908,25767,2818,28585,328
2022-01-06,Marin,041,260295,24608,22377,1249,23626,251
2022-01-06,Mariposa,043,17540,1741,1588,70,1658,6
2022-01-06,Mendocino,045,87422,9394,8792,879,9671,101
2022-01-06,Merced,047,269075,48208,46094,2817,48911,703
2022-01-06,Modoc,049,8938,631,610,216,826,6
2022-01-06,Mono,051,14174,2450,2240,59,2299,4
2022-01-06,Monterey,053,433212,56941,51721,4953,56674,644
2022-01-06,Napa,055,140530,17902,15819,398,16217,109
2022-01-06,Nevada,057,99092,11609,10765,462,11227,110
2022-01-06,Orange,059,3164182,419811,375124,28841,403965,5903
2022-01-06,Placer,061,380077,46770,43172,5015,48187,495
2022-01-06,Plumas,063,18699,2161,2053,65,2118,12
2022-01-06,Riverside,065,2383286,458169,422591,20956,443547,5535
2022-01-06,Sacramento,067,1510023,204086,185118,9976,195094,2470
2022-01-06,San Benito,069,59416,9590,9016,255,9271,83
2022-01-06,San Bernardino,071,2135413,449575,411724,16261,427985,6122
2022-01-06,San Diego,073,3302833,541296,472273,32854,505127,4495
2022-01-06,San Francisco,075,870044,85652,73660,4303,77963,690
2022-01-06,San Joaquin,077,732212,121683,112514,6669,119183,1916
2022-01-06,San Luis Obispo,079,281455,37576,34489,1966,36455,369
2022-01-06,San Mateo,081,765935,81588,67918,2713,70631,582
2022-01-06,Santa Barbara,083,443738,59451,54617,2233,56850,575
2022-01-06,Santa Clara,085,1922200,207533,183842,4873,188715,1966
2022-01-06,Santa Cruz,087,273765,28038,24678,1426,26104,230
2022-01-06,Shasta,089,179085,24372,23585,4046,27631,445
2022-01-06,Sierra,091,2930,229,215,25,240,0
2022-01-06,Siskiyou,093,43540,3661,3545,1559,5104,62
2022-01-06,Solano,095,438530,57257,52452,2500,54952,383
2022-01-06,Sonoma,097,501317,55793,50130,1257,51387,411
2022-01-06,Stanislaus,099,539301,90470,87049,10567,97616,1372
2022-01-06,Sutter,101,95872,15824,15261,554,15815,195
2022-01-06,Tehama,103,63373,9505,9109,1750,10859,140
2022-01-06,Trinity,105,12862,943,836,238,1074,19
2022-01-06,Tulare,107,460477,77450,73600,18704,92304,1185
2022-01-06,Tuolumne,109,53932,8812,8360,146,8506,91
2022-01-06,Ventura,111,848112,131589,117229,7007,124236,1216
2022-01-06,Yolo,113,214977,26279,24006,1919,25925,270
2022-01-06,Yuba,115,75493,11887,11277,522,11799,101
2022-01-05,Alameda,001,1643700,164087,144824,5569,150393,1548
2022-01-05,Alpine,003,1148,114,112,0,112,0
2022-01-05,Amador,005,37829,6314,6012,110,6122,70
2022-01-05,Butte,007,227075,24587,23134,4409,27543,343
2022-01-05,Calaveras,009,45235,5070,4758,89,4847,90
2022-01-05,Colusa,011,21464,2756,2704,775,3479,21
2022-01-05,Contra Costa,013,1133247,130449,117188,4913,122101,1071
2022-01-05,Del Norte,015,27424,3993,3862,73,3935,43
2022-01-05,El Dorado,017,186661,19908,18367,2088,20455,171
2022-01-05,Fresno,019,978130,161955,153033,14913,167946,2377
2022-01-05,Glenn,021,27897,3821,3700,1151,4851,39
2022-01-05,Humboldt,023,135768,11935,10938,1103,12041,120
2022-01-05,Imperial,025,180216,41100,38789,5521,44310,800
2022-01-05,Inyo,027,18085,3177,2939,69,3008,49
2022-01-05,Kern,029,883053,147151,138186,29241,167427,1913
2022-01-05,Kings,031,150075,36474,34893,2292,37185,387
2022-01-05,Lake,033,64148,7480,7129,258,7387,117
2022-01-05,Lassen,035,31185,7230,7077,451,7528,55
2022-01-05,Los Angeles,037,10098052,1943853,1729640,85055,1814695,27443
2022-01-05,Madera,039,155013,26669,25392,2727,28119,327
2022-01-05,Marin,041,260295,24265,21829,1197,23026,251
2022-01-05,Mariposa,043,17540,1715,1564,69,1633,6
2022-01-05,Mendocino,045,87422,9263,8625,844,9469,101
2022-01-05,Merced,047,269075,47632,45721,2685,48406,700
2022-01-05,Modoc,049,8938,628,603,216,819,6
2022-01-05,Mono,051,14174,2430,2201,55,2256,4
2022-01-05,Monterey,053,433212,56111,51241,4752,55993,639
2022-01-05,Napa,055,140530,17539,15494,366,15860,108
2022-01-05,Nevada,057,99092,11409,10624,445,11069,110
2022-01-05,Orange,059,3164182,409772,366139,27789,393928,5869
2022-01-05,Placer,061,380077,45888,42456,4919,47375,492
2022-01-05,Plumas,063,18699,2141,2020,63,2083,12
2022-01-05,Riverside,065,2383286,450715,415253,20600,435853,5502
2022-01-05,Sacramento,067,1510023,199303,181488,8997,190485,2455
2022-01-05,San Benito,069,59416,9397,8829,243,9072,83
2022-01-05,San Bernardino,071,2135413,441302,405323,15708,421031,6085
2022-01-05,San Diego,073,3302833,527701,466602,31877,498479,4495
2022-01-05,San Francisco,075,870044,83094,71405,4166,75571,686
2022-01-05,San Joaquin,077,732212,119152,110497,6589,117086,1903
2022-01-05,San Luis Obispo,079,281455,36779,34066,1889,35955,369
2022-01-05,San Mateo,081,765935,79426,66018,2514,68532,578
2022-01-05,Santa Barbara,083,443738,58145,53082,2153,55235,570
2022-01-05,Santa Clara,085,1922200,201771,178629,4457,183086,1961
2022-01-05,Santa Cruz,087,273765,27285,24394,1403,25797,229
2022-01-05,Shasta,089,179085,24214,23361,4017,27378,441
2022-01-05,Sierra,091,2930,226,210,23,233,0
2022-01-05,Siskiyou,093,43540,3651,3513,1530,5043,60
2022-01-05,Solano,095,438530,56215,51505,2364,53869,380
2022-01-05,Sonoma,097,501317,54529,49120,1095,50215,412
2022-01-05,Stanislaus,099,539301,89486,86248,10412,96660,1360
2022-01-05,Sutter,101,95872,15622,15117,514,15631,193
2022-01-05,Tehama,103,63373,9408,9011,1719,10730,140
2022-01-05,Trinity,105,12862,940,822,236,1058,19
2022-01-05,Tulare,107,460477,76672,72718,18527,91245,1173
2022-01-05,Tuolumne,109,53932,8719,8223,139,8362,90
2022-01-05,Ventura,111,848112,128835,114752,6801,121553,1211
2022-01-05,Yolo,113,214977,25667,23401,1876,25277,269
2022-01-05,Yuba,115,75493,11704,11138,496,11634,100
2022-01-04,Alameda,001,1643700,158522,143360,5156,148516,1532
2022-01-04,Alpine,003,1148,114,113,0,113,0
2022-01-04,Amador,005,37829,6247,6025,105,6130,71
2022-01-04,Butte,007,227075,24289,23094,4342,27436,346
2022-01-04,Calaveras,009,45235,4995,4767,86,4853,93
2022-01-04,Colusa,011,21464,2736,2689,768,3457,21
2022-01-04,Contra Costa,013,1133247,127390,116005,4554,120559,1075
2022-01-04,Del Norte,015,27424,3961,3882,70,3952,43
2022-01-04,El Dorado,017,186661,19548,18339,2066,20405,172
2022-01-04,Fresno,019,978130,159796,153244,14662,167906,2380
2022-01-04,Glenn,021,27897,3791,3705,1137,4842,39
2022-01-04,Humboldt,023,135768,11683,10865,1052,11917,120
2022-01-04,Imperial,025,180216,40497,38596,5256,43852,800
2022-01-04,Inyo,027,18085,3093,2870,68,2938,49
2022-01-04,Kern,029,883053,145221,138245,28654,166899,1916
2022-01-04,Kings,031,150075,36159,34931,2276,37207,388
2022-01-04,Lake,033,64148,7439,7152,248,7400,117
2022-01-04,Lassen,035,31185,7207,7111,447,7558,55
2022-01-04,Los Angeles,037,10098052,1883923,1705253,82710,1787963,27419
2022-01-04,Madera,039,155013,26326,25425,2658,28083,328
2022-01-04,Marin,041,260295,23783,21675,1138,22813,251
2022-01-04,Mariposa,043,17540,1679,1564,68,1632,6
2022-01-04,Mendocino,045,87422,9140,8636,820,9456,101
2022-01-04,Merced,047,269075,47021,45583,2556,48139,700
2022-01-04,Modoc,049,8938,625,611,216,827,6
2022-01-04,Mono,051,14174,2381,2190,45,2235,4
2022-01-04,Monterey,053,433212,55377,51176,4557,55733,643
2022-01-04,Napa,055,140530,17037,15370,336,15706,107
2022-01-04,Nevada,057,99092,11253,10608,433,11041,110
2022-01-04,Orange,059,3164182,399008,362051,26647,388698,5897
2022-01-04,Placer,061,380077,45054,42285,4801,47086,494
2022-01-04,Plumas,063,18699,2115,2014,61,2075,12
2022-01-04,Riverside,065,2383286,442193,413366,20250,433616,5504
2022-01-04,Sacramento,067,1510023,194347,181271,8246,189517,2453
2022-01-04,San Benito,069,59416,9209,8763,235,8998,79
2022-01-04,San Bernardino,071,2135413,432627,404409,15171,419580,6060
2022-01-04,San Diego,073,3302833,511298,458499,30917,489416,4487
2022-01-04,San Francisco,075,870044,80253,70666,4019,74685,688
2022-01-04,San Joaquin,077,732212,116743,110374,6456,116830,1911
2022-01-04,San Luis Obispo,079,281455,35970,33788,1801,35589,371
2022-01-04,San Mateo,081,765935,77112,65157,2324,67481,582
2022-01-04,Santa Barbara,083,443738,56622,52449,2075,54524,574
2022-01-04,Santa Clara,085,1922200,195805,176854,3992,180846,1964
2022-01-04,Santa Cruz,087,273765,26522,23904,1367,25271,228
2022-01-04,Shasta,089,179085,24071,23366,3963,27329,442
2022-01-04,Sierra,091,2930,225,214,22,236,0
2022-01-04,Siskiyou,093,43540,3635,3509,1511,5020,61
2022-01-04,Solano,095,438530,54916,51300,2167,53467,383
2022-01-04,Sonoma,097,501317,52819,48653,972,49625,410
2022-01-04,Stanislaus,099,539301,88431,86107,10256,96363,1361
2022-01-04,Sutter,101,95872,15468,15032,490,15522,193
2022-01-04,Tehama,103,63373,9332,9020,1696,10716,140
2022-01-04,Trinity,105,12862,934,833,232,1065,18
2022-01-04,Tulare,107,460477,75877,72893,18322,91215,1172
2022-01-04,Tuolumne,109,53932,8610,8235,134,8369,91
2022-01-04,Ventura,111,848112,125764,114079,6570,120649,1213
2022-01-04,Yolo,113,214977,25017,22938,1834,24772,270
2022-01-04,Yuba,115,75493,11524,11104,481,11585,101
2022-01-03,Alameda,001,1643700,152489,142090,4716,146806,1529
2022-01-03,Alpine,003,1148,113,113,0,113,0
2022-01-03,Amador,005,37829,6187,6004,100,6104,71
2022-01-03,Butte,007,227075,23994,22924,4290,27214,345
2022-01-03,Calaveras,009,45235,4936,4742,81,4823,93
2022-01-03,Colusa,011,21464,2727,2683,761,3444,21
2022-01-03,Contra Costa,013,1133247,124191,114966,3967,118933,1073
2022-01-03,Del Norte,015,27424,3941,3873,66,3939,43
2022-01-03,El Dorado,017,186661,19155,18183,2040,20223,172
2022-01-03,Fresno,019,978130,157813,152674,14459,167133,2379
2022-01-03,Glenn,021,27897,3762,3703,1102,4805,39
2022-01-03,Humboldt,023,135768,11472,10784,1004,11788,119
2022-01-03,Imperial,025,180216,39860,38411,5076,43487,800
2022-01-03,Inyo,027,18085,3024,2845,64,2909,49
2022-01-03,Kern,029,883053,143225,137773,28056,165829,1916
2022-01-03,Kings,031,150075,35841,34817,2247,37064,387
2022-01-03,Lake,033,64148,7337,7134,230,7364,117
2022-01-03,Lassen,035,31185,7189,7103,445,7548,55
2022-01-03,Los Angeles,037,10098052,1823162,1686203,79929,1766132,27394
2022-01-03,Madera,039,155013,26033,25323,2614,27937,320
2022-01-03,Marin,041,260295,23194,21532,1099,22631,251
2022-01-03,Mariposa,043,17540,1637,1559,68,1627,6
2022-01-03,Mendocino,045,87422,8992,8573,770,9343,101
2022-01-03,Merced,047,269075,46430,45459,2449,47908,696
2022-01-03,Modoc,049,8938,622,602,216,818,6
2022-01-03,Mono,051,14174,2302,2172,40,2212,4
2022-01-03,Monterey,053,433212,54549,51047,4354,55401,644
2022-01-03,Napa,055,140530,16529,15260,303,15563,107
2022-01-03,Nevada,057,99092,11088,10572,423,10995,110
2022-01-03,Orange,059,3164182,387839,358052,25447,383499,5894
2022-01-03,Placer,061,380077,44231,42054,4738,46792,489
2022-01-03,Plumas,063,18699,2095,2005,61,2066,12
2022-01-03,Riverside,065,2383286,433716,410155,19752,429907,5504
2022-01-03,Sacramento,067,1510023,189188,179992,7679,187671,2452
2022-01-03,San Benito,069,59416,9044,8688,228,8916,79
2022-01-03,San Bernardino,071,2135413,424187,401938,14711,416649,6056
2022-01-03,San Diego,073,3302833,495148,451154,29949,481103,4476
2022-01-03,San Francisco,075,870044,77461,69315,3771,73086,686
2022-01-03,San Joaquin,077,732212,114442,109757,6374,116131,1903
2022-01-03,San Luis Obispo,079,281455,35156,33667,1708,35375,367
2022-01-03,San Mateo,081,765935,74403,64470,2167,66637,582
2022-01-03,Santa Barbara,083,443738,55160,51912,1980,53892,571
2022-01-03,Santa Clara,085,1922200,189859,174215,3514,177729,1963
2022-01-03,Santa Cruz,087,273765,25712,23765,1334,25099,228
2022-01-03,Shasta,089,179085,23889,23301,3936,27237,440
2022-01-03,Sierra,091,2930,218,213,21,234,0
2022-01-03,Siskiyou,093,43540,3609,3500,1489,4989,61
2022-01-03,Solano,095,438530,53619,51030,1975,53005,380
2022-01-03,Sonoma,097,501317,51121,48391,875,49266,410
2022-01-03,Stanislaus,099,539301,87439,85793,10089,95882,1332
2022-01-03,Sutter,101,95872,15312,14973,469,15442,193
2022-01-03,Tehama,103,63373,9257,9005,1670,10675,140
2022-01-03,Trinity,105,12862,929,833,231,1064,18
2022-01-03,Tulare,107,460477,75175,72664,18099,90763,1167
2022-01-03,Tuolumne,109,53932,8472,8179,130,8309,91
2022-01-03,Ventura,111,848112,122590,112762,6339,119101,1211
2022-01-03,Yolo,113,214977,24337,22563,1771,24334,270
2022-01-03,Yuba,115,75493,11388,11037,462,11499,99
2022-01-02,Alameda,001,1643700,148066,133486,4228,137714,1528
2022-01-02,Alpine,003,1148,111,113,0,113,0
2022-01-02,Amador,005,37829,6121,5913,95,6008,70
2022-01-02,Butte,007,227075,23655,22469,4230,26699,341
2022-01-02,Calaveras,009,45235,4867,4668,73,4741,93
2022-01-02,Colusa,011,21464,2722,2659,750,3409,21
2022-01-02,Contra Costa,013,1133247,120624,109593,3524,113117,1073
2022-01-02,Del Norte,015,27424,3909,3841,64,3905,43
2022-01-02,El Dorado,017,186661,18820,17621,1988,19609,172
2022-01-02,Fresno,019,978130,156092,149927,14228,164155,2379
2022-01-02,Glenn,021,27897,3742,3663,1093,4756,39
2022-01-02,Humboldt,023,135768,11231,10381,926,11307,119
2022-01-02,Imperial,025,180216,39202,37672,4858,42530,800
2022-01-02,Inyo,027,18085,2954,2726,53,2779,49
2022-01-02,Kern,029,883053,141299,136123,27458,163581,1917
2022-01-02,Kings,031,150075,35522,34318,2212,36530,386
2022-01-02,Lake,033,64148,7266,7060,216,7276,117
2022-01-02,Lassen,035,31185,7173,7089,443,7532,55
2022-01-02,Los Angeles,037,10098052,1772042,1596123,77033,1673156,27371
2022-01-02,Madera,039,155013,25778,25002,2555,27557,320
2022-01-02,Marin,041,260295,22632,20475,1028,21503,249
2022-01-02,Mariposa,043,17540,1606,1509,66,1575,6
2022-01-02,Mendocino,045,87422,8868,8422,752,9174,101
2022-01-02,Merced,047,269075,45896,44769,2353,47122,694
2022-01-02,Modoc,049,8938,620,601,215,816,6
2022-01-02,Mono,051,14174,2274,2101,35,2136,4
2022-01-02,Monterey,053,433212,53928,50251,4144,54395,643
2022-01-02,Napa,055,140530,15987,14439,292,14731,107
2022-01-02,Nevada,057,99092,10904,10299,409,10708,110
2022-01-02,Orange,059,3164182,376837,339526,24289,363815,5890
2022-01-02,Placer,061,380077,43503,40857,4651,45508,489
2022-01-02,Plumas,063,18699,2080,1994,57,2051,12
2022-01-02,Riverside,065,2383286,425389,397124,19229,416353,5501
2022-01-02,Sacramento,067,1510023,185108,173562,6818,180380,2448
2022-01-02,San Benito,069,59416,8861,8320,213,8533,79
2022-01-02,San Bernardino,071,2135413,416512,386278,14159,400437,6051
2022-01-02,San Diego,073,3302833,480069,427087,28766,455853,4469
2022-01-02,San Francisco,075,870044,74531,64498,3532,68030,682
2022-01-02,San Joaquin,077,732212,112575,106640,6268,112908,1902
2022-01-02,San Luis Obispo,079,281455,34423,32342,1625,33967,365
2022-01-02,San Mateo,081,765935,71832,60504,1925,62429,581
2022-01-02,Santa Barbara,083,443738,53724,49555,1917,51472,568
2022-01-02,Santa Clara,085,1922200,183717,164547,3113,167660,1969
2022-01-02,Santa Cruz,087,273765,25042,22980,1302,24282,228
2022-01-02,Shasta,089,179085,23700,23161,3887,27048,435
2022-01-02,Sierra,091,2930,217,206,21,227,0
2022-01-02,Siskiyou,093,43540,3584,3474,1466,4940,61
2022-01-02,Solano,095,438530,52679,48957,1810,50767,379
2022-01-02,Sonoma,097,501317,49796,46040,838,46878,410
2022-01-02,Stanislaus,099,539301,86587,84367,9973,94340,1332
2022-01-02,Sutter,101,95872,15139,14741,450,15191,193
2022-01-02,Tehama,103,63373,9192,8944,1647,10591,139
2022-01-02,Trinity,105,12862,927,832,230,1062,17
2022-01-02,Tulare,107,460477,74515,71941,17904,89845,1160
2022-01-02,Tuolumne,109,53932,8366,8044,125,8169,91
2022-01-02,Ventura,111,848112,119667,107992,6120,114112,1211
2022-01-02,Yolo,113,214977,23664,21747,1701,23448,270
2022-01-02,Yuba,115,75493,11266,10844,445,11289,99
2022-01-01,Alameda,001,1643700,146273,133486,3975,137461,1528
2022-01-01,Alpine,003,1148,111,113,0,113,0
2022-01-01,Amador,005,37829,6086,5913,90,6003,70
2022-01-01,Butte,007,227075,23459,22469,4200,26669,341
2022-01-01,Calaveras,009,45235,4831,4668,71,4739,93
2022-01-01,Colusa,011,21464,2720,2659,740,3399,21
2022-01-01,Contra Costa,013,1133247,119259,109593,3396,112989,1073
2022-01-01,Del Norte,015,27424,3903,3841,64,3905,43
2022-01-01,El Dorado,017,186661,18673,17621,1973,19594,172
2022-01-01,Fresno,019,978130,155428,149927,14149,164076,2379
2022-01-01,Glenn,021,27897,3735,3663,1093,4756,39
2022-01-01,Humboldt,023,135768,11096,10381,905,11286,119
2022-01-01,Imperial,025,180216,39055,37672,4813,42485,800
2022-01-01,Inyo,027,18085,2925,2726,51,2777,49
2022-01-01,Kern,029,883053,140608,136123,27147,163270,1917
2022-01-01,Kings,031,150075,35386,34318,2185,36503,386
2022-01-01,Lake,033,64148,7227,7060,211,7271,117
2022-01-01,Lassen,035,31185,7167,7089,438,7527,55
2022-01-01,Los Angeles,037,10098052,1751948,1596123,75065,1671188,27371
2022-01-01,Madera,039,155013,25694,25002,2541,27543,320
2022-01-01,Marin,041,260295,22321,20475,987,21462,249
2022-01-01,Mariposa,043,17540,1595,1509,66,1575,6
2022-01-01,Mendocino,045,87422,8776,8422,746,9168,101
2022-01-01,Merced,047,269075,45764,44769,2343,47112,694
2022-01-01,Modoc,049,8938,617,601,215,816,6
2022-01-01,Mono,051,14174,2250,2101,30,2131,4
2022-01-01,Monterey,053,433212,53622,50251,4060,54311,643
2022-01-01,Napa,055,140530,15837,14439,277,14716,107
2022-01-01,Nevada,057,99092,10832,10299,402,10701,110
2022-01-01,Orange,059,3164182,372625,339526,23578,363104,5890
2022-01-01,Placer,061,380077,43205,40857,4586,45443,489
2022-01-01,Plumas,063,18699,2068,1994,57,2051,12
2022-01-01,Riverside,065,2383286,421906,397124,19026,416150,5501
2022-01-01,Sacramento,067,1510023,183838,173562,6551,180113,2448
2022-01-01,San Benito,069,59416,8771,8320,213,8533,79
2022-01-01,San Bernardino,071,2135413,413410,386278,13877,400155,6051
2022-01-01,San Diego,073,3302833,474135,427087,28249,455336,4469
2022-01-01,San Francisco,075,870044,73138,64498,3320,67818,682
2022-01-01,San Joaquin,077,732212,111877,106640,6216,112856,1902
2022-01-01,San Luis Obispo,079,281455,34222,32342,1615,33957,365
2022-01-01,San Mateo,081,765935,70367,60504,1774,62278,581
2022-01-01,Santa Barbara,083,443738,52987,49555,1881,51436,568
2022-01-01,Santa Clara,085,1922200,180686,164547,2915,167462,1969
2022-01-01,Santa Cruz,087,273765,24722,22980,1284,24264,228
2022-01-01,Shasta,089,179085,23619,23161,3869,27030,435
2022-01-01,Sierra,091,2930,216,206,21,227,0
2022-01-01,Siskiyou,093,43540,3581,3474,1456,4930,61
2022-01-01,Solano,095,438530,52414,48957,1753,50710,379
2022-01-01,Sonoma,097,501317,49406,46040,806,46846,410
2022-01-01,Stanislaus,099,539301,86185,84367,9911,94278,1332
2022-01-01,Sutter,101,95872,15063,14741,448,15189,193
2022-01-01,Tehama,103,63373,9160,8944,1635,10579,139
2022-01-01,Trinity,105,12862,924,832,230,1062,17
2022-01-01,Tulare,107,460477,74271,71941,17798,89739,1160
2022-01-01,Tuolumne,109,53932,8307,8044,122,8166,91
2022-01-01,Ventura,111,848112,118281,107992,5991,113983,1211
2022-01-01,Yolo,113,214977,23247,21747,1663,23410,270
2022-01-01,Yuba,115,75493,11201,10844,439,11283,99
2021-12-31,Alameda,001,1643700,145540,133486,3879,137365,1528
2021-12-31,Alpine,003,1148,111,113,0,113,0
2021-12-31,Amador,005,37829,6063,5913,89,6002,70
2021-12-31,Butte,007,227075,23356,22469,4170,26639,341
2021-12-31,Calaveras,009,45235,4800,4668,71,4739,93
2021-12-31,Colusa,011,21464,2713,2659,734,3393,21
2021-12-31,Contra Costa,013,1133247,118380,109593,3316,112909,1073
2021-12-31,Del Norte,015,27424,3894,3841,62,3903,43
2021-12-31,El Dorado,017,186661,18594,17621,1955,19576,172
2021-12-31,Fresno,019,978130,155123,149927,14131,164058,2379
2021-12-31,Glenn,021,27897,3734,3663,1091,4754,39
2021-12-31,Humboldt,023,135768,11010,10381,886,11267,119
2021-12-31,Imperial,025,180216,38925,37672,4800,42472,800
2021-12-31,Inyo,027,18085,2899,2726,51,2777,49
2021-12-31,Kern,029,883053,140103,136123,27009,163132,1917
2021-12-31,Kings,031,150075,35281,34318,2175,36493,386
2021-12-31,Lake,033,64148,7204,7060,206,7266,117
2021-12-31,Lassen,035,31185,7154,7089,438,7527,55
2021-12-31,Los Angeles,037,10098052,1741202,1596123,74304,1670427,27371
2021-12-31,Madera,039,155013,25627,25002,2524,27526,320
2021-12-31,Marin,041,260295,22165,20475,956,21431,249
2021-12-31,Mariposa,043,17540,1588,1509,65,1574,6
2021-12-31,Mendocino,045,87422,8743,8422,743,9165,101
2021-12-31,Merced,047,269075,45680,44769,2326,47095,694
2021-12-31,Modoc,049,8938,613,601,213,814,6
2021-12-31,Mono,051,14174,2237,2101,29,2130,4
2021-12-31,Monterey,053,433212,53496,50251,3995,54246,643
2021-12-31,Napa,055,140530,15725,14439,267,14706,107
2021-12-31,Nevada,057,99092,10766,10299,396,10695,110
2021-12-31,Orange,059,3164182,370116,339526,23153,362679,5890
2021-12-31,Placer,061,380077,42968,40857,4520,45377,489
2021-12-31,Plumas,063,18699,2063,1994,57,2051,12
2021-12-31,Riverside,065,2383286,420228,397124,18869,415993,5501
2021-12-31,Sacramento,067,1510023,182980,173562,6448,180010,2448
2021-12-31,San Benito,069,59416,8757,8320,212,8532,79
2021-12-31,San Bernardino,071,2135413,411227,386278,13690,399968,6051
2021-12-31,San Diego,073,3302833,470932,427087,27934,455021,4469
2021-12-31,San Francisco,075,870044,72218,64498,3264,67762,682
2021-12-31,San Joaquin,077,732212,111257,106640,6173,112813,1902
2021-12-31,San Luis Obispo,079,281455,34114,32342,1602,33944,365
2021-12-31,San Mateo,081,765935,69493,60504,1720,62224,581
2021-12-31,Santa Barbara,083,443738,52593,49555,1867,51422,568
2021-12-31,Santa Clara,085,1922200,178743,164547,2773,167320,1969
2021-12-31,Santa Cruz,087,273765,24487,22980,1262,24242,228
2021-12-31,Shasta,089,179085,23555,23161,3848,27009,435
2021-12-31,Sierra,091,2930,216,206,21,227,0
2021-12-31,Siskiyou,093,43540,3574,3474,1445,4919,61
2021-12-31,Solano,095,438530,52256,48957,1727,50684,379
2021-12-31,Sonoma,097,501317,49158,46040,793,46833,410
2021-12-31,Stanislaus,099,539301,85860,84367,9867,94234,1332
2021-12-31,Sutter,101,95872,15002,14741,442,15183,193
2021-12-31,Tehama,103,63373,9128,8944,1626,10570,139
2021-12-31,Trinity,105,12862,923,832,230,1062,17
2021-12-31,Tulare,107,460477,74071,71941,17710,89651,1160
2021-12-31,Tuolumne,109,53932,8263,8044,121,8165,91
2021-12-31,Ventura,111,848112,117308,107992,5909,113901,1211
2021-12-31,Yolo,113,214977,23026,21747,1641,23388,270
2021-12-31,Yuba,115,75493,11144,10844,433,11277,99
2021-12-30,Alameda,001,1643700,144296,133486,3833,137319,1528
2021-12-30,Alpine,003,1148,110,113,0,113,0
2021-12-30,Amador,005,37829,6044,5913,88,6001,70
2021-12-30,Butte,007,227075,23233,22469,4148,26617,341
2021-12-30,Calaveras,009,45235,4781,4668,71,4739,93
2021-12-30,Colusa,011,21464,2712,2659,732,3391,21
2021-12-30,Contra Costa,013,1133247,117288,109593,3204,112797,1073
2021-12-30,Del Norte,015,27424,3883,3841,61,3902,43
2021-12-30,El Dorado,017,186661,18489,17621,1934,19555,172
2021-12-30,Fresno,019,978130,154594,149927,14058,163985,2379
2021-12-30,Glenn,021,27897,3729,3663,1088,4751,39
2021-12-30,Humboldt,023,135768,10941,10381,874,11255,119
2021-12-30,Imperial,025,180216,38757,37672,4686,42358,800
2021-12-30,Inyo,027,18085,2881,2726,49,2775,49
2021-12-30,Kern,029,883053,139571,136123,26707,162830,1917
2021-12-30,Kings,031,150075,35163,34318,2160,36478,386
2021-12-30,Lake,033,64148,7190,7060,201,7261,117
2021-12-30,Lassen,035,31185,7148,7089,438,7527,55
2021-12-30,Los Angeles,037,10098052,1717910,1596123,73044,1669167,27371
2021-12-30,Madera,039,155013,25545,25002,2504,27506,320
2021-12-30,Marin,041,260295,21987,20475,932,21407,249
2021-12-30,Mariposa,043,17540,1582,1509,65,1574,6
2021-12-30,Mendocino,045,87422,8726,8422,732,9154,101
2021-12-30,Merced,047,269075,45578,44769,2312,47081,694
2021-12-30,Modoc,049,8938,612,601,213,814,6
2021-12-30,Mono,051,14174,2233,2101,28,2129,4
2021-12-30,Monterey,053,433212,53186,50251,3934,54185,643
2021-12-30,Napa,055,140530,15581,14439,258,14697,107
2021-12-30,Nevada,057,99092,10704,10299,388,10687,110
2021-12-30,Orange,059,3164182,365028,339526,22596,362122,5890
2021-12-30,Placer,061,380077,42691,40857,4472,45329,489
2021-12-30,Plumas,063,18699,2059,1994,56,2050,12
2021-12-30,Riverside,065,2383286,416959,397124,18713,415837,5501
2021-12-30,Sacramento,067,1510023,181721,173562,6302,179864,2448
2021-12-30,San Benito,069,59416,8712,8320,208,8528,79
2021-12-30,San Bernardino,071,2135413,408731,386278,13541,399819,6051
2021-12-30,San Diego,073,3302833,465773,427087,27429,454516,4469
2021-12-30,San Francisco,075,870044,71130,64498,3191,67689,682
2021-12-30,San Joaquin,077,732212,110664,106640,6136,112776,1902
2021-12-30,San Luis Obispo,079,281455,33994,32342,1588,33930,365
2021-12-30,San Mateo,081,765935,68446,60504,1588,62092,581
2021-12-30,Santa Barbara,083,443738,52113,49555,1847,51402,568
2021-12-30,Santa Clara,085,1922200,176467,164547,2648,167195,1969
2021-12-30,Santa Cruz,087,273765,24249,22980,1227,24207,228
2021-12-30,Shasta,089,179085,23505,23161,3842,27003,435
2021-12-30,Sierra,091,2930,216,206,21,227,0
2021-12-30,Siskiyou,093,43540,3565,3474,1443,4917,61
2021-12-30,Solano,095,438530,51907,48957,1680,50637,379
2021-12-30,Sonoma,097,501317,48826,46040,783,46823,410
2021-12-30,Stanislaus,099,539301,85546,84367,9818,94185,1332
2021-12-30,Sutter,101,95872,14940,14741,441,15182,193
2021-12-30,Tehama,103,63373,9100,8944,1620,10564,139
2021-12-30,Trinity,105,12862,920,832,230,1062,17
2021-12-30,Tulare,107,460477,73891,71941,17628,89569,1160
2021-12-30,Tuolumne,109,53932,8224,8044,120,8164,91
2021-12-30,Ventura,111,848112,116051,107992,5809,113801,1211
2021-12-30,Yolo,113,214977,22888,21747,1615,23362,270
2021-12-30,Yuba,115,75493,11097,10844,431,11275,99
2021-12-29,Alameda,001,1643700,141153,131586,3699,135285,1529
2021-12-29,Alpine,003,1148,110,113,0,113,0
2021-12-29,Amador,005,37829,6021,5905,85,5990,70
2021-12-29,Butte,007,227075,23091,22353,4112,26465,338
2021-12-29,Calaveras,009,45235,4753,4646,69,4715,93
2021-12-29,Colusa,011,21464,2702,2657,727,3384,21
2021-12-29,Contra Costa,013,1133247,115194,108165,3078,111243,1072
2021-12-29,Del Norte,015,27424,3869,3826,59,3885,43
2021-12-29,El Dorado,017,186661,18265,17489,1916,19405,172
2021-12-29,Fresno,019,978130,153462,149318,13946,163264,2364
2021-12-29,Glenn,021,27897,3719,3653,1086,4739,39
2021-12-29,Humboldt,023,135768,10833,10249,852,11101,119
2021-12-29,Imperial,025,180216,38522,37460,4618,42078,800
2021-12-29,Inyo,027,18085,2849,2703,49,2752,49
2021-12-29,Kern,029,883053,138769,135648,26318,161966,1913
2021-12-29,Kings,031,150075,35048,34216,2154,36370,386
2021-12-29,Lake,033,64148,7159,7048,199,7247,117
2021-12-29,Lassen,035,31185,7144,7085,437,7522,55
2021-12-29,Los Angeles,037,10098052,1687973,1576414,71323,1647737,27349
2021-12-29,Madera,039,155013,25441,24923,2493,27416,320
2021-12-29,Marin,041,260295,21631,20025,911,20936,249
2021-12-29,Mariposa,043,17540,1560,1507,65,1572,6
2021-12-29,Mendocino,045,87422,8667,8386,728,9114,99
2021-12-29,Merced,047,269075,45362,44548,2298,46846,693
2021-12-29,Modoc,049,8938,609,600,213,813,6
2021-12-29,Mono,051,14174,2209,2056,27,2083,4
2021-12-29,Monterey,053,433212,52774,50097,3829,53926,641
2021-12-29,Napa,055,140530,15256,14247,239,14486,107
2021-12-29,Nevada,057,99092,10612,10274,387,10661,110
2021-12-29,Orange,059,3164182,357517,334557,21918,356475,5887
2021-12-29,Placer,061,380077,42206,40545,4397,44942,489
2021-12-29,Plumas,063,18699,2047,1990,56,2046,12
2021-12-29,Riverside,065,2383286,411544,392989,18504,411493,5486
2021-12-29,Sacramento,067,1510023,179376,172145,6138,178283,2437
2021-12-29,San Benito,069,59416,8567,8239,207,8446,79
2021-12-29,San Bernardino,071,2135413,403450,382872,13331,396203,6049
2021-12-29,San Diego,073,3302833,454886,421045,26713,447758,4461
2021-12-29,San Francisco,075,870044,69432,63117,3119,66236,684
2021-12-29,San Joaquin,077,732212,109485,106063,6084,112147,1891
2021-12-29,San Luis Obispo,079,281455,33600,31936,1539,33475,365
2021-12-29,San Mateo,081,765935,66833,59478,1478,60956,581
2021-12-29,Santa Barbara,083,443738,51273,49003,1822,50825,568
2021-12-29,Santa Clara,085,1922200,173322,162008,2515,164523,1962
2021-12-29,Santa Cruz,087,273765,23971,22669,1195,23864,228
2021-12-29,Shasta,089,179085,23430,23083,3830,26913,435
2021-12-29,Sierra,091,2930,215,206,21,227,0
2021-12-29,Siskiyou,093,43540,3553,3472,1432,4904,61
2021-12-29,Solano,095,438530,51203,48562,1624,50186,379
2021-12-29,Sonoma,097,501317,48030,45479,759,46238,410
2021-12-29,Stanislaus,099,539301,85065,84083,9766,93849,1332
2021-12-29,Sutter,101,95872,14872,14688,439,15127,193
2021-12-29,Tehama,103,63373,9076,8914,1607,10521,138
2021-12-29,Trinity,105,12862,919,832,230,1062,17
2021-12-29,Tulare,107,460477,73599,71752,17511,89263,1160
2021-12-29,Tuolumne,109,53932,8171,8012,119,8131,91
2021-12-29,Ventura,111,848112,114111,106974,5629,112603,1207
2021-12-29,Yolo,113,214977,22649,21564,1584,23148,270
2021-12-29,Yuba,115,75493,11036,10808,427,11235,99
2021-12-28,Alameda,001,1643700,138065,130427,3590,134017,1522
2021-12-28,Alpine,003,1148,110,113,0,113,0
2021-12-28,Amador,005,37829,6001,5900,84,5984,70
2021-12-28,Butte,007,227075,22950,22285,4095,26380,338
2021-12-28,Calaveras,009,45235,4736,4641,68,4709,91
2021-12-28,Colusa,011,21464,2696,2653,725,3378,21
2021-12-28,Contra Costa,013,1133247,112896,107160,2960,110120,1072
2021-12-28,Del Norte,015,27424,3863,3815,59,3874,43
2021-12-28,El Dorado,017,186661,18040,17419,1905,19324,172
2021-12-28,Fresno,019,978130,152380,148987,13862,162849,2365
2021-12-28,Glenn,021,27897,3693,3639,1082,4721,39
2021-12-28,Humboldt,023,135768,10712,10198,827,11025,119
2021-12-28,Imperial,025,180216,38224,37223,4512,41735,800
2021-12-28,Inyo,027,18085,2791,2676,48,2724,48
2021-12-28,Kern,029,883053,138053,135346,25962,161308,1909
2021-12-28,Kings,031,150075,34912,34165,2139,36304,386
2021-12-28,Lake,033,64148,7140,7044,194,7238,116
2021-12-28,Lassen,035,31185,7136,7083,437,7520,55
2021-12-28,Los Angeles,037,10098052,1655758,1561791,69649,1631440,27323
2021-12-28,Madera,039,155013,25316,24865,2473,27338,320
2021-12-28,Marin,041,260295,21217,19739,880,20619,249
2021-12-28,Mariposa,043,17540,1549,1499,64,1563,6
2021-12-28,Mendocino,045,87422,8607,8366,720,9086,98
2021-12-28,Merced,047,269075,45123,44434,2288,46722,691
2021-12-28,Modoc,049,8938,609,599,212,811,6
2021-12-28,Mono,051,14174,2186,2045,25,2070,4
2021-12-28,Monterey,053,433212,52398,49973,3756,53729,639
2021-12-28,Napa,055,140530,14939,14131,212,14343,107
2021-12-28,Nevada,057,99092,10522,10250,384,10634,110
2021-12-28,Orange,059,3164182,349864,331279,21175,352454,5882
2021-12-28,Placer,061,380077,41735,40410,4327,44737,489
2021-12-28,Plumas,063,18699,2044,1989,56,2045,12
2021-12-28,Riverside,065,2383286,406311,390343,18257,408600,5470
2021-12-28,Sacramento,067,1510023,177091,171290,6007,177297,2426
2021-12-28,San Benito,069,59416,8424,8170,205,8375,79
2021-12-28,San Bernardino,071,2135413,397899,381316,13118,394434,6047
2021-12-28,San Diego,073,3302833,444139,417383,26168,443551,4450
2021-12-28,San Francisco,075,870044,67816,61745,3060,64805,682
2021-12-28,San Joaquin,077,732212,108431,105572,6039,111611,1884
2021-12-28,San Luis Obispo,079,281455,33141,31759,1523,33282,365
2021-12-28,San Mateo,081,765935,65322,58712,1389,60101,582
2021-12-28,Santa Barbara,083,443738,50627,48493,1802,50295,568
2021-12-28,Santa Clara,085,1922200,170185,160811,2419,163230,1962
2021-12-28,Santa Cruz,087,273765,23599,22513,1156,23669,228
2021-12-28,Shasta,089,179085,23358,23035,3825,26860,434
2021-12-28,Sierra,091,2930,212,206,21,227,0
2021-12-28,Siskiyou,093,43540,3544,3468,1427,4895,60
2021-12-28,Solano,095,438530,50286,48318,1570,49888,378
2021-12-28,Sonoma,097,501317,47169,45086,733,45819,410
2021-12-28,Stanislaus,099,539301,84586,83946,9716,93662,1331
2021-12-28,Sutter,101,95872,14822,14662,436,15098,193
2021-12-28,Tehama,103,63373,9059,8893,1605,10498,138
2021-12-28,Trinity,105,12862,917,831,229,1060,17
2021-12-28,Tulare,107,460477,73316,71630,17386,89016,1156
2021-12-28,Tuolumne,109,53932,8128,8006,119,8125,91
2021-12-28,Ventura,111,848112,111999,105883,5498,111381,1207
2021-12-28,Yolo,113,214977,22315,21320,1532,22852,270
2021-12-28,Yuba,115,75493,10981,10778,424,11202,99
2021-12-27,Alameda,001,1643700,135481,129910,3520,133430,1530
2021-12-27,Alpine,003,1148,110,113,0,113,0
2021-12-27,Amador,005,37829,5973,5891,84,5975,70
2021-12-27,Butte,007,227075,22817,22234,4072,26306,335
2021-12-27,Calaveras,009,45235,4712,4630,67,4697,91
2021-12-27,Colusa,011,21464,2685,2652,719,3371,21
2021-12-27,Contra Costa,013,1133247,110731,106692,2879,109571,1071
2021-12-27,Del Norte,015,27424,3854,3802,58,3860,43
2021-12-27,El Dorado,017,186661,17881,17361,1892,19253,172
2021-12-27,Fresno,019,978130,151416,148826,13783,162609,2364
2021-12-27,Glenn,021,27897,3685,3634,1076,4710,39
2021-12-27,Humboldt,023,135768,10597,10164,805,10969,119
2021-12-27,Imperial,025,180216,37982,37180,4412,41592,800
2021-12-27,Inyo,027,18085,2762,2662,46,2708,48
2021-12-27,Kern,029,883053,137405,135119,25659,160778,1907
2021-12-27,Kings,031,150075,34764,34126,2126,36252,382
2021-12-27,Lake,033,64148,7117,7037,184,7221,116
2021-12-27,Lassen,035,31185,7130,7080,437,7517,55
2021-12-27,Los Angeles,037,10098052,1619481,1554074,67883,1621957,27300
2021-12-27,Madera,039,155013,25200,24840,2454,27294,320
2021-12-27,Marin,041,260295,20829,19601,853,20454,249
2021-12-27,Mariposa,043,17540,1534,1495,64,1559,6
2021-12-27,Mendocino,045,87422,8540,8351,715,9066,98
2021-12-27,Merced,047,269075,44892,44383,2271,46654,690
2021-12-27,Modoc,049,8938,607,599,212,811,6
2021-12-27,Mono,051,14174,2123,2026,25,2051,4
2021-12-27,Monterey,053,433212,52095,49918,3704,53622,639
2021-12-27,Napa,055,140530,14670,14083,203,14286,107
2021-12-27,Nevada,057,99092,10453,10239,376,10615,110
2021-12-27,Orange,059,3164182,342413,329222,20368,349590,5875
2021-12-27,Placer,061,380077,41352,40263,4278,44541,489
2021-12-27,Plumas,063,18699,2042,1988,54,2042,12
2021-12-27,Riverside,065,2383286,401735,389096,17998,407094,5470
2021-12-27,Sacramento,067,1510023,175072,170858,5834,176692,2422
2021-12-27,San Benito,069,59416,8307,8133,201,8334,79
2021-12-27,San Bernardino,071,2135413,392196,380526,12920,393446,6047
2021-12-27,San Diego,073,3302833,433937,414968,25681,440649,4445
2021-12-27,San Francisco,075,870044,66077,60920,2995,63915,682
2021-12-27,San Joaquin,077,732212,107514,105413,5978,111391,1876
2021-12-27,San Luis Obispo,079,281455,32698,31671,1501,33172,365
2021-12-27,San Mateo,081,765935,63805,58397,1289,59686,581
2021-12-27,Santa Barbara,083,443738,49844,48209,1781,49990,568
2021-12-27,Santa Clara,085,1922200,167217,159904,2293,162197,1961
2021-12-27,Santa Cruz,087,273765,23310,22456,1138,23594,228
2021-12-27,Shasta,089,179085,23295,23015,3814,26829,432
2021-12-27,Sierra,091,2930,212,206,21,227,0
2021-12-27,Siskiyou,093,43540,3535,3466,1422,4888,60
2021-12-27,Solano,095,438530,49553,48172,1522,49694,378
2021-12-27,Sonoma,097,501317,46593,44990,714,45704,410
2021-12-27,Stanislaus,099,539301,84139,83833,9680,93513,1331
2021-12-27,Sutter,101,95872,14766,14642,431,15073,191
2021-12-27,Tehama,103,63373,9044,8887,1598,10485,136
2021-12-27,Trinity,105,12862,917,827,229,1056,17
2021-12-27,Tulare,107,460477,73051,71562,17289,88851,1146
2021-12-27,Tuolumne,109,53932,8091,7978,118,8096,91
2021-12-27,Ventura,111,848112,109910,105212,5362,110574,1206
2021-12-27,Yolo,113,214977,22020,21300,1497,22797,270
2021-12-27,Yuba,115,75493,10920,10759,423,11182,98
2021-12-26,Alameda,001,1643700,133452,127221,3453,130674,1525
2021-12-26,Alpine,003,1148,110,113,0,113,0
2021-12-26,Amador,005,37829,5957,5861,82,5943,70
2021-12-26,Butte,007,227075,22662,22087,4049,26136,330
2021-12-26,Calaveras,009,45235,4690,4591,67,4658,91
2021-12-26,Colusa,011,21464,2675,2647,713,3360,21
2021-12-26,Contra Costa,013,1133247,108970,105022,2780,107802,1071
2021-12-26,Del Norte,015,27424,3849,3795,58,3853,43
2021-12-26,El Dorado,017,186661,17725,17188,1883,19071,172
2021-12-26,Fresno,019,978130,150708,148027,13705,161732,2358
2021-12-26,Glenn,021,27897,3677,3611,1065,4676,39
2021-12-26,Humboldt,023,135768,10453,10052,782,10834,119
2021-12-26,Imperial,025,180216,37676,36878,4319,41197,800
2021-12-26,Inyo,027,18085,2738,2636,43,2679,47
2021-12-26,Kern,029,883053,136686,134591,25403,159994,1908
2021-12-26,Kings,031,150075,34612,34009,2120,36129,379
2021-12-26,Lake,033,64148,7095,7019,181,7200,116
2021-12-26,Lassen,035,31185,7124,7072,436,7508,55
2021-12-26,Los Angeles,037,10098052,1589651,1515469,66072,1581541,27257
2021-12-26,Madera,039,155013,25082,24741,2438,27179,320
2021-12-26,Marin,041,260295,20448,19085,792,19877,249
2021-12-26,Mariposa,043,17540,1528,1480,64,1544,6
2021-12-26,Mendocino,045,87422,8489,8314,713,9027,98
2021-12-26,Merced,047,269075,44641,44208,2260,46468,690
2021-12-26,Modoc,049,8938,606,597,210,807,6
2021-12-26,Mono,051,14174,2097,2000,25,2025,4
2021-12-26,Monterey,053,433212,51816,49709,3656,53365,638
2021-12-26,Napa,055,140530,14434,13809,198,14007,107
2021-12-26,Nevada,057,99092,10393,10153,369,10522,110
2021-12-26,Orange,059,3164182,336096,322991,19564,342555,5863
2021-12-26,Placer,061,380077,41006,39852,4207,44059,489
2021-12-26,Plumas,063,18699,2034,1987,53,2040,12
2021-12-26,Riverside,065,2383286,397568,384567,17828,402395,5470
2021-12-26,Sacramento,067,1510023,173349,169144,5685,174829,2418
2021-12-26,San Benito,069,59416,8218,7991,197,8188,79
2021-12-26,San Bernardino,071,2135413,387611,376052,12745,388797,6043
2021-12-26,San Diego,073,3302833,424974,406616,25196,431812,4442
2021-12-26,San Francisco,075,870044,64508,58229,2933,61162,682
2021-12-26,San Joaquin,077,732212,106699,104590,5927,110517,1872
2021-12-26,San Luis Obispo,079,281455,32259,31290,1483,32773,365
2021-12-26,San Mateo,081,765935,62403,56973,1241,58214,581
2021-12-26,Santa Barbara,083,443738,49169,47553,1751,49304,567
2021-12-26,Santa Clara,085,1922200,164523,156872,2160,159032,1967
2021-12-26,Santa Cruz,087,273765,23026,22176,1124,23300,228
2021-12-26,Shasta,089,179085,23212,22959,3802,26761,432
2021-12-26,Sierra,091,2930,212,202,21,223,0
2021-12-26,Siskiyou,093,43540,3527,3460,1413,4873,60
2021-12-26,Solano,095,438530,49050,47646,1484,49130,377
2021-12-26,Sonoma,097,501317,46097,44358,681,45039,408
2021-12-26,Stanislaus,099,539301,83768,83368,9644,93012,1331
2021-12-26,Sutter,101,95872,14702,14533,428,14961,191
2021-12-26,Tehama,103,63373,9011,8861,1595,10456,136
2021-12-26,Trinity,105,12862,917,826,228,1054,17
2021-12-26,Tulare,107,460477,72803,71292,17178,88470,1137
2021-12-26,Tuolumne,109,53932,8054,7919,118,8037,91
2021-12-26,Ventura,111,848112,108077,103498,5212,108710,1206
2021-12-26,Yolo,113,214977,21738,21084,1457,22541,270
2021-12-26,Yuba,115,75493,10869,10694,421,11115,98
2021-12-25,Alameda,001,1643700,132399,127221,3391,130612,1525
2021-12-25,Alpine,003,1148,110,113,0,113,0
2021-12-25,Amador,005,37829,5938,5861,82,5943,70
2021-12-25,Butte,007,227075,22566,22087,4033,26120,330
2021-12-25,Calaveras,009,45235,4661,4591,66,4657,91
2021-12-25,Colusa,011,21464,2670,2647,707,3354,21
2021-12-25,Contra Costa,013,1133247,108148,105022,2727,107749,1071
2021-12-25,Del Norte,015,27424,3842,3795,57,3852,43
2021-12-25,El Dorado,017,186661,17672,17188,1872,19060,172
2021-12-25,Fresno,019,978130,150397,148027,13658,161685,2358
2021-12-25,Glenn,021,27897,3667,3611,1060,4671,39
2021-12-25,Humboldt,023,135768,10375,10052,775,10827,119
2021-12-25,Imperial,025,180216,37557,36878,4296,41174,800
2021-12-25,Inyo,027,18085,2718,2636,43,2679,47
2021-12-25,Kern,029,883053,136339,134591,25278,159869,1908
2021-12-25,Kings,031,150075,34523,34009,2113,36122,379
2021-12-25,Lake,033,64148,7083,7019,179,7198,116
2021-12-25,Lassen,035,31185,7122,7072,436,7508,55
2021-12-25,Los Angeles,037,10098052,1576867,1515469,64737,1580206,27257
2021-12-25,Madera,039,155013,25034,24741,2432,27173,320
2021-12-25,Marin,041,260295,20108,19085,743,19828,249
2021-12-25,Mariposa,043,17540,1522,1480,64,1544,6
2021-12-25,Mendocino,045,87422,8451,8314,713,9027,98
2021-12-25,Merced,047,269075,44541,44208,2258,46466,690
2021-12-25,Modoc,049,8938,606,597,210,807,6
2021-12-25,Mono,051,14174,2080,2000,25,2025,4
2021-12-25,Monterey,053,433212,51648,49709,3621,53330,638
2021-12-25,Napa,055,140530,14319,13809,190,13999,107
2021-12-25,Nevada,057,99092,10364,10153,369,10522,110
2021-12-25,Orange,059,3164182,333237,322991,18989,341980,5863
2021-12-25,Placer,061,380077,40826,39852,4171,44023,489
2021-12-25,Plumas,063,18699,2032,1987,53,2040,12
2021-12-25,Riverside,065,2383286,395289,384567,17708,402275,5470
2021-12-25,Sacramento,067,1510023,172534,169144,5577,174721,2418
2021-12-25,San Benito,069,59416,8153,7991,197,8188,79
2021-12-25,San Bernardino,071,2135413,385463,376052,12607,388659,6043
2021-12-25,San Diego,073,3302833,420923,406616,24926,431542,4442
2021-12-25,San Francisco,075,870044,63486,58229,2897,61126,682
2021-12-25,San Joaquin,077,732212,106364,104590,5895,110485,1872
2021-12-25,San Luis Obispo,079,281455,32104,31290,1474,32764,365
2021-12-25,San Mateo,081,765935,61372,56973,1198,58171,581
2021-12-25,Santa Barbara,083,443738,48806,47553,1739,49292,567
2021-12-25,Santa Clara,085,1922200,163040,156872,2093,158965,1967
2021-12-25,Santa Cruz,087,273765,22867,22176,1118,23294,228
2021-12-25,Shasta,089,179085,23182,22959,3796,26755,432
2021-12-25,Sierra,091,2930,212,202,21,223,0
2021-12-25,Siskiyou,093,43540,3524,3460,1407,4867,60
2021-12-25,Solano,095,438530,48928,47646,1466,49112,377
2021-12-25,Sonoma,097,501317,45712,44358,655,45013,408
2021-12-25,Stanislaus,099,539301,83555,83368,9623,92991,1331
2021-12-25,Sutter,101,95872,14661,14533,426,14959,191
2021-12-25,Tehama,103,63373,8991,8861,1591,10452,136
2021-12-25,Trinity,105,12862,916,826,228,1054,17
2021-12-25,Tulare,107,460477,72667,71292,17098,88390,1137
2021-12-25,Tuolumne,109,53932,8023,7919,118,8037,91
2021-12-25,Ventura,111,848112,106907,103498,5103,108601,1206
2021-12-25,Yolo,113,214977,21626,21084,1435,22519,270
2021-12-25,Yuba,115,75493,10843,10694,420,11114,98
2021-12-24,Alameda,001,1643700,131789,127221,3373,130594,1525
2021-12-24,Alpine,003,1148,110,113,0,113,0
2021-12-24,Amador,005,37829,5930,5861,81,5942,70
2021-12-24,Butte,007,227075,22511,22087,4020,26107,330
2021-12-24,Calaveras,009,45235,4655,4591,66,4657,91
2021-12-24,Colusa,011,21464,2668,2647,706,3353,21
2021-12-24,Contra Costa,013,1133247,107830,105022,2695,107717,1071
2021-12-24,Del Norte,015,27424,3835,3795,57,3852,43
2021-12-24,El Dorado,017,186661,17620,17188,1867,19055,172
2021-12-24,Fresno,019,978130,150232,148027,13645,161672,2358
2021-12-24,Glenn,021,27897,3666,3611,1060,4671,39
2021-12-24,Humboldt,023,135768,10319,10052,769,10821,119
2021-12-24,Imperial,025,180216,37474,36878,4292,41170,800
2021-12-24,Inyo,027,18085,2698,2636,43,2679,47
2021-12-24,Kern,029,883053,136216,134591,25236,159827,1908
2021-12-24,Kings,031,150075,34457,34009,2112,36121,379
2021-12-24,Lake,033,64148,7079,7019,179,7198,116
2021-12-24,Lassen,035,31185,7119,7072,436,7508,55
2021-12-24,Los Angeles,037,10098052,1572028,1515469,64207,1579676,27257
2021-12-24,Madera,039,155013,25001,24741,2427,27168,320
2021-12-24,Marin,041,260295,19964,19085,712,19797,249
2021-12-24,Mariposa,043,17540,1520,1480,64,1544,6
2021-12-24,Mendocino,045,87422,8434,8314,713,9027,98
2021-12-24,Merced,047,269075,44491,44208,2256,46464,690
2021-12-24,Modoc,049,8938,606,597,210,807,6
2021-12-24,Mono,051,14174,2067,2000,25,2025,4
2021-12-24,Monterey,053,433212,51550,49709,3596,53305,638
2021-12-24,Napa,055,140530,14253,13809,186,13995,107
2021-12-24,Nevada,057,99092,10337,10153,367,10520,110
2021-12-24,Orange,059,3164182,332190,322991,18830,341821,5863
2021-12-24,Placer,061,380077,40708,39852,4155,44007,489
2021-12-24,Plumas,063,18699,2031,1987,53,2040,12
2021-12-24,Riverside,065,2383286,394301,384567,17618,402185,5470
2021-12-24,Sacramento,067,1510023,172224,169144,5541,174685,2418
2021-12-24,San Benito,069,59416,8144,7991,196,8187,79
2021-12-24,San Bernardino,071,2135413,384373,376052,12538,388590,6043
2021-12-24,San Diego,073,3302833,419821,406616,24798,431414,4442
2021-12-24,San Francisco,075,870044,62977,58229,2879,61108,682
2021-12-24,San Joaquin,077,732212,106171,104590,5888,110478,1872
2021-12-24,San Luis Obispo,079,281455,32042,31290,1464,32754,365
2021-12-24,San Mateo,081,765935,60940,56973,1175,58148,581
2021-12-24,Santa Barbara,083,443738,48601,47553,1732,49285,567
2021-12-24,Santa Clara,085,1922200,162219,156872,2059,158931,1967
2021-12-24,Santa Cruz,087,273765,22784,22176,1115,23291,228
2021-12-24,Shasta,089,179085,23150,22959,3792,26751,432
2021-12-24,Sierra,091,2930,211,202,21,223,0
2021-12-24,Siskiyou,093,43540,3519,3460,1403,4863,60
2021-12-24,Solano,095,438530,48876,47646,1464,49110,377
2021-12-24,Sonoma,097,501317,45548,44358,647,45005,408
2021-12-24,Stanislaus,099,539301,83443,83368,9610,92978,1331
2021-12-24,Sutter,101,95872,14641,14533,423,14956,191
2021-12-24,Tehama,103,63373,8982,8861,1588,10449,136
2021-12-24,Trinity,105,12862,914,826,228,1054,17
2021-12-24,Tulare,107,460477,72601,71292,17054,88346,1137
2021-12-24,Tuolumne,109,53932,7998,7919,118,8037,91
2021-12-24,Ventura,111,848112,106459,103498,5047,108545,1206
2021-12-24,Yolo,113,214977,21553,21084,1417,22501,270
2021-12-24,Yuba,115,75493,10820,10694,419,11113,98
2021-12-23,Alameda,001,1643700,131097,127221,3339,130560,1525
2021-12-23,Alpine,003,1148,110,113,0,113,0
2021-12-23,Amador,005,37829,5918,5861,79,5940,70
2021-12-23,Butte,007,227075,22461,22087,4008,26095,330
2021-12-23,Calaveras,009,45235,4644,4591,66,4657,91
2021-12-23,Colusa,011,21464,2662,2647,702,3349,21
2021-12-23,Contra Costa,013,1133247,107402,105022,2650,107672,1071
2021-12-23,Del Norte,015,27424,3832,3795,57,3852,43
2021-12-23,El Dorado,017,186661,17558,17188,1861,19049,172
2021-12-23,Fresno,019,978130,150027,148027,13624,161651,2358
2021-12-23,Glenn,021,27897,3662,3611,1060,4671,39
2021-12-23,Humboldt,023,135768,10266,10052,766,10818,119
2021-12-23,Imperial,025,180216,37401,36878,4263,41141,800
2021-12-23,Inyo,027,18085,2685,2636,43,2679,47
2021-12-23,Kern,029,883053,136065,134591,25138,159729,1908
2021-12-23,Kings,031,150075,34416,34009,2111,36120,379
2021-12-23,Lake,033,64148,7067,7019,177,7196,116
2021-12-23,Lassen,035,31185,7118,7072,436,7508,55
2021-12-23,Los Angeles,037,10098052,1562518,1515469,63100,1578569,27257
2021-12-23,Madera,039,155013,24969,24741,2422,27163,320
2021-12-23,Marin,041,260295,19830,19085,695,19780,249
2021-12-23,Mariposa,043,17540,1515,1480,64,1544,6
2021-12-23,Mendocino,045,87422,8425,8314,713,9027,98
2021-12-23,Merced,047,269075,44442,44208,2254,46462,690
2021-12-23,Modoc,049,8938,606,597,210,807,6
2021-12-23,Mono,051,14174,2046,2000,24,2024,4
2021-12-23,Monterey,053,433212,51432,49709,3575,53284,638
2021-12-23,Napa,055,140530,14172,13809,181,13990,107
2021-12-23,Nevada,057,99092,10314,10153,366,10519,110
2021-12-23,Orange,059,3164182,330513,322991,18497,341488,5863
2021-12-23,Placer,061,380077,40584,39852,4139,43991,489
2021-12-23,Plumas,063,18699,2031,1987,53,2040,12
2021-12-23,Riverside,065,2383286,393096,384567,17548,402115,5470
2021-12-23,Sacramento,067,1510023,171769,169144,5493,174637,2418
2021-12-23,San Benito,069,59416,8125,7991,194,8185,79
2021-12-23,San Bernardino,071,2135413,383232,376052,12434,388486,6043
2021-12-23,San Diego,073,3302833,417988,406616,24598,431214,4442
2021-12-23,San Francisco,075,870044,62251,58229,2851,61080,682
2021-12-23,San Joaquin,077,732212,105953,104590,5875,110465,1872
2021-12-23,San Luis Obispo,079,281455,31970,31290,1460,32750,365
2021-12-23,San Mateo,081,765935,60379,56973,1154,58127,581
2021-12-23,Santa Barbara,083,443738,48402,47553,1730,49283,567
2021-12-23,Santa Clara,085,1922200,161312,156872,2000,158872,1967
2021-12-23,Santa Cruz,087,273765,22668,22176,1103,23279,228
2021-12-23,Shasta,089,179085,23121,22959,3789,26748,432
2021-12-23,Sierra,091,2930,208,202,21,223,0
2021-12-23,Siskiyou,093,43540,3519,3460,1401,4861,60
2021-12-23,Solano,095,438530,48771,47646,1448,49094,377
2021-12-23,Sonoma,097,501317,45371,44358,644,45002,408
2021-12-23,Stanislaus,099,539301,83315,83368,9596,92964,1331
2021-12-23,Sutter,101,95872,14623,14533,422,14955,191
2021-12-23,Tehama,103,63373,8970,8861,1584,10445,136
2021-12-23,Trinity,105,12862,914,826,228,1054,17
2021-12-23,Tulare,107,460477,72525,71292,17009,88301,1137
2021-12-23,Tuolumne,109,53932,7980,7919,117,8036,91
2021-12-23,Ventura,111,848112,105924,103498,4980,108478,1206
2021-12-23,Yolo,113,214977,21481,21084,1399,22483,270
2021-12-23,Yuba,115,75493,10807,10694,419,11113,98
2021-12-22,Alameda,001,1643700,130180,126533,3269,129802,1522
2021-12-22,Alpine,003,1148,110,112,0,112,0
2021-12-22,Amador,005,37829,5905,5850,78,5928,70
2021-12-22,Butte,007,227075,22411,22070,3997,26067,330
2021-12-22,Calaveras,009,45235,4635,4580,66,4646,91
2021-12-22,Colusa,011,21464,2662,2645,699,3344,21
2021-12-22,Contra Costa,013,1133247,106763,104559,2607,107166,1070
2021-12-22,Del Norte,015,27424,3832,3794,57,3851,43
2021-12-22,El Dorado,017,186661,17497,17140,1852,18992,172
2021-12-22,Fresno,019,978130,149745,147838,13590,161428,2349
2021-12-22,Glenn,021,27897,3657,3604,1060,4664,39
2021-12-22,Humboldt,023,135768,10206,10022,761,10783,119
2021-12-22,Imperial,025,180216,37315,36755,4226,40981,798
2021-12-22,Inyo,027,18085,2667,2632,43,2675,47
2021-12-22,Kern,029,883053,135830,134433,25053,159486,1900
2021-12-22,Kings,031,150075,34366,33953,2104,36057,376
2021-12-22,Lake,033,64148,7060,7008,175,7183,116
2021-12-22,Lassen,035,31185,7113,7069,435,7504,55
2021-12-22,Los Angeles,037,10098052,1549009,1507110,61923,1569033,27234
2021-12-22,Madera,039,155013,24930,24702,2418,27120,320
2021-12-22,Marin,041,260295,19609,18927,672,19599,249
2021-12-22,Mariposa,043,17540,1508,1480,64,1544,6
2021-12-22,Mendocino,045,87422,8416,8299,713,9012,99
2021-12-22,Merced,047,269075,44371,44137,2252,46389,689
2021-12-22,Modoc,049,8938,606,595,210,805,6
2021-12-22,Mono,051,14174,2042,1979,24,2003,4
2021-12-22,Monterey,053,433212,51274,49650,3558,53208,639
2021-12-22,Napa,055,140530,14044,13746,171,13917,107
2021-12-22,Nevada,057,99092,10287,10101,361,10462,110
2021-12-22,Orange,059,3164182,328236,321765,18064,339829,5858
2021-12-22,Placer,061,380077,40402,39758,4102,43860,489
2021-12-22,Plumas,063,18699,2027,1986,53,2039,12
2021-12-22,Riverside,065,2383286,391283,383319,17433,400752,5472
2021-12-22,Sacramento,067,1510023,171112,168695,5424,174119,2422
2021-12-22,San Benito,069,59416,8073,7971,192,8163,79
2021-12-22,San Bernardino,071,2135413,381603,375044,12350,387394,6039
2021-12-22,San Diego,073,3302833,413881,404269,24270,428539,4434
2021-12-22,San Francisco,075,870044,61264,57520,2806,60326,682
2021-12-22,San Joaquin,077,732212,105683,104385,5861,110246,1870
2021-12-22,San Luis Obispo,079,281455,31829,31175,1440,32615,365
2021-12-22,San Mateo,081,765935,59696,56604,1125,57729,581
2021-12-22,Santa Barbara,083,443738,48146,47372,1714,49086,566
2021-12-22,Santa Clara,085,1922200,160195,156258,1957,158215,1954
2021-12-22,Santa Cruz,087,273765,22562,22075,1097,23172,228
2021-12-22,Shasta,089,179085,23093,22937,3784,26721,432
2021-12-22,Sierra,091,2930,208,202,21,223,0
2021-12-22,Siskiyou,093,43540,3516,3458,1398,4856,59
2021-12-22,Solano,095,438530,48542,47531,1434,48965,375
2021-12-22,Sonoma,097,501317,45095,44201,633,44834,408
2021-12-22,Stanislaus,099,539301,83172,83245,9581,92826,1331
2021-12-22,Sutter,101,95872,14588,14513,419,14932,191
2021-12-22,Tehama,103,63373,8957,8853,1581,10434,136
2021-12-22,Trinity,105,12862,914,826,228,1054,17
2021-12-22,Tulare,107,460477,72424,71226,16956,88182,1137
2021-12-22,Tuolumne,109,53932,7959,7903,117,8020,91
2021-12-22,Ventura,111,848112,105318,103089,4873,107962,1206
2021-12-22,Yolo,113,214977,21405,21012,1384,22396,270
2021-12-22,Yuba,115,75493,10790,10681,419,11100,98
2021-12-21,Alameda,001,1643700,129197,126007,3229,129236,1518
2021-12-21,Alpine,003,1148,110,112,0,112,0
2021-12-21,Amador,005,37829,5895,5845,78,5923,70
2021-12-21,Butte,007,227075,22349,22041,3984,26025,330
2021-12-21,Calaveras,009,45235,4622,4575,66,4641,91
2021-12-21,Colusa,011,21464,2660,2643,698,3341,21
2021-12-21,Contra Costa,013,1133247,106131,104255,2541,106796,1068
2021-12-21,Del Norte,015,27424,3831,3793,57,3850,43
2021-12-21,El Dorado,017,186661,17434,17098,1840,18938,172
2021-12-21,Fresno,019,978130,149459,147707,13555,161262,2341
2021-12-21,Glenn,021,27897,3643,3602,1060,4662,39
2021-12-21,Humboldt,023,135768,10141,9989,756,10745,118
2021-12-21,Imperial,025,180216,37217,36580,4184,40764,792
2021-12-21,Inyo,027,18085,2655,2627,43,2670,47
2021-12-21,Kern,029,883053,135622,134321,24947,159268,1892
2021-12-21,Kings,031,150075,34306,33914,2103,36017,376
2021-12-21,Lake,033,64148,7055,7004,173,7177,116
2021-12-21,Lassen,035,31185,7111,7069,435,7504,55
2021-12-21,Los Angeles,037,10098052,1535127,1501169,60885,1562054,27220
2021-12-21,Madera,039,155013,24894,24688,2411,27099,320
2021-12-21,Marin,041,260295,19439,18828,637,19465,249
2021-12-21,Mariposa,043,17540,1507,1480,63,1543,6
2021-12-21,Mendocino,045,87422,8400,8282,711,8993,97
2021-12-21,Merced,047,269075,44299,44096,2249,46345,688
2021-12-21,Modoc,049,8938,604,595,208,803,6
2021-12-21,Mono,051,14174,2022,1979,24,2003,4
2021-12-21,Monterey,053,433212,51183,49586,3541,53127,638
2021-12-21,Napa,055,140530,13943,13703,160,13863,107
2021-12-21,Nevada,057,99092,10258,10095,361,10456,110
2021-12-21,Orange,059,3164182,326120,320705,17610,338315,5855
2021-12-21,Placer,061,380077,40262,39649,4073,43722,487
2021-12-21,Plumas,063,18699,2027,1975,53,2028,12
2021-12-21,Riverside,065,2383286,389563,382415,17313,399728,5465
2021-12-21,Sacramento,067,1510023,170461,168422,5368,173790,2419
2021-12-21,San Benito,069,59416,8034,7950,190,8140,79
2021-12-21,San Bernardino,071,2135413,380007,374219,12242,386461,6026
2021-12-21,San Diego,073,3302833,410161,402386,23934,426320,4424
2021-12-21,San Francisco,075,870044,60315,56950,2772,59722,681
2021-12-21,San Joaquin,077,732212,105396,104238,5842,110080,1870
2021-12-21,San Luis Obispo,079,281455,31665,31103,1428,32531,365
2021-12-21,San Mateo,081,765935,59080,56381,1101,57482,581
2021-12-21,Santa Barbara,083,443738,47916,47194,1699,48893,564
2021-12-21,Santa Clara,085,1922200,159173,155769,1914,157683,1951
2021-12-21,Santa Cruz,087,273765,22445,22028,1086,23114,228
2021-12-21,Shasta,089,179085,23063,22920,3780,26700,429
2021-12-21,Sierra,091,2930,206,201,21,222,0
2021-12-21,Siskiyou,093,43540,3515,3455,1398,4853,59
2021-12-21,Solano,095,438530,48387,47474,1427,48901,372
2021-12-21,Sonoma,097,501317,44872,44051,623,44674,408
2021-12-21,Stanislaus,099,539301,83017,83167,9555,92722,1331
2021-12-21,Sutter,101,95872,14565,14492,418,14910,190
2021-12-21,Tehama,103,63373,8949,8849,1576,10425,136
2021-12-21,Trinity,105,12862,913,826,228,1054,17
2021-12-21,Tulare,107,460477,72332,71166,16914,88080,1137
2021-12-21,Tuolumne,109,53932,7935,7893,117,8010,91
2021-12-21,Ventura,111,848112,104701,102631,4760,107391,1205
2021-12-21,Yolo,113,214977,21296,20944,1380,22324,267
2021-12-21,Yuba,115,75493,10773,10668,419,11087,98
2021-12-20,Alameda,001,1643700,128276,125762,3165,128927,1515
2021-12-20,Alpine,003,1148,110,112,0,112,0
2021-12-20,Amador,005,37829,5881,5838,78,5916,70
2021-12-20,Butte,007,227075,22288,22030,3975,26005,329
2021-12-20,Calaveras,009,45235,4612,4569,66,4635,91
2021-12-20,Colusa,011,21464,2658,2644,698,3342,21
2021-12-20,Contra Costa,013,1133247,105594,104051,2494,106545,1068
2021-12-20,Del Norte,015,27424,3829,3792,57,3849,43
2021-12-20,El Dorado,017,186661,17372,17083,1831,18914,172
2021-12-20,Fresno,019,978130,149216,147605,13527,161132,2341
2021-12-20,Glenn,021,27897,3637,3597,1060,4657,39
2021-12-20,Humboldt,023,135768,10098,9973,752,10725,118
2021-12-20,Imperial,025,180216,37100,36532,4154,40686,792
2021-12-20,Inyo,027,18085,2652,2615,43,2658,47
2021-12-20,Kern,029,883053,135425,134203,24887,159090,1883
2021-12-20,Kings,031,150075,34264,33898,2102,36000,376
2021-12-20,Lake,033,64148,7050,6999,173,7172,116
2021-12-20,Lassen,035,31185,7109,7065,434,7499,55
2021-12-20,Los Angeles,037,10098052,1523660,1495251,60149,1555400,27188
2021-12-20,Madera,039,155013,24865,24668,2407,27075,313
2021-12-20,Marin,041,260295,19225,18747,619,19366,249
2021-12-20,Mariposa,043,17540,1498,1479,63,1542,6
2021-12-20,Mendocino,045,87422,8388,8264,709,8973,96
2021-12-20,Merced,047,269075,44242,44071,2244,46315,687
2021-12-20,Modoc,049,8938,604,595,205,800,6
2021-12-20,Mono,051,14174,2000,1973,24,1997,4
2021-12-20,Monterey,053,433212,51086,49556,3521,53077,636
2021-12-20,Napa,055,140530,13859,13672,150,13822,107
2021-12-20,Nevada,057,99092,10218,10079,360,10439,109
2021-12-20,Orange,059,3164182,324524,320235,17289,337524,5852
2021-12-20,Placer,061,380077,40134,39579,4043,43622,485
2021-12-20,Plumas,063,18699,2024,1971,51,2022,12
2021-12-20,Riverside,065,2383286,388123,381841,17223,399064,5452
2021-12-20,Sacramento,067,1510023,169890,168153,5325,173478,2414
2021-12-20,San Benito,069,59416,7990,7934,188,8122,79
2021-12-20,San Bernardino,071,2135413,378543,373881,12158,386039,6023
2021-12-20,San Diego,073,3302833,406926,401483,23692,425175,4412
2021-12-20,San Francisco,075,870044,59256,56661,2711,59372,681
2021-12-20,San Joaquin,077,732212,105154,104188,5833,110021,1865
2021-12-20,San Luis Obispo,079,281455,31552,31075,1420,32495,365
2021-12-20,San Mateo,081,765935,58533,56247,1082,57329,581
2021-12-20,Santa Barbara,083,443738,47707,47131,1694,48825,562
2021-12-20,Santa Clara,085,1922200,158214,155427,1865,157292,1950
2021-12-20,Santa Cruz,087,273765,22364,21989,1081,23070,227
2021-12-20,Shasta,089,179085,23043,22888,3775,26663,429
2021-12-20,Sierra,091,2930,205,201,21,222,0
2021-12-20,Siskiyou,093,43540,3514,3453,1396,4849,59
2021-12-20,Solano,095,438530,48258,47394,1419,48813,370
2021-12-20,Sonoma,097,501317,44682,43982,615,44597,408
2021-12-20,Stanislaus,099,539301,82893,83110,9528,92638,1331
2021-12-20,Sutter,101,95872,14542,14480,418,14898,190
2021-12-20,Tehama,103,63373,8941,8840,1573,10413,136
2021-12-20,Trinity,105,12862,913,826,228,1054,17
2021-12-20,Tulare,107,460477,72238,71124,16854,87978,1129
2021-12-20,Tuolumne,109,53932,7921,7867,113,7980,91
2021-12-20,Ventura,111,848112,104194,102452,4682,107134,1203
2021-12-20,Yolo,113,214977,21203,20903,1368,22271,267
2021-12-20,Yuba,115,75493,10757,10656,416,11072,97
2021-12-19,Alameda,001,1643700,127398,125464,3123,128587,1519
2021-12-19,Alpine,003,1148,110,112,0,112,0
2021-12-19,Amador,005,37829,5869,5832,77,5909,70
2021-12-19,Butte,007,227075,22236,22022,3969,25991,329
2021-12-19,Calaveras,009,45235,4596,4563,65,4628,91
2021-12-19,Colusa,011,21464,2658,2643,695,3338,21
2021-12-19,Contra Costa,013,1133247,105103,103906,2459,106365,1068
2021-12-19,Del Norte,015,27424,3825,3797,57,3854,43
2021-12-19,El Dorado,017,186661,17316,17067,1829,18896,172
2021-12-19,Fresno,019,978130,148975,147505,13501,161006,2341
2021-12-19,Glenn,021,27897,3633,3596,1059,4655,39
2021-12-19,Humboldt,023,135768,10057,9957,747,10704,118
2021-12-19,Imperial,025,180216,36971,36501,4110,40611,792
2021-12-19,Inyo,027,18085,2643,2613,43,2656,47
2021-12-19,Kern,029,883053,135228,134136,24816,158952,1883
2021-12-19,Kings,031,150075,34204,33874,2098,35972,378
2021-12-19,Lake,033,64148,7041,6999,170,7169,116
2021-12-19,Lassen,035,31185,7105,7065,434,7499,55
2021-12-19,Los Angeles,037,10098052,1514702,1495082,59536,1554618,27189
2021-12-19,Madera,039,155013,24840,24642,2401,27043,313
2021-12-19,Marin,041,260295,19049,18707,596,19303,249
2021-12-19,Mariposa,043,17540,1492,1475,63,1538,6
2021-12-19,Mendocino,045,87422,8371,8257,706,8963,96
2021-12-19,Merced,047,269075,44147,44045,2237,46282,687
2021-12-19,Modoc,049,8938,603,595,205,800,6
2021-12-19,Mono,051,14174,1989,1968,23,1991,4
2021-12-19,Monterey,053,433212,50984,49516,3499,53015,636
2021-12-19,Napa,055,140530,13786,13659,141,13800,107
2021-12-19,Nevada,057,99092,10182,10057,357,10414,109
2021-12-19,Orange,059,3164182,323137,319615,17060,336675,5852
2021-12-19,Placer,061,380077,40015,39525,4026,43551,485
2021-12-19,Plumas,063,18699,2021,1971,51,2022,12
2021-12-19,Riverside,065,2383286,386696,381305,17147,398452,5452
2021-12-19,Sacramento,067,1510023,169393,167933,5296,173229,2415
2021-12-19,San Benito,069,59416,7964,7929,187,8116,79
2021-12-19,San Bernardino,071,2135413,377263,373480,12117,385597,6023
2021-12-19,San Diego,073,3302833,404420,398197,23495,421692,4406
2021-12-19,San Francisco,075,870044,58386,56358,2655,59013,681
2021-12-19,San Joaquin,077,732212,104896,104125,5819,109944,1865
2021-12-19,San Luis Obispo,079,281455,31429,31035,1408,32443,366
2021-12-19,San Mateo,081,765935,58067,56132,1067,57199,581
2021-12-19,Santa Barbara,083,443738,47484,47070,1687,48757,562
2021-12-19,Santa Clara,085,1922200,157326,155049,1837,156886,1950
2021-12-19,Santa Cruz,087,273765,22265,21960,1076,23036,227
2021-12-19,Shasta,089,179085,23007,22875,3771,26646,429
2021-12-19,Sierra,091,2930,204,201,21,222,0
2021-12-19,Siskiyou,093,43540,3511,3452,1396,4848,59
2021-12-19,Solano,095,438530,48139,47341,1413,48754,370
2021-12-19,Sonoma,097,501317,44498,43944,613,44557,408
2021-12-19,Stanislaus,099,539301,82755,83040,9497,92537,1331
2021-12-19,Sutter,101,95872,14502,14475,417,14892,190
2021-12-19,Tehama,103,63373,8933,8840,1573,10413,136
2021-12-19,Trinity,105,12862,913,826,228,1054,17
2021-12-19,Tulare,107,460477,72144,71085,16812,87897,1129
2021-12-19,Tuolumne,109,53932,7904,7865,112,7977,91
2021-12-19,Ventura,111,848112,103614,102170,4617,106787,1203
2021-12-19,Yolo,113,214977,21124,20887,1348,22235,267
2021-12-19,Yuba,115,75493,10740,10646,414,11060,97
2021-12-18,Alameda,001,1643700,126994,124583,3098,127681,1512
2021-12-18,Alpine,003,1148,110,110,0,110,0
2021-12-18,Amador,005,37829,5863,5821,77,5898,69
2021-12-18,Butte,007,227075,22219,21956,3964,25920,328
2021-12-18,Calaveras,009,45235,4589,4534,65,4599,91
2021-12-18,Colusa,011,21464,2655,2635,693,3328,21
2021-12-18,Contra Costa,013,1133247,104890,103380,2445,105825,1065
2021-12-18,Del Norte,015,27424,3822,3791,57,3848,43
2021-12-18,El Dorado,017,186661,17288,16968,1826,18794,171
2021-12-18,Fresno,019,978130,148872,147038,13489,160527,2335
2021-12-18,Glenn,021,27897,3630,3590,1059,4649,39
2021-12-18,Humboldt,023,135768,10041,9889,747,10636,118
2021-12-18,Imperial,025,180216,36899,36280,4098,40378,790
2021-12-18,Inyo,027,18085,2637,2607,43,2650,47
2021-12-18,Kern,029,883053,135138,133754,24769,158523,1873
2021-12-18,Kings,031,150075,34172,33783,2094,35877,374
2021-12-18,Lake,033,64148,7040,6976,170,7146,115
2021-12-18,Lassen,035,31185,7103,7061,433,7494,55
2021-12-18,Los Angeles,037,10098052,1510626,1484840,59219,1544059,27135
2021-12-18,Madera,039,155013,24825,24575,2399,26974,313
2021-12-18,Marin,041,260295,18949,18537,584,19121,249
2021-12-18,Mariposa,043,17540,1491,1468,63,1531,6
2021-12-18,Mendocino,045,87422,8365,8219,706,8925,95
2021-12-18,Merced,047,269075,44113,43929,2236,46165,686
2021-12-18,Modoc,049,8938,601,595,205,800,6
2021-12-18,Mono,051,14174,1987,1956,23,1979,4
2021-12-18,Monterey,053,433212,50925,49343,3494,52837,635
2021-12-18,Napa,055,140530,13760,13581,139,13720,107
2021-12-18,Nevada,057,99092,10160,9991,355,10346,108
2021-12-18,Orange,059,3164182,322474,318149,16921,335070,5844
2021-12-18,Placer,061,380077,39915,39336,4012,43348,485
2021-12-18,Plumas,063,18699,2021,1964,51,2015,13
2021-12-18,Riverside,065,2383286,386004,379354,17105,396459,5439
2021-12-18,Sacramento,067,1510023,169156,167046,5275,172321,2404
2021-12-18,San Benito,069,59416,7949,7894,187,8081,79
2021-12-18,San Bernardino,071,2135413,376614,371658,12089,383747,6017
2021-12-18,San Diego,073,3302833,403465,397130,23443,420573,4399
2021-12-18,San Francisco,075,870044,57894,55562,2625,58187,679
2021-12-18,San Joaquin,077,732212,104809,103698,5809,109507,1858
2021-12-18,San Luis Obispo,079,281455,31386,30873,1402,32275,365
2021-12-18,San Mateo,081,765935,57827,55730,1062,56792,580
2021-12-18,Santa Barbara,083,443738,47388,46776,1685,48461,562
2021-12-18,Santa Clara,085,1922200,156876,154243,1824,156067,1946
2021-12-18,Santa Cruz,087,273765,22213,21805,1074,22879,225
2021-12-18,Shasta,089,179085,22986,22811,3771,26582,429
2021-12-18,Sierra,091,2930,204,199,21,220,0
2021-12-18,Siskiyou,093,43540,3509,3441,1395,4836,58
2021-12-18,Solano,095,438530,48093,47174,1411,48585,369
2021-12-18,Sonoma,097,501317,44387,43658,609,44267,407
2021-12-18,Stanislaus,099,539301,82673,82736,9486,92222,1330
2021-12-18,Sutter,101,95872,14484,14435,417,14852,190
2021-12-18,Tehama,103,63373,8927,8814,1572,10386,136
2021-12-18,Trinity,105,12862,913,823,228,1051,17
2021-12-18,Tulare,107,460477,72106,70922,16787,87709,1120
2021-12-18,Tuolumne,109,53932,7890,7834,112,7946,91
2021-12-18,Ventura,111,848112,103329,101612,4593,106205,1201
2021-12-18,Yolo,113,214977,21084,20793,1342,22135,267
2021-12-18,Yuba,115,75493,10727,10599,414,11013,96
2021-12-17,Alameda,001,1643700,126662,124583,3082,127665,1512
2021-12-17,Alpine,003,1148,110,110,0,110,0
2021-12-17,Amador,005,37829,5856,5821,77,5898,69
2021-12-17,Butte,007,227075,22199,21956,3958,25914,328
2021-12-17,Calaveras,009,45235,4585,4534,65,4599,91
2021-12-17,Colusa,011,21464,2654,2635,692,3327,21
2021-12-17,Contra Costa,013,1133247,104688,103380,2441,105821,1065
2021-12-17,Del Norte,015,27424,3821,3791,57,3848,43
2021-12-17,El Dorado,017,186661,17259,16968,1823,18791,171
2021-12-17,Fresno,019,978130,148768,147038,13489,160527,2335
2021-12-17,Glenn,021,27897,3623,3590,1059,4649,39
2021-12-17,Humboldt,023,135768,10021,9889,745,10634,118
2021-12-17,Imperial,025,180216,36836,36280,4080,40360,790
2021-12-17,Inyo,027,18085,2632,2607,43,2650,47
2021-12-17,Kern,029,883053,135048,133754,24727,158481,1873
2021-12-17,Kings,031,150075,34153,33783,2094,35877,374
2021-12-17,Lake,033,64148,7036,6976,170,7146,115
2021-12-17,Lassen,035,31185,7103,7061,432,7493,55
2021-12-17,Los Angeles,037,10098052,1506684,1484840,58974,1543814,27135
2021-12-17,Madera,039,155013,24809,24575,2394,26969,313
2021-12-17,Marin,041,260295,18873,18537,580,19117,249
2021-12-17,Mariposa,043,17540,1487,1468,63,1531,6
2021-12-17,Mendocino,045,87422,8354,8219,706,8925,95
2021-12-17,Merced,047,269075,44086,43929,2235,46164,686
2021-12-17,Modoc,049,8938,601,595,205,800,6
2021-12-17,Mono,051,14174,1984,1956,23,1979,4
2021-12-17,Monterey,053,433212,50867,49343,3489,52832,635
2021-12-17,Napa,055,140530,13733,13581,138,13719,107
2021-12-17,Nevada,057,99092,10149,9991,355,10346,108
2021-12-17,Orange,059,3164182,321916,318149,16853,335002,5844
2021-12-17,Placer,061,380077,39861,39336,4006,43342,485
2021-12-17,Plumas,063,18699,2020,1964,51,2015,13
2021-12-17,Riverside,065,2383286,385358,379354,17094,396448,5439
2021-12-17,Sacramento,067,1510023,168926,167046,5262,172308,2404
2021-12-17,San Benito,069,59416,7947,7894,187,8081,79
2021-12-17,San Bernardino,071,2135413,376076,371658,12072,383730,6017
2021-12-17,San Diego,073,3302833,402526,397130,23395,420525,4399
2021-12-17,San Francisco,075,870044,57568,55562,2595,58157,679
2021-12-17,San Joaquin,077,732212,104735,103698,5791,109489,1858
2021-12-17,San Luis Obispo,079,281455,31358,30873,1398,32271,365
2021-12-17,San Mateo,081,765935,57639,55730,1055,56785,580
2021-12-17,Santa Barbara,083,443738,47311,46776,1679,48455,562
2021-12-17,Santa Clara,085,1922200,156503,154243,1809,156052,1946
2021-12-17,Santa Cruz,087,273765,22167,21805,1071,22876,225
2021-12-17,Shasta,089,179085,22973,22811,3769,26580,429
2021-12-17,Sierra,091,2930,203,199,21,220,0
2021-12-17,Siskiyou,093,43540,3505,3441,1393,4834,58
2021-12-17,Solano,095,438530,48025,47174,1407,48581,369
2021-12-17,Sonoma,097,501317,44290,43658,606,44264,407
2021-12-17,Stanislaus,099,539301,82622,82736,9480,92216,1330
2021-12-17,Sutter,101,95872,14472,14435,415,14850,190
2021-12-17,Tehama,103,63373,8920,8814,1571,10385,136
2021-12-17,Trinity,105,12862,913,823,228,1051,17
2021-12-17,Tulare,107,460477,72064,70922,16756,87678,1120
2021-12-17,Tuolumne,109,53932,7878,7834,112,7946,91
2021-12-17,Ventura,111,848112,103079,101612,4581,106193,1201
2021-12-17,Yolo,113,214977,21051,20793,1336,22129,267
2021-12-17,Yuba,115,75493,10716,10599,411,11010,96
2021-12-16,Alameda,001,1643700,126290,124583,3068,127651,1512
2021-12-16,Alpine,003,1148,108,110,0,110,0
2021-12-16,Amador,005,37829,5848,5821,77,5898,69
2021-12-16,Butte,007,227075,22180,21956,3955,25911,328
2021-12-16,Calaveras,009,45235,4577,4534,65,4599,91
2021-12-16,Colusa,011,21464,2654,2635,692,3327,21
2021-12-16,Contra Costa,013,1133247,104464,103380,2428,105808,1065
2021-12-16,Del Norte,015,27424,3818,3791,57,3848,43
2021-12-16,El Dorado,017,186661,17224,16968,1818,18786,171
2021-12-16,Fresno,019,978130,148608,147038,13483,160521,2335
2021-12-16,Glenn,021,27897,3622,3590,1056,4646,39
2021-12-16,Humboldt,023,135768,9997,9889,735,10624,118
2021-12-16,Imperial,025,180216,36751,36280,4050,40330,790
2021-12-16,Inyo,027,18085,2628,2607,42,2649,47
2021-12-16,Kern,029,883053,134906,133754,24676,158430,1873
2021-12-16,Kings,031,150075,34129,33783,2093,35876,374
2021-12-16,Lake,033,64148,7032,6976,170,7146,115
2021-12-16,Lassen,035,31185,7100,7061,431,7492,55
2021-12-16,Los Angeles,037,10098052,1502472,1484840,58701,1543541,27135
2021-12-16,Madera,039,155013,24781,24575,2390,26965,313
2021-12-16,Marin,041,260295,18826,18537,572,19109,249
2021-12-16,Mariposa,043,17540,1485,1468,63,1531,6
2021-12-16,Mendocino,045,87422,8343,8219,701,8920,95
2021-12-16,Merced,047,269075,44047,43929,2234,46163,686
2021-12-16,Modoc,049,8938,601,595,205,800,6
2021-12-16,Mono,051,14174,1981,1956,23,1979,4
2021-12-16,Monterey,053,433212,50796,49343,3472,52815,635
2021-12-16,Napa,055,140530,13701,13581,138,13719,107
2021-12-16,Nevada,057,99092,10123,9991,355,10346,108
2021-12-16,Orange,059,3164182,321309,318149,16773,334922,5844
2021-12-16,Placer,061,380077,39784,39336,4001,43337,485
2021-12-16,Plumas,063,18699,2020,1964,51,2015,13
2021-12-16,Riverside,065,2383286,384558,379354,17080,396434,5439
2021-12-16,Sacramento,067,1510023,168640,167046,5237,172283,2404
2021-12-16,San Benito,069,59416,7940,7894,187,8081,79
2021-12-16,San Bernardino,071,2135413,375427,371658,12054,383712,6017
2021-12-16,San Diego,073,3302833,401344,397130,23329,420459,4399
2021-12-16,San Francisco,075,870044,57193,55562,2573,58135,679
2021-12-16,San Joaquin,077,732212,104614,103698,5784,109482,1858
2021-12-16,San Luis Obispo,079,281455,31289,30873,1392,32265,365
2021-12-16,San Mateo,081,765935,57439,55730,1052,56782,580
2021-12-16,Santa Barbara,083,443738,47189,46776,1675,48451,562
2021-12-16,Santa Clara,085,1922200,156172,154243,1799,156042,1946
2021-12-16,Santa Cruz,087,273765,22121,21805,1070,22875,225
2021-12-16,Shasta,089,179085,22943,22811,3767,26578,429
2021-12-16,Sierra,091,2930,203,199,21,220,0
2021-12-16,Siskiyou,093,43540,3504,3441,1389,4830,58
2021-12-16,Solano,095,438530,47957,47174,1400,48574,369
2021-12-16,Sonoma,097,501317,44192,43658,604,44262,407
2021-12-16,Stanislaus,099,539301,82535,82736,9466,92202,1330
2021-12-16,Sutter,101,95872,14458,14435,414,14849,190
2021-12-16,Tehama,103,63373,8913,8814,1570,10384,136
2021-12-16,Trinity,105,12862,913,823,228,1051,17
2021-12-16,Tulare,107,460477,72015,70922,16730,87652,1120
2021-12-16,Tuolumne,109,53932,7859,7834,112,7946,91
2021-12-16,Ventura,111,848112,102811,101612,4574,106186,1201
2021-12-16,Yolo,113,214977,21001,20793,1331,22124,267
2021-12-16,Yuba,115,75493,10701,10599,410,11009,96
2021-12-15,Alameda,001,1643700,125968,124342,3057,127399,1509
2021-12-15,Alpine,003,1148,108,109,0,109,0
2021-12-15,Amador,005,37829,5842,5810,77,5887,69
2021-12-15,Butte,007,227075,22158,21922,3954,25876,327
2021-12-15,Calaveras,009,45235,4571,4523,65,4588,89
2021-12-15,Colusa,011,21464,2653,2632,691,3323,21
2021-12-15,Contra Costa,013,1133247,104245,103236,2425,105661,1064
2021-12-15,Del Norte,015,27424,3817,3789,56,3845,43
2021-12-15,El Dorado,017,186661,17192,16936,1812,18748,171
2021-12-15,Fresno,019,978130,148480,146859,13468,160327,2319
2021-12-15,Glenn,021,27897,3622,3589,1056,4645,39
2021-12-15,Humboldt,023,135768,9977,9854,734,10588,118
2021-12-15,Imperial,025,180216,36672,36187,4006,40193,789
2021-12-15,Inyo,027,18085,2623,2606,42,2648,47
2021-12-15,Kern,029,883053,134767,133590,24629,158219,1866
2021-12-15,Kings,031,150075,34100,33716,2089,35805,374
2021-12-15,Lake,033,64148,7023,6968,169,7137,115
2021-12-15,Lassen,035,31185,7100,7062,431,7493,55
2021-12-15,Los Angeles,037,10098052,1498583,1482735,58504,1541239,27116
2021-12-15,Madera,039,155013,24763,24549,2384,26933,313
2021-12-15,Marin,041,260295,18768,18514,567,19081,249
2021-12-15,Mariposa,043,17540,1482,1463,63,1526,6
2021-12-15,Mendocino,045,87422,8338,8209,698,8907,95
2021-12-15,Merced,047,269075,44005,43890,2222,46112,685
2021-12-15,Modoc,049,8938,601,595,205,800,6
2021-12-15,Mono,051,14174,1977,1955,23,1978,4
2021-12-15,Monterey,053,433212,50741,49279,3454,52733,635
2021-12-15,Napa,055,140530,13672,13557,136,13693,107
2021-12-15,Nevada,057,99092,10102,9958,355,10313,107
2021-12-15,Orange,059,3164182,320734,317808,16731,334539,5838
2021-12-15,Placer,061,380077,39729,39264,3991,43255,485
2021-12-15,Plumas,063,18699,2016,1957,51,2008,12
2021-12-15,Riverside,065,2383286,383841,378769,17068,395837,5438
2021-12-15,Sacramento,067,1510023,168332,166793,5215,172008,2401
2021-12-15,San Benito,069,59416,7925,7877,187,8064,79
2021-12-15,San Bernardino,071,2135413,374889,371122,12023,383145,6013
2021-12-15,San Diego,073,3302833,400156,396546,23260,419806,4395
2021-12-15,San Francisco,075,870044,56875,55414,2555,57969,679
2021-12-15,San Joaquin,077,732212,104457,103579,5774,109353,1853
2021-12-15,San Luis Obispo,079,281455,31241,30784,1385,32169,365
2021-12-15,San Mateo,081,765935,57298,55657,1041,56698,580
2021-12-15,Santa Barbara,083,443738,47108,46681,1673,48354,562
2021-12-15,Santa Clara,085,1922200,155860,153928,1778,155706,1944
2021-12-15,Santa Cruz,087,273765,22082,21753,1063,22816,225
2021-12-15,Shasta,089,179085,22928,22778,3763,26541,427
2021-12-15,Sierra,091,2930,203,199,21,220,0
2021-12-15,Siskiyou,093,43540,3503,3434,1388,4822,58
2021-12-15,Solano,095,438530,47886,47098,1393,48491,367
2021-12-15,Sonoma,097,501317,44108,43580,599,44179,407
2021-12-15,Stanislaus,099,539301,82428,82628,9458,92086,1298
2021-12-15,Sutter,101,95872,14438,14428,413,14841,189
2021-12-15,Tehama,103,63373,8906,8806,1569,10375,136
2021-12-15,Trinity,105,12862,912,822,228,1050,17
2021-12-15,Tulare,107,460477,71963,70846,16701,87547,1120
2021-12-15,Tuolumne,109,53932,7850,7818,111,7929,91
2021-12-15,Ventura,111,848112,102596,101447,4568,106015,1199
2021-12-15,Yolo,113,214977,20973,20749,1326,22075,267
2021-12-15,Yuba,115,75493,10690,10587,409,10996,96
2021-12-14,Alameda,001,1643700,125639,124272,3047,127319,1506
2021-12-14,Alpine,003,1148,107,109,0,109,0
2021-12-14,Amador,005,37829,5836,5808,76,5884,69
2021-12-14,Butte,007,227075,22125,21901,3952,25853,326
2021-12-14,Calaveras,009,45235,4559,4517,65,4582,89
2021-12-14,Colusa,011,21464,2651,2628,691,3319,21
2021-12-14,Contra Costa,013,1133247,104061,103135,2421,105556,1064
2021-12-14,Del Norte,015,27424,3814,3788,56,3844,43
2021-12-14,El Dorado,017,186661,17158,16915,1810,18725,170
2021-12-14,Fresno,019,978130,148310,146756,13460,160216,2316
2021-12-14,Glenn,021,27897,3621,3589,1056,4645,39
2021-12-14,Humboldt,023,135768,9965,9836,726,10562,118
2021-12-14,Imperial,025,180216,36599,36049,3964,40013,789
2021-12-14,Inyo,027,18085,2623,2601,42,2643,46
2021-12-14,Kern,029,883053,134631,133498,24580,158078,1863
2021-12-14,Kings,031,150075,34063,33693,2086,35779,373
2021-12-14,Lake,033,64148,7014,6961,169,7130,115
2021-12-14,Lassen,035,31185,7099,7061,431,7492,55
2021-12-14,Los Angeles,037,10098052,1494938,1481131,58322,1539453,27099
2021-12-14,Madera,039,155013,24737,24535,2376,26911,313
2021-12-14,Marin,041,260295,18720,18491,565,19056,249
2021-12-14,Mariposa,043,17540,1479,1463,62,1525,6
2021-12-14,Mendocino,045,87422,8310,8206,696,8902,95
2021-12-14,Merced,047,269075,43959,43870,2220,46090,684
2021-12-14,Modoc,049,8938,600,595,205,800,6
2021-12-14,Mono,051,14174,1970,1955,23,1978,4
2021-12-14,Monterey,053,433212,50658,49237,3443,52680,635
2021-12-14,Napa,055,140530,13643,13528,136,13664,107
2021-12-14,Nevada,057,99092,10076,9956,354,10310,106
2021-12-14,Orange,059,3164182,320184,317465,16677,334142,5827
2021-12-14,Placer,061,380077,39652,39221,3986,43207,482
2021-12-14,Plumas,063,18699,2012,1950,49,1999,12
2021-12-14,Riverside,065,2383286,383170,378227,17051,395278,5427
2021-12-14,Sacramento,067,1510023,168022,166605,5192,171797,2394
2021-12-14,San Benito,069,59416,7906,7871,187,8058,79
2021-12-14,San Bernardino,071,2135413,374273,370604,11993,382597,6013
2021-12-14,San Diego,073,3302833,399018,395876,23209,419085,4393
2021-12-14,San Francisco,075,870044,56562,55278,2543,57821,679
2021-12-14,San Joaquin,077,732212,104312,103488,5756,109244,1848
2021-12-14,San Luis Obispo,079,281455,31180,30753,1381,32134,363
2021-12-14,San Mateo,081,765935,57135,55601,1034,56635,580
2021-12-14,Santa Barbara,083,443738,47008,46648,1668,48316,560
2021-12-14,Santa Clara,085,1922200,155539,153814,1765,155579,1945
2021-12-14,Santa Cruz,087,273765,22017,21737,1058,22795,225
2021-12-14,Shasta,089,179085,22901,22756,3762,26518,427
2021-12-14,Sierra,091,2930,201,199,21,220,0
2021-12-14,Siskiyou,093,43540,3498,3430,1387,4817,58
2021-12-14,Solano,095,438530,47839,47065,1387,48452,367
2021-12-14,Sonoma,097,501317,44026,43538,597,44135,407
2021-12-14,Stanislaus,099,539301,82343,82581,9444,92025,1293
2021-12-14,Sutter,101,95872,14426,14421,412,14833,189
2021-12-14,Tehama,103,63373,8902,8805,1569,10374,134
2021-12-14,Trinity,105,12862,912,821,228,1049,17
2021-12-14,Tulare,107,460477,71892,70803,16670,87473,1120
2021-12-14,Tuolumne,109,53932,7837,7815,111,7926,91
2021-12-14,Ventura,111,848112,102372,101343,4561,105904,1199
2021-12-14,Yolo,113,214977,20939,20734,1312,22046,267
2021-12-14,Yuba,115,75493,10673,10574,409,10983,92
2021-12-13,Alameda,001,1643700,125354,124174,3040,127214,1501
2021-12-13,Alpine,003,1148,107,109,0,109,0
2021-12-13,Amador,005,37829,5832,5797,76,5873,69
2021-12-13,Butte,007,227075,22101,21889,3948,25837,326
2021-12-13,Calaveras,009,45235,4552,4507,64,4571,89
2021-12-13,Colusa,011,21464,2649,2627,691,3318,21
2021-12-13,Contra Costa,013,1133247,103909,103041,2410,105451,1064
2021-12-13,Del Norte,015,27424,3810,3787,56,3843,42
2021-12-13,El Dorado,017,186661,17135,16896,1808,18704,170
2021-12-13,Fresno,019,978130,148158,146641,13450,160091,2312
2021-12-13,Glenn,021,27897,3616,3589,1054,4643,37
2021-12-13,Humboldt,023,135768,9936,9821,722,10543,118
2021-12-13,Imperial,025,180216,36515,35974,3943,39917,787
2021-12-13,Inyo,027,18085,2622,2592,42,2634,46
2021-12-13,Kern,029,883053,134504,133381,24527,157908,1863
2021-12-13,Kings,031,150075,34020,33680,2081,35761,372
2021-12-13,Lake,033,64148,7012,6958,167,7125,115
2021-12-13,Lassen,035,31185,7098,7057,431,7488,55
2021-12-13,Los Angeles,037,10098052,1492155,1480195,58154,1538349,27085
2021-12-13,Madera,039,155013,24709,24527,2371,26898,311
2021-12-13,Marin,041,260295,18660,18471,562,19033,249
2021-12-13,Mariposa,043,17540,1477,1462,62,1524,6
2021-12-13,Mendocino,045,87422,8297,8196,694,8890,95
2021-12-13,Merced,047,269075,43920,43848,2216,46064,682
2021-12-13,Modoc,049,8938,599,595,205,800,6
2021-12-13,Mono,051,14174,1963,1952,23,1975,4
2021-12-13,Monterey,053,433212,50606,49222,3423,52645,631
2021-12-13,Napa,055,140530,13630,13518,136,13654,107
2021-12-13,Nevada,057,99092,10057,9946,353,10299,106
2021-12-13,Orange,059,3164182,319717,317112,16623,333735,5824
2021-12-13,Placer,061,380077,39591,39168,3975,43143,481
2021-12-13,Plumas,063,18699,2008,1943,49,1992,12
2021-12-13,Riverside,065,2383286,382590,377728,17036,394764,5414
2021-12-13,Sacramento,067,1510023,167742,166439,5158,171597,2392
2021-12-13,San Benito,069,59416,7897,7856,187,8043,79
2021-12-13,San Bernardino,071,2135413,373705,370274,11986,382260,6011
2021-12-13,San Diego,073,3302833,398207,395266,23156,418422,4389
2021-12-13,San Francisco,075,870044,56291,55245,2530,57775,678
2021-12-13,San Joaquin,077,732212,104196,103449,5747,109196,1846
2021-12-13,San Luis Obispo,079,281455,31131,30746,1377,32123,363
2021-12-13,San Mateo,081,765935,56975,55569,1025,56594,580
2021-12-13,Santa Barbara,083,443738,46921,46608,1663,48271,560
2021-12-13,Santa Clara,085,1922200,155274,153672,1754,155426,1944
2021-12-13,Santa Cruz,087,273765,21962,21698,1055,22753,225
2021-12-13,Shasta,089,179085,22880,22731,3760,26491,426
2021-12-13,Sierra,091,2930,201,199,21,220,0
2021-12-13,Siskiyou,093,43540,3494,3426,1384,4810,57
2021-12-13,Solano,095,438530,47765,47045,1382,48427,365
2021-12-13,Sonoma,097,501317,43931,43492,595,44087,407
2021-12-13,Stanislaus,099,539301,82229,82507,9424,91931,1282
2021-12-13,Sutter,101,95872,14419,14408,412,14820,188
2021-12-13,Tehama,103,63373,8889,8800,1569,10369,134
2021-12-13,Trinity,105,12862,912,820,228,1048,17
2021-12-13,Tulare,107,460477,71835,70758,16646,87404,1114
2021-12-13,Tuolumne,109,53932,7826,7804,111,7915,91
2021-12-13,Ventura,111,848112,102148,101180,4550,105730,1197
2021-12-13,Yolo,113,214977,20889,20706,1307,22013,267
2021-12-13,Yuba,115,75493,10656,10570,409,10979,92
2021-12-12,Alameda,001,1643700,125068,124075,3029,127104,1503
2021-12-12,Alpine,003,1148,107,109,0,109,0
2021-12-12,Amador,005,37829,5824,5797,75,5872,69
2021-12-12,Butte,007,227075,22077,21874,3945,25819,326
2021-12-12,Calaveras,009,45235,4542,4501,64,4565,89
2021-12-12,Colusa,011,21464,2644,2627,688,3315,21
2021-12-12,Contra Costa,013,1133247,103721,102976,2408,105384,1065
2021-12-12,Del Norte,015,27424,3807,3793,56,3849,42
2021-12-12,El Dorado,017,186661,17099,16890,1800,18690,170
2021-12-12,Fresno,019,978130,147995,146518,13434,159952,2310
2021-12-12,Glenn,021,27897,3613,3589,1054,4643,37
2021-12-12,Humboldt,023,135768,9912,9804,715,10519,118
2021-12-12,Imperial,025,180216,36380,35926,3910,39836,787
2021-12-12,Inyo,027,18085,2617,2592,42,2634,46
2021-12-12,Kern,029,883053,134339,133314,24486,157800,1861
2021-12-12,Kings,031,150075,33969,33661,2079,35740,372
2021-12-12,Lake,033,64148,7005,6955,165,7120,115
2021-12-12,Lassen,035,31185,7097,7057,431,7488,55
2021-12-12,Los Angeles,037,10098052,1489247,1479054,57969,1537023,27074
2021-12-12,Madera,039,155013,24679,24493,2363,26856,311
2021-12-12,Marin,041,260295,18607,18451,558,19009,249
2021-12-12,Mariposa,043,17540,1476,1461,62,1523,6
2021-12-12,Mendocino,045,87422,8284,8190,693,8883,95
2021-12-12,Merced,047,269075,43886,43821,2209,46030,682
2021-12-12,Modoc,049,8938,599,595,204,799,6
2021-12-12,Mono,051,14174,1959,1947,23,1970,4
2021-12-12,Monterey,053,433212,50553,49192,3396,52588,631
2021-12-12,Napa,055,140530,13587,13508,134,13642,107
2021-12-12,Nevada,057,99092,10030,9938,352,10290,106
2021-12-12,Orange,059,3164182,319213,316918,16559,333477,5825
2021-12-12,Placer,061,380077,39526,39139,3969,43108,481
2021-12-12,Plumas,063,18699,2004,1942,47,1989,12
2021-12-12,Riverside,065,2383286,381918,377467,17010,394477,5414
2021-12-12,Sacramento,067,1510023,167476,166291,5137,171428,2392
2021-12-12,San Benito,069,59416,7877,7853,187,8040,79
2021-12-12,San Bernardino,071,2135413,373072,369977,11962,381939,6011
2021-12-12,San Diego,073,3302833,397307,393307,23118,416425,4378
2021-12-12,San Francisco,075,870044,56037,55180,2518,57698,678
2021-12-12,San Joaquin,077,732212,104057,103405,5737,109142,1846
2021-12-12,San Luis Obispo,079,281455,31078,30719,1375,32094,363
2021-12-12,San Mateo,081,765935,56860,55505,1021,56526,580
2021-12-12,Santa Barbara,083,443738,46846,46586,1661,48247,560
2021-12-12,Santa Clara,085,1922200,154995,153452,1740,155192,1945
2021-12-12,Santa Cruz,087,273765,21913,21671,1053,22724,225
2021-12-12,Shasta,089,179085,22852,22732,3759,26491,426
2021-12-12,Sierra,091,2930,201,199,21,220,0
2021-12-12,Siskiyou,093,43540,3494,3424,1384,4808,57
2021-12-12,Solano,095,438530,47699,47021,1377,48398,365
2021-12-12,Sonoma,097,501317,43838,43424,592,44016,407
2021-12-12,Stanislaus,099,539301,82131,82460,9413,91873,1282
2021-12-12,Sutter,101,95872,14408,14396,412,14808,189
2021-12-12,Tehama,103,63373,8878,8796,1567,10363,134
2021-12-12,Trinity,105,12862,910,820,228,1048,17
2021-12-12,Tulare,107,460477,71757,70733,16604,87337,1115
2021-12-12,Tuolumne,109,53932,7809,7794,111,7905,91
2021-12-12,Ventura,111,848112,101954,101105,4536,105641,1197
2021-12-12,Yolo,113,214977,20839,20685,1296,21981,267
2021-12-12,Yuba,115,75493,10642,10565,406,10971,92
2021-12-11,Alameda,001,1643700,124931,123572,3027,126599,1496
2021-12-11,Alpine,003,1148,107,109,0,109,0
2021-12-11,Amador,005,37829,5819,5787,75,5862,69
2021-12-11,Butte,007,227075,22063,21819,3944,25763,326
2021-12-11,Calaveras,009,45235,4534,4469,63,4532,89
2021-12-11,Colusa,011,21464,2640,2619,687,3306,21
2021-12-11,Contra Costa,013,1133247,103635,102618,2406,105024,1061
2021-12-11,Del Norte,015,27424,3807,3778,56,3834,42
2021-12-11,El Dorado,017,186661,17078,16796,1799,18595,170
2021-12-11,Fresno,019,978130,147908,145988,13426,159414,2294
2021-12-11,Glenn,021,27897,3612,3585,1054,4639,37
2021-12-11,Humboldt,023,135768,9895,9721,712,10433,118
2021-12-11,Imperial,025,180216,36321,35635,3900,39535,782
2021-12-11,Inyo,027,18085,2612,2576,42,2618,46
2021-12-11,Kern,029,883053,134270,132852,24451,157303,1854
2021-12-11,Kings,031,150075,33956,33530,2077,35607,371
2021-12-11,Lake,033,64148,7004,6932,163,7095,114
2021-12-11,Lassen,035,31185,7096,7049,431,7480,55
2021-12-11,Los Angeles,037,10098052,1488029,1474030,57877,1531907,27031
2021-12-11,Madera,039,155013,24673,24417,2362,26779,311
2021-12-11,Marin,041,260295,18573,18339,555,18894,249
2021-12-11,Mariposa,043,17540,1475,1450,62,1512,6
2021-12-11,Mendocino,045,87422,8277,8130,693,8823,95
2021-12-11,Merced,047,269075,43867,43690,2208,45898,681
2021-12-11,Modoc,049,8938,599,594,204,798,6
2021-12-11,Mono,051,14174,1955,1926,23,1949,4
2021-12-11,Monterey,053,433212,50525,49008,3393,52401,631
2021-12-11,Napa,055,140530,13570,13459,134,13593,107
2021-12-11,Nevada,057,99092,10016,9880,352,10232,106
2021-12-11,Orange,059,3164182,318961,315759,16531,332290,5805
2021-12-11,Placer,061,380077,39468,38959,3962,42921,481
2021-12-11,Plumas,063,18699,1998,1934,47,1981,12
2021-12-11,Riverside,065,2383286,381501,375649,16996,392645,5408
2021-12-11,Sacramento,067,1510023,167346,165530,5127,170657,2386
2021-12-11,San Benito,069,59416,7863,7808,187,7995,79
2021-12-11,San Bernardino,071,2135413,372713,368145,11953,380098,6007
2021-12-11,San Diego,073,3302833,396883,392274,23080,415354,4374
2021-12-11,San Francisco,075,870044,55884,54869,2513,57382,678
2021-12-11,San Joaquin,077,732212,103996,103013,5733,108746,1842
2021-12-11,San Luis Obispo,079,281455,31056,30567,1371,31938,362
2021-12-11,San Mateo,081,765935,56782,55284,1019,56303,580
2021-12-11,Santa Barbara,083,443738,46811,46309,1661,47970,559
2021-12-11,Santa Clara,085,1922200,154797,152846,1728,154574,1941
2021-12-11,Santa Cruz,087,273765,21889,21557,1053,22610,225
2021-12-11,Shasta,089,179085,22837,22660,3755,26415,419
2021-12-11,Sierra,091,2930,201,199,21,220,0
2021-12-11,Siskiyou,093,43540,3488,3418,1381,4799,57
2021-12-11,Solano,095,438530,47670,46891,1372,48263,365
2021-12-11,Sonoma,097,501317,43790,43227,592,43819,407
2021-12-11,Stanislaus,099,539301,82081,82133,9404,91537,1264
2021-12-11,Sutter,101,95872,14399,14354,412,14766,187
2021-12-11,Tehama,103,63373,8875,8776,1565,10341,134
2021-12-11,Trinity,105,12862,910,819,228,1047,17
2021-12-11,Tulare,107,460477,71714,70523,16594,87117,1103
2021-12-11,Tuolumne,109,53932,7800,7760,111,7871,91
2021-12-11,Ventura,111,848112,101879,100711,4529,105240,1195
2021-12-11,Yolo,113,214977,20820,20608,1292,21900,267
2021-12-11,Yuba,115,75493,10630,10519,405,10924,92
2021-12-10,Alameda,001,1643700,124805,123572,3021,126593,1496
2021-12-10,Alpine,003,1148,106,109,0,109,0
2021-12-10,Amador,005,37829,5812,5787,75,5862,69
2021-12-10,Butte,007,227075,22050,21819,3942,25761,326
2021-12-10,Calaveras,009,45235,4531,4469,63,4532,89
2021-12-10,Colusa,011,21464,2639,2619,687,3306,21
2021-12-10,Contra Costa,013,1133247,103539,102618,2405,105023,1061
2021-12-10,Del Norte,015,27424,3807,3778,56,3834,42
2021-12-10,El Dorado,017,186661,17065,16796,1799,18595,170
2021-12-10,Fresno,019,978130,147820,145988,13415,159403,2294
2021-12-10,Glenn,021,27897,3612,3585,1054,4639,37
2021-12-10,Humboldt,023,135768,9878,9721,710,10431,118
2021-12-10,Imperial,025,180216,36266,35635,3885,39520,782
2021-12-10,Inyo,027,18085,2609,2576,42,2618,46
2021-12-10,Kern,029,883053,134181,132852,24427,157279,1854
2021-12-10,Kings,031,150075,33941,33530,2075,35605,371
2021-12-10,Lake,033,64148,6997,6932,163,7095,114
2021-12-10,Lassen,035,31185,7095,7049,431,7480,55
2021-12-10,Los Angeles,037,10098052,1486936,1474030,57789,1531819,27031
2021-12-10,Madera,039,155013,24655,24417,2360,26777,311
2021-12-10,Marin,041,260295,18551,18339,555,18894,249
2021-12-10,Mariposa,043,17540,1472,1450,62,1512,6
2021-12-10,Mendocino,045,87422,8270,8130,692,8822,95
2021-12-10,Merced,047,269075,43849,43690,2206,45896,681
2021-12-10,Modoc,049,8938,599,594,204,798,6
2021-12-10,Mono,051,14174,1952,1926,23,1949,4
2021-12-10,Monterey,053,433212,50488,49008,3387,52395,631
2021-12-10,Napa,055,140530,13558,13459,133,13592,107
2021-12-10,Nevada,057,99092,10007,9880,352,10232,106
2021-12-10,Orange,059,3164182,318690,315759,16499,332258,5805
2021-12-10,Placer,061,380077,39425,38959,3959,42918,481
2021-12-10,Plumas,063,18699,1996,1934,47,1981,12
2021-12-10,Riverside,065,2383286,381094,375649,16985,392634,5408
2021-12-10,Sacramento,067,1510023,167192,165530,5125,170655,2386
2021-12-10,San Benito,069,59416,7859,7808,187,7995,79
2021-12-10,San Bernardino,071,2135413,372340,368145,11930,380075,6007
2021-12-10,San Diego,073,3302833,396404,392274,23066,415340,4374
2021-12-10,San Francisco,075,870044,55799,54869,2507,57376,678
2021-12-10,San Joaquin,077,732212,103941,103013,5729,108742,1842
2021-12-10,San Luis Obispo,079,281455,31046,30567,1368,31935,362
2021-12-10,San Mateo,081,765935,56725,55284,1016,56300,580
2021-12-10,Santa Barbara,083,443738,46775,46309,1660,47969,559
2021-12-10,Santa Clara,085,1922200,154626,152846,1715,154561,1941
2021-12-10,Santa Cruz,087,273765,21869,21557,1052,22609,225
2021-12-10,Shasta,089,179085,22826,22660,3752,26412,419
2021-12-10,Sierra,091,2930,201,199,21,220,0
2021-12-10,Siskiyou,093,43540,3481,3418,1381,4799,57
2021-12-10,Solano,095,438530,47628,46891,1368,48259,365
2021-12-10,Sonoma,097,501317,43756,43227,591,43818,407
2021-12-10,Stanislaus,099,539301,82015,82133,9398,91531,1264
2021-12-10,Sutter,101,95872,14391,14354,412,14766,187
2021-12-10,Tehama,103,63373,8873,8776,1563,10339,134
2021-12-10,Trinity,105,12862,910,819,228,1047,17
2021-12-10,Tulare,107,460477,71685,70523,16569,87092,1103
2021-12-10,Tuolumne,109,53932,7794,7760,111,7871,91
2021-12-10,Ventura,111,848112,101775,100711,4526,105237,1195
2021-12-10,Yolo,113,214977,20806,20608,1290,21898,267
2021-12-10,Yuba,115,75493,10618,10519,404,10923,92
2021-12-09,Alameda,001,1643700,124661,123572,3017,126589,1496
2021-12-09,Alpine,003,1148,106,109,0,109,0
2021-12-09,Amador,005,37829,5809,5787,74,5861,69
2021-12-09,Butte,007,227075,22029,21819,3939,25758,326
2021-12-09,Calaveras,009,45235,4522,4469,63,4532,89
2021-12-09,Colusa,011,21464,2637,2619,687,3306,21
2021-12-09,Contra Costa,013,1133247,103420,102618,2399,105017,1061
2021-12-09,Del Norte,015,27424,3806,3778,56,3834,42
2021-12-09,El Dorado,017,186661,17036,16796,1794,18590,170
2021-12-09,Fresno,019,978130,147672,145988,13404,159392,2294
2021-12-09,Glenn,021,27897,3612,3585,1054,4639,37
2021-12-09,Humboldt,023,135768,9856,9721,709,10430,118
2021-12-09,Imperial,025,180216,36196,35635,3855,39490,782
2021-12-09,Inyo,027,18085,2607,2576,42,2618,46
2021-12-09,Kern,029,883053,134055,132852,24394,157246,1854
2021-12-09,Kings,031,150075,33915,33530,2072,35602,371
2021-12-09,Lake,033,64148,6989,6932,163,7095,114
2021-12-09,Lassen,035,31185,7093,7049,431,7480,55
2021-12-09,Los Angeles,037,10098052,1485396,1474030,57702,1531732,27031
2021-12-09,Madera,039,155013,24630,24417,2357,26774,311
2021-12-09,Marin,041,260295,18538,18339,553,18892,249
2021-12-09,Mariposa,043,17540,1471,1450,62,1512,6
2021-12-09,Mendocino,045,87422,8257,8130,689,8819,95
2021-12-09,Merced,047,269075,43811,43690,2194,45884,681
2021-12-09,Modoc,049,8938,599,594,204,798,6
2021-12-09,Mono,051,14174,1948,1926,23,1949,4
2021-12-09,Monterey,053,433212,50441,49008,3376,52384,631
2021-12-09,Napa,055,140530,13538,13459,129,13588,107
2021-12-09,Nevada,057,99092,9988,9880,352,10232,106
2021-12-09,Orange,059,3164182,318360,315759,16460,332219,5805
2021-12-09,Placer,061,380077,39382,38959,3946,42905,481
2021-12-09,Plumas,063,18699,1988,1934,47,1981,12
2021-12-09,Riverside,065,2383286,380545,375649,16969,392618,5408
2021-12-09,Sacramento,067,1510023,166974,165530,5110,170640,2386
2021-12-09,San Benito,069,59416,7847,7808,186,7994,79
2021-12-09,San Bernardino,071,2135413,371838,368145,11910,380055,6007
2021-12-09,San Diego,073,3302833,395758,392274,23036,415310,4374
2021-12-09,San Francisco,075,870044,55714,54869,2500,57369,678
2021-12-09,San Joaquin,077,732212,103849,103013,5723,108736,1842
2021-12-09,San Luis Obispo,079,281455,31018,30567,1366,31933,362
2021-12-09,San Mateo,081,765935,56637,55284,1014,56298,580
2021-12-09,Santa Barbara,083,443738,46695,46309,1653,47962,559
2021-12-09,Santa Clara,085,1922200,154412,152846,1704,154550,1941
2021-12-09,Santa Cruz,087,273765,21841,21557,1052,22609,225
2021-12-09,Shasta,089,179085,22810,22660,3751,26411,419
2021-12-09,Sierra,091,2930,201,199,21,220,0
2021-12-09,Siskiyou,093,43540,3477,3418,1380,4798,57
2021-12-09,Solano,095,438530,47591,46891,1366,48257,365
2021-12-09,Sonoma,097,501317,43699,43227,590,43817,407
2021-12-09,Stanislaus,099,539301,81945,82133,9385,91518,1264
2021-12-09,Sutter,101,95872,14376,14354,412,14766,187
2021-12-09,Tehama,103,63373,8866,8776,1561,10337,134
2021-12-09,Trinity,105,12862,910,819,228,1047,17
2021-12-09,Tulare,107,460477,71628,70523,16540,87063,1103
2021-12-09,Tuolumne,109,53932,7783,7760,111,7871,91
2021-12-09,Ventura,111,848112,101630,100711,4514,105225,1195
2021-12-09,Yolo,113,214977,20783,20608,1282,21890,267
2021-12-09,Yuba,115,75493,10610,10519,401,10920,92
2021-12-08,Alameda,001,1643700,124513,123438,3008,126446,1496
2021-12-08,Alpine,003,1148,106,108,0,108,0
2021-12-08,Amador,005,37829,5804,5781,74,5855,69
2021-12-08,Butte,007,227075,22013,21780,3936,25716,326
2021-12-08,Calaveras,009,45235,4513,4455,63,4518,89
2021-12-08,Colusa,011,21464,2634,2619,686,3305,21
2021-12-08,Contra Costa,013,1133247,103290,102506,2398,104904,1058
2021-12-08,Del Norte,015,27424,3805,3767,56,3823,42
2021-12-08,El Dorado,017,186661,17004,16757,1794,18551,170
2021-12-08,Fresno,019,978130,147513,145830,13389,159219,2293
2021-12-08,Glenn,021,27897,3612,3584,1050,4634,37
2021-12-08,Humboldt,023,135768,9834,9704,707,10411,117
2021-12-08,Imperial,025,180216,36117,35537,3825,39362,782
2021-12-08,Inyo,027,18085,2604,2570,42,2612,46
2021-12-08,Kern,029,883053,133932,132709,24346,157055,1846
2021-12-08,Kings,031,150075,33880,33468,2071,35539,371
2021-12-08,Lake,033,64148,6983,6927,162,7089,114
2021-12-08,Lassen,035,31185,7091,7041,429,7470,55
2021-12-08,Los Angeles,037,10098052,1483857,1472410,57591,1530001,27018
2021-12-08,Madera,039,155013,24609,24396,2350,26746,311
2021-12-08,Marin,041,260295,18517,18305,550,18855,249
2021-12-08,Mariposa,043,17540,1469,1447,62,1509,6
2021-12-08,Mendocino,045,87422,8244,8118,688,8806,95
2021-12-08,Merced,047,269075,43779,43631,2186,45817,680
2021-12-08,Modoc,049,8938,599,594,204,798,6
2021-12-08,Mono,051,14174,1942,1924,23,1947,4
2021-12-08,Monterey,053,433212,50376,48957,3360,52317,631
2021-12-08,Napa,055,140530,13524,13421,129,13550,107
2021-12-08,Nevada,057,99092,9972,9862,352,10214,106
2021-12-08,Orange,059,3164182,318013,315421,16422,331843,5795
2021-12-08,Placer,061,380077,39330,38934,3941,42875,478
2021-12-08,Plumas,063,18699,1986,1924,47,1971,12
2021-12-08,Riverside,065,2383286,380034,375099,16946,392045,5404
2021-12-08,Sacramento,067,1510023,166719,165278,5082,170360,2373
2021-12-08,San Benito,069,59416,7838,7793,186,7979,79
2021-12-08,San Bernardino,071,2135413,371364,367516,11885,379401,6006
2021-12-08,San Diego,073,3302833,395104,391676,23004,414680,4369
2021-12-08,San Francisco,075,870044,55627,54792,2492,57284,677
2021-12-08,San Joaquin,077,732212,103748,102877,5713,108590,1841
2021-12-08,San Luis Obispo,079,281455,30970,30519,1361,31880,361
2021-12-08,San Mateo,081,765935,56569,55220,1008,56228,580
2021-12-08,Santa Barbara,083,443738,46640,46250,1650,47900,558
2021-12-08,Santa Clara,085,1922200,154250,152674,1693,154367,1937
2021-12-08,Santa Cruz,087,273765,21794,21505,1050,22555,224
2021-12-08,Shasta,089,179085,22790,22616,3745,26361,419
2021-12-08,Sierra,091,2930,201,199,21,220,0
2021-12-08,Siskiyou,093,43540,3476,3415,1378,4793,57
2021-12-08,Solano,095,438530,47561,46837,1365,48202,365
2021-12-08,Sonoma,097,501317,43636,43179,589,43768,405
2021-12-08,Stanislaus,099,539301,81862,82038,9374,91412,1264
2021-12-08,Sutter,101,95872,14360,14336,410,14746,187
2021-12-08,Tehama,103,63373,8857,8768,1561,10329,133
2021-12-08,Trinity,105,12862,910,818,228,1046,17
2021-12-08,Tulare,107,460477,71565,70472,16515,86987,1102
2021-12-08,Tuolumne,109,53932,7770,7749,111,7860,91
2021-12-08,Ventura,111,848112,101502,100647,4511,105158,1194
2021-12-08,Yolo,113,214977,20757,20575,1276,21851,267
2021-12-08,Yuba,115,75493,10596,10499,398,10897,92
2021-12-07,Alameda,001,1643700,124338,123325,2999,126324,1497
2021-12-07,Alpine,003,1148,106,108,0,108,0
2021-12-07,Amador,005,37829,5801,5778,73,5851,69
2021-12-07,Butte,007,227075,21989,21761,3931,25692,324
2021-12-07,Calaveras,009,45235,4497,4445,63,4508,88
2021-12-07,Colusa,011,21464,2632,2619,686,3305,21
2021-12-07,Contra Costa,013,1133247,103168,102421,2389,104810,1058
2021-12-07,Del Norte,015,27424,3804,3766,56,3822,42
2021-12-07,El Dorado,017,186661,16980,16742,1791,18533,170
2021-12-07,Fresno,019,978130,147366,145715,13373,159088,2289
2021-12-07,Glenn,021,27897,3611,3579,1050,4629,36
2021-12-07,Humboldt,023,135768,9810,9693,702,10395,117
2021-12-07,Imperial,025,180216,36039,35502,3804,39306,778
2021-12-07,Inyo,027,18085,2601,2567,42,2609,46
2021-12-07,Kern,029,883053,133773,132564,24293,156857,1838
2021-12-07,Kings,031,150075,33848,33441,2068,35509,372
2021-12-07,Lake,033,64148,6978,6925,162,7087,113
2021-12-07,Lassen,035,31185,7090,7040,428,7468,55
2021-12-07,Los Angeles,037,10098052,1482075,1470904,57487,1528391,27007
2021-12-07,Madera,039,155013,24586,24367,2343,26710,311
2021-12-07,Marin,041,260295,18483,18284,544,18828,249
2021-12-07,Mariposa,043,17540,1467,1446,62,1508,6
2021-12-07,Mendocino,045,87422,8226,8107,688,8795,95
2021-12-07,Merced,047,269075,43738,43600,2179,45779,675
2021-12-07,Modoc,049,8938,599,594,203,797,6
2021-12-07,Mono,051,14174,1940,1921,23,1944,4
2021-12-07,Monterey,053,433212,50293,48880,3343,52223,631
2021-12-07,Napa,055,140530,13506,13409,129,13538,107
2021-12-07,Nevada,057,99092,9958,9858,351,10209,105
2021-12-07,Orange,059,3164182,317680,315138,16373,331511,5784
2021-12-07,Placer,061,380077,39253,38860,3937,42797,474
2021-12-07,Plumas,063,18699,1982,1915,47,1962,12
2021-12-07,Riverside,065,2383286,379504,374552,16930,391482,5397
2021-12-07,Sacramento,067,1510023,166473,165148,5068,170216,2375
2021-12-07,San Benito,069,59416,7822,7776,186,7962,78
2021-12-07,San Bernardino,071,2135413,370796,366981,11867,378848,6007
2021-12-07,San Diego,073,3302833,394256,391110,22966,414076,4357
2021-12-07,San Francisco,075,870044,55517,54729,2487,57216,676
2021-12-07,San Joaquin,077,732212,103629,102797,5701,108498,1839
2021-12-07,San Luis Obispo,079,281455,30931,30495,1359,31854,361
2021-12-07,San Mateo,081,765935,56477,55163,1002,56165,580
2021-12-07,Santa Barbara,083,443738,46568,46205,1648,47853,556
2021-12-07,Santa Clara,085,1922200,154064,152465,1684,154149,1941
2021-12-07,Santa Cruz,087,273765,21747,21493,1050,22543,224
2021-12-07,Shasta,089,179085,22768,22594,3742,26336,418
2021-12-07,Sierra,091,2930,201,199,21,220,0
2021-12-07,Siskiyou,093,43540,3474,3412,1378,4790,57
2021-12-07,Solano,095,438530,47521,46812,1363,48175,365
2021-12-07,Sonoma,097,501317,43562,43154,588,43742,405
2021-12-07,Stanislaus,099,539301,81785,81980,9362,91342,1258
2021-12-07,Sutter,101,95872,14352,14322,409,14731,186
2021-12-07,Tehama,103,63373,8849,8765,1560,10325,133
2021-12-07,Trinity,105,12862,910,818,228,1046,17
2021-12-07,Tulare,107,460477,71509,70411,16486,86897,1103
2021-12-07,Tuolumne,109,53932,7762,7743,111,7854,91
2021-12-07,Ventura,111,848112,101405,100569,4501,105070,1194
2021-12-07,Yolo,113,214977,20731,20560,1273,21833,263
2021-12-07,Yuba,115,75493,10579,10491,397,10888,91
2021-12-06,Alameda,001,1643700,124172,123227,2996,126223,1496
2021-12-06,Alpine,003,1148,106,108,0,108,0
2021-12-06,Amador,005,37829,5794,5769,72,5841,67
2021-12-06,Butte,007,227075,21972,21732,3928,25660,321
2021-12-06,Calaveras,009,45235,4490,4443,63,4506,88
2021-12-06,Colusa,011,21464,2631,2615,682,3297,21
2021-12-06,Contra Costa,013,1133247,103048,102327,2385,104712,1058
2021-12-06,Del Norte,015,27424,3802,3744,56,3800,42
2021-12-06,El Dorado,017,186661,16955,16726,1789,18515,168
2021-12-06,Fresno,019,978130,147167,145539,13363,158902,2285
2021-12-06,Glenn,021,27897,3608,3577,1049,4626,36
2021-12-06,Humboldt,023,135768,9790,9671,695,10366,117
2021-12-06,Imperial,025,180216,35958,35453,3786,39239,778
2021-12-06,Inyo,027,18085,2595,2562,41,2603,46
2021-12-06,Kern,029,883053,133587,132366,24235,156601,1835
2021-12-06,Kings,031,150075,33815,33399,2063,35462,368
2021-12-06,Lake,033,64148,6974,6922,162,7084,113
2021-12-06,Lassen,035,31185,7085,7032,426,7458,51
2021-12-06,Los Angeles,037,10098052,1480406,1470059,57394,1527453,26993
2021-12-06,Madera,039,155013,24559,24334,2339,26673,307
2021-12-06,Marin,041,260295,18455,18252,542,18794,249
2021-12-06,Mariposa,043,17540,1464,1443,62,1505,6
2021-12-06,Mendocino,045,87422,8213,8079,684,8763,95
2021-12-06,Merced,047,269075,43698,43549,2169,45718,672
2021-12-06,Modoc,049,8938,599,593,203,796,6
2021-12-06,Mono,051,14174,1935,1913,23,1936,4
2021-12-06,Monterey,053,433212,50214,48831,3324,52155,626
2021-12-06,Napa,055,140530,13483,13387,127,13514,107
2021-12-06,Nevada,057,99092,9930,9847,350,10197,105
2021-12-06,Orange,059,3164182,317301,314859,16330,331189,5771
2021-12-06,Placer,061,380077,39195,38785,3932,42717,473
2021-12-06,Plumas,063,18699,1974,1913,47,1960,10
2021-12-06,Riverside,065,2383286,378985,374116,16916,391032,5388
2021-12-06,Sacramento,067,1510023,166196,164926,5047,169973,2367
2021-12-06,San Benito,069,59416,7806,7755,186,7941,78
2021-12-06,San Bernardino,071,2135413,370245,366606,11840,378446,5998
2021-12-06,San Diego,073,3302833,393406,390389,22921,413310,4352
2021-12-06,San Francisco,075,870044,55410,54659,2482,57141,674
2021-12-06,San Joaquin,077,732212,103502,102728,5694,108422,1837
2021-12-06,San Luis Obispo,079,281455,30893,30464,1357,31821,361
2021-12-06,San Mateo,081,765935,56403,55112,999,56111,580
2021-12-06,Santa Barbara,083,443738,46476,46146,1647,47793,556
2021-12-06,Santa Clara,085,1922200,153854,152310,1668,153978,1937
2021-12-06,Santa Cruz,087,273765,21712,21450,1047,22497,224
2021-12-06,Shasta,089,179085,22745,22556,3734,26290,416
2021-12-06,Sierra,091,2930,200,198,21,219,0
2021-12-06,Siskiyou,093,43540,3472,3409,1373,4782,57
2021-12-06,Solano,095,438530,47476,46748,1362,48110,360
2021-12-06,Sonoma,097,501317,43493,43114,580,43694,405
2021-12-06,Stanislaus,099,539301,81691,81889,9328,91217,1241
2021-12-06,Sutter,101,95872,14340,14319,409,14728,186
2021-12-06,Tehama,103,63373,8841,8760,1560,10320,133
2021-12-06,Trinity,105,12862,910,815,227,1042,17
2021-12-06,Tulare,107,460477,71432,70285,16447,86732,1101
2021-12-06,Tuolumne,109,53932,7748,7726,111,7837,91
2021-12-06,Ventura,111,848112,101303,100426,4493,104919,1194
2021-12-06,Yolo,113,214977,20707,20548,1272,21820,263
2021-12-06,Yuba,115,75493,10564,10480,392,10872,91
2021-12-05,Alameda,001,1643700,123988,123104,2988,126092,1496
2021-12-05,Alpine,003,1148,105,108,0,108,0
2021-12-05,Amador,005,37829,5791,5761,72,5833,67
2021-12-05,Butte,007,227075,21938,21720,3922,25642,320
2021-12-05,Calaveras,009,45235,4473,4434,63,4497,88
2021-12-05,Colusa,011,21464,2630,2615,681,3296,21
2021-12-05,Contra Costa,013,1133247,102917,102251,2375,104626,1058
2021-12-05,Del Norte,015,27424,3800,3751,56,3807,42
2021-12-05,El Dorado,017,186661,16918,16717,1783,18500,168
2021-12-05,Fresno,019,978130,146993,145452,13342,158794,2284
2021-12-05,Glenn,021,27897,3606,3577,1048,4625,36
2021-12-05,Humboldt,023,135768,9760,9662,692,10354,117
2021-12-05,Imperial,025,180216,35864,35422,3757,39179,778
2021-12-05,Inyo,027,18085,2588,2559,41,2600,46
2021-12-05,Kern,029,883053,133422,132286,24183,156469,1833
2021-12-05,Kings,031,150075,33751,33360,2063,35423,369
2021-12-05,Lake,033,64148,6969,6919,161,7080,113
2021-12-05,Lassen,035,31185,7083,7031,426,7457,51
2021-12-05,Los Angeles,037,10098052,1478553,1468937,57253,1526190,26991
2021-12-05,Madera,039,155013,24518,24311,2336,26647,307
2021-12-05,Marin,041,260295,18408,18216,534,18750,249
2021-12-05,Mariposa,043,17540,1461,1440,61,1501,6
2021-12-05,Mendocino,045,87422,8194,8069,678,8747,95
2021-12-05,Merced,047,269075,43653,43534,2160,45694,672
2021-12-05,Modoc,049,8938,599,593,203,796,6
2021-12-05,Mono,051,14174,1928,1907,23,1930,4
2021-12-05,Monterey,053,433212,50143,48813,3292,52105,626
2021-12-05,Napa,055,140530,13457,13382,124,13506,107
2021-12-05,Nevada,057,99092,9909,9827,350,10177,105
2021-12-05,Orange,059,3164182,316866,314560,16287,330847,5771
2021-12-05,Placer,061,380077,39137,38738,3923,42661,473
2021-12-05,Plumas,063,18699,1970,1913,46,1959,9
2021-12-05,Riverside,065,2383286,378329,373827,16886,390713,5388
2021-12-05,Sacramento,067,1510023,165889,164721,5029,169750,2367
2021-12-05,San Benito,069,59416,7789,7748,185,7933,78
2021-12-05,San Bernardino,071,2135413,369544,366282,11793,378075,5998
2021-12-05,San Diego,073,3302833,392607,387979,22872,410851,4351
2021-12-05,San Francisco,075,870044,55309,54603,2480,57083,674
2021-12-05,San Joaquin,077,732212,103361,102698,5689,108387,1837
2021-12-05,San Luis Obispo,079,281455,30823,30454,1354,31808,360
2021-12-05,San Mateo,081,765935,56314,55050,989,56039,580
2021-12-05,Santa Barbara,083,443738,46393,46097,1639,47736,555
2021-12-05,Santa Clara,085,1922200,153599,152114,1648,153762,1933
2021-12-05,Santa Cruz,087,273765,21662,21424,1047,22471,224
2021-12-05,Shasta,089,179085,22688,22550,3733,26283,416
2021-12-05,Sierra,091,2930,200,198,21,219,0
2021-12-05,Siskiyou,093,43540,3470,3409,1371,4780,57
2021-12-05,Solano,095,438530,47413,46715,1360,48075,360
2021-12-05,Sonoma,097,501317,43416,43038,575,43613,405
2021-12-05,Stanislaus,099,539301,81557,81847,9318,91165,1241
2021-12-05,Sutter,101,95872,14316,14303,404,14707,186
2021-12-05,Tehama,103,63373,8833,8755,1559,10314,133
2021-12-05,Trinity,105,12862,909,815,227,1042,17
2021-12-05,Tulare,107,460477,71351,70254,16399,86653,1102
2021-12-05,Tuolumne,109,53932,7735,7718,111,7829,91
2021-12-05,Ventura,111,848112,101167,100367,4480,104847,1194
2021-12-05,Yolo,113,214977,20665,20512,1270,21782,263
2021-12-05,Yuba,115,75493,10551,10467,385,10852,91
2021-12-04,Alameda,001,1643700,123875,122508,2985,125493,1494
2021-12-04,Alpine,003,1148,105,108,0,108,0
2021-12-04,Amador,005,37829,5788,5729,72,5801,67
2021-12-04,Butte,007,227075,21919,21638,3918,25556,318
2021-12-04,Calaveras,009,45235,4465,4392,62,4454,88
2021-12-04,Colusa,011,21464,2630,2600,679,3279,21
2021-12-04,Contra Costa,013,1133247,102845,101824,2369,104193,1056
2021-12-04,Del Norte,015,27424,3797,3726,56,3782,42
2021-12-04,El Dorado,017,186661,16909,16621,1782,18403,168
2021-12-04,Fresno,019,978130,146905,144734,13333,158067,2270
2021-12-04,Glenn,021,27897,3606,3559,1048,4607,36
2021-12-04,Humboldt,023,135768,9745,9596,688,10284,117
2021-12-04,Imperial,025,180216,35809,35206,3744,38950,776
2021-12-04,Inyo,027,18085,2583,2538,41,2579,46
2021-12-04,Kern,029,883053,133341,131771,24160,155931,1817
2021-12-04,Kings,031,150075,33727,33183,2062,35245,367
2021-12-04,Lake,033,64148,6960,6903,161,7064,113
2021-12-04,Lassen,035,31185,7082,7014,424,7438,51
2021-12-04,Los Angeles,037,10098052,1477678,1463270,57174,1520444,26952
2021-12-04,Madera,039,155013,24504,24188,2332,26520,307
2021-12-04,Marin,041,260295,18386,18075,533,18608,249
2021-12-04,Mariposa,043,17540,1457,1421,61,1482,6
2021-12-04,Mendocino,045,87422,8189,7981,678,8659,91
2021-12-04,Merced,047,269075,43626,43337,2158,45495,671
2021-12-04,Modoc,049,8938,599,591,203,794,6
2021-12-04,Mono,051,14174,1928,1883,23,1906,4
2021-12-04,Monterey,053,433212,50112,48682,3285,51967,626
2021-12-04,Napa,055,140530,13447,13327,123,13450,106
2021-12-04,Nevada,057,99092,9901,9752,350,10102,105
2021-12-04,Orange,059,3164182,316636,313112,16261,329373,5748
2021-12-04,Placer,061,380077,39097,38460,3917,42377,473
2021-12-04,Plumas,063,18699,1967,1903,46,1949,7
2021-12-04,Riverside,065,2383286,377970,371768,16880,388648,5381
2021-12-04,Sacramento,067,1510023,165746,163900,5021,168921,2365
2021-12-04,San Benito,069,59416,7763,7688,185,7873,78
2021-12-04,San Bernardino,071,2135413,369158,364154,11779,375933,5983
2021-12-04,San Diego,073,3302833,392128,386710,22842,409552,4350
2021-12-04,San Francisco,075,870044,55241,54286,2477,56763,674
2021-12-04,San Joaquin,077,732212,103307,102286,5687,107973,1835
2021-12-04,San Luis Obispo,079,281455,30802,30318,1350,31668,360
2021-12-04,San Mateo,081,765935,56264,54774,986,55760,579
2021-12-04,Santa Barbara,083,443738,46348,45774,1639,47413,555
2021-12-04,Santa Clara,085,1922200,153445,151275,1634,152909,1928
2021-12-04,Santa Cruz,087,273765,21636,21286,1046,22332,224
2021-12-04,Shasta,089,179085,22671,22418,3731,26149,414
2021-12-04,Sierra,091,2930,200,196,21,217,0
2021-12-04,Siskiyou,093,43540,3468,3398,1371,4769,57
2021-12-04,Solano,095,438530,47393,46529,1359,47888,360
2021-12-04,Sonoma,097,501317,43371,42778,572,43350,405
2021-12-04,Stanislaus,099,539301,81485,81462,9311,90773,1231
2021-12-04,Sutter,101,95872,14308,14258,403,14661,186
2021-12-04,Tehama,103,63373,8831,8742,1559,10301,131
2021-12-04,Trinity,105,12862,908,801,227,1028,17
2021-12-04,Tulare,107,460477,71314,70014,16371,86385,1100
2021-12-04,Tuolumne,109,53932,7730,7676,111,7787,91
2021-12-04,Ventura,111,848112,101076,99751,4476,104227,1192
2021-12-04,Yolo,113,214977,20642,20442,1267,21709,261
2021-12-04,Yuba,115,75493,10540,10418,384,10802,91
2021-12-03,Alameda,001,1643700,123782,122508,2975,125483,1494
2021-12-03,Alpine,003,1148,105,108,0,108,0
2021-12-03,Amador,005,37829,5783,5729,71,5800,67
2021-12-03,Butte,007,227075,21906,21638,3913,25551,318
2021-12-03,Calaveras,009,45235,4456,4392,62,4454,88
2021-12-03,Colusa,011,21464,2628,2600,679,3279,21
2021-12-03,Contra Costa,013,1133247,102772,101824,2364,104188,1056
2021-12-03,Del Norte,015,27424,3795,3726,56,3782,42
2021-12-03,El Dorado,017,186661,16880,16621,1780,18401,168
2021-12-03,Fresno,019,978130,146791,144734,13330,158064,2270
2021-12-03,Glenn,021,27897,3605,3559,1047,4606,36
2021-12-03,Humboldt,023,135768,9728,9596,686,10282,117
2021-12-03,Imperial,025,180216,35765,35206,3714,38920,776
2021-12-03,Inyo,027,18085,2576,2538,41,2579,46
2021-12-03,Kern,029,883053,133270,131771,24124,155895,1817
2021-12-03,Kings,031,150075,33699,33183,2062,35245,367
2021-12-03,Lake,033,64148,6960,6903,161,7064,113
2021-12-03,Lassen,035,31185,7080,7014,423,7437,51
2021-12-03,Los Angeles,037,10098052,1476735,1463270,57093,1520363,26952
2021-12-03,Madera,039,155013,24478,24188,2328,26516,307
2021-12-03,Marin,041,260295,18354,18075,529,18604,249
2021-12-03,Mariposa,043,17540,1455,1421,61,1482,6
2021-12-03,Mendocino,045,87422,8182,7981,678,8659,91
2021-12-03,Merced,047,269075,43603,43337,2155,45492,671
2021-12-03,Modoc,049,8938,599,591,203,794,6
2021-12-03,Mono,051,14174,1922,1883,23,1906,4
2021-12-03,Monterey,053,433212,50073,48682,3274,51956,626
2021-12-03,Napa,055,140530,13435,13327,123,13450,106
2021-12-03,Nevada,057,99092,9890,9752,350,10102,105
2021-12-03,Orange,059,3164182,316367,313112,16229,329341,5748
2021-12-03,Placer,061,380077,39060,38460,3910,42370,473
2021-12-03,Plumas,063,18699,1964,1903,46,1949,7
2021-12-03,Riverside,065,2383286,377579,371768,16874,388642,5381
2021-12-03,Sacramento,067,1510023,165566,163900,5007,168907,2365
2021-12-03,San Benito,069,59416,7756,7688,185,7873,78
2021-12-03,San Bernardino,071,2135413,368714,364154,11769,375923,5983
2021-12-03,San Diego,073,3302833,391653,386710,22818,409528,4350
2021-12-03,San Francisco,075,870044,55171,54286,2473,56759,674
2021-12-03,San Joaquin,077,732212,103250,102286,5686,107972,1835
2021-12-03,San Luis Obispo,079,281455,30776,30318,1347,31665,360
2021-12-03,San Mateo,081,765935,56200,54774,983,55757,579
2021-12-03,Santa Barbara,083,443738,46312,45774,1639,47413,555
2021-12-03,Santa Clara,085,1922200,153263,151275,1619,152894,1928
2021-12-03,Santa Cruz,087,273765,21609,21286,1046,22332,224
2021-12-03,Shasta,089,179085,22656,22418,3731,26149,414
2021-12-03,Sierra,091,2930,200,196,21,217,0
2021-12-03,Siskiyou,093,43540,3465,3398,1369,4767,57
2021-12-03,Solano,095,438530,47351,46529,1358,47887,360
2021-12-03,Sonoma,097,501317,43335,42778,570,43348,405
2021-12-03,Stanislaus,099,539301,81428,81462,9302,90764,1231
2021-12-03,Sutter,101,95872,14295,14258,401,14659,186
2021-12-03,Tehama,103,63373,8830,8742,1558,10300,131
2021-12-03,Trinity,105,12862,908,801,227,1028,17
2021-12-03,Tulare,107,460477,71275,70014,16338,86352,1100
2021-12-03,Tuolumne,109,53932,7721,7676,111,7787,91
2021-12-03,Ventura,111,848112,100988,99751,4469,104220,1192
2021-12-03,Yolo,113,214977,20625,20442,1266,21708,261
2021-12-03,Yuba,115,75493,10532,10418,384,10802,91
2021-12-02,Alameda,001,1643700,123627,122508,2967,125475,1494
2021-12-02,Alpine,003,1148,105,108,0,108,0
2021-12-02,Amador,005,37829,5778,5729,70,5799,67
2021-12-02,Butte,007,227075,21881,21638,3910,25548,318
2021-12-02,Calaveras,009,45235,4446,4392,61,4453,88
2021-12-02,Colusa,011,21464,2627,2600,679,3279,21
2021-12-02,Contra Costa,013,1133247,102657,101824,2360,104184,1056
2021-12-02,Del Norte,015,27424,3787,3726,56,3782,42
2021-12-02,El Dorado,017,186661,16859,16621,1778,18399,168
2021-12-02,Fresno,019,978130,146624,144734,13318,158052,2270
2021-12-02,Glenn,021,27897,3605,3559,1044,4603,36
2021-12-02,Humboldt,023,135768,9709,9596,684,10280,117
2021-12-02,Imperial,025,180216,35698,35206,3691,38897,776
2021-12-02,Inyo,027,18085,2571,2538,41,2579,46
2021-12-02,Kern,029,883053,133099,131771,24071,155842,1817
2021-12-02,Kings,031,150075,33644,33183,2060,35243,367
2021-12-02,Lake,033,64148,6956,6903,161,7064,113
2021-12-02,Lassen,035,31185,7076,7014,423,7437,51
2021-12-02,Los Angeles,037,10098052,1475213,1463270,57008,1520278,26952
2021-12-02,Madera,039,155013,24441,24188,2319,26507,307
2021-12-02,Marin,041,260295,18324,18075,525,18600,249
2021-12-02,Mariposa,043,17540,1453,1421,61,1482,6
2021-12-02,Mendocino,045,87422,8166,7981,677,8658,91
2021-12-02,Merced,047,269075,43557,43337,2150,45487,671
2021-12-02,Modoc,049,8938,598,591,203,794,6
2021-12-02,Mono,051,14174,1916,1883,23,1906,4
2021-12-02,Monterey,053,433212,49998,48682,3252,51934,626
2021-12-02,Napa,055,140530,13422,13327,123,13450,106
2021-12-02,Nevada,057,99092,9872,9752,349,10101,105
2021-12-02,Orange,059,3164182,316024,313112,16192,329304,5748
2021-12-02,Placer,061,380077,38995,38460,3905,42365,473
2021-12-02,Plumas,063,18699,1961,1903,46,1949,7
2021-12-02,Riverside,065,2383286,377052,371768,16864,388632,5381
2021-12-02,Sacramento,067,1510023,165337,163900,4997,168897,2365
2021-12-02,San Benito,069,59416,7736,7688,185,7873,78
2021-12-02,San Bernardino,071,2135413,368166,364154,11749,375903,5983
2021-12-02,San Diego,073,3302833,391008,386710,22763,409473,4350
2021-12-02,San Francisco,075,870044,55076,54286,2468,56754,674
2021-12-02,San Joaquin,077,732212,103136,102286,5681,107967,1835
2021-12-02,San Luis Obispo,079,281455,30743,30318,1340,31658,360
2021-12-02,San Mateo,081,765935,56119,54774,975,55749,579
2021-12-02,Santa Barbara,083,443738,46231,45774,1636,47410,555
2021-12-02,Santa Clara,085,1922200,153017,151275,1602,152877,1928
2021-12-02,Santa Cruz,087,273765,21558,21286,1045,22331,224
2021-12-02,Shasta,089,179085,22623,22418,3730,26148,414
2021-12-02,Sierra,091,2930,200,196,21,217,0
2021-12-02,Siskiyou,093,43540,3464,3398,1362,4760,57
2021-12-02,Solano,095,438530,47300,46529,1356,47885,360
2021-12-02,Sonoma,097,501317,43262,42778,570,43348,405
2021-12-02,Stanislaus,099,539301,81336,81462,9294,90756,1231
2021-12-02,Sutter,101,95872,14282,14258,398,14656,186
2021-12-02,Tehama,103,63373,8823,8742,1556,10298,131
2021-12-02,Trinity,105,12862,908,801,227,1028,17
2021-12-02,Tulare,107,460477,71188,70014,16286,86300,1100
2021-12-02,Tuolumne,109,53932,7706,7676,110,7786,91
2021-12-02,Ventura,111,848112,100863,99751,4467,104218,1192
2021-12-02,Yolo,113,214977,20601,20442,1262,21704,261
2021-12-02,Yuba,115,75493,10516,10418,381,10799,91
2021-12-01,Alameda,001,1643700,123476,122298,2957,125255,1492
2021-12-01,Alpine,003,1148,105,108,0,108,0
2021-12-01,Amador,005,37829,5771,5723,70,5793,67
2021-12-01,Butte,007,227075,21862,21600,3905,25505,318
2021-12-01,Calaveras,009,45235,4441,4371,61,4432,88
2021-12-01,Colusa,011,21464,2620,2595,676,3271,20
2021-12-01,Contra Costa,013,1133247,102549,101651,2349,104000,1048
2021-12-01,Del Norte,015,27424,3785,3722,56,3778,42
2021-12-01,El Dorado,017,186661,16838,16575,1776,18351,166
2021-12-01,Fresno,019,978130,146415,144507,13310,157817,2264
2021-12-01,Glenn,021,27897,3598,3556,1043,4599,36
2021-12-01,Humboldt,023,135768,9685,9573,679,10252,117
2021-12-01,Imperial,025,180216,35618,35085,3664,38749,776
2021-12-01,Inyo,027,18085,2567,2533,41,2574,46
2021-12-01,Kern,029,883053,132952,131580,24016,155596,1804
2021-12-01,Kings,031,150075,33595,33112,2059,35171,364
2021-12-01,Lake,033,64148,6948,6896,160,7056,112
2021-12-01,Lassen,035,31185,7070,7008,421,7429,51
2021-12-01,Los Angeles,037,10098052,1473616,1461394,56913,1518307,26928
2021-12-01,Madera,039,155013,24409,24134,2310,26444,307
2021-12-01,Marin,041,260295,18287,18038,519,18557,249
2021-12-01,Mariposa,043,17540,1449,1415,61,1476,6
2021-12-01,Mendocino,045,87422,8152,7966,672,8638,90
2021-12-01,Merced,047,269075,43501,43259,2129,45388,670
2021-12-01,Modoc,049,8938,598,576,203,779,5
2021-12-01,Mono,051,14174,1911,1876,23,1899,4
2021-12-01,Monterey,053,433212,49948,48611,3243,51854,626
2021-12-01,Napa,055,140530,13405,13319,120,13439,107
2021-12-01,Nevada,057,99092,9859,9706,349,10055,105
2021-12-01,Orange,059,3164182,315660,312772,16154,328926,5735
2021-12-01,Placer,061,380077,38939,38373,3899,42272,472
2021-12-01,Plumas,063,18699,1957,1893,46,1939,7
2021-12-01,Riverside,065,2383286,376528,371189,16847,388036,5369
2021-12-01,Sacramento,067,1510023,165123,163616,4978,168594,2360
2021-12-01,San Benito,069,59416,7722,7669,185,7854,78
2021-12-01,San Bernardino,071,2135413,367586,363368,11723,375091,5973
2021-12-01,San Diego,073,3302833,390211,386056,22708,408764,4346
2021-12-01,San Francisco,075,870044,54994,54199,2461,56660,672
2021-12-01,San Joaquin,077,732212,103028,102109,5680,107789,1834
2021-12-01,San Luis Obispo,079,281455,30701,30238,1336,31574,360
2021-12-01,San Mateo,081,765935,56038,54711,972,55683,579
2021-12-01,Santa Barbara,083,443738,46161,45681,1634,47315,554
2021-12-01,Santa Clara,085,1922200,152798,150961,1585,152546,1925
2021-12-01,Santa Cruz,087,273765,21528,21191,1044,22235,224
2021-12-01,Shasta,089,179085,22591,22375,3724,26099,410
2021-12-01,Sierra,091,2930,200,195,21,216,0
2021-12-01,Siskiyou,093,43540,3461,3391,1362,4753,55
2021-12-01,Solano,095,438530,47256,46485,1356,47841,360
2021-12-01,Sonoma,097,501317,43187,42713,569,43282,405
2021-12-01,Stanislaus,099,539301,81242,81330,9282,90612,1231
2021-12-01,Sutter,101,95872,14267,14229,397,14626,186
2021-12-01,Tehama,103,63373,8813,8728,1556,10284,130
2021-12-01,Trinity,105,12862,903,801,227,1028,17
2021-12-01,Tulare,107,460477,71112,69953,16246,86199,1098
2021-12-01,Tuolumne,109,53932,7698,7655,110,7765,91
2021-12-01,Ventura,111,848112,100757,99680,4456,104136,1191
2021-12-01,Yolo,113,214977,20573,20393,1262,21655,260
2021-12-01,Yuba,115,75493,10505,10401,380,10781,89
2021-11-30,Alameda,001,1643700,123305,122196,2948,125144,1489
2021-11-30,Alpine,003,1148,105,108,0,108,0
2021-11-30,Amador,005,37829,5763,5716,70,5786,66
2021-11-30,Butte,007,227075,21833,21565,3896,25461,318
2021-11-30,Calaveras,009,45235,4423,4360,61,4421,88
2021-11-30,Colusa,011,21464,2619,2592,676,3268,21
2021-11-30,Contra Costa,013,1133247,102411,101538,2342,103880,1046
2021-11-30,Del Norte,015,27424,3779,3718,56,3774,42
2021-11-30,El Dorado,017,186661,16810,16558,1770,18328,166
2021-11-30,Fresno,019,978130,146215,144384,13302,157686,2259
2021-11-30,Glenn,021,27897,3593,3555,1042,4597,36
2021-11-30,Humboldt,023,135768,9654,9539,673,10212,116
2021-11-30,Imperial,025,180216,35510,34999,3636,38635,773
2021-11-30,Inyo,027,18085,2558,2530,41,2571,46
2021-11-30,Kern,029,883053,132778,131451,23959,155410,1799
2021-11-30,Kings,031,150075,33544,33074,2055,35129,362
2021-11-30,Lake,033,64148,6943,6892,158,7050,110
2021-11-30,Lassen,035,31185,7066,7003,420,7423,51
2021-11-30,Los Angeles,037,10098052,1471821,1460177,56807,1516984,26913
2021-11-30,Madera,039,155013,24375,24108,2305,26413,307
2021-11-30,Marin,041,260295,18243,18010,517,18527,249
2021-11-30,Mariposa,043,17540,1443,1412,61,1473,6
2021-11-30,Mendocino,045,87422,8123,7960,666,8626,89
2021-11-30,Merced,047,269075,43431,43200,2121,45321,668
2021-11-30,Modoc,049,8938,597,576,203,779,5
2021-11-30,Mono,051,14174,1908,1873,23,1896,4
2021-11-30,Monterey,053,433212,49884,48581,3233,51814,626
2021-11-30,Napa,055,140530,13385,13308,120,13428,105
2021-11-30,Nevada,057,99092,9843,9699,348,10047,105
2021-11-30,Orange,059,3164182,315240,312451,16112,328563,5724
2021-11-30,Placer,061,380077,38836,38324,3891,42215,470
2021-11-30,Plumas,063,18699,1952,1887,45,1932,7
2021-11-30,Riverside,065,2383286,375842,370739,16822,387561,5358
2021-11-30,Sacramento,067,1510023,164842,163420,4956,168376,2353
2021-11-30,San Benito,069,59416,7700,7645,184,7829,78
2021-11-30,San Bernardino,071,2135413,366915,363006,11701,374707,5967
2021-11-30,San Diego,073,3302833,389285,385405,22661,408066,4340
2021-11-30,San Francisco,075,870044,54887,54147,2452,56599,672
2021-11-30,San Joaquin,077,732212,102902,101972,5672,107644,1834
2021-11-30,San Luis Obispo,079,281455,30676,30200,1333,31533,360
2021-11-30,San Mateo,081,765935,55933,54656,962,55618,579
2021-11-30,Santa Barbara,083,443738,46065,45628,1628,47256,553
2021-11-30,Santa Clara,085,1922200,152537,150799,1567,152366,1929
2021-11-30,Santa Cruz,087,273765,21470,21169,1040,22209,224
2021-11-30,Shasta,089,179085,22561,22347,3721,26068,401
2021-11-30,Sierra,091,2930,197,195,21,216,0
2021-11-30,Siskiyou,093,43540,3457,3385,1359,4744,55
2021-11-30,Solano,095,438530,47193,46434,1350,47784,358
2021-11-30,Sonoma,097,501317,43108,42663,568,43231,405
2021-11-30,Stanislaus,099,539301,81142,81276,9255,90531,1227
2021-11-30,Sutter,101,95872,14256,14210,394,14604,186
2021-11-30,Tehama,103,63373,8806,8727,1555,10282,130
2021-11-30,Trinity,105,12862,902,799,227,1026,17
2021-11-30,Tulare,107,460477,71026,69900,16196,86096,1099
2021-11-30,Tuolumne,109,53932,7683,7643,110,7753,91
2021-11-30,Ventura,111,848112,100604,99601,4444,104045,1191
2021-11-30,Yolo,113,214977,20531,20376,1256,21632,260
2021-11-30,Yuba,115,75493,10486,10398,375,10773,89
2021-11-29,Alameda,001,1643700,123148,122136,2940,125076,1489
2021-11-29,Alpine,003,1148,105,108,0,108,0
2021-11-29,Amador,005,37829,5756,5706,70,5776,66
2021-11-29,Butte,007,227075,21808,21544,3890,25434,314
2021-11-29,Calaveras,009,45235,4407,4353,61,4414,88
2021-11-29,Colusa,011,21464,2617,2585,673,3258,20
2021-11-29,Contra Costa,013,1133247,102263,101441,2334,103775,1046
2021-11-29,Del Norte,015,27424,3776,3704,56,3760,42
2021-11-29,El Dorado,017,186661,16792,16534,1765,18299,166
2021-11-29,Fresno,019,978130,146009,144282,13279,157561,2254
2021-11-29,Glenn,021,27897,3590,3555,1041,4596,36
2021-11-29,Humboldt,023,135768,9637,9514,666,10180,115
2021-11-29,Imperial,025,180216,35446,34960,3615,38575,773
2021-11-29,Inyo,027,18085,2553,2529,41,2570,46
2021-11-29,Kern,029,883053,132594,131362,23917,155279,1789
2021-11-29,Kings,031,150075,33492,33059,2051,35110,363
2021-11-29,Lake,033,64148,6931,6889,158,7047,110
2021-11-29,Lassen,035,31185,7063,7003,418,7421,51
2021-11-29,Los Angeles,037,10098052,1469963,1459446,56720,1516166,26889
2021-11-29,Madera,039,155013,24339,24069,2297,26366,307
2021-11-29,Marin,041,260295,18196,17980,512,18492,249
2021-11-29,Mariposa,043,17540,1435,1409,61,1470,6
2021-11-29,Mendocino,045,87422,8106,7954,662,8616,89
2021-11-29,Merced,047,269075,43357,43167,2113,45280,667
2021-11-29,Modoc,049,8938,596,569,203,772,5
2021-11-29,Mono,051,14174,1891,1859,23,1882,4
2021-11-29,Monterey,053,433212,49823,48548,3217,51765,626
2021-11-29,Napa,055,140530,13375,13304,120,13424,104
2021-11-29,Nevada,057,99092,9829,9689,348,10037,105
2021-11-29,Orange,059,3164182,314839,312203,16066,328269,5709
2021-11-29,Placer,061,380077,38771,38261,3886,42147,470
2021-11-29,Plumas,063,18699,1949,1884,45,1929,7
2021-11-29,Riverside,065,2383286,375306,370334,16811,387145,5358
2021-11-29,Sacramento,067,1510023,164593,163282,4923,168205,2342
2021-11-29,San Benito,069,59416,7681,7631,183,7814,77
2021-11-29,San Bernardino,071,2135413,366315,362694,11669,374363,5962
2021-11-29,San Diego,073,3302833,388395,384853,22627,407480,4335
2021-11-29,San Francisco,075,870044,54789,54125,2448,56573,669
2021-11-29,San Joaquin,077,732212,102763,101927,5665,107592,1834
2021-11-29,San Luis Obispo,079,281455,30642,30165,1329,31494,359
2021-11-29,San Mateo,081,765935,55830,54622,958,55580,579
2021-11-29,Santa Barbara,083,443738,45968,45576,1624,47200,549
2021-11-29,Santa Clara,085,1922200,152265,150620,1561,152181,1925
2021-11-29,Santa Cruz,087,273765,21433,21149,1039,22188,224
2021-11-29,Shasta,089,179085,22527,22315,3717,26032,399
2021-11-29,Sierra,091,2930,197,195,21,216,0
2021-11-29,Siskiyou,093,43540,3454,3374,1352,4726,55
2021-11-29,Solano,095,438530,47141,46412,1348,47760,357
2021-11-29,Sonoma,097,501317,43032,42624,565,43189,405
2021-11-29,Stanislaus,099,539301,81062,81227,9237,90464,1223
2021-11-29,Sutter,101,95872,14240,14204,391,14595,186
2021-11-29,Tehama,103,63373,8801,8720,1550,10270,130
2021-11-29,Trinity,105,12862,897,798,227,1025,17
2021-11-29,Tulare,107,460477,70947,69850,16162,86012,1096
2021-11-29,Tuolumne,109,53932,7670,7627,110,7737,90
2021-11-29,Ventura,111,848112,100484,99520,4434,103954,1190
2021-11-29,Yolo,113,214977,20487,20344,1253,21597,257
2021-11-29,Yuba,115,75493,10469,10395,374,10769,89
2021-11-28,Alameda,001,1643700,122928,122082,2934,125016,1491
2021-11-28,Alpine,003,1148,105,108,0,108,0
2021-11-28,Amador,005,37829,5746,5703,70,5773,66
2021-11-28,Butte,007,227075,21769,21530,3888,25418,313
2021-11-28,Calaveras,009,45235,4385,4350,61,4411,88
2021-11-28,Colusa,011,21464,2613,2586,672,3258,19
2021-11-28,Contra Costa,013,1133247,102090,101355,2324,103679,1046
2021-11-28,Del Norte,015,27424,3771,3703,56,3759,42
2021-11-28,El Dorado,017,186661,16751,16527,1764,18291,166
2021-11-28,Fresno,019,978130,145764,144164,13254,157418,2252
2021-11-28,Glenn,021,27897,3587,3547,1039,4586,36
2021-11-28,Humboldt,023,135768,9605,9499,662,10161,115
2021-11-28,Imperial,025,180216,35338,34929,3591,38520,773
2021-11-28,Inyo,027,18085,2546,2531,41,2572,46
2021-11-28,Kern,029,883053,132386,131279,23860,155139,1789
2021-11-28,Kings,031,150075,33418,33057,2044,35101,364
2021-11-28,Lake,033,64148,6921,6885,157,7042,110
2021-11-28,Lassen,035,31185,7055,7002,414,7416,51
2021-11-28,Los Angeles,037,10098052,1467791,1458646,56632,1515278,26878
2021-11-28,Madera,039,155013,24291,24055,2290,26345,307
2021-11-28,Marin,041,260295,18147,17962,508,18470,249
2021-11-28,Mariposa,043,17540,1431,1406,61,1467,6
2021-11-28,Mendocino,045,87422,8076,7943,657,8600,89
2021-11-28,Merced,047,269075,43291,43166,2098,45264,667
2021-11-28,Modoc,049,8938,595,569,203,772,5
2021-11-28,Mono,051,14174,1885,1841,23,1864,4
2021-11-28,Monterey,053,433212,49758,48537,3198,51735,626
2021-11-28,Napa,055,140530,13362,13303,120,13423,104
2021-11-28,Nevada,057,99092,9802,9684,347,10031,105
2021-11-28,Orange,059,3164182,314455,312028,16023,328051,5693
2021-11-28,Placer,061,380077,38690,38240,3867,42107,470
2021-11-28,Plumas,063,18699,1943,1884,44,1928,7
2021-11-28,Riverside,065,2383286,374648,370051,16789,386840,5358
2021-11-28,Sacramento,067,1510023,164237,163170,4900,168070,2335
2021-11-28,San Benito,069,59416,7662,7623,182,7805,77
2021-11-28,San Bernardino,071,2135413,365595,362407,11641,374048,5958
2021-11-28,San Diego,073,3302833,387504,383025,22563,405588,4325
2021-11-28,San Francisco,075,870044,54713,54082,2443,56525,669
2021-11-28,San Joaquin,077,732212,102582,101895,5648,107543,1834
2021-11-28,San Luis Obispo,079,281455,30578,30152,1325,31477,358
2021-11-28,San Mateo,081,765935,55736,54567,954,55521,579
2021-11-28,Santa Barbara,083,443738,45889,45551,1613,47164,549
2021-11-28,Santa Clara,085,1922200,151962,150436,1546,151982,1920
2021-11-28,Santa Cruz,087,273765,21361,21110,1038,22148,224
2021-11-28,Shasta,089,179085,22487,22316,3715,26031,400
2021-11-28,Sierra,091,2930,197,195,21,216,0
2021-11-28,Siskiyou,093,43540,3448,3372,1348,4720,55
2021-11-28,Solano,095,438530,47079,46385,1347,47732,356
2021-11-28,Sonoma,097,501317,42946,42583,562,43145,405
2021-11-28,Stanislaus,099,539301,80944,81181,9217,90398,1223
2021-11-28,Sutter,101,95872,14218,14192,385,14577,186
2021-11-28,Tehama,103,63373,8793,8720,1546,10266,130
2021-11-28,Trinity,105,12862,896,797,227,1024,17
2021-11-28,Tulare,107,460477,70850,69833,16109,85942,1095
2021-11-28,Tuolumne,109,53932,7649,7620,110,7730,90
2021-11-28,Ventura,111,848112,100328,99486,4423,103909,1190
2021-11-28,Yolo,113,214977,20444,20333,1252,21585,257
2021-11-28,Yuba,115,75493,10451,10391,372,10763,89
2021-11-27,Alameda,001,1643700,122831,121618,2931,124549,1477
2021-11-27,Alpine,003,1148,105,106,0,106,0
2021-11-27,Amador,005,37829,5745,5670,70,5740,66
2021-11-27,Butte,007,227075,21746,21384,3883,25267,309
2021-11-27,Calaveras,009,45235,4379,4294,61,4355,85
2021-11-27,Colusa,011,21464,2612,2568,670,3238,19
2021-11-27,Contra Costa,013,1133247,102005,100961,2323,103284,1045
2021-11-27,Del Norte,015,27424,3764,3661,56,3717,42
2021-11-27,El Dorado,017,186661,16716,16399,1763,18162,161
2021-11-27,Fresno,019,978130,145652,143386,13248,156634,2246
2021-11-27,Glenn,021,27897,3583,3532,1038,4570,36
2021-11-27,Humboldt,023,135768,9577,9399,660,10059,115
2021-11-27,Imperial,025,180216,35255,34611,3575,38186,769
2021-11-27,Inyo,027,18085,2543,2506,41,2547,45
2021-11-27,Kern,029,883053,132302,130245,23831,154076,1773
2021-11-27,Kings,031,150075,33395,32891,2041,34932,358
2021-11-27,Lake,033,64148,6918,6836,156,6992,110
2021-11-27,Lassen,035,31185,7053,6959,413,7372,47
2021-11-27,Los Angeles,037,10098052,1466782,1454495,56562,1511057,26817
2021-11-27,Madera,039,155013,24271,23880,2285,26165,296
2021-11-27,Marin,041,260295,18109,17857,503,18360,248
2021-11-27,Mariposa,043,17540,1429,1374,61,1435,6
2021-11-27,Mendocino,045,87422,8057,7871,657,8528,89
2021-11-27,Merced,047,269075,43256,42921,2095,45016,664
2021-11-27,Modoc,049,8938,593,551,203,754,5
2021-11-27,Mono,051,14174,1883,1810,23,1833,4
2021-11-27,Monterey,053,433212,49725,48400,3184,51584,625
2021-11-27,Napa,055,140530,13348,13256,120,13376,104
2021-11-27,Nevada,057,99092,9780,9584,346,9930,103
2021-11-27,Orange,059,3164182,314203,310809,15986,326795,5665
2021-11-27,Placer,061,380077,38629,38001,3861,41862,468
2021-11-27,Plumas,063,18699,1939,1860,44,1904,7
2021-11-27,Riverside,065,2383286,374290,367601,16782,384383,5306
2021-11-27,Sacramento,067,1510023,164080,162328,4897,167225,2335
2021-11-27,San Benito,069,59416,7645,7575,182,7757,77
2021-11-27,San Bernardino,071,2135413,365162,360033,11632,371665,5932
2021-11-27,San Diego,073,3302833,387002,382634,22537,405171,4319
2021-11-27,San Francisco,075,870044,54663,53830,2440,56270,669
2021-11-27,San Joaquin,077,732212,102515,101368,5645,107013,1833
2021-11-27,San Luis Obispo,079,281455,30543,29983,1321,31304,358
2021-11-27,San Mateo,081,765935,55679,54360,951,55311,577
2021-11-27,Santa Barbara,083,443738,45835,45318,1611,46929,548
2021-11-27,Santa Clara,085,1922200,151755,149700,1539,151239,1922
2021-11-27,Santa Cruz,087,273765,21321,20929,1035,21964,222
2021-11-27,Shasta,089,179085,22464,22151,3714,25865,396
2021-11-27,Sierra,091,2930,196,194,21,215,0
2021-11-27,Siskiyou,093,43540,3445,3336,1346,4682,54
2021-11-27,Solano,095,438530,47043,46163,1344,47507,356
2021-11-27,Sonoma,097,501317,42883,42368,562,42930,405
2021-11-27,Stanislaus,099,539301,80876,80782,9199,89981,1220
2021-11-27,Sutter,101,95872,14210,14127,384,14511,181
2021-11-27,Tehama,103,63373,8791,8675,1545,10220,129
2021-11-27,Trinity,105,12862,896,789,227,1016,17
2021-11-27,Tulare,107,460477,70798,69377,16093,85470,1082
2021-11-27,Tuolumne,109,53932,7636,7574,110,7684,90
2021-11-27,Ventura,111,848112,100255,99163,4416,103579,1188
2021-11-27,Yolo,113,214977,20423,20237,1243,21480,257
2021-11-27,Yuba,115,75493,10440,10335,372,10707,88
2021-11-26,Alameda,001,1643700,122719,121618,2929,124547,1477
2021-11-26,Alpine,003,1148,105,106,0,106,0
2021-11-26,Amador,005,37829,5741,5670,70,5740,66
2021-11-26,Butte,007,227075,21723,21384,3878,25262,309
2021-11-26,Calaveras,009,45235,4370,4294,61,4355,85
2021-11-26,Colusa,011,21464,2610,2568,669,3237,19
2021-11-26,Contra Costa,013,1133247,101918,100961,2319,103280,1045
2021-11-26,Del Norte,015,27424,3761,3661,56,3717,42
2021-11-26,El Dorado,017,186661,16699,16399,1760,18159,161
2021-11-26,Fresno,019,978130,145519,143386,13238,156624,2246
2021-11-26,Glenn,021,27897,3581,3532,1038,4570,36
2021-11-26,Humboldt,023,135768,9558,9399,656,10055,115
2021-11-26,Imperial,025,180216,35198,34611,3562,38173,769
2021-11-26,Inyo,027,18085,2543,2506,41,2547,45
2021-11-26,Kern,029,883053,132219,130245,23787,154032,1773
2021-11-26,Kings,031,150075,33371,32891,2039,34930,358
2021-11-26,Lake,033,64148,6916,6836,156,6992,110
2021-11-26,Lassen,035,31185,7047,6959,413,7372,47
2021-11-26,Los Angeles,037,10098052,1465930,1454495,56499,1510994,26817
2021-11-26,Madera,039,155013,24244,23880,2283,26163,296
2021-11-26,Marin,041,260295,18080,17857,503,18360,248
2021-11-26,Mariposa,043,17540,1423,1374,60,1434,6
2021-11-26,Mendocino,045,87422,8047,7871,657,8528,89
2021-11-26,Merced,047,269075,43226,42921,2090,45011,664
2021-11-26,Modoc,049,8938,591,551,203,754,5
2021-11-26,Mono,051,14174,1872,1810,23,1833,4
2021-11-26,Monterey,053,433212,49681,48400,3177,51577,625
2021-11-26,Napa,055,140530,13332,13256,120,13376,104
2021-11-26,Nevada,057,99092,9769,9584,346,9930,103
2021-11-26,Orange,059,3164182,313933,310809,15954,326763,5665
2021-11-26,Placer,061,380077,38584,38001,3853,41854,468
2021-11-26,Plumas,063,18699,1934,1860,44,1904,7
2021-11-26,Riverside,065,2383286,373889,367601,16775,384376,5306
2021-11-26,Sacramento,067,1510023,163968,162328,4892,167220,2335
2021-11-26,San Benito,069,59416,7637,7575,182,7757,77
2021-11-26,San Bernardino,071,2135413,364732,360033,11625,371658,5932
2021-11-26,San Diego,073,3302833,386445,382634,22525,405159,4319
2021-11-26,San Francisco,075,870044,54616,53830,2438,56268,669
2021-11-26,San Joaquin,077,732212,102458,101368,5644,107012,1833
2021-11-26,San Luis Obispo,079,281455,30501,29983,1318,31301,358
2021-11-26,San Mateo,081,765935,55616,54360,950,55310,577
2021-11-26,Santa Barbara,083,443738,45788,45318,1610,46928,548
2021-11-26,Santa Clara,085,1922200,151587,149700,1531,151231,1922
2021-11-26,Santa Cruz,087,273765,21281,20929,1035,21964,222
2021-11-26,Shasta,089,179085,22445,22151,3712,25863,396
2021-11-26,Sierra,091,2930,196,194,21,215,0
2021-11-26,Siskiyou,093,43540,3442,3336,1345,4681,54
2021-11-26,Solano,095,438530,47002,46163,1343,47506,356
2021-11-26,Sonoma,097,501317,42832,42368,560,42928,405
2021-11-26,Stanislaus,099,539301,80803,80782,9188,89970,1220
2021-11-26,Sutter,101,95872,14197,14127,383,14510,181
2021-11-26,Tehama,103,63373,8789,8675,1544,10219,129
2021-11-26,Trinity,105,12862,895,789,227,1016,17
2021-11-26,Tulare,107,460477,70752,69377,16061,85438,1082
2021-11-26,Tuolumne,109,53932,7626,7574,110,7684,90
2021-11-26,Ventura,111,848112,100175,99163,4411,103574,1188
2021-11-26,Yolo,113,214977,20404,20237,1235,21472,257
2021-11-26,Yuba,115,75493,10434,10335,372,10707,88
2021-11-25,Alameda,001,1643700,122611,121618,2924,124542,1477
2021-11-25,Alpine,003,1148,105,106,0,106,0
2021-11-25,Amador,005,37829,5733,5670,70,5740,66
2021-11-25,Butte,007,227075,21705,21384,3876,25260,309
2021-11-25,Calaveras,009,45235,4365,4294,61,4355,85
2021-11-25,Colusa,011,21464,2607,2568,667,3235,19
2021-11-25,Contra Costa,013,1133247,101814,100961,2315,103276,1045
2021-11-25,Del Norte,015,27424,3756,3661,56,3717,42
2021-11-25,El Dorado,017,186661,16680,16399,1759,18158,161
2021-11-25,Fresno,019,978130,145384,143386,13229,156615,2246
2021-11-25,Glenn,021,27897,3580,3532,1037,4569,36
2021-11-25,Humboldt,023,135768,9539,9399,653,10052,115
2021-11-25,Imperial,025,180216,35153,34611,3550,38161,769
2021-11-25,Inyo,027,18085,2541,2506,41,2547,45
2021-11-25,Kern,029,883053,132121,130245,23741,153986,1773
2021-11-25,Kings,031,150075,33343,32891,2038,34929,358
2021-11-25,Lake,033,64148,6909,6836,156,6992,110
2021-11-25,Lassen,035,31185,7045,6959,412,7371,47
2021-11-25,Los Angeles,037,10098052,1464947,1454495,56441,1510936,26817
2021-11-25,Madera,039,155013,24209,23880,2282,26162,296
2021-11-25,Marin,041,260295,18053,17857,498,18355,248
2021-11-25,Mariposa,043,17540,1420,1374,60,1434,6
2021-11-25,Mendocino,045,87422,8029,7871,657,8528,89
2021-11-25,Merced,047,269075,43187,42921,2084,45005,664
2021-11-25,Modoc,049,8938,590,551,203,754,5
2021-11-25,Mono,051,14174,1861,1810,23,1833,4
2021-11-25,Monterey,053,433212,49637,48400,3168,51568,625
2021-11-25,Napa,055,140530,13324,13256,120,13376,104
2021-11-25,Nevada,057,99092,9750,9584,343,9927,103
2021-11-25,Orange,059,3164182,313671,310809,15922,326731,5665
2021-11-25,Placer,061,380077,38538,38001,3847,41848,468
2021-11-25,Plumas,063,18699,1932,1860,44,1904,7
2021-11-25,Riverside,065,2383286,373475,367601,16768,384369,5306
2021-11-25,Sacramento,067,1510023,163788,162328,4886,167214,2335
2021-11-25,San Benito,069,59416,7630,7575,182,7757,77
2021-11-25,San Bernardino,071,2135413,364339,360033,11608,371641,5932
2021-11-25,San Diego,073,3302833,385998,382634,22506,405140,4319
2021-11-25,San Francisco,075,870044,54566,53830,2435,56265,669
2021-11-25,San Joaquin,077,732212,102374,101368,5640,107008,1833
2021-11-25,San Luis Obispo,079,281455,30471,29983,1316,31299,358
2021-11-25,San Mateo,081,765935,55567,54360,948,55308,577
2021-11-25,Santa Barbara,083,443738,45749,45318,1608,46926,548
2021-11-25,Santa Clara,085,1922200,151430,149700,1526,151226,1922
2021-11-25,Santa Cruz,087,273765,21248,20929,1035,21964,222
2021-11-25,Shasta,089,179085,22419,22151,3712,25863,396
2021-11-25,Sierra,091,2930,196,194,21,215,0
2021-11-25,Siskiyou,093,43540,3439,3336,1345,4681,54
2021-11-25,Solano,095,438530,46965,46163,1342,47505,356
2021-11-25,Sonoma,097,501317,42775,42368,556,42924,405
2021-11-25,Stanislaus,099,539301,80739,80782,9174,89956,1220
2021-11-25,Sutter,101,95872,14181,14127,382,14509,181
2021-11-25,Tehama,103,63373,8781,8675,1544,10219,129
2021-11-25,Trinity,105,12862,895,789,227,1016,17
2021-11-25,Tulare,107,460477,70685,69377,16034,85411,1082
2021-11-25,Tuolumne,109,53932,7614,7574,110,7684,90
2021-11-25,Ventura,111,848112,100108,99163,4408,103571,1188
2021-11-25,Yolo,113,214977,20374,20237,1230,21467,257
2021-11-25,Yuba,115,75493,10425,10335,371,10706,88
2021-11-24,Alameda,001,1643700,122547,121618,2920,124538,1477
2021-11-24,Alpine,003,1148,105,106,0,106,0
2021-11-24,Amador,005,37829,5723,5670,70,5740,66
2021-11-24,Butte,007,227075,21689,21384,3875,25259,309
2021-11-24,Calaveras,009,45235,4358,4294,61,4355,85
2021-11-24,Colusa,011,21464,2607,2568,666,3234,19
2021-11-24,Contra Costa,013,1133247,101777,100961,2312,103273,1045
2021-11-24,Del Norte,015,27424,3753,3661,56,3717,42
2021-11-24,El Dorado,017,186661,16668,16399,1758,18157,161
2021-11-24,Fresno,019,978130,145330,143386,13228,156614,2246
2021-11-24,Glenn,021,27897,3575,3532,1036,4568,36
2021-11-24,Humboldt,023,135768,9524,9399,653,10052,115
2021-11-24,Imperial,025,180216,35125,34611,3544,38155,769
2021-11-24,Inyo,027,18085,2538,2506,41,2547,45
2021-11-24,Kern,029,883053,132059,130245,23729,153974,1773
2021-11-24,Kings,031,150075,33329,32891,2037,34928,358
2021-11-24,Lake,033,64148,6905,6836,156,6992,110
2021-11-24,Lassen,035,31185,7045,6959,412,7371,47
2021-11-24,Los Angeles,037,10098052,1464456,1454495,56397,1510892,26817
2021-11-24,Madera,039,155013,24185,23880,2276,26156,296
2021-11-24,Marin,041,260295,18041,17857,496,18353,248
2021-11-24,Mariposa,043,17540,1420,1374,60,1434,6
2021-11-24,Mendocino,045,87422,8017,7871,657,8528,89
2021-11-24,Merced,047,269075,43155,42921,2081,45002,664
2021-11-24,Modoc,049,8938,590,551,203,754,5
2021-11-24,Mono,051,14174,1858,1810,23,1833,4
2021-11-24,Monterey,053,433212,49624,48400,3166,51566,625
2021-11-24,Napa,055,140530,13320,13256,120,13376,104
2021-11-24,Nevada,057,99092,9735,9584,343,9927,103
2021-11-24,Orange,059,3164182,313515,310809,15907,326716,5665
2021-11-24,Placer,061,380077,38505,38001,3845,41846,468
2021-11-24,Plumas,063,18699,1930,1860,44,1904,7
2021-11-24,Riverside,065,2383286,373295,367601,16762,384363,5306
2021-11-24,Sacramento,067,1510023,163716,162328,4886,167214,2335
2021-11-24,San Benito,069,59416,7628,7575,182,7757,77
2021-11-24,San Bernardino,071,2135413,364129,360033,11597,371630,5932
2021-11-24,San Diego,073,3302833,385741,382634,22493,405127,4319
2021-11-24,San Francisco,075,870044,54535,53830,2433,56263,669
2021-11-24,San Joaquin,077,732212,102333,101368,5637,107005,1833
2021-11-24,San Luis Obispo,079,281455,30452,29983,1316,31299,358
2021-11-24,San Mateo,081,765935,55537,54360,947,55307,577
2021-11-24,Santa Barbara,083,443738,45722,45318,1608,46926,548
2021-11-24,Santa Clara,085,1922200,151334,149700,1525,151225,1922
2021-11-24,Santa Cruz,087,273765,21225,20929,1034,21963,222
2021-11-24,Shasta,089,179085,22408,22151,3709,25860,396
2021-11-24,Sierra,091,2930,196,194,21,215,0
2021-11-24,Siskiyou,093,43540,3436,3336,1345,4681,54
2021-11-24,Solano,095,438530,46937,46163,1340,47503,356
2021-11-24,Sonoma,097,501317,42743,42368,554,42922,405
2021-11-24,Stanislaus,099,539301,80702,80782,9169,89951,1220
2021-11-24,Sutter,101,95872,14168,14127,380,14507,181
2021-11-24,Tehama,103,63373,8778,8675,1543,10218,129
2021-11-24,Trinity,105,12862,895,789,227,1016,17
2021-11-24,Tulare,107,460477,70661,69377,16015,85392,1082
2021-11-24,Tuolumne,109,53932,7610,7574,110,7684,90
2021-11-24,Ventura,111,848112,100073,99163,4404,103567,1188
2021-11-24,Yolo,113,214977,20366,20237,1229,21466,257
2021-11-24,Yuba,115,75493,10421,10335,370,10705,88
2021-11-23,Alameda,001,1643700,122428,121618,2913,124531,1477
2021-11-23,Alpine,003,1148,105,106,0,106,0
2021-11-23,Amador,005,37829,5716,5670,70,5740,66
2021-11-23,Butte,007,227075,21660,21384,3871,25255,309
2021-11-23,Calaveras,009,45235,4352,4294,60,4354,85
2021-11-23,Colusa,011,21464,2603,2568,664,3232,19
2021-11-23,Contra Costa,013,1133247,101670,100961,2310,103271,1045
2021-11-23,Del Norte,015,27424,3750,3661,56,3717,42
2021-11-23,El Dorado,017,186661,16636,16399,1755,18154,161
2021-11-23,Fresno,019,978130,145193,143386,13219,156605,2246
2021-11-23,Glenn,021,27897,3570,3532,1036,4568,36
2021-11-23,Humboldt,023,135768,9502,9399,650,10049,115
2021-11-23,Imperial,025,180216,35056,34611,3525,38136,769
2021-11-23,Inyo,027,18085,2534,2506,41,2547,45
2021-11-23,Kern,029,883053,131951,130245,23680,153925,1773
2021-11-23,Kings,031,150075,33288,32891,2036,34927,358
2021-11-23,Lake,033,64148,6900,6836,156,6992,110
2021-11-23,Lassen,035,31185,7041,6959,409,7368,47
2021-11-23,Los Angeles,037,10098052,1463434,1454495,56330,1510825,26817
2021-11-23,Madera,039,155013,24159,23880,2274,26154,296
2021-11-23,Marin,041,260295,18010,17857,492,18349,248
2021-11-23,Mariposa,043,17540,1417,1374,60,1434,6
2021-11-23,Mendocino,045,87422,7996,7871,654,8525,89
2021-11-23,Merced,047,269075,43117,42921,2080,45001,664
2021-11-23,Modoc,049,8938,588,551,203,754,5
2021-11-23,Mono,051,14174,1844,1810,23,1833,4
2021-11-23,Monterey,053,433212,49588,48400,3160,51560,625
2021-11-23,Napa,055,140530,13311,13256,120,13376,104
2021-11-23,Nevada,057,99092,9706,9584,342,9926,103
2021-11-23,Orange,059,3164182,313265,310809,15871,326680,5665
2021-11-23,Placer,061,380077,38446,38001,3828,41829,468
2021-11-23,Plumas,063,18699,1926,1860,44,1904,7
2021-11-23,Riverside,065,2383286,372912,367601,16749,384350,5306
2021-11-23,Sacramento,067,1510023,163529,162328,4875,167203,2335
2021-11-23,San Benito,069,59416,7619,7575,180,7755,77
2021-11-23,San Bernardino,071,2135413,363715,360033,11582,371615,5932
2021-11-23,San Diego,073,3302833,385250,382634,22470,405104,4319
2021-11-23,San Francisco,075,870044,54476,53830,2430,56260,669
2021-11-23,San Joaquin,077,732212,102224,101368,5626,106994,1833
2021-11-23,San Luis Obispo,079,281455,30417,29983,1313,31296,358
2021-11-23,San Mateo,081,765935,55488,54360,946,55306,577
2021-11-23,Santa Barbara,083,443738,45669,45318,1608,46926,548
2021-11-23,Santa Clara,085,1922200,151123,149700,1513,151213,1922
2021-11-23,Santa Cruz,087,273765,21187,20929,1034,21963,222
2021-11-23,Shasta,089,179085,22372,22151,3707,25858,396
2021-11-23,Sierra,091,2930,196,194,21,215,0
2021-11-23,Siskiyou,093,43540,3431,3336,1344,4680,54
2021-11-23,Solano,095,438530,46883,46163,1336,47499,356
2021-11-23,Sonoma,097,501317,42692,42368,551,42919,405
2021-11-23,Stanislaus,099,539301,80633,80782,9156,89938,1220
2021-11-23,Sutter,101,95872,14152,14127,379,14506,181
2021-11-23,Tehama,103,63373,8765,8675,1542,10217,129
2021-11-23,Trinity,105,12862,894,789,227,1016,17
2021-11-23,Tulare,107,460477,70614,69377,15985,85362,1082
2021-11-23,Tuolumne,109,53932,7598,7574,110,7684,90
2021-11-23,Ventura,111,848112,99990,99163,4398,103561,1188
2021-11-23,Yolo,113,214977,20345,20237,1221,21458,257
2021-11-23,Yuba,115,75493,10409,10335,370,10705,88
2021-11-22,Alameda,001,1643700,122315,121566,2910,124476,1475
2021-11-22,Alpine,003,1148,105,106,0,106,0
2021-11-22,Amador,005,37829,5703,5670,70,5740,66
2021-11-22,Butte,007,227075,21621,21363,3865,25228,305
2021-11-22,Calaveras,009,45235,4340,4294,60,4354,84
2021-11-22,Colusa,011,21464,2600,2565,664,3229,19
2021-11-22,Contra Costa,013,1133247,101582,100877,2305,103182,1045
2021-11-22,Del Norte,015,27424,3747,3659,56,3715,42
2021-11-22,El Dorado,017,186661,16613,16378,1752,18130,161
2021-11-22,Fresno,019,978130,145059,143290,13211,156501,2243
2021-11-22,Glenn,021,27897,3565,3530,1035,4565,36
2021-11-22,Humboldt,023,135768,9476,9389,645,10034,115
2021-11-22,Imperial,025,180216,34995,34562,3511,38073,766
2021-11-22,Inyo,027,18085,2528,2501,41,2542,44
2021-11-22,Kern,029,883053,131790,130091,23629,153720,1762
2021-11-22,Kings,031,150075,33252,32867,2031,34898,358
2021-11-22,Lake,033,64148,6895,6837,156,6993,110
2021-11-22,Lassen,035,31185,7039,6954,408,7362,47
2021-11-22,Los Angeles,037,10098052,1462363,1453945,56249,1510194,26800
2021-11-22,Madera,039,155013,24125,23872,2266,26138,296
2021-11-22,Marin,041,260295,17979,17842,490,18332,248
2021-11-22,Mariposa,043,17540,1413,1372,60,1432,6
2021-11-22,Mendocino,045,87422,7980,7859,653,8512,89
2021-11-22,Merced,047,269075,43066,42898,2069,44967,660
2021-11-22,Modoc,049,8938,587,551,203,754,5
2021-11-22,Mono,051,14174,1837,1809,23,1832,4
2021-11-22,Monterey,053,433212,49561,48374,3156,51530,611
2021-11-22,Napa,055,140530,13303,13255,119,13374,104
2021-11-22,Nevada,057,99092,9689,9575,340,9915,96
2021-11-22,Orange,059,3164182,313025,310654,15845,326499,5663
2021-11-22,Placer,061,380077,38401,37956,3820,41776,465
2021-11-22,Plumas,063,18699,1923,1858,44,1902,7
2021-11-22,Riverside,065,2383286,372475,367301,16740,384041,5283
2021-11-22,Sacramento,067,1510023,163337,162222,4866,167088,2328
2021-11-22,San Benito,069,59416,7599,7567,180,7747,77
2021-11-22,San Bernardino,071,2135413,363304,359851,11572,371423,5916
2021-11-22,San Diego,073,3302833,384754,382132,22446,404578,4317
2021-11-22,San Francisco,075,870044,54384,53778,2424,56202,669
2021-11-22,San Joaquin,077,732212,102099,101299,5621,106920,1833
2021-11-22,San Luis Obispo,079,281455,30391,29963,1310,31273,358
2021-11-22,San Mateo,081,765935,55431,54330,944,55274,577
2021-11-22,Santa Barbara,083,443738,45593,45279,1608,46887,546
2021-11-22,Santa Clara,085,1922200,150938,149541,1503,151044,1919
2021-11-22,Santa Cruz,087,273765,21146,20891,1034,21925,222
2021-11-22,Shasta,089,179085,22358,22116,3702,25818,393
2021-11-22,Sierra,091,2930,196,193,21,214,0
2021-11-22,Siskiyou,093,43540,3426,3336,1342,4678,54
2021-11-22,Solano,095,438530,46834,46153,1334,47487,356
2021-11-22,Sonoma,097,501317,42631,42344,550,42894,404
2021-11-22,Stanislaus,099,539301,80545,80718,9146,89864,1209
2021-11-22,Sutter,101,95872,14136,14125,377,14502,181
2021-11-22,Tehama,103,63373,8758,8669,1537,10206,127
2021-11-22,Trinity,105,12862,893,785,227,1012,17
2021-11-22,Tulare,107,460477,70552,69314,15948,85262,1075
2021-11-22,Tuolumne,109,53932,7583,7567,110,7677,90
2021-11-22,Ventura,111,848112,99924,99114,4395,103509,1186
2021-11-22,Yolo,113,214977,20322,20227,1219,21446,257
2021-11-22,Yuba,115,75493,10400,10332,369,10701,88
2021-11-21,Alameda,001,1643700,122184,121443,2906,124349,1475
2021-11-21,Alpine,003,1148,103,106,0,106,0
2021-11-21,Amador,005,37829,5698,5662,69,5731,66
2021-11-21,Butte,007,227075,21579,21342,3860,25202,306
2021-11-21,Calaveras,009,45235,4331,4287,60,4347,84
2021-11-21,Colusa,011,21464,2596,2562,663,3225,19
2021-11-21,Contra Costa,013,1133247,101480,100807,2299,103106,1045
2021-11-21,Del Norte,015,27424,3743,3659,56,3715,42
2021-11-21,El Dorado,017,186661,16586,16370,1746,18116,161
2021-11-21,Fresno,019,978130,144887,143203,13191,156394,2242
2021-11-21,Glenn,021,27897,3561,3529,1035,4564,36
2021-11-21,Humboldt,023,135768,9453,9378,644,10022,115
2021-11-21,Imperial,025,180216,34906,34527,3501,38028,766
2021-11-21,Inyo,027,18085,2521,2501,41,2542,44
2021-11-21,Kern,029,883053,131626,130020,23583,153603,1762
2021-11-21,Kings,031,150075,33214,32843,2027,34870,356
2021-11-21,Lake,033,64148,6888,6834,156,6990,110
2021-11-21,Lassen,035,31185,7030,6953,408,7361,47
2021-11-21,Los Angeles,037,10098052,1461294,1453181,56191,1509372,26793
2021-11-21,Madera,039,155013,24099,23856,2261,26117,296
2021-11-21,Marin,041,260295,17950,17829,487,18316,248
2021-11-21,Mariposa,043,17540,1412,1371,59,1430,6
2021-11-21,Mendocino,045,87422,7974,7846,650,8496,89
2021-11-21,Merced,047,269075,43011,42881,2065,44946,660
2021-11-21,Modoc,049,8938,583,551,203,754,5
2021-11-21,Mono,051,14174,1827,1799,22,1821,4
2021-11-21,Monterey,053,433212,49515,48358,3147,51505,611
2021-11-21,Napa,055,140530,13290,13250,119,13369,104
2021-11-21,Nevada,057,99092,9663,9556,339,9895,96
2021-11-21,Orange,059,3164182,312769,310477,15812,326289,5663
2021-11-21,Placer,061,380077,38319,37929,3819,41748,465
2021-11-21,Plumas,063,18699,1918,1858,44,1902,7
2021-11-21,Riverside,065,2383286,371983,367093,16732,383825,5283
2021-11-21,Sacramento,067,1510023,163121,162087,4856,166943,2327
2021-11-21,San Benito,069,59416,7585,7563,179,7742,77
2021-11-21,San Bernardino,071,2135413,362818,359621,11537,371158,5912
2021-11-21,San Diego,073,3302833,384216,380747,22421,403168,4317
2021-11-21,San Francisco,075,870044,54315,53741,2419,56160,669
2021-11-21,San Joaquin,077,732212,101994,101264,5608,106872,1833
2021-11-21,San Luis Obispo,079,281455,30353,29948,1310,31258,358
2021-11-21,San Mateo,081,765935,55379,54290,942,55232,577
2021-11-21,Santa Barbara,083,443738,45532,45237,1605,46842,546
2021-11-21,Santa Clara,085,1922200,150732,149387,1483,150870,1918
2021-11-21,Santa Cruz,087,273765,21102,20866,1032,21898,222
2021-11-21,Shasta,089,179085,22327,22112,3700,25812,393
2021-11-21,Sierra,091,2930,196,193,21,214,0
2021-11-21,Siskiyou,093,43540,3421,3333,1341,4674,54
2021-11-21,Solano,095,438530,46778,46122,1327,47449,356
2021-11-21,Sonoma,097,501317,42571,42298,549,42847,404
2021-11-21,Stanislaus,099,539301,80450,80687,9132,89819,1209
2021-11-21,Sutter,101,95872,14122,14111,377,14488,181
2021-11-21,Tehama,103,63373,8752,8669,1536,10205,127
2021-11-21,Trinity,105,12862,891,784,225,1009,17
2021-11-21,Tulare,107,460477,70468,69285,15909,85194,1075
2021-11-21,Tuolumne,109,53932,7575,7560,109,7669,90
2021-11-21,Ventura,111,848112,99833,99081,4391,103472,1186
2021-11-21,Yolo,113,214977,20294,20209,1216,21425,257
2021-11-21,Yuba,115,75493,10391,10326,369,10695,88
2021-11-20,Alameda,001,1643700,122091,121059,2899,123958,1473
2021-11-20,Alpine,003,1148,103,105,0,105,0
2021-11-20,Amador,005,37829,5692,5652,68,5720,66
2021-11-20,Butte,007,227075,21564,21265,3856,25121,300
2021-11-20,Calaveras,009,45235,4322,4268,60,4328,84
2021-11-20,Colusa,011,21464,2595,2549,662,3211,19
2021-11-20,Contra Costa,013,1133247,101403,100491,2295,102786,1043
2021-11-20,Del Norte,015,27424,3740,3637,56,3693,42
2021-11-20,El Dorado,017,186661,16564,16308,1744,18052,161
2021-11-20,Fresno,019,978130,144817,142579,13182,155761,2233
2021-11-20,Glenn,021,27897,3560,3526,1034,4560,35
2021-11-20,Humboldt,023,135768,9440,9302,642,9944,115
2021-11-20,Imperial,025,180216,34854,34312,3495,37807,766
2021-11-20,Inyo,027,18085,2520,2467,41,2508,44
2021-11-20,Kern,029,883053,131526,129488,23546,153034,1750
2021-11-20,Kings,031,150075,33204,32720,2027,34747,354
2021-11-20,Lake,033,64148,6885,6808,156,6964,110
2021-11-20,Lassen,035,31185,7029,6931,408,7339,47
2021-11-20,Los Angeles,037,10098052,1460675,1448963,56143,1505106,26741
2021-11-20,Madera,039,155013,24087,23720,2257,25977,296
2021-11-20,Marin,041,260295,17935,17774,487,18261,248
2021-11-20,Mariposa,043,17540,1411,1354,59,1413,6
2021-11-20,Mendocino,045,87422,7966,7773,650,8423,89
2021-11-20,Merced,047,269075,42985,42692,2065,44757,656
2021-11-20,Modoc,049,8938,582,550,203,753,5
2021-11-20,Mono,051,14174,1821,1767,22,1789,4
2021-11-20,Monterey,053,433212,49502,48260,3139,51399,609
2021-11-20,Napa,055,140530,13287,13184,119,13303,103
2021-11-20,Nevada,057,99092,9647,9480,339,9819,92
2021-11-20,Orange,059,3164182,312570,309672,15795,325467,5658
2021-11-20,Placer,061,380077,38279,37800,3814,41614,462
2021-11-20,Plumas,063,18699,1914,1841,44,1885,7
2021-11-20,Riverside,065,2383286,371710,365809,16720,382529,5265
2021-11-20,Sacramento,067,1510023,163016,161533,4852,166385,2316
2021-11-20,San Benito,069,59416,7581,7533,179,7712,77
2021-11-20,San Bernardino,071,2135413,362546,358322,11526,369848,5897
2021-11-20,San Diego,073,3302833,383883,380147,22395,402542,4311
2021-11-20,San Francisco,075,870044,54276,53525,2418,55943,669
2021-11-20,San Joaquin,077,732212,101944,100922,5603,106525,1832
2021-11-20,San Luis Obispo,079,281455,30339,29815,1309,31124,355
2021-11-20,San Mateo,081,765935,55345,54132,941,55073,577
2021-11-20,Santa Barbara,083,443738,45500,45074,1605,46679,544
2021-11-20,Santa Clara,085,1922200,150625,148829,1482,150311,1917
2021-11-20,Santa Cruz,087,273765,21084,20756,1032,21788,222
2021-11-20,Shasta,089,179085,22303,21968,3699,25667,383
2021-11-20,Sierra,091,2930,196,191,21,212,0
2021-11-20,Siskiyou,093,43540,3418,3313,1341,4654,54
2021-11-20,Solano,095,438530,46757,46006,1327,47333,356
2021-11-20,Sonoma,097,501317,42540,42151,549,42700,403
2021-11-20,Stanislaus,099,539301,80403,80412,9128,89540,1205
2021-11-20,Sutter,101,95872,14114,14074,377,14451,181
2021-11-20,Tehama,103,63373,8747,8648,1536,10184,125
2021-11-20,Trinity,105,12862,887,771,225,996,17
2021-11-20,Tulare,107,460477,70429,69074,15888,84962,1054
2021-11-20,Tuolumne,109,53932,7566,7511,109,7620,90
2021-11-20,Ventura,111,848112,99784,98893,4384,103277,1186
2021-11-20,Yolo,113,214977,20286,20139,1212,21351,257
2021-11-20,Yuba,115,75493,10385,10290,368,10658,88
2021-11-19,Alameda,001,1643700,122015,121059,2896,123955,1473
2021-11-19,Alpine,003,1148,103,105,0,105,0
2021-11-19,Amador,005,37829,5682,5652,68,5720,66
2021-11-19,Butte,007,227075,21541,21265,3849,25114,300
2021-11-19,Calaveras,009,45235,4315,4268,60,4328,84
2021-11-19,Colusa,011,21464,2593,2549,661,3210,19
2021-11-19,Contra Costa,013,1133247,101345,100491,2290,102781,1043
2021-11-19,Del Norte,015,27424,3735,3637,56,3693,42
2021-11-19,El Dorado,017,186661,16543,16308,1742,18050,161
2021-11-19,Fresno,019,978130,144699,142579,13173,155752,2233
2021-11-19,Glenn,021,27897,3559,3526,1033,4559,35
2021-11-19,Humboldt,023,135768,9427,9302,639,9941,115
2021-11-19,Imperial,025,180216,34817,34312,3488,37800,766
2021-11-19,Inyo,027,18085,2516,2467,41,2508,44
2021-11-19,Kern,029,883053,131422,129488,23503,152991,1750
2021-11-19,Kings,031,150075,33178,32720,2025,34745,354
2021-11-19,Lake,033,64148,6882,6808,156,6964,110
2021-11-19,Lassen,035,31185,7025,6931,407,7338,47
2021-11-19,Los Angeles,037,10098052,1459993,1448963,56087,1505050,26741
2021-11-19,Madera,039,155013,24066,23720,2252,25972,296
2021-11-19,Marin,041,260295,17916,17774,485,18259,248
2021-11-19,Mariposa,043,17540,1409,1354,59,1413,6
2021-11-19,Mendocino,045,87422,7946,7773,650,8423,89
2021-11-19,Merced,047,269075,42959,42692,2064,44756,656
2021-11-19,Modoc,049,8938,581,550,203,753,5
2021-11-19,Mono,051,14174,1810,1767,22,1789,4
2021-11-19,Monterey,053,433212,49480,48260,3139,51399,609
2021-11-19,Napa,055,140530,13277,13184,118,13302,103
2021-11-19,Nevada,057,99092,9634,9480,339,9819,92
2021-11-19,Orange,059,3164182,312417,309672,15770,325442,5658
2021-11-19,Placer,061,380077,38242,37800,3810,41610,462
2021-11-19,Plumas,063,18699,1910,1841,44,1885,7
2021-11-19,Riverside,065,2383286,371436,365809,16716,382525,5265
2021-11-19,Sacramento,067,1510023,162892,161533,4848,166381,2316
2021-11-19,San Benito,069,59416,7575,7533,177,7710,77
2021-11-19,San Bernardino,071,2135413,362224,358322,11517,369839,5897
2021-11-19,San Diego,073,3302833,383482,380147,22369,402516,4311
2021-11-19,San Francisco,075,870044,54238,53525,2418,55943,669
2021-11-19,San Joaquin,077,732212,101887,100922,5599,106521,1832
2021-11-19,San Luis Obispo,079,281455,30321,29815,1307,31122,355
2021-11-19,San Mateo,081,765935,55297,54132,937,55069,577
2021-11-19,Santa Barbara,083,443738,45463,45074,1605,46679,544
2021-11-19,Santa Clara,085,1922200,150476,148829,1479,150308,1917
2021-11-19,Santa Cruz,087,273765,21057,20756,1029,21785,222
2021-11-19,Shasta,089,179085,22291,21968,3698,25666,383
2021-11-19,Sierra,091,2930,196,191,21,212,0
2021-11-19,Siskiyou,093,43540,3415,3313,1341,4654,54
2021-11-19,Solano,095,438530,46727,46006,1323,47329,356
2021-11-19,Sonoma,097,501317,42507,42151,546,42697,403
2021-11-19,Stanislaus,099,539301,80346,80412,9118,89530,1205
2021-11-19,Sutter,101,95872,14112,14074,377,14451,181
2021-11-19,Tehama,103,63373,8744,8648,1536,10184,125
2021-11-19,Trinity,105,12862,885,771,225,996,17
2021-11-19,Tulare,107,460477,70388,69074,15861,84935,1054
2021-11-19,Tuolumne,109,53932,7555,7511,109,7620,90
2021-11-19,Ventura,111,848112,99719,98893,4380,103273,1186
2021-11-19,Yolo,113,214977,20275,20139,1210,21349,257
2021-11-19,Yuba,115,75493,10382,10290,368,10658,88
2021-11-18,Alameda,001,1643700,121891,121059,2889,123948,1473
2021-11-18,Alpine,003,1148,103,105,0,105,0
2021-11-18,Amador,005,37829,5680,5652,68,5720,66
2021-11-18,Butte,007,227075,21524,21265,3842,25107,300
2021-11-18,Calaveras,009,45235,4308,4268,59,4327,84
2021-11-18,Colusa,011,21464,2585,2549,661,3210,19
2021-11-18,Contra Costa,013,1133247,101243,100491,2282,102773,1043
2021-11-18,Del Norte,015,27424,3732,3637,56,3693,42
2021-11-18,El Dorado,017,186661,16524,16308,1739,18047,161
2021-11-18,Fresno,019,978130,144559,142579,13163,155742,2233
2021-11-18,Glenn,021,27897,3558,3526,1032,4558,35
2021-11-18,Humboldt,023,135768,9411,9302,634,9936,115
2021-11-18,Imperial,025,180216,34763,34312,3472,37784,766
2021-11-18,Inyo,027,18085,2508,2467,41,2508,44
2021-11-18,Kern,029,883053,131278,129488,23455,152943,1750
2021-11-18,Kings,031,150075,33141,32720,2022,34742,354
2021-11-18,Lake,033,64148,6877,6808,156,6964,110
2021-11-18,Lassen,035,31185,7022,6931,402,7333,47
2021-11-18,Los Angeles,037,10098052,1459002,1448963,56023,1504986,26741
2021-11-18,Madera,039,155013,24041,23720,2248,25968,296
2021-11-18,Marin,041,260295,17900,17774,481,18255,248
2021-11-18,Mariposa,043,17540,1406,1354,59,1413,6
2021-11-18,Mendocino,045,87422,7924,7773,641,8414,89
2021-11-18,Merced,047,269075,42903,42692,2062,44754,656
2021-11-18,Modoc,049,8938,569,550,203,753,5
2021-11-18,Mono,051,14174,1802,1767,22,1789,4
2021-11-18,Monterey,053,433212,49455,48260,3134,51394,609
2021-11-18,Napa,055,140530,13265,13184,117,13301,103
2021-11-18,Nevada,057,99092,9610,9480,339,9819,92
2021-11-18,Orange,059,3164182,312181,309672,15751,325423,5658
2021-11-18,Placer,061,380077,38199,37800,3799,41599,462
2021-11-18,Plumas,063,18699,1909,1841,44,1885,7
2021-11-18,Riverside,065,2383286,371064,365809,16703,382512,5265
2021-11-18,Sacramento,067,1510023,162665,161533,4833,166366,2316
2021-11-18,San Benito,069,59416,7565,7533,177,7710,77
2021-11-18,San Bernardino,071,2135413,361790,358322,11498,369820,5897
2021-11-18,San Diego,073,3302833,382976,380147,22353,402500,4311
2021-11-18,San Francisco,075,870044,54186,53525,2414,55939,669
2021-11-18,San Joaquin,077,732212,101794,100922,5590,106512,1832
2021-11-18,San Luis Obispo,079,281455,30291,29815,1306,31121,355
2021-11-18,San Mateo,081,765935,55238,54132,934,55066,577
2021-11-18,Santa Barbara,083,443738,45417,45074,1598,46672,544
2021-11-18,Santa Clara,085,1922200,150289,148829,1471,150300,1917
2021-11-18,Santa Cruz,087,273765,21006,20756,1028,21784,222
2021-11-18,Shasta,089,179085,22255,21968,3693,25661,383
2021-11-18,Sierra,091,2930,195,191,21,212,0
2021-11-18,Siskiyou,093,43540,3415,3313,1337,4650,54
2021-11-18,Solano,095,438530,46685,46006,1320,47326,356
2021-11-18,Sonoma,097,501317,42458,42151,544,42695,403
2021-11-18,Stanislaus,099,539301,80279,80412,9110,89522,1205
2021-11-18,Sutter,101,95872,14101,14074,376,14450,181
2021-11-18,Tehama,103,63373,8739,8648,1536,10184,125
2021-11-18,Trinity,105,12862,884,771,225,996,17
2021-11-18,Tulare,107,460477,70315,69074,15813,84887,1054
2021-11-18,Tuolumne,109,53932,7545,7511,109,7620,90
2021-11-18,Ventura,111,848112,99642,98893,4376,103269,1186
2021-11-18,Yolo,113,214977,20258,20139,1205,21344,257
2021-11-18,Yuba,115,75493,10376,10290,368,10658,88
2021-11-17,Alameda,001,1643700,121769,120913,2888,123801,1472
2021-11-17,Alpine,003,1148,103,105,0,105,0
2021-11-17,Amador,005,37829,5673,5646,68,5714,66
2021-11-17,Butte,007,227075,21498,21230,3839,25069,300
2021-11-17,Calaveras,009,45235,4301,4259,59,4318,84
2021-11-17,Colusa,011,21464,2582,2546,660,3206,19
2021-11-17,Contra Costa,013,1133247,101151,100387,2278,102665,1039
2021-11-17,Del Norte,015,27424,3729,3630,56,3686,42
2021-11-17,El Dorado,017,186661,16505,16269,1738,18007,161
2021-11-17,Fresno,019,978130,144376,142366,13150,155516,2230
2021-11-17,Glenn,021,27897,3556,3527,1031,4558,34
2021-11-17,Humboldt,023,135768,9400,9270,631,9901,115
2021-11-17,Imperial,025,180216,34707,34256,3450,37706,766
2021-11-17,Inyo,027,18085,2502,2457,41,2498,44
2021-11-17,Kern,029,883053,131105,129307,23413,152720,1743
2021-11-17,Kings,031,150075,33113,32669,2018,34687,352
2021-11-17,Lake,033,64148,6873,6795,155,6950,110
2021-11-17,Lassen,035,31185,7020,6918,402,7320,47
2021-11-17,Los Angeles,037,10098052,1457900,1447947,55957,1503904,26721
2021-11-17,Madera,039,155013,24007,23673,2246,25919,287
2021-11-17,Marin,041,260295,17880,17757,479,18236,248
2021-11-17,Mariposa,043,17540,1402,1353,59,1412,6
2021-11-17,Mendocino,045,87422,7916,7735,640,8375,89
2021-11-17,Merced,047,269075,42844,42612,2057,44669,654
2021-11-17,Modoc,049,8938,565,540,203,743,5
2021-11-17,Mono,051,14174,1798,1765,22,1787,5
2021-11-17,Monterey,053,433212,49407,48221,3123,51344,609
2021-11-17,Napa,055,140530,13241,13167,117,13284,103
2021-11-17,Nevada,057,99092,9597,9447,339,9786,92
2021-11-17,Orange,059,3164182,311933,309396,15717,325113,5651
2021-11-17,Placer,061,380077,38151,37725,3790,41515,460
2021-11-17,Plumas,063,18699,1904,1833,44,1877,7
2021-11-17,Riverside,065,2383286,370653,365406,16690,382096,5229
2021-11-17,Sacramento,067,1510023,162496,161269,4825,166094,2302
2021-11-17,San Benito,069,59416,7558,7524,177,7701,77
2021-11-17,San Bernardino,071,2135413,361429,357947,11482,369429,5893
2021-11-17,San Diego,073,3302833,382478,379769,22327,402096,4301
2021-11-17,San Francisco,075,870044,54131,53469,2411,55880,667
2021-11-17,San Joaquin,077,732212,101692,100764,5585,106349,1828
2021-11-17,San Luis Obispo,079,281455,30265,29731,1303,31034,354
2021-11-17,San Mateo,081,765935,55170,54092,931,55023,577
2021-11-17,Santa Barbara,083,443738,45379,45000,1598,46598,542
2021-11-17,Santa Clara,085,1922200,150125,148626,1463,150089,1915
2021-11-17,Santa Cruz,087,273765,20971,20700,1028,21728,222
2021-11-17,Shasta,089,179085,22222,21883,3691,25574,382
2021-11-17,Sierra,091,2930,194,189,21,210,0
2021-11-17,Siskiyou,093,43540,3411,3307,1334,4641,54
2021-11-17,Solano,095,438530,46652,45948,1319,47267,353
2021-11-17,Sonoma,097,501317,42412,42093,541,42634,403
2021-11-17,Stanislaus,099,539301,80191,80276,9100,89376,1199
2021-11-17,Sutter,101,95872,14087,14064,374,14438,181
2021-11-17,Tehama,103,63373,8729,8633,1533,10166,125
2021-11-17,Trinity,105,12862,883,765,225,990,17
2021-11-17,Tulare,107,460477,70243,68977,15786,84763,1047
2021-11-17,Tuolumne,109,53932,7528,7485,109,7594,90
2021-11-17,Ventura,111,848112,99580,98812,4370,103182,1183
2021-11-17,Yolo,113,214977,20239,20100,1201,21301,257
2021-11-17,Yuba,115,75493,10364,10275,364,10639,88
2021-11-16,Alameda,001,1643700,121657,120809,2884,123693,1467
2021-11-16,Alpine,003,1148,103,105,0,105,0
2021-11-16,Amador,005,37829,5667,5644,68,5712,66
2021-11-16,Butte,007,227075,21473,21208,3834,25042,297
2021-11-16,Calaveras,009,45235,4292,4249,59,4308,83
2021-11-16,Colusa,011,21464,2576,2538,660,3198,19
2021-11-16,Contra Costa,013,1133247,101029,100320,2275,102595,1038
2021-11-16,Del Norte,015,27424,3723,3630,56,3686,42
2021-11-16,El Dorado,017,186661,16480,16248,1736,17984,159
2021-11-16,Fresno,019,978130,144189,142200,13129,155329,2218
2021-11-16,Glenn,021,27897,3555,3527,1028,4555,34
2021-11-16,Humboldt,023,135768,9379,9252,627,9879,115
2021-11-16,Imperial,025,180216,34623,34177,3436,37613,766
2021-11-16,Inyo,027,18085,2495,2449,41,2490,42
2021-11-16,Kern,029,883053,130946,129136,23352,152488,1735
2021-11-16,Kings,031,150075,33063,32614,2011,34625,350
2021-11-16,Lake,033,64148,6868,6789,155,6944,110
2021-11-16,Lassen,035,31185,7010,6915,402,7317,47
2021-11-16,Los Angeles,037,10098052,1456729,1446815,55885,1502700,26703
2021-11-16,Madera,039,155013,23969,23642,2240,25882,287
2021-11-16,Marin,041,260295,17861,17736,478,18214,248
2021-11-16,Mariposa,043,17540,1394,1349,58,1407,6
2021-11-16,Mendocino,045,87422,7874,7723,636,8359,89
2021-11-16,Merced,047,269075,42807,42578,2050,44628,653
2021-11-16,Modoc,049,8938,564,539,202,741,5
2021-11-16,Mono,051,14174,1789,1767,22,1789,4
2021-11-16,Monterey,053,433212,49377,48195,3109,51304,609
2021-11-16,Napa,055,140530,13230,13151,117,13268,103
2021-11-16,Nevada,057,99092,9580,9435,338,9773,92
2021-11-16,Orange,059,3164182,311665,309170,15682,324852,5651
2021-11-16,Placer,061,380077,38109,37676,3784,41460,459
2021-11-16,Plumas,063,18699,1895,1832,44,1876,7
2021-11-16,Riverside,065,2383286,370231,365078,16668,381746,5208
2021-11-16,Sacramento,067,1510023,162317,161102,4812,165914,2299
2021-11-16,San Benito,069,59416,7544,7513,177,7690,77
2021-11-16,San Bernardino,071,2135413,361017,357528,11430,368958,5901
2021-11-16,San Diego,073,3302833,381921,379435,22300,401735,4287
2021-11-16,San Francisco,075,870044,54058,53415,2403,55818,667
2021-11-16,San Joaquin,077,732212,101552,100637,5569,106206,1807
2021-11-16,San Luis Obispo,079,281455,30234,29703,1300,31003,356
2021-11-16,San Mateo,081,765935,55108,54034,929,54963,577
2021-11-16,Santa Barbara,083,443738,45311,44932,1595,46527,539
2021-11-16,Santa Clara,085,1922200,149945,148452,1451,149903,1916
2021-11-16,Santa Cruz,087,273765,20926,20684,1026,21710,222
2021-11-16,Shasta,089,179085,22183,21853,3687,25540,379
2021-11-16,Sierra,091,2930,194,189,21,210,0
2021-11-16,Siskiyou,093,43540,3408,3304,1332,4636,54
2021-11-16,Solano,095,438530,46612,45908,1318,47226,351
2021-11-16,Sonoma,097,501317,42363,42056,540,42596,401
2021-11-16,Stanislaus,099,539301,80096,80214,9076,89290,1196
2021-11-16,Sutter,101,95872,14075,14058,373,14431,181
2021-11-16,Tehama,103,63373,8722,8621,1526,10147,125
2021-11-16,Trinity,105,12862,883,762,224,986,17
2021-11-16,Tulare,107,460477,70163,68881,15749,84630,1039
2021-11-16,Tuolumne,109,53932,7518,7478,109,7587,90
2021-11-16,Ventura,111,848112,99505,98731,4367,103098,1183
2021-11-16,Yolo,113,214977,20200,20077,1199,21276,257
2021-11-16,Yuba,115,75493,10356,10262,362,10624,85
2021-11-15,Alameda,001,1643700,121503,120731,2879,123610,1464
2021-11-15,Alpine,003,1148,103,105,0,105,0
2021-11-15,Amador,005,37829,5663,5637,68,5705,66
2021-11-15,Butte,007,227075,21448,21182,3830,25012,296
2021-11-15,Calaveras,009,45235,4278,4237,59,4296,83
2021-11-15,Colusa,011,21464,2569,2535,657,3192,19
2021-11-15,Contra Costa,013,1133247,100922,100251,2272,102523,1038
2021-11-15,Del Norte,015,27424,3718,3630,55,3685,42
2021-11-15,El Dorado,017,186661,16456,16236,1732,17968,159
2021-11-15,Fresno,019,978130,143965,142015,13108,155123,2210
2021-11-15,Glenn,021,27897,3553,3526,1028,4554,34
2021-11-15,Humboldt,023,135768,9356,9230,619,9849,115
2021-11-15,Imperial,025,180216,34550,34130,3420,37550,766
2021-11-15,Inyo,027,18085,2490,2442,41,2483,42
2021-11-15,Kern,029,883053,130737,128928,23281,152209,1730
2021-11-15,Kings,031,150075,33029,32584,2006,34590,348
2021-11-15,Lake,033,64148,6864,6784,155,6939,109
2021-11-15,Lassen,035,31185,6999,6915,400,7315,47
2021-11-15,Los Angeles,037,10098052,1455535,1446114,55819,1501933,26677
2021-11-15,Madera,039,155013,23930,23605,2229,25834,287
2021-11-15,Marin,041,260295,17844,17723,477,18200,248
2021-11-15,Mariposa,043,17540,1393,1347,56,1403,6
2021-11-15,Mendocino,045,87422,7854,7694,630,8324,89
2021-11-15,Merced,047,269075,42749,42552,2039,44591,648
2021-11-15,Modoc,049,8938,563,538,201,739,5
2021-11-15,Mono,051,14174,1784,1763,22,1785,4
2021-11-15,Monterey,053,433212,49345,48154,3103,51257,609
2021-11-15,Napa,055,140530,13222,13143,117,13260,103
2021-11-15,Nevada,057,99092,9551,9420,337,9757,92
2021-11-15,Orange,059,3164182,311388,308859,15658,324517,5646
2021-11-15,Placer,061,380077,38045,37610,3780,41390,452
2021-11-15,Plumas,063,18699,1888,1829,44,1873,7
2021-11-15,Riverside,065,2383286,369785,364750,16649,381399,5199
2021-11-15,Sacramento,067,1510023,162097,160937,4799,165736,2293
2021-11-15,San Benito,069,59416,7539,7511,176,7687,77
2021-11-15,San Bernardino,071,2135413,360600,357306,11410,368716,5898
2021-11-15,San Diego,073,3302833,381371,378845,22275,401120,4284
2021-11-15,San Francisco,075,870044,53990,53374,2400,55774,667
2021-11-15,San Joaquin,077,732212,101398,100587,5558,106145,1799
2021-11-15,San Luis Obispo,079,281455,30191,29669,1288,30957,351
2021-11-15,San Mateo,081,765935,55055,54010,926,54936,576
2021-11-15,Santa Barbara,083,443738,45255,44879,1589,46468,539
2021-11-15,Santa Clara,085,1922200,149727,148313,1444,149757,1914
2021-11-15,Santa Cruz,087,273765,20884,20630,1025,21655,223
2021-11-15,Shasta,089,179085,22137,21779,3682,25461,374
2021-11-15,Sierra,091,2930,194,189,21,210,0
2021-11-15,Siskiyou,093,43540,3401,3302,1330,4632,54
2021-11-15,Solano,095,438530,46573,45885,1313,47198,351
2021-11-15,Sonoma,097,501317,42312,42021,539,42560,401
2021-11-15,Stanislaus,099,539301,80011,80129,9062,89191,1174
2021-11-15,Sutter,101,95872,14062,14043,372,14415,181
2021-11-15,Tehama,103,63373,8716,8615,1525,10140,125
2021-11-15,Trinity,105,12862,881,757,222,979,17
2021-11-15,Tulare,107,460477,70076,68826,15703,84529,1039
2021-11-15,Tuolumne,109,53932,7507,7461,109,7570,90
2021-11-15,Ventura,111,848112,99421,98605,4362,102967,1183
2021-11-15,Yolo,113,214977,20170,20065,1194,21259,255
2021-11-15,Yuba,115,75493,10337,10254,358,10612,85
2021-11-14,Alameda,001,1643700,121328,120629,2875,123504,1461
2021-11-14,Alpine,003,1148,102,105,0,105,0
2021-11-14,Amador,005,37829,5656,5632,67,5699,66
2021-11-14,Butte,007,227075,21417,21146,3821,24967,296
2021-11-14,Calaveras,009,45235,4267,4222,59,4281,83
2021-11-14,Colusa,011,21464,2567,2532,654,3186,19
2021-11-14,Contra Costa,013,1133247,100814,100188,2270,102458,1038
2021-11-14,Del Norte,015,27424,3715,3629,55,3684,42
2021-11-14,El Dorado,017,186661,16415,16212,1727,17939,159
2021-11-14,Fresno,019,978130,143682,141869,13075,154944,2209
2021-11-14,Glenn,021,27897,3551,3521,1028,4549,34
2021-11-14,Humboldt,023,135768,9326,9215,609,9824,115
2021-11-14,Imperial,025,180216,34447,34078,3405,37483,766
2021-11-14,Inyo,027,18085,2478,2441,41,2482,42
2021-11-14,Kern,029,883053,130497,128842,23211,152053,1730
2021-11-14,Kings,031,150075,32972,32545,1999,34544,349
2021-11-14,Lake,033,64148,6856,6777,155,6932,109
2021-11-14,Lassen,035,31185,6989,6911,399,7310,47
2021-11-14,Los Angeles,037,10098052,1454173,1445284,55742,1501026,26667
2021-11-14,Madera,039,155013,23880,23566,2220,25786,287
2021-11-14,Marin,041,260295,17829,17712,477,18189,247
2021-11-14,Mariposa,043,17540,1383,1337,52,1389,6
2021-11-14,Mendocino,045,87422,7821,7684,625,8309,89
2021-11-14,Merced,047,269075,42659,42513,2033,44546,648
2021-11-14,Modoc,049,8938,561,538,201,739,5
2021-11-14,Mono,051,14174,1772,1760,22,1782,4
2021-11-14,Monterey,053,433212,49290,48135,3085,51220,609
2021-11-14,Napa,055,140530,13204,13132,117,13249,103
2021-11-14,Nevada,057,99092,9523,9408,337,9745,92
2021-11-14,Orange,059,3164182,311069,308699,15637,324336,5646
2021-11-14,Placer,061,380077,37964,37569,3770,41339,452
2021-11-14,Plumas,063,18699,1885,1829,43,1872,7
2021-11-14,Riverside,065,2383286,369287,364490,16632,381122,5199
2021-11-14,Sacramento,067,1510023,161859,160761,4782,165543,2295
2021-11-14,San Benito,069,59416,7528,7507,175,7682,77
2021-11-14,San Bernardino,071,2135413,360019,357014,11393,368407,5897
2021-11-14,San Diego,073,3302833,380765,377633,22244,399877,4280
2021-11-14,San Francisco,075,870044,53915,53338,2395,55733,667
2021-11-14,San Joaquin,077,732212,101270,100518,5553,106071,1799
2021-11-14,San Luis Obispo,079,281455,30109,29645,1284,30929,352
2021-11-14,San Mateo,081,765935,55002,53978,924,54902,576
2021-11-14,Santa Barbara,083,443738,45176,44842,1586,46428,539
2021-11-14,Santa Clara,085,1922200,149528,148152,1436,149588,1913
2021-11-14,Santa Cruz,087,273765,20830,20609,1023,21632,223
2021-11-14,Shasta,089,179085,22085,21771,3669,25440,373
2021-11-14,Sierra,091,2930,194,189,21,210,0
2021-11-14,Siskiyou,093,43540,3392,3302,1329,4631,54
2021-11-14,Solano,095,438530,46517,45860,1306,47166,351
2021-11-14,Sonoma,097,501317,42246,41974,537,42511,401
2021-11-14,Stanislaus,099,539301,79876,80076,9047,89123,1174
2021-11-14,Sutter,101,95872,14045,14031,367,14398,181
2021-11-14,Tehama,103,63373,8706,8607,1523,10130,125
2021-11-14,Trinity,105,12862,878,754,220,974,17
2021-11-14,Tulare,107,460477,69958,68772,15644,84416,1037
2021-11-14,Tuolumne,109,53932,7489,7439,108,7547,90
2021-11-14,Ventura,111,848112,99306,98550,4361,102911,1183
2021-11-14,Yolo,113,214977,20143,20040,1188,21228,255
2021-11-14,Yuba,115,75493,10330,10238,357,10595,85
2021-11-13,Alameda,001,1643700,121255,120407,2873,123280,1454
2021-11-13,Alpine,003,1148,102,105,0,105,0
2021-11-13,Amador,005,37829,5655,5614,67,5681,66
2021-11-13,Butte,007,227075,21397,21104,3818,24922,296
2021-11-13,Calaveras,009,45235,4256,4203,59,4262,83
2021-11-13,Colusa,011,21464,2565,2522,654,3176,19
2021-11-13,Contra Costa,013,1133247,100742,100004,2264,102268,1028
2021-11-13,Del Norte,015,27424,3715,3629,55,3684,42
2021-11-13,El Dorado,017,186661,16403,16163,1724,17887,159
2021-11-13,Fresno,019,978130,143575,141452,13061,154513,2205
2021-11-13,Glenn,021,27897,3551,3514,1027,4541,34
2021-11-13,Humboldt,023,135768,9311,9177,604,9781,115
2021-11-13,Imperial,025,180216,34396,33990,3388,37378,766
2021-11-13,Inyo,027,18085,2472,2436,41,2477,42
2021-11-13,Kern,029,883053,130396,128472,23167,151639,1719
2021-11-13,Kings,031,150075,32955,32452,1998,34450,347
2021-11-13,Lake,033,64148,6851,6769,155,6924,109
2021-11-13,Lassen,035,31185,6984,6897,399,7296,47
2021-11-13,Los Angeles,037,10098052,1453512,1443088,55700,1498788,26649
2021-11-13,Madera,039,155013,23850,23462,2215,25677,287
2021-11-13,Marin,041,260295,17816,17684,475,18159,247
2021-11-13,Mariposa,043,17540,1380,1323,52,1375,6
2021-11-13,Mendocino,045,87422,7802,7652,624,8276,89
2021-11-13,Merced,047,269075,42621,42411,2030,44441,644
2021-11-13,Modoc,049,8938,560,536,201,737,5
2021-11-13,Mono,051,14174,1768,1750,22,1772,4
2021-11-13,Monterey,053,433212,49264,48087,3083,51170,609
2021-11-13,Napa,055,140530,13196,13110,117,13227,103
2021-11-13,Nevada,057,99092,9503,9369,335,9704,92
2021-11-13,Orange,059,3164182,310903,308211,15609,323820,5641
2021-11-13,Placer,061,380077,37914,37453,3767,41220,445
2021-11-13,Plumas,063,18699,1882,1828,43,1871,8
2021-11-13,Riverside,065,2383286,368981,363801,16625,380426,5187
2021-11-13,Sacramento,067,1510023,161723,160397,4769,165166,2291
2021-11-13,San Benito,069,59416,7515,7491,174,7665,77
2021-11-13,San Bernardino,071,2135413,359767,356325,11386,367711,5873
2021-11-13,San Diego,073,3302833,380428,377633,22216,399849,4280
2021-11-13,San Francisco,075,870044,53883,53195,2394,55589,667
2021-11-13,San Joaquin,077,732212,101214,100263,5544,105807,1799
2021-11-13,San Luis Obispo,079,281455,30079,29589,1282,30871,351
2021-11-13,San Mateo,081,765935,54964,53853,923,54776,574
2021-11-13,Santa Barbara,083,443738,45143,44734,1586,46320,537
2021-11-13,Santa Clara,085,1922200,149410,147821,1431,149252,1905
2021-11-13,Santa Cruz,087,273765,20815,20565,1022,21587,223
2021-11-13,Shasta,089,179085,22054,21713,3665,25378,366
2021-11-13,Sierra,091,2930,193,188,21,209,0
2021-11-13,Siskiyou,093,43540,3383,3299,1328,4627,54
2021-11-13,Solano,095,438530,46488,45774,1302,47076,350
2021-11-13,Sonoma,097,501317,42212,41882,536,42418,399
2021-11-13,Stanislaus,099,539301,79800,79872,9033,88905,1174
2021-11-13,Sutter,101,95872,14035,14017,366,14383,181
2021-11-13,Tehama,103,63373,8700,8592,1519,10111,125
2021-11-13,Trinity,105,12862,877,749,220,969,17
2021-11-13,Tulare,107,460477,69892,68619,15621,84240,1033
2021-11-13,Tuolumne,109,53932,7472,7392,108,7500,90
2021-11-13,Ventura,111,848112,99248,98452,4358,102810,1183
2021-11-13,Yolo,113,214977,20129,20009,1183,21192,255
2021-11-13,Yuba,115,75493,10320,10218,355,10573,85
2021-11-12,Alameda,001,1643700,121172,120407,2870,123277,1454
2021-11-12,Alpine,003,1148,102,105,0,105,0
2021-11-12,Amador,005,37829,5649,5614,66,5680,66
2021-11-12,Butte,007,227075,21380,21104,3814,24918,296
2021-11-12,Calaveras,009,45235,4245,4203,59,4262,83
2021-11-12,Colusa,011,21464,2561,2522,653,3175,19
2021-11-12,Contra Costa,013,1133247,100687,100004,2263,102267,1028
2021-11-12,Del Norte,015,27424,3715,3629,55,3684,42
2021-11-12,El Dorado,017,186661,16384,16163,1723,17886,159
2021-11-12,Fresno,019,978130,143432,141452,13047,154499,2205
2021-11-12,Glenn,021,27897,3548,3514,1026,4540,34
2021-11-12,Humboldt,023,135768,9304,9177,602,9779,115
2021-11-12,Imperial,025,180216,34370,33990,3378,37368,766
2021-11-12,Inyo,027,18085,2468,2436,41,2477,42
2021-11-12,Kern,029,883053,130259,128472,23135,151607,1719
2021-11-12,Kings,031,150075,32929,32452,1996,34448,347
2021-11-12,Lake,033,64148,6847,6769,155,6924,109
2021-11-12,Lassen,035,31185,6980,6897,398,7295,47
2021-11-12,Los Angeles,037,10098052,1452784,1443088,55655,1498743,26649
2021-11-12,Madera,039,155013,23821,23462,2210,25672,287
2021-11-12,Marin,041,260295,17800,17684,474,18158,247
2021-11-12,Mariposa,043,17540,1373,1323,52,1375,6
2021-11-12,Mendocino,045,87422,7790,7652,621,8273,89
2021-11-12,Merced,047,269075,42592,42411,2028,44439,644
2021-11-12,Modoc,049,8938,559,536,201,737,5
2021-11-12,Mono,051,14174,1766,1750,22,1772,4
2021-11-12,Monterey,053,433212,49232,48087,3077,51164,609
2021-11-12,Napa,055,140530,13187,13110,117,13227,103
2021-11-12,Nevada,057,99092,9489,9369,334,9703,92
2021-11-12,Orange,059,3164182,310715,308211,15591,323802,5641
2021-11-12,Placer,061,380077,37874,37453,3764,41217,445
2021-11-12,Plumas,063,18699,1876,1828,43,1871,8
2021-11-12,Riverside,065,2383286,368714,363801,16621,380422,5187
2021-11-12,Sacramento,067,1510023,161564,160397,4764,165161,2291
2021-11-12,San Benito,069,59416,7515,7491,174,7665,77
2021-11-12,San Bernardino,071,2135413,359460,356325,11375,367700,5873
2021-11-12,San Diego,073,3302833,380053,377633,22194,399827,4280
2021-11-12,San Francisco,075,870044,53848,53195,2390,55585,667
2021-11-12,San Joaquin,077,732212,101169,100263,5538,105801,1799
2021-11-12,San Luis Obispo,079,281455,30050,29589,1281,30870,351
2021-11-12,San Mateo,081,765935,54914,53853,920,54773,574
2021-11-12,Santa Barbara,083,443738,45088,44734,1585,46319,537
2021-11-12,Santa Clara,085,1922200,149268,147821,1426,149247,1905
2021-11-12,Santa Cruz,087,273765,20788,20565,1020,21585,223
2021-11-12,Shasta,089,179085,22022,21713,3662,25375,366
2021-11-12,Sierra,091,2930,192,188,21,209,0
2021-11-12,Siskiyou,093,43540,3382,3299,1326,4625,54
2021-11-12,Solano,095,438530,46461,45774,1298,47072,350
2021-11-12,Sonoma,097,501317,42172,41882,536,42418,399
2021-11-12,Stanislaus,099,539301,79748,79872,9025,88897,1174
2021-11-12,Sutter,101,95872,14028,14017,366,14383,181
2021-11-12,Tehama,103,63373,8696,8592,1518,10110,125
2021-11-12,Trinity,105,12862,870,749,220,969,17
2021-11-12,Tulare,107,460477,69850,68619,15586,84205,1033
2021-11-12,Tuolumne,109,53932,7459,7392,107,7499,90
2021-11-12,Ventura,111,848112,99183,98452,4357,102809,1183
2021-11-12,Yolo,113,214977,20115,20009,1177,21186,255
2021-11-12,Yuba,115,75493,10311,10218,354,10572,85
2021-11-11,Alameda,001,1643700,121056,120147,2862,123009,1453
2021-11-11,Alpine,003,1148,102,105,0,105,0
2021-11-11,Amador,005,37829,5646,5603,65,5668,66
2021-11-11,Butte,007,227075,21337,21047,3809,24856,293
2021-11-11,Calaveras,009,45235,4227,4179,59,4238,83
2021-11-11,Colusa,011,21464,2553,2518,651,3169,19
2021-11-11,Contra Costa,013,1133247,100582,99808,2258,102066,1028
2021-11-11,Del Norte,015,27424,3713,3622,55,3677,42
2021-11-11,El Dorado,017,186661,16350,16085,1720,17805,159
2021-11-11,Fresno,019,978130,143227,140833,13013,153846,2202
2021-11-11,Glenn,021,27897,3546,3503,1026,4529,34
2021-11-11,Humboldt,023,135768,9281,9125,599,9724,115
2021-11-11,Imperial,025,180216,34301,33844,3356,37200,766
2021-11-11,Inyo,027,18085,2463,2428,41,2469,42
2021-11-11,Kern,029,883053,130075,128023,23071,151094,1709
2021-11-11,Kings,031,150075,32878,32318,1994,34312,345
2021-11-11,Lake,033,64148,6840,6745,155,6900,107
2021-11-11,Lassen,035,31185,6974,6875,398,7273,47
2021-11-11,Los Angeles,037,10098052,1451694,1440436,55596,1496032,26614
2021-11-11,Madera,039,155013,23774,23316,2202,25518,287
2021-11-11,Marin,041,260295,17790,17639,474,18113,247
2021-11-11,Mariposa,043,17540,1363,1317,52,1369,6
2021-11-11,Mendocino,045,87422,7775,7612,612,8224,89
2021-11-11,Merced,047,269075,42536,42292,2025,44317,643
2021-11-11,Modoc,049,8938,557,536,201,737,5
2021-11-11,Mono,051,14174,1762,1743,22,1765,4
2021-11-11,Monterey,053,433212,49197,48008,3065,51073,609
2021-11-11,Napa,055,140530,13179,13075,117,13192,103
2021-11-11,Nevada,057,99092,9467,9308,334,9642,92
2021-11-11,Orange,059,3164182,310441,307674,15553,323227,5633
2021-11-11,Placer,061,380077,37823,37333,3756,41089,440
2021-11-11,Plumas,063,18699,1872,1814,43,1857,7
2021-11-11,Riverside,065,2383286,368281,362930,16603,379533,5175
2021-11-11,Sacramento,067,1510023,161351,159962,4745,164707,2289
2021-11-11,San Benito,069,59416,7507,7473,174,7647,76
2021-11-11,San Bernardino,071,2135413,359033,355413,11362,366775,5849
2021-11-11,San Diego,073,3302833,379538,376428,22171,398599,4272
2021-11-11,San Francisco,075,870044,53789,53063,2388,55451,666
2021-11-11,San Joaquin,077,732212,101074,99937,5523,105460,1799
2021-11-11,San Luis Obispo,079,281455,29999,29532,1279,30811,351
2021-11-11,San Mateo,081,765935,54865,53722,915,54637,574
2021-11-11,Santa Barbara,083,443738,45030,44603,1582,46185,534
2021-11-11,Santa Clara,085,1922200,149086,147458,1420,148878,1901
2021-11-11,Santa Cruz,087,273765,20743,20479,1020,21499,222
2021-11-11,Shasta,089,179085,21975,21600,3660,25260,364
2021-11-11,Sierra,091,2930,191,186,21,207,0
2021-11-11,Siskiyou,093,43540,3376,3297,1325,4622,53
2021-11-11,Solano,095,438530,46424,45679,1297,46976,350
2021-11-11,Sonoma,097,501317,42135,41774,536,42310,395
2021-11-11,Stanislaus,099,539301,79665,79570,9011,88581,1166
2021-11-11,Sutter,101,95872,14014,13993,365,14358,181
2021-11-11,Tehama,103,63373,8684,8565,1516,10081,125
2021-11-11,Trinity,105,12862,869,748,220,968,17
2021-11-11,Tulare,107,460477,69757,68367,15550,83917,1028
2021-11-11,Tuolumne,109,53932,7446,7354,107,7461,90
2021-11-11,Ventura,111,848112,99105,98297,4350,102647,1182
2021-11-11,Yolo,113,214977,20088,19946,1175,21121,255
2021-11-11,Yuba,115,75493,10295,10191,354,10545,85
2021-11-10,Alameda,001,1643700,120947,120147,2853,123000,1453
2021-11-10,Alpine,003,1148,102,105,0,105,0
2021-11-10,Amador,005,37829,5640,5603,65,5668,66
2021-11-10,Butte,007,227075,21311,21047,3805,24852,293
2021-11-10,Calaveras,009,45235,4216,4179,59,4238,83
2021-11-10,Colusa,011,21464,2547,2518,651,3169,19
2021-11-10,Contra Costa,013,1133247,100499,99808,2254,102062,1028
2021-11-10,Del Norte,015,27424,3712,3622,55,3677,42
2021-11-10,El Dorado,017,186661,16334,16085,1719,17804,159
2021-11-10,Fresno,019,978130,143047,140833,12999,153832,2202
2021-11-10,Glenn,021,27897,3546,3503,1025,4528,34
2021-11-10,Humboldt,023,135768,9263,9125,599,9724,115
2021-11-10,Imperial,025,180216,34252,33844,3337,37181,766
2021-11-10,Inyo,027,18085,2456,2428,41,2469,42
2021-11-10,Kern,029,883053,129926,128023,23015,151038,1709
2021-11-10,Kings,031,150075,32845,32318,1992,34310,345
2021-11-10,Lake,033,64148,6830,6745,155,6900,107
2021-11-10,Lassen,035,31185,6969,6875,398,7273,47
2021-11-10,Los Angeles,037,10098052,1450742,1440436,55537,1495973,26614
2021-11-10,Madera,039,155013,23725,23316,2196,25512,287
2021-11-10,Marin,041,260295,17777,17639,472,18111,247
2021-11-10,Mariposa,043,17540,1357,1317,52,1369,6
2021-11-10,Mendocino,045,87422,7763,7612,611,8223,89
2021-11-10,Merced,047,269075,42501,42292,2023,44315,643
2021-11-10,Modoc,049,8938,556,536,200,736,5
2021-11-10,Mono,051,14174,1760,1743,22,1765,4
2021-11-10,Monterey,053,433212,49163,48008,3053,51061,609
2021-11-10,Napa,055,140530,13165,13075,116,13191,103
2021-11-10,Nevada,057,99092,9460,9308,332,9640,92
2021-11-10,Orange,059,3164182,310178,307674,15521,323195,5633
2021-11-10,Placer,061,380077,37778,37333,3749,41082,440
2021-11-10,Plumas,063,18699,1866,1814,42,1856,7
2021-11-10,Riverside,065,2383286,367900,362930,16597,379527,5175
2021-11-10,Sacramento,067,1510023,161196,159962,4735,164697,2289
2021-11-10,San Benito,069,59416,7499,7473,174,7647,76
2021-11-10,San Bernardino,071,2135413,358695,355413,11354,366767,5849
2021-11-10,San Diego,073,3302833,379122,376428,22149,398577,4272
2021-11-10,San Francisco,075,870044,53728,53063,2385,55448,666
2021-11-10,San Joaquin,077,732212,100967,99937,5517,105454,1799
2021-11-10,San Luis Obispo,079,281455,29968,29532,1278,30810,351
2021-11-10,San Mateo,081,765935,54811,53722,914,54636,574
2021-11-10,Santa Barbara,083,443738,44992,44603,1581,46184,534
2021-11-10,Santa Clara,085,1922200,148938,147458,1414,148872,1901
2021-11-10,Santa Cruz,087,273765,20716,20479,1019,21498,222
2021-11-10,Shasta,089,179085,21939,21600,3658,25258,364
2021-11-10,Sierra,091,2930,190,186,21,207,0
2021-11-10,Siskiyou,093,43540,3374,3297,1325,4622,53
2021-11-10,Solano,095,438530,46394,45679,1295,46974,350
2021-11-10,Sonoma,097,501317,42084,41774,536,42310,395
2021-11-10,Stanislaus,099,539301,79564,79570,8995,88565,1166
2021-11-10,Sutter,101,95872,14006,13993,365,14358,181
2021-11-10,Tehama,103,63373,8672,8565,1510,10075,125
2021-11-10,Trinity,105,12862,865,748,219,967,17
2021-11-10,Tulare,107,460477,69697,68367,15509,83876,1028
2021-11-10,Tuolumne,109,53932,7422,7354,107,7461,90
2021-11-10,Ventura,111,848112,99034,98297,4350,102647,1182
2021-11-10,Yolo,113,214977,20069,19946,1174,21120,255
2021-11-10,Yuba,115,75493,10286,10191,354,10545,85
2021-11-09,Alameda,001,1643700,120810,120051,2843,122894,1450
2021-11-09,Alpine,003,1148,102,105,0,105,0
2021-11-09,Amador,005,37829,5636,5596,65,5661,66
2021-11-09,Butte,007,227075,21290,21022,3802,24824,291
2021-11-09,Calaveras,009,45235,4212,4174,59,4233,84
2021-11-09,Colusa,011,21464,2542,2517,650,3167,19
2021-11-09,Contra Costa,013,1133247,100404,99732,2246,101978,1028
2021-11-09,Del Norte,015,27424,3711,3620,55,3675,42
2021-11-09,El Dorado,017,186661,16296,16073,1714,17787,160
2021-11-09,Fresno,019,978130,142804,140666,12984,153650,2188
2021-11-09,Glenn,021,27897,3541,3499,1025,4524,34
2021-11-09,Humboldt,023,135768,9242,9112,594,9706,115
2021-11-09,Imperial,025,180216,34200,33751,3323,37074,766
2021-11-09,Inyo,027,18085,2452,2404,41,2445,42
2021-11-09,Kern,029,883053,129682,127901,22952,150853,1694
2021-11-09,Kings,031,150075,32778,32279,1988,34267,344
2021-11-09,Lake,033,64148,6821,6743,155,6898,106
2021-11-09,Lassen,035,31185,6957,6846,398,7244,47
2021-11-09,Los Angeles,037,10098052,1449495,1439125,55474,1494599,26581
2021-11-09,Madera,039,155013,23675,23285,2187,25472,287
2021-11-09,Marin,041,260295,17758,17630,470,18100,247
2021-11-09,Mariposa,043,17540,1349,1317,51,1368,5
2021-11-09,Mendocino,045,87422,7740,7598,605,8203,85
2021-11-09,Merced,047,269075,42460,42251,2017,44268,613
2021-11-09,Modoc,049,8938,555,536,198,734,5
2021-11-09,Mono,051,14174,1755,1738,22,1760,4
2021-11-09,Monterey,053,433212,49126,47975,3029,51004,609
2021-11-09,Napa,055,140530,13147,13051,116,13167,103
2021-11-09,Nevada,057,99092,9441,9288,332,9620,92
2021-11-09,Orange,059,3164182,309893,307412,15493,322905,5621
2021-11-09,Placer,061,380077,37724,37291,3732,41023,440
2021-11-09,Plumas,063,18699,1864,1802,42,1844,7
2021-11-09,Riverside,065,2383286,367435,362557,16582,379139,5160
2021-11-09,Sacramento,067,1510023,160955,159856,4725,164581,2286
2021-11-09,San Benito,069,59416,7489,7471,173,7644,76
2021-11-09,San Bernardino,071,2135413,358248,354972,11337,366309,5839
2021-11-09,San Diego,073,3302833,378615,375997,22123,398120,4272
2021-11-09,San Francisco,075,870044,53655,52996,2379,55375,666
2021-11-09,San Joaquin,077,732212,100791,99848,5504,105352,1794
2021-11-09,San Luis Obispo,079,281455,29925,29488,1277,30765,350
2021-11-09,San Mateo,081,765935,54764,53697,904,54601,574
2021-11-09,Santa Barbara,083,443738,44925,44579,1574,46153,533
2021-11-09,Santa Clara,085,1922200,148731,147281,1407,148688,1901
2021-11-09,Santa Cruz,087,273765,20682,20463,1018,21481,222
2021-11-09,Shasta,089,179085,21884,21558,3653,25211,364
2021-11-09,Sierra,091,2930,190,186,21,207,0
2021-11-09,Siskiyou,093,43540,3372,3295,1323,4618,52
2021-11-09,Solano,095,438530,46339,45639,1294,46933,350
2021-11-09,Sonoma,097,501317,42027,41727,534,42261,395
2021-11-09,Stanislaus,099,539301,79458,79505,8978,88483,1165
2021-11-09,Sutter,101,95872,13991,13988,363,14351,180
2021-11-09,Tehama,103,63373,8654,8555,1508,10063,125
2021-11-09,Trinity,105,12862,864,746,219,965,17
2021-11-09,Tulare,107,460477,69591,68298,15469,83767,1024
2021-11-09,Tuolumne,109,53932,7402,7347,107,7454,90
2021-11-09,Ventura,111,848112,98955,98202,4345,102547,1182
2021-11-09,Yolo,113,214977,20045,19931,1170,21101,255
2021-11-09,Yuba,115,75493,10269,10175,348,10523,85
2021-11-08,Alameda,001,1643700,120667,119983,2837,122820,1447
2021-11-08,Alpine,003,1148,102,105,0,105,0
2021-11-08,Amador,005,37829,5630,5590,65,5655,66
2021-11-08,Butte,007,227075,21262,21000,3794,24794,288
2021-11-08,Calaveras,009,45235,4204,4166,59,4225,82
2021-11-08,Colusa,011,21464,2541,2514,649,3163,19
2021-11-08,Contra Costa,013,1133247,100301,99669,2242,101911,1028
2021-11-08,Del Norte,015,27424,3707,3619,55,3674,42
2021-11-08,El Dorado,017,186661,16277,16055,1709,17764,156
2021-11-08,Fresno,019,978130,142503,140466,12962,153428,2179
2021-11-08,Glenn,021,27897,3538,3496,1021,4517,34
2021-11-08,Humboldt,023,135768,9215,9095,584,9679,109
2021-11-08,Imperial,025,180216,34120,33690,3305,36995,766
2021-11-08,Inyo,027,18085,2445,2398,41,2439,41
2021-11-08,Kern,029,883053,129446,127722,22869,150591,1692
2021-11-08,Kings,031,150075,32732,32248,1987,34235,344
2021-11-08,Lake,033,64148,6815,6737,155,6892,106
2021-11-08,Lassen,035,31185,6950,6830,396,7226,46
2021-11-08,Los Angeles,037,10098052,1448154,1438322,55414,1493736,26575
2021-11-08,Madera,039,155013,23626,23253,2176,25429,287
2021-11-08,Marin,041,260295,17741,17617,467,18084,247
2021-11-08,Mariposa,043,17540,1341,1316,50,1366,5
2021-11-08,Mendocino,045,87422,7727,7581,599,8180,85
2021-11-08,Merced,047,269075,42391,42224,2007,44231,607
2021-11-08,Modoc,049,8938,554,529,198,727,5
2021-11-08,Mono,051,14174,1751,1739,22,1761,4
2021-11-08,Monterey,053,433212,49085,47942,3008,50950,602
2021-11-08,Napa,055,140530,13133,13045,116,13161,103
2021-11-08,Nevada,057,99092,9422,9278,330,9608,92
2021-11-08,Orange,059,3164182,309620,307156,15462,322618,5616
2021-11-08,Placer,061,380077,37672,37250,3729,40979,439
2021-11-08,Plumas,063,18699,1863,1788,41,1829,7
2021-11-08,Riverside,065,2383286,366980,362201,16568,378769,5152
2021-11-08,Sacramento,067,1510023,160739,159735,4705,164440,2275
2021-11-08,San Benito,069,59416,7487,7461,173,7634,75
2021-11-08,San Bernardino,071,2135413,357741,354741,11319,366060,5836
2021-11-08,San Diego,073,3302833,378026,375557,22076,397633,4259
2021-11-08,San Francisco,075,870044,53602,52942,2373,55315,666
2021-11-08,San Joaquin,077,732212,100677,99736,5502,105238,1794
2021-11-08,San Luis Obispo,079,281455,29873,29464,1272,30736,350
2021-11-08,San Mateo,081,765935,54690,53658,899,54557,574
2021-11-08,Santa Barbara,083,443738,44871,44548,1573,46121,532
2021-11-08,Santa Clara,085,1922200,148503,147183,1401,148584,1899
2021-11-08,Santa Cruz,087,273765,20653,20435,1018,21453,222
2021-11-08,Shasta,089,179085,21837,21504,3647,25151,354
2021-11-08,Sierra,091,2930,190,183,21,204,0
2021-11-08,Siskiyou,093,43540,3368,3290,1312,4602,50
2021-11-08,Solano,095,438530,46298,45613,1290,46903,350
2021-11-08,Sonoma,097,501317,41959,41669,532,42201,395
2021-11-08,Stanislaus,099,539301,79306,79417,8964,88381,1150
2021-11-08,Sutter,101,95872,13983,13976,359,14335,180
2021-11-08,Tehama,103,63373,8645,8534,1508,10042,123
2021-11-08,Trinity,105,12862,864,743,218,961,13
2021-11-08,Tulare,107,460477,69474,68199,15431,83630,1020
2021-11-08,Tuolumne,109,53932,7383,7328,106,7434,90
2021-11-08,Ventura,111,848112,98862,98144,4343,102487,1182
2021-11-08,Yolo,113,214977,20007,19916,1165,21081,255
2021-11-08,Yuba,115,75493,10258,10172,345,10517,83
2021-11-07,Alameda,001,1643700,120510,119902,2831,122733,1444
2021-11-07,Alpine,003,1148,102,105,0,105,0
2021-11-07,Amador,005,37829,5622,5580,63,5643,66
2021-11-07,Butte,007,227075,21223,20969,3785,24754,288
2021-11-07,Calaveras,009,45235,4177,4158,58,4216,82
2021-11-07,Colusa,011,21464,2535,2511,647,3158,19
2021-11-07,Contra Costa,013,1133247,100189,99596,2233,101829,1028
2021-11-07,Del Norte,015,27424,3705,3617,55,3672,42
2021-11-07,El Dorado,017,186661,16240,16040,1706,17746,156
2021-11-07,Fresno,019,978130,142160,140263,12934,153197,2179
2021-11-07,Glenn,021,27897,3531,3493,1020,4513,34
2021-11-07,Humboldt,023,135768,9190,9074,580,9654,109
2021-11-07,Imperial,025,180216,34047,33674,3286,36960,766
2021-11-07,Inyo,027,18085,2432,2394,41,2435,41
2021-11-07,Kern,029,883053,129173,127583,22777,150360,1692
2021-11-07,Kings,031,150075,32642,32221,1984,34205,343
2021-11-07,Lake,033,64148,6799,6734,154,6888,106
2021-11-07,Lassen,035,31185,6941,6819,392,7211,46
2021-11-07,Los Angeles,037,10098052,1446664,1437314,55337,1492651,26573
2021-11-07,Madera,039,155013,23581,23225,2168,25393,287
2021-11-07,Marin,041,260295,17721,17594,466,18060,247
2021-11-07,Mariposa,043,17540,1339,1306,50,1356,5
2021-11-07,Mendocino,045,87422,7699,7567,595,8162,85
2021-11-07,Merced,047,269075,42312,42186,1976,44162,607
2021-11-07,Modoc,049,8938,551,528,197,725,5
2021-11-07,Mono,051,14174,1745,1739,22,1761,4
2021-11-07,Monterey,053,433212,49033,47924,3003,50927,602
2021-11-07,Napa,055,140530,13112,13041,116,13157,103
2021-11-07,Nevada,057,99092,9374,9254,330,9584,92
2021-11-07,Orange,059,3164182,309295,306954,15423,322377,5616
2021-11-07,Placer,061,380077,37596,37202,3714,40916,439
2021-11-07,Plumas,063,18699,1856,1787,40,1827,7
2021-11-07,Riverside,065,2383286,366445,361960,16548,378508,5152
2021-11-07,Sacramento,067,1510023,160507,159549,4688,164237,2277
2021-11-07,San Benito,069,59416,7474,7460,173,7633,75
2021-11-07,San Bernardino,071,2135413,357235,354488,11296,365784,5832
2021-11-07,San Diego,073,3302833,377438,375165,22043,397208,4250
2021-11-07,San Francisco,075,870044,53518,52868,2367,55235,666
2021-11-07,San Joaquin,077,732212,100492,99696,5496,105192,1794
2021-11-07,San Luis Obispo,079,281455,29822,29454,1268,30722,350
2021-11-07,San Mateo,081,765935,54631,53600,897,54497,574
2021-11-07,Santa Barbara,083,443738,44808,44501,1572,46073,532
2021-11-07,Santa Clara,085,1922200,148299,147054,1388,148442,1898
2021-11-07,Santa Cruz,087,273765,20595,20397,1017,21414,222
2021-11-07,Shasta,089,179085,21789,21479,3641,25120,354
2021-11-07,Sierra,091,2930,188,183,21,204,0
2021-11-07,Siskiyou,093,43540,3362,3289,1310,4599,51
2021-11-07,Solano,095,438530,46243,45582,1283,46865,350
2021-11-07,Sonoma,097,501317,41909,41630,532,42162,395
2021-11-07,Stanislaus,099,539301,79151,79351,8944,88295,1150
2021-11-07,Sutter,101,95872,13970,13964,356,14320,180
2021-11-07,Tehama,103,63373,8621,8528,1506,10034,121
2021-11-07,Trinity,105,12862,863,742,217,959,13
2021-11-07,Tulare,107,460477,69321,68145,15388,83533,1020
2021-11-07,Tuolumne,109,53932,7365,7300,104,7404,90
2021-11-07,Ventura,111,848112,98770,98085,4341,102426,1182
2021-11-07,Yolo,113,214977,19986,19899,1160,21059,255
2021-11-07,Yuba,115,75493,10241,10162,340,10502,83
2021-11-06,Alameda,001,1643700,120447,119499,2827,122326,1436
2021-11-06,Alpine,003,1148,102,105,0,105,0
2021-11-06,Amador,005,37829,5616,5557,63,5620,66
2021-11-06,Butte,007,227075,21203,20796,3781,24577,288
2021-11-06,Calaveras,009,45235,4169,4105,58,4163,82
2021-11-06,Colusa,011,21464,2534,2501,646,3147,19
2021-11-06,Contra Costa,013,1133247,100134,99282,2231,101513,1025
2021-11-06,Del Norte,015,27424,3702,3607,55,3662,42
2021-11-06,El Dorado,017,186661,16223,15958,1706,17664,156
2021-11-06,Fresno,019,978130,142041,139249,12929,152178,2170
2021-11-06,Glenn,021,27897,3528,3479,1020,4499,33
2021-11-06,Humboldt,023,135768,9178,8972,576,9548,109
2021-11-06,Imperial,025,180216,34001,33471,3280,36751,766
2021-11-06,Inyo,027,18085,2426,2353,41,2394,41
2021-11-06,Kern,029,883053,129040,126848,22724,149572,1684
2021-11-06,Kings,031,150075,32609,32018,1979,33997,342
2021-11-06,Lake,033,64148,6797,6695,154,6849,106
2021-11-06,Lassen,035,31185,6936,6796,391,7187,46
2021-11-06,Los Angeles,037,10098052,1445889,1433081,55294,1488375,26533
2021-11-06,Madera,039,155013,23545,22994,2158,25152,287
2021-11-06,Marin,041,260295,17702,17520,463,17983,247
2021-11-06,Mariposa,043,17540,1337,1282,50,1332,5
2021-11-06,Mendocino,045,87422,7677,7486,595,8081,85
2021-11-06,Merced,047,269075,42288,41958,1968,43926,604
2021-11-06,Modoc,049,8938,550,523,197,720,5
2021-11-06,Mono,051,14174,1743,1725,22,1747,4
2021-11-06,Monterey,053,433212,49001,47830,2993,50823,602
2021-11-06,Napa,055,140530,13102,12950,116,13066,103
2021-11-06,Nevada,057,99092,9352,9169,329,9498,91
2021-11-06,Orange,059,3164182,309088,306049,15397,321446,5611
2021-11-06,Placer,061,380077,37555,36967,3711,40678,438
2021-11-06,Plumas,063,18699,1852,1755,39,1794,7
2021-11-06,Riverside,065,2383286,366127,360584,16539,377123,5138
2021-11-06,Sacramento,067,1510023,160414,158766,4683,163449,2263
2021-11-06,San Benito,069,59416,7467,7429,173,7602,75
2021-11-06,San Bernardino,071,2135413,356964,353142,11292,364434,5813
2021-11-06,San Diego,073,3302833,377090,373423,22025,395448,4246
2021-11-06,San Francisco,075,870044,53465,52556,2364,54920,666
2021-11-06,San Joaquin,077,732212,100435,99372,5495,104867,1782
2021-11-06,San Luis Obispo,079,281455,29794,29335,1264,30599,350
2021-11-06,San Mateo,081,765935,54597,53442,896,54338,574
2021-11-06,Santa Barbara,083,443738,44772,44301,1571,45872,532
2021-11-06,Santa Clara,085,1922200,148154,146519,1383,147902,1894
2021-11-06,Santa Cruz,087,273765,20576,20311,1015,21326,222
2021-11-06,Shasta,089,179085,21770,21281,3636,24917,349
2021-11-06,Sierra,091,2930,188,181,21,202,0
2021-11-06,Siskiyou,093,43540,3362,3279,1308,4587,48
2021-11-06,Solano,095,438530,46213,45465,1282,46747,350
2021-11-06,Sonoma,097,501317,41859,41398,531,41929,395
2021-11-06,Stanislaus,099,539301,79083,78902,8936,87838,1193
2021-11-06,Sutter,101,95872,13966,13908,355,14263,180
2021-11-06,Tehama,103,63373,8610,8474,1504,9978,120
2021-11-06,Trinity,105,12862,860,732,217,949,11
2021-11-06,Tulare,107,460477,69271,67767,15359,83126,1010
2021-11-06,Tuolumne,109,53932,7352,7245,104,7349,90
2021-11-06,Ventura,111,848112,98704,97770,4336,102106,1180
2021-11-06,Yolo,113,214977,19969,19827,1156,20983,255
2021-11-06,Yuba,115,75493,10227,10107,340,10447,83
2021-11-05,Alameda,001,1643700,120364,119499,2825,122324,1436
2021-11-05,Alpine,003,1148,102,105,0,105,0
2021-11-05,Amador,005,37829,5611,5557,63,5620,66
2021-11-05,Butte,007,227075,21190,20796,3780,24576,288
2021-11-05,Calaveras,009,45235,4164,4105,58,4163,82
2021-11-05,Colusa,011,21464,2534,2501,645,3146,19
2021-11-05,Contra Costa,013,1133247,100069,99282,2229,101511,1025
2021-11-05,Del Norte,015,27424,3700,3607,55,3662,42
2021-11-05,El Dorado,017,186661,16205,15958,1700,17658,156
2021-11-05,Fresno,019,978130,141863,139249,12920,152169,2170
2021-11-05,Glenn,021,27897,3528,3479,1019,4498,33
2021-11-05,Humboldt,023,135768,9164,8972,576,9548,109
2021-11-05,Imperial,025,180216,33966,33471,3277,36748,766
2021-11-05,Inyo,027,18085,2418,2353,41,2394,41
2021-11-05,Kern,029,883053,128913,126848,22668,149516,1684
2021-11-05,Kings,031,150075,32585,32018,1978,33996,342
2021-11-05,Lake,033,64148,6791,6695,154,6849,106
2021-11-05,Lassen,035,31185,6932,6796,390,7186,46
2021-11-05,Los Angeles,037,10098052,1445070,1433081,55256,1488337,26533
2021-11-05,Madera,039,155013,23507,22994,2157,25151,287
2021-11-05,Marin,041,260295,17680,17520,462,17982,247
2021-11-05,Mariposa,043,17540,1334,1282,49,1331,5
2021-11-05,Mendocino,045,87422,7666,7486,594,8080,85
2021-11-05,Merced,047,269075,42262,41958,1959,43917,604
2021-11-05,Modoc,049,8938,550,523,197,720,5
2021-11-05,Mono,051,14174,1742,1725,22,1747,4
2021-11-05,Monterey,053,433212,48971,47830,2991,50821,602
2021-11-05,Napa,055,140530,13080,12950,116,13066,103
2021-11-05,Nevada,057,99092,9339,9169,329,9498,91
2021-11-05,Orange,059,3164182,308890,306049,15375,321424,5611
2021-11-05,Placer,061,380077,37528,36967,3701,40668,438
2021-11-05,Plumas,063,18699,1844,1755,39,1794,7
2021-11-05,Riverside,065,2383286,365786,360584,16529,377113,5138
2021-11-05,Sacramento,067,1510023,160292,158766,4677,163443,2263
2021-11-05,San Benito,069,59416,7465,7429,172,7601,75
2021-11-05,San Bernardino,071,2135413,356632,353142,11281,364423,5813
2021-11-05,San Diego,073,3302833,376725,373423,22013,395436,4246
2021-11-05,San Francisco,075,870044,53414,52556,2361,54917,666
2021-11-05,San Joaquin,077,732212,100382,99372,5486,104858,1782
2021-11-05,San Luis Obispo,079,281455,29771,29335,1264,30599,350
2021-11-05,San Mateo,081,765935,54555,53442,894,54336,574
2021-11-05,Santa Barbara,083,443738,44727,44301,1570,45871,532
2021-11-05,Santa Clara,085,1922200,148016,146519,1382,147901,1894
2021-11-05,Santa Cruz,087,273765,20552,20311,1014,21325,222
2021-11-05,Shasta,089,179085,21738,21281,3631,24912,349
2021-11-05,Sierra,091,2930,188,181,21,202,0
2021-11-05,Siskiyou,093,43540,3357,3279,1307,4586,48
2021-11-05,Solano,095,438530,46168,45465,1279,46744,350
2021-11-05,Sonoma,097,501317,41819,41398,531,41929,395
2021-11-05,Stanislaus,099,539301,79025,78902,8924,87826,1193
2021-11-05,Sutter,101,95872,13958,13908,354,14262,180
2021-11-05,Tehama,103,63373,8603,8474,1503,9977,120
2021-11-05,Trinity,105,12862,860,732,217,949,11
2021-11-05,Tulare,107,460477,69198,67767,15323,83090,1010
2021-11-05,Tuolumne,109,53932,7335,7245,103,7348,90
2021-11-05,Ventura,111,848112,98664,97770,4333,102103,1180
2021-11-05,Yolo,113,214977,19958,19827,1155,20982,255
2021-11-05,Yuba,115,75493,10214,10107,338,10445,83
2021-11-04,Alameda,001,1643700,120247,119499,2819,122318,1436
2021-11-04,Alpine,003,1148,102,105,0,105,0
2021-11-04,Amador,005,37829,5603,5557,63,5620,66
2021-11-04,Butte,007,227075,21148,20796,3770,24566,288
2021-11-04,Calaveras,009,45235,4150,4105,56,4161,82
2021-11-04,Colusa,011,21464,2528,2501,644,3145,19
2021-11-04,Contra Costa,013,1133247,99977,99282,2224,101506,1025
2021-11-04,Del Norte,015,27424,3697,3607,55,3662,42
2021-11-04,El Dorado,017,186661,16179,15958,1696,17654,156
2021-11-04,Fresno,019,978130,141581,139249,12911,152160,2170
2021-11-04,Glenn,021,27897,3523,3479,1018,4497,33
2021-11-04,Humboldt,023,135768,9139,8972,573,9545,109
2021-11-04,Imperial,025,180216,33908,33471,3268,36739,766
2021-11-04,Inyo,027,18085,2410,2353,41,2394,41
2021-11-04,Kern,029,883053,128681,126848,22600,149448,1684
2021-11-04,Kings,031,150075,32506,32018,1968,33986,342
2021-11-04,Lake,033,64148,6781,6695,152,6847,106
2021-11-04,Lassen,035,31185,6922,6796,385,7181,46
2021-11-04,Los Angeles,037,10098052,1443773,1433081,55172,1488253,26533
2021-11-04,Madera,039,155013,23452,22994,2146,25140,287
2021-11-04,Marin,041,260295,17668,17520,460,17980,247
2021-11-04,Mariposa,043,17540,1327,1282,49,1331,5
2021-11-04,Mendocino,045,87422,7653,7486,588,8074,85
2021-11-04,Merced,047,269075,42207,41958,1955,43913,604
2021-11-04,Modoc,049,8938,549,523,197,720,5
2021-11-04,Mono,051,14174,1737,1725,22,1747,4
2021-11-04,Monterey,053,433212,48926,47830,2975,50805,602
2021-11-04,Napa,055,140530,13059,12950,116,13066,103
2021-11-04,Nevada,057,99092,9308,9169,328,9497,91
2021-11-04,Orange,059,3164182,308642,306049,15356,321405,5611
2021-11-04,Placer,061,380077,37457,36967,3692,40659,438
2021-11-04,Plumas,063,18699,1836,1755,35,1790,7
2021-11-04,Riverside,065,2383286,365390,360584,16520,377104,5138
2021-11-04,Sacramento,067,1510023,160058,158766,4656,163422,2263
2021-11-04,San Benito,069,59416,7459,7429,172,7601,75
2021-11-04,San Bernardino,071,2135413,356197,353142,11274,364416,5813
2021-11-04,San Diego,073,3302833,376244,373423,21992,395415,4246
2021-11-04,San Francisco,075,870044,53333,52556,2357,54913,666
2021-11-04,San Joaquin,077,732212,100274,99372,5474,104846,1782
2021-11-04,San Luis Obispo,079,281455,29747,29335,1258,30593,350
2021-11-04,San Mateo,081,765935,54496,53442,888,54330,574
2021-11-04,Santa Barbara,083,443738,44671,44301,1570,45871,532
2021-11-04,Santa Clara,085,1922200,147862,146519,1378,147897,1894
2021-11-04,Santa Cruz,087,273765,20517,20311,1014,21325,222
2021-11-04,Shasta,089,179085,21680,21281,3625,24906,349
2021-11-04,Sierra,091,2930,186,181,21,202,0
2021-11-04,Siskiyou,093,43540,3354,3279,1300,4579,48
2021-11-04,Solano,095,438530,46126,45465,1278,46743,350
2021-11-04,Sonoma,097,501317,41759,41398,531,41929,395
2021-11-04,Stanislaus,099,539301,78887,78902,8918,87820,1193
2021-11-04,Sutter,101,95872,13947,13908,352,14260,180
2021-11-04,Tehama,103,63373,8594,8474,1499,9973,120
2021-11-04,Trinity,105,12862,859,732,217,949,11
2021-11-04,Tulare,107,460477,69082,67767,15277,83044,1010
2021-11-04,Tuolumne,109,53932,7313,7245,101,7346,90
2021-11-04,Ventura,111,848112,98576,97770,4330,102100,1180
2021-11-04,Yolo,113,214977,19933,19827,1149,20976,255
2021-11-04,Yuba,115,75493,10200,10107,336,10443,83
2021-11-03,Alameda,001,1643700,120105,119356,2815,122171,1428
2021-11-03,Alpine,003,1148,102,105,0,105,0
2021-11-03,Amador,005,37829,5597,5545,62,5607,66
2021-11-03,Butte,007,227075,21103,20769,3761,24530,284
2021-11-03,Calaveras,009,45235,4132,4087,55,4142,82
2021-11-03,Colusa,011,21464,2522,2499,644,3143,20
2021-11-03,Contra Costa,013,1133247,99877,99168,2219,101387,1025
2021-11-03,Del Norte,015,27424,3695,3600,54,3654,42
2021-11-03,El Dorado,017,186661,16153,15915,1693,17608,156
2021-11-03,Fresno,019,978130,141217,138873,12887,151760,2166
2021-11-03,Glenn,021,27897,3519,3470,1018,4488,33
2021-11-03,Humboldt,023,135768,9122,8949,568,9517,109
2021-11-03,Imperial,025,180216,33837,33402,3258,36660,766
2021-11-03,Inyo,027,18085,2389,2344,41,2385,41
2021-11-03,Kern,029,883053,128421,126523,22498,149021,1681
2021-11-03,Kings,031,150075,32451,31923,1961,33884,341
2021-11-03,Lake,033,64148,6765,6685,152,6837,106
2021-11-03,Lassen,035,31185,6906,6782,380,7162,46
2021-11-03,Los Angeles,037,10098052,1442424,1431209,55087,1486296,26517
2021-11-03,Madera,039,155013,23385,22893,2137,25030,287
2021-11-03,Marin,041,260295,17647,17491,456,17947,247
2021-11-03,Mariposa,043,17540,1317,1276,49,1325,5
2021-11-03,Mendocino,045,87422,7637,7457,580,8037,84
2021-11-03,Merced,047,269075,42146,41849,1945,43794,597
2021-11-03,Modoc,049,8938,549,521,195,716,5
2021-11-03,Mono,051,14174,1733,1719,22,1741,4
2021-11-03,Monterey,053,433212,48877,47794,2962,50756,601
2021-11-03,Napa,055,140530,13047,12937,115,13052,103
2021-11-03,Nevada,057,99092,9281,9131,327,9458,91
2021-11-03,Orange,059,3164182,308331,305661,15323,320984,5607
2021-11-03,Placer,061,380077,37387,36868,3687,40555,438
2021-11-03,Plumas,063,18699,1825,1739,34,1773,7
2021-11-03,Riverside,065,2383286,364932,360060,16516,376576,5131
2021-11-03,Sacramento,067,1510023,159834,158311,4645,162956,2259
2021-11-03,San Benito,069,59416,7451,7419,172,7591,75
2021-11-03,San Bernardino,071,2135413,355721,352225,11254,363479,5813
2021-11-03,San Diego,073,3302833,375733,372951,21969,394920,4241
2021-11-03,San Francisco,075,870044,53240,52493,2352,54845,663
2021-11-03,San Joaquin,077,732212,100162,99188,5463,104651,1776
2021-11-03,San Luis Obispo,079,281455,29705,29276,1252,30528,348
2021-11-03,San Mateo,081,765935,54432,53396,882,54278,571
2021-11-03,Santa Barbara,083,443738,44614,44220,1567,45787,531
2021-11-03,Santa Clara,085,1922200,147692,146259,1371,147630,1897
2021-11-03,Santa Cruz,087,273765,20482,20275,1014,21289,222
2021-11-03,Shasta,089,179085,21622,21215,3618,24833,346
2021-11-03,Sierra,091,2930,184,180,21,201,0
2021-11-03,Siskiyou,093,43540,3350,3276,1298,4574,46
2021-11-03,Solano,095,438530,46099,45411,1276,46687,351
2021-11-03,Sonoma,097,501317,41682,41326,529,41855,395
2021-11-03,Stanislaus,099,539301,78756,78736,8902,87638,1193
2021-11-03,Sutter,101,95872,13934,13876,350,14226,179
2021-11-03,Tehama,103,63373,8582,8438,1499,9937,118
2021-11-03,Trinity,105,12862,858,730,217,947,11
2021-11-03,Tulare,107,460477,68954,67588,15234,82822,1007
2021-11-03,Tuolumne,109,53932,7296,7218,99,7317,90
2021-11-03,Ventura,111,848112,98467,97682,4326,102008,1178
2021-11-03,Yolo,113,214977,19915,19758,1141,20899,250
2021-11-03,Yuba,115,75493,10188,10092,336,10428,83
2021-11-02,Alameda,001,1643700,119959,119241,2809,122050,1425
2021-11-02,Alpine,003,1148,101,105,0,105,0
2021-11-02,Amador,005,37829,5592,5535,62,5597,66
2021-11-02,Butte,007,227075,21059,20744,3750,24494,282
2021-11-02,Calaveras,009,45235,4109,4075,55,4130,82
2021-11-02,Colusa,011,21464,2517,2497,643,3140,19
2021-11-02,Contra Costa,013,1133247,99774,99080,2207,101287,1025
2021-11-02,Del Norte,015,27424,3693,3596,54,3650,42
2021-11-02,El Dorado,017,186661,16124,15883,1693,17576,154
2021-11-02,Fresno,019,978130,140896,138644,12856,151500,2158
2021-11-02,Glenn,021,27897,3511,3469,1015,4484,33
2021-11-02,Humboldt,023,135768,9080,8937,567,9504,109
2021-11-02,Imperial,025,180216,33764,33371,3246,36617,766
2021-11-02,Inyo,027,18085,2382,2324,41,2365,41
2021-11-02,Kern,029,883053,128166,126311,22376,148687,1665
2021-11-02,Kings,031,150075,32392,31896,1956,33852,339
2021-11-02,Lake,033,64148,6760,6681,151,6832,106
2021-11-02,Lassen,035,31185,6894,6777,377,7154,45
2021-11-02,Los Angeles,037,10098052,1440970,1429601,55011,1484612,26496
2021-11-02,Madera,039,155013,23304,22837,2126,24963,287
2021-11-02,Marin,041,260295,17619,17482,456,17938,247
2021-11-02,Mariposa,043,17540,1306,1270,48,1318,5
2021-11-02,Mendocino,045,87422,7613,7447,568,8015,84
2021-11-02,Merced,047,269075,42079,41785,1937,43722,596
2021-11-02,Modoc,049,8938,546,520,194,714,5
2021-11-02,Mono,051,14174,1729,1718,22,1740,4
2021-11-02,Monterey,053,433212,48826,47775,2944,50719,599
2021-11-02,Napa,055,140530,13029,12930,115,13045,104
2021-11-02,Nevada,057,99092,9251,9122,326,9448,91
2021-11-02,Orange,059,3164182,308015,305369,15276,320645,5600
2021-11-02,Placer,061,380077,37315,36817,3672,40489,438
2021-11-02,Plumas,063,18699,1814,1721,34,1755,7
2021-11-02,Riverside,065,2383286,364480,359586,16496,376082,5116
2021-11-02,Sacramento,067,1510023,159579,158112,4622,162734,2250
2021-11-02,San Benito,069,59416,7435,7407,172,7579,75
2021-11-02,San Bernardino,071,2135413,355246,351832,11201,363033,5813
2021-11-02,San Diego,073,3302833,375138,372440,21939,394379,4232
2021-11-02,San Francisco,075,870044,53121,52450,2348,54798,663
2021-11-02,San Joaquin,077,732212,100027,99076,5452,104528,1772
2021-11-02,San Luis Obispo,079,281455,29672,29224,1248,30472,348
2021-11-02,San Mateo,081,765935,54360,53351,879,54230,571
2021-11-02,Santa Barbara,083,443738,44558,44177,1563,45740,531
2021-11-02,Santa Clara,085,1922200,147498,146115,1364,147479,1896
2021-11-02,Santa Cruz,087,273765,20449,20266,1013,21279,222
2021-11-02,Shasta,089,179085,21548,21127,3608,24735,344
2021-11-02,Sierra,091,2930,184,180,20,200,0
2021-11-02,Siskiyou,093,43540,3348,3272,1295,4567,46
2021-11-02,Solano,095,438530,46059,45378,1270,46648,350
2021-11-02,Sonoma,097,501317,41601,41288,528,41816,395
2021-11-02,Stanislaus,099,539301,78601,78629,8882,87511,1193
2021-11-02,Sutter,101,95872,13913,13868,350,14218,179
2021-11-02,Tehama,103,63373,8566,8422,1496,9918,116
2021-11-02,Trinity,105,12862,858,729,217,946,11
2021-11-02,Tulare,107,460477,68829,67502,15185,82687,1002
2021-11-02,Tuolumne,109,53932,7275,7204,97,7301,90
2021-11-02,Ventura,111,848112,98362,97574,4322,101896,1178
2021-11-02,Yolo,113,214977,19884,19736,1139,20875,250
2021-11-02,Yuba,115,75493,10165,10080,334,10414,83
2021-11-01,Alameda,001,1643700,119819,119159,2806,121965,1421
2021-11-01,Alpine,003,1148,101,105,0,105,0
2021-11-01,Amador,005,37829,5590,5532,62,5594,64
2021-11-01,Butte,007,227075,21009,20710,3745,24455,281
2021-11-01,Calaveras,009,45235,4099,4059,54,4113,82
2021-11-01,Colusa,011,21464,2515,2494,640,3134,19
2021-11-01,Contra Costa,013,1133247,99649,99011,2199,101210,1025
2021-11-01,Del Norte,015,27424,3691,3594,54,3648,42
2021-11-01,El Dorado,017,186661,16100,15858,1687,17545,154
2021-11-01,Fresno,019,978130,140520,138421,12819,151240,2149
2021-11-01,Glenn,021,27897,3504,3461,1013,4474,33
2021-11-01,Humboldt,023,135768,9052,8929,563,9492,108
2021-11-01,Imperial,025,180216,33713,33342,3237,36579,766
2021-11-01,Inyo,027,18085,2370,2307,41,2348,41
2021-11-01,Kern,029,883053,127866,126092,22261,148353,1660
2021-11-01,Kings,031,150075,32339,31866,1953,33819,337
2021-11-01,Lake,033,64148,6749,6676,150,6826,106
2021-11-01,Lassen,035,31185,6879,6775,374,7149,42
2021-11-01,Los Angeles,037,10098052,1439581,1428891,54919,1483810,26483
2021-11-01,Madera,039,155013,23225,22801,2121,24922,283
2021-11-01,Marin,041,260295,17599,17460,455,17915,247
2021-11-01,Mariposa,043,17540,1298,1266,47,1313,5
2021-11-01,Mendocino,045,87422,7580,7422,550,7972,84
2021-11-01,Merced,047,269075,41989,41740,1935,43675,594
2021-11-01,Modoc,049,8938,541,520,192,712,5
2021-11-01,Mono,051,14174,1725,1714,22,1736,3
2021-11-01,Monterey,053,433212,48783,47756,2932,50688,597
2021-11-01,Napa,055,140530,13002,12916,114,13030,101
2021-11-01,Nevada,057,99092,9228,9108,325,9433,91
2021-11-01,Orange,059,3164182,307673,305192,15234,320426,5596
2021-11-01,Placer,061,380077,37232,36747,3660,40407,435
2021-11-01,Plumas,063,18699,1795,1719,34,1753,7
2021-11-01,Riverside,065,2383286,363978,359263,16474,375737,5115
2021-11-01,Sacramento,067,1510023,159307,157893,4598,162491,2239
2021-11-01,San Benito,069,59416,7425,7406,171,7577,73
2021-11-01,San Bernardino,071,2135413,354758,351620,11180,362800,5815
2021-11-01,San Diego,073,3302833,374553,372043,21921,393964,4232
2021-11-01,San Francisco,075,870044,53036,52418,2341,54759,661
2021-11-01,San Joaquin,077,732212,99864,98969,5445,104414,1772
2021-11-01,San Luis Obispo,079,281455,29628,29199,1243,30442,343
2021-11-01,San Mateo,081,765935,54293,53314,875,54189,571
2021-11-01,Santa Barbara,083,443738,44491,44146,1559,45705,529
2021-11-01,Santa Clara,085,1922200,147301,145978,1359,147337,1907
2021-11-01,Santa Cruz,087,273765,20414,20238,1013,21251,221
2021-11-01,Shasta,089,179085,21495,21104,3601,24705,338
2021-11-01,Sierra,091,2930,184,180,20,200,0
2021-11-01,Siskiyou,093,43540,3341,3272,1290,4562,46
2021-11-01,Solano,095,438530,46005,45358,1270,46628,350
2021-11-01,Sonoma,097,501317,41528,41234,528,41762,395
2021-11-01,Stanislaus,099,539301,78472,78534,8867,87401,1193
2021-11-01,Sutter,101,95872,13889,13852,348,14200,179
2021-11-01,Tehama,103,63373,8538,8412,1493,9905,116
2021-11-01,Trinity,105,12862,856,727,217,944,11
2021-11-01,Tulare,107,460477,68685,67388,15132,82520,1002
2021-11-01,Tuolumne,109,53932,7259,7175,96,7271,90
2021-11-01,Ventura,111,848112,98272,97507,4320,101827,1178
2021-11-01,Yolo,113,214977,19864,19708,1132,20840,250
2021-11-01,Yuba,115,75493,10147,10066,332,10398,83
2021-10-31,Alameda,001,1643700,119674,119071,2803,121874,1419
2021-10-31,Alpine,003,1148,101,105,0,105,0
2021-10-31,Amador,005,37829,5579,5518,62,5580,64
2021-10-31,Butte,007,227075,20948,20689,3736,24425,281
2021-10-31,Calaveras,009,45235,4081,4052,53,4105,82
2021-10-31,Colusa,011,21464,2513,2493,637,3130,18
2021-10-31,Contra Costa,013,1133247,99521,98936,2196,101132,1025
2021-10-31,Del Norte,015,27424,3685,3591,54,3645,42
2021-10-31,El Dorado,017,186661,16054,15841,1684,17525,154
2021-10-31,Fresno,019,978130,140113,138165,12782,150947,2147
2021-10-31,Glenn,021,27897,3499,3459,1013,4472,33
2021-10-31,Humboldt,023,135768,9004,8919,557,9476,108
2021-10-31,Imperial,025,180216,33638,33334,3225,36559,766
2021-10-31,Inyo,027,18085,2351,2309,41,2350,41
2021-10-31,Kern,029,883053,127497,125917,22136,148053,1666
2021-10-31,Kings,031,150075,32253,31814,1941,33755,338
2021-10-31,Lake,033,64148,6738,6665,148,6813,106
2021-10-31,Lassen,035,31185,6864,6768,369,7137,42
2021-10-31,Los Angeles,037,10098052,1438034,1427933,54834,1482767,26474
2021-10-31,Madera,039,155013,23130,22744,2108,24852,283
2021-10-31,Marin,041,260295,17571,17443,454,17897,247
2021-10-31,Mariposa,043,17540,1292,1257,46,1303,5
2021-10-31,Mendocino,045,87422,7539,7403,533,7936,84
2021-10-31,Merced,047,269075,41895,41699,1915,43614,589
2021-10-31,Modoc,049,8938,535,517,189,706,5
2021-10-31,Mono,051,14174,1721,1711,22,1733,3
2021-10-31,Monterey,053,433212,48741,47744,2914,50658,596
2021-10-31,Napa,055,140530,12985,12906,112,13018,101
2021-10-31,Nevada,057,99092,9191,9084,320,9404,91
2021-10-31,Orange,059,3164182,307324,305032,15151,320183,5596
2021-10-31,Placer,061,380077,37135,36698,3646,40344,435
2021-10-31,Plumas,063,18699,1777,1716,34,1750,7
2021-10-31,Riverside,065,2383286,363399,359005,16460,375465,5104
2021-10-31,Sacramento,067,1510023,158955,157667,4583,162250,2243
2021-10-31,San Benito,069,59416,7416,7397,169,7566,73
2021-10-31,San Bernardino,071,2135413,354226,351411,11166,362577,5810
2021-10-31,San Diego,073,3302833,373979,371603,21890,393493,4218
2021-10-31,San Francisco,075,870044,52928,52370,2335,54705,661
2021-10-31,San Joaquin,077,732212,99700,98893,5431,104324,1772
2021-10-31,San Luis Obispo,079,281455,29574,29176,1242,30418,343
2021-10-31,San Mateo,081,765935,54234,53284,873,54157,571
2021-10-31,Santa Barbara,083,443738,44421,44113,1554,45667,529
2021-10-31,Santa Clara,085,1922200,147086,145829,1345,147174,1908
2021-10-31,Santa Cruz,087,273765,20379,20218,1012,21230,221
2021-10-31,Shasta,089,179085,21412,21086,3589,24675,338
2021-10-31,Sierra,091,2930,184,180,20,200,0
2021-10-31,Siskiyou,093,43540,3335,3271,1289,4560,46
2021-10-31,Solano,095,438530,45957,45310,1263,46573,350
2021-10-31,Sonoma,097,501317,41458,41183,525,41708,395
2021-10-31,Stanislaus,099,539301,78282,78426,8852,87278,1193
2021-10-31,Sutter,101,95872,13870,13838,345,14183,179
2021-10-31,Tehama,103,63373,8507,8391,1489,9880,116
2021-10-31,Trinity,105,12862,856,724,217,941,11
2021-10-31,Tulare,107,460477,68491,67310,15041,82351,1002
2021-10-31,Tuolumne,109,53932,7230,7141,95,7236,90
2021-10-31,Ventura,111,848112,98151,97460,4315,101775,1178
2021-10-31,Yolo,113,214977,19820,19662,1126,20788,250
2021-10-31,Yuba,115,75493,10129,10051,322,10373,83
2021-10-30,Alameda,001,1643700,119614,118632,2801,121433,1419
2021-10-30,Alpine,003,1148,101,105,0,105,0
2021-10-30,Amador,005,37829,5570,5480,61,5541,64
2021-10-30,Butte,007,227075,20933,20516,3730,24246,277
2021-10-30,Calaveras,009,45235,4074,3992,53,4045,82
2021-10-30,Colusa,011,21464,2513,2484,636,3120,19
2021-10-30,Contra Costa,013,1133247,99458,98562,2195,100757,1024
2021-10-30,Del Norte,015,27424,3682,3574,54,3628,42
2021-10-30,El Dorado,017,186661,16038,15752,1679,17431,154
2021-10-30,Fresno,019,978130,139968,136901,12770,149671,2131
2021-10-30,Glenn,021,27897,3495,3442,1013,4455,33
2021-10-30,Humboldt,023,135768,8989,8871,555,9426,105
2021-10-30,Imperial,025,180216,33593,33156,3221,36377,766
2021-10-30,Inyo,027,18085,2348,2249,41,2290,41
2021-10-30,Kern,029,883053,127343,124892,22065,146957,1653
2021-10-30,Kings,031,150075,32219,31578,1937,33515,337
2021-10-30,Lake,033,64148,6733,6610,148,6758,106
2021-10-30,Lassen,035,31185,6858,6719,367,7086,42
2021-10-30,Los Angeles,037,10098052,1437309,1424257,54781,1479038,26625
2021-10-30,Madera,039,155013,23086,22524,2103,24627,283
2021-10-30,Marin,041,260295,17556,17380,452,17832,247
2021-10-30,Mariposa,043,17540,1289,1228,46,1274,5
2021-10-30,Mendocino,045,87422,7516,7338,531,7869,84
2021-10-30,Merced,047,269075,41856,41428,1913,43341,586
2021-10-30,Modoc,049,8938,533,513,188,701,5
2021-10-30,Mono,051,14174,1721,1684,22,1706,3
2021-10-30,Monterey,053,433212,48724,47649,2908,50557,588
2021-10-30,Napa,055,140530,12971,12863,111,12974,101
2021-10-30,Nevada,057,99092,9172,9015,320,9335,91
2021-10-30,Orange,059,3164182,307145,304120,15129,319249,5588
2021-10-30,Placer,061,380077,37089,36400,3640,40040,434
2021-10-30,Plumas,063,18699,1772,1695,34,1729,7
2021-10-30,Riverside,065,2383286,363099,357645,16451,374096,5088
2021-10-30,Sacramento,067,1510023,158796,157125,4574,161699,2233
2021-10-30,San Benito,069,59416,7409,7362,169,7531,71
2021-10-30,San Bernardino,071,2135413,353948,350076,11152,361228,5777
2021-10-30,San Diego,073,3302833,373605,370006,21868,391874,4213
2021-10-30,San Francisco,075,870044,52899,52161,2333,54494,661
2021-10-30,San Joaquin,077,732212,99644,98314,5430,103744,1768
2021-10-30,San Luis Obispo,079,281455,29542,29053,1239,30292,341
2021-10-30,San Mateo,081,765935,54195,53083,873,53956,571
2021-10-30,Santa Barbara,083,443738,44386,43972,1553,45525,528
2021-10-30,Santa Clara,085,1922200,146981,145262,1341,146603,1903
2021-10-30,Santa Cruz,087,273765,20361,20134,1010,21144,221
2021-10-30,Shasta,089,179085,21368,20878,3583,24461,332
2021-10-30,Sierra,091,2930,184,175,20,195,0
2021-10-30,Siskiyou,093,43540,3334,3257,1286,4543,46
2021-10-30,Solano,095,438530,45936,45146,1261,46407,346
2021-10-30,Sonoma,097,501317,41419,40924,525,41449,393
2021-10-30,Stanislaus,099,539301,78212,77871,8845,86716,1191
2021-10-30,Sutter,101,95872,13857,13773,345,14118,178
2021-10-30,Tehama,103,63373,8496,8307,1484,9791,114
2021-10-30,Trinity,105,12862,854,708,216,924,11
2021-10-30,Tulare,107,460477,68420,66745,14994,81739,995
2021-10-30,Tuolumne,109,53932,7206,7050,94,7144,90
2021-10-30,Ventura,111,848112,98102,97182,4312,101494,1174
2021-10-30,Yolo,113,214977,19801,19568,1124,20692,250
2021-10-30,Yuba,115,75493,10118,9969,322,10291,82
2021-10-29,Alameda,001,1643700,119535,118632,2796,121428,1419
2021-10-29,Alpine,003,1148,101,105,0,105,0
2021-10-29,Amador,005,37829,5559,5480,61,5541,64
2021-10-29,Butte,007,227075,20909,20516,3720,24236,277
2021-10-29,Calaveras,009,45235,4067,3992,53,4045,82
2021-10-29,Colusa,011,21464,2513,2484,634,3118,19
2021-10-29,Contra Costa,013,1133247,99391,98562,2193,100755,1024
2021-10-29,Del Norte,015,27424,3675,3574,54,3628,42
2021-10-29,El Dorado,017,186661,16024,15752,1679,17431,154
2021-10-29,Fresno,019,978130,139753,136901,12755,149656,2131
2021-10-29,Glenn,021,27897,3494,3442,1012,4454,33
2021-10-29,Humboldt,023,135768,8984,8871,554,9425,105
2021-10-29,Imperial,025,180216,33566,33156,3218,36374,766
2021-10-29,Inyo,027,18085,2345,2249,41,2290,41
2021-10-29,Kern,029,883053,127166,124892,21975,146867,1653
2021-10-29,Kings,031,150075,32185,31578,1935,33513,337
2021-10-29,Lake,033,64148,6724,6610,145,6755,106
2021-10-29,Lassen,035,31185,6849,6719,364,7083,42
2021-10-29,Los Angeles,037,10098052,1436463,1424257,54737,1478994,26625
2021-10-29,Madera,039,155013,23034,22524,2098,24622,283
2021-10-29,Marin,041,260295,17540,17380,451,17831,247
2021-10-29,Mariposa,043,17540,1285,1228,46,1274,5
2021-10-29,Mendocino,045,87422,7508,7338,531,7869,84
2021-10-29,Merced,047,269075,41806,41428,1907,43335,586
2021-10-29,Modoc,049,8938,531,513,187,700,5
2021-10-29,Mono,051,14174,1719,1684,22,1706,3
2021-10-29,Monterey,053,433212,48701,47649,2908,50557,588
2021-10-29,Napa,055,140530,12950,12863,111,12974,101
2021-10-29,Nevada,057,99092,9160,9015,320,9335,91
2021-10-29,Orange,059,3164182,306920,304120,15109,319229,5588
2021-10-29,Placer,061,380077,37053,36400,3629,40029,434
2021-10-29,Plumas,063,18699,1766,1695,34,1729,7
2021-10-29,Riverside,065,2383286,362765,357645,16446,374091,5088
2021-10-29,Sacramento,067,1510023,158607,157125,4565,161690,2233
2021-10-29,San Benito,069,59416,7406,7362,169,7531,71
2021-10-29,San Bernardino,071,2135413,353651,350076,11143,361219,5777
2021-10-29,San Diego,073,3302833,373229,370006,21840,391846,4213
2021-10-29,San Francisco,075,870044,52839,52161,2327,54488,661
2021-10-29,San Joaquin,077,732212,99587,98314,5425,103739,1768
2021-10-29,San Luis Obispo,079,281455,29516,29053,1237,30290,341
2021-10-29,San Mateo,081,765935,54152,53083,871,53954,571
2021-10-29,Santa Barbara,083,443738,44346,43972,1550,45522,528
2021-10-29,Santa Clara,085,1922200,146866,145262,1334,146596,1903
2021-10-29,Santa Cruz,087,273765,20354,20134,1009,21143,221
2021-10-29,Shasta,089,179085,21329,20878,3577,24455,332
2021-10-29,Sierra,091,2930,182,175,20,195,0
2021-10-29,Siskiyou,093,43540,3334,3257,1285,4542,46
2021-10-29,Solano,095,438530,45899,45146,1260,46406,346
2021-10-29,Sonoma,097,501317,41398,40924,525,41449,393
2021-10-29,Stanislaus,099,539301,78126,77871,8834,86705,1191
2021-10-29,Sutter,101,95872,13838,13773,345,14118,178
2021-10-29,Tehama,103,63373,8483,8307,1483,9790,114
2021-10-29,Trinity,105,12862,853,708,216,924,11
2021-10-29,Tulare,107,460477,68315,66745,14949,81694,995
2021-10-29,Tuolumne,109,53932,7193,7050,94,7144,90
2021-10-29,Ventura,111,848112,98047,97182,4308,101490,1174
2021-10-29,Yolo,113,214977,19783,19568,1119,20687,250
2021-10-29,Yuba,115,75493,10110,9969,318,10287,82
2021-10-28,Alameda,001,1643700,119411,118632,2789,121421,1419
2021-10-28,Alpine,003,1148,101,105,0,105,0
2021-10-28,Amador,005,37829,5546,5480,61,5541,64
2021-10-28,Butte,007,227075,20866,20516,3711,24227,277
2021-10-28,Calaveras,009,45235,4054,3992,53,4045,82
2021-10-28,Colusa,011,21464,2510,2484,633,3117,19
2021-10-28,Contra Costa,013,1133247,99261,98562,2188,100750,1024
2021-10-28,Del Norte,015,27424,3674,3574,54,3628,42
2021-10-28,El Dorado,017,186661,15998,15752,1676,17428,154
2021-10-28,Fresno,019,978130,139419,136901,12722,149623,2131
2021-10-28,Glenn,021,27897,3491,3442,1010,4452,33
2021-10-28,Humboldt,023,135768,8968,8871,549,9420,105
2021-10-28,Imperial,025,180216,33501,33156,3212,36368,766
2021-10-28,Inyo,027,18085,2328,2249,41,2290,41
2021-10-28,Kern,029,883053,126919,124892,21861,146753,1653
2021-10-28,Kings,031,150075,32116,31578,1930,33508,337
2021-10-28,Lake,033,64148,6714,6610,145,6755,106
2021-10-28,Lassen,035,31185,6839,6719,360,7079,42
2021-10-28,Los Angeles,037,10098052,1435321,1424257,54664,1478921,26625
2021-10-28,Madera,039,155013,22980,22524,2087,24611,283
2021-10-28,Marin,041,260295,17522,17380,450,17830,247
2021-10-28,Mariposa,043,17540,1281,1228,46,1274,5
2021-10-28,Mendocino,045,87422,7495,7338,520,7858,84
2021-10-28,Merced,047,269075,41721,41428,1895,43323,586
2021-10-28,Modoc,049,8938,530,513,187,700,5
2021-10-28,Mono,051,14174,1713,1684,22,1706,3
2021-10-28,Monterey,053,433212,48670,47649,2891,50540,588
2021-10-28,Napa,055,140530,12941,12863,110,12973,101
2021-10-28,Nevada,057,99092,9142,9015,320,9335,91
2021-10-28,Orange,059,3164182,306633,304120,15044,319164,5588
2021-10-28,Placer,061,380077,36974,36400,3620,40020,434
2021-10-28,Plumas,063,18699,1758,1695,34,1729,7
2021-10-28,Riverside,065,2383286,362327,357645,16422,374067,5088
2021-10-28,Sacramento,067,1510023,158341,157125,4553,161678,2233
2021-10-28,San Benito,069,59416,7398,7362,169,7531,71
2021-10-28,San Bernardino,071,2135413,353233,350076,11121,361197,5777
2021-10-28,San Diego,073,3302833,372756,370006,21817,391823,4213
2021-10-28,San Francisco,075,870044,52793,52161,2320,54481,661
2021-10-28,San Joaquin,077,732212,99459,98314,5424,103738,1768
2021-10-28,San Luis Obispo,079,281455,29487,29053,1234,30287,341
2021-10-28,San Mateo,081,765935,54107,53083,869,53952,571
2021-10-28,Santa Barbara,083,443738,44307,43972,1548,45520,528
2021-10-28,Santa Clara,085,1922200,146708,145262,1329,146591,1903
2021-10-28,Santa Cruz,087,273765,20330,20134,1009,21143,221
2021-10-28,Shasta,089,179085,21254,20878,3570,24448,332
2021-10-28,Sierra,091,2930,181,175,20,195,0
2021-10-28,Siskiyou,093,43540,3333,3257,1285,4542,46
2021-10-28,Solano,095,438530,45860,45146,1259,46405,346
2021-10-28,Sonoma,097,501317,41330,40924,524,41448,393
2021-10-28,Stanislaus,099,539301,77974,77871,8818,86689,1191
2021-10-28,Sutter,101,95872,13825,13773,341,14114,178
2021-10-28,Tehama,103,63373,8446,8307,1480,9787,114
2021-10-28,Trinity,105,12862,850,708,216,924,11
2021-10-28,Tulare,107,460477,68175,66745,14892,81637,995
2021-10-28,Tuolumne,109,53932,7162,7050,94,7144,90
2021-10-28,Ventura,111,848112,97962,97182,4305,101487,1174
2021-10-28,Yolo,113,214977,19745,19568,1114,20682,250
2021-10-28,Yuba,115,75493,10081,9969,315,10284,82
2021-10-27,Alameda,001,1643700,119289,118487,2787,121274,1414
2021-10-27,Alpine,003,1148,101,105,0,105,0
2021-10-27,Amador,005,37829,5534,5470,60,5530,64
2021-10-27,Butte,007,227075,20822,20446,3697,24143,274
2021-10-27,Calaveras,009,45235,4036,3970,52,4022,82
2021-10-27,Colusa,011,21464,2509,2480,632,3112,18
2021-10-27,Contra Costa,013,1133247,99153,98442,2176,100618,1018
2021-10-27,Del Norte,015,27424,3667,3571,53,3624,42
2021-10-27,El Dorado,017,186661,15967,15723,1671,17394,154
2021-10-27,Fresno,019,978130,139037,136447,12688,149135,2128
2021-10-27,Glenn,021,27897,3489,3435,1009,4444,33
2021-10-27,Humboldt,023,135768,8948,8851,547,9398,105
2021-10-27,Imperial,025,180216,33462,33068,3207,36275,766
2021-10-27,Inyo,027,18085,2308,2236,41,2277,41
2021-10-27,Kern,029,883053,126650,124557,21761,146318,1647
2021-10-27,Kings,031,150075,32050,31437,1924,33361,335
2021-10-27,Lake,033,64148,6688,6589,145,6734,105
2021-10-27,Lassen,035,31185,6825,6706,358,7064,42
2021-10-27,Los Angeles,037,10098052,1434089,1422615,54605,1477220,26604
2021-10-27,Madera,039,155013,22894,22413,2063,24476,283
2021-10-27,Marin,041,260295,17507,17362,450,17812,247
2021-10-27,Mariposa,043,17540,1268,1228,46,1274,5
2021-10-27,Mendocino,045,87422,7481,7321,513,7834,84
2021-10-27,Merced,047,269075,41623,41310,1881,43191,583
2021-10-27,Modoc,049,8938,526,513,187,700,5
2021-10-27,Mono,051,14174,1710,1682,22,1704,3
2021-10-27,Monterey,053,433212,48632,47610,2869,50479,588
2021-10-27,Napa,055,140530,12926,12856,109,12965,101
2021-10-27,Nevada,057,99092,9125,8987,319,9306,90
2021-10-27,Orange,059,3164182,306312,303825,14993,318818,5584
2021-10-27,Placer,061,380077,36908,36296,3613,39909,434
2021-10-27,Plumas,063,18699,1750,1686,34,1720,7
2021-10-27,Riverside,065,2383286,361897,357152,16414,373566,5081
2021-10-27,Sacramento,067,1510023,158073,156830,4532,161362,2230
2021-10-27,San Benito,069,59416,7392,7337,169,7506,71
2021-10-27,San Bernardino,071,2135413,352810,349624,11099,360723,5770
2021-10-27,San Diego,073,3302833,372180,369579,21793,391372,4207
2021-10-27,San Francisco,075,870044,52742,52108,2316,54424,655
2021-10-27,San Joaquin,077,732212,99301,98168,5409,103577,1753
2021-10-27,San Luis Obispo,079,281455,29448,29002,1232,30234,341
2021-10-27,San Mateo,081,765935,54052,53032,861,53893,571
2021-10-27,Santa Barbara,083,443738,44254,43901,1545,45446,527
2021-10-27,Santa Clara,085,1922200,146531,145081,1321,146402,1902
2021-10-27,Santa Cruz,087,273765,20303,20091,1007,21098,221
2021-10-27,Shasta,089,179085,21178,20813,3562,24375,331
2021-10-27,Sierra,091,2930,180,176,20,196,0
2021-10-27,Siskiyou,093,43540,3330,3256,1281,4537,46
2021-10-27,Solano,095,438530,45815,45089,1251,46340,346
2021-10-27,Sonoma,097,501317,41254,40829,522,41351,393
2021-10-27,Stanislaus,099,539301,77814,77687,8804,86491,1191
2021-10-27,Sutter,101,95872,13811,13754,341,14095,177
2021-10-27,Tehama,103,63373,8424,8265,1478,9743,113
2021-10-27,Trinity,105,12862,850,706,215,921,11
2021-10-27,Tulare,107,460477,68021,66568,14834,81402,991
2021-10-27,Tuolumne,109,53932,7135,7009,93,7102,90
2021-10-27,Ventura,111,848112,97870,97108,4300,101408,1172
2021-10-27,Yolo,113,214977,19716,19517,1107,20624,250
2021-10-27,Yuba,115,75493,10060,9945,313,10258,82
2021-10-26,Alameda,001,1643700,119154,118360,2785,121145,1407
2021-10-26,Alpine,003,1148,101,105,0,105,0
2021-10-26,Amador,005,37829,5526,5465,59,5524,64
2021-10-26,Butte,007,227075,20763,20387,3680,24067,274
2021-10-26,Calaveras,009,45235,4025,3966,52,4018,81
2021-10-26,Colusa,011,21464,2507,2478,631,3109,18
2021-10-26,Contra Costa,013,1133247,99031,98352,2165,100517,1017
2021-10-26,Del Norte,015,27424,3662,3563,53,3616,42
2021-10-26,El Dorado,017,186661,15939,15690,1662,17352,153
2021-10-26,Fresno,019,978130,138588,136211,12644,148855,2122
2021-10-26,Glenn,021,27897,3474,3431,1006,4437,33
2021-10-26,Humboldt,023,135768,8930,8830,541,9371,105
2021-10-26,Imperial,025,180216,33397,33012,3202,36214,766
2021-10-26,Inyo,027,18085,2293,2200,41,2241,41
2021-10-26,Kern,029,883053,126307,124351,21641,145992,1645
2021-10-26,Kings,031,150075,31983,31382,1917,33299,336
2021-10-26,Lake,033,64148,6678,6584,143,6727,105
2021-10-26,Lassen,035,31185,6805,6689,356,7045,42
2021-10-26,Los Angeles,037,10098052,1432740,1421795,54535,1476330,26599
2021-10-26,Madera,039,155013,22804,22363,2052,24415,283
2021-10-26,Marin,041,260295,17490,17354,449,17803,244
2021-10-26,Mariposa,043,17540,1263,1225,45,1270,5
2021-10-26,Mendocino,045,87422,7452,7308,496,7804,83
2021-10-26,Merced,047,269075,41545,41267,1873,43140,583
2021-10-26,Modoc,049,8938,526,513,187,700,5
2021-10-26,Mono,051,14174,1705,1680,22,1702,3
2021-10-26,Monterey,053,433212,48594,47572,2858,50430,588
2021-10-26,Napa,055,140530,12914,12849,109,12958,101
2021-10-26,Nevada,057,99092,9094,8971,318,9289,90
2021-10-26,Orange,059,3164182,306042,303533,14954,318487,5580
2021-10-26,Placer,061,380077,36810,36245,3607,39852,434
2021-10-26,Plumas,063,18699,1741,1645,34,1679,7
2021-10-26,Riverside,065,2383286,361407,356775,16404,373179,5068
2021-10-26,Sacramento,067,1510023,157772,156643,4515,161158,2228
2021-10-26,San Benito,069,59416,7369,7325,169,7494,71
2021-10-26,San Bernardino,071,2135413,352388,349346,11084,360430,5764
2021-10-26,San Diego,073,3302833,371661,369043,21763,390806,4198
2021-10-26,San Francisco,075,870044,52667,52063,2313,54376,655
2021-10-26,San Joaquin,077,732212,99122,98036,5394,103430,1748
2021-10-26,San Luis Obispo,079,281455,29409,28928,1226,30154,337
2021-10-26,San Mateo,081,765935,53979,52974,858,53832,571
2021-10-26,Santa Barbara,083,443738,44208,43835,1544,45379,525
2021-10-26,Santa Clara,085,1922200,146332,144932,1315,146247,1903
2021-10-26,Santa Cruz,087,273765,20272,20067,1006,21073,221
2021-10-26,Shasta,089,179085,21118,20725,3544,24269,330
2021-10-26,Sierra,091,2930,180,169,20,189,0
2021-10-26,Siskiyou,093,43540,3324,3254,1279,4533,46
2021-10-26,Solano,095,438530,45759,45044,1250,46294,344
2021-10-26,Sonoma,097,501317,41172,40794,520,41314,393
2021-10-26,Stanislaus,099,539301,77640,77552,8779,86331,1157
2021-10-26,Sutter,101,95872,13782,13739,340,14079,176
2021-10-26,Tehama,103,63373,8396,8247,1472,9719,112
2021-10-26,Trinity,105,12862,846,705,215,920,11
2021-10-26,Tulare,107,460477,67862,66476,14772,81248,991
2021-10-26,Tuolumne,109,53932,7109,6995,91,7086,90
2021-10-26,Ventura,111,848112,97761,97014,4296,101310,1170
2021-10-26,Yolo,113,214977,19688,19490,1104,20594,248
2021-10-26,Yuba,115,75493,10042,9927,308,10235,82
2021-10-25,Alameda,001,1643700,119009,118319,2783,121102,1404
2021-10-25,Alpine,003,1148,101,105,0,105,0
2021-10-25,Amador,005,37829,5512,5455,59,5514,64
2021-10-25,Butte,007,227075,20689,20331,3672,24003,273
2021-10-25,Calaveras,009,45235,3995,3942,51,3993,82
2021-10-25,Colusa,011,21464,2505,2471,629,3100,18
2021-10-25,Contra Costa,013,1133247,98914,98267,2160,100427,1017
2021-10-25,Del Norte,015,27424,3655,3562,53,3615,42
2021-10-25,El Dorado,017,186661,15904,15663,1660,17323,149
2021-10-25,Fresno,019,978130,138153,135974,12605,148579,2112
2021-10-25,Glenn,021,27897,3471,3421,1005,4426,33
2021-10-25,Humboldt,023,135768,8907,8825,536,9361,105
2021-10-25,Imperial,025,180216,33336,32968,3191,36159,766
2021-10-25,Inyo,027,18085,2275,2183,41,2224,41
2021-10-25,Kern,029,883053,125953,124078,21502,145580,1649
2021-10-25,Kings,031,150075,31894,31329,1908,33237,335
2021-10-25,Lake,033,64148,6665,6571,143,6714,105
2021-10-25,Lassen,035,31185,6794,6688,354,7042,42
2021-10-25,Los Angeles,037,10098052,1431368,1421061,54468,1475529,26579
2021-10-25,Madera,039,155013,22750,22325,2045,24370,281
2021-10-25,Marin,041,260295,17468,17334,447,17781,244
2021-10-25,Mariposa,043,17540,1249,1220,45,1265,5
2021-10-25,Mendocino,045,87422,7422,7296,492,7788,82
2021-10-25,Merced,047,269075,41477,41207,1846,43053,583
2021-10-25,Modoc,049,8938,524,512,185,697,5
2021-10-25,Mono,051,14174,1697,1677,22,1699,3
2021-10-25,Monterey,053,433212,48561,47547,2856,50403,587
2021-10-25,Napa,055,140530,12901,12841,109,12950,100
2021-10-25,Nevada,057,99092,9068,8958,318,9276,90
2021-10-25,Orange,059,3164182,305744,303279,14916,318195,5574
2021-10-25,Placer,061,380077,36703,36153,3597,39750,431
2021-10-25,Plumas,063,18699,1729,1641,34,1675,7
2021-10-25,Riverside,065,2383286,360980,356381,16389,372770,5056
2021-10-25,Sacramento,067,1510023,157466,156516,4489,161005,2235
2021-10-25,San Benito,069,59416,7355,7314,168,7482,71
2021-10-25,San Bernardino,071,2135413,351892,349075,11072,360147,5748
2021-10-25,San Diego,073,3302833,371074,368386,21735,390121,4196
2021-10-25,San Francisco,075,870044,52594,52041,2306,54347,649
2021-10-25,San Joaquin,077,732212,98920,97980,5385,103365,1740
2021-10-25,San Luis Obispo,079,281455,29361,28907,1221,30128,336
2021-10-25,San Mateo,081,765935,53919,52927,854,53781,571
2021-10-25,Santa Barbara,083,443738,44149,43775,1544,45319,525
2021-10-25,Santa Clara,085,1922200,146142,144895,1310,146205,1901
2021-10-25,Santa Cruz,087,273765,20243,20053,1005,21058,221
2021-10-25,Shasta,089,179085,21046,20666,3537,24203,326
2021-10-25,Sierra,091,2930,180,168,20,188,0
2021-10-25,Siskiyou,093,43540,3320,3248,1274,4522,46
2021-10-25,Solano,095,438530,45698,45022,1248,46270,344
2021-10-25,Sonoma,097,501317,41099,40746,518,41264,393
2021-10-25,Stanislaus,099,539301,77447,77452,8750,86202,1145
2021-10-25,Sutter,101,95872,13769,13721,337,14058,176
2021-10-25,Tehama,103,63373,8369,8224,1468,9692,111
2021-10-25,Trinity,105,12862,841,699,214,913,11
2021-10-25,Tulare,107,460477,67668,66357,14710,81067,986
2021-10-25,Tuolumne,109,53932,7075,6952,89,7041,90
2021-10-25,Ventura,111,848112,97670,96932,4293,101225,1167
2021-10-25,Yolo,113,214977,19639,19457,1100,20557,248
2021-10-25,Yuba,115,75493,10026,9924,304,10228,82
2021-10-24,Alameda,001,1643700,118877,117816,2778,120594,1397
2021-10-24,Alpine,003,1148,101,105,0,105,0
2021-10-24,Amador,005,37829,5507,5412,59,5471,64
2021-10-24,Butte,007,227075,20618,20101,3660,23761,273
2021-10-24,Calaveras,009,45235,3976,3865,50,3915,81
2021-10-24,Colusa,011,21464,2501,2458,626,3084,18
2021-10-24,Contra Costa,013,1133247,98796,97855,2151,100006,1008
2021-10-24,Del Norte,015,27424,3651,3540,53,3593,42
2021-10-24,El Dorado,017,186661,15868,15540,1656,17196,149
2021-10-24,Fresno,019,978130,137718,134466,12556,147022,2094
2021-10-24,Glenn,021,27897,3464,3399,1003,4402,33
2021-10-24,Humboldt,023,135768,8894,8753,530,9283,105
2021-10-24,Imperial,025,180216,33258,32777,3184,35961,766
2021-10-24,Inyo,027,18085,2243,2108,41,2149,41
2021-10-24,Kern,029,883053,125619,122939,21384,144323,1636
2021-10-24,Kings,031,150075,31765,30942,1892,32834,325
2021-10-24,Lake,033,64148,6642,6501,142,6643,105
2021-10-24,Lassen,035,31185,6777,6632,353,6985,27
2021-10-24,Los Angeles,037,10098052,1429921,1415919,54400,1470319,26527
2021-10-24,Madera,039,155013,22673,22062,2032,24094,281
2021-10-24,Marin,041,260295,17452,17264,446,17710,244
2021-10-24,Mariposa,043,17540,1246,1184,45,1229,5
2021-10-24,Mendocino,045,87422,7398,7220,481,7701,82
2021-10-24,Merced,047,269075,41356,40808,1840,42648,581
2021-10-24,Modoc,049,8938,523,507,185,692,5
2021-10-24,Mono,051,14174,1692,1655,22,1677,3
2021-10-24,Monterey,053,433212,48513,47456,2845,50301,586
2021-10-24,Napa,055,140530,12890,12789,109,12898,100
2021-10-24,Nevada,057,99092,9045,8861,315,9176,90
2021-10-24,Orange,059,3164182,305394,302237,14878,317115,5546
2021-10-24,Placer,061,380077,36599,35822,3583,39405,426
2021-10-24,Plumas,063,18699,1719,1623,33,1656,7
2021-10-24,Riverside,065,2383286,360505,354688,16369,371057,5041
2021-10-24,Sacramento,067,1510023,157123,155125,4466,159591,2232
2021-10-24,San Benito,069,59416,7335,7280,168,7448,71
2021-10-24,San Bernardino,071,2135413,351343,347681,11061,358742,5688
2021-10-24,San Diego,073,3302833,370471,366085,21704,387789,4183
2021-10-24,San Francisco,075,870044,52531,51820,2300,54120,649
2021-10-24,San Joaquin,077,732212,98747,97440,5379,102819,1721
2021-10-24,San Luis Obispo,079,281455,29300,28755,1214,29969,333
2021-10-24,San Mateo,081,765935,53847,52719,854,53573,571
2021-10-24,Santa Barbara,083,443738,44082,43552,1542,45094,523
2021-10-24,Santa Clara,085,1922200,145951,144276,1300,145576,1897
2021-10-24,Santa Cruz,087,273765,20205,19967,1004,20971,221
2021-10-24,Shasta,089,179085,20946,20386,3531,23917,321
2021-10-24,Sierra,091,2930,180,168,20,188,0
2021-10-24,Siskiyou,093,43540,3313,3231,1270,4501,46
2021-10-24,Solano,095,438530,45648,44861,1243,46104,341
2021-10-24,Sonoma,097,501317,41016,40476,518,40994,393
2021-10-24,Stanislaus,099,539301,77254,76812,8738,85550,1145
2021-10-24,Sutter,101,95872,13742,13616,329,13945,175
2021-10-24,Tehama,103,63373,8321,8105,1456,9561,110
2021-10-24,Trinity,105,12862,837,696,211,907,11
2021-10-24,Tulare,107,460477,67496,65585,14636,80221,978
2021-10-24,Tuolumne,109,53932,7035,6840,87,6927,90
2021-10-24,Ventura,111,848112,97563,96664,4292,100956,1167
2021-10-24,Yolo,113,214977,19592,19280,1097,20377,248
2021-10-24,Yuba,115,75493,10001,9838,303,10141,82
2021-10-23,Alameda,001,1643700,118788,117816,2773,120589,1397
2021-10-23,Alpine,003,1148,101,105,0,105,0
2021-10-23,Amador,005,37829,5500,5412,59,5471,64
2021-10-23,Butte,007,227075,20583,20101,3651,23752,273
2021-10-23,Calaveras,009,45235,3969,3865,49,3914,81
2021-10-23,Colusa,011,21464,2499,2458,625,3083,18
2021-10-23,Contra Costa,013,1133247,98744,97855,2147,100002,1008
2021-10-23,Del Norte,015,27424,3649,3540,53,3593,42
2021-10-23,El Dorado,017,186661,15842,15540,1654,17194,149
2021-10-23,Fresno,019,978130,137540,134466,12542,147008,2094
2021-10-23,Glenn,021,27897,3462,3399,1002,4401,33
2021-10-23,Humboldt,023,135768,8879,8753,525,9278,105
2021-10-23,Imperial,025,180216,33211,32777,3180,35957,766
2021-10-23,Inyo,027,18085,2232,2108,41,2149,41
2021-10-23,Kern,029,883053,125459,122939,21296,144235,1636
2021-10-23,Kings,031,150075,31719,30942,1890,32832,325
2021-10-23,Lake,033,64148,6637,6501,142,6643,105
2021-10-23,Lassen,035,31185,6774,6632,351,6983,27
2021-10-23,Los Angeles,037,10098052,1429245,1415919,54345,1470264,26527
2021-10-23,Madera,039,155013,22624,22062,2024,24086,281
2021-10-23,Marin,041,260295,17435,17264,445,17709,244
2021-10-23,Mariposa,043,17540,1243,1184,44,1228,5
2021-10-23,Mendocino,045,87422,7391,7220,480,7700,82
2021-10-23,Merced,047,269075,41315,40808,1835,42643,581
2021-10-23,Modoc,049,8938,521,507,185,692,5
2021-10-23,Mono,051,14174,1686,1655,22,1677,3
2021-10-23,Monterey,053,433212,48495,47456,2841,50297,586
2021-10-23,Napa,055,140530,12885,12789,109,12898,100
2021-10-23,Nevada,057,99092,9034,8861,313,9174,90
2021-10-23,Orange,059,3164182,305207,302237,14862,317099,5546
2021-10-23,Placer,061,380077,36537,35822,3577,39399,426
2021-10-23,Plumas,063,18699,1718,1623,33,1656,7
2021-10-23,Riverside,065,2383286,360184,354688,16362,371050,5041
2021-10-23,Sacramento,067,1510023,156994,155125,4457,159582,2232
2021-10-23,San Benito,069,59416,7325,7280,168,7448,71
2021-10-23,San Bernardino,071,2135413,351075,347681,11054,358735,5688
2021-10-23,San Diego,073,3302833,370113,366085,21673,387758,4183
2021-10-23,San Francisco,075,870044,52496,51820,2299,54119,649
2021-10-23,San Joaquin,077,732212,98679,97440,5370,102810,1721
2021-10-23,San Luis Obispo,079,281455,29263,28755,1212,29967,333
2021-10-23,San Mateo,081,765935,53809,52719,853,53572,571
2021-10-23,Santa Barbara,083,443738,44051,43552,1540,45092,523
2021-10-23,Santa Clara,085,1922200,145843,144276,1296,145572,1897
2021-10-23,Santa Cruz,087,273765,20193,19967,1004,20971,221
2021-10-23,Shasta,089,179085,20910,20386,3519,23905,321
2021-10-23,Sierra,091,2930,179,168,20,188,0
2021-10-23,Siskiyou,093,43540,3311,3231,1270,4501,46
2021-10-23,Solano,095,438530,45623,44861,1240,46101,341
2021-10-23,Sonoma,097,501317,40976,40476,518,40994,393
2021-10-23,Stanislaus,099,539301,77165,76812,8718,85530,1145
2021-10-23,Sutter,101,95872,13736,13616,328,13944,175
2021-10-23,Tehama,103,63373,8309,8105,1455,9560,110
2021-10-23,Trinity,105,12862,836,696,211,907,11
2021-10-23,Tulare,107,460477,67408,65585,14576,80161,978
2021-10-23,Tuolumne,109,53932,7014,6840,87,6927,90
2021-10-23,Ventura,111,848112,97502,96664,4292,100956,1167
2021-10-23,Yolo,113,214977,19575,19280,1094,20374,248
2021-10-23,Yuba,115,75493,9993,9838,303,10141,82
2021-10-22,Alameda,001,1643700,118704,117816,2770,120586,1397
2021-10-22,Alpine,003,1148,101,105,0,105,0
2021-10-22,Amador,005,37829,5489,5412,59,5471,64
2021-10-22,Butte,007,227075,20551,20101,3647,23748,273
2021-10-22,Calaveras,009,45235,3961,3865,49,3914,81
2021-10-22,Colusa,011,21464,2496,2458,625,3083,18
2021-10-22,Contra Costa,013,1133247,98653,97855,2145,100000,1008
2021-10-22,Del Norte,015,27424,3645,3540,53,3593,42
2021-10-22,El Dorado,017,186661,15829,15540,1652,17192,149
2021-10-22,Fresno,019,978130,137325,134466,12520,146986,2094
2021-10-22,Glenn,021,27897,3452,3399,1002,4401,33
2021-10-22,Humboldt,023,135768,8865,8753,524,9277,105
2021-10-22,Imperial,025,180216,33168,32777,3180,35957,766
2021-10-22,Inyo,027,18085,2219,2108,41,2149,41
2021-10-22,Kern,029,883053,125272,122939,21223,144162,1636
2021-10-22,Kings,031,150075,31684,30942,1889,32831,325
2021-10-22,Lake,033,64148,6627,6501,142,6643,105
2021-10-22,Lassen,035,31185,6767,6632,348,6980,27
2021-10-22,Los Angeles,037,10098052,1428491,1415919,54285,1470204,26527
2021-10-22,Madera,039,155013,22575,22062,2011,24073,281
2021-10-22,Marin,041,260295,17423,17264,445,17709,244
2021-10-22,Mariposa,043,17540,1240,1184,44,1228,5
2021-10-22,Mendocino,045,87422,7377,7220,479,7699,82
2021-10-22,Merced,047,269075,41278,40808,1828,42636,581
2021-10-22,Modoc,049,8938,521,507,185,692,5
2021-10-22,Mono,051,14174,1684,1655,22,1677,3
2021-10-22,Monterey,053,433212,48462,47456,2839,50295,586
2021-10-22,Napa,055,140530,12879,12789,109,12898,100
2021-10-22,Nevada,057,99092,9017,8861,312,9173,90
2021-10-22,Orange,059,3164182,304991,302237,14831,317068,5546
2021-10-22,Placer,061,380077,36509,35822,3568,39390,426
2021-10-22,Plumas,063,18699,1712,1623,33,1656,7
2021-10-22,Riverside,065,2383286,359873,354688,16357,371045,5041
2021-10-22,Sacramento,067,1510023,156808,155125,4447,159572,2232
2021-10-22,San Benito,069,59416,7320,7280,168,7448,71
2021-10-22,San Bernardino,071,2135413,350746,347681,11040,358721,5688
2021-10-22,San Diego,073,3302833,369700,366085,21655,387740,4183
2021-10-22,San Francisco,075,870044,52461,51820,2292,54112,649
2021-10-22,San Joaquin,077,732212,98620,97440,5367,102807,1721
2021-10-22,San Luis Obispo,079,281455,29233,28755,1212,29967,333
2021-10-22,San Mateo,081,765935,53760,52719,846,53565,571
2021-10-22,Santa Barbara,083,443738,44010,43552,1540,45092,523
2021-10-22,Santa Clara,085,1922200,145687,144276,1289,145565,1897
2021-10-22,Santa Cruz,087,273765,20171,19967,1004,20971,221
2021-10-22,Shasta,089,179085,20878,20386,3516,23902,321
2021-10-22,Sierra,091,2930,178,168,19,187,0
2021-10-22,Siskiyou,093,43540,3309,3231,1267,4498,46
2021-10-22,Solano,095,438530,45588,44861,1236,46097,341
2021-10-22,Sonoma,097,501317,40919,40476,518,40994,393
2021-10-22,Stanislaus,099,539301,77062,76812,8700,85512,1145
2021-10-22,Sutter,101,95872,13721,13616,328,13944,175
2021-10-22,Tehama,103,63373,8287,8105,1450,9555,110
2021-10-22,Trinity,105,12862,835,696,211,907,11
2021-10-22,Tulare,107,460477,67322,65585,14522,80107,978
2021-10-22,Tuolumne,109,53932,6979,6840,87,6927,90
2021-10-22,Ventura,111,848112,97449,96664,4286,100950,1167
2021-10-22,Yolo,113,214977,19548,19280,1092,20372,248
2021-10-22,Yuba,115,75493,9979,9838,301,10139,82
2021-10-21,Alameda,001,1643700,118588,117816,2765,120581,1397
2021-10-21,Alpine,003,1148,101,105,0,105,0
2021-10-21,Amador,005,37829,5481,5412,59,5471,64
2021-10-21,Butte,007,227075,20467,20101,3634,23735,273
2021-10-21,Calaveras,009,45235,3942,3865,49,3914,81
2021-10-21,Colusa,011,21464,2492,2458,621,3079,18
2021-10-21,Contra Costa,013,1133247,98538,97855,2139,99994,1008
2021-10-21,Del Norte,015,27424,3639,3540,52,3592,42
2021-10-21,El Dorado,017,186661,15801,15540,1645,17185,149
2021-10-21,Fresno,019,978130,136975,134466,12477,146943,2094
2021-10-21,Glenn,021,27897,3448,3399,999,4398,33
2021-10-21,Humboldt,023,135768,8851,8753,520,9273,105
2021-10-21,Imperial,025,180216,33113,32777,3176,35953,766
2021-10-21,Inyo,027,18085,2197,2108,41,2149,41
2021-10-21,Kern,029,883053,125025,122939,21112,144051,1636
2021-10-21,Kings,031,150075,31586,30942,1883,32825,325
2021-10-21,Lake,033,64148,6613,6501,141,6642,105
2021-10-21,Lassen,035,31185,6754,6632,344,6976,27
2021-10-21,Los Angeles,037,10098052,1427374,1415919,54234,1470153,26527
2021-10-21,Madera,039,155013,22517,22062,2001,24063,281
2021-10-21,Marin,041,260295,17405,17264,445,17709,244
2021-10-21,Mariposa,043,17540,1234,1184,43,1227,5
2021-10-21,Mendocino,045,87422,7359,7220,471,7691,82
2021-10-21,Merced,047,269075,41180,40808,1817,42625,581
2021-10-21,Modoc,049,8938,521,507,185,692,5
2021-10-21,Mono,051,14174,1675,1655,22,1677,3
2021-10-21,Monterey,053,433212,48428,47456,2827,50283,586
2021-10-21,Napa,055,140530,12867,12789,109,12898,100
2021-10-21,Nevada,057,99092,8992,8861,312,9173,90
2021-10-21,Orange,059,3164182,304718,302237,14795,317032,5546
2021-10-21,Placer,061,380077,36420,35822,3555,39377,426
2021-10-21,Plumas,063,18699,1698,1623,33,1656,7
2021-10-21,Riverside,065,2383286,359428,354688,16346,371034,5041
2021-10-21,Sacramento,067,1510023,156489,155125,4422,159547,2232
2021-10-21,San Benito,069,59416,7313,7280,166,7446,71
2021-10-21,San Bernardino,071,2135413,350366,347681,11005,358686,5688
2021-10-21,San Diego,073,3302833,369175,366085,21625,387710,4183
2021-10-21,San Francisco,075,870044,52406,51820,2291,54111,649
2021-10-21,San Joaquin,077,732212,98481,97440,5360,102800,1721
2021-10-21,San Luis Obispo,079,281455,29191,28755,1210,29965,333
2021-10-21,San Mateo,081,765935,53713,52719,845,53564,571
2021-10-21,Santa Barbara,083,443738,43944,43552,1538,45090,523
2021-10-21,Santa Clara,085,1922200,145515,144276,1285,145561,1897
2021-10-21,Santa Cruz,087,273765,20147,19967,1002,20969,221
2021-10-21,Shasta,089,179085,20816,20386,3501,23887,321
2021-10-21,Sierra,091,2930,177,168,18,186,0
2021-10-21,Siskiyou,093,43540,3304,3231,1265,4496,46
2021-10-21,Solano,095,438530,45536,44861,1234,46095,341
2021-10-21,Sonoma,097,501317,40850,40476,516,40992,393
2021-10-21,Stanislaus,099,539301,76893,76812,8689,85501,1145
2021-10-21,Sutter,101,95872,13693,13616,324,13940,175
2021-10-21,Tehama,103,63373,8260,8105,1443,9548,110
2021-10-21,Trinity,105,12862,833,696,211,907,11
2021-10-21,Tulare,107,460477,67132,65585,14451,80036,978
2021-10-21,Tuolumne,109,53932,6941,6840,86,6926,90
2021-10-21,Ventura,111,848112,97358,96664,4284,100948,1167
2021-10-21,Yolo,113,214977,19501,19280,1090,20370,248
2021-10-21,Yuba,115,75493,9955,9838,300,10138,82
2021-10-20,Alameda,001,1643700,118466,117654,2764,120418,1390
2021-10-20,Alpine,003,1148,101,103,0,103,0
2021-10-20,Amador,005,37829,5473,5379,59,5438,64
2021-10-20,Butte,007,227075,20413,20021,3619,23640,270
2021-10-20,Calaveras,009,45235,3922,3844,48,3892,81
2021-10-20,Colusa,011,21464,2488,2454,619,3073,18
2021-10-20,Contra Costa,013,1133247,98422,97721,2135,99856,1008
2021-10-20,Del Norte,015,27424,3635,3536,52,3588,42
2021-10-20,El Dorado,017,186661,15771,15502,1642,17144,149
2021-10-20,Fresno,019,978130,136573,134025,12441,146466,2084
2021-10-20,Glenn,021,27897,3440,3382,998,4380,33
2021-10-20,Humboldt,023,135768,8829,8727,518,9245,105
2021-10-20,Imperial,025,180216,33039,32705,3168,35873,766
2021-10-20,Inyo,027,18085,2177,2077,40,2117,40
2021-10-20,Kern,029,883053,124731,122630,20991,143621,1623
2021-10-20,Kings,031,150075,31509,30805,1873,32678,322
2021-10-20,Lake,033,64148,6591,6475,140,6615,104
2021-10-20,Lassen,035,31185,6739,6622,344,6966,27
2021-10-20,Los Angeles,037,10098052,1426255,1414931,54161,1469092,26506
2021-10-20,Madera,039,155013,22447,21983,1992,23975,281
2021-10-20,Marin,041,260295,17384,17250,443,17693,244
2021-10-20,Mariposa,043,17540,1227,1174,43,1217,5
2021-10-20,Mendocino,045,87422,7331,7189,468,7657,82
2021-10-20,Merced,047,269075,41099,40685,1800,42485,581
2021-10-20,Modoc,049,8938,521,504,185,689,5
2021-10-20,Mono,051,14174,1675,1653,22,1675,3
2021-10-20,Monterey,053,433212,48396,47430,2818,50248,587
2021-10-20,Napa,055,140530,12853,12773,108,12881,100
2021-10-20,Nevada,057,99092,8964,8836,312,9148,90
2021-10-20,Orange,059,3164182,304433,301957,14773,316730,5534
2021-10-20,Placer,061,380077,36330,35729,3546,39275,425
2021-10-20,Plumas,063,18699,1691,1604,33,1637,7
2021-10-20,Riverside,065,2383286,358983,354311,16329,370640,5030
2021-10-20,Sacramento,067,1510023,156188,154822,4398,159220,2222
2021-10-20,San Benito,069,59416,7310,7275,164,7439,71
2021-10-20,San Bernardino,071,2135413,349963,347217,10973,358190,5663
2021-10-20,San Diego,073,3302833,368659,365698,21606,387304,4178
2021-10-20,San Francisco,075,870044,52357,51755,2290,54045,646
2021-10-20,San Joaquin,077,732212,98336,97246,5352,102598,1721
2021-10-20,San Luis Obispo,079,281455,29146,28727,1206,29933,332
2021-10-20,San Mateo,081,765935,53642,52663,837,53500,571
2021-10-20,Santa Barbara,083,443738,43881,43489,1537,45026,523
2021-10-20,Santa Clara,085,1922200,145379,144124,1280,145404,1896
2021-10-20,Santa Cruz,087,273765,20134,19951,1002,20953,219
2021-10-20,Shasta,089,179085,20755,20313,3474,23787,320
2021-10-20,Sierra,091,2930,177,168,18,186,0
2021-10-20,Siskiyou,093,43540,3304,3224,1259,4483,46
2021-10-20,Solano,095,438530,45504,44819,1232,46051,341
2021-10-20,Sonoma,097,501317,40803,40404,516,40920,393
2021-10-20,Stanislaus,099,539301,76743,76631,8670,85301,1145
2021-10-20,Sutter,101,95872,13669,13592,318,13910,175
2021-10-20,Tehama,103,63373,8229,8081,1432,9513,110
2021-10-20,Trinity,105,12862,833,693,210,903,11
2021-10-20,Tulare,107,460477,66958,65413,14405,79818,967
2021-10-20,Tuolumne,109,53932,6918,6803,86,6889,89
2021-10-20,Ventura,111,848112,97276,96610,4280,100890,1166
2021-10-20,Yolo,113,214977,19457,19236,1087,20323,248
2021-10-20,Yuba,115,75493,9938,9808,297,10105,82
2021-10-19,Alameda,001,1643700,118344,117542,2758,120300,1383
2021-10-19,Alpine,003,1148,101,103,0,103,0
2021-10-19,Amador,005,37829,5457,5367,59,5426,64
2021-10-19,Butte,007,227075,20360,19974,3611,23585,268
2021-10-19,Calaveras,009,45235,3905,3826,47,3873,80
2021-10-19,Colusa,011,21464,2485,2447,617,3064,18
2021-10-19,Contra Costa,013,1133247,98331,97613,2130,99743,1004
2021-10-19,Del Norte,015,27424,3628,3531,52,3583,42
2021-10-19,El Dorado,017,186661,15746,15478,1637,17115,149
2021-10-19,Fresno,019,978130,136208,133813,12392,146205,2073
2021-10-19,Glenn,021,27897,3437,3380,996,4376,33
2021-10-19,Humboldt,023,135768,8805,8714,512,9226,105
2021-10-19,Imperial,025,180216,32973,32632,3164,35796,764
2021-10-19,Inyo,027,18085,2146,2045,40,2085,40
2021-10-19,Kern,029,883053,124414,122391,20867,143258,1613
2021-10-19,Kings,031,150075,31415,30757,1866,32623,322
2021-10-19,Lake,033,64148,6587,6465,140,6605,104
2021-10-19,Lassen,035,31185,6733,6612,340,6952,27
2021-10-19,Los Angeles,037,10098052,1425010,1413882,54084,1467966,26473
2021-10-19,Madera,039,155013,22384,21950,1984,23934,281
2021-10-19,Marin,041,260295,17370,17241,440,17681,244
2021-10-19,Mariposa,043,17540,1221,1171,41,1212,5
2021-10-19,Mendocino,045,87422,7316,7172,465,7637,82
2021-10-19,Merced,047,269075,40984,40628,1779,42407,580
2021-10-19,Modoc,049,8938,519,502,185,687,5
2021-10-19,Mono,051,14174,1671,1651,22,1673,3
2021-10-19,Monterey,053,433212,48357,47412,2807,50219,583
2021-10-19,Napa,055,140530,12846,12769,108,12877,100
2021-10-19,Nevada,057,99092,8943,8829,311,9140,90
2021-10-19,Orange,059,3164182,304176,301700,14740,316440,5527
2021-10-19,Placer,061,380077,36209,35663,3531,39194,422
2021-10-19,Plumas,063,18699,1673,1586,33,1619,8
2021-10-19,Riverside,065,2383286,358561,353891,16321,370212,5020
2021-10-19,Sacramento,067,1510023,155882,154570,4372,158942,2227
2021-10-19,San Benito,069,59416,7294,7264,164,7428,71
2021-10-19,San Bernardino,071,2135413,349563,346814,10943,357757,5627
2021-10-19,San Diego,073,3302833,368065,365285,21575,386860,4170
2021-10-19,San Francisco,075,870044,52294,51704,2288,53992,645
2021-10-19,San Joaquin,077,732212,98169,97105,5341,102446,1721
2021-10-19,San Luis Obispo,079,281455,29098,28670,1203,29873,332
2021-10-19,San Mateo,081,765935,53584,52617,835,53452,571
2021-10-19,Santa Barbara,083,443738,43814,43413,1535,44948,522
2021-10-19,Santa Clara,085,1922200,145206,143989,1272,145261,1898
2021-10-19,Santa Cruz,087,273765,20110,19895,1000,20895,218
2021-10-19,Shasta,089,179085,20678,20209,3466,23675,319
2021-10-19,Sierra,091,2930,174,168,18,186,0
2021-10-19,Siskiyou,093,43540,3300,3216,1254,4470,46
2021-10-19,Solano,095,438530,45462,44782,1226,46008,341
2021-10-19,Sonoma,097,501317,40729,40379,515,40894,392
2021-10-19,Stanislaus,099,539301,76601,76526,8658,85184,1145
2021-10-19,Sutter,101,95872,13645,13569,317,13886,174
2021-10-19,Tehama,103,63373,8199,8057,1416,9473,108
2021-10-19,Trinity,105,12862,826,691,210,901,11
2021-10-19,Tulare,107,460477,66771,65253,14336,79589,958
2021-10-19,Tuolumne,109,53932,6889,6782,85,6867,89
2021-10-19,Ventura,111,848112,97200,96539,4275,100814,1166
2021-10-19,Yolo,113,214977,19412,19206,1082,20288,248
2021-10-19,Yuba,115,75493,9920,9796,296,10092,82
2021-10-18,Alameda,001,1643700,118207,117506,2749,120255,1381
2021-10-18,Alpine,003,1148,101,103,0,103,0
2021-10-18,Amador,005,37829,5446,5345,59,5404,64
2021-10-18,Butte,007,227075,20309,19921,3603,23524,265
2021-10-18,Calaveras,009,45235,3880,3819,46,3865,80
2021-10-18,Colusa,011,21464,2484,2444,615,3059,18
2021-10-18,Contra Costa,013,1133247,98219,97585,2126,99711,995
2021-10-18,Del Norte,015,27424,3621,3529,52,3581,41
2021-10-18,El Dorado,017,186661,15715,15452,1635,17087,149
2021-10-18,Fresno,019,978130,135805,133688,12349,146037,2063
2021-10-18,Glenn,021,27897,3433,3370,992,4362,32
2021-10-18,Humboldt,023,135768,8786,8699,504,9203,104
2021-10-18,Imperial,025,180216,32882,32558,3164,35722,764
2021-10-18,Inyo,027,18085,2128,2020,40,2060,40
2021-10-18,Kern,029,883053,124115,122231,20771,143002,1605
2021-10-18,Kings,031,150075,31300,30698,1853,32551,320
2021-10-18,Lake,033,64148,6568,6455,136,6591,104
2021-10-18,Lassen,035,31185,6713,6607,337,6944,26
2021-10-18,Los Angeles,037,10098052,1423768,1413291,54006,1467297,26446
2021-10-18,Madera,039,155013,22330,21909,1971,23880,277
2021-10-18,Marin,041,260295,17350,17232,437,17669,244
2021-10-18,Mariposa,043,17540,1213,1160,41,1201,5
2021-10-18,Mendocino,045,87422,7297,7156,457,7613,82
2021-10-18,Merced,047,269075,40861,40573,1768,42341,579
2021-10-18,Modoc,049,8938,519,498,185,683,5
2021-10-18,Mono,051,14174,1665,1648,21,1669,3
2021-10-18,Monterey,053,433212,48335,47389,2802,50191,583
2021-10-18,Napa,055,140530,12831,12762,108,12870,100
2021-10-18,Nevada,057,99092,8924,8816,311,9127,90
2021-10-18,Orange,059,3164182,303837,301573,14706,316279,5524
2021-10-18,Placer,061,380077,36132,35598,3527,39125,420
2021-10-18,Plumas,063,18699,1665,1579,33,1612,6
2021-10-18,Riverside,065,2383286,358146,353699,16307,370006,5008
2021-10-18,Sacramento,067,1510023,155577,154428,4339,158767,2203
2021-10-18,San Benito,069,59416,7282,7253,164,7417,71
2021-10-18,San Bernardino,071,2135413,349141,346742,10929,357671,5606
2021-10-18,San Diego,073,3302833,367499,364948,21537,386485,4169
2021-10-18,San Francisco,075,870044,52231,51671,2282,53953,644
2021-10-18,San Joaquin,077,732212,98004,97041,5331,102372,1721
2021-10-18,San Luis Obispo,079,281455,29059,28644,1200,29844,331
2021-10-18,San Mateo,081,765935,53519,52594,834,53428,571
2021-10-18,Santa Barbara,083,443738,43755,43386,1533,44919,522
2021-10-18,Santa Clara,085,1922200,145051,143891,1263,145154,1895
2021-10-18,Santa Cruz,087,273765,20096,19876,998,20874,218
2021-10-18,Shasta,089,179085,20598,20146,3455,23601,313
2021-10-18,Sierra,091,2930,174,166,18,184,0
2021-10-18,Siskiyou,093,43540,3297,3210,1246,4456,42
2021-10-18,Solano,095,438530,45418,44758,1223,45981,339
2021-10-18,Sonoma,097,501317,40665,40349,512,40861,392
2021-10-18,Stanislaus,099,539301,76437,76466,8645,85111,1145
2021-10-18,Sutter,101,95872,13611,13557,315,13872,172
2021-10-18,Tehama,103,63373,8164,8042,1404,9446,107
2021-10-18,Trinity,105,12862,825,688,210,898,11
2021-10-18,Tulare,107,460477,66595,65171,14270,79441,958
2021-10-18,Tuolumne,109,53932,6859,6755,85,6840,89
2021-10-18,Ventura,111,848112,97105,96506,4272,100778,1165
2021-10-18,Yolo,113,214977,19374,19197,1079,20276,248
2021-10-18,Yuba,115,75493,9893,9782,294,10076,82
2021-10-17,Alameda,001,1643700,118055,117423,2744,120167,1376
2021-10-17,Alpine,003,1148,101,103,0,103,0
2021-10-17,Amador,005,37829,5423,5341,58,5399,64
2021-10-17,Butte,007,227075,20224,19897,3594,23491,265
2021-10-17,Calaveras,009,45235,3864,3805,46,3851,80
2021-10-17,Colusa,011,21464,2479,2442,608,3050,18
2021-10-17,Contra Costa,013,1133247,98096,97485,2115,99600,995
2021-10-17,Del Norte,015,27424,3616,3526,52,3578,41
2021-10-17,El Dorado,017,186661,15657,15438,1628,17066,149
2021-10-17,Fresno,019,978130,135337,133429,12308,145737,2063
2021-10-17,Glenn,021,27897,3423,3364,987,4351,32
2021-10-17,Humboldt,023,135768,8766,8690,501,9191,104
2021-10-17,Imperial,025,180216,32799,32520,3157,35677,764
2021-10-17,Inyo,027,18085,2100,2000,40,2040,40
2021-10-17,Kern,029,883053,123765,122085,20671,142756,1603
2021-10-17,Kings,031,150075,31187,30636,1844,32480,315
2021-10-17,Lake,033,64148,6552,6437,136,6573,104
2021-10-17,Lassen,035,31185,6701,6605,333,6938,26
2021-10-17,Los Angeles,037,10098052,1422431,1412371,53930,1466301,26443
2021-10-17,Madera,039,155013,22268,21869,1960,23829,277
2021-10-17,Marin,041,260295,17328,17211,437,17648,243
2021-10-17,Mariposa,043,17540,1206,1150,41,1191,5
2021-10-17,Mendocino,045,87422,7268,7148,451,7599,82
2021-10-17,Merced,047,269075,40735,40531,1752,42283,579
2021-10-17,Modoc,049,8938,516,498,183,681,5
2021-10-17,Mono,051,14174,1663,1640,20,1660,3
2021-10-17,Monterey,053,433212,48294,47369,2792,50161,583
2021-10-17,Napa,055,140530,12816,12753,105,12858,100
2021-10-17,Nevada,057,99092,8907,8794,310,9104,90
2021-10-17,Orange,059,3164182,303522,301414,14673,316087,5524
2021-10-17,Placer,061,380077,36033,35559,3512,39071,420
2021-10-17,Plumas,063,18699,1641,1571,32,1603,6
2021-10-17,Riverside,065,2383286,357662,353500,16293,369793,5008
2021-10-17,Sacramento,067,1510023,155175,154080,4321,158401,2213
2021-10-17,San Benito,069,59416,7273,7250,163,7413,71
2021-10-17,San Bernardino,071,2135413,348712,346524,10909,357433,5597
2021-10-17,San Diego,073,3302833,366891,364675,21509,386184,4163
2021-10-17,San Francisco,075,870044,52159,51625,2272,53897,644
2021-10-17,San Joaquin,077,732212,97831,96950,5322,102272,1721
2021-10-17,San Luis Obispo,079,281455,29007,28604,1192,29796,331
2021-10-17,San Mateo,081,765935,53467,52541,830,53371,571
2021-10-17,Santa Barbara,083,443738,43692,43344,1532,44876,522
2021-10-17,Santa Clara,085,1922200,144875,143768,1254,145022,1895
2021-10-17,Santa Cruz,087,273765,20068,19861,996,20857,218
2021-10-17,Shasta,089,179085,20508,20116,3445,23561,312
2021-10-17,Sierra,091,2930,172,165,18,183,0
2021-10-17,Siskiyou,093,43540,3289,3204,1243,4447,42
2021-10-17,Solano,095,438530,45361,44722,1222,45944,340
2021-10-17,Sonoma,097,501317,40589,40306,511,40817,392
2021-10-17,Stanislaus,099,539301,76239,76354,8630,84984,1145
2021-10-17,Sutter,101,95872,13594,13543,313,13856,172
2021-10-17,Tehama,103,63373,8132,8015,1387,9402,107
2021-10-17,Trinity,105,12862,822,686,209,895,11
2021-10-17,Tulare,107,460477,66410,65057,14196,79253,958
2021-10-17,Tuolumne,109,53932,6825,6735,84,6819,89
2021-10-17,Ventura,111,848112,97005,96458,4269,100727,1165
2021-10-17,Yolo,113,214977,19332,19171,1070,20241,248
2021-10-17,Yuba,115,75493,9867,9771,292,10063,82
2021-10-16,Alameda,001,1643700,117964,117027,2743,119770,1365
2021-10-16,Alpine,003,1148,100,102,0,102,0
2021-10-16,Amador,005,37829,5416,5310,58,5368,64
2021-10-16,Butte,007,227075,20193,19612,3587,23199,260
2021-10-16,Calaveras,009,45235,3857,3771,46,3817,80
2021-10-16,Colusa,011,21464,2475,2431,605,3036,18
2021-10-16,Contra Costa,013,1133247,98005,97107,2108,99215,982
2021-10-16,Del Norte,015,27424,3613,3516,52,3568,41
2021-10-16,El Dorado,017,186661,15636,15315,1626,16941,149
2021-10-16,Fresno,019,978130,135184,132433,12292,144725,2051
2021-10-16,Glenn,021,27897,3417,3331,987,4318,26
2021-10-16,Humboldt,023,135768,8754,8621,496,9117,104
2021-10-16,Imperial,025,180216,32784,32368,3155,35523,764
2021-10-16,Inyo,027,18085,2086,1932,40,1972,39
2021-10-16,Kern,029,883053,123610,121354,20588,141942,1590
2021-10-16,Kings,031,150075,31141,30418,1841,32259,314
2021-10-16,Lake,033,64148,6541,6378,136,6514,104
2021-10-16,Lassen,035,31185,6692,6559,328,6887,26
2021-10-16,Los Angeles,037,10098052,1421781,1409418,53875,1463293,26398
2021-10-16,Madera,039,155013,22224,21707,1956,23663,277
2021-10-16,Marin,041,260295,17318,17148,437,17585,243
2021-10-16,Mariposa,043,17540,1203,1096,41,1137,5
2021-10-16,Mendocino,045,87422,7257,7099,451,7550,82
2021-10-16,Merced,047,269075,40703,40265,1750,42015,577
2021-10-16,Modoc,049,8938,513,492,183,675,5
2021-10-16,Mono,051,14174,1659,1628,20,1648,3
2021-10-16,Monterey,053,433212,48277,47293,2784,50077,582
2021-10-16,Napa,055,140530,12805,12706,105,12811,100
2021-10-16,Nevada,057,99092,8887,8739,310,9049,90
2021-10-16,Orange,059,3164182,303346,300722,14648,315370,5509
2021-10-16,Placer,061,380077,35949,35343,3506,38849,412
2021-10-16,Plumas,063,18699,1636,1542,31,1573,6
2021-10-16,Riverside,065,2383286,357393,352435,16281,368716,4990
2021-10-16,Sacramento,067,1510023,154976,153264,4317,157581,2192
2021-10-16,San Benito,069,59416,7260,7210,162,7372,71
2021-10-16,San Bernardino,071,2135413,348505,345418,10901,356319,5566
2021-10-16,San Diego,073,3302833,366568,363109,21493,384602,4151
2021-10-16,San Francisco,075,870044,52112,51436,2268,53704,645
2021-10-16,San Joaquin,077,732212,97759,96507,5319,101826,1708
2021-10-16,San Luis Obispo,079,281455,28981,28460,1191,29651,329
2021-10-16,San Mateo,081,765935,53418,52399,829,53228,569
2021-10-16,Santa Barbara,083,443738,43656,43175,1531,44706,521
2021-10-16,Santa Clara,085,1922200,144775,143282,1246,144528,1890
2021-10-16,Santa Cruz,087,273765,20053,19794,995,20789,218
2021-10-16,Shasta,089,179085,20458,19932,3434,23366,309
2021-10-16,Sierra,091,2930,170,160,18,178,0
2021-10-16,Siskiyou,093,43540,3287,3173,1236,4409,42
2021-10-16,Solano,095,438530,45335,44585,1218,45803,334
2021-10-16,Sonoma,097,501317,40549,40195,511,40706,390
2021-10-16,Stanislaus,099,539301,76153,75868,8620,84488,1142
2021-10-16,Sutter,101,95872,13575,13471,312,13783,169
2021-10-16,Tehama,103,63373,8119,7907,1382,9289,104
2021-10-16,Trinity,105,12862,822,679,209,888,11
2021-10-16,Tulare,107,460477,66272,64489,14163,78652,951
2021-10-16,Tuolumne,109,53932,6793,6666,84,6750,89
2021-10-16,Ventura,111,848112,96973,96181,4264,100445,1164
2021-10-16,Yolo,113,214977,19305,19078,1064,20142,247
2021-10-16,Yuba,115,75493,9843,9705,289,9994,82
2021-10-15,Alameda,001,1643700,117891,117027,2739,119766,1365
2021-10-15,Alpine,003,1148,100,102,0,102,0
2021-10-15,Amador,005,37829,5392,5310,58,5368,64
2021-10-15,Butte,007,227075,20156,19612,3580,23192,260
2021-10-15,Calaveras,009,45235,3851,3771,46,3817,80
2021-10-15,Colusa,011,21464,2473,2431,602,3033,18
2021-10-15,Contra Costa,013,1133247,97923,97107,2104,99211,982
2021-10-15,Del Norte,015,27424,3611,3516,52,3568,41
2021-10-15,El Dorado,017,186661,15616,15315,1621,16936,149
2021-10-15,Fresno,019,978130,134930,132433,12282,144715,2051
2021-10-15,Glenn,021,27897,3411,3331,986,4317,26
2021-10-15,Humboldt,023,135768,8745,8621,494,9115,104
2021-10-15,Imperial,025,180216,32737,32368,3151,35519,764
2021-10-15,Inyo,027,18085,2068,1932,40,1972,39
2021-10-15,Kern,029,883053,123474,121354,20513,141867,1590
2021-10-15,Kings,031,150075,31086,30418,1837,32255,314
2021-10-15,Lake,033,64148,6532,6378,136,6514,104
2021-10-15,Lassen,035,31185,6680,6559,327,6886,26
2021-10-15,Los Angeles,037,10098052,1421090,1409418,53826,1463244,26398
2021-10-15,Madera,039,155013,22180,21707,1948,23655,277
2021-10-15,Marin,041,260295,17307,17148,437,17585,243
2021-10-15,Mariposa,043,17540,1195,1096,41,1137,5
2021-10-15,Mendocino,045,87422,7242,7099,451,7550,82
2021-10-15,Merced,047,269075,40673,40265,1747,42012,577
2021-10-15,Modoc,049,8938,512,492,183,675,5
2021-10-15,Mono,051,14174,1656,1628,20,1648,3
2021-10-15,Monterey,053,433212,48255,47293,2782,50075,582
2021-10-15,Napa,055,140530,12801,12706,105,12811,100
2021-10-15,Nevada,057,99092,8872,8739,310,9049,90
2021-10-15,Orange,059,3164182,303178,300722,14629,315351,5509
2021-10-15,Placer,061,380077,35895,35343,3500,38843,412
2021-10-15,Plumas,063,18699,1628,1542,31,1573,6
2021-10-15,Riverside,065,2383286,357151,352435,16276,368711,4990
2021-10-15,Sacramento,067,1510023,154791,153264,4307,157571,2192
2021-10-15,San Benito,069,59416,7257,7210,162,7372,71
2021-10-15,San Bernardino,071,2135413,348269,345418,10899,356317,5566
2021-10-15,San Diego,073,3302833,366204,363109,21468,384577,4151
2021-10-15,San Francisco,075,870044,52072,51436,2261,53697,645
2021-10-15,San Joaquin,077,732212,97681,96507,5312,101819,1708
2021-10-15,San Luis Obispo,079,281455,28960,28460,1189,29649,329
2021-10-15,San Mateo,081,765935,53374,52399,828,53227,569
2021-10-15,Santa Barbara,083,443738,43618,43175,1531,44706,521
2021-10-15,Santa Clara,085,1922200,144653,143282,1238,144520,1890
2021-10-15,Santa Cruz,087,273765,20042,19794,995,20789,218
2021-10-15,Shasta,089,179085,20401,19932,3426,23358,309
2021-10-15,Sierra,091,2930,170,160,18,178,0
2021-10-15,Siskiyou,093,43540,3286,3173,1233,4406,42
2021-10-15,Solano,095,438530,45309,44585,1218,45803,334
2021-10-15,Sonoma,097,501317,40515,40195,510,40705,390
2021-10-15,Stanislaus,099,539301,76073,75868,8604,84472,1142
2021-10-15,Sutter,101,95872,13558,13471,310,13781,169
2021-10-15,Tehama,103,63373,8098,7907,1376,9283,104
2021-10-15,Trinity,105,12862,822,679,209,888,11
2021-10-15,Tulare,107,460477,66193,64489,14126,78615,951
2021-10-15,Tuolumne,109,53932,6770,6666,82,6748,89
2021-10-15,Ventura,111,848112,96931,96181,4261,100442,1164
2021-10-15,Yolo,113,214977,19290,19078,1060,20138,247
2021-10-15,Yuba,115,75493,9833,9705,288,9993,82
2021-10-14,Alameda,001,1643700,117780,117027,2734,119761,1365
2021-10-14,Alpine,003,1148,100,102,0,102,0
2021-10-14,Amador,005,37829,5381,5310,58,5368,64
2021-10-14,Butte,007,227075,20104,19612,3575,23187,260
2021-10-14,Calaveras,009,45235,3838,3771,45,3816,80
2021-10-14,Colusa,011,21464,2471,2431,600,3031,18
2021-10-14,Contra Costa,013,1133247,97788,97107,2096,99203,982
2021-10-14,Del Norte,015,27424,3605,3516,52,3568,41
2021-10-14,El Dorado,017,186661,15577,15315,1618,16933,149
2021-10-14,Fresno,019,978130,134634,132433,12250,144683,2051
2021-10-14,Glenn,021,27897,3406,3331,985,4316,26
2021-10-14,Humboldt,023,135768,8728,8621,491,9112,104
2021-10-14,Imperial,025,180216,32674,32368,3144,35512,764
2021-10-14,Inyo,027,18085,2049,1932,40,1972,39
2021-10-14,Kern,029,883053,123204,121354,20413,141767,1590
2021-10-14,Kings,031,150075,31021,30418,1829,32247,314
2021-10-14,Lake,033,64148,6511,6378,135,6513,104
2021-10-14,Lassen,035,31185,6674,6559,326,6885,26
2021-10-14,Los Angeles,037,10098052,1420108,1409418,53775,1463193,26398
2021-10-14,Madera,039,155013,22115,21707,1942,23649,277
2021-10-14,Marin,041,260295,17302,17148,435,17583,243
2021-10-14,Mariposa,043,17540,1182,1096,40,1136,5
2021-10-14,Mendocino,045,87422,7228,7099,449,7548,82
2021-10-14,Merced,047,269075,40585,40265,1733,41998,577
2021-10-14,Modoc,049,8938,512,492,183,675,5
2021-10-14,Mono,051,14174,1649,1628,20,1648,3
2021-10-14,Monterey,053,433212,48229,47293,2777,50070,582
2021-10-14,Napa,055,140530,12786,12706,105,12811,100
2021-10-14,Nevada,057,99092,8845,8739,308,9047,90
2021-10-14,Orange,059,3164182,302969,300722,14612,315334,5509
2021-10-14,Placer,061,380077,35828,35343,3486,38829,412
2021-10-14,Plumas,063,18699,1613,1542,31,1573,6
2021-10-14,Riverside,065,2383286,356754,352435,16265,368700,4990
2021-10-14,Sacramento,067,1510023,154539,153264,4285,157549,2192
2021-10-14,San Benito,069,59416,7246,7210,162,7372,71
2021-10-14,San Bernardino,071,2135413,347912,345418,10893,356311,5566
2021-10-14,San Diego,073,3302833,365756,363109,21441,384550,4151
2021-10-14,San Francisco,075,870044,52016,51436,2257,53693,645
2021-10-14,San Joaquin,077,732212,97552,96507,5303,101810,1708
2021-10-14,San Luis Obispo,079,281455,28916,28460,1185,29645,329
2021-10-14,San Mateo,081,765935,53326,52399,827,53226,569
2021-10-14,Santa Barbara,083,443738,43562,43175,1526,44701,521
2021-10-14,Santa Clara,085,1922200,144512,143282,1232,144514,1890
2021-10-14,Santa Cruz,087,273765,20019,19794,995,20789,218
2021-10-14,Shasta,089,179085,20344,19932,3414,23346,309
2021-10-14,Sierra,091,2930,169,160,18,178,0
2021-10-14,Siskiyou,093,43540,3283,3173,1225,4398,42
2021-10-14,Solano,095,438530,45259,44585,1210,45795,334
2021-10-14,Sonoma,097,501317,40464,40195,507,40702,390
2021-10-14,Stanislaus,099,539301,75927,75868,8591,84459,1142
2021-10-14,Sutter,101,95872,13538,13471,309,13780,169
2021-10-14,Tehama,103,63373,8067,7907,1369,9276,104
2021-10-14,Trinity,105,12862,821,679,208,887,11
2021-10-14,Tulare,107,460477,66009,64489,14078,78567,951
2021-10-14,Tuolumne,109,53932,6739,6666,81,6747,89
2021-10-14,Ventura,111,848112,96863,96181,4255,100436,1164
2021-10-14,Yolo,113,214977,19257,19078,1053,20131,247
2021-10-14,Yuba,115,75493,9819,9705,279,9984,82
2021-10-13,Alameda,001,1643700,117673,116914,2729,119643,1360
2021-10-13,Alpine,003,1148,100,102,0,102,0
2021-10-13,Amador,005,37829,5367,5305,58,5363,63
2021-10-13,Butte,007,227075,20030,19546,3571,23117,257
2021-10-13,Calaveras,009,45235,3817,3756,43,3799,79
2021-10-13,Colusa,011,21464,2464,2430,596,3026,18
2021-10-13,Contra Costa,013,1133247,97672,96975,2095,99070,969
2021-10-13,Del Norte,015,27424,3600,3512,52,3564,39
2021-10-13,El Dorado,017,186661,15553,15302,1613,16915,149
2021-10-13,Fresno,019,978130,134300,132055,12217,144272,2048
2021-10-13,Glenn,021,27897,3401,3327,981,4308,26
2021-10-13,Humboldt,023,135768,8717,8604,487,9091,102
2021-10-13,Imperial,025,180216,32614,32317,3140,35457,762
2021-10-13,Inyo,027,18085,2012,1907,40,1947,39
2021-10-13,Kern,029,883053,122961,120956,20318,141274,1586
2021-10-13,Kings,031,150075,30940,30246,1822,32068,312
2021-10-13,Lake,033,64148,6491,6371,135,6506,103
2021-10-13,Lassen,035,31185,6663,6535,320,6855,25
2021-10-13,Los Angeles,037,10098052,1419052,1408384,53718,1462102,26379
2021-10-13,Madera,039,155013,22062,21609,1928,23537,277
2021-10-13,Marin,041,260295,17278,17137,434,17571,243
2021-10-13,Mariposa,043,17540,1168,1090,40,1130,5
2021-10-13,Mendocino,045,87422,7212,7088,441,7529,82
2021-10-13,Merced,047,269075,40500,40164,1722,41886,577
2021-10-13,Modoc,049,8938,510,490,181,671,5
2021-10-13,Mono,051,14174,1649,1612,20,1632,3
2021-10-13,Monterey,053,433212,48210,47273,2770,50043,582
2021-10-13,Napa,055,140530,12775,12695,103,12798,100
2021-10-13,Nevada,057,99092,8823,8725,308,9033,90
2021-10-13,Orange,059,3164182,302761,300468,14596,315064,5503
2021-10-13,Placer,061,380077,35761,35254,3477,38731,412
2021-10-13,Plumas,063,18699,1599,1514,31,1545,6
2021-10-13,Riverside,065,2383286,356424,352044,16252,368296,4978
2021-10-13,Sacramento,067,1510023,154289,153141,4263,157404,2182
2021-10-13,San Benito,069,59416,7240,7196,161,7357,71
2021-10-13,San Bernardino,071,2135413,347587,344951,10877,355828,5562
2021-10-13,San Diego,073,3302833,365320,362564,21419,383983,4141
2021-10-13,San Francisco,075,870044,51974,51379,2253,53632,644
2021-10-13,San Joaquin,077,732212,97409,96343,5298,101641,1696
2021-10-13,San Luis Obispo,079,281455,28878,28397,1182,29579,330
2021-10-13,San Mateo,081,765935,53274,52352,823,53175,569
2021-10-13,Santa Barbara,083,443738,43510,43109,1526,44635,518
2021-10-13,Santa Clara,085,1922200,144374,143064,1231,144295,1886
2021-10-13,Santa Cruz,087,273765,19993,19763,994,20757,217
2021-10-13,Shasta,089,179085,20274,19802,3393,23195,307
2021-10-13,Sierra,091,2930,169,155,18,173,0
2021-10-13,Siskiyou,093,43540,3275,3173,1224,4397,42
2021-10-13,Solano,095,438530,45220,44558,1207,45765,334
2021-10-13,Sonoma,097,501317,40408,40122,507,40629,390
2021-10-13,Stanislaus,099,539301,75786,75698,8581,84279,1136
2021-10-13,Sutter,101,95872,13508,13458,307,13765,169
2021-10-13,Tehama,103,63373,8029,7849,1363,9212,103
2021-10-13,Trinity,105,12862,818,677,208,885,11
2021-10-13,Tulare,107,460477,65829,64297,14022,78319,945
2021-10-13,Tuolumne,109,53932,6725,6644,80,6724,89
2021-10-13,Ventura,111,848112,96789,96099,4249,100348,1162
2021-10-13,Yolo,113,214977,19228,19023,1051,20074,247
2021-10-13,Yuba,115,75493,9794,9690,265,9955,80
2021-10-12,Alameda,001,1643700,117568,116813,2724,119537,1357
2021-10-12,Alpine,003,1148,100,102,0,102,0
2021-10-12,Amador,005,37829,5356,5301,58,5359,63
2021-10-12,Butte,007,227075,19960,19506,3559,23065,256
2021-10-12,Calaveras,009,45235,3802,3750,43,3793,75
2021-10-12,Colusa,011,21464,2461,2428,594,3022,18
2021-10-12,Contra Costa,013,1133247,97557,96894,2086,98980,960
2021-10-12,Del Norte,015,27424,3594,3511,52,3563,39
2021-10-12,El Dorado,017,186661,15519,15287,1611,16898,148
2021-10-12,Fresno,019,978130,133937,131848,12186,144034,2042
2021-10-12,Glenn,021,27897,3386,3321,980,4301,26
2021-10-12,Humboldt,023,135768,8690,8587,481,9068,102
2021-10-12,Imperial,025,180216,32562,32267,3138,35405,762
2021-10-12,Inyo,027,18085,1980,1889,40,1929,39
2021-10-12,Kern,029,883053,122674,120826,20207,141033,1580
2021-10-12,Kings,031,150075,30866,30200,1811,32011,312
2021-10-12,Lake,033,64148,6476,6372,133,6505,97
2021-10-12,Lassen,035,31185,6653,6526,319,6845,25
2021-10-12,Los Angeles,037,10098052,1417985,1407462,53670,1461132,26362
2021-10-12,Madera,039,155013,21991,21574,1915,23489,277
2021-10-12,Marin,041,260295,17255,17126,434,17560,242
2021-10-12,Mariposa,043,17540,1154,1088,40,1128,5
2021-10-12,Mendocino,045,87422,7183,7077,438,7515,82
2021-10-12,Merced,047,269075,40421,40113,1716,41829,567
2021-10-12,Modoc,049,8938,505,485,180,665,5
2021-10-12,Mono,051,14174,1647,1608,20,1628,3
2021-10-12,Monterey,053,433212,48179,47254,2762,50016,582
2021-10-12,Napa,055,140530,12761,12671,103,12774,97
2021-10-12,Nevada,057,99092,8811,8720,307,9027,89
2021-10-12,Orange,059,3164182,302507,300256,14570,314826,5499
2021-10-12,Placer,061,380077,35698,35214,3469,38683,404
2021-10-12,Plumas,063,18699,1585,1488,30,1518,6
2021-10-12,Riverside,065,2383286,356097,351771,16238,368009,4973
2021-10-12,Sacramento,067,1510023,153985,152935,4238,157173,2170
2021-10-12,San Benito,069,59416,7226,7193,161,7354,71
2021-10-12,San Bernardino,071,2135413,347273,344788,10868,355656,5563
2021-10-12,San Diego,073,3302833,364797,362256,21390,383646,4137
2021-10-12,San Francisco,075,870044,51911,51301,2252,53553,643
2021-10-12,San Joaquin,077,732212,97272,96237,5293,101530,1690
2021-10-12,San Luis Obispo,079,281455,28831,28379,1181,29560,327
2021-10-12,San Mateo,081,765935,53224,52328,822,53150,569
2021-10-12,Santa Barbara,083,443738,43449,43076,1526,44602,515
2021-10-12,Santa Clara,085,1922200,144220,142954,1229,144183,1882
2021-10-12,Santa Cruz,087,273765,19968,19757,994,20751,218
2021-10-12,Shasta,089,179085,20200,19731,3372,23103,304
2021-10-12,Sierra,091,2930,169,153,18,171,0
2021-10-12,Siskiyou,093,43540,3264,3166,1218,4384,42
2021-10-12,Solano,095,438530,45178,44516,1202,45718,329
2021-10-12,Sonoma,097,501317,40367,40105,506,40611,390
2021-10-12,Stanislaus,099,539301,75634,75589,8568,84157,1126
2021-10-12,Sutter,101,95872,13485,13436,303,13739,168
2021-10-12,Tehama,103,63373,7996,7820,1359,9179,103
2021-10-12,Trinity,105,12862,815,676,208,884,11
2021-10-12,Tulare,107,460477,65644,64216,13965,78181,944
2021-10-12,Tuolumne,109,53932,6708,6637,79,6716,89
2021-10-12,Ventura,111,848112,96688,96022,4244,100266,1160
2021-10-12,Yolo,113,214977,19201,18987,1043,20030,247
2021-10-12,Yuba,115,75493,9779,9676,261,9937,70
2021-10-11,Alameda,001,1643700,117426,116759,2723,119482,1358
2021-10-11,Alpine,003,1148,100,102,0,102,0
2021-10-11,Amador,005,37829,5344,5286,58,5344,62
2021-10-11,Butte,007,227075,19901,19452,3554,23006,253
2021-10-11,Calaveras,009,45235,3781,3750,43,3793,75
2021-10-11,Colusa,011,21464,2457,2427,586,3013,18
2021-10-11,Contra Costa,013,1133247,97421,96832,2081,98913,960
2021-10-11,Del Norte,015,27424,3591,3510,48,3558,39
2021-10-11,El Dorado,017,186661,15489,15273,1607,16880,146
2021-10-11,Fresno,019,978130,133607,131703,12151,143854,2036
2021-10-11,Glenn,021,27897,3369,3308,977,4285,26
2021-10-11,Humboldt,023,135768,8665,8571,474,9045,101
2021-10-11,Imperial,025,180216,32512,32207,3132,35339,762
2021-10-11,Inyo,027,18085,1957,1862,39,1901,39
2021-10-11,Kern,029,883053,122438,120684,20111,140795,1575
2021-10-11,Kings,031,150075,30777,30180,1801,31981,309
2021-10-11,Lake,033,64148,6460,6361,129,6490,97
2021-10-11,Lassen,035,31185,6633,6499,316,6815,25
2021-10-11,Los Angeles,037,10098052,1416937,1406826,53619,1460445,26346
2021-10-11,Madera,039,155013,21934,21555,1898,23453,272
2021-10-11,Marin,041,260295,17237,17121,430,17551,242
2021-10-11,Mariposa,043,17540,1124,1083,39,1122,5
2021-10-11,Mendocino,045,87422,7167,7064,434,7498,82
2021-10-11,Merced,047,269075,40305,40064,1691,41755,566
2021-10-11,Modoc,049,8938,502,482,177,659,5
2021-10-11,Mono,051,14174,1637,1604,20,1624,3
2021-10-11,Monterey,053,433212,48150,47241,2755,49996,580
2021-10-11,Napa,055,140530,12738,12654,101,12755,96
2021-10-11,Nevada,057,99092,8791,8716,306,9022,90
2021-10-11,Orange,059,3164182,302279,299941,14540,314481,5499
2021-10-11,Placer,061,380077,35629,35173,3452,38625,404
2021-10-11,Plumas,063,18699,1567,1469,28,1497,6
2021-10-11,Riverside,065,2383286,355753,351444,16233,367677,4973
2021-10-11,Sacramento,067,1510023,153695,152681,4207,156888,2169
2021-10-11,San Benito,069,59416,7205,7184,159,7343,71
2021-10-11,San Bernardino,071,2135413,346885,344594,10860,355454,5549
2021-10-11,San Diego,073,3302833,364276,361712,21358,383070,4124
2021-10-11,San Francisco,075,870044,51840,51275,2248,53523,643
2021-10-11,San Joaquin,077,732212,97118,96152,5282,101434,1681
2021-10-11,San Luis Obispo,079,281455,28784,28355,1176,29531,327
2021-10-11,San Mateo,081,765935,53176,52298,821,53119,569
2021-10-11,Santa Barbara,083,443738,43402,43018,1525,44543,515
2021-10-11,Santa Clara,085,1922200,144058,142836,1225,144061,1882
2021-10-11,Santa Cruz,087,273765,19944,19745,993,20738,217
2021-10-11,Shasta,089,179085,20121,19662,3356,23018,295
2021-10-11,Sierra,091,2930,166,147,17,164,0
2021-10-11,Siskiyou,093,43540,3257,3159,1214,4373,42
2021-10-11,Solano,095,438530,45129,44474,1199,45673,329
2021-10-11,Sonoma,097,501317,40322,40067,506,40573,390
2021-10-11,Stanislaus,099,539301,75462,75478,8547,84025,1118
2021-10-11,Sutter,101,95872,13466,13427,301,13728,165
2021-10-11,Tehama,103,63373,7955,7795,1350,9145,102
2021-10-11,Trinity,105,12862,809,675,207,882,11
2021-10-11,Tulare,107,460477,65464,64094,13898,77992,942
2021-10-11,Tuolumne,109,53932,6670,6602,79,6681,89
2021-10-11,Ventura,111,848112,96591,95876,4237,100113,1160
2021-10-11,Yolo,113,214977,19155,18977,1040,20017,247
2021-10-11,Yuba,115,75493,9762,9657,249,9906,69
2021-10-10,Alameda,001,1643700,117306,116679,2719,119398,1358
2021-10-10,Alpine,003,1148,100,102,0,102,0
2021-10-10,Amador,005,37829,5330,5278,58,5336,62
2021-10-10,Butte,007,227075,19837,19430,3540,22970,253
2021-10-10,Calaveras,009,45235,3769,3747,43,3790,75
2021-10-10,Colusa,011,21464,2456,2425,585,3010,18
2021-10-10,Contra Costa,013,1133247,97322,96760,2075,98835,960
2021-10-10,Del Norte,015,27424,3587,3507,48,3555,39
2021-10-10,El Dorado,017,186661,15459,15250,1601,16851,146
2021-10-10,Fresno,019,978130,133277,131434,12121,143555,2035
2021-10-10,Glenn,021,27897,3365,3297,975,4272,26
2021-10-10,Humboldt,023,135768,8643,8554,470,9024,101
2021-10-10,Imperial,025,180216,32438,32167,3131,35298,762
2021-10-10,Inyo,027,18085,1936,1857,39,1896,39
2021-10-10,Kern,029,883053,122112,120552,20007,140559,1573
2021-10-10,Kings,031,150075,30688,30122,1791,31913,308
2021-10-10,Lake,033,64148,6444,6349,128,6477,97
2021-10-10,Lassen,035,31185,6613,6495,315,6810,26
2021-10-10,Los Angeles,037,10098052,1415749,1406034,53544,1459578,26338
2021-10-10,Madera,039,155013,21888,21486,1889,23375,272
2021-10-10,Marin,041,260295,17220,17112,430,17542,242
2021-10-10,Mariposa,043,17540,1121,1074,39,1113,5
2021-10-10,Mendocino,045,87422,7152,7060,426,7486,81
2021-10-10,Merced,047,269075,40220,40036,1673,41709,566
2021-10-10,Modoc,049,8938,502,482,177,659,5
2021-10-10,Mono,051,14174,1636,1596,20,1616,3
2021-10-10,Monterey,053,433212,48120,47228,2754,49982,580
2021-10-10,Napa,055,140530,12715,12641,101,12742,96
2021-10-10,Nevada,057,99092,8779,8689,306,8995,90
2021-10-10,Orange,059,3164182,302017,299787,14512,314299,5499
2021-10-10,Placer,061,380077,35536,35128,3440,38568,404
2021-10-10,Plumas,063,18699,1551,1468,26,1494,6
2021-10-10,Riverside,065,2383286,355380,351248,16214,367462,4973
2021-10-10,Sacramento,067,1510023,153431,152405,4190,156595,2178
2021-10-10,San Benito,069,59416,7200,7180,158,7338,71
2021-10-10,San Bernardino,071,2135413,346579,344423,10852,355275,5551
2021-10-10,San Diego,073,3302833,363750,361038,21311,382349,4113
2021-10-10,San Francisco,075,870044,51793,51216,2245,53461,643
2021-10-10,San Joaquin,077,732212,96947,96084,5265,101349,1681
2021-10-10,San Luis Obispo,079,281455,28740,28343,1176,29519,326
2021-10-10,San Mateo,081,765935,53134,52273,820,53093,569
2021-10-10,Santa Barbara,083,443738,43355,42987,1524,44511,515
2021-10-10,Santa Clara,085,1922200,143893,142768,1218,143986,1881
2021-10-10,Santa Cruz,087,273765,19924,19727,993,20720,217
2021-10-10,Shasta,089,179085,20033,19635,3347,22982,296
2021-10-10,Sierra,091,2930,164,147,17,164,0
2021-10-10,Siskiyou,093,43540,3243,3155,1207,4362,42
2021-10-10,Solano,095,438530,45073,44431,1199,45630,329
2021-10-10,Sonoma,097,501317,40270,40027,506,40533,390
2021-10-10,Stanislaus,099,539301,75285,75403,8533,83936,1118
2021-10-10,Sutter,101,95872,13442,13412,296,13708,165
2021-10-10,Tehama,103,63373,7917,7764,1341,9105,102
2021-10-10,Trinity,105,12862,808,669,206,875,11
2021-10-10,Tulare,107,460477,65292,63930,13847,77777,940
2021-10-10,Tuolumne,109,53932,6646,6580,78,6658,89
2021-10-10,Ventura,111,848112,96502,95829,4237,100066,1160
2021-10-10,Yolo,113,214977,19123,18952,1035,19987,247
2021-10-10,Yuba,115,75493,9746,9641,244,9885,69
2021-10-09,Alameda,001,1643700,117207,116253,2717,118970,1356
2021-10-09,Alpine,003,1148,99,102,0,102,0
2021-10-09,Amador,005,37829,5328,5237,57,5294,62
2021-10-09,Butte,007,227075,19806,19277,3537,22814,250
2021-10-09,Calaveras,009,45235,3765,3716,43,3759,75
2021-10-09,Colusa,011,21464,2452,2419,584,3003,18
2021-10-09,Contra Costa,013,1133247,97251,96378,2069,98447,958
2021-10-09,Del Norte,015,27424,3586,3495,48,3543,39
2021-10-09,El Dorado,017,186661,15441,15153,1598,16751,144
2021-10-09,Fresno,019,978130,133144,130508,12102,142610,2018
2021-10-09,Glenn,021,27897,3361,3277,973,4250,26
2021-10-09,Humboldt,023,135768,8629,8448,468,8916,97
2021-10-09,Imperial,025,180216,32404,31989,3129,35118,760
2021-10-09,Inyo,027,18085,1927,1808,39,1847,39
2021-10-09,Kern,029,883053,121973,119795,19980,139775,1559
2021-10-09,Kings,031,150075,30639,29894,1789,31683,308
2021-10-09,Lake,033,64148,6425,6283,127,6410,97
2021-10-09,Lassen,035,31185,6608,6442,314,6756,25
2021-10-09,Los Angeles,037,10098052,1415160,1402810,53505,1456315,26280
2021-10-09,Madera,039,155013,21855,21313,1875,23188,271
2021-10-09,Marin,041,260295,17215,17049,428,17477,242
2021-10-09,Mariposa,043,17540,1114,1042,38,1080,5
2021-10-09,Mendocino,045,87422,7145,7011,425,7436,82
2021-10-09,Merced,047,269075,40178,39784,1673,41457,565
2021-10-09,Modoc,049,8938,500,477,176,653,5
2021-10-09,Mono,051,14174,1633,1577,20,1597,3
2021-10-09,Monterey,053,433212,48108,47168,2751,49919,577
2021-10-09,Napa,055,140530,12711,12586,101,12687,96
2021-10-09,Nevada,057,99092,8768,8613,305,8918,90
2021-10-09,Orange,059,3164182,301836,299089,14493,313582,5457
2021-10-09,Placer,061,380077,35498,34877,3433,38310,393
2021-10-09,Plumas,063,18699,1540,1418,26,1444,6
2021-10-09,Riverside,065,2383286,355129,350082,16197,366279,4965
2021-10-09,Sacramento,067,1510023,153221,151566,4177,155743,2160
2021-10-09,San Benito,069,59416,7192,7123,158,7281,71
2021-10-09,San Bernardino,071,2135413,346395,343452,10848,354300,5556
2021-10-09,San Diego,073,3302833,363435,359909,21306,381215,4111
2021-10-09,San Francisco,075,870044,51745,50960,2238,53198,643
2021-10-09,San Joaquin,077,732212,96881,95606,5260,100866,1669
2021-10-09,San Luis Obispo,079,281455,28723,28197,1174,29371,324
2021-10-09,San Mateo,081,765935,53103,52121,819,52940,569
2021-10-09,Santa Barbara,083,443738,43328,42735,1524,44259,514
2021-10-09,Santa Clara,085,1922200,143770,142298,1212,143510,1873
2021-10-09,Santa Cruz,087,273765,19914,19635,992,20627,217
2021-10-09,Shasta,089,179085,19983,19437,3342,22779,290
2021-10-09,Sierra,091,2930,161,141,17,158,0
2021-10-09,Siskiyou,093,43540,3242,3124,1206,4330,42
2021-10-09,Solano,095,438530,45056,44265,1198,45463,329
2021-10-09,Sonoma,097,501317,40226,39848,506,40354,387
2021-10-09,Stanislaus,099,539301,75195,74899,8523,83422,1114
2021-10-09,Sutter,101,95872,13433,13314,294,13608,165
2021-10-09,Tehama,103,63373,7906,7670,1336,9006,99
2021-10-09,Trinity,105,12862,807,660,206,866,11
2021-10-09,Tulare,107,460477,65184,63398,13825,77223,932
2021-10-09,Tuolumne,109,53932,6627,6521,78,6599,89
2021-10-09,Ventura,111,848112,96448,95542,4234,99776,1158
2021-10-09,Yolo,113,214977,19102,18850,1032,19882,247
2021-10-09,Yuba,115,75493,9734,9551,242,9793,69
2021-10-08,Alameda,001,1643700,117126,116253,2714,118967,1356
2021-10-08,Alpine,003,1148,99,102,0,102,0
2021-10-08,Amador,005,37829,5315,5237,57,5294,62
2021-10-08,Butte,007,227075,19777,19277,3533,22810,250
2021-10-08,Calaveras,009,45235,3760,3716,43,3759,75
2021-10-08,Colusa,011,21464,2450,2419,584,3003,18
2021-10-08,Contra Costa,013,1133247,97207,96378,2064,98442,958
2021-10-08,Del Norte,015,27424,3585,3495,48,3543,39
2021-10-08,El Dorado,017,186661,15421,15153,1594,16747,144
2021-10-08,Fresno,019,978130,132947,130508,12080,142588,2018
2021-10-08,Glenn,021,27897,3353,3277,971,4248,26
2021-10-08,Humboldt,023,135768,8618,8448,465,8913,97
2021-10-08,Imperial,025,180216,32374,31989,3125,35114,760
2021-10-08,Inyo,027,18085,1909,1808,39,1847,39
2021-10-08,Kern,029,883053,121836,119795,19938,139733,1559
2021-10-08,Kings,031,150075,30545,29894,1788,31682,308
2021-10-08,Lake,033,64148,6417,6283,127,6410,97
2021-10-08,Lassen,035,31185,6594,6442,311,6753,25
2021-10-08,Los Angeles,037,10098052,1414499,1402810,53468,1456278,26280
2021-10-08,Madera,039,155013,21796,21313,1868,23181,271
2021-10-08,Marin,041,260295,17204,17049,427,17476,242
2021-10-08,Mariposa,043,17540,1107,1042,36,1078,5
2021-10-08,Mendocino,045,87422,7132,7011,425,7436,82
2021-10-08,Merced,047,269075,40146,39784,1670,41454,565
2021-10-08,Modoc,049,8938,498,477,176,653,5
2021-10-08,Mono,051,14174,1630,1577,20,1597,3
2021-10-08,Monterey,053,433212,48081,47168,2749,49917,577
2021-10-08,Napa,055,140530,12695,12586,101,12687,96
2021-10-08,Nevada,057,99092,8755,8613,305,8918,90
2021-10-08,Orange,059,3164182,301689,299089,14473,313562,5457
2021-10-08,Placer,061,380077,35460,34877,3425,38302,393
2021-10-08,Plumas,063,18699,1528,1418,26,1444,6
2021-10-08,Riverside,065,2383286,354860,350082,16186,366268,4965
2021-10-08,Sacramento,067,1510023,153056,151566,4163,155729,2160
2021-10-08,San Benito,069,59416,7188,7123,156,7279,71
2021-10-08,San Bernardino,071,2135413,346187,343452,10840,354292,5556
2021-10-08,San Diego,073,3302833,363100,359909,21288,381197,4111
2021-10-08,San Francisco,075,870044,51698,50960,2229,53189,643
2021-10-08,San Joaquin,077,732212,96813,95606,5254,100860,1669
2021-10-08,San Luis Obispo,079,281455,28696,28197,1173,29370,324
2021-10-08,San Mateo,081,765935,53075,52121,819,52940,569
2021-10-08,Santa Barbara,083,443738,43293,42735,1523,44258,514
2021-10-08,Santa Clara,085,1922200,143657,142298,1207,143505,1873
2021-10-08,Santa Cruz,087,273765,19899,19635,992,20627,217
2021-10-08,Shasta,089,179085,19941,19437,3336,22773,290
2021-10-08,Sierra,091,2930,159,141,15,156,0
2021-10-08,Siskiyou,093,43540,3234,3124,1205,4329,42
2021-10-08,Solano,095,438530,45017,44265,1197,45462,329
2021-10-08,Sonoma,097,501317,40190,39848,506,40354,387
2021-10-08,Stanislaus,099,539301,75126,74899,8514,83413,1114
2021-10-08,Sutter,101,95872,13419,13314,292,13606,165
2021-10-08,Tehama,103,63373,7889,7670,1334,9004,99
2021-10-08,Trinity,105,12862,806,660,206,866,11
2021-10-08,Tulare,107,460477,65066,63398,13793,77191,932
2021-10-08,Tuolumne,109,53932,6604,6521,78,6599,89
2021-10-08,Ventura,111,848112,96397,95542,4228,99770,1158
2021-10-08,Yolo,113,214977,19089,18850,1028,19878,247
2021-10-08,Yuba,115,75493,9714,9551,241,9792,69
2021-10-07,Alameda,001,1643700,117005,116253,2713,118966,1356
2021-10-07,Alpine,003,1148,99,102,0,102,0
2021-10-07,Amador,005,37829,5308,5237,57,5294,62
2021-10-07,Butte,007,227075,19728,19277,3522,22799,250
2021-10-07,Calaveras,009,45235,3748,3716,43,3759,75
2021-10-07,Colusa,011,21464,2447,2419,578,2997,18
2021-10-07,Contra Costa,013,1133247,97084,96378,2060,98438,958
2021-10-07,Del Norte,015,27424,3582,3495,48,3543,39
2021-10-07,El Dorado,017,186661,15385,15153,1590,16743,144
2021-10-07,Fresno,019,978130,132672,130508,12056,142564,2018
2021-10-07,Glenn,021,27897,3346,3277,969,4246,26
2021-10-07,Humboldt,023,135768,8592,8448,462,8910,97
2021-10-07,Imperial,025,180216,32302,31989,3112,35101,760
2021-10-07,Inyo,027,18085,1890,1808,39,1847,39
2021-10-07,Kern,029,883053,121605,119795,19872,139667,1559
2021-10-07,Kings,031,150075,30480,29894,1782,31676,308
2021-10-07,Lake,033,64148,6406,6283,127,6410,97
2021-10-07,Lassen,035,31185,6576,6442,309,6751,25
2021-10-07,Los Angeles,037,10098052,1413541,1402810,53423,1456233,26280
2021-10-07,Madera,039,155013,21723,21313,1854,23167,271
2021-10-07,Marin,041,260295,17186,17049,427,17476,242
2021-10-07,Mariposa,043,17540,1099,1042,36,1078,5
2021-10-07,Mendocino,045,87422,7122,7011,421,7432,82
2021-10-07,Merced,047,269075,40079,39784,1653,41437,565
2021-10-07,Modoc,049,8938,495,477,175,652,5
2021-10-07,Mono,051,14174,1621,1577,20,1597,3
2021-10-07,Monterey,053,433212,48056,47168,2740,49908,577
2021-10-07,Napa,055,140530,12680,12586,101,12687,96
2021-10-07,Nevada,057,99092,8727,8613,305,8918,90
2021-10-07,Orange,059,3164182,301463,299089,14459,313548,5457
2021-10-07,Placer,061,380077,35398,34877,3418,38295,393
2021-10-07,Plumas,063,18699,1511,1418,26,1444,6
2021-10-07,Riverside,065,2383286,354527,350082,16174,366256,4965
2021-10-07,Sacramento,067,1510023,152774,151566,4136,155702,2160
2021-10-07,San Benito,069,59416,7172,7123,154,7277,71
2021-10-07,San Bernardino,071,2135413,345916,343452,10833,354285,5556
2021-10-07,San Diego,073,3302833,362688,359909,21267,381176,4111
2021-10-07,San Francisco,075,870044,51628,50960,2226,53186,643
2021-10-07,San Joaquin,077,732212,96659,95606,5246,100852,1669
2021-10-07,San Luis Obispo,079,281455,28645,28197,1171,29368,324
2021-10-07,San Mateo,081,765935,53035,52121,817,52938,569
2021-10-07,Santa Barbara,083,443738,43225,42735,1517,44252,514
2021-10-07,Santa Clara,085,1922200,143506,142298,1201,143499,1873
2021-10-07,Santa Cruz,087,273765,19879,19635,991,20626,217
2021-10-07,Shasta,089,179085,19852,19437,3321,22758,290
2021-10-07,Sierra,091,2930,158,141,15,156,0
2021-10-07,Siskiyou,093,43540,3230,3124,1200,4324,42
2021-10-07,Solano,095,438530,44972,44265,1193,45458,329
2021-10-07,Sonoma,097,501317,40153,39848,504,40352,387
2021-10-07,Stanislaus,099,539301,74963,74899,8489,83388,1114
2021-10-07,Sutter,101,95872,13397,13314,289,13603,165
2021-10-07,Tehama,103,63373,7856,7670,1328,8998,99
2021-10-07,Trinity,105,12862,804,660,206,866,11
2021-10-07,Tulare,107,460477,64900,63398,13755,77153,932
2021-10-07,Tuolumne,109,53932,6582,6521,78,6599,89
2021-10-07,Ventura,111,848112,96324,95542,4225,99767,1158
2021-10-07,Yolo,113,214977,19056,18850,1023,19873,247
2021-10-07,Yuba,115,75493,9688,9551,234,9785,69
2021-10-06,Alameda,001,1643700,116869,116058,2707,118765,1353
2021-10-06,Alpine,003,1148,99,102,0,102,0
2021-10-06,Amador,005,37829,5305,5205,57,5262,62
2021-10-06,Butte,007,227075,19665,19208,3515,22723,247
2021-10-06,Calaveras,009,45235,3739,3669,43,3712,75
2021-10-06,Colusa,011,21464,2445,2414,571,2985,18
2021-10-06,Contra Costa,013,1133247,96957,96184,2056,98240,953
2021-10-06,Del Norte,015,27424,3579,3490,45,3535,39
2021-10-06,El Dorado,017,186661,15360,15078,1587,16665,140
2021-10-06,Fresno,019,978130,132382,130074,12031,142105,2008
2021-10-06,Glenn,021,27897,3337,3270,967,4237,26
2021-10-06,Humboldt,023,135768,8577,8416,455,8871,94
2021-10-06,Imperial,025,180216,32249,31930,3101,35031,760
2021-10-06,Inyo,027,18085,1875,1806,39,1845,39
2021-10-06,Kern,029,883053,121348,119491,19779,139270,1552
2021-10-06,Kings,031,150075,30414,29785,1774,31559,308
2021-10-06,Lake,033,64148,6392,6271,127,6398,97
2021-10-06,Lassen,035,31185,6559,6429,308,6737,25
2021-10-06,Los Angeles,037,10098052,1412582,1401675,53374,1455049,26252
2021-10-06,Madera,039,155013,21668,21230,1844,23074,269
2021-10-06,Marin,041,260295,17177,17042,424,17466,242
2021-10-06,Mariposa,043,17540,1092,1036,36,1072,5
2021-10-06,Mendocino,045,87422,7113,6986,419,7405,81
2021-10-06,Merced,047,269075,40004,39666,1641,41307,563
2021-10-06,Modoc,049,8938,495,477,173,650,5
2021-10-06,Mono,051,14174,1609,1568,20,1588,3
2021-10-06,Monterey,053,433212,48023,47136,2735,49871,577
2021-10-06,Napa,055,140530,12656,12552,100,12652,96
2021-10-06,Nevada,057,99092,8711,8582,304,8886,90
2021-10-06,Orange,059,3164182,301225,298785,14446,313231,5448
2021-10-06,Placer,061,380077,35347,34764,3412,38176,390
2021-10-06,Plumas,063,18699,1488,1383,26,1409,6
2021-10-06,Riverside,065,2383286,354171,349645,16153,365798,4953
2021-10-06,Sacramento,067,1510023,152521,151164,4105,155269,2141
2021-10-06,San Benito,069,59416,7157,7108,154,7262,69
2021-10-06,San Bernardino,071,2135413,345623,343022,10826,353848,5551
2021-10-06,San Diego,073,3302833,362189,359564,21239,380803,4104
2021-10-06,San Francisco,075,870044,51565,50894,2223,53117,641
2021-10-06,San Joaquin,077,732212,96525,95418,5234,100652,1658
2021-10-06,San Luis Obispo,079,281455,28595,28170,1165,29335,323
2021-10-06,San Mateo,081,765935,52985,52056,812,52868,569
2021-10-06,Santa Barbara,083,443738,43142,42687,1515,44202,513
2021-10-06,Santa Clara,085,1922200,143355,142124,1196,143320,1872
2021-10-06,Santa Cruz,087,273765,19850,19604,989,20593,217
2021-10-06,Shasta,089,179085,19778,19325,3308,22633,287
2021-10-06,Sierra,091,2930,156,138,15,153,0
2021-10-06,Siskiyou,093,43540,3220,3116,1193,4309,42
2021-10-06,Solano,095,438530,44938,44185,1192,45377,328
2021-10-06,Sonoma,097,501317,40103,39787,504,40291,383
2021-10-06,Stanislaus,099,539301,74821,74699,8476,83175,1114
2021-10-06,Sutter,101,95872,13376,13284,287,13571,164
2021-10-06,Tehama,103,63373,7820,7629,1321,8950,99
2021-10-06,Trinity,105,12862,801,656,206,862,11
2021-10-06,Tulare,107,460477,64720,63198,13695,76893,926
2021-10-06,Tuolumne,109,53932,6557,6486,78,6564,89
2021-10-06,Ventura,111,848112,96233,95449,4217,99666,1158
2021-10-06,Yolo,113,214977,19024,18815,1018,19833,247
2021-10-06,Yuba,115,75493,9664,9520,233,9753,69
2021-10-05,Alameda,001,1643700,116722,115968,2702,118670,1350
2021-10-05,Alpine,003,1148,99,102,0,102,0
2021-10-05,Amador,005,37829,5284,5194,56,5250,61
2021-10-05,Butte,007,227075,19617,19137,3505,22642,246
2021-10-05,Calaveras,009,45235,3723,3657,43,3700,73
2021-10-05,Colusa,011,21464,2438,2414,570,2984,18
2021-10-05,Contra Costa,013,1133247,96841,96108,2050,98158,941
2021-10-05,Del Norte,015,27424,3577,3485,44,3529,39
2021-10-05,El Dorado,017,186661,15321,15052,1584,16636,140
2021-10-05,Fresno,019,978130,132042,129957,11994,141951,1987
2021-10-05,Glenn,021,27897,3327,3270,964,4234,26
2021-10-05,Humboldt,023,135768,8546,8398,451,8849,94
2021-10-05,Imperial,025,180216,32201,31909,3096,35005,759
2021-10-05,Inyo,027,18085,1858,1800,39,1839,39
2021-10-05,Kern,029,883053,121083,119260,19677,138937,1540
2021-10-05,Kings,031,150075,30339,29749,1768,31517,301
2021-10-05,Lake,033,64148,6371,6264,126,6390,97
2021-10-05,Lassen,035,31185,6540,6417,306,6723,25
2021-10-05,Los Angeles,037,10098052,1411438,1400300,53321,1453621,26223
2021-10-05,Madera,039,155013,21610,21183,1831,23014,269
2021-10-05,Marin,041,260295,17165,17024,424,17448,242
2021-10-05,Mariposa,043,17540,1073,1033,33,1066,5
2021-10-05,Mendocino,045,87422,7097,6972,412,7384,79
2021-10-05,Merced,047,269075,39938,39608,1633,41241,562
2021-10-05,Modoc,049,8938,491,475,172,647,5
2021-10-05,Mono,051,14174,1601,1565,20,1585,3
2021-10-05,Monterey,053,433212,48005,47087,2725,49812,573
2021-10-05,Napa,055,140530,12632,12533,100,12633,96
2021-10-05,Nevada,057,99092,8681,8576,304,8880,90
2021-10-05,Orange,059,3164182,300948,298589,14414,313003,5441
2021-10-05,Placer,061,380077,35267,34728,3405,38133,382
2021-10-05,Plumas,063,18699,1463,1357,26,1383,6
2021-10-05,Riverside,065,2383286,353811,349365,16138,365503,4942
2021-10-05,Sacramento,067,1510023,152248,151111,4076,155187,2126
2021-10-05,San Benito,069,59416,7139,7103,152,7255,69
2021-10-05,San Bernardino,071,2135413,345294,342711,10819,353530,5557
2021-10-05,San Diego,073,3302833,361605,359194,21212,380406,4092
2021-10-05,San Francisco,075,870044,51468,50826,2220,53046,641
2021-10-05,San Joaquin,077,732212,96372,95276,5207,100483,1651
2021-10-05,San Luis Obispo,079,281455,28551,28113,1163,29276,324
2021-10-05,San Mateo,081,765935,52939,52008,812,52820,569
2021-10-05,Santa Barbara,083,443738,43064,42595,1511,44106,511
2021-10-05,Santa Clara,085,1922200,143197,141971,1189,143160,1873
2021-10-05,Santa Cruz,087,273765,19808,19582,989,20571,216
2021-10-05,Shasta,089,179085,19704,19285,3295,22580,286
2021-10-05,Sierra,091,2930,152,136,15,151,0
2021-10-05,Siskiyou,093,43540,3206,3107,1193,4300,42
2021-10-05,Solano,095,438530,44867,44149,1190,45339,325
2021-10-05,Sonoma,097,501317,40048,39756,499,40255,383
2021-10-05,Stanislaus,099,539301,74659,74599,8459,83058,1114
2021-10-05,Sutter,101,95872,13348,13270,286,13556,164
2021-10-05,Tehama,103,63373,7790,7607,1312,8919,98
2021-10-05,Trinity,105,12862,798,655,206,861,11
2021-10-05,Tulare,107,460477,64513,63093,13641,76734,920
2021-10-05,Tuolumne,109,53932,6542,6473,77,6550,89
2021-10-05,Ventura,111,848112,96127,95351,4216,99567,1155
2021-10-05,Yolo,113,214977,18988,18782,1012,19794,245
2021-10-05,Yuba,115,75493,9632,9504,230,9734,69
2021-10-04,Alameda,001,1643700,116558,115845,2699,118544,1347
2021-10-04,Alpine,003,1148,99,102,0,102,0
2021-10-04,Amador,005,37829,5274,5163,55,5218,61
2021-10-04,Butte,007,227075,19540,19081,3493,22574,245
2021-10-04,Calaveras,009,45235,3714,3641,43,3684,73
2021-10-04,Colusa,011,21464,2437,2414,568,2982,18
2021-10-04,Contra Costa,013,1133247,96700,95958,2045,98003,937
2021-10-04,Del Norte,015,27424,3575,3485,40,3525,39
2021-10-04,El Dorado,017,186661,15274,15031,1577,16608,138
2021-10-04,Fresno,019,978130,131732,129665,11964,141629,1978
2021-10-04,Glenn,021,27897,3320,3270,961,4231,26
2021-10-04,Humboldt,023,135768,8514,8355,443,8798,94
2021-10-04,Imperial,025,180216,32152,31866,3089,34955,757
2021-10-04,Inyo,027,18085,1846,1792,36,1828,39
2021-10-04,Kern,029,883053,120792,118984,19556,138540,1531
2021-10-04,Kings,031,150075,30246,29702,1765,31467,303
2021-10-04,Lake,033,64148,6358,6248,126,6374,97
2021-10-04,Lassen,035,31185,6523,6405,306,6711,25
2021-10-04,Los Angeles,037,10098052,1410323,1399604,53261,1452865,26186
2021-10-04,Madera,039,155013,21546,21126,1819,22945,266
2021-10-04,Marin,041,260295,17149,17008,423,17431,242
2021-10-04,Mariposa,043,17540,1061,1024,33,1057,5
2021-10-04,Mendocino,045,87422,7079,6947,409,7356,79
2021-10-04,Merced,047,269075,39823,39565,1617,41182,558
2021-10-04,Modoc,049,8938,488,473,172,645,5
2021-10-04,Mono,051,14174,1594,1561,20,1581,3
2021-10-04,Monterey,053,433212,47984,47058,2718,49776,571
2021-10-04,Napa,055,140530,12608,12506,100,12606,96
2021-10-04,Nevada,057,99092,8661,8563,304,8867,90
2021-10-04,Orange,059,3164182,300652,298165,14382,312547,5438
2021-10-04,Placer,061,380077,35184,34630,3377,38007,379
2021-10-04,Plumas,063,18699,1441,1329,26,1355,6
2021-10-04,Riverside,065,2383286,353431,348828,16128,364956,4923
2021-10-04,Sacramento,067,1510023,151924,150887,4049,154936,2115
2021-10-04,San Benito,069,59416,7126,7099,152,7251,69
2021-10-04,San Bernardino,071,2135413,344934,342418,10807,353225,5551
2021-10-04,San Diego,073,3302833,361026,358525,21181,379706,4090
2021-10-04,San Francisco,075,870044,51373,50798,2216,53014,638
2021-10-04,San Joaquin,077,732212,96175,95198,5187,100385,1649
2021-10-04,San Luis Obispo,079,281455,28506,28090,1157,29247,323
2021-10-04,San Mateo,081,765935,52879,51958,811,52769,569
2021-10-04,Santa Barbara,083,443738,42979,42585,1510,44095,511
2021-10-04,Santa Clara,085,1922200,143053,141840,1183,143023,1869
2021-10-04,Santa Cruz,087,273765,19779,19559,988,20547,216
2021-10-04,Shasta,089,179085,19597,19170,3281,22451,279
2021-10-04,Sierra,091,2930,145,136,14,150,0
2021-10-04,Siskiyou,093,43540,3197,3103,1178,4281,42
2021-10-04,Solano,095,438530,44808,44092,1186,45278,322
2021-10-04,Sonoma,097,501317,39982,39720,499,40219,381
2021-10-04,Stanislaus,099,539301,74507,74444,8440,82884,1106
2021-10-04,Sutter,101,95872,13319,13261,285,13546,164
2021-10-04,Tehama,103,63373,7749,7585,1306,8891,95
2021-10-04,Trinity,105,12862,797,649,205,854,11
2021-10-04,Tulare,107,460477,64322,62957,13573,76530,920
2021-10-04,Tuolumne,109,53932,6516,6442,77,6519,89
2021-10-04,Ventura,111,848112,96035,95170,4210,99380,1153
2021-10-04,Yolo,113,214977,18944,18761,1007,19768,242
2021-10-04,Yuba,115,75493,9593,9481,228,9709,68
2021-10-03,Alameda,001,1643700,116418,115751,2689,118440,1349
2021-10-03,Alpine,003,1148,99,102,0,102,0
2021-10-03,Amador,005,37829,5256,5160,53,5213,61
2021-10-03,Butte,007,227075,19467,19066,3477,22543,245
2021-10-03,Calaveras,009,45235,3697,3632,43,3675,73
2021-10-03,Colusa,011,21464,2436,2413,565,2978,18
2021-10-03,Contra Costa,013,1133247,96568,95890,2038,97928,937
2021-10-03,Del Norte,015,27424,3569,3483,39,3522,39
2021-10-03,El Dorado,017,186661,15216,15014,1570,16584,139
2021-10-03,Fresno,019,978130,131351,129365,11923,141288,1978
2021-10-03,Glenn,021,27897,3313,3266,953,4219,26
2021-10-03,Humboldt,023,135768,8469,8352,439,8791,94
2021-10-03,Imperial,025,180216,32085,31844,3081,34925,757
2021-10-03,Inyo,027,18085,1825,1788,36,1824,39
2021-10-03,Kern,029,883053,120488,118851,19434,138285,1535
2021-10-03,Kings,031,150075,30145,29623,1758,31381,300
2021-10-03,Lake,033,64148,6332,6239,126,6365,97
2021-10-03,Lassen,035,31185,6501,6400,304,6704,25
2021-10-03,Los Angeles,037,10098052,1409053,1398790,53206,1451996,26179
2021-10-03,Madera,039,155013,21474,21066,1809,22875,266
2021-10-03,Marin,041,260295,17126,16995,418,17413,242
2021-10-03,Mariposa,043,17540,1054,1011,33,1044,5
2021-10-03,Mendocino,045,87422,7059,6939,400,7339,79
2021-10-03,Merced,047,269075,39716,39516,1597,41113,558
2021-10-03,Modoc,049,8938,487,472,171,643,5
2021-10-03,Mono,051,14174,1590,1554,20,1574,3
2021-10-03,Monterey,053,433212,47959,47049,2707,49756,571
2021-10-03,Napa,055,140530,12580,12489,98,12587,96
2021-10-03,Nevada,057,99092,8626,8545,304,8849,90
2021-10-03,Orange,059,3164182,300370,298027,14362,312389,5447
2021-10-03,Placer,061,380077,35045,34596,3360,37956,379
2021-10-03,Plumas,063,18699,1413,1328,26,1354,6
2021-10-03,Riverside,065,2383286,353000,348593,16108,364701,4924
2021-10-03,Sacramento,067,1510023,151634,150664,4021,154685,2120
2021-10-03,San Benito,069,59416,7117,7095,152,7247,69
2021-10-03,San Bernardino,071,2135413,344525,342302,10800,353102,5555
2021-10-03,San Diego,073,3302833,360430,358153,21149,379302,4081
2021-10-03,San Francisco,075,870044,51285,50733,2213,52946,638
2021-10-03,San Joaquin,077,732212,95986,95133,5179,100312,1649
2021-10-03,San Luis Obispo,079,281455,28439,28065,1152,29217,325
2021-10-03,San Mateo,081,765935,52812,51923,810,52733,569
2021-10-03,Santa Barbara,083,443738,42883,42550,1502,44052,511
2021-10-03,Santa Clara,085,1922200,142883,141737,1175,142912,1869
2021-10-03,Santa Cruz,087,273765,19739,19548,986,20534,216
2021-10-03,Shasta,089,179085,19492,19132,3252,22384,279
2021-10-03,Sierra,091,2930,142,136,14,150,0
2021-10-03,Siskiyou,093,43540,3184,3096,1167,4263,42
2021-10-03,Solano,095,438530,44744,44051,1183,45234,322
2021-10-03,Sonoma,097,501317,39916,39679,499,40178,381
2021-10-03,Stanislaus,099,539301,74320,74366,8422,82788,1106
2021-10-03,Sutter,101,95872,13304,13248,281,13529,164
2021-10-03,Tehama,103,63373,7706,7564,1301,8865,94
2021-10-03,Trinity,105,12862,793,647,203,850,11
2021-10-03,Tulare,107,460477,64120,62860,13498,76358,924
2021-10-03,Tuolumne,109,53932,6487,6430,75,6505,89
2021-10-03,Ventura,111,848112,95930,95108,4207,99315,1153
2021-10-03,Yolo,113,214977,18915,18720,1000,19720,242
2021-10-03,Yuba,115,75493,9574,9462,227,9689,68
2021-10-02,Alameda,001,1643700,116311,115185,2685,117870,1343
2021-10-02,Alpine,003,1148,99,102,0,102,0
2021-10-02,Amador,005,37829,5247,5105,53,5158,61
2021-10-02,Butte,007,227075,19436,18911,3470,22381,243
2021-10-02,Calaveras,009,45235,3690,3585,43,3628,72
2021-10-02,Colusa,011,21464,2435,2403,563,2966,18
2021-10-02,Contra Costa,013,1133247,96497,95369,2034,97403,933
2021-10-02,Del Norte,015,27424,3564,3468,39,3507,39
2021-10-02,El Dorado,017,186661,15190,14887,1569,16456,136
2021-10-02,Fresno,019,978130,131180,128450,11910,140360,1964
2021-10-02,Glenn,021,27897,3308,3234,953,4187,26
2021-10-02,Humboldt,023,135768,8450,8244,439,8683,94
2021-10-02,Imperial,025,180216,32050,31674,3078,34752,757
2021-10-02,Inyo,027,18085,1816,1746,36,1782,39
2021-10-02,Kern,029,883053,120355,117962,19352,137314,1524
2021-10-02,Kings,031,150075,30096,29339,1754,31093,301
2021-10-02,Lake,033,64148,6323,6191,126,6317,97
2021-10-02,Lassen,035,31185,6496,6360,304,6664,25
2021-10-02,Los Angeles,037,10098052,1408446,1395070,53169,1448239,26126
2021-10-02,Madera,039,155013,21449,20931,1800,22731,266
2021-10-02,Marin,041,260295,17121,16936,415,17351,242
2021-10-02,Mariposa,043,17540,1052,967,33,1000,5
2021-10-02,Mendocino,045,87422,7049,6869,400,7269,78
2021-10-02,Merced,047,269075,39689,39196,1593,40789,552
2021-10-02,Modoc,049,8938,485,468,171,639,5
2021-10-02,Mono,051,14174,1588,1540,20,1560,3
2021-10-02,Monterey,053,433212,47904,46964,2706,49670,571
2021-10-02,Napa,055,140530,12569,12433,98,12531,96
2021-10-02,Nevada,057,99092,8615,8474,303,8777,87
2021-10-02,Orange,059,3164182,300205,297307,14342,311649,5435
2021-10-02,Placer,061,380077,34979,34377,3351,37728,381
2021-10-02,Plumas,063,18699,1402,1298,26,1324,6
2021-10-02,Riverside,065,2383286,352759,347227,16097,363324,4895
2021-10-02,Sacramento,067,1510023,151460,149897,4013,153910,2099
2021-10-02,San Benito,069,59416,7110,7055,152,7207,69
2021-10-02,San Bernardino,071,2135413,344342,341212,10750,351962,5540
2021-10-02,San Diego,073,3302833,360108,356454,21127,377581,4078
2021-10-02,San Francisco,075,870044,51236,50393,2208,52601,634
2021-10-02,San Joaquin,077,732212,95921,94599,5173,99772,1646
2021-10-02,San Luis Obispo,079,281455,28415,27915,1152,29067,323
2021-10-02,San Mateo,081,765935,52771,51767,806,52573,573
2021-10-02,Santa Barbara,083,443738,42843,42423,1502,43925,508
2021-10-02,Santa Clara,085,1922200,142769,141231,1171,142402,1862
2021-10-02,Santa Cruz,087,273765,19722,19461,985,20446,214
2021-10-02,Shasta,089,179085,19446,18912,3246,22158,270
2021-10-02,Sierra,091,2930,141,131,14,145,0
2021-10-02,Siskiyou,093,43540,3183,3053,1164,4217,42
2021-10-02,Solano,095,438530,44699,43800,1182,44982,321
2021-10-02,Sonoma,097,501317,39882,39497,498,39995,382
2021-10-02,Stanislaus,099,539301,74234,73859,8409,82268,1099
2021-10-02,Sutter,101,95872,13295,13160,280,13440,160
2021-10-02,Tehama,103,63373,7691,7453,1301,8754,93
2021-10-02,Trinity,105,12862,790,625,203,828,10
2021-10-02,Tulare,107,460477,64046,62247,13471,75718,908
2021-10-02,Tuolumne,109,53932,6473,6369,75,6444,89
2021-10-02,Ventura,111,848112,95858,94854,4202,99056,1148
2021-10-02,Yolo,113,214977,18890,18640,996,19636,242
2021-10-02,Yuba,115,75493,9555,9370,226,9596,66
2021-10-01,Alameda,001,1643700,116234,115185,2679,117864,1343
2021-10-01,Alpine,003,1148,99,102,0,102,0
2021-10-01,Amador,005,37829,5227,5105,53,5158,61
2021-10-01,Butte,007,227075,19395,18911,3464,22375,243
2021-10-01,Calaveras,009,45235,3680,3585,43,3628,72
2021-10-01,Colusa,011,21464,2433,2403,563,2966,18
2021-10-01,Contra Costa,013,1133247,96400,95369,2030,97399,933
2021-10-01,Del Norte,015,27424,3561,3468,38,3506,39
2021-10-01,El Dorado,017,186661,15173,14887,1565,16452,136
2021-10-01,Fresno,019,978130,130992,128450,11900,140350,1964
2021-10-01,Glenn,021,27897,3306,3234,952,4186,26
2021-10-01,Humboldt,023,135768,8433,8244,439,8683,94
2021-10-01,Imperial,025,180216,32032,31674,3069,34743,757
2021-10-01,Inyo,027,18085,1807,1746,36,1782,39
2021-10-01,Kern,029,883053,120202,117962,19294,137256,1524
2021-10-01,Kings,031,150075,30062,29339,1748,31087,301
2021-10-01,Lake,033,64148,6313,6191,126,6317,97
2021-10-01,Lassen,035,31185,6485,6360,303,6663,25
2021-10-01,Los Angeles,037,10098052,1407685,1395070,53124,1448194,26126
2021-10-01,Madera,039,155013,21399,20931,1791,22722,266
2021-10-01,Marin,041,260295,17106,16936,414,17350,242
2021-10-01,Mariposa,043,17540,1045,967,33,1000,5
2021-10-01,Mendocino,045,87422,7037,6869,400,7269,78
2021-10-01,Merced,047,269075,39645,39196,1584,40780,552
2021-10-01,Modoc,049,8938,484,468,171,639,5
2021-10-01,Mono,051,14174,1585,1540,20,1560,3
2021-10-01,Monterey,053,433212,47883,46964,2703,49667,571
2021-10-01,Napa,055,140530,12559,12433,97,12530,96
2021-10-01,Nevada,057,99092,8601,8474,302,8776,87
2021-10-01,Orange,059,3164182,300021,297307,14322,311629,5435
2021-10-01,Placer,061,380077,34945,34377,3347,37724,381
2021-10-01,Plumas,063,18699,1393,1298,26,1324,6
2021-10-01,Riverside,065,2383286,352466,347227,16089,363316,4895
2021-10-01,Sacramento,067,1510023,151307,149897,4002,153899,2099
2021-10-01,San Benito,069,59416,7108,7055,150,7205,69
2021-10-01,San Bernardino,071,2135413,344142,341212,10747,351959,5540
2021-10-01,San Diego,073,3302833,359741,356454,21106,377560,4078
2021-10-01,San Francisco,075,870044,51195,50393,2206,52599,634
2021-10-01,San Joaquin,077,732212,95851,94599,5169,99768,1646
2021-10-01,San Luis Obispo,079,281455,28391,27915,1149,29064,323
2021-10-01,San Mateo,081,765935,52731,51767,803,52570,573
2021-10-01,Santa Barbara,083,443738,42807,42423,1502,43925,508
2021-10-01,Santa Clara,085,1922200,142676,141231,1166,142397,1862
2021-10-01,Santa Cruz,087,273765,19702,19461,984,20445,214
2021-10-01,Shasta,089,179085,19392,18912,3238,22150,270
2021-10-01,Sierra,091,2930,141,131,14,145,0
2021-10-01,Siskiyou,093,43540,3182,3053,1161,4214,42
2021-10-01,Solano,095,438530,44647,43800,1176,44976,321
2021-10-01,Sonoma,097,501317,39850,39497,497,39994,382
2021-10-01,Stanislaus,099,539301,74150,73859,8398,82257,1099
2021-10-01,Sutter,101,95872,13279,13160,278,13438,160
2021-10-01,Tehama,103,63373,7679,7453,1299,8752,93
2021-10-01,Trinity,105,12862,788,625,203,828,10
2021-10-01,Tulare,107,460477,63943,62247,13436,75683,908
2021-10-01,Tuolumne,109,53932,6456,6369,75,6444,89
2021-10-01,Ventura,111,848112,95791,94854,4197,99051,1148
2021-10-01,Yolo,113,214977,18866,18640,992,19632,242
2021-10-01,Yuba,115,75493,9533,9370,226,9596,66
2021-09-30,Alameda,001,1643700,116087,115185,2676,117861,1343
2021-09-30,Alpine,003,1148,99,102,0,102,0
2021-09-30,Amador,005,37829,5215,5105,53,5158,61
2021-09-30,Butte,007,227075,19346,18911,3455,22366,243
2021-09-30,Calaveras,009,45235,3666,3585,43,3628,72
2021-09-30,Colusa,011,21464,2430,2403,562,2965,18
2021-09-30,Contra Costa,013,1133247,96295,95369,2024,97393,933
2021-09-30,Del Norte,015,27424,3557,3468,35,3503,39
2021-09-30,El Dorado,017,186661,15147,14887,1557,16444,136
2021-09-30,Fresno,019,978130,130716,128450,11866,140316,1964
2021-09-30,Glenn,021,27897,3296,3234,950,4184,26
2021-09-30,Humboldt,023,135768,8401,8244,433,8677,94
2021-09-30,Imperial,025,180216,31980,31674,3067,34741,757
2021-09-30,Inyo,027,18085,1797,1746,36,1782,39
2021-09-30,Kern,029,883053,119958,117962,19212,137174,1524
2021-09-30,Kings,031,150075,29972,29339,1744,31083,301
2021-09-30,Lake,033,64148,6295,6191,126,6317,97
2021-09-30,Lassen,035,31185,6471,6360,303,6663,25
2021-09-30,Los Angeles,037,10098052,1406479,1395070,53064,1448134,26126
2021-09-30,Madera,039,155013,21316,20931,1776,22707,266
2021-09-30,Marin,041,260295,17086,16936,413,17349,242
2021-09-30,Mariposa,043,17540,1023,967,33,1000,5
2021-09-30,Mendocino,045,87422,7028,6869,391,7260,78
2021-09-30,Merced,047,269075,39548,39196,1580,40776,552
2021-09-30,Modoc,049,8938,484,468,170,638,5
2021-09-30,Mono,051,14174,1577,1540,20,1560,3
2021-09-30,Monterey,053,433212,47853,46964,2691,49655,571
2021-09-30,Napa,055,140530,12539,12433,97,12530,96
2021-09-30,Nevada,057,99092,8584,8474,301,8775,87
2021-09-30,Orange,059,3164182,299749,297307,14283,311590,5435
2021-09-30,Placer,061,380077,34892,34377,3326,37703,381
2021-09-30,Plumas,063,18699,1375,1298,26,1324,6
2021-09-30,Riverside,065,2383286,352033,347227,16068,363295,4895
2021-09-30,Sacramento,067,1510023,151047,149897,3976,153873,2099
2021-09-30,San Benito,069,59416,7102,7055,150,7205,69
2021-09-30,San Bernardino,071,2135413,343831,341212,10733,351945,5540
2021-09-30,San Diego,073,3302833,359247,356454,21080,377534,4078
2021-09-30,San Francisco,075,870044,51118,50393,2202,52595,634
2021-09-30,San Joaquin,077,732212,95721,94599,5161,99760,1646
2021-09-30,San Luis Obispo,079,281455,28343,27915,1145,29060,323
2021-09-30,San Mateo,081,765935,52682,51767,800,52567,573
2021-09-30,Santa Barbara,083,443738,42750,42423,1501,43924,508
2021-09-30,Santa Clara,085,1922200,142525,141231,1163,142394,1862
2021-09-30,Santa Cruz,087,273765,19662,19461,983,20444,214
2021-09-30,Shasta,089,179085,19330,18912,3223,22135,270
2021-09-30,Sierra,091,2930,140,131,14,145,0
2021-09-30,Siskiyou,093,43540,3174,3053,1156,4209,42
2021-09-30,Solano,095,438530,44593,43800,1173,44973,321
2021-09-30,Sonoma,097,501317,39801,39497,497,39994,382
2021-09-30,Stanislaus,099,539301,73990,73859,8379,82238,1099
2021-09-30,Sutter,101,95872,13258,13160,278,13438,160
2021-09-30,Tehama,103,63373,7642,7453,1287,8740,93
2021-09-30,Trinity,105,12862,784,625,203,828,10
2021-09-30,Tulare,107,460477,63767,62247,13378,75625,908
2021-09-30,Tuolumne,109,53932,6433,6369,75,6444,89
2021-09-30,Ventura,111,848112,95686,94854,4190,99044,1148
2021-09-30,Yolo,113,214977,18827,18640,989,19629,242
2021-09-30,Yuba,115,75493,9510,9370,225,9595,66
2021-09-29,Alameda,001,1643700,115941,114998,2673,117671,1339
2021-09-29,Alpine,003,1148,99,101,0,101,0
2021-09-29,Amador,005,37829,5193,5058,53,5111,61
2021-09-29,Butte,007,227075,19292,18835,3448,22283,242
2021-09-29,Calaveras,009,45235,3649,3553,42,3595,72
2021-09-29,Colusa,011,21464,2428,2401,562,2963,18
2021-09-29,Contra Costa,013,1133247,96181,95213,2016,97229,929
2021-09-29,Del Norte,015,27424,3551,3467,35,3502,39
2021-09-29,El Dorado,017,186661,15113,14834,1550,16384,136
2021-09-29,Fresno,019,978130,130416,128068,11846,139914,1957
2021-09-29,Glenn,021,27897,3291,3213,948,4161,26
2021-09-29,Humboldt,023,135768,8377,8203,432,8635,94
2021-09-29,Imperial,025,180216,31913,31600,3062,34662,757
2021-09-29,Inyo,027,18085,1787,1740,35,1775,39
2021-09-29,Kern,029,883053,119723,117605,19136,136741,1513
2021-09-29,Kings,031,150075,29890,29195,1729,30924,299
2021-09-29,Lake,033,64148,6275,6164,126,6290,97
2021-09-29,Lassen,035,31185,6457,6347,303,6650,25
2021-09-29,Los Angeles,037,10098052,1405267,1393617,52992,1446609,26098
2021-09-29,Madera,039,155013,21271,20818,1760,22578,266
2021-09-29,Marin,041,260295,17068,16921,411,17332,242
2021-09-29,Mariposa,043,17540,1008,963,33,996,5
2021-09-29,Mendocino,045,87422,7016,6821,383,7204,78
2021-09-29,Merced,047,269075,39454,39026,1569,40595,552
2021-09-29,Modoc,049,8938,482,468,170,638,5
2021-09-29,Mono,051,14174,1575,1527,20,1547,3
2021-09-29,Monterey,053,433212,47816,46917,2677,49594,571
2021-09-29,Napa,055,140530,12519,12416,93,12509,96
2021-09-29,Nevada,057,99092,8571,8434,301,8735,87
2021-09-29,Orange,059,3164182,299480,296936,14247,311183,5429
2021-09-29,Placer,061,380077,34829,34271,3303,37574,379
2021-09-29,Plumas,063,18699,1356,1289,26,1315,6
2021-09-29,Riverside,065,2383286,351599,346558,16055,362613,4886
2021-09-29,Sacramento,067,1510023,150796,149686,3966,153652,2099
2021-09-29,San Benito,069,59416,7091,7039,150,7189,69
2021-09-29,San Bernardino,071,2135413,343510,340672,10719,351391,5539
2021-09-29,San Diego,073,3302833,358745,355899,21050,376949,4066
2021-09-29,San Francisco,075,870044,51033,50286,2198,52484,629
2021-09-29,San Joaquin,077,732212,95563,94356,5139,99495,1645
2021-09-29,San Luis Obispo,079,281455,28297,27800,1139,28939,323
2021-09-29,San Mateo,081,765935,52622,51673,798,52471,573
2021-09-29,Santa Barbara,083,443738,42678,42328,1498,43826,507
2021-09-29,Santa Clara,085,1922200,142390,141036,1157,142193,1861
2021-09-29,Santa Cruz,087,273765,19644,19425,982,20407,214
2021-09-29,Shasta,089,179085,19264,18805,3211,22016,271
2021-09-29,Sierra,091,2930,136,130,14,144,0
2021-09-29,Siskiyou,093,43540,3161,3043,1149,4192,42
2021-09-29,Solano,095,438530,44537,43724,1166,44890,321
2021-09-29,Sonoma,097,501317,39740,39426,495,39921,370
2021-09-29,Stanislaus,099,539301,73858,73634,8368,82002,1096
2021-09-29,Sutter,101,95872,13231,13135,275,13410,155
2021-09-29,Tehama,103,63373,7612,7409,1272,8681,88
2021-09-29,Trinity,105,12862,780,616,203,819,10
2021-09-29,Tulare,107,460477,63595,62046,13319,75365,908
2021-09-29,Tuolumne,109,53932,6416,6336,75,6411,89
2021-09-29,Ventura,111,848112,95596,94753,4186,98939,1144
2021-09-29,Yolo,113,214977,18794,18587,984,19571,239
2021-09-29,Yuba,115,75493,9479,9351,221,9572,66
2021-09-28,Alameda,001,1643700,115784,114869,2667,117536,1333
2021-09-28,Alpine,003,1148,99,101,0,101,0
2021-09-28,Amador,005,37829,5171,5049,53,5102,61
2021-09-28,Butte,007,227075,19241,18764,3435,22199,241
2021-09-28,Calaveras,009,45235,3629,3530,42,3572,72
2021-09-28,Colusa,011,21464,2425,2399,560,2959,18
2021-09-28,Contra Costa,013,1133247,96040,95115,2011,97126,929
2021-09-28,Del Norte,015,27424,3548,3462,35,3497,39
2021-09-28,El Dorado,017,186661,15066,14793,1546,16339,133
2021-09-28,Fresno,019,978130,130071,127877,11812,139689,1948
2021-09-28,Glenn,021,27897,3286,3205,947,4152,26
2021-09-28,Humboldt,023,135768,8336,8159,429,8588,91
2021-09-28,Imperial,025,180216,31868,31543,3058,34601,757
2021-09-28,Inyo,027,18085,1773,1708,34,1742,39
2021-09-28,Kern,029,883053,119454,117420,19041,136461,1506
2021-09-28,Kings,031,150075,29788,29141,1721,30862,295
2021-09-28,Lake,033,64148,6260,6155,126,6281,95
2021-09-28,Lassen,035,31185,6451,6340,299,6639,25
2021-09-28,Los Angeles,037,10098052,1403971,1392445,52923,1445368,26068
2021-09-28,Madera,039,155013,21217,20764,1744,22508,266
2021-09-28,Marin,041,260295,17049,16887,409,17296,242
2021-09-28,Mariposa,043,17540,1003,952,33,985,5
2021-09-28,Mendocino,045,87422,6994,6804,381,7185,78
2021-09-28,Merced,047,269075,39366,38953,1556,40509,551
2021-09-28,Modoc,049,8938,481,467,170,637,5
2021-09-28,Mono,051,14174,1565,1527,20,1547,3
2021-09-28,Monterey,053,433212,47779,46859,2668,49527,571
2021-09-28,Napa,055,140530,12502,12388,92,12480,96
2021-09-28,Nevada,057,99092,8548,8409,300,8709,84
2021-09-28,Orange,059,3164182,299228,296596,14219,310815,5421
2021-09-28,Placer,061,380077,34764,34187,3285,37472,370
2021-09-28,Plumas,063,18699,1347,1276,26,1302,6
2021-09-28,Riverside,065,2383286,351140,346096,16034,362130,4874
2021-09-28,Sacramento,067,1510023,150505,149310,3944,153254,2086
2021-09-28,San Benito,069,59416,7074,7028,149,7177,69
2021-09-28,San Bernardino,071,2135413,343162,340342,10702,351044,5540
2021-09-28,San Diego,073,3302833,358185,355373,21018,376391,4054
2021-09-28,San Francisco,075,870044,50932,50234,2197,52431,627
2021-09-28,San Joaquin,077,732212,95409,94194,5126,99320,1639
2021-09-28,San Luis Obispo,079,281455,28263,27755,1134,28889,321
2021-09-28,San Mateo,081,765935,52577,51620,797,52417,571
2021-09-28,Santa Barbara,083,443738,42605,42226,1497,43723,506
2021-09-28,Santa Clara,085,1922200,142229,140886,1148,142034,1858
2021-09-28,Santa Cruz,087,273765,19603,19324,981,20305,214
2021-09-28,Shasta,089,179085,19203,18701,3197,21898,267
2021-09-28,Sierra,091,2930,135,130,13,143,0
2021-09-28,Siskiyou,093,43540,3149,3032,1146,4178,42
2021-09-28,Solano,095,438530,44464,43652,1163,44815,316
2021-09-28,Sonoma,097,501317,39693,39395,494,39889,370
2021-09-28,Stanislaus,099,539301,73686,73528,8356,81884,1094
2021-09-28,Sutter,101,95872,13212,13102,271,13373,155
2021-09-28,Tehama,103,63373,7594,7382,1257,8639,88
2021-09-28,Trinity,105,12862,777,613,203,816,10
2021-09-28,Tulare,107,460477,63435,61916,13260,75176,905
2021-09-28,Tuolumne,109,53932,6390,6308,75,6383,89
2021-09-28,Ventura,111,848112,95470,94632,4183,98815,1143
2021-09-28,Yolo,113,214977,18768,18564,981,19545,239
2021-09-28,Yuba,115,75493,9460,9323,220,9543,66
2021-09-27,Alameda,001,1643700,115591,114731,2658,117389,1327
2021-09-27,Alpine,003,1148,99,101,0,101,0
2021-09-27,Amador,005,37829,5157,5017,53,5070,59
2021-09-27,Butte,007,227075,19184,18687,3419,22106,239
2021-09-27,Calaveras,009,45235,3609,3514,41,3555,70
2021-09-27,Colusa,011,21464,2424,2393,559,2952,18
2021-09-27,Contra Costa,013,1133247,95909,94979,2002,96981,924
2021-09-27,Del Norte,015,27424,3546,3468,33,3501,37
2021-09-27,El Dorado,017,186661,15027,14764,1539,16303,132
2021-09-27,Fresno,019,978130,129750,127475,11778,139253,1942
2021-09-27,Glenn,021,27897,3273,3189,943,4132,26
2021-09-27,Humboldt,023,135768,8296,8118,429,8547,91
2021-09-27,Imperial,025,180216,31805,31491,3051,34542,756
2021-09-27,Inyo,027,18085,1761,1698,34,1732,39
2021-09-27,Kern,029,883053,119179,117064,18943,136007,1503
2021-09-27,Kings,031,150075,29690,28998,1709,30707,297
2021-09-27,Lake,033,64148,6240,6126,124,6250,95
2021-09-27,Lassen,035,31185,6436,6327,295,6622,25
2021-09-27,Los Angeles,037,10098052,1402634,1391538,52854,1444392,26040
2021-09-27,Madera,039,155013,21152,20691,1736,22427,262
2021-09-27,Marin,041,260295,17027,16861,408,17269,242
2021-09-27,Mariposa,043,17540,993,931,33,964,5
2021-09-27,Mendocino,045,87422,6968,6761,374,7135,74
2021-09-27,Merced,047,269075,39267,38840,1550,40390,548
2021-09-27,Modoc,049,8938,480,465,168,633,5
2021-09-27,Mono,051,14174,1553,1525,20,1545,3
2021-09-27,Monterey,053,433212,47735,46811,2656,49467,571
2021-09-27,Napa,055,140530,12478,12354,91,12445,95
2021-09-27,Nevada,057,99092,8524,8379,297,8676,84
2021-09-27,Orange,059,3164182,298923,296334,14188,310522,5409
2021-09-27,Placer,061,380077,34677,34087,3280,37367,370
2021-09-27,Plumas,063,18699,1337,1269,26,1295,6
2021-09-27,Riverside,065,2383286,350698,345529,16024,361553,4864
2021-09-27,Sacramento,067,1510023,150187,149096,3922,153018,2076
2021-09-27,San Benito,069,59416,7057,7017,149,7166,67
2021-09-27,San Bernardino,071,2135413,342747,339952,10677,350629,5544
2021-09-27,San Diego,073,3302833,357527,354755,20993,375748,4054
2021-09-27,San Francisco,075,870044,50848,50157,2193,52350,622
2021-09-27,San Joaquin,077,732212,95225,94085,5123,99208,1633
2021-09-27,San Luis Obispo,079,281455,28208,27674,1131,28805,320
2021-09-27,San Mateo,081,765935,52501,51552,797,52349,571
2021-09-27,Santa Barbara,083,443738,42538,42012,1493,43505,505
2021-09-27,Santa Clara,085,1922200,142047,140802,1138,141940,1853
2021-09-27,Santa Cruz,087,273765,19579,19292,980,20272,214
2021-09-27,Shasta,089,179085,19122,18599,3170,21769,267
2021-09-27,Sierra,091,2930,135,128,13,141,0
2021-09-27,Siskiyou,093,43540,3137,3015,1141,4156,42
2021-09-27,Solano,095,438530,44389,43582,1157,44739,314
2021-09-27,Sonoma,097,501317,39640,39347,494,39841,370
2021-09-27,Stanislaus,099,539301,73532,73370,8336,81706,1091
2021-09-27,Sutter,101,95872,13181,13082,268,13350,155
2021-09-27,Tehama,103,63373,7553,7345,1248,8593,88
2021-09-27,Trinity,105,12862,766,605,202,807,9
2021-09-27,Tulare,107,460477,63235,61708,13189,74897,904
2021-09-27,Tuolumne,109,53932,6369,6264,75,6339,89
2021-09-27,Ventura,111,848112,95345,94477,4179,98656,1138
2021-09-27,Yolo,113,214977,18736,18524,980,19504,239
2021-09-27,Yuba,115,75493,9423,9292,216,9508,64
2021-09-26,Alameda,001,1643700,115395,114601,2651,117252,1326
2021-09-26,Alpine,003,1148,99,101,0,101,0
2021-09-26,Amador,005,37829,5125,5001,52,5053,59
2021-09-26,Butte,007,227075,19108,18634,3402,22036,238
2021-09-26,Calaveras,009,45235,3587,3505,41,3546,70
2021-09-26,Colusa,011,21464,2419,2392,557,2949,18
2021-09-26,Contra Costa,013,1133247,95734,94877,1989,96866,924
2021-09-26,Del Norte,015,27424,3541,3466,32,3498,37
2021-09-26,El Dorado,017,186661,14985,14738,1531,16269,132
2021-09-26,Fresno,019,978130,129392,127235,11732,138967,1939
2021-09-26,Glenn,021,27897,3265,3182,939,4121,26
2021-09-26,Humboldt,023,135768,8261,8098,428,8526,91
2021-09-26,Imperial,025,180216,31744,31462,3050,34512,756
2021-09-26,Inyo,027,18085,1746,1685,34,1719,39
2021-09-26,Kern,029,883053,118841,116927,18833,135760,1502
2021-09-26,Kings,031,150075,29589,28930,1698,30628,293
2021-09-26,Lake,033,64148,6223,6113,124,6237,95
2021-09-26,Lassen,035,31185,6426,6319,290,6609,25
2021-09-26,Los Angeles,037,10098052,1401146,1390577,52783,1443360,26035
2021-09-26,Madera,039,155013,21078,20629,1717,22346,262
2021-09-26,Marin,041,260295,17004,16860,408,17268,242
2021-09-26,Mariposa,043,17540,987,929,33,962,5
2021-09-26,Mendocino,045,87422,6934,6744,359,7103,74
2021-09-26,Merced,047,269075,39106,38717,1542,40259,548
2021-09-26,Modoc,049,8938,480,465,167,632,5
2021-09-26,Mono,051,14174,1549,1516,20,1536,3
2021-09-26,Monterey,053,433212,47687,46792,2642,49434,571
2021-09-26,Napa,055,140530,12454,12340,90,12430,95
2021-09-26,Nevada,057,99092,8493,8356,292,8648,84
2021-09-26,Orange,059,3164182,298584,296085,14156,310241,5409
2021-09-26,Placer,061,380077,34583,34043,3270,37313,370
2021-09-26,Plumas,063,18699,1319,1268,26,1294,6
2021-09-26,Riverside,065,2383286,350165,345257,16010,361267,4864
2021-09-26,Sacramento,067,1510023,149783,148745,3903,152648,2071
2021-09-26,San Benito,069,59416,7040,7012,148,7160,67
2021-09-26,San Bernardino,071,2135413,342291,339771,10662,350433,5545
2021-09-26,San Diego,073,3302833,356884,354414,20952,375366,4051
2021-09-26,San Francisco,075,870044,50722,50092,2184,52276,622
2021-09-26,San Joaquin,077,732212,95022,93935,5109,99044,1633
2021-09-26,San Luis Obispo,079,281455,28134,27624,1126,28750,319
2021-09-26,San Mateo,081,765935,52432,51496,795,52291,571
2021-09-26,Santa Barbara,083,443738,42451,41946,1490,43436,505
2021-09-26,Santa Clara,085,1922200,141847,140667,1134,141801,1852
2021-09-26,Santa Cruz,087,273765,19554,19279,980,20259,214
2021-09-26,Shasta,089,179085,19013,18566,3147,21713,266
2021-09-26,Sierra,091,2930,135,128,13,141,0
2021-09-26,Siskiyou,093,43540,3123,2998,1131,4129,42
2021-09-26,Solano,095,438530,44322,43537,1156,44693,314
2021-09-26,Sonoma,097,501317,39581,39302,494,39796,370
2021-09-26,Stanislaus,099,539301,73332,73243,8308,81551,1091
2021-09-26,Sutter,101,95872,13144,13045,267,13312,155
2021-09-26,Tehama,103,63373,7495,7323,1237,8560,88
2021-09-26,Trinity,105,12862,763,591,202,793,9
2021-09-26,Tulare,107,460477,63014,61560,13111,74671,904
2021-09-26,Tuolumne,109,53932,6341,6236,73,6309,89
2021-09-26,Ventura,111,848112,95231,94391,4172,98563,1138
2021-09-26,Yolo,113,214977,18700,18496,972,19468,239
2021-09-26,Yuba,115,75493,9396,9275,216,9491,64
2021-09-25,Alameda,001,1643700,115315,114014,2648,116662,1324
2021-09-25,Alpine,003,1148,99,101,0,101,0
2021-09-25,Amador,005,37829,5111,4934,52,4986,59
2021-09-25,Butte,007,227075,19079,18396,3393,21789,236
2021-09-25,Calaveras,009,45235,3584,3461,41,3502,70
2021-09-25,Colusa,011,21464,2416,2387,555,2942,16
2021-09-25,Contra Costa,013,1133247,95663,94337,1985,96322,924
2021-09-25,Del Norte,015,27424,3540,3404,32,3436,35
2021-09-25,El Dorado,017,186661,14962,14641,1527,16168,130
2021-09-25,Fresno,019,978130,129247,126299,11716,138015,1927
2021-09-25,Glenn,021,27897,3260,3144,938,4082,25
2021-09-25,Humboldt,023,135768,8242,8014,426,8440,88
2021-09-25,Imperial,025,180216,31717,31280,3050,34330,755
2021-09-25,Inyo,027,18085,1738,1657,34,1691,39
2021-09-25,Kern,029,883053,118686,116021,18765,134786,1485
2021-09-25,Kings,031,150075,29538,28636,1695,30331,293
2021-09-25,Lake,033,64148,6218,6046,122,6168,92
2021-09-25,Lassen,035,31185,6414,6248,289,6537,25
2021-09-25,Los Angeles,037,10098052,1400431,1386417,52742,1439159,25964
2021-09-25,Madera,039,155013,21053,20432,1711,22143,262
2021-09-25,Marin,041,260295,16995,16802,406,17208,242
2021-09-25,Mariposa,043,17540,982,906,33,939,5
2021-09-25,Mendocino,045,87422,6915,6657,358,7015,74
2021-09-25,Merced,047,269075,39060,38393,1540,39933,546
2021-09-25,Modoc,049,8938,480,460,167,627,5
2021-09-25,Mono,051,14174,1546,1501,20,1521,3
2021-09-25,Monterey,053,433212,47657,46653,2640,49293,567
2021-09-25,Napa,055,140530,12434,12266,90,12356,95
2021-09-25,Nevada,057,99092,8476,8285,292,8577,84
2021-09-25,Orange,059,3164182,298411,294514,14138,308652,5374
2021-09-25,Placer,061,380077,34519,33764,3267,37031,367
2021-09-25,Plumas,063,18699,1315,1238,26,1264,6
2021-09-25,Riverside,065,2383286,349842,343463,16002,359465,4843
2021-09-25,Sacramento,067,1510023,149607,147728,3894,151622,2049
2021-09-25,San Benito,069,59416,7035,6965,148,7113,67
2021-09-25,San Bernardino,071,2135413,342057,338413,10648,349061,5540
2021-09-25,San Diego,073,3302833,356534,352017,20926,372943,4039
2021-09-25,San Francisco,075,870044,50678,49840,2183,52023,615
2021-09-25,San Joaquin,077,732212,94936,93273,5107,98380,1628
2021-09-25,San Luis Obispo,079,281455,28096,27447,1122,28569,318
2021-09-25,San Mateo,081,765935,52368,51266,793,52059,568
2021-09-25,Santa Barbara,083,443738,42393,41728,1490,43218,505
2021-09-25,Santa Clara,085,1922200,141741,140023,1132,141155,1844
2021-09-25,Santa Cruz,087,273765,19538,19200,978,20178,214
2021-09-25,Shasta,089,179085,18962,18256,3138,21394,262
2021-09-25,Sierra,091,2930,134,127,13,140,0
2021-09-25,Siskiyou,093,43540,3116,2956,1121,4077,41
2021-09-25,Solano,095,438530,44281,43331,1153,44484,312
2021-09-25,Sonoma,097,501317,39540,39112,494,39606,369
2021-09-25,Stanislaus,099,539301,73222,72628,8294,80922,1091
2021-09-25,Sutter,101,95872,13126,12976,264,13240,154
2021-09-25,Tehama,103,63373,7480,7200,1235,8435,86
2021-09-25,Trinity,105,12862,763,576,202,778,9
2021-09-25,Tulare,107,460477,62932,60909,13067,73976,898
2021-09-25,Tuolumne,109,53932,6329,6168,73,6241,89
2021-09-25,Ventura,111,848112,95164,94059,4168,98227,1129
2021-09-25,Yolo,113,214977,18678,18393,971,19364,239
2021-09-25,Yuba,115,75493,9376,9191,216,9407,61
2021-09-24,Alameda,001,1643700,115211,114014,2644,116658,1324
2021-09-24,Alpine,003,1148,99,101,0,101,0
2021-09-24,Amador,005,37829,5081,4934,52,4986,59
2021-09-24,Butte,007,227075,19027,18396,3384,21780,236
2021-09-24,Calaveras,009,45235,3577,3461,40,3501,70
2021-09-24,Colusa,011,21464,2413,2387,554,2941,16
2021-09-24,Contra Costa,013,1133247,95553,94337,1981,96318,924
2021-09-24,Del Norte,015,27424,3537,3404,32,3436,35
2021-09-24,El Dorado,017,186661,14944,14641,1523,16164,130
2021-09-24,Fresno,019,978130,129049,126299,11704,138003,1927
2021-09-24,Glenn,021,27897,3252,3144,938,4082,25
2021-09-24,Humboldt,023,135768,8223,8014,423,8437,88
2021-09-24,Imperial,025,180216,31679,31280,3048,34328,755
2021-09-24,Inyo,027,18085,1729,1657,34,1691,39
2021-09-24,Kern,029,883053,118550,116021,18699,134720,1485
2021-09-24,Kings,031,150075,29497,28636,1690,30326,293
2021-09-24,Lake,033,64148,6210,6046,122,6168,92
2021-09-24,Lassen,035,31185,6406,6248,288,6536,25
2021-09-24,Los Angeles,037,10098052,1399549,1386417,52700,1439117,25964
2021-09-24,Madera,039,155013,21022,20432,1702,22134,262
2021-09-24,Marin,041,260295,16981,16802,405,17207,242
2021-09-24,Mariposa,043,17540,970,906,33,939,5
2021-09-24,Mendocino,045,87422,6902,6657,358,7015,74
2021-09-24,Merced,047,269075,39016,38393,1540,39933,546
2021-09-24,Modoc,049,8938,480,460,166,626,5
2021-09-24,Mono,051,14174,1541,1501,20,1521,3
2021-09-24,Monterey,053,433212,47636,46653,2632,49285,567
2021-09-24,Napa,055,140530,12415,12266,90,12356,95
2021-09-24,Nevada,057,99092,8462,8285,289,8574,84
2021-09-24,Orange,059,3164182,298203,294514,14120,308634,5374
2021-09-24,Placer,061,380077,34464,33764,3254,37018,367
2021-09-24,Plumas,063,18699,1311,1238,26,1264,6
2021-09-24,Riverside,065,2383286,349508,343463,15993,359456,4843
2021-09-24,Sacramento,067,1510023,149423,147728,3890,151618,2049
2021-09-24,San Benito,069,59416,7029,6965,148,7113,67
2021-09-24,San Bernardino,071,2135413,341790,338413,10638,349051,5540
2021-09-24,San Diego,073,3302833,356180,352017,20911,372928,4039
2021-09-24,San Francisco,075,870044,50614,49840,2175,52015,615
2021-09-24,San Joaquin,077,732212,94823,93273,5105,98378,1628
2021-09-24,San Luis Obispo,079,281455,28065,27447,1117,28564,318
2021-09-24,San Mateo,081,765935,52308,51266,792,52058,568
2021-09-24,Santa Barbara,083,443738,42353,41728,1489,43217,505
2021-09-24,Santa Clara,085,1922200,141629,140023,1131,141154,1844
2021-09-24,Santa Cruz,087,273765,19515,19200,977,20177,214
2021-09-24,Shasta,089,179085,18908,18256,3124,21380,262
2021-09-24,Sierra,091,2930,133,127,13,140,0
2021-09-24,Siskiyou,093,43540,3107,2956,1115,4071,41
2021-09-24,Solano,095,438530,44244,43331,1151,44482,312
2021-09-24,Sonoma,097,501317,39507,39112,494,39606,369
2021-09-24,Stanislaus,099,539301,73107,72628,8279,80907,1091
2021-09-24,Sutter,101,95872,13107,12976,263,13239,154
2021-09-24,Tehama,103,63373,7468,7200,1230,8430,86
2021-09-24,Trinity,105,12862,760,576,202,778,9
2021-09-24,Tulare,107,460477,62841,60909,13025,73934,898
2021-09-24,Tuolumne,109,53932,6300,6168,73,6241,89
2021-09-24,Ventura,111,848112,95086,94059,4161,98220,1129
2021-09-24,Yolo,113,214977,18646,18393,968,19361,239
2021-09-24,Yuba,115,75493,9357,9191,216,9407,61
2021-09-23,Alameda,001,1643700,115052,114014,2638,116652,1324
2021-09-23,Alpine,003,1148,99,101,0,101,0
2021-09-23,Amador,005,37829,5068,4934,52,4986,59
2021-09-23,Butte,007,227075,18965,18396,3360,21756,236
2021-09-23,Calaveras,009,45235,3556,3461,40,3501,70
2021-09-23,Colusa,011,21464,2411,2387,551,2938,16
2021-09-23,Contra Costa,013,1133247,95412,94337,1974,96311,924
2021-09-23,Del Norte,015,27424,3528,3404,31,3435,35
2021-09-23,El Dorado,017,186661,14918,14641,1517,16158,130
2021-09-23,Fresno,019,978130,128752,126299,11685,137984,1927
2021-09-23,Glenn,021,27897,3238,3144,935,4079,25
2021-09-23,Humboldt,023,135768,8198,8014,421,8435,88
2021-09-23,Imperial,025,180216,31643,31280,3048,34328,755
2021-09-23,Inyo,027,18085,1715,1657,34,1691,39
2021-09-23,Kern,029,883053,118292,116021,18618,134639,1485
2021-09-23,Kings,031,150075,29393,28636,1681,30317,293
2021-09-23,Lake,033,64148,6200,6046,122,6168,92
2021-09-23,Lassen,035,31185,6397,6248,283,6531,25
2021-09-23,Los Angeles,037,10098052,1398353,1386417,52635,1439052,25964
2021-09-23,Madera,039,155013,20940,20432,1698,22130,262
2021-09-23,Marin,041,260295,16966,16802,402,17204,242
2021-09-23,Mariposa,043,17540,957,906,33,939,5
2021-09-23,Mendocino,045,87422,6880,6657,353,7010,74
2021-09-23,Merced,047,269075,38913,38393,1533,39926,546
2021-09-23,Modoc,049,8938,479,460,166,626,5
2021-09-23,Mono,051,14174,1538,1501,20,1521,3
2021-09-23,Monterey,053,433212,47587,46653,2620,49273,567
2021-09-23,Napa,055,140530,12398,12266,90,12356,95
2021-09-23,Nevada,057,99092,8435,8285,289,8574,84
2021-09-23,Orange,059,3164182,297906,294514,14096,308610,5374
2021-09-23,Placer,061,380077,34388,33764,3247,37011,367
2021-09-23,Plumas,063,18699,1294,1238,25,1263,6
2021-09-23,Riverside,065,2383286,349055,343463,15986,359449,4843
2021-09-23,Sacramento,067,1510023,149093,147728,3870,151598,2049
2021-09-23,San Benito,069,59416,7018,6965,148,7113,67
2021-09-23,San Bernardino,071,2135413,341427,338413,10623,349036,5540
2021-09-23,San Diego,073,3302833,355716,352017,20872,372889,4039
2021-09-23,San Francisco,075,870044,50541,49840,2173,52013,615
2021-09-23,San Joaquin,077,732212,94650,93273,5090,98363,1628
2021-09-23,San Luis Obispo,079,281455,28022,27447,1115,28562,318
2021-09-23,San Mateo,081,765935,52233,51266,791,52057,568
2021-09-23,Santa Barbara,083,443738,42275,41728,1486,43214,505
2021-09-23,Santa Clara,085,1922200,141479,140023,1124,141147,1844
2021-09-23,Santa Cruz,087,273765,19484,19200,977,20177,214
2021-09-23,Shasta,089,179085,18828,18256,3107,21363,262
2021-09-23,Sierra,091,2930,133,127,13,140,0
2021-09-23,Siskiyou,093,43540,3103,2956,1104,4060,41
2021-09-23,Solano,095,438530,44176,43331,1148,44479,312
2021-09-23,Sonoma,097,501317,39448,39112,491,39603,369
2021-09-23,Stanislaus,099,539301,72951,72628,8247,80875,1091
2021-09-23,Sutter,101,95872,13078,12976,263,13239,154
2021-09-23,Tehama,103,63373,7427,7200,1225,8425,86
2021-09-23,Trinity,105,12862,746,576,201,777,9
2021-09-23,Tulare,107,460477,62664,60909,12970,73879,898
2021-09-23,Tuolumne,109,53932,6275,6168,72,6240,89
2021-09-23,Ventura,111,848112,94983,94059,4154,98213,1129
2021-09-23,Yolo,113,214977,18615,18393,963,19356,239
2021-09-23,Yuba,115,75493,9329,9191,215,9406,61
2021-09-22,Alameda,001,1643700,114894,113862,2634,116496,1322
2021-09-22,Alpine,003,1148,99,100,0,100,0
2021-09-22,Amador,005,37829,5052,4915,52,4967,59
2021-09-22,Butte,007,227075,18905,18337,3345,21682,235
2021-09-22,Calaveras,009,45235,3540,3448,40,3488,70
2021-09-22,Colusa,011,21464,2406,2384,550,2934,16
2021-09-22,Contra Costa,013,1133247,95228,94209,1965,96174,924
2021-09-22,Del Norte,015,27424,3517,3386,30,3416,35
2021-09-22,El Dorado,017,186661,14882,14605,1510,16115,127
2021-09-22,Fresno,019,978130,128494,126006,11670,137676,1908
2021-09-22,Glenn,021,27897,3231,3138,934,4072,25
2021-09-22,Humboldt,023,135768,8176,7998,413,8411,80
2021-09-22,Imperial,025,180216,31591,31243,3041,34284,755
2021-09-22,Inyo,027,18085,1705,1651,34,1685,39
2021-09-22,Kern,029,883053,118051,115757,18496,134253,1477
2021-09-22,Kings,031,150075,29308,28589,1675,30264,292
2021-09-22,Lake,033,64148,6188,6035,122,6157,93
2021-09-22,Lassen,035,31185,6377,6209,279,6488,25
2021-09-22,Los Angeles,037,10098052,1397030,1384719,52579,1437298,25930
2021-09-22,Madera,039,155013,20883,20382,1688,22070,262
2021-09-22,Marin,041,260295,16956,16782,399,17181,242
2021-09-22,Mariposa,043,17540,951,901,33,934,5
2021-09-22,Mendocino,045,87422,6853,6624,347,6971,70
2021-09-22,Merced,047,269075,38780,38305,1531,39836,541
2021-09-22,Modoc,049,8938,476,458,166,624,5
2021-09-22,Mono,051,14174,1529,1496,19,1515,3
2021-09-22,Monterey,053,433212,47536,46615,2613,49228,566
2021-09-22,Napa,055,140530,12375,12248,89,12337,95
2021-09-22,Nevada,057,99092,8412,8273,286,8559,84
2021-09-22,Orange,059,3164182,297630,294214,14079,308293,5366
2021-09-22,Placer,061,380077,34301,33661,3234,36895,367
2021-09-22,Plumas,063,18699,1282,1230,25,1255,6
2021-09-22,Riverside,065,2383286,348520,342946,15961,358907,4830
2021-09-22,Sacramento,067,1510023,148781,147533,3839,151372,2043
2021-09-22,San Benito,069,59416,7007,6961,146,7107,67
2021-09-22,San Bernardino,071,2135413,341033,337938,10614,348552,5528
2021-09-22,San Diego,073,3302833,355257,351132,20848,371980,4027
2021-09-22,San Francisco,075,870044,50456,49734,2168,51902,610
2021-09-22,San Joaquin,077,732212,94418,93010,5064,98074,1626
2021-09-22,San Luis Obispo,079,281455,27974,27398,1112,28510,315
2021-09-22,San Mateo,081,765935,52160,51197,787,51984,568
2021-09-22,Santa Barbara,083,443738,42212,41678,1485,43163,504
2021-09-22,Santa Clara,085,1922200,141315,139803,1117,140920,1844
2021-09-22,Santa Cruz,087,273765,19446,19177,977,20154,214
2021-09-22,Shasta,089,179085,18738,18153,3095,21248,260
2021-09-22,Sierra,091,2930,133,127,13,140,0
2021-09-22,Siskiyou,093,43540,3086,2947,1094,4041,41
2021-09-22,Solano,095,438530,44111,43269,1147,44416,312
2021-09-22,Sonoma,097,501317,39395,39063,490,39553,369
2021-09-22,Stanislaus,099,539301,72786,72355,8228,80583,1091
2021-09-22,Sutter,101,95872,13058,12960,260,13220,153
2021-09-22,Tehama,103,63373,7400,7173,1222,8395,86
2021-09-22,Trinity,105,12862,745,572,201,773,9
2021-09-22,Tulare,107,460477,62455,60776,12899,73675,896
2021-09-22,Tuolumne,109,53932,6254,6155,71,6226,89
2021-09-22,Ventura,111,848112,94878,93978,4148,98126,1122
2021-09-22,Yolo,113,214977,18576,18342,956,19298,239
2021-09-22,Yuba,115,75493,9300,9169,210,9379,61
2021-09-21,Alameda,001,1643700,114740,113765,2634,116399,1321
2021-09-21,Alpine,003,1148,99,100,0,100,0
2021-09-21,Amador,005,37829,5030,4897,52,4949,59
2021-09-21,Butte,007,227075,18809,18229,3308,21537,232
2021-09-21,Calaveras,009,45235,3523,3437,40,3477,70
2021-09-21,Colusa,011,21464,2403,2378,549,2927,16
2021-09-21,Contra Costa,013,1133247,95034,94101,1951,96052,924
2021-09-21,Del Norte,015,27424,3504,3378,30,3408,34
2021-09-21,El Dorado,017,186661,14852,14578,1503,16081,127
2021-09-21,Fresno,019,978130,128143,125789,11644,137433,1892
2021-09-21,Glenn,021,27897,3224,3134,930,4064,25
2021-09-21,Humboldt,023,135768,8144,7955,408,8363,80
2021-09-21,Imperial,025,180216,31534,31185,3039,34224,755
2021-09-21,Inyo,027,18085,1695,1646,34,1680,39
2021-09-21,Kern,029,883053,117759,115534,18382,133916,1467
2021-09-21,Kings,031,150075,29220,28545,1667,30212,291
2021-09-21,Lake,033,64148,6165,6013,122,6135,90
2021-09-21,Lassen,035,31185,6359,6159,275,6434,25
2021-09-21,Los Angeles,037,10098052,1395573,1383277,52522,1435799,25893
2021-09-21,Madera,039,155013,20823,20317,1678,21995,262
2021-09-21,Marin,041,260295,16941,16748,398,17146,242
2021-09-21,Mariposa,043,17540,946,894,32,926,5
2021-09-21,Mendocino,045,87422,6815,6580,336,6916,68
2021-09-21,Merced,047,269075,38658,38225,1527,39752,539
2021-09-21,Modoc,049,8938,473,458,166,624,5
2021-09-21,Mono,051,14174,1527,1495,18,1513,3
2021-09-21,Monterey,053,433212,47467,46583,2601,49184,565
2021-09-21,Napa,055,140530,12354,12238,89,12327,95
2021-09-21,Nevada,057,99092,8385,8259,277,8536,84
2021-09-21,Orange,059,3164182,297299,293898,14049,307947,5357
2021-09-21,Placer,061,380077,34200,33609,3223,36832,365
2021-09-21,Plumas,063,18699,1275,1225,25,1250,5
2021-09-21,Riverside,065,2383286,347960,342460,15937,358397,4817
2021-09-21,Sacramento,067,1510023,148399,147378,3811,151189,2027
2021-09-21,San Benito,069,59416,6996,6950,145,7095,67
2021-09-21,San Bernardino,071,2135413,340595,337387,10597,347984,5520
2021-09-21,San Diego,073,3302833,354641,350265,20822,371087,4021
2021-09-21,San Francisco,075,870044,50360,49653,2164,51817,609
2021-09-21,San Joaquin,077,732212,94184,92762,5053,97815,1621
2021-09-21,San Luis Obispo,079,281455,27915,27318,1108,28426,314
2021-09-21,San Mateo,081,765935,52090,51136,787,51923,568
2021-09-21,Santa Barbara,083,443738,42143,41644,1481,43125,503
2021-09-21,Santa Clara,085,1922200,141098,139657,1113,140770,1843
2021-09-21,Santa Cruz,087,273765,19416,19140,976,20116,212
2021-09-21,Shasta,089,179085,18610,18027,3071,21098,258
2021-09-21,Sierra,091,2930,133,127,13,140,0
2021-09-21,Siskiyou,093,43540,3072,2927,1080,4007,36
2021-09-21,Solano,095,438530,44035,43220,1147,44367,311
2021-09-21,Sonoma,097,501317,39342,39042,490,39532,369
2021-09-21,Stanislaus,099,539301,72602,72211,8206,80417,1091
2021-09-21,Sutter,101,95872,13035,12930,257,13187,153
2021-09-21,Tehama,103,63373,7354,7151,1218,8369,85
2021-09-21,Trinity,105,12862,734,572,199,771,9
2021-09-21,Tulare,107,460477,62241,60607,12838,73445,896
2021-09-21,Tuolumne,109,53932,6222,6139,71,6210,89
2021-09-21,Ventura,111,848112,94773,93818,4140,97958,1120
2021-09-21,Yolo,113,214977,18540,18313,952,19265,239
2021-09-21,Yuba,115,75493,9272,9135,210,9345,61
2021-09-20,Alameda,001,1643700,114557,113637,2630,116267,1320
2021-09-20,Alpine,003,1148,99,100,0,100,0
2021-09-20,Amador,005,37829,5012,4883,51,4934,59
2021-09-20,Butte,007,227075,18727,18135,3292,21427,231
2021-09-20,Calaveras,009,45235,3501,3395,39,3434,66
2021-09-20,Colusa,011,21464,2401,2376,546,2922,16
2021-09-20,Contra Costa,013,1133247,94884,93919,1945,95864,924
2021-09-20,Del Norte,015,27424,3496,3374,29,3403,34
2021-09-20,El Dorado,017,186661,14819,14545,1491,16036,127
2021-09-20,Fresno,019,978130,127730,125287,11616,136903,1889
2021-09-20,Glenn,021,27897,3213,3112,927,4039,25
2021-09-20,Humboldt,023,135768,8108,7938,403,8341,80
2021-09-20,Imperial,025,180216,31451,31146,3038,34184,755
2021-09-20,Inyo,027,18085,1687,1641,33,1674,39
2021-09-20,Kern,029,883053,117420,115271,18250,133521,1459
2021-09-20,Kings,031,150075,29133,28471,1661,30132,285
2021-09-20,Lake,033,64148,6150,5984,121,6105,87
2021-09-20,Lassen,035,31185,6329,6132,275,6407,25
2021-09-20,Los Angeles,037,10098052,1394052,1382206,52441,1434647,25858
2021-09-20,Madera,039,155013,20770,20203,1671,21874,257
2021-09-20,Marin,041,260295,16916,16732,396,17128,242
2021-09-20,Mariposa,043,17540,935,887,32,919,5
2021-09-20,Mendocino,045,87422,6781,6568,330,6898,67
2021-09-20,Merced,047,269075,38547,38144,1516,39660,536
2021-09-20,Modoc,049,8938,472,457,164,621,5
2021-09-20,Mono,051,14174,1521,1480,18,1498,3
2021-09-20,Monterey,053,433212,47425,46506,2583,49089,565
2021-09-20,Napa,055,140530,12329,12209,88,12297,95
2021-09-20,Nevada,057,99092,8365,8228,275,8503,84
2021-09-20,Orange,059,3164182,296956,293642,14022,307664,5354
2021-09-20,Placer,061,380077,34109,33531,3208,36739,364
2021-09-20,Plumas,063,18699,1270,1211,25,1236,5
2021-09-20,Riverside,065,2383286,347460,341961,15924,357885,4802
2021-09-20,Sacramento,067,1510023,148025,147016,3777,150793,2016
2021-09-20,San Benito,069,59416,6987,6947,144,7091,67
2021-09-20,San Bernardino,071,2135413,340198,337059,10581,347640,5507
2021-09-20,San Diego,073,3302833,353964,349579,20785,370364,4009
2021-09-20,San Francisco,075,870044,50253,49559,2163,51722,605
2021-09-20,San Joaquin,077,732212,93941,92614,5040,97654,1615
2021-09-20,San Luis Obispo,079,281455,27839,27259,1100,28359,313
2021-09-20,San Mateo,081,765935,52003,51100,784,51884,567
2021-09-20,Santa Barbara,083,443738,42044,41589,1477,43066,500
2021-09-20,Santa Clara,085,1922200,140897,139578,1111,140689,1841
2021-09-20,Santa Cruz,087,273765,19384,19121,976,20097,211
2021-09-20,Shasta,089,179085,18511,17893,3040,20933,258
2021-09-20,Sierra,091,2930,131,126,13,139,0
2021-09-20,Siskiyou,093,43540,3050,2902,1067,3969,35
2021-09-20,Solano,095,438530,43967,43152,1139,44291,312
2021-09-20,Sonoma,097,501317,39296,38991,490,39481,369
2021-09-20,Stanislaus,099,539301,72403,72031,8187,80218,1091
2021-09-20,Sutter,101,95872,12999,12896,252,13148,153
2021-09-20,Tehama,103,63373,7322,7121,1206,8327,84
2021-09-20,Trinity,105,12862,728,568,198,766,7
2021-09-20,Tulare,107,460477,62039,60302,12782,73084,896
2021-09-20,Tuolumne,109,53932,6196,6113,71,6184,89
2021-09-20,Ventura,111,848112,94660,93700,4133,97833,1120
2021-09-20,Yolo,113,214977,18494,18287,950,19237,239
2021-09-20,Yuba,115,75493,9236,9107,208,9315,61
2021-09-19,Alameda,001,1643700,114340,113446,2625,116071,1320
2021-09-19,Alpine,003,1148,99,100,0,100,0
2021-09-19,Amador,005,37829,4972,4875,50,4925,59
2021-09-19,Butte,007,227075,18634,18063,3265,21328,230
2021-09-19,Calaveras,009,45235,3477,3390,36,3426,66
2021-09-19,Colusa,011,21464,2399,2375,544,2919,16
2021-09-19,Contra Costa,013,1133247,94699,93788,1935,95723,924
2021-09-19,Del Norte,015,27424,3470,3344,28,3372,34
2021-09-19,El Dorado,017,186661,14766,14512,1485,15997,127
2021-09-19,Fresno,019,978130,127324,124985,11571,136556,1888
2021-09-19,Glenn,021,27897,3204,3102,924,4026,25
2021-09-19,Humboldt,023,135768,8063,7914,401,8315,80
2021-09-19,Imperial,025,180216,31382,31122,3035,34157,755
2021-09-19,Inyo,027,18085,1678,1639,33,1672,39
2021-09-19,Kern,029,883053,117108,115074,18144,133218,1459
2021-09-19,Kings,031,150075,29005,28416,1652,30068,284
2021-09-19,Lake,033,64148,6119,5962,121,6083,87
2021-09-19,Lassen,035,31185,6309,6129,269,6398,25
2021-09-19,Los Angeles,037,10098052,1392077,1381200,52342,1433542,25852
2021-09-19,Madera,039,155013,20691,20161,1660,21821,257
2021-09-19,Marin,041,260295,16887,16711,394,17105,242
2021-09-19,Mariposa,043,17540,927,881,32,913,5
2021-09-19,Mendocino,045,87422,6736,6538,324,6862,67
2021-09-19,Merced,047,269075,38390,38068,1507,39575,535
2021-09-19,Modoc,049,8938,469,457,162,619,5
2021-09-19,Mono,051,14174,1516,1480,18,1498,3
2021-09-19,Monterey,053,433212,47370,46486,2580,49066,565
2021-09-19,Napa,055,140530,12308,12190,86,12276,95
2021-09-19,Nevada,057,99092,8337,8203,273,8476,84
2021-09-19,Orange,059,3164182,296588,293258,14000,307258,5354
2021-09-19,Placer,061,380077,33996,33406,3190,36596,364
2021-09-19,Plumas,063,18699,1262,1211,25,1236,5
2021-09-19,Riverside,065,2383286,346867,341566,15915,357481,4804
2021-09-19,Sacramento,067,1510023,147665,146603,3732,150335,2012
2021-09-19,San Benito,069,59416,6968,6942,144,7086,67
2021-09-19,San Bernardino,071,2135413,339704,336688,10570,347258,5506
2021-09-19,San Diego,073,3302833,353250,349225,20748,369973,4006
2021-09-19,San Francisco,075,870044,50145,49458,2154,51612,605
2021-09-19,San Joaquin,077,732212,93644,92467,5029,97496,1615
2021-09-19,San Luis Obispo,079,281455,27738,27208,1091,28299,313
2021-09-19,San Mateo,081,765935,51905,51028,783,51811,567
2021-09-19,Santa Barbara,083,443738,41938,41512,1477,42989,500
2021-09-19,Santa Clara,085,1922200,140711,139410,1106,140516,1841
2021-09-19,Santa Cruz,087,273765,19345,19096,976,20072,211
2021-09-19,Shasta,089,179085,18397,17813,3004,20817,258
2021-09-19,Sierra,091,2930,130,126,13,139,0
2021-09-19,Siskiyou,093,43540,3024,2882,1058,3940,35
2021-09-19,Solano,095,438530,43878,43056,1134,44190,312
2021-09-19,Sonoma,097,501317,39224,38956,486,39442,369
2021-09-19,Stanislaus,099,539301,72159,71830,8162,79992,1091
2021-09-19,Sutter,101,95872,12972,12868,245,13113,153
2021-09-19,Tehama,103,63373,7268,7081,1197,8278,84
2021-09-19,Trinity,105,12862,717,562,196,758,7
2021-09-19,Tulare,107,460477,61778,60160,12688,72848,896
2021-09-19,Tuolumne,109,53932,6154,6097,71,6168,89
2021-09-19,Ventura,111,848112,94498,93491,4124,97615,1120
2021-09-19,Yolo,113,214977,18445,18238,944,19182,239
2021-09-19,Yuba,115,75493,9210,9087,207,9294,61
2021-09-18,Alameda,001,1643700,114239,113300,2624,115924,1320
2021-09-18,Alpine,003,1148,99,100,0,100,0
2021-09-18,Amador,005,37829,4962,4850,50,4900,59
2021-09-18,Butte,007,227075,18597,17961,3251,21212,230
2021-09-18,Calaveras,009,45235,3472,3361,35,3396,66
2021-09-18,Colusa,011,21464,2399,2373,543,2916,16
2021-09-18,Contra Costa,013,1133247,94609,93656,1931,95587,924
2021-09-18,Del Norte,015,27424,3462,3326,26,3352,34
2021-09-18,El Dorado,017,186661,14743,14472,1482,15954,127
2021-09-18,Fresno,019,978130,127182,124771,11553,136324,1889
2021-09-18,Glenn,021,27897,3195,3086,921,4007,25
2021-09-18,Humboldt,023,135768,8049,7881,400,8281,80
2021-09-18,Imperial,025,180216,31358,31096,3034,34130,755
2021-09-18,Inyo,027,18085,1672,1636,33,1669,39
2021-09-18,Kern,029,883053,116953,114781,18080,132861,1459
2021-09-18,Kings,031,150075,28957,28330,1647,29977,285
2021-09-18,Lake,033,64148,6102,5936,121,6057,87
2021-09-18,Lassen,035,31185,6299,6121,267,6388,25
2021-09-18,Los Angeles,037,10098052,1391318,1379880,52291,1432171,25849
2021-09-18,Madera,039,155013,20647,20126,1650,21776,257
2021-09-18,Marin,041,260295,16870,16685,393,17078,242
2021-09-18,Mariposa,043,17540,924,871,32,903,5
2021-09-18,Mendocino,045,87422,6715,6523,324,6847,67
2021-09-18,Merced,047,269075,38353,37977,1501,39478,535
2021-09-18,Modoc,049,8938,469,457,161,618,5
2021-09-18,Mono,051,14174,1513,1480,18,1498,3
2021-09-18,Monterey,053,433212,47332,46466,2577,49043,565
2021-09-18,Napa,055,140530,12296,12168,86,12254,95
2021-09-18,Nevada,057,99092,8320,8183,273,8456,84
2021-09-18,Orange,059,3164182,296394,293005,13986,306991,5354
2021-09-18,Placer,061,380077,33924,33309,3187,36496,364
2021-09-18,Plumas,063,18699,1261,1204,25,1229,5
2021-09-18,Riverside,065,2383286,346482,341136,15900,357036,4802
2021-09-18,Sacramento,067,1510023,147484,146162,3723,149885,2016
2021-09-18,San Benito,069,59416,6963,6937,144,7081,67
2021-09-18,San Bernardino,071,2135413,339431,336380,10557,346937,5501
2021-09-18,San Diego,073,3302833,352852,348848,20735,369583,4006
2021-09-18,San Francisco,075,870044,50082,49359,2149,51508,605
2021-09-18,San Joaquin,077,732212,93534,92242,5017,97259,1615
2021-09-18,San Luis Obispo,079,281455,27701,27181,1088,28269,313
2021-09-18,San Mateo,081,765935,51854,50961,781,51742,567
2021-09-18,Santa Barbara,083,443738,41873,41465,1477,42942,500
2021-09-18,Santa Clara,085,1922200,140591,139233,1103,140336,1841
2021-09-18,Santa Cruz,087,273765,19325,19079,976,20055,211
2021-09-18,Shasta,089,179085,18334,17777,2987,20764,258
2021-09-18,Sierra,091,2930,129,125,13,138,0
2021-09-18,Siskiyou,093,43540,3021,2875,1052,3927,35
2021-09-18,Solano,095,438530,43838,42966,1131,44097,312
2021-09-18,Sonoma,097,501317,39189,38891,484,39375,369
2021-09-18,Stanislaus,099,539301,72013,71587,8137,79724,1091
2021-09-18,Sutter,101,95872,12958,12829,245,13074,153
2021-09-18,Tehama,103,63373,7254,7055,1190,8245,84
2021-09-18,Trinity,105,12862,715,561,196,757,7
2021-09-18,Tulare,107,460477,61702,60003,12636,72639,896
2021-09-18,Tuolumne,109,53932,6139,6069,71,6140,89
2021-09-18,Ventura,111,848112,94430,93424,4119,97543,1120
2021-09-18,Yolo,113,214977,18418,18213,939,19152,239
2021-09-18,Yuba,115,75493,9196,9061,206,9267,61
2021-09-17,Alameda,001,1643700,114114,113070,2622,115692,1320
2021-09-17,Alpine,003,1148,99,99,0,99,0
2021-09-17,Amador,005,37829,4946,4835,49,4884,58
2021-09-17,Butte,007,227075,18545,17870,3242,21112,230
2021-09-17,Calaveras,009,45235,3460,3338,34,3372,66
2021-09-17,Colusa,011,21464,2398,2369,538,2907,16
2021-09-17,Contra Costa,013,1133247,94506,93485,1928,95413,924
2021-09-17,Del Norte,015,27424,3457,3311,24,3335,34
2021-09-17,El Dorado,017,186661,14724,14421,1480,15901,127
2021-09-17,Fresno,019,978130,126963,124296,11537,135833,1882
2021-09-17,Glenn,021,27897,3178,3072,917,3989,25
2021-09-17,Humboldt,023,135768,8028,7850,400,8250,80
2021-09-17,Imperial,025,180216,31332,31031,3033,34064,755
2021-09-17,Inyo,027,18085,1664,1634,33,1667,39
2021-09-17,Kern,029,883053,116762,114303,17983,132286,1456
2021-09-17,Kings,031,150075,28892,28240,1645,29885,281
2021-09-17,Lake,033,64148,6089,5915,121,6036,87
2021-09-17,Lassen,035,31185,6284,6080,265,6345,25
2021-09-17,Los Angeles,037,10098052,1390341,1377905,52224,1430129,25820
2021-09-17,Madera,039,155013,20596,20040,1638,21678,257
2021-09-17,Marin,041,260295,16857,16658,391,17049,242
2021-09-17,Mariposa,043,17540,922,869,32,901,5
2021-09-17,Mendocino,045,87422,6696,6498,324,6822,67
2021-09-17,Merced,047,269075,38306,37803,1499,39302,533
2021-09-17,Modoc,049,8938,469,456,161,617,5
2021-09-17,Mono,051,14174,1509,1457,18,1475,3
2021-09-17,Monterey,053,433212,47309,46421,2576,48997,564
2021-09-17,Napa,055,140530,12275,12153,86,12239,95
2021-09-17,Nevada,057,99092,8305,8157,273,8430,84
2021-09-17,Orange,059,3164182,296174,292685,13968,306653,5346
2021-09-17,Placer,061,380077,33863,33188,3177,36365,362
2021-09-17,Plumas,063,18699,1252,1192,24,1216,5
2021-09-17,Riverside,065,2383286,346082,340445,15889,356334,4792
2021-09-17,Sacramento,067,1510023,147285,145985,3712,149697,1999
2021-09-17,San Benito,069,59416,6960,6929,144,7073,67
2021-09-17,San Bernardino,071,2135413,339075,335810,10550,346360,5488
2021-09-17,San Diego,073,3302833,352417,348098,20718,368816,4002
2021-09-17,San Francisco,075,870044,50030,49249,2144,51393,605
2021-09-17,San Joaquin,077,732212,93396,91977,5006,96983,1610
2021-09-17,San Luis Obispo,079,281455,27667,27102,1077,28179,311
2021-09-17,San Mateo,081,765935,51801,50854,780,51634,564
2021-09-17,Santa Barbara,083,443738,41810,41354,1476,42830,498
2021-09-17,Santa Clara,085,1922200,140442,138939,1101,140040,1838
2021-09-17,Santa Cruz,087,273765,19301,19039,976,20015,211
2021-09-17,Shasta,089,179085,18263,17617,2974,20591,254
2021-09-17,Sierra,091,2930,129,124,13,137,0
2021-09-17,Siskiyou,093,43540,3006,2852,1052,3904,35
2021-09-17,Solano,095,438530,43775,42898,1127,44025,312
2021-09-17,Sonoma,097,501317,39152,38808,483,39291,369
2021-09-17,Stanislaus,099,539301,71906,71408,8119,79527,1091
2021-09-17,Sutter,101,95872,12942,12799,242,13041,153
2021-09-17,Tehama,103,63373,7230,7020,1178,8198,84
2021-09-17,Trinity,105,12862,710,556,195,751,7
2021-09-17,Tulare,107,460477,61587,59689,12602,72291,895
2021-09-17,Tuolumne,109,53932,6120,6047,71,6118,89
2021-09-17,Ventura,111,848112,94318,93273,4117,97390,1116
2021-09-17,Yolo,113,214977,18387,18177,935,19112,239
2021-09-17,Yuba,115,75493,9169,9019,205,9224,61
2021-09-16,Alameda,001,1643700,113936,112770,2619,115389,1318
2021-09-16,Alpine,003,1148,99,99,0,99,0
2021-09-16,Amador,005,37829,4926,4819,49,4868,58
2021-09-16,Butte,007,227075,18471,17750,3226,20976,230
2021-09-16,Calaveras,009,45235,3428,3313,34,3347,66
2021-09-16,Colusa,011,21464,2396,2363,536,2899,16
2021-09-16,Contra Costa,013,1133247,94334,93213,1920,95133,917
2021-09-16,Del Norte,015,27424,3439,3285,24,3309,34
2021-09-16,El Dorado,017,186661,14684,14372,1472,15844,127
2021-09-16,Fresno,019,978130,126606,123853,11494,135347,1868
2021-09-16,Glenn,021,27897,3168,3068,915,3983,24
2021-09-16,Humboldt,023,135768,7994,7809,390,8199,80
2021-09-16,Imperial,025,180216,31289,30966,3025,33991,753
2021-09-16,Inyo,027,18085,1662,1623,33,1656,39
2021-09-16,Kern,029,883053,116491,113828,17915,131743,1448
2021-09-16,Kings,031,150075,28806,28114,1636,29750,280
2021-09-16,Lake,033,64148,6065,5890,118,6008,87
2021-09-16,Lassen,035,31185,6249,6028,260,6288,25
2021-09-16,Los Angeles,037,10098052,1388952,1376277,52158,1428435,25796
2021-09-16,Madera,039,155013,20518,19974,1632,21606,257
2021-09-16,Marin,041,260295,16830,16625,390,17015,242
2021-09-16,Mariposa,043,17540,916,849,32,881,6
2021-09-16,Mendocino,045,87422,6658,6445,313,6758,67
2021-09-16,Merced,047,269075,38199,37675,1496,39171,532
2021-09-16,Modoc,049,8938,467,455,161,616,5
2021-09-16,Mono,051,14174,1503,1449,18,1467,3
2021-09-16,Monterey,053,433212,47255,46342,2570,48912,562
2021-09-16,Napa,055,140530,12250,12115,82,12197,95
2021-09-16,Nevada,057,99092,8278,8121,272,8393,84
2021-09-16,Orange,059,3164182,295828,292183,13948,306131,5340
2021-09-16,Placer,061,380077,33767,33037,3158,36195,354
2021-09-16,Plumas,063,18699,1244,1178,24,1202,5
2021-09-16,Riverside,065,2383286,345551,339770,15875,355645,4786
2021-09-16,Sacramento,067,1510023,146929,145754,3680,149434,1996
2021-09-16,San Benito,069,59416,6947,6913,143,7056,67
2021-09-16,San Bernardino,071,2135413,338647,335129,10543,345672,5474
2021-09-16,San Diego,073,3302833,351793,347472,20679,368151,3994
2021-09-16,San Francisco,075,870044,49945,49133,2135,51268,605
2021-09-16,San Joaquin,077,732212,93158,91650,4961,96611,1608
2021-09-16,San Luis Obispo,079,281455,27594,27044,1073,28117,310
2021-09-16,San Mateo,081,765935,51724,50773,778,51551,564
2021-09-16,Santa Barbara,083,443738,41744,41272,1473,42745,497
2021-09-16,Santa Clara,085,1922200,140286,138685,1097,139782,1835
2021-09-16,Santa Cruz,087,273765,19274,19011,976,19987,211
2021-09-16,Shasta,089,179085,18138,17438,2940,20378,251
2021-09-16,Sierra,091,2930,129,123,13,136,0
2021-09-16,Siskiyou,093,43540,2986,2819,1045,3864,35
2021-09-16,Solano,095,438530,43703,42792,1118,43910,312
2021-09-16,Sonoma,097,501317,39089,38707,482,39189,369
2021-09-16,Stanislaus,099,539301,71673,71105,8102,79207,1091
2021-09-16,Sutter,101,95872,12898,12729,236,12965,152
2021-09-16,Tehama,103,63373,7191,6953,1167,8120,83
2021-09-16,Trinity,105,12862,707,547,194,741,7
2021-09-16,Tulare,107,460477,61365,59459,12529,71988,894
2021-09-16,Tuolumne,109,53932,6100,5999,70,6069,89
2021-09-16,Ventura,111,848112,94178,93087,4113,97200,1110
2021-09-16,Yolo,113,214977,18355,18135,933,19068,239
2021-09-16,Yuba,115,75493,9135,8981,202,9183,61
2021-09-15,Alameda,001,1643700,113770,112498,2611,115109,1317
2021-09-15,Alpine,003,1148,99,99,0,99,0
2021-09-15,Amador,005,37829,4918,4792,49,4841,58
2021-09-15,Butte,007,227075,18372,17664,3207,20871,228
2021-09-15,Calaveras,009,45235,3399,3293,32,3325,66
2021-09-15,Colusa,011,21464,2394,2352,533,2885,16
2021-09-15,Contra Costa,013,1133247,94154,92989,1908,94897,913
2021-09-15,Del Norte,015,27424,3426,3271,22,3293,34
2021-09-15,El Dorado,017,186661,14658,14309,1464,15773,127
2021-09-15,Fresno,019,978130,126226,123370,11437,134807,1867
2021-09-15,Glenn,021,27897,3156,3051,910,3961,20
2021-09-15,Humboldt,023,135768,7959,7754,385,8139,52
2021-09-15,Imperial,025,180216,31234,30891,3020,33911,753
2021-09-15,Inyo,027,18085,1658,1614,33,1647,39
2021-09-15,Kern,029,883053,116144,113546,17816,131362,1434
2021-09-15,Kings,031,150075,28727,27991,1627,29618,279
2021-09-15,Lake,033,64148,6033,5852,117,5969,85
2021-09-15,Lassen,035,31185,6189,6018,255,6273,25
2021-09-15,Los Angeles,037,10098052,1387452,1374307,52089,1426396,25767
2021-09-15,Madera,039,155013,20443,19880,1624,21504,257
2021-09-15,Marin,041,260295,16795,16592,385,16977,242
2021-09-15,Mariposa,043,17540,904,843,32,875,5
2021-09-15,Mendocino,045,87422,6628,6399,308,6707,66
2021-09-15,Merced,047,269075,38091,37508,1494,39002,529
2021-09-15,Modoc,049,8938,467,454,161,615,5
2021-09-15,Mono,051,14174,1497,1445,18,1463,3
2021-09-15,Monterey,053,433212,47184,46317,2558,48875,562
2021-09-15,Napa,055,140530,12229,12082,82,12164,95
2021-09-15,Nevada,057,99092,8256,8081,269,8350,84
2021-09-15,Orange,059,3164182,295506,291834,13929,305763,5328
2021-09-15,Placer,061,380077,33655,32860,3137,35997,352
2021-09-15,Plumas,063,18699,1239,1164,23,1187,5
2021-09-15,Riverside,065,2383286,344968,339077,15851,354928,4769
2021-09-15,Sacramento,067,1510023,146502,145202,3649,148851,1981
2021-09-15,San Benito,069,59416,6944,6902,143,7045,67
2021-09-15,San Bernardino,071,2135413,338186,334556,10529,345085,5470
2021-09-15,San Diego,073,3302833,351166,346933,20651,367584,3983
2021-09-15,San Francisco,075,870044,49834,48999,2130,51129,605
2021-09-15,San Joaquin,077,732212,92882,91322,4918,96240,1607
2021-09-15,San Luis Obispo,079,281455,27511,26943,1067,28010,306
2021-09-15,San Mateo,081,765935,51642,50691,775,51466,564
2021-09-15,Santa Barbara,083,443738,41641,41077,1468,42545,497
2021-09-15,Santa Clara,085,1922200,140113,138410,1092,139502,1833
2021-09-15,Santa Cruz,087,273765,19236,18984,974,19958,210
2021-09-15,Shasta,089,179085,18027,17317,2919,20236,250
2021-09-15,Sierra,091,2930,129,123,13,136,0
2021-09-15,Siskiyou,093,43540,2966,2804,1015,3819,35
2021-09-15,Solano,095,438530,43631,42682,1113,43795,312
2021-09-15,Sonoma,097,501317,39031,38629,481,39110,369
2021-09-15,Stanislaus,099,539301,71449,70852,8080,78932,1091
2021-09-15,Sutter,101,95872,12865,12699,231,12930,151
2021-09-15,Tehama,103,63373,7150,6894,1158,8052,79
2021-09-15,Trinity,105,12862,705,541,192,733,7
2021-09-15,Tulare,107,460477,61106,59149,12468,71617,890
2021-09-15,Tuolumne,109,53932,6074,5969,70,6039,89
2021-09-15,Ventura,111,848112,94035,92960,4106,97066,1109
2021-09-15,Yolo,113,214977,18321,18064,925,18989,239
2021-09-15,Yuba,115,75493,9101,8953,202,9155,61
2021-09-14,Alameda,001,1643700,113564,112329,2605,114934,1316
2021-09-14,Alpine,003,1148,99,98,0,98,0
2021-09-14,Amador,005,37829,4898,4790,49,4839,57
2021-09-14,Butte,007,227075,18237,17516,3184,20700,226
2021-09-14,Calaveras,009,45235,3379,3280,29,3309,66
2021-09-14,Colusa,011,21464,2390,2344,529,2873,16
2021-09-14,Contra Costa,013,1133247,93956,92822,1900,94722,908
2021-09-14,Del Norte,015,27424,3410,3252,21,3273,32
2021-09-14,El Dorado,017,186661,14605,14247,1456,15703,123
2021-09-14,Fresno,019,978130,125751,123151,11384,134535,1856
2021-09-14,Glenn,021,27897,3139,3045,906,3951,20
2021-09-14,Humboldt,023,135768,7925,7717,380,8097,52
2021-09-14,Imperial,025,180216,31184,30845,3017,33862,752
2021-09-14,Inyo,027,18085,1649,1605,32,1637,39
2021-09-14,Kern,029,883053,115761,113250,17690,130940,1428
2021-09-14,Kings,031,150075,28651,27955,1619,29574,278
2021-09-14,Lake,033,64148,6001,5845,117,5962,83
2021-09-14,Lassen,035,31185,6175,5977,250,6227,25
2021-09-14,Los Angeles,037,10098052,1385614,1372831,52005,1424836,25729
2021-09-14,Madera,039,155013,20361,19800,1613,21413,254
2021-09-14,Marin,041,260295,16767,16584,383,16967,242
2021-09-14,Mariposa,043,17540,893,834,31,865,5
2021-09-14,Mendocino,045,87422,6592,6372,296,6668,65
2021-09-14,Merced,047,269075,37941,37430,1490,38920,526
2021-09-14,Modoc,049,8938,466,453,161,614,5
2021-09-14,Mono,051,14174,1493,1440,18,1458,4
2021-09-14,Monterey,053,433212,47143,46224,2546,48770,558
2021-09-14,Napa,055,140530,12196,12070,81,12151,91
2021-09-14,Nevada,057,99092,8222,8056,269,8325,83
2021-09-14,Orange,059,3164182,295113,291423,13905,305328,5319
2021-09-14,Placer,061,380077,33523,32735,3117,35852,350
2021-09-14,Plumas,063,18699,1224,1148,23,1171,5
2021-09-14,Riverside,065,2383286,344328,338534,15820,354354,4748
2021-09-14,Sacramento,067,1510023,146117,145051,3601,148652,1977
2021-09-14,San Benito,069,59416,6934,6887,143,7030,64
2021-09-14,San Bernardino,071,2135413,337690,333968,10503,344471,5465
2021-09-14,San Diego,073,3302833,350500,346204,20600,366804,3966
2021-09-14,San Francisco,075,870044,49700,48998,2128,51126,603
2021-09-14,San Joaquin,077,732212,92643,91128,4908,96036,1596
2021-09-14,San Luis Obispo,079,281455,27438,26845,1062,27907,304
2021-09-14,San Mateo,081,765935,51543,50602,772,51374,564
2021-09-14,Santa Barbara,083,443738,41545,40783,1459,42242,495
2021-09-14,Santa Clara,085,1922200,139878,138321,1089,139410,1828
2021-09-14,Santa Cruz,087,273765,19196,18965,972,19937,210
2021-09-14,Shasta,089,179085,17896,17152,2898,20050,246
2021-09-14,Sierra,091,2930,129,123,13,136,0
2021-09-14,Siskiyou,093,43540,2942,2756,998,3754,35
2021-09-14,Solano,095,438530,43548,42599,1110,43709,307
2021-09-14,Sonoma,097,501317,38962,38595,477,39072,369
2021-09-14,Stanislaus,099,539301,71190,70697,8052,78749,1091
2021-09-14,Sutter,101,95872,12823,12670,224,12894,149
2021-09-14,Tehama,103,63373,7096,6859,1150,8009,80
2021-09-14,Trinity,105,12862,699,538,191,729,7
2021-09-14,Tulare,107,460477,60853,58961,12397,71358,888
2021-09-14,Tuolumne,109,53932,6053,5951,68,6019,89
2021-09-14,Ventura,111,848112,93850,92841,4089,96930,1107
2021-09-14,Yolo,113,214977,18277,18039,920,18959,239
2021-09-14,Yuba,115,75493,9065,8928,202,9130,61
2021-09-13,Alameda,001,1643700,113348,112159,2600,114759,1309
2021-09-13,Alpine,003,1148,98,98,0,98,0
2021-09-13,Amador,005,37829,4880,4761,49,4810,56
2021-09-13,Butte,007,227075,18112,17393,3157,20550,225
2021-09-13,Calaveras,009,45235,3353,3253,28,3281,65
2021-09-13,Colusa,011,21464,2381,2346,525,2871,16
2021-09-13,Contra Costa,013,1133247,93710,92658,1895,94553,908
2021-09-13,Del Norte,015,27424,3374,3232,21,3253,28
2021-09-13,El Dorado,017,186661,14544,14194,1448,15642,119
2021-09-13,Fresno,019,978130,125284,122650,11319,133969,1853
2021-09-13,Glenn,021,27897,3125,3026,899,3925,20
2021-09-13,Humboldt,023,135768,7893,7659,377,8036,52
2021-09-13,Imperial,025,180216,31131,30802,3014,33816,751
2021-09-13,Inyo,027,18085,1642,1602,32,1634,39
2021-09-13,Kern,029,883053,115378,112930,17567,130497,1424
2021-09-13,Kings,031,150075,28541,27858,1607,29465,275
2021-09-13,Lake,033,64148,5979,5809,117,5926,82
2021-09-13,Lassen,035,31185,6140,5953,249,6202,25
2021-09-13,Los Angeles,037,10098052,1383750,1371423,51936,1423359,25703
2021-09-13,Madera,039,155013,20291,19735,1598,21333,252
2021-09-13,Marin,041,260295,16731,16557,382,16939,242
2021-09-13,Mariposa,043,17540,879,825,31,856,5
2021-09-13,Mendocino,045,87422,6557,6323,287,6610,61
2021-09-13,Merced,047,269075,37790,37291,1485,38776,521
2021-09-13,Modoc,049,8938,465,451,161,612,5
2021-09-13,Mono,051,14174,1487,1435,18,1453,3
2021-09-13,Monterey,053,433212,47052,46188,2533,48721,558
2021-09-13,Napa,055,140530,12178,12039,81,12120,91
2021-09-13,Nevada,057,99092,8196,8021,267,8288,83
2021-09-13,Orange,059,3164182,294681,291128,13884,305012,5312
2021-09-13,Placer,061,380077,33358,32617,3100,35717,343
2021-09-13,Plumas,063,18699,1215,1142,23,1165,5
2021-09-13,Riverside,065,2383286,343683,337876,15802,353678,4731
2021-09-13,Sacramento,067,1510023,145630,144537,3567,148104,1956
2021-09-13,San Benito,069,59416,6919,6867,142,7009,64
2021-09-13,San Bernardino,071,2135413,337198,333613,10478,344091,5441
2021-09-13,San Diego,073,3302833,349711,345647,20548,366195,3961
2021-09-13,San Francisco,075,870044,49571,48914,2122,51036,603
2021-09-13,San Joaquin,077,732212,92359,90966,4890,95856,1581
2021-09-13,San Luis Obispo,079,281455,27341,26805,1059,27864,300
2021-09-13,San Mateo,081,765935,51453,50525,767,51292,564
2021-09-13,Santa Barbara,083,443738,41426,40661,1452,42113,494
2021-09-13,Santa Clara,085,1922200,139630,138152,1084,139236,1820
2021-09-13,Santa Cruz,087,273765,19156,18917,971,19888,210
2021-09-13,Shasta,089,179085,17766,17033,2857,19890,243
2021-09-13,Sierra,091,2930,129,123,13,136,0
2021-09-13,Siskiyou,093,43540,2927,2745,986,3731,35
2021-09-13,Solano,095,438530,43444,42501,1107,43608,306
2021-09-13,Sonoma,097,501317,38895,38513,474,38987,368
2021-09-13,Stanislaus,099,539301,70936,70477,8016,78493,1091
2021-09-13,Sutter,101,95872,12765,12624,220,12844,145
2021-09-13,Tehama,103,63373,7033,6803,1138,7941,79
2021-09-13,Trinity,105,12862,697,533,189,722,7
2021-09-13,Tulare,107,460477,60569,58768,12336,71104,887
2021-09-13,Tuolumne,109,53932,6022,5909,68,5977,89
2021-09-13,Ventura,111,848112,93688,92679,4081,96760,1107
2021-09-13,Yolo,113,214977,18233,17974,915,18889,239
2021-09-13,Yuba,115,75493,9020,8884,201,9085,61
2021-09-12,Alameda,001,1643700,113085,111961,2597,114558,1309
2021-09-12,Alpine,003,1148,98,98,0,98,0
2021-09-12,Amador,005,37829,4859,4752,49,4801,56
2021-09-12,Butte,007,227075,17967,17257,3113,20370,221
2021-09-12,Calaveras,009,45235,3323,3236,24,3260,65
2021-09-12,Colusa,011,21464,2378,2344,524,2868,16
2021-09-12,Contra Costa,013,1133247,93442,92498,1883,94381,908
2021-09-12,Del Norte,015,27424,3339,3200,21,3221,28
2021-09-12,El Dorado,017,186661,14471,14167,1432,15599,119
2021-09-12,Fresno,019,978130,124764,122407,11262,133669,1853
2021-09-12,Glenn,021,27897,3108,3016,894,3910,20
2021-09-12,Humboldt,023,135768,7823,7636,366,8002,52
2021-09-12,Imperial,025,180216,31068,30790,3009,33799,751
2021-09-12,Inyo,027,18085,1632,1596,30,1626,39
2021-09-12,Kern,029,883053,114966,112602,17408,130010,1424
2021-09-12,Kings,031,150075,28430,27764,1590,29354,274
2021-09-12,Lake,033,64148,5940,5781,115,5896,82
2021-09-12,Lassen,035,31185,6103,5943,239,6182,25
2021-09-12,Los Angeles,037,10098052,1381690,1365968,51860,1417828,25630
2021-09-12,Madera,039,155013,20204,19691,1585,21276,252
2021-09-12,Marin,041,260295,16708,16526,382,16908,242
2021-09-12,Mariposa,043,17540,868,811,29,840,5
2021-09-12,Mendocino,045,87422,6516,6283,278,6561,61
2021-09-12,Merced,047,269075,37618,37172,1474,38646,521
2021-09-12,Modoc,049,8938,465,451,160,611,5
2021-09-12,Mono,051,14174,1480,1431,18,1449,3
2021-09-12,Monterey,053,433212,46952,46167,2523,48690,558
2021-09-12,Napa,055,140530,12148,12011,81,12092,91
2021-09-12,Nevada,057,99092,8156,7987,265,8252,83
2021-09-12,Orange,059,3164182,294217,290718,13863,304581,5312
2021-09-12,Placer,061,380077,33209,32520,3076,35596,343
2021-09-12,Plumas,063,18699,1196,1138,23,1161,5
2021-09-12,Riverside,065,2383286,343000,337332,15768,353100,4731
2021-09-12,Sacramento,067,1510023,145121,144030,3527,147557,1959
2021-09-12,San Benito,069,59416,6900,6852,141,6993,64
2021-09-12,San Bernardino,071,2135413,336583,333049,10465,343514,5439
2021-09-12,San Diego,073,3302833,348891,345058,20472,365530,3942
2021-09-12,San Francisco,075,870044,49460,48819,2115,50934,603
2021-09-12,San Joaquin,077,732212,92030,90730,4882,95612,1581
2021-09-12,San Luis Obispo,079,281455,27222,26729,1046,27775,299
2021-09-12,San Mateo,081,765935,51345,50432,763,51195,564
2021-09-12,Santa Barbara,083,443738,41314,40600,1445,42045,494
2021-09-12,Santa Clara,085,1922200,139375,137899,1081,138980,1820
2021-09-12,Santa Cruz,087,273765,19123,18892,970,19862,210
2021-09-12,Shasta,089,179085,17601,16957,2798,19755,243
2021-09-12,Sierra,091,2930,129,123,13,136,0
2021-09-12,Siskiyou,093,43540,2899,2730,971,3701,35
2021-09-12,Solano,095,438530,43338,42409,1102,43511,306
2021-09-12,Sonoma,097,501317,38816,38456,472,38928,368
2021-09-12,Stanislaus,099,539301,70636,70184,7977,78161,1091
2021-09-12,Sutter,101,95872,12723,12589,214,12803,145
2021-09-12,Tehama,103,63373,6969,6732,1126,7858,79
2021-09-12,Trinity,105,12862,693,529,187,716,7
2021-09-12,Tulare,107,460477,60215,58582,12276,70858,887
2021-09-12,Tuolumne,109,53932,5989,5888,68,5956,89
2021-09-12,Ventura,111,848112,93561,92496,4075,96571,1107
2021-09-12,Yolo,113,214977,18167,17943,907,18850,239
2021-09-12,Yuba,115,75493,8985,8842,201,9043,61
2021-09-11,Alameda,001,1643700,112961,111715,2595,114310,1309
2021-09-11,Alpine,003,1148,98,98,0,98,0
2021-09-11,Amador,005,37829,4846,4728,48,4776,56
2021-09-11,Butte,007,227075,17885,17218,3086,20304,221
2021-09-11,Calaveras,009,45235,3315,3208,23,3231,65
2021-09-11,Colusa,011,21464,2377,2338,521,2859,16
2021-09-11,Contra Costa,013,1133247,93323,92269,1878,94147,908
2021-09-11,Del Norte,015,27424,3323,3184,21,3205,28
2021-09-11,El Dorado,017,186661,14452,14117,1425,15542,119
2021-09-11,Fresno,019,978130,124584,122224,11238,133462,1853
2021-09-11,Glenn,021,27897,3098,3007,891,3898,20
2021-09-11,Humboldt,023,135768,7801,7615,363,7978,52
2021-09-11,Imperial,025,180216,31043,30760,3005,33765,751
2021-09-11,Inyo,027,18085,1629,1590,30,1620,39
2021-09-11,Kern,029,883053,114716,112205,17292,129497,1424
2021-09-11,Kings,031,150075,28381,27631,1584,29215,275
2021-09-11,Lake,033,64148,5919,5761,115,5876,82
2021-09-11,Lassen,035,31185,6088,5930,235,6165,25
2021-09-11,Los Angeles,037,10098052,1380724,1365831,51795,1417626,25630
2021-09-11,Madera,039,155013,20151,19648,1580,21228,252
2021-09-11,Marin,041,260295,16680,16496,381,16877,242
2021-09-11,Mariposa,043,17540,863,799,29,828,5
2021-09-11,Mendocino,045,87422,6492,6257,278,6535,61
2021-09-11,Merced,047,269075,37564,37042,1471,38513,521
2021-09-11,Modoc,049,8938,465,449,160,609,5
2021-09-11,Mono,051,14174,1474,1431,18,1449,3
2021-09-11,Monterey,053,433212,46915,46140,2520,48660,558
2021-09-11,Napa,055,140530,12125,11991,81,12072,91
2021-09-11,Nevada,057,99092,8141,7967,265,8232,83
2021-09-11,Orange,059,3164182,293915,290429,13846,304275,5306
2021-09-11,Placer,061,380077,33126,32414,3065,35479,344
2021-09-11,Plumas,063,18699,1191,1112,23,1135,5
2021-09-11,Riverside,065,2383286,342561,336585,15754,352339,4731
2021-09-11,Sacramento,067,1510023,144820,143557,3515,147072,1955
2021-09-11,San Benito,069,59416,6887,6844,141,6985,64
2021-09-11,San Bernardino,071,2135413,336241,332512,10451,342963,5430
2021-09-11,San Diego,073,3302833,348401,344355,20448,364803,3942
2021-09-11,San Francisco,075,870044,49405,48660,2110,50770,603
2021-09-11,San Joaquin,077,732212,91885,90482,4875,95357,1581
2021-09-11,San Luis Obispo,079,281455,27176,26651,1045,27696,299
2021-09-11,San Mateo,081,765935,51273,50341,763,51104,564
2021-09-11,Santa Barbara,083,443738,41241,40451,1445,41896,494
2021-09-11,Santa Clara,085,1922200,139225,137659,1078,138737,1820
2021-09-11,Santa Cruz,087,273765,19094,18865,970,19835,210
2021-09-11,Shasta,089,179085,17508,16877,2778,19655,243
2021-09-11,Sierra,091,2930,129,123,13,136,0
2021-09-11,Siskiyou,093,43540,2882,2717,968,3685,35
2021-09-11,Solano,095,438530,43287,42344,1099,43443,306
2021-09-11,Sonoma,097,501317,38769,38399,470,38869,368
2021-09-11,Stanislaus,099,539301,70511,69974,7963,77937,1091
2021-09-11,Sutter,101,95872,12697,12538,211,12749,145
2021-09-11,Tehama,103,63373,6948,6703,1118,7821,79
2021-09-11,Trinity,105,12862,686,526,187,713,7
2021-09-11,Tulare,107,460477,60104,58321,12229,70550,889
2021-09-11,Tuolumne,109,53932,5970,5879,65,5944,89
2021-09-11,Ventura,111,848112,93479,92328,4070,96398,1107
2021-09-11,Yolo,113,214977,18144,17906,902,18808,239
2021-09-11,Yuba,115,75493,8960,8813,201,9014,61
2021-09-10,Alameda,001,1643700,112770,111386,2594,113980,1306
2021-09-10,Alpine,003,1148,97,97,0,97,0
2021-09-10,Amador,005,37829,4834,4706,48,4754,56
2021-09-10,Butte,007,227075,17810,17051,3071,20122,222
2021-09-10,Calaveras,009,45235,3306,3183,23,3206,65
2021-09-10,Colusa,011,21464,2373,2327,518,2845,16
2021-09-10,Contra Costa,013,1133247,93200,92024,1876,93900,908
2021-09-10,Del Norte,015,27424,3308,3128,20,3148,28
2021-09-10,El Dorado,017,186661,14421,14051,1421,15472,119
2021-09-10,Fresno,019,978130,124261,121659,11207,132866,1846
2021-09-10,Glenn,021,27897,3091,2977,890,3867,20
2021-09-10,Humboldt,023,135768,7769,7543,359,7902,52
2021-09-10,Imperial,025,180216,31020,30716,3003,33719,751
2021-09-10,Inyo,027,18085,1625,1590,30,1620,39
2021-09-10,Kern,029,883053,114462,111832,17176,129008,1419
2021-09-10,Kings,031,150075,28307,27473,1575,29048,274
2021-09-10,Lake,033,64148,5903,5713,113,5826,79
2021-09-10,Lassen,035,31185,6080,5914,232,6146,25
2021-09-10,Los Angeles,037,10098052,1379515,1365709,51728,1417437,25630
2021-09-10,Madera,039,155013,20105,19520,1573,21093,252
2021-09-10,Marin,041,260295,16660,16458,378,16836,242
2021-09-10,Mariposa,043,17540,858,795,29,824,5
2021-09-10,Mendocino,045,87422,6460,6184,277,6461,61
2021-09-10,Merced,047,269075,37512,36884,1470,38354,521
2021-09-10,Modoc,049,8938,465,448,160,608,5
2021-09-10,Mono,051,14174,1469,1422,18,1440,3
2021-09-10,Monterey,053,433212,46871,46084,2518,48602,557
2021-09-10,Napa,055,140530,12100,11948,81,12029,90
2021-09-10,Nevada,057,99092,8123,7932,264,8196,83
2021-09-10,Orange,059,3164182,293607,290022,13837,303859,5302
2021-09-10,Placer,061,380077,33024,32264,3052,35316,343
2021-09-10,Plumas,063,18699,1183,1111,23,1134,5
2021-09-10,Riverside,065,2383286,342088,335988,15747,351735,4720
2021-09-10,Sacramento,067,1510023,144477,143244,3507,146751,1950
2021-09-10,San Benito,069,59416,6883,6824,141,6965,64
2021-09-10,San Bernardino,071,2135413,335822,331894,10441,342335,5422
2021-09-10,San Diego,073,3302833,347836,343173,20411,363584,3941
2021-09-10,San Francisco,075,870044,49326,48518,2103,50621,602
2021-09-10,San Joaquin,077,732212,91706,90208,4869,95077,1573
2021-09-10,San Luis Obispo,079,281455,27143,26526,1043,27569,299
2021-09-10,San Mateo,081,765935,51206,50251,762,51013,564
2021-09-10,Santa Barbara,083,443738,41188,40321,1442,41763,492
2021-09-10,Santa Clara,085,1922200,139041,137337,1077,138414,1817
2021-09-10,Santa Cruz,087,273765,19075,18785,969,19754,210
2021-09-10,Shasta,089,179085,17414,16667,2750,19417,242
2021-09-10,Sierra,091,2930,129,117,13,130,0
2021-09-10,Siskiyou,093,43540,2870,2702,964,3666,35
2021-09-10,Solano,095,438530,43213,42230,1092,43322,305
2021-09-10,Sonoma,097,501317,38711,38271,469,38740,368
2021-09-10,Stanislaus,099,539301,70355,69617,7939,77556,1091
2021-09-10,Sutter,101,95872,12663,12468,211,12679,145
2021-09-10,Tehama,103,63373,6915,6652,1112,7764,77
2021-09-10,Trinity,105,12862,682,524,187,711,7
2021-09-10,Tulare,107,460477,59956,57930,12182,70112,883
2021-09-10,Tuolumne,109,53932,5952,5842,64,5906,89
2021-09-10,Ventura,111,848112,93382,92145,4066,96211,1104
2021-09-10,Yolo,113,214977,18119,17825,897,18722,239
2021-09-10,Yuba,115,75493,8941,8760,200,8960,62
2021-09-09,Alameda,001,1643700,112550,111014,2590,113604,1306
2021-09-09,Alpine,003,1148,97,94,0,94,0
2021-09-09,Amador,005,37829,4813,4698,47,4745,56
2021-09-09,Butte,007,227075,17664,16874,3045,19919,221
2021-09-09,Calaveras,009,45235,3272,3165,23,3188,65
2021-09-09,Colusa,011,21464,2366,2321,517,2838,16
2021-09-09,Contra Costa,013,1133247,92990,91687,1871,93558,904
2021-09-09,Del Norte,015,27424,3285,3102,20,3122,28
2021-09-09,El Dorado,017,186661,14364,13970,1411,15381,119
2021-09-09,Fresno,019,978130,123786,121040,11160,132200,1838
2021-09-09,Glenn,021,27897,3079,2947,886,3833,20
2021-09-09,Humboldt,023,135768,7719,7471,353,7824,52
2021-09-09,Imperial,025,180216,30982,30661,3000,33661,751
2021-09-09,Inyo,027,18085,1618,1586,30,1616,39
2021-09-09,Kern,029,883053,114114,111390,17019,128409,1414
2021-09-09,Kings,031,150075,28206,27282,1564,28846,273
2021-09-09,Lake,033,64148,5879,5638,111,5749,79
2021-09-09,Lassen,035,31185,6030,5860,226,6086,25
2021-09-09,Los Angeles,037,10098052,1377650,1363735,51653,1415388,25583
2021-09-09,Madera,039,155013,20032,19401,1560,20961,252
2021-09-09,Marin,041,260295,16637,16416,375,16791,242
2021-09-09,Mariposa,043,17540,845,779,28,807,5
2021-09-09,Mendocino,045,87422,6426,6089,268,6357,61
2021-09-09,Merced,047,269075,37358,36634,1457,38091,516
2021-09-09,Modoc,049,8938,465,448,160,608,5
2021-09-09,Mono,051,14174,1459,1420,18,1438,3
2021-09-09,Monterey,053,433212,46817,45991,2507,48498,556
2021-09-09,Napa,055,140530,12068,11878,81,11959,90
2021-09-09,Nevada,057,99092,8085,7855,264,8119,82
2021-09-09,Orange,059,3164182,293197,289109,13806,302915,5299
2021-09-09,Placer,061,380077,32906,32048,3037,35085,342
2021-09-09,Plumas,063,18699,1173,1098,22,1120,5
2021-09-09,Riverside,065,2383286,341449,334774,15729,350503,4701
2021-09-09,Sacramento,067,1510023,143997,142728,3461,146189,1929
2021-09-09,San Benito,069,59416,6873,6820,140,6960,64
2021-09-09,San Bernardino,071,2135413,335258,331040,10429,341469,5417
2021-09-09,San Diego,073,3302833,347111,342149,20354,362503,3929
2021-09-09,San Francisco,075,870044,49212,48404,2094,50498,597
2021-09-09,San Joaquin,077,732212,91431,89874,4851,94725,1570
2021-09-09,San Luis Obispo,079,281455,27061,26472,1040,27512,296
2021-09-09,San Mateo,081,765935,51084,50143,759,50902,561
2021-09-09,Santa Barbara,083,443738,41082,40180,1438,41618,490
2021-09-09,Santa Clara,085,1922200,138818,137017,1072,138089,1816
2021-09-09,Santa Cruz,087,273765,19029,18728,969,19697,210
2021-09-09,Shasta,089,179085,17268,16401,2708,19109,238
2021-09-09,Sierra,091,2930,129,115,13,128,0
2021-09-09,Siskiyou,093,43540,2847,2683,950,3633,35
2021-09-09,Solano,095,438530,43097,42081,1088,43169,303
2021-09-09,Sonoma,097,501317,38643,38171,468,38639,360
2021-09-09,Stanislaus,099,539301,70076,69178,7906,77084,1074
2021-09-09,Sutter,101,95872,12608,12396,209,12605,144
2021-09-09,Tehama,103,63373,6861,6554,1107,7661,75
2021-09-09,Trinity,105,12862,676,523,185,708,6
2021-09-09,Tulare,107,460477,59714,57564,12122,69686,879
2021-09-09,Tuolumne,109,53932,5924,5802,63,5865,89
2021-09-09,Ventura,111,848112,93237,91610,4057,95667,1098
2021-09-09,Yolo,113,214977,18062,17724,894,18618,239
2021-09-09,Yuba,115,75493,8896,8707,197,8904,55
2021-09-08,Alameda,001,1643700,112302,110781,2587,113368,1305
2021-09-08,Alpine,003,1148,97,94,0,94,0
2021-09-08,Amador,005,37829,4801,4693,47,4740,56
2021-09-08,Butte,007,227075,17530,16775,3028,19803,220
2021-09-08,Calaveras,009,45235,3254,3157,23,3180,63
2021-09-08,Colusa,011,21464,2364,2308,517,2825,16
2021-09-08,Contra Costa,013,1133247,92711,91471,1866,93337,900
2021-09-08,Del Norte,015,27424,3262,3085,20,3105,25
2021-09-08,El Dorado,017,186661,14284,13928,1390,15318,119
2021-09-08,Fresno,019,978130,123288,120644,11093,131737,1831
2021-09-08,Glenn,021,27897,3064,2942,877,3819,20
2021-09-08,Humboldt,023,135768,7675,7438,345,7783,52
2021-09-08,Imperial,025,180216,30949,30609,2987,33596,751
2021-09-08,Inyo,027,18085,1607,1580,30,1610,39
2021-09-08,Kern,029,883053,113716,110933,16879,127812,1409
2021-09-08,Kings,031,150075,28077,27235,1549,28784,267
2021-09-08,Lake,033,64148,5849,5618,109,5727,79
2021-09-08,Lassen,035,31185,6012,5848,219,6067,25
2021-09-08,Los Angeles,037,10098052,1375581,1362029,51565,1413594,25533
2021-09-08,Madera,039,155013,19972,19352,1546,20898,252
2021-09-08,Marin,041,260295,16609,16386,374,16760,242
2021-09-08,Mariposa,043,17540,833,777,27,804,5
2021-09-08,Mendocino,045,87422,6382,6069,259,6328,61
2021-09-08,Merced,047,269075,37197,36500,1445,37945,516
2021-09-08,Modoc,049,8938,465,448,160,608,5
2021-09-08,Mono,051,14174,1453,1418,18,1436,3
2021-09-08,Monterey,053,433212,46768,45959,2501,48460,554
2021-09-08,Napa,055,140530,12033,11842,79,11921,90
2021-09-08,Nevada,057,99092,8050,7843,263,8106,82
2021-09-08,Orange,059,3164182,292789,288511,13782,302293,5290
2021-09-08,Placer,061,380077,32769,31852,3020,34872,337
2021-09-08,Plumas,063,18699,1166,1072,22,1094,5
2021-09-08,Riverside,065,2383286,340690,334037,15704,349741,4683
2021-09-08,Sacramento,067,1510023,143518,142448,3412,145860,1921
2021-09-08,San Benito,069,59416,6855,6800,140,6940,64
2021-09-08,San Bernardino,071,2135413,334654,330279,10413,340692,5411
2021-09-08,San Diego,073,3302833,346186,341437,20303,361740,3926
2021-09-08,San Francisco,075,870044,49074,48263,2090,50353,589
2021-09-08,San Joaquin,077,732212,91152,89631,4827,94458,1561
2021-09-08,San Luis Obispo,079,281455,26967,26303,1035,27338,294
2021-09-08,San Mateo,081,765935,50980,50051,759,50810,561
2021-09-08,Santa Barbara,083,443738,40970,40000,1434,41434,490
2021-09-08,Santa Clara,085,1922200,138583,136836,1068,137904,1810
2021-09-08,Santa Cruz,087,273765,18992,18699,969,19668,210
2021-09-08,Shasta,089,179085,17113,16227,2661,18888,234
2021-09-08,Sierra,091,2930,129,113,13,126,0
2021-09-08,Siskiyou,093,43540,2814,2643,939,3582,35
2021-09-08,Solano,095,438530,43005,41971,1085,43056,302
2021-09-08,Sonoma,097,501317,38559,38075,467,38542,360
2021-09-08,Stanislaus,099,539301,69845,68945,7867,76812,1074
2021-09-08,Sutter,101,95872,12543,12349,206,12555,144
2021-09-08,Tehama,103,63373,6794,6520,1090,7610,75
2021-09-08,Trinity,105,12862,673,520,181,701,6
2021-09-08,Tulare,107,460477,59390,57425,12066,69491,876
2021-09-08,Tuolumne,109,53932,5892,5783,61,5844,89
2021-09-08,Ventura,111,848112,93085,91345,4039,95384,1096
2021-09-08,Yolo,113,214977,17980,17680,889,18569,239
2021-09-08,Yuba,115,75493,8854,8675,195,8870,55
2021-09-07,Alameda,001,1643700,112001,110550,2580,113130,1301
2021-09-07,Alpine,003,1148,96,94,0,94,0
2021-09-07,Amador,005,37829,4774,4679,47,4726,53
2021-09-07,Butte,007,227075,17374,16723,2992,19715,220
2021-09-07,Calaveras,009,45235,3214,3140,21,3161,63
2021-09-07,Colusa,011,21464,2354,2306,515,2821,16
2021-09-07,Contra Costa,013,1133247,92448,91167,1860,93027,891
2021-09-07,Del Norte,015,27424,3248,3081,20,3101,24
2021-09-07,El Dorado,017,186661,14212,13892,1375,15267,119
2021-09-07,Fresno,019,978130,122729,120268,10997,131265,1828
2021-09-07,Glenn,021,27897,3052,2937,871,3808,20
2021-09-07,Humboldt,023,135768,7615,7397,328,7725,52
2021-09-07,Imperial,025,180216,30909,30584,2979,33563,751
2021-09-07,Inyo,027,18085,1601,1579,29,1608,39
2021-09-07,Kern,029,883053,113284,110674,16718,127392,1408
2021-09-07,Kings,031,150075,27953,27169,1531,28700,267
2021-09-07,Lake,033,64148,5806,5597,101,5698,78
2021-09-07,Lassen,035,31185,5994,5842,213,6055,21
2021-09-07,Los Angeles,037,10098052,1373347,1360407,51473,1411880,25486
2021-09-07,Madera,039,155013,19885,19316,1538,20854,249
2021-09-07,Marin,041,260295,16570,16363,374,16737,242
2021-09-07,Mariposa,043,17540,817,771,27,798,5
2021-09-07,Mendocino,045,87422,6322,6036,249,6285,61
2021-09-07,Merced,047,269075,37023,36400,1439,37839,513
2021-09-07,Modoc,049,8938,463,449,160,609,5
2021-09-07,Mono,051,14174,1444,1416,18,1434,3
2021-09-07,Monterey,053,433212,46685,45911,2488,48399,543
2021-09-07,Napa,055,140530,11992,11814,79,11893,90
2021-09-07,Nevada,057,99092,8023,7829,263,8092,82
2021-09-07,Orange,059,3164182,292360,288225,13751,301976,5274
2021-09-07,Placer,061,380077,32616,31710,2992,34702,337
2021-09-07,Plumas,063,18699,1151,1071,22,1093,5
2021-09-07,Riverside,065,2383286,339903,333390,15685,349075,4666
2021-09-07,Sacramento,067,1510023,142978,142364,3366,145730,1905
2021-09-07,San Benito,069,59416,6837,6786,140,6926,64
2021-09-07,San Bernardino,071,2135413,333906,329962,10389,340351,5407
2021-09-07,San Diego,073,3302833,345183,340709,20237,360946,3922
2021-09-07,San Francisco,075,870044,48934,48175,2085,50260,589
2021-09-07,San Joaquin,077,732212,90817,89468,4813,94281,1548
2021-09-07,San Luis Obispo,079,281455,26849,26253,1026,27279,287
2021-09-07,San Mateo,081,765935,50887,49913,758,50671,561
2021-09-07,Santa Barbara,083,443738,40844,39957,1429,41386,489
2021-09-07,Santa Clara,085,1922200,138295,136631,1063,137694,1807
2021-09-07,Santa Cruz,087,273765,18943,18669,967,19636,210
2021-09-07,Shasta,089,179085,16957,16096,2608,18704,226
2021-09-07,Sierra,091,2930,129,111,13,124,0
2021-09-07,Siskiyou,093,43540,2788,2607,922,3529,34
2021-09-07,Solano,095,438530,42875,41862,1081,42943,300
2021-09-07,Sonoma,097,501317,38475,38013,465,38478,358
2021-09-07,Stanislaus,099,539301,69572,68831,7839,76670,1074
2021-09-07,Sutter,101,95872,12469,12310,200,12510,138
2021-09-07,Tehama,103,63373,6742,6482,1070,7552,74
2021-09-07,Trinity,105,12862,667,517,181,698,6
2021-09-07,Tulare,107,460477,59040,57228,11987,69215,874
2021-09-07,Tuolumne,109,53932,5855,5759,61,5820,88
2021-09-07,Ventura,111,848112,92874,91246,4029,95275,1093
2021-09-07,Yolo,113,214977,17911,17653,884,18537,235
2021-09-07,Yuba,115,75493,8811,8642,190,8832,55
2021-09-06,Alameda,001,1643700,111687,110357,2572,112929,1301
2021-09-06,Alpine,003,1148,94,94,0,94,0
2021-09-06,Amador,005,37829,4758,4648,46,4694,53
2021-09-06,Butte,007,227075,17181,16588,2949,19537,218
2021-09-06,Calaveras,009,45235,3192,3122,21,3143,63
2021-09-06,Colusa,011,21464,2347,2306,511,2817,16
2021-09-06,Contra Costa,013,1133247,92153,90971,1850,92821,891
2021-09-06,Del Norte,015,27424,3207,3037,19,3056,24
2021-09-06,El Dorado,017,186661,14143,13848,1359,15207,119
2021-09-06,Fresno,019,978130,122155,119738,10922,130660,1828
2021-09-06,Glenn,021,27897,3023,2912,863,3775,20
2021-09-06,Humboldt,023,135768,7539,7320,310,7630,52
2021-09-06,Imperial,025,180216,30846,30576,2973,33549,751
2021-09-06,Inyo,027,18085,1592,1578,17,1595,39
2021-09-06,Kern,029,883053,112772,110347,16530,126877,1408
2021-09-06,Kings,031,150075,27810,27094,1516,28610,264
2021-09-06,Lake,033,64148,5742,5548,94,5642,78
2021-09-06,Lassen,035,31185,5968,5822,203,6025,21
2021-09-06,Los Angeles,037,10098052,1370969,1359348,51356,1410704,25477
2021-09-06,Madera,039,155013,19782,19191,1515,20706,249
2021-09-06,Marin,041,260295,16530,16356,374,16730,242
2021-09-06,Mariposa,043,17540,805,764,27,791,5
2021-09-06,Mendocino,045,87422,6252,5984,236,6220,61
2021-09-06,Merced,047,269075,36809,36300,1425,37725,513
2021-09-06,Modoc,049,8938,460,449,160,609,5
2021-09-06,Mono,051,14174,1440,1416,18,1434,3
2021-09-06,Monterey,053,433212,46591,45833,2471,48304,541
2021-09-06,Napa,055,140530,11949,11792,78,11870,90
2021-09-06,Nevada,057,99092,7975,7748,261,8009,82
2021-09-06,Orange,059,3164182,291866,287948,13698,301646,5274
2021-09-06,Placer,061,380077,32439,31595,2954,34549,337
2021-09-06,Plumas,063,18699,1130,1068,19,1087,5
2021-09-06,Riverside,065,2383286,339088,333052,15665,348717,4666
2021-09-06,Sacramento,067,1510023,142337,141730,3298,145028,1905
2021-09-06,San Benito,069,59416,6814,6777,137,6914,64
2021-09-06,San Bernardino,071,2135413,333023,329693,10358,340051,5398
2021-09-06,San Diego,073,3302833,344173,340222,20140,360362,3922
2021-09-06,San Francisco,075,870044,48800,48120,2078,50198,589
2021-09-06,San Joaquin,077,732212,90471,89293,4787,94080,1548
2021-09-06,San Luis Obispo,079,281455,26720,26183,1022,27205,286
2021-09-06,San Mateo,081,765935,50758,49859,756,50615,561
2021-09-06,Santa Barbara,083,443738,40714,39876,1420,41296,489
2021-09-06,Santa Clara,085,1922200,138004,136458,1061,137519,1807
2021-09-06,Santa Cruz,087,273765,18894,18615,964,19579,210
2021-09-06,Shasta,089,179085,16776,15985,2553,18538,226
2021-09-06,Sierra,091,2930,129,109,13,122,0
2021-09-06,Siskiyou,093,43540,2744,2595,888,3483,34
2021-09-06,Solano,095,438530,42727,41774,1074,42848,300
2021-09-06,Sonoma,097,501317,38354,37929,464,38393,358
2021-09-06,Stanislaus,099,539301,69231,68596,7795,76391,1074
2021-09-06,Sutter,101,95872,12407,12238,191,12429,138
2021-09-06,Tehama,103,63373,6680,6413,1043,7456,74
2021-09-06,Trinity,105,12862,664,515,179,694,6
2021-09-06,Tulare,107,460477,58681,57068,11907,68975,874
2021-09-06,Tuolumne,109,53932,5819,5697,61,5758,88
2021-09-06,Ventura,111,848112,92697,91132,4017,95149,1093
2021-09-06,Yolo,113,214977,17828,17576,878,18454,235
2021-09-06,Yuba,115,75493,8761,8584,186,8770,55
2021-09-05,Alameda,001,1643700,111496,110173,2569,112742,1301
2021-09-05,Alpine,003,1148,94,94,0,94,0
2021-09-05,Amador,005,37829,4746,4642,46,4688,53
2021-09-05,Butte,007,227075,17091,16504,2921,19425,218
2021-09-05,Calaveras,009,45235,3186,3106,21,3127,63
2021-09-05,Colusa,011,21464,2339,2305,509,2814,16
2021-09-05,Contra Costa,013,1133247,91968,90862,1845,92707,891
2021-09-05,Del Norte,015,27424,3187,3023,19,3042,24
2021-09-05,El Dorado,017,186661,14114,13827,1345,15172,119
2021-09-05,Fresno,019,978130,121856,119384,10880,130264,1828
2021-09-05,Glenn,021,27897,3009,2899,861,3760,20
2021-09-05,Humboldt,023,135768,7506,7312,307,7619,52
2021-09-05,Imperial,025,180216,30817,30548,2971,33519,751
2021-09-05,Inyo,027,18085,1589,1572,17,1589,39
2021-09-05,Kern,029,883053,112472,110073,16370,126443,1408
2021-09-05,Kings,031,150075,27733,26989,1512,28501,264
2021-09-05,Lake,033,64148,5722,5525,94,5619,78
2021-09-05,Lassen,035,31185,5946,5820,199,6019,21
2021-09-05,Los Angeles,037,10098052,1369677,1357748,51284,1409032,25465
2021-09-05,Madera,039,155013,19741,19155,1504,20659,249
2021-09-05,Marin,041,260295,16511,16342,373,16715,242
2021-09-05,Mariposa,043,17540,801,761,27,788,5
2021-09-05,Mendocino,045,87422,6218,5965,236,6201,61
2021-09-05,Merced,047,269075,36734,36243,1423,37666,513
2021-09-05,Modoc,049,8938,460,447,160,607,5
2021-09-05,Mono,051,14174,1440,1416,18,1434,3
2021-09-05,Monterey,053,433212,46562,45795,2462,48257,540
2021-09-05,Napa,055,140530,11924,11770,78,11848,90
2021-09-05,Nevada,057,99092,7953,7722,260,7982,82
2021-09-05,Orange,059,3164182,291578,287614,13681,301295,5274
2021-09-05,Placer,061,380077,32311,31487,2940,34427,337
2021-09-05,Plumas,063,18699,1123,1067,19,1086,5
2021-09-05,Riverside,065,2383286,338633,332604,15653,348257,4654
2021-09-05,Sacramento,067,1510023,141899,141276,3280,144556,1905
2021-09-05,San Benito,069,59416,6813,6764,137,6901,64
2021-09-05,San Bernardino,071,2135413,332642,329062,10343,339405,5392
2021-09-05,San Diego,073,3302833,343619,339427,20099,359526,3914
2021-09-05,San Francisco,075,870044,48722,48035,2073,50108,589
2021-09-05,San Joaquin,077,732212,90305,89121,4770,93891,1548
2021-09-05,San Luis Obispo,079,281455,26671,26098,1021,27119,285
2021-09-05,San Mateo,081,765935,50690,49809,752,50561,561
2021-09-05,Santa Barbara,083,443738,40647,39762,1418,41180,489
2021-09-05,Santa Clara,085,1922200,137794,136146,1059,137205,1807
2021-09-05,Santa Cruz,087,273765,18874,18588,962,19550,210
2021-09-05,Shasta,089,179085,16693,15960,2527,18487,226
2021-09-05,Sierra,091,2930,128,109,13,122,0
2021-09-05,Siskiyou,093,43540,2727,2585,874,3459,34
2021-09-05,Solano,095,438530,42632,41687,1069,42756,300
2021-09-05,Sonoma,097,501317,38269,37881,463,38344,358
2021-09-05,Stanislaus,099,539301,69092,68434,7770,76204,1074
2021-09-05,Sutter,101,95872,12377,12179,185,12364,138
2021-09-05,Tehama,103,63373,6654,6400,1037,7437,74
2021-09-05,Trinity,105,12862,658,505,178,683,6
2021-09-05,Tulare,107,460477,58512,56915,11863,68778,874
2021-09-05,Tuolumne,109,53932,5807,5688,61,5749,88
2021-09-05,Ventura,111,848112,92561,91004,4013,95017,1093
2021-09-05,Yolo,113,214977,17791,17557,872,18429,235
2021-09-05,Yuba,115,75493,8734,8521,184,8705,55
2021-09-04,Alameda,001,1643700,111372,109944,2562,112506,1301
2021-09-04,Alpine,003,1148,94,94,0,94,0
2021-09-04,Amador,005,37829,4728,4637,45,4682,53
2021-09-04,Butte,007,227075,17033,16403,2906,19309,218
2021-09-04,Calaveras,009,45235,3174,3087,20,3107,63
2021-09-04,Colusa,011,21464,2337,2301,509,2810,16
2021-09-04,Contra Costa,013,1133247,91851,90623,1842,92465,891
2021-09-04,Del Norte,015,27424,3176,2984,19,3003,24
2021-09-04,El Dorado,017,186661,14088,13782,1337,15119,119
2021-09-04,Fresno,019,978130,121660,119033,10859,129892,1828
2021-09-04,Glenn,021,27897,2999,2878,855,3733,20
2021-09-04,Humboldt,023,135768,7475,7298,301,7599,52
2021-09-04,Imperial,025,180216,30794,30526,2969,33495,751
2021-09-04,Inyo,027,18085,1587,1571,17,1588,39
2021-09-04,Kern,029,883053,112228,109751,16239,125990,1408
2021-09-04,Kings,031,150075,27646,26896,1506,28402,263
2021-09-04,Lake,033,64148,5704,5507,94,5601,78
2021-09-04,Lassen,035,31185,5931,5814,191,6005,21
2021-09-04,Los Angeles,037,10098052,1368728,1355634,51226,1406860,25454
2021-09-04,Madera,039,155013,19708,19112,1497,20609,249
2021-09-04,Marin,041,260295,16495,16319,372,16691,242
2021-09-04,Mariposa,043,17540,796,759,27,786,5
2021-09-04,Mendocino,045,87422,6182,5933,236,6169,61
2021-09-04,Merced,047,269075,36690,36083,1418,37501,513
2021-09-04,Modoc,049,8938,460,447,160,607,5
2021-09-04,Mono,051,14174,1437,1417,18,1435,3
2021-09-04,Monterey,053,433212,46531,45756,2458,48214,540
2021-09-04,Napa,055,140530,11899,11760,76,11836,90
2021-09-04,Nevada,057,99092,7938,7691,259,7950,82
2021-09-04,Orange,059,3164182,291315,287244,13660,300904,5274
2021-09-04,Placer,061,380077,32207,31374,2923,34297,337
2021-09-04,Plumas,063,18699,1115,1067,19,1086,5
2021-09-04,Riverside,065,2383286,338163,331958,15641,347599,4654
2021-09-04,Sacramento,067,1510023,141606,140735,3272,144007,1896
2021-09-04,San Benito,069,59416,6804,6758,137,6895,64
2021-09-04,San Bernardino,071,2135413,332310,328425,10329,338754,5393
2021-09-04,San Diego,073,3302833,343185,338748,20077,358825,3914
2021-09-04,San Francisco,075,870044,48647,47937,2064,50001,589
2021-09-04,San Joaquin,077,732212,90189,88846,4762,93608,1548
2021-09-04,San Luis Obispo,079,281455,26639,26020,1021,27041,285
2021-09-04,San Mateo,081,765935,50636,49721,752,50473,560
2021-09-04,Santa Barbara,083,443738,40581,39667,1416,41083,489
2021-09-04,Santa Clara,085,1922200,137608,135845,1056,136901,1806
2021-09-04,Santa Cruz,087,273765,18856,18579,958,19537,210
2021-09-04,Shasta,089,179085,16616,15924,2501,18425,226
2021-09-04,Sierra,091,2930,126,108,13,121,0
2021-09-04,Siskiyou,093,43540,2701,2563,863,3426,34
2021-09-04,Solano,095,438530,42559,41614,1067,42681,300
2021-09-04,Sonoma,097,501317,38236,37809,463,38272,358
2021-09-04,Stanislaus,099,539301,68944,68210,7745,75955,1074
2021-09-04,Sutter,101,95872,12336,12137,184,12321,138
2021-09-04,Tehama,103,63373,6629,6367,1019,7386,74
2021-09-04,Trinity,105,12862,656,497,178,675,6
2021-09-04,Tulare,107,460477,58404,56719,11820,68539,874
2021-09-04,Tuolumne,109,53932,5789,5667,59,5726,88
2021-09-04,Ventura,111,848112,92426,90904,4010,94914,1090
2021-09-04,Yolo,113,214977,17757,17522,868,18390,235
2021-09-04,Yuba,115,75493,8705,8475,183,8658,55
2021-09-03,Alameda,001,1643700,111218,109636,2559,112195,1301
2021-09-03,Alpine,003,1148,94,94,0,94,0
2021-09-03,Amador,005,37829,4706,4614,45,4659,53
2021-09-03,Butte,007,227075,16943,16259,2880,19139,215
2021-09-03,Calaveras,009,45235,3164,3069,20,3089,63
2021-09-03,Colusa,011,21464,2332,2295,508,2803,16
2021-09-03,Contra Costa,013,1133247,91699,90299,1839,92138,886
2021-09-03,Del Norte,015,27424,3148,2943,18,2961,24
2021-09-03,El Dorado,017,186661,14055,13710,1333,15043,119
2021-09-03,Fresno,019,978130,121325,118508,10837,129345,1822
2021-09-03,Glenn,021,27897,2990,2867,848,3715,20
2021-09-03,Humboldt,023,135768,7450,7194,296,7490,52
2021-09-03,Imperial,025,180216,30771,30475,2964,33439,751
2021-09-03,Inyo,027,18085,1582,1567,17,1584,39
2021-09-03,Kern,029,883053,112012,109296,16128,125424,1407
2021-09-03,Kings,031,150075,27562,26753,1503,28256,263
2021-09-03,Lake,033,64148,5684,5479,92,5571,78
2021-09-03,Lassen,035,31185,5914,5789,186,5975,21
2021-09-03,Los Angeles,037,10098052,1367396,1351185,51159,1402344,25384
2021-09-03,Madera,039,155013,19623,19021,1491,20512,247
2021-09-03,Marin,041,260295,16473,16293,371,16664,242
2021-09-03,Mariposa,043,17540,789,753,25,778,5
2021-09-03,Mendocino,045,87422,6147,5891,236,6127,61
2021-09-03,Merced,047,269075,36636,35941,1409,37350,512
2021-09-03,Modoc,049,8938,460,445,160,605,5
2021-09-03,Mono,051,14174,1436,1410,18,1428,3
2021-09-03,Monterey,053,433212,46493,45707,2454,48161,540
2021-09-03,Napa,055,140530,11878,11733,76,11809,89
2021-09-03,Nevada,057,99092,7904,7632,259,7891,82
2021-09-03,Orange,059,3164182,290997,286818,13633,300451,5253
2021-09-03,Placer,061,380077,32100,31238,2899,34137,335
2021-09-03,Plumas,063,18699,1104,1057,19,1076,5
2021-09-03,Riverside,065,2383286,337631,331011,15625,346636,4653
2021-09-03,Sacramento,067,1510023,141237,139982,3253,143235,1886
2021-09-03,San Benito,069,59416,6798,6746,137,6883,64
2021-09-03,San Bernardino,071,2135413,331896,327599,10318,337917,5381
2021-09-03,San Diego,073,3302833,342565,337627,20044,357671,3911
2021-09-03,San Francisco,075,870044,48571,47822,2058,49880,589
2021-09-03,San Joaquin,077,732212,90036,88366,4754,93120,1540
2021-09-03,San Luis Obispo,079,281455,26563,25917,1019,26936,283
2021-09-03,San Mateo,081,765935,50541,49617,750,50367,560
2021-09-03,Santa Barbara,083,443738,40514,39507,1413,40920,489
2021-09-03,Santa Clara,085,1922200,137406,135522,1052,136574,1801
2021-09-03,Santa Cruz,087,273765,18831,18532,958,19490,210
2021-09-03,Shasta,089,179085,16541,15778,2477,18255,226
2021-09-03,Sierra,091,2930,124,105,13,118,0
2021-09-03,Siskiyou,093,43540,2689,2529,850,3379,34
2021-09-03,Solano,095,438530,42463,41457,1064,42521,300
2021-09-03,Sonoma,097,501317,38173,37699,463,38162,358
2021-09-03,Stanislaus,099,539301,68770,67887,7719,75606,1074
2021-09-03,Sutter,101,95872,12297,12073,183,12256,139
2021-09-03,Tehama,103,63373,6590,6334,1012,7346,72
2021-09-03,Trinity,105,12862,654,490,173,663,6
2021-09-03,Tulare,107,460477,58277,56401,11767,68168,872
2021-09-03,Tuolumne,109,53932,5747,5630,59,5689,88
2021-09-03,Ventura,111,848112,92292,90742,4006,94748,1088
2021-09-03,Yolo,113,214977,17734,17446,862,18308,235
2021-09-03,Yuba,115,75493,8673,8412,183,8595,55
2021-09-02,Alameda,001,1643700,110960,109377,2556,111933,1301
2021-09-02,Alpine,003,1148,93,92,0,92,0
2021-09-02,Amador,005,37829,4690,4606,45,4651,53
2021-09-02,Butte,007,227075,16817,16154,2861,19015,215
2021-09-02,Calaveras,009,45235,3151,3042,20,3062,62
2021-09-02,Colusa,011,21464,2328,2290,508,2798,16
2021-09-02,Contra Costa,013,1133247,91516,90038,1828,91866,886
2021-09-02,Del Norte,015,27424,3117,2891,18,2909,24
2021-09-02,El Dorado,017,186661,13995,13641,1307,14948,119
2021-09-02,Fresno,019,978130,120837,117974,10782,128756,1804
2021-09-02,Glenn,021,27897,2974,2855,842,3697,20
2021-09-02,Humboldt,023,135768,7403,7141,285,7426,52
2021-09-02,Imperial,025,180216,30727,30449,2959,33408,751
2021-09-02,Inyo,027,18085,1577,1564,16,1580,39
2021-09-02,Kern,029,883053,111600,108930,15984,124914,1404
2021-09-02,Kings,031,150075,27469,26638,1493,28131,263
2021-09-02,Lake,033,64148,5654,5432,88,5520,78
2021-09-02,Lassen,035,31185,5900,5747,179,5926,21
2021-09-02,Los Angeles,037,10098052,1365536,1351105,51063,1402168,25382
2021-09-02,Madera,039,155013,19532,18937,1472,20409,247
2021-09-02,Marin,041,260295,16460,16244,369,16613,242
2021-09-02,Mariposa,043,17540,782,745,22,767,5
2021-09-02,Mendocino,045,87422,6105,5848,233,6081,61
2021-09-02,Merced,047,269075,36473,35820,1402,37222,508
2021-09-02,Modoc,049,8938,460,437,160,597,5
2021-09-02,Mono,051,14174,1436,1409,18,1427,3
2021-09-02,Monterey,053,433212,46427,45648,2439,48087,539
2021-09-02,Napa,055,140530,11849,11684,76,11760,88
2021-09-02,Nevada,057,99092,7852,7575,258,7833,82
2021-09-02,Orange,059,3164182,290536,286326,13599,299925,5240
2021-09-02,Placer,061,380077,31962,31067,2870,33937,330
2021-09-02,Plumas,063,18699,1093,1045,18,1063,5
2021-09-02,Riverside,065,2383286,336916,330190,15600,345790,4644
2021-09-02,Sacramento,067,1510023,140653,139274,3214,142488,1882
2021-09-02,San Benito,069,59416,6793,6734,136,6870,64
2021-09-02,San Bernardino,071,2135413,331290,326940,10245,337185,5369
2021-09-02,San Diego,073,3302833,341599,336382,19991,356373,3909
2021-09-02,San Francisco,075,870044,48463,47674,2054,49728,587
2021-09-02,San Joaquin,077,732212,89752,88056,4730,92786,1540
2021-09-02,San Luis Obispo,079,281455,26478,25851,1014,26865,283
2021-09-02,San Mateo,081,765935,50442,49490,747,50237,558
2021-09-02,Santa Barbara,083,443738,40424,39386,1400,40786,486
2021-09-02,Santa Clara,085,1922200,137105,135216,1046,136262,1799
2021-09-02,Santa Cruz,087,273765,18797,18473,955,19428,210
2021-09-02,Shasta,089,179085,16403,15670,2448,18118,224
2021-09-02,Sierra,091,2930,124,105,13,118,0
2021-09-02,Siskiyou,093,43540,2668,2513,822,3335,34
2021-09-02,Solano,095,438530,42357,41293,1061,42354,294
2021-09-02,Sonoma,097,501317,38092,37558,463,38021,352
2021-09-02,Stanislaus,099,539301,68528,67576,7697,75273,1074
2021-09-02,Sutter,101,95872,12228,11995,179,12174,138
2021-09-02,Tehama,103,63373,6531,6265,993,7258,72
2021-09-02,Trinity,105,12862,650,484,171,655,6
2021-09-02,Tulare,107,460477,58047,56105,11714,67819,872
2021-09-02,Tuolumne,109,53932,5691,5578,59,5637,88
2021-09-02,Ventura,111,848112,92109,90610,4001,94611,1084
2021-09-02,Yolo,113,214977,17665,17357,851,18208,235
2021-09-02,Yuba,115,75493,8613,8363,183,8546,55
2021-09-01,Alameda,001,1643700,110692,109075,2550,111625,1299
2021-09-01,Alpine,003,1148,93,92,0,92,0
2021-09-01,Amador,005,37829,4674,4599,44,4643,53
2021-09-01,Butte,007,227075,16704,16046,2836,18882,215
2021-09-01,Calaveras,009,45235,3139,3023,20,3043,59
2021-09-01,Colusa,011,21464,2323,2281,507,2788,16
2021-09-01,Contra Costa,013,1133247,91281,89834,1821,91655,877
2021-09-01,Del Norte,015,27424,3084,2860,18,2878,24
2021-09-01,El Dorado,017,186661,13939,13577,1280,14857,119
2021-09-01,Fresno,019,978130,120346,117492,10713,128205,1800
2021-09-01,Glenn,021,27897,2949,2846,834,3680,20
2021-09-01,Humboldt,023,135768,7356,7090,278,7368,52
2021-09-01,Imperial,025,180216,30690,30393,2954,33347,750
2021-09-01,Inyo,027,18085,1573,1561,15,1576,39
2021-09-01,Kern,029,883053,111169,108449,15842,124291,1400
2021-09-01,Kings,031,150075,27356,26443,1482,27925,263
2021-09-01,Lake,033,64148,5612,5396,83,5479,77
2021-09-01,Lassen,035,31185,5878,5731,175,5906,21
2021-09-01,Los Angeles,037,10098052,1363274,1348589,50956,1399545,25341
2021-09-01,Madera,039,155013,19454,18852,1457,20309,247
2021-09-01,Marin,041,260295,16438,16224,364,16588,240
2021-09-01,Mariposa,043,17540,774,735,22,757,5
2021-09-01,Mendocino,045,87422,6062,5821,228,6049,59
2021-09-01,Merced,047,269075,36296,35686,1392,37078,500
2021-09-01,Modoc,049,8938,454,436,158,594,5
2021-09-01,Mono,051,14174,1436,1400,18,1418,3
2021-09-01,Monterey,053,433212,46347,45590,2424,48014,539
2021-09-01,Napa,055,140530,11816,11653,76,11729,88
2021-09-01,Nevada,057,99092,7799,7508,257,7765,82
2021-09-01,Orange,059,3164182,290062,285840,13561,299401,5233
2021-09-01,Placer,061,380077,31807,30902,2856,33758,330
2021-09-01,Plumas,063,18699,1085,1033,18,1051,5
2021-09-01,Riverside,065,2383286,336100,329388,15570,344958,4634
2021-09-01,Sacramento,067,1510023,140044,138499,3168,141667,1875
2021-09-01,San Benito,069,59416,6776,6716,136,6852,64
2021-09-01,San Bernardino,071,2135413,330639,326250,10216,336466,5364
2021-09-01,San Diego,073,3302833,340569,335302,19935,355237,3908
2021-09-01,San Francisco,075,870044,48354,47538,2047,49585,584
2021-09-01,San Joaquin,077,732212,89430,87640,4707,92347,1540
2021-09-01,San Luis Obispo,079,281455,26382,25691,1009,26700,283
2021-09-01,San Mateo,081,765935,50322,49394,741,50135,558
2021-09-01,Santa Barbara,083,443738,40307,39263,1384,40647,483
2021-09-01,Santa Clara,085,1922200,136837,134855,1039,135894,1796
2021-09-01,Santa Cruz,087,273765,18750,18453,953,19406,210
2021-09-01,Shasta,089,179085,16271,15552,2407,17959,221
2021-09-01,Sierra,091,2930,123,98,13,111,0
2021-09-01,Siskiyou,093,43540,2638,2482,802,3284,34
2021-09-01,Solano,095,438530,42206,41194,1055,42249,293
2021-09-01,Sonoma,097,501317,37997,37454,462,37916,352
2021-09-01,Stanislaus,099,539301,68241,67287,7666,74953,1075
2021-09-01,Sutter,101,95872,12164,11945,172,12117,136
2021-09-01,Tehama,103,63373,6497,6228,976,7204,72
2021-09-01,Trinity,105,12862,649,482,168,650,5
2021-09-01,Tulare,107,460477,57764,55768,11677,67445,870
2021-09-01,Tuolumne,109,53932,5652,5553,59,5612,88
2021-09-01,Ventura,111,848112,91894,90471,3985,94456,1089
2021-09-01,Yolo,113,214977,17609,17264,845,18109,235
2021-09-01,Yuba,115,75493,8551,8308,183,8491,55
2021-08-31,Alameda,001,1643700,110399,108837,2543,111380,1297
2021-08-31,Alpine,003,1148,91,92,0,92,0
2021-08-31,Amador,005,37829,4653,4555,44,4599,53
2021-08-31,Butte,007,227075,16562,15896,2795,18691,216
2021-08-31,Calaveras,009,45235,3099,3008,20,3028,59
2021-08-31,Colusa,011,21464,2321,2275,505,2780,16
2021-08-31,Contra Costa,013,1133247,90985,89546,1809,91355,871
2021-08-31,Del Norte,015,27424,3048,2830,18,2848,19
2021-08-31,El Dorado,017,186661,13869,13539,1263,14802,119
2021-08-31,Fresno,019,978130,119771,117155,10633,127788,1801
2021-08-31,Glenn,021,27897,2933,2829,823,3652,20
2021-08-31,Humboldt,023,135768,7281,7030,265,7295,52
2021-08-31,Imperial,025,180216,30653,30348,2946,33294,750
2021-08-31,Inyo,027,18085,1569,1550,15,1565,39
2021-08-31,Kern,029,883053,110667,108151,15663,123814,1393
2021-08-31,Kings,031,150075,27214,26405,1468,27873,260
2021-08-31,Lake,033,64148,5568,5359,80,5439,74
2021-08-31,Lassen,035,31185,5852,5702,172,5874,21
2021-08-31,Los Angeles,037,10098052,1360685,1346686,50876,1397562,25303
2021-08-31,Madera,039,155013,19364,18811,1439,20250,247
2021-08-31,Marin,041,260295,16409,16215,361,16576,240
2021-08-31,Mariposa,043,17540,766,732,22,754,5
2021-08-31,Mendocino,045,87422,6020,5777,226,6003,59
2021-08-31,Merced,047,269075,36126,35512,1387,36899,498
2021-08-31,Modoc,049,8938,453,436,158,594,5
2021-08-31,Mono,051,14174,1424,1398,18,1416,3
2021-08-31,Monterey,053,433212,46263,45550,2411,47961,539
2021-08-31,Napa,055,140530,11769,11618,76,11694,88
2021-08-31,Nevada,057,99092,7732,7460,257,7717,82
2021-08-31,Orange,059,3164182,289463,285310,13527,298837,5229
2021-08-31,Placer,061,380077,31618,30745,2818,33563,325
2021-08-31,Plumas,063,18699,1081,1018,17,1035,5
2021-08-31,Riverside,065,2383286,335126,328556,15537,344093,4627
2021-08-31,Sacramento,067,1510023,139359,137879,3136,141015,1863
2021-08-31,San Benito,069,59416,6764,6694,134,6828,64
2021-08-31,San Bernardino,071,2135413,329890,325446,10196,335642,5350
2021-08-31,San Diego,073,3302833,339310,334377,19877,354254,3888
2021-08-31,San Francisco,075,870044,48204,47440,2036,49476,581
2021-08-31,San Joaquin,077,732212,88985,87365,4692,92057,1540
2021-08-31,San Luis Obispo,079,281455,26259,25518,1005,26523,282
2021-08-31,San Mateo,081,765935,50210,49299,741,50040,556
2021-08-31,Santa Barbara,083,443738,40156,39091,1378,40469,481
2021-08-31,Santa Clara,085,1922200,136487,134637,1032,135669,1793
2021-08-31,Santa Cruz,087,273765,18711,18419,950,19369,210
2021-08-31,Shasta,089,179085,16119,15368,2380,17748,220
2021-08-31,Sierra,091,2930,120,95,13,108,0
2021-08-31,Siskiyou,093,43540,2618,2435,786,3221,33
2021-08-31,Solano,095,438530,42067,41067,1048,42115,289
2021-08-31,Sonoma,097,501317,37901,37379,461,37840,352
2021-08-31,Stanislaus,099,539301,67886,67004,7631,74635,1075
2021-08-31,Sutter,101,95872,12099,11901,168,12069,136
2021-08-31,Tehama,103,63373,6437,6169,945,7114,72
2021-08-31,Trinity,105,12862,643,480,168,648,3
2021-08-31,Tulare,107,460477,57431,55567,11605,67172,870
2021-08-31,Tuolumne,109,53932,5616,5516,59,5575,88
2021-08-31,Ventura,111,848112,91675,90292,3973,94265,1081
2021-08-31,Yolo,113,214977,17529,17205,836,18041,234
2021-08-31,Yuba,115,75493,8497,8253,183,8436,54
2021-08-30,Alameda,001,1643700,110075,107734,2532,110266,1296
2021-08-30,Alpine,003,1148,91,92,0,92,0
2021-08-30,Amador,005,37829,4642,4507,44,4551,53
2021-08-30,Butte,007,227075,16411,15719,2762,18481,214
2021-08-30,Calaveras,009,45235,3084,2975,20,2995,59
2021-08-30,Colusa,011,21464,2312,2271,502,2773,16
2021-08-30,Contra Costa,013,1133247,90726,87679,1799,89478,872
2021-08-30,Del Norte,015,27424,3006,2796,17,2813,11
2021-08-30,El Dorado,017,186661,13800,13217,1246,14463,119
2021-08-30,Fresno,019,978130,119198,115867,10562,126429,1790
2021-08-30,Glenn,021,27897,2922,2804,817,3621,20
2021-08-30,Humboldt,023,135768,7227,6930,259,7189,52
2021-08-30,Imperial,025,180216,30615,30311,2941,33252,750
2021-08-30,Inyo,027,18085,1564,1544,15,1559,39
2021-08-30,Kern,029,883053,110188,107615,15499,123114,1389
2021-08-30,Kings,031,150075,27098,26236,1453,27689,259
2021-08-30,Lake,033,64148,5533,5323,77,5400,74
2021-08-30,Lassen,035,31185,5830,5667,166,5833,21
2021-08-30,Los Angeles,037,10098052,1358225,1344949,50789,1395738,25269
2021-08-30,Madera,039,155013,19282,18622,1419,20041,247
2021-08-30,Marin,041,260295,16378,16160,361,16521,240
2021-08-30,Mariposa,043,17540,760,715,21,736,5
2021-08-30,Mendocino,045,87422,5986,5721,222,5943,55
2021-08-30,Merced,047,269075,35998,35335,1383,36718,497
2021-08-30,Modoc,049,8938,451,436,157,593,5
2021-08-30,Mono,051,14174,1423,1390,18,1408,3
2021-08-30,Monterey,053,433212,46201,45463,2394,47857,539
2021-08-30,Napa,055,140530,11720,11579,74,11653,87
2021-08-30,Nevada,057,99092,7673,7356,254,7610,82
2021-08-30,Orange,059,3164182,288881,284750,13478,298228,5223
2021-08-30,Placer,061,380077,31453,29825,2795,32620,319
2021-08-30,Plumas,063,18699,1064,998,17,1015,5
2021-08-30,Riverside,065,2383286,334229,327593,15506,343099,4623
2021-08-30,Sacramento,067,1510023,138702,134571,3090,137661,1847
2021-08-30,San Benito,069,59416,6755,6663,134,6797,64
2021-08-30,San Bernardino,071,2135413,329212,324870,10166,335036,5348
2021-08-30,San Diego,073,3302833,338039,333011,19797,352808,3885
2021-08-30,San Francisco,075,870044,48065,46966,2022,48988,581
2021-08-30,San Joaquin,077,732212,88654,86203,4671,90874,1528
2021-08-30,San Luis Obispo,079,281455,26134,25422,998,26420,280
2021-08-30,San Mateo,081,765935,50084,48839,735,49574,554
2021-08-30,Santa Barbara,083,443738,40005,38998,1373,40371,481
2021-08-30,Santa Clara,085,1922200,136166,133281,1025,134306,1789
2021-08-30,Santa Cruz,087,273765,18657,18326,946,19272,210
2021-08-30,Shasta,089,179085,15990,15238,2338,17576,217
2021-08-30,Sierra,091,2930,118,91,13,104,0
2021-08-30,Siskiyou,093,43540,2605,2411,775,3186,33
2021-08-30,Solano,095,438530,41906,39986,1044,41030,290
2021-08-30,Sonoma,097,501317,37795,36764,461,37225,352
2021-08-30,Stanislaus,099,539301,67547,66173,7600,73773,1074
2021-08-30,Sutter,101,95872,12029,11791,161,11952,136
2021-08-30,Tehama,103,63373,6358,6085,921,7006,71
2021-08-30,Trinity,105,12862,632,468,165,633,3
2021-08-30,Tulare,107,460477,57119,55140,11529,66669,870
2021-08-30,Tuolumne,109,53932,5570,5492,59,5551,74
2021-08-30,Ventura,111,848112,91459,90149,3961,94110,1082
2021-08-30,Yolo,113,214977,17467,17071,832,17903,231
2021-08-30,Yuba,115,75493,8423,8129,182,8311,54
2021-08-29,Alameda,001,1643700,109731,107494,2520,110014,1296
2021-08-29,Alpine,003,1148,91,92,0,92,0
2021-08-29,Amador,005,37829,4628,4501,44,4545,53
2021-08-29,Butte,007,227075,16241,15602,2725,18327,214
2021-08-29,Calaveras,009,45235,3051,2970,20,2990,59
2021-08-29,Colusa,011,21464,2305,2260,496,2756,16
2021-08-29,Contra Costa,013,1133247,90429,87439,1794,89233,872
2021-08-29,Del Norte,015,27424,2963,2752,17,2769,11
2021-08-29,El Dorado,017,186661,13745,13166,1235,14401,119
2021-08-29,Fresno,019,978130,118601,115502,10492,125994,1790
2021-08-29,Glenn,021,27897,2904,2778,810,3588,20
2021-08-29,Humboldt,023,135768,7183,6922,244,7166,52
2021-08-29,Imperial,025,180216,30554,30293,2930,33223,750
2021-08-29,Inyo,027,18085,1554,1543,14,1557,39
2021-08-29,Kern,029,883053,109737,107324,15329,122653,1389
2021-08-29,Kings,031,150075,26945,26143,1438,27581,259
2021-08-29,Lake,033,64148,5493,5293,67,5360,74
2021-08-29,Lassen,035,31185,5807,5666,162,5828,21
2021-08-29,Los Angeles,037,10098052,1355466,1342541,50677,1393218,25263
2021-08-29,Madera,039,155013,19195,18594,1403,19997,247
2021-08-29,Marin,041,260295,16347,16134,359,16493,240
2021-08-29,Mariposa,043,17540,754,709,19,728,5
2021-08-29,Mendocino,045,87422,5928,5689,209,5898,55
2021-08-29,Merced,047,269075,35759,35250,1371,36621,497
2021-08-29,Modoc,049,8938,448,436,157,593,5
2021-08-29,Mono,051,14174,1416,1387,18,1405,3
2021-08-29,Monterey,053,433212,46095,45424,2370,47794,539
2021-08-29,Napa,055,140530,11689,11552,74,11626,87
2021-08-29,Nevada,057,99092,7616,7294,253,7547,82
2021-08-29,Orange,059,3164182,288254,284432,13436,297868,5223
2021-08-29,Placer,061,380077,31280,29674,2754,32428,319
2021-08-29,Plumas,063,18699,1053,996,17,1013,5
2021-08-29,Riverside,065,2383286,333372,326987,15485,342472,4623
2021-08-29,Sacramento,067,1510023,137949,133981,3041,137022,1843
2021-08-29,San Benito,069,59416,6730,6646,134,6780,64
2021-08-29,San Bernardino,071,2135413,328425,324266,10132,334398,5347
2021-08-29,San Diego,073,3302833,336933,332014,19701,351715,3880
2021-08-29,San Francisco,075,870044,47930,46885,2010,48895,581
2021-08-29,San Joaquin,077,732212,88207,85922,4650,90572,1528
2021-08-29,San Luis Obispo,079,281455,25936,25288,990,26278,280
2021-08-29,San Mateo,081,765935,49971,48737,730,49467,554
2021-08-29,Santa Barbara,083,443738,39839,38900,1369,40269,481
2021-08-29,Santa Clara,085,1922200,135812,132979,1019,133998,1789
2021-08-29,Santa Cruz,087,273765,18609,18285,944,19229,210
2021-08-29,Shasta,089,179085,15836,15198,2311,17509,217
2021-08-29,Sierra,091,2930,116,91,13,104,0
2021-08-29,Siskiyou,093,43540,2558,2407,755,3162,33
2021-08-29,Solano,095,438530,41752,39887,1037,40924,290
2021-08-29,Sonoma,097,501317,37659,36650,457,37107,352
2021-08-29,Stanislaus,099,539301,67202,65956,7564,73520,1074
2021-08-29,Sutter,101,95872,11970,11719,154,11873,136
2021-08-29,Tehama,103,63373,6287,6040,898,6938,71
2021-08-29,Trinity,105,12862,629,468,161,629,3
2021-08-29,Tulare,107,460477,56786,54974,11445,66419,870
2021-08-29,Tuolumne,109,53932,5545,5478,58,5536,74
2021-08-29,Ventura,111,848112,91201,90114,3952,94066,1082
2021-08-29,Yolo,113,214977,17368,17015,820,17835,231
2021-08-29,Yuba,115,75493,8359,8042,182,8224,54
2021-08-28,Alameda,001,1643700,109565,107007,2511,109518,1296
2021-08-28,Alpine,003,1148,91,92,0,92,0
2021-08-28,Amador,005,37829,4609,4484,43,4527,53
2021-08-28,Butte,007,227075,16182,15487,2697,18184,214
2021-08-28,Calaveras,009,45235,3041,2926,20,2946,59
2021-08-28,Colusa,011,21464,2301,2252,494,2746,16
2021-08-28,Contra Costa,013,1133247,90217,86938,1791,88729,872
2021-08-28,Del Norte,015,27424,2936,2734,16,2750,11
2021-08-28,El Dorado,017,186661,13705,13089,1229,14318,119
2021-08-28,Fresno,019,978130,118360,115079,10461,125540,1792
2021-08-28,Glenn,021,27897,2895,2773,803,3576,20
2021-08-28,Humboldt,023,135768,7148,6887,239,7126,52
2021-08-28,Imperial,025,180216,30527,30260,2927,33187,750
2021-08-28,Inyo,027,18085,1552,1539,14,1553,39
2021-08-28,Kern,029,883053,109499,107012,15187,122199,1389
2021-08-28,Kings,031,150075,26878,26059,1435,27494,257
2021-08-28,Lake,033,64148,5470,5267,63,5330,74
2021-08-28,Lassen,035,31185,5792,5665,161,5826,21
2021-08-28,Los Angeles,037,10098052,1354256,1337097,50604,1387701,25234
2021-08-28,Madera,039,155013,19144,18553,1389,19942,247
2021-08-28,Marin,041,260295,16332,16106,359,16465,240
2021-08-28,Mariposa,043,17540,752,704,19,723,5
2021-08-28,Mendocino,045,87422,5903,5658,209,5867,55
2021-08-28,Merced,047,269075,35707,35108,1368,36476,497
2021-08-28,Modoc,049,8938,448,436,156,592,5
2021-08-28,Mono,051,14174,1413,1385,18,1403,3
2021-08-28,Monterey,053,433212,46053,45394,2365,47759,539
2021-08-28,Napa,055,140530,11666,11512,73,11585,88
2021-08-28,Nevada,057,99092,7592,7238,251,7489,82
2021-08-28,Orange,059,3164182,287896,283953,13387,297340,5222
2021-08-28,Placer,061,380077,31171,29428,2741,32169,319
2021-08-28,Plumas,063,18699,1046,991,17,1008,5
2021-08-28,Riverside,065,2383286,332784,326222,15475,341697,4623
2021-08-28,Sacramento,067,1510023,137557,132985,3025,136010,1844
2021-08-28,San Benito,069,59416,6723,6636,134,6770,64
2021-08-28,San Bernardino,071,2135413,327977,323672,10124,333796,5348
2021-08-28,San Diego,073,3302833,336349,331330,19665,350995,3880
2021-08-28,San Francisco,075,870044,47858,46654,2003,48657,581
2021-08-28,San Joaquin,077,732212,88038,85481,4641,90122,1527
2021-08-28,San Luis Obispo,079,281455,25869,25138,985,26123,280
2021-08-28,San Mateo,081,765935,49897,48575,726,49301,554
2021-08-28,Santa Barbara,083,443738,39768,38780,1368,40148,481
2021-08-28,Santa Clara,085,1922200,135605,132488,1017,133505,1789
2021-08-28,Santa Cruz,087,273765,18593,18240,941,19181,210
2021-08-28,Shasta,089,179085,15733,15147,2292,17439,217
2021-08-28,Sierra,091,2930,112,91,13,104,0
2021-08-28,Siskiyou,093,43540,2550,2402,744,3146,33
2021-08-28,Solano,095,438530,41703,39610,1036,40646,290
2021-08-28,Sonoma,097,501317,37586,36466,455,36921,352
2021-08-28,Stanislaus,099,539301,67044,65670,7547,73217,1074
2021-08-28,Sutter,101,95872,11949,11669,153,11822,136
2021-08-28,Tehama,103,63373,6262,6004,885,6889,71
2021-08-28,Trinity,105,12862,625,463,160,623,3
2021-08-28,Tulare,107,460477,56656,54746,11403,66149,870
2021-08-28,Tuolumne,109,53932,5529,5469,58,5527,74
2021-08-28,Ventura,111,848112,91083,89934,3950,93884,1081
2021-08-28,Yolo,113,214977,17332,16907,813,17720,231
2021-08-28,Yuba,115,75493,8328,7985,181,8166,55
2021-08-27,Alameda,001,1643700,109357,106622,2508,109130,1296
2021-08-27,Alpine,003,1148,91,92,0,92,0
2021-08-27,Amador,005,37829,4593,4458,42,4500,53
2021-08-27,Butte,007,227075,16102,15277,2678,17955,214
2021-08-27,Calaveras,009,45235,3027,2903,20,2923,59
2021-08-27,Colusa,011,21464,2295,2240,492,2732,16
2021-08-27,Contra Costa,013,1133247,90018,86386,1788,88174,872
2021-08-27,Del Norte,015,27424,2904,2695,16,2711,11
2021-08-27,El Dorado,017,186661,13666,12968,1225,14193,119
2021-08-27,Fresno,019,978130,117926,114481,10437,124918,1774
2021-08-27,Glenn,021,27897,2877,2754,794,3548,20
2021-08-27,Humboldt,023,135768,7115,6782,236,7018,52
2021-08-27,Imperial,025,180216,30507,30201,2924,33125,750
2021-08-27,Inyo,027,18085,1551,1529,14,1543,39
2021-08-27,Kern,029,883053,109205,106570,15077,121647,1385
2021-08-27,Kings,031,150075,26799,25957,1433,27390,257
2021-08-27,Lake,033,64148,5445,5228,62,5290,74
2021-08-27,Lassen,035,31185,5776,5646,156,5802,21
2021-08-27,Los Angeles,037,10098052,1352733,1337006,50537,1387543,25230
2021-08-27,Madera,039,155013,19088,18476,1376,19852,247
2021-08-27,Marin,041,260295,16316,16055,357,16412,240
2021-08-27,Mariposa,043,17540,746,690,19,709,5
2021-08-27,Mendocino,045,87422,5872,5602,208,5810,55
2021-08-27,Merced,047,269075,35653,34906,1359,36265,495
2021-08-27,Modoc,049,8938,448,434,156,590,5
2021-08-27,Mono,051,14174,1408,1385,18,1403,3
2021-08-27,Monterey,053,433212,46004,45337,2357,47694,539
2021-08-27,Napa,055,140530,11632,11460,73,11533,87
2021-08-27,Nevada,057,99092,7552,7169,249,7418,82
2021-08-27,Orange,059,3164182,287535,283407,13348,296755,5206
2021-08-27,Placer,061,380077,31041,29157,2721,31878,320
2021-08-27,Plumas,063,18699,1040,984,17,1001,5
2021-08-27,Riverside,065,2383286,332266,325379,15460,340839,4622
2021-08-27,Sacramento,067,1510023,137122,131921,3012,134933,1838
2021-08-27,San Benito,069,59416,6717,6622,134,6756,64
2021-08-27,San Bernardino,071,2135413,327453,322893,10106,332999,5342
2021-08-27,San Diego,073,3302833,335568,330162,19611,349773,3877
2021-08-27,San Francisco,075,870044,47782,46456,1985,48441,581
2021-08-27,San Joaquin,077,732212,87855,84949,4622,89571,1524
2021-08-27,San Luis Obispo,079,281455,25821,24952,982,25934,280
2021-08-27,San Mateo,081,765935,49822,48424,722,49146,553
2021-08-27,Santa Barbara,083,443738,39676,38675,1366,40041,480
2021-08-27,Santa Clara,085,1922200,135375,132011,1014,133025,1783
2021-08-27,Santa Cruz,087,273765,18554,18163,937,19100,210
2021-08-27,Shasta,089,179085,15653,14996,2276,17272,217
2021-08-27,Sierra,091,2930,111,91,13,104,0
2021-08-27,Siskiyou,093,43540,2535,2358,730,3088,33
2021-08-27,Solano,095,438530,41589,39347,1032,40379,287
2021-08-27,Sonoma,097,501317,37514,36326,454,36780,342
2021-08-27,Stanislaus,099,539301,66834,65167,7509,72676,1061
2021-08-27,Sutter,101,95872,11903,11590,151,11741,135
2021-08-27,Tehama,103,63373,6229,5964,870,6834,71
2021-08-27,Trinity,105,12862,625,458,159,617,3
2021-08-27,Tulare,107,460477,56520,54443,11358,65801,870
2021-08-27,Tuolumne,109,53932,5497,5438,58,5496,74
2021-08-27,Ventura,111,848112,90954,89774,3946,93720,1076
2021-08-27,Yolo,113,214977,17289,16805,808,17613,231
2021-08-27,Yuba,115,75493,8271,7926,181,8107,54
2021-08-26,Alameda,001,1643700,109078,106146,2499,108645,1296
2021-08-26,Alpine,003,1148,91,92,0,92,0
2021-08-26,Amador,005,37829,4578,4442,41,4483,53
2021-08-26,Butte,007,227075,15969,15159,2643,17802,214
2021-08-26,Calaveras,009,45235,3016,2873,20,2893,59
2021-08-26,Colusa,011,21464,2288,2234,488,2722,16
2021-08-26,Contra Costa,013,1133247,89659,85808,1782,87590,866
2021-08-26,Del Norte,015,27424,2868,2625,16,2641,8
2021-08-26,El Dorado,017,186661,13597,12863,1211,14074,118
2021-08-26,Fresno,019,978130,117422,113854,10382,124236,1770
2021-08-26,Glenn,021,27897,2859,2740,785,3525,20
2021-08-26,Humboldt,023,135768,7057,6695,226,6921,53
2021-08-26,Imperial,025,180216,30458,30121,2916,33037,748
2021-08-26,Inyo,027,18085,1541,1521,13,1534,39
2021-08-26,Kern,029,883053,108777,106051,14934,120985,1380
2021-08-26,Kings,031,150075,26676,25838,1425,27263,260
2021-08-26,Lake,033,64148,5399,5196,59,5255,74
2021-08-26,Lassen,035,31185,5764,5626,154,5780,21
2021-08-26,Los Angeles,037,10098052,1350463,1334372,50441,1384813,25199
2021-08-26,Madera,039,155013,19018,18393,1363,19756,247
2021-08-26,Marin,041,260295,16287,15983,354,16337,240
2021-08-26,Mariposa,043,17540,736,677,19,696,5
2021-08-26,Mendocino,045,87422,5834,5533,203,5736,55
2021-08-26,Merced,047,269075,35486,34755,1338,36093,495
2021-08-26,Modoc,049,8938,448,433,156,589,5
2021-08-26,Mono,051,14174,1404,1385,18,1403,3
2021-08-26,Monterey,053,433212,45931,45265,2346,47611,539
2021-08-26,Napa,055,140530,11610,11394,72,11466,87
2021-08-26,Nevada,057,99092,7493,7086,246,7332,80
2021-08-26,Orange,059,3164182,287043,282814,13325,296139,5200
2021-08-26,Placer,061,380077,30872,28898,2695,31593,319
2021-08-26,Plumas,063,18699,1033,971,16,987,5
2021-08-26,Riverside,065,2383286,331474,324486,15439,339925,4615
2021-08-26,Sacramento,067,1510023,136589,130977,2971,133948,1827
2021-08-26,San Benito,069,59416,6707,6604,134,6738,64
2021-08-26,San Bernardino,071,2135413,326793,322100,10082,332182,5339
2021-08-26,San Diego,073,3302833,334542,328276,19546,347822,3869
2021-08-26,San Francisco,075,870044,47655,46288,1980,48268,581
2021-08-26,San Joaquin,077,732212,87477,84429,4599,89028,1513
2021-08-26,San Luis Obispo,079,281455,25672,24831,975,25806,278
2021-08-26,San Mateo,081,765935,49694,48263,720,48983,553
2021-08-26,Santa Barbara,083,443738,39592,38566,1365,39931,479
2021-08-26,Santa Clara,085,1922200,135049,131443,1010,132453,1782
2021-08-26,Santa Cruz,087,273765,18494,18072,935,19007,210
2021-08-26,Shasta,089,179085,15531,14891,2249,17140,217
2021-08-26,Sierra,091,2930,109,90,13,103,0
2021-08-26,Siskiyou,093,43540,2513,2342,716,3058,33
2021-08-26,Solano,095,438530,41440,39027,1024,40051,286
2021-08-26,Sonoma,097,501317,37425,36102,454,36556,337
2021-08-26,Stanislaus,099,539301,66537,64785,7468,72253,1061
2021-08-26,Sutter,101,95872,11843,11499,148,11647,135
2021-08-26,Tehama,103,63373,6171,5913,857,6770,68
2021-08-26,Trinity,105,12862,620,450,157,607,3
2021-08-26,Tulare,107,460477,56263,54157,11312,65469,870
2021-08-26,Tuolumne,109,53932,5477,5387,58,5445,74
2021-08-26,Ventura,111,848112,90768,89595,3937,93532,1080
2021-08-26,Yolo,113,214977,17224,16727,797,17524,231
2021-08-26,Yuba,115,75493,8198,7834,179,8013,54
2021-08-25,Alameda,001,1643700,108755,105636,2492,108128,1296
2021-08-25,Alpine,003,1148,91,92,0,92,0
2021-08-25,Amador,005,37829,4563,4415,41,4456,53
2021-08-25,Butte,007,227075,15863,15039,2601,17640,214
2021-08-25,Calaveras,009,45235,2997,2851,20,2871,59
2021-08-25,Colusa,011,21464,2281,2227,479,2706,16
2021-08-25,Contra Costa,013,1133247,89275,85322,1776,87098,863
2021-08-25,Del Norte,015,27424,2823,2573,16,2589,8
2021-08-25,El Dorado,017,186661,13538,12787,1195,13982,118
2021-08-25,Fresno,019,978130,116881,113384,10339,123723,1761
2021-08-25,Glenn,021,27897,2841,2728,770,3498,20
2021-08-25,Humboldt,023,135768,6988,6653,216,6869,52
2021-08-25,Imperial,025,180216,30421,30085,2910,32995,748
2021-08-25,Inyo,027,18085,1537,1518,13,1531,39
2021-08-25,Kern,029,883053,108346,105687,14778,120465,1379
2021-08-25,Kings,031,150075,26569,25676,1418,27094,258
2021-08-25,Lake,033,64148,5369,5163,56,5219,74
2021-08-25,Lassen,035,31185,5747,5583,153,5736,21
2021-08-25,Los Angeles,037,10098052,1347860,1331400,50343,1381743,25170
2021-08-25,Madera,039,155013,18954,18311,1340,19651,247
2021-08-25,Marin,041,260295,16265,15938,348,16286,240
2021-08-25,Mariposa,043,17540,730,676,19,695,5
2021-08-25,Mendocino,045,87422,5799,5486,197,5683,53
2021-08-25,Merced,047,269075,35354,34600,1325,35925,492
2021-08-25,Modoc,049,8938,448,433,156,589,5
2021-08-25,Mono,051,14174,1400,1382,18,1400,3
2021-08-25,Monterey,053,433212,45857,45196,2331,47527,539
2021-08-25,Napa,055,140530,11576,11348,71,11419,87
2021-08-25,Nevada,057,99092,7427,7000,245,7245,77
2021-08-25,Orange,059,3164182,286517,282061,13291,295352,5193
2021-08-25,Placer,061,380077,30696,28740,2662,31402,319
2021-08-25,Plumas,063,18699,1018,962,16,978,5
2021-08-25,Riverside,065,2383286,330629,323548,15417,338965,4610
2021-08-25,Sacramento,067,1510023,135909,130046,2932,132978,1827
2021-08-25,San Benito,069,59416,6686,6587,133,6720,64
2021-08-25,San Bernardino,071,2135413,326099,321228,10061,331289,5337
2021-08-25,San Diego,073,3302833,333274,327166,19462,346628,3859
2021-08-25,San Francisco,075,870044,47506,46107,1975,48082,578
2021-08-25,San Joaquin,077,732212,87092,84002,4583,88585,1510
2021-08-25,San Luis Obispo,079,281455,25480,24607,971,25578,276
2021-08-25,San Mateo,081,765935,49571,48153,717,48870,553
2021-08-25,Santa Barbara,083,443738,39463,38450,1365,39815,479
2021-08-25,Santa Clara,085,1922200,134680,130995,1007,132002,1783
2021-08-25,Santa Cruz,087,273765,18434,17987,932,18919,210
2021-08-25,Shasta,089,179085,15402,14752,2217,16969,217
2021-08-25,Sierra,091,2930,106,90,13,103,0
2021-08-25,Siskiyou,093,43540,2468,2322,697,3019,33
2021-08-25,Solano,095,438530,41269,38848,1012,39860,286
2021-08-25,Sonoma,097,501317,37301,35986,451,36437,336
2021-08-25,Stanislaus,099,539301,66256,64441,7436,71877,1061
2021-08-25,Sutter,101,95872,11775,11451,144,11595,134
2021-08-25,Tehama,103,63373,6112,5861,840,6701,68
2021-08-25,Trinity,105,12862,614,450,156,606,3
2021-08-25,Tulare,107,460477,55978,53877,11241,65118,866
2021-08-25,Tuolumne,109,53932,5451,5354,58,5412,74
2021-08-25,Ventura,111,848112,90584,89379,3923,93302,1068
2021-08-25,Yolo,113,214977,17159,16667,787,17454,231
2021-08-25,Yuba,115,75493,8132,7771,178,7949,54
2021-08-24,Alameda,001,1643700,108433,105319,2482,107801,1296
2021-08-24,Alpine,003,1148,91,92,0,92,0
2021-08-24,Amador,005,37829,4544,4380,41,4421,50
2021-08-24,Butte,007,227075,15708,14964,2567,17531,214
2021-08-24,Calaveras,009,45235,2958,2811,20,2831,59
2021-08-24,Colusa,011,21464,2273,2221,474,2695,16
2021-08-24,Contra Costa,013,1133247,88912,84963,1770,86733,857
2021-08-24,Del Norte,015,27424,2796,2543,16,2559,8
2021-08-24,El Dorado,017,186661,13461,12732,1179,13911,118
2021-08-24,Fresno,019,978130,116275,113024,10279,123303,1761
2021-08-24,Glenn,021,27897,2825,2717,763,3480,20
2021-08-24,Humboldt,023,135768,6925,6585,203,6788,52
2021-08-24,Imperial,025,180216,30360,30045,2904,32949,748
2021-08-24,Inyo,027,18085,1532,1512,13,1525,39
2021-08-24,Kern,029,883053,107882,105399,14611,120010,1375
2021-08-24,Kings,031,150075,26448,25629,1402,27031,258
2021-08-24,Lake,033,64148,5334,5135,56,5191,72
2021-08-24,Lassen,035,31185,5731,5576,151,5727,21
2021-08-24,Los Angeles,037,10098052,1344995,1328777,50233,1379010,25135
2021-08-24,Madera,039,155013,18878,18251,1323,19574,247
2021-08-24,Marin,041,260295,16229,15900,344,16244,240
2021-08-24,Mariposa,043,17540,723,670,19,689,5
2021-08-24,Mendocino,045,87422,5756,5416,190,5606,52
2021-08-24,Merced,047,269075,35186,34490,1314,35804,491
2021-08-24,Modoc,049,8938,448,432,156,588,5
2021-08-24,Mono,051,14174,1398,1382,18,1400,3
2021-08-24,Monterey,053,433212,45791,45126,2313,47439,539
2021-08-24,Napa,055,140530,11543,11299,70,11369,85
2021-08-24,Nevada,057,99092,7357,6981,243,7224,77
2021-08-24,Orange,059,3164182,285918,281461,13265,294726,5187
2021-08-24,Placer,061,380077,30493,28618,2623,31241,318
2021-08-24,Plumas,063,18699,1008,953,16,969,5
2021-08-24,Riverside,065,2383286,329756,322620,15386,338006,4605
2021-08-24,Sacramento,067,1510023,135225,129542,2884,132426,1812
2021-08-24,San Benito,069,59416,6673,6576,133,6709,64
2021-08-24,San Bernardino,071,2135413,325344,320300,10031,330331,5328
2021-08-24,San Diego,073,3302833,331829,325823,19362,345185,3851
2021-08-24,San Francisco,075,870044,47331,46010,1964,47974,574
2021-08-24,San Joaquin,077,732212,86652,83684,4545,88229,1508
2021-08-24,San Luis Obispo,079,281455,25302,24443,960,25403,274
2021-08-24,San Mateo,081,765935,49422,48050,715,48765,553
2021-08-24,Santa Barbara,083,443738,39332,38307,1364,39671,478
2021-08-24,Santa Clara,085,1922200,134256,130763,1003,131766,1779
2021-08-24,Santa Cruz,087,273765,18359,17928,926,18854,209
2021-08-24,Shasta,089,179085,15294,14664,2185,16849,217
2021-08-24,Sierra,091,2930,103,90,13,103,0
2021-08-24,Siskiyou,093,43540,2446,2294,682,2976,33
2021-08-24,Solano,095,438530,41060,38724,1000,39724,283
2021-08-24,Sonoma,097,501317,37172,35849,449,36298,336
2021-08-24,Stanislaus,099,539301,65929,64195,7382,71577,1058
2021-08-24,Sutter,101,95872,11708,11384,141,11525,134
2021-08-24,Tehama,103,63373,6066,5826,826,6652,67
2021-08-24,Trinity,105,12862,603,446,148,594,3
2021-08-24,Tulare,107,460477,55626,53702,11151,64853,856
2021-08-24,Tuolumne,109,53932,5420,5287,58,5345,74
2021-08-24,Ventura,111,848112,90400,89167,3912,93079,1068
2021-08-24,Yolo,113,214977,17083,16492,774,17266,231
2021-08-24,Yuba,115,75493,8049,7723,176,7899,54
2021-08-23,Alameda,001,1643700,108019,104922,2469,107391,1294
2021-08-23,Alpine,003,1148,91,91,0,91,0
2021-08-23,Amador,005,37829,4530,4369,41,4410,50
2021-08-23,Butte,007,227075,15563,14847,2532,17379,211
2021-08-23,Calaveras,009,45235,2930,2803,20,2823,59
2021-08-23,Colusa,011,21464,2269,2206,471,2677,16
2021-08-23,Contra Costa,013,1133247,88532,84651,1763,86414,857
2021-08-23,Del Norte,015,27424,2750,2499,16,2515,8
2021-08-23,El Dorado,017,186661,13358,12684,1157,13841,118
2021-08-23,Fresno,019,978130,115714,112445,10229,122674,1759
2021-08-23,Glenn,021,27897,2809,2696,753,3449,20
2021-08-23,Humboldt,023,135768,6852,6498,188,6686,52
2021-08-23,Imperial,025,180216,30309,30011,2901,32912,748
2021-08-23,Inyo,027,18085,1525,1509,13,1522,39
2021-08-23,Kern,029,883053,107427,104995,14456,119451,1375
2021-08-23,Kings,031,150075,26317,25465,1396,26861,257
2021-08-23,Lake,033,64148,5294,5099,54,5153,69
2021-08-23,Lassen,035,31185,5719,5562,151,5713,21
2021-08-23,Los Angeles,037,10098052,1342029,1326412,50101,1376513,25096
2021-08-23,Madera,039,155013,18792,18155,1308,19463,246
2021-08-23,Marin,041,260295,16181,15856,340,16196,240
2021-08-23,Mariposa,043,17540,712,645,19,664,5
2021-08-23,Mendocino,045,87422,5689,5374,183,5557,51
2021-08-23,Merced,047,269075,35004,34322,1309,35631,488
2021-08-23,Modoc,049,8938,445,431,155,586,6
2021-08-23,Mono,051,14174,1394,1384,18,1402,3
2021-08-23,Monterey,053,433212,45691,45047,2302,47349,538
2021-08-23,Napa,055,140530,11505,11257,70,11327,85
2021-08-23,Nevada,057,99092,7276,6930,241,7171,77
2021-08-23,Orange,059,3164182,285282,280891,13230,294121,5181
2021-08-23,Placer,061,380077,30293,28540,2585,31125,314
2021-08-23,Plumas,063,18699,1000,934,16,950,5
2021-08-23,Riverside,065,2383286,328843,321650,15360,337010,4598
2021-08-23,Sacramento,067,1510023,134438,128969,2817,131786,1807
2021-08-23,San Benito,069,59416,6655,6562,131,6693,64
2021-08-23,San Bernardino,071,2135413,324541,319577,9992,329569,5324
2021-08-23,San Diego,073,3302833,330388,324536,19248,343784,3848
2021-08-23,San Francisco,075,870044,47177,45945,1955,47900,573
2021-08-23,San Joaquin,077,732212,86219,83466,4511,87977,1499
2021-08-23,San Luis Obispo,079,281455,25120,24317,958,25275,274
2021-08-23,San Mateo,081,765935,49284,47935,712,48647,553
2021-08-23,Santa Barbara,083,443738,39153,38181,1362,39543,478
2021-08-23,Santa Clara,085,1922200,133856,130489,998,131487,1778
2021-08-23,Santa Cruz,087,273765,18302,17871,924,18795,209
2021-08-23,Shasta,089,179085,15168,14537,2146,16683,216
2021-08-23,Sierra,091,2930,103,90,13,103,0
2021-08-23,Siskiyou,093,43540,2425,2274,661,2935,33
2021-08-23,Solano,095,438530,40907,38612,991,39603,283
2021-08-23,Sonoma,097,501317,37052,35769,448,36217,336
2021-08-23,Stanislaus,099,539301,65596,63922,7343,71265,1058
2021-08-23,Sutter,101,95872,11619,11314,133,11447,133
2021-08-23,Tehama,103,63373,6012,5805,808,6613,67
2021-08-23,Trinity,105,12862,600,435,145,580,3
2021-08-23,Tulare,107,460477,55319,53370,11079,64449,856
2021-08-23,Tuolumne,109,53932,5378,5240,58,5298,73
2021-08-23,Ventura,111,848112,90181,88960,3900,92860,1063
2021-08-23,Yolo,113,214977,16995,16445,759,17204,226
2021-08-23,Yuba,115,75493,7978,7653,174,7827,54
2021-08-22,Alameda,001,1643700,107570,104539,2441,106980,1294
2021-08-22,Alpine,003,1148,91,91,0,91,0
2021-08-22,Amador,005,37829,4500,4349,41,4390,50
2021-08-22,Butte,007,227075,15424,14791,2496,17287,211
2021-08-22,Calaveras,009,45235,2893,2771,20,2791,59
2021-08-22,Colusa,011,21464,2262,2201,465,2666,16
2021-08-22,Contra Costa,013,1133247,87991,84371,1750,86121,857
2021-08-22,Del Norte,015,27424,2690,2455,16,2471,8
2021-08-22,El Dorado,017,186661,13254,12629,1137,13766,118
2021-08-22,Fresno,019,978130,115114,112057,10160,122217,1759
2021-08-22,Glenn,021,27897,2781,2678,740,3418,20
2021-08-22,Humboldt,023,135768,6774,6483,170,6653,52
2021-08-22,Imperial,025,180216,30251,29993,2896,32889,748
2021-08-22,Inyo,027,18085,1519,1505,13,1518,39
2021-08-22,Kern,029,883053,106902,104691,14302,118993,1375
2021-08-22,Kings,031,150075,26159,25391,1379,26770,257
2021-08-22,Lake,033,64148,5248,5069,51,5120,69
2021-08-22,Lassen,035,31185,5687,5556,147,5703,21
2021-08-22,Los Angeles,037,10098052,1338721,1324151,49966,1374117,25089
2021-08-22,Madera,039,155013,18673,18120,1293,19413,246
2021-08-22,Marin,041,260295,16129,15822,332,16154,240
2021-08-22,Mariposa,043,17540,702,638,17,655,5
2021-08-22,Mendocino,045,87422,5630,5336,183,5519,51
2021-08-22,Merced,047,269075,34801,34234,1296,35530,488
2021-08-22,Modoc,049,8938,443,431,155,586,6
2021-08-22,Mono,051,14174,1392,1378,18,1396,3
2021-08-22,Monterey,053,433212,45592,45017,2288,47305,538
2021-08-22,Napa,055,140530,11460,11231,70,11301,85
2021-08-22,Nevada,057,99092,7202,6864,239,7103,77
2021-08-22,Orange,059,3164182,284590,280390,13185,293575,5181
2021-08-22,Placer,061,380077,30084,28395,2549,30944,314
2021-08-22,Plumas,063,18699,981,923,15,938,5
2021-08-22,Riverside,065,2383286,327822,320836,15311,336147,4594
2021-08-22,Sacramento,067,1510023,133662,128231,2777,131008,1802
2021-08-22,San Benito,069,59416,6638,6550,131,6681,64
2021-08-22,San Bernardino,071,2135413,323574,318839,9957,328796,5324
2021-08-22,San Diego,073,3302833,329066,323591,19143,342734,3848
2021-08-22,San Francisco,075,870044,47011,45831,1945,47776,573
2021-08-22,San Joaquin,077,732212,85761,83121,4476,87597,1498
2021-08-22,San Luis Obispo,079,281455,24914,24250,951,25201,274
2021-08-22,San Mateo,081,765935,49108,47821,707,48528,553
2021-08-22,Santa Barbara,083,443738,38972,38099,1354,39453,478
2021-08-22,Santa Clara,085,1922200,133439,130189,991,131180,1778
2021-08-22,Santa Cruz,087,273765,18244,17823,919,18742,209
2021-08-22,Shasta,089,179085,15031,14478,2110,16588,216
2021-08-22,Sierra,091,2930,103,87,13,100,0
2021-08-22,Siskiyou,093,43540,2396,2261,643,2904,33
2021-08-22,Solano,095,438530,40708,38489,978,39467,283
2021-08-22,Sonoma,097,501317,36896,35676,445,36121,336
2021-08-22,Stanislaus,099,539301,65245,63683,7253,70936,1058
2021-08-22,Sutter,101,95872,11537,11251,129,11380,133
2021-08-22,Tehama,103,63373,5966,5791,789,6580,67
2021-08-22,Trinity,105,12862,593,433,143,576,3
2021-08-22,Tulare,107,460477,54999,53220,10994,64214,856
2021-08-22,Tuolumne,109,53932,5335,5214,58,5272,73
2021-08-22,Ventura,111,848112,89972,88791,3883,92674,1063
2021-08-22,Yolo,113,214977,16893,16374,750,17124,226
2021-08-22,Yuba,115,75493,7905,7626,173,7799,54
2021-08-21,Alameda,001,1643700,107365,104281,2434,106715,1294
2021-08-21,Alpine,003,1148,91,91,0,91,0
2021-08-21,Amador,005,37829,4490,4338,39,4377,50
2021-08-21,Butte,007,227075,15356,14714,2475,17189,211
2021-08-21,Calaveras,009,45235,2877,2744,20,2764,59
2021-08-21,Colusa,011,21464,2256,2192,461,2653,16
2021-08-21,Contra Costa,013,1133247,87732,84136,1742,85878,857
2021-08-21,Del Norte,015,27424,2667,2409,16,2425,8
2021-08-21,El Dorado,017,186661,13210,12590,1133,13723,118
2021-08-21,Fresno,019,978130,114914,111765,10147,121912,1759
2021-08-21,Glenn,021,27897,2768,2654,732,3386,20
2021-08-21,Humboldt,023,135768,6736,6446,164,6610,52
2021-08-21,Imperial,025,180216,30208,29976,2893,32869,748
2021-08-21,Inyo,027,18085,1516,1500,13,1513,39
2021-08-21,Kern,029,883053,106646,104443,14178,118621,1375
2021-08-21,Kings,031,150075,26088,25313,1374,26687,257
2021-08-21,Lake,033,64148,5228,5055,49,5104,69
2021-08-21,Lassen,035,31185,5673,5553,147,5700,21
2021-08-21,Los Angeles,037,10098052,1337421,1321308,49872,1371180,25080
2021-08-21,Madera,039,155013,18635,18067,1287,19354,246
2021-08-21,Marin,041,260295,16095,15775,330,16105,240
2021-08-21,Mariposa,043,17540,692,634,17,651,5
2021-08-21,Mendocino,045,87422,5584,5307,182,5489,51
2021-08-21,Merced,047,269075,34696,34148,1291,35439,488
2021-08-21,Modoc,049,8938,443,430,155,585,6
2021-08-21,Mono,051,14174,1392,1378,18,1396,3
2021-08-21,Monterey,053,433212,45545,44969,2281,47250,538
2021-08-21,Napa,055,140530,11425,11211,70,11281,85
2021-08-21,Nevada,057,99092,7158,6810,237,7047,77
2021-08-21,Orange,059,3164182,284138,279855,13151,293006,5181
2021-08-21,Placer,061,380077,29946,28289,2524,30813,314
2021-08-21,Plumas,063,18699,977,916,14,930,5
2021-08-21,Riverside,065,2383286,327241,320086,15298,335384,4594
2021-08-21,Sacramento,067,1510023,133167,127751,2765,130516,1809
2021-08-21,San Benito,069,59416,6628,6542,130,6672,64
2021-08-21,San Bernardino,071,2135413,323122,318293,9936,328229,5324
2021-08-21,San Diego,073,3302833,328410,322620,19094,341714,3848
2021-08-21,San Francisco,075,870044,46909,45637,1938,47575,573
2021-08-21,San Joaquin,077,732212,85544,82825,4462,87287,1498
2021-08-21,San Luis Obispo,079,281455,24856,24169,951,25120,273
2021-08-21,San Mateo,081,765935,49013,47685,707,48392,553
2021-08-21,Santa Barbara,083,443738,38890,37951,1350,39301,478
2021-08-21,Santa Clara,085,1922200,133174,129911,987,130898,1778
2021-08-21,Santa Cruz,087,273765,18207,17763,914,18677,209
2021-08-21,Shasta,089,179085,14957,14417,2096,16513,217
2021-08-21,Sierra,091,2930,98,85,13,98,0
2021-08-21,Siskiyou,093,43540,2382,2246,632,2878,33
2021-08-21,Solano,095,438530,40597,38423,968,39391,281
2021-08-21,Sonoma,097,501317,36809,35582,444,36026,336
2021-08-21,Stanislaus,099,539301,65063,63512,7235,70747,1058
2021-08-21,Sutter,101,95872,11492,11204,127,11331,133
2021-08-21,Tehama,103,63373,5941,5757,782,6539,67
2021-08-21,Trinity,105,12862,588,431,141,572,3
2021-08-21,Tulare,107,460477,54856,53045,10950,63995,857
2021-08-21,Tuolumne,109,53932,5304,5193,58,5251,73
2021-08-21,Ventura,111,848112,89828,88558,3868,92426,1063
2021-08-21,Yolo,113,214977,16846,16322,744,17066,226
2021-08-21,Yuba,115,75493,7859,7580,172,7752,54
2021-08-20,Alameda,001,1643700,107125,103812,2426,106238,1294
2021-08-20,Alpine,003,1148,91,91,0,91,0
2021-08-20,Amador,005,37829,4464,4323,39,4362,50
2021-08-20,Butte,007,227075,15283,14617,2454,17071,211
2021-08-20,Calaveras,009,45235,2856,2717,20,2737,59
2021-08-20,Colusa,011,21464,2251,2178,459,2637,16
2021-08-20,Contra Costa,013,1133247,87457,83721,1735,85456,857
2021-08-20,Del Norte,015,27424,2635,2316,16,2332,8
2021-08-20,El Dorado,017,186661,13172,12495,1125,13620,118
2021-08-20,Fresno,019,978130,114558,111315,10114,121429,1759
2021-08-20,Glenn,021,27897,2761,2642,722,3364,20
2021-08-20,Humboldt,023,135768,6684,6349,159,6508,52
2021-08-20,Imperial,025,180216,30185,29934,2893,32827,747
2021-08-20,Inyo,027,18085,1510,1495,13,1508,39
2021-08-20,Kern,029,883053,106362,104048,14050,118098,1373
2021-08-20,Kings,031,150075,26022,25241,1372,26613,256
2021-08-20,Lake,033,64148,5213,5024,46,5070,69
2021-08-20,Lassen,035,31185,5653,5539,147,5686,21
2021-08-20,Los Angeles,037,10098052,1335545,1317541,49769,1367310,25049
2021-08-20,Madera,039,155013,18586,18018,1272,19290,246
2021-08-20,Marin,041,260295,16077,15727,326,16053,240
2021-08-20,Mariposa,043,17540,687,630,17,647,5
2021-08-20,Mendocino,045,87422,5538,5241,181,5422,51
2021-08-20,Merced,047,269075,34632,34035,1281,35316,486
2021-08-20,Modoc,049,8938,443,429,155,584,6
2021-08-20,Mono,051,14174,1391,1368,18,1386,3
2021-08-20,Monterey,053,433212,45507,44890,2274,47164,538
2021-08-20,Napa,055,140530,11393,11152,70,11222,83
2021-08-20,Nevada,057,99092,7116,6753,231,6984,77
2021-08-20,Orange,059,3164182,283693,279193,13130,292323,5179
2021-08-20,Placer,061,380077,29851,28156,2495,30651,313
2021-08-20,Plumas,063,18699,967,908,14,922,5
2021-08-20,Riverside,065,2383286,326545,319072,15267,334339,4594
2021-08-20,Sacramento,067,1510023,132692,127226,2748,129974,1797
2021-08-20,San Benito,069,59416,6614,6508,130,6638,64
2021-08-20,San Bernardino,071,2135413,322509,317372,9907,327279,5322
2021-08-20,San Diego,073,3302833,327501,321102,19024,340126,3846
2021-08-20,San Francisco,075,870044,46812,45432,1923,47355,573
2021-08-20,San Joaquin,077,732212,85314,82419,4444,86863,1496
2021-08-20,San Luis Obispo,079,281455,24778,23986,947,24933,273
2021-08-20,San Mateo,081,765935,48900,47561,704,48265,551
2021-08-20,Santa Barbara,083,443738,38805,37794,1345,39139,477
2021-08-20,Santa Clara,085,1922200,132891,129510,982,130492,1774
2021-08-20,Santa Cruz,087,273765,18167,17701,911,18612,209
2021-08-20,Shasta,089,179085,14878,14277,2077,16354,215
2021-08-20,Sierra,091,2930,97,83,13,96,0
2021-08-20,Siskiyou,093,43540,2366,2226,627,2853,33
2021-08-20,Solano,095,438530,40457,38214,957,39171,277
2021-08-20,Sonoma,097,501317,36741,35416,443,35859,336
2021-08-20,Stanislaus,099,539301,64874,63219,7211,70430,1047
2021-08-20,Sutter,101,95872,11436,11136,126,11262,133
2021-08-20,Tehama,103,63373,5925,5730,770,6500,66
2021-08-20,Trinity,105,12862,588,422,140,562,3
2021-08-20,Tulare,107,460477,54726,52855,10907,63762,856
2021-08-20,Tuolumne,109,53932,5280,5153,57,5210,73
2021-08-20,Ventura,111,848112,89661,88285,3865,92150,1061
2021-08-20,Yolo,113,214977,16792,16236,738,16974,225
2021-08-20,Yuba,115,75493,7818,7523,172,7695,54
2021-08-19,Alameda,001,1643700,106674,103276,2404,105680,1294
2021-08-19,Alpine,003,1148,91,91,0,91,0
2021-08-19,Amador,005,37829,4457,4317,39,4356,50
2021-08-19,Butte,007,227075,15149,14518,2425,16943,211
2021-08-19,Calaveras,009,45235,2836,2673,20,2693,59
2021-08-19,Colusa,011,21464,2242,2167,454,2621,16
2021-08-19,Contra Costa,013,1133247,87019,83296,1721,85017,852
2021-08-19,Del Norte,015,27424,2585,2257,16,2273,8
2021-08-19,El Dorado,017,186661,13087,12410,1105,13515,118
2021-08-19,Fresno,019,978130,114119,110947,10060,121007,1759
2021-08-19,Glenn,021,27897,2743,2629,715,3344,20
2021-08-19,Humboldt,023,135768,6623,6246,153,6399,52
2021-08-19,Imperial,025,180216,30139,29865,2888,32753,747
2021-08-19,Inyo,027,18085,1503,1494,13,1507,39
2021-08-19,Kern,029,883053,105966,103731,13909,117640,1371
2021-08-19,Kings,031,150075,25891,25128,1360,26488,256
2021-08-19,Lake,033,64148,5183,4991,42,5033,69
2021-08-19,Lassen,035,31185,5635,5520,146,5666,21
2021-08-19,Los Angeles,037,10098052,1332565,1314453,49626,1364079,25020
2021-08-19,Madera,039,155013,18524,17947,1257,19204,246
2021-08-19,Marin,041,260295,16044,15672,323,15995,240
2021-08-19,Mariposa,043,17540,672,618,17,635,5
2021-08-19,Mendocino,045,87422,5505,5167,178,5345,51
2021-08-19,Merced,047,269075,34497,33851,1268,35119,486
2021-08-19,Modoc,049,8938,443,427,155,582,6
2021-08-19,Mono,051,14174,1387,1349,18,1367,3
2021-08-19,Monterey,053,433212,45434,44821,2264,47085,538
2021-08-19,Napa,055,140530,11341,11104,70,11174,83
2021-08-19,Nevada,057,99092,7052,6695,229,6924,77
2021-08-19,Orange,059,3164182,283058,278562,13079,291641,5172
2021-08-19,Placer,061,380077,29671,27953,2477,30430,313
2021-08-19,Plumas,063,18699,954,896,14,910,5
2021-08-19,Riverside,065,2383286,325517,318056,15238,333294,4589
2021-08-19,Sacramento,067,1510023,131988,126720,2712,129432,1801
2021-08-19,San Benito,069,59416,6596,6493,128,6621,64
2021-08-19,San Bernardino,071,2135413,321687,316398,9884,326282,5318
2021-08-19,San Diego,073,3302833,326250,319582,18927,338509,3839
2021-08-19,San Francisco,075,870044,46649,45220,1910,47130,571
2021-08-19,San Joaquin,077,732212,84869,82047,4393,86440,1491
2021-08-19,San Luis Obispo,079,281455,24640,23878,940,24818,271
2021-08-19,San Mateo,081,765935,48768,47431,702,48133,551
2021-08-19,Santa Barbara,083,443738,38660,37693,1342,39035,477
2021-08-19,Santa Clara,085,1922200,132501,129133,975,130108,1774
2021-08-19,Santa Cruz,087,273765,18104,17644,904,18548,209
2021-08-19,Shasta,089,179085,14754,14200,2054,16254,214
2021-08-19,Sierra,091,2930,93,83,13,96,0
2021-08-19,Siskiyou,093,43540,2351,2218,615,2833,33
2021-08-19,Solano,095,438530,40299,38025,945,38970,273
2021-08-19,Sonoma,097,501317,36653,35233,442,35675,336
2021-08-19,Stanislaus,099,539301,64532,62928,7167,70095,1047
2021-08-19,Sutter,101,95872,11351,11057,125,11182,133
2021-08-19,Tehama,103,63373,5889,5683,743,6426,66
2021-08-19,Trinity,105,12862,584,414,138,552,3
2021-08-19,Tulare,107,460477,54494,52685,10843,63528,856
2021-08-19,Tuolumne,109,53932,5244,5112,56,5168,64
2021-08-19,Ventura,111,848112,89458,88073,3850,91923,1060
2021-08-19,Yolo,113,214977,16707,16153,730,16883,225
2021-08-19,Yuba,115,75493,7765,7458,171,7629,51
2021-08-18,Alameda,001,1643700,106260,102696,2382,105078,1294
2021-08-18,Alpine,003,1148,90,91,0,91,0
2021-08-18,Amador,005,37829,4440,4279,38,4317,50
2021-08-18,Butte,007,227075,15039,14426,2399,16825,208
2021-08-18,Calaveras,009,45235,2799,2643,19,2662,59
2021-08-18,Colusa,011,21464,2234,2160,450,2610,16
2021-08-18,Contra Costa,013,1133247,86519,82767,1715,84482,851
2021-08-18,Del Norte,015,27424,2528,2219,16,2235,8
2021-08-18,El Dorado,017,186661,12997,12306,1091,13397,118
2021-08-18,Fresno,019,978130,113665,110523,9997,120520,1759
2021-08-18,Glenn,021,27897,2711,2623,707,3330,20
2021-08-18,Humboldt,023,135768,6551,6195,148,6343,52
2021-08-18,Imperial,025,180216,30106,29821,2886,32707,746
2021-08-18,Inyo,027,18085,1500,1494,13,1507,39
2021-08-18,Kern,029,883053,105619,103440,13814,117254,1370
2021-08-18,Kings,031,150075,25782,24984,1352,26336,256
2021-08-18,Lake,033,64148,5142,4957,41,4998,69
2021-08-18,Lassen,035,31185,5616,5506,145,5651,21
2021-08-18,Los Angeles,037,10098052,1329418,1311477,49492,1360969,24984
2021-08-18,Madera,039,155013,18464,17871,1244,19115,246
2021-08-18,Marin,041,260295,16006,15610,320,15930,240
2021-08-18,Mariposa,043,17540,659,615,16,631,5
2021-08-18,Mendocino,045,87422,5454,5129,176,5305,51
2021-08-18,Merced,047,269075,34332,33708,1257,34965,484
2021-08-18,Modoc,049,8938,443,427,154,581,6
2021-08-18,Mono,051,14174,1384,1344,18,1362,3
2021-08-18,Monterey,053,433212,45350,44735,2247,46982,532
2021-08-18,Napa,055,140530,11302,11060,69,11129,83
2021-08-18,Nevada,057,99092,6986,6633,229,6862,76
2021-08-18,Orange,059,3164182,282421,277795,13024,290819,5168
2021-08-18,Placer,061,380077,29445,27741,2449,30190,312
2021-08-18,Plumas,063,18699,945,874,14,888,5
2021-08-18,Riverside,065,2383286,324517,317107,15204,332311,4585
2021-08-18,Sacramento,067,1510023,131228,125599,2681,128280,1781
2021-08-18,San Benito,069,59416,6585,6481,127,6608,64
2021-08-18,San Bernardino,071,2135413,320886,315477,9865,325342,5304
2021-08-18,San Diego,073,3302833,324909,318152,18861,337013,3834
2021-08-18,San Francisco,075,870044,46446,44957,1900,46857,568
2021-08-18,San Joaquin,077,732212,84416,81601,4362,85963,1491
2021-08-18,San Luis Obispo,079,281455,24490,23726,927,24653,270
2021-08-18,San Mateo,081,765935,48603,47255,701,47956,551
2021-08-18,Santa Barbara,083,443738,38529,37599,1336,38935,475
2021-08-18,Santa Clara,085,1922200,132138,128563,972,129535,1773
2021-08-18,Santa Cruz,087,273765,18049,17566,900,18466,209
2021-08-18,Shasta,089,179085,14655,14087,2035,16122,213
2021-08-18,Sierra,091,2930,92,83,13,96,0
2021-08-18,Siskiyou,093,43540,2322,2204,603,2807,33
2021-08-18,Solano,095,438530,40093,37812,930,38742,271
2021-08-18,Sonoma,097,501317,36509,35063,441,35504,333
2021-08-18,Stanislaus,099,539301,64201,62613,7123,69736,1047
2021-08-18,Sutter,101,95872,11279,11004,120,11124,130
2021-08-18,Tehama,103,63373,5854,5653,733,6386,66
2021-08-18,Trinity,105,12862,577,409,135,544,3
2021-08-18,Tulare,107,460477,54254,52486,10774,63260,856
2021-08-18,Tuolumne,109,53932,5208,5081,54,5135,64
2021-08-18,Ventura,111,848112,89226,87835,3840,91675,1055
2021-08-18,Yolo,113,214977,16624,16047,711,16758,225
2021-08-18,Yuba,115,75493,7700,7391,171,7562,51
2021-08-17,Alameda,001,1643700,105860,102379,2367,104746,1290
2021-08-17,Alpine,003,1148,90,91,0,91,0
2021-08-17,Amador,005,37829,4411,4266,38,4304,50
2021-08-17,Butte,007,227075,14932,14357,2365,16722,206
2021-08-17,Calaveras,009,45235,2765,2624,19,2643,59
2021-08-17,Colusa,011,21464,2225,2156,446,2602,16
2021-08-17,Contra Costa,013,1133247,86073,82482,1704,84186,848
2021-08-17,Del Norte,015,27424,2474,2188,16,2204,8
2021-08-17,El Dorado,017,186661,12909,12242,1077,13319,118
2021-08-17,Fresno,019,978130,113181,110263,9932,120195,1755
2021-08-17,Glenn,021,27897,2697,2608,698,3306,20
2021-08-17,Humboldt,023,135768,6471,6155,146,6301,52
2021-08-17,Imperial,025,180216,30055,29768,2882,32650,746
2021-08-17,Inyo,027,18085,1497,1492,13,1505,39
2021-08-17,Kern,029,883053,105225,103048,13690,116738,1367
2021-08-17,Kings,031,150075,25676,24930,1341,26271,254
2021-08-17,Lake,033,64148,5099,4930,35,4965,68
2021-08-17,Lassen,035,31185,5599,5499,143,5642,21
2021-08-17,Los Angeles,037,10098052,1325866,1307999,49360,1357359,24952
2021-08-17,Madera,039,155013,18390,17838,1224,19062,246
2021-08-17,Marin,041,260295,15950,15570,320,15890,240
2021-08-17,Mariposa,043,17540,651,609,15,624,5
2021-08-17,Mendocino,045,87422,5399,5097,176,5273,51
2021-08-17,Merced,047,269075,34182,33508,1247,34755,482
2021-08-17,Modoc,049,8938,440,424,152,576,6
2021-08-17,Mono,051,14174,1379,1341,18,1359,3
2021-08-17,Monterey,053,433212,45266,44672,2237,46909,528
2021-08-17,Napa,055,140530,11261,11007,68,11075,83
2021-08-17,Nevada,057,99092,6911,6605,227,6832,75
2021-08-17,Orange,059,3164182,281774,277121,12988,290109,5164
2021-08-17,Placer,061,380077,29230,27634,2420,30054,312
2021-08-17,Plumas,063,18699,933,860,14,874,5
2021-08-17,Riverside,065,2383286,323505,316051,15161,331212,4582
2021-08-17,Sacramento,067,1510023,130435,125151,2638,127789,1774
2021-08-17,San Benito,069,59416,6566,6470,127,6597,64
2021-08-17,San Bernardino,071,2135413,319949,314402,9825,324227,5302
2021-08-17,San Diego,073,3302833,323298,317058,18763,335821,3824
2021-08-17,San Francisco,075,870044,46246,44820,1894,46714,567
2021-08-17,San Joaquin,077,732212,83946,81300,4329,85629,1489
2021-08-17,San Luis Obispo,079,281455,24334,23556,924,24480,268
2021-08-17,San Mateo,081,765935,48448,47127,696,47823,551
2021-08-17,Santa Barbara,083,443738,38370,37478,1329,38807,475
2021-08-17,Santa Clara,085,1922200,131735,128354,965,129319,1773
2021-08-17,Santa Cruz,087,273765,17964,17528,899,18427,209
2021-08-17,Shasta,089,179085,14524,14012,2016,16028,214
2021-08-17,Sierra,091,2930,91,82,13,95,0
2021-08-17,Siskiyou,093,43540,2306,2183,590,2773,33
2021-08-17,Solano,095,438530,39864,37662,917,38579,269
2021-08-17,Sonoma,097,501317,36361,34943,437,35380,333
2021-08-17,Stanislaus,099,539301,63864,62385,7063,69448,1047
2021-08-17,Sutter,101,95872,11207,10973,120,11093,130
2021-08-17,Tehama,103,63373,5820,5612,711,6323,66
2021-08-17,Trinity,105,12862,572,406,132,538,3
2021-08-17,Tulare,107,460477,53986,52362,10708,63070,856
2021-08-17,Tuolumne,109,53932,5165,5042,53,5095,64
2021-08-17,Ventura,111,848112,88988,87601,3819,91420,1053
2021-08-17,Yolo,113,214977,16535,15975,697,16672,225
2021-08-17,Yuba,115,75493,7629,7355,171,7526,51
2021-08-16,Alameda,001,1643700,105357,102052,2358,104410,1287
2021-08-16,Alpine,003,1148,90,91,0,91,0
2021-08-16,Amador,005,37829,4401,4235,38,4273,50
2021-08-16,Butte,007,227075,14814,14283,2331,16614,206
2021-08-16,Calaveras,009,45235,2705,2609,18,2627,57
2021-08-16,Colusa,011,21464,2214,2147,442,2589,16
2021-08-16,Contra Costa,013,1133247,85530,82070,1694,83764,848
2021-08-16,Del Norte,015,27424,2397,2125,16,2141,8
2021-08-16,El Dorado,017,186661,12807,12139,1064,13203,118
2021-08-16,Fresno,019,978130,112683,109623,9880,119503,1753
2021-08-16,Glenn,021,27897,2678,2593,692,3285,20
2021-08-16,Humboldt,023,135768,6400,6064,125,6189,52
2021-08-16,Imperial,025,180216,30014,29737,2867,32604,746
2021-08-16,Inyo,027,18085,1494,1490,13,1503,39
2021-08-16,Kern,029,883053,104850,102690,13574,116264,1367
2021-08-16,Kings,031,150075,25573,24817,1331,26148,254
2021-08-16,Lake,033,64148,5072,4898,34,4932,68
2021-08-16,Lassen,035,31185,5583,5481,135,5616,21
2021-08-16,Los Angeles,037,10098052,1322485,1305330,49214,1354544,24923
2021-08-16,Madera,039,155013,18315,17756,1203,18959,246
2021-08-16,Marin,041,260295,15891,15497,318,15815,239
2021-08-16,Mariposa,043,17540,634,597,15,612,5
2021-08-16,Mendocino,045,87422,5343,5037,174,5211,49
2021-08-16,Merced,047,269075,33981,33364,1234,34598,481
2021-08-16,Modoc,049,8938,438,421,151,572,5
2021-08-16,Mono,051,14174,1374,1339,18,1357,3
2021-08-16,Monterey,053,433212,45187,44595,2225,46820,527
2021-08-16,Napa,055,140530,11232,10946,68,11014,83
2021-08-16,Nevada,057,99092,6856,6535,226,6761,74
2021-08-16,Orange,059,3164182,280980,275985,12943,288928,5161
2021-08-16,Placer,061,380077,29047,27384,2387,29771,306
2021-08-16,Plumas,063,18699,922,851,14,865,5
2021-08-16,Riverside,065,2383286,322414,314774,15124,329898,4582
2021-08-16,Sacramento,067,1510023,129625,124554,2595,127149,1762
2021-08-16,San Benito,069,59416,6542,6452,127,6579,64
2021-08-16,San Bernardino,071,2135413,318986,313617,9798,323415,5301
2021-08-16,San Diego,073,3302833,321701,315348,18623,333971,3824
2021-08-16,San Francisco,075,870044,46042,44681,1885,46566,567
2021-08-16,San Joaquin,077,732212,83443,81087,4302,85389,1488
2021-08-16,San Luis Obispo,079,281455,24184,23452,916,24368,265
2021-08-16,San Mateo,081,765935,48265,47024,689,47713,548
2021-08-16,Santa Barbara,083,443738,38199,37358,1324,38682,475
2021-08-16,Santa Clara,085,1922200,131271,127978,961,128939,1773
2021-08-16,Santa Cruz,087,273765,17900,17491,893,18384,209
2021-08-16,Shasta,089,179085,14435,13862,2000,15862,211
2021-08-16,Sierra,091,2930,88,82,13,95,0
2021-08-16,Siskiyou,093,43540,2289,2169,570,2739,33
2021-08-16,Solano,095,438530,39583,37436,903,38339,263
2021-08-16,Sonoma,097,501317,36193,34844,435,35279,333
2021-08-16,Stanislaus,099,539301,63525,62033,7011,69044,1039
2021-08-16,Sutter,101,95872,11138,10902,119,11021,130
2021-08-16,Tehama,103,63373,5757,5565,706,6271,66
2021-08-16,Trinity,105,12862,566,400,131,531,3
2021-08-16,Tulare,107,460477,53743,52162,10638,62800,856
2021-08-16,Tuolumne,109,53932,5126,4984,52,5036,64
2021-08-16,Ventura,111,848112,88743,86954,3801,90755,1052
2021-08-16,Yolo,113,214977,16434,15922,689,16611,225
2021-08-16,Yuba,115,75493,7545,7314,170,7484,51
2021-08-15,Alameda,001,1643700,104861,101660,2341,104001,1287
2021-08-15,Alpine,003,1148,90,91,0,91,0
2021-08-15,Amador,005,37829,4373,4231,38,4269,49
2021-08-15,Butte,007,227075,14690,14263,2308,16571,206
2021-08-15,Calaveras,009,45235,2662,2599,18,2617,57
2021-08-15,Colusa,011,21464,2202,2140,432,2572,16
2021-08-15,Contra Costa,013,1133247,85048,81781,1679,83460,848
2021-08-15,Del Norte,015,27424,2330,2060,16,2076,8
2021-08-15,El Dorado,017,186661,12672,12057,1047,13104,118
2021-08-15,Fresno,019,978130,112204,109382,9814,119196,1753
2021-08-15,Glenn,021,27897,2655,2592,680,3272,20
2021-08-15,Humboldt,023,135768,6326,6024,119,6143,52
2021-08-15,Imperial,025,180216,29948,29711,2863,32574,746
2021-08-15,Inyo,027,18085,1493,1489,13,1502,39
2021-08-15,Kern,029,883053,104406,102524,13461,115985,1367
2021-08-15,Kings,031,150075,25428,24736,1321,26057,254
2021-08-15,Lake,033,64148,5013,4886,33,4919,68
2021-08-15,Lassen,035,31185,5566,5482,134,5616,21
2021-08-15,Los Angeles,037,10098052,1318953,1302882,49041,1351923,24918
2021-08-15,Madera,039,155013,18227,17714,1187,18901,246
2021-08-15,Marin,041,260295,15832,15461,316,15777,239
2021-08-15,Mariposa,043,17540,627,591,14,605,5
2021-08-15,Mendocino,045,87422,5287,5022,168,5190,49
2021-08-15,Merced,047,269075,33736,33305,1223,34528,481
2021-08-15,Modoc,049,8938,436,421,151,572,5
2021-08-15,Mono,051,14174,1370,1334,18,1352,3
2021-08-15,Monterey,053,433212,45065,44567,2203,46770,527
2021-08-15,Napa,055,140530,11177,10919,68,10987,83
2021-08-15,Nevada,057,99092,6771,6486,226,6712,74
2021-08-15,Orange,059,3164182,280209,275447,12902,288349,5161
2021-08-15,Placer,061,380077,28825,27220,2339,29559,306
2021-08-15,Plumas,063,18699,910,850,14,864,5
2021-08-15,Riverside,065,2383286,321275,314133,15096,329229,4582
2021-08-15,Sacramento,067,1510023,128808,123924,2563,126487,1761
2021-08-15,San Benito,069,59416,6524,6446,126,6572,64
2021-08-15,San Bernardino,071,2135413,317911,313120,9766,322886,5301
2021-08-15,San Diego,073,3302833,320231,314247,18496,332743,3824
2021-08-15,San Francisco,075,870044,45817,44531,1868,46399,567
2021-08-15,San Joaquin,077,732212,82955,80832,4262,85094,1488
2021-08-15,San Luis Obispo,079,281455,23987,23404,906,24310,265
2021-08-15,San Mateo,081,765935,48076,46897,683,47580,548
2021-08-15,Santa Barbara,083,443738,38027,37276,1317,38593,475
2021-08-15,Santa Clara,085,1922200,130838,127715,955,128670,1773
2021-08-15,Santa Cruz,087,273765,17830,17440,886,18326,209
2021-08-15,Shasta,089,179085,14332,13835,1975,15810,211
2021-08-15,Sierra,091,2930,87,82,12,94,0
2021-08-15,Siskiyou,093,43540,2268,2169,556,2725,33
2021-08-15,Solano,095,438530,39327,37320,892,38212,263
2021-08-15,Sonoma,097,501317,35997,34706,427,35133,333
2021-08-15,Stanislaus,099,539301,63157,61795,6933,68728,1039
2021-08-15,Sutter,101,95872,11047,10863,119,10982,130
2021-08-15,Tehama,103,63373,5708,5550,700,6250,66
2021-08-15,Trinity,105,12862,562,400,130,530,3
2021-08-15,Tulare,107,460477,53486,52046,10578,62624,856
2021-08-15,Tuolumne,109,53932,5088,4934,50,4984,64
2021-08-15,Ventura,111,848112,88438,86797,3787,90584,1052
2021-08-15,Yolo,113,214977,16337,15873,679,16552,225
2021-08-15,Yuba,115,75493,7468,7265,169,7434,51
2021-08-14,Alameda,001,1643700,104644,101305,2337,103642,1287
2021-08-14,Alpine,003,1148,90,91,0,91,0
2021-08-14,Amador,005,37829,4355,4206,38,4244,49
2021-08-14,Butte,007,227075,14654,14192,2292,16484,206
2021-08-14,Calaveras,009,45235,2655,2579,18,2597,57
2021-08-14,Colusa,011,21464,2191,2134,428,2562,16
2021-08-14,Contra Costa,013,1133247,84800,81458,1671,83129,848
2021-08-14,Del Norte,015,27424,2303,2015,16,2031,8
2021-08-14,El Dorado,017,186661,12636,12019,1039,13058,118
2021-08-14,Fresno,019,978130,112043,109056,9784,118840,1753
2021-08-14,Glenn,021,27897,2644,2583,677,3260,20
2021-08-14,Humboldt,023,135768,6273,5998,115,6113,52
2021-08-14,Imperial,025,180216,29921,29671,2863,32534,746
2021-08-14,Inyo,027,18085,1491,1487,13,1500,39
2021-08-14,Kern,029,883053,104211,102306,13365,115671,1367
2021-08-14,Kings,031,150075,25330,24647,1312,25959,254
2021-08-14,Lake,033,64148,4996,4850,32,4882,68
2021-08-14,Lassen,035,31185,5559,5475,133,5608,21
2021-08-14,Los Angeles,037,10098052,1317181,1299346,48900,1348246,24911
2021-08-14,Madera,039,155013,18180,17691,1182,18873,246
2021-08-14,Marin,041,260295,15798,15441,316,15757,239
2021-08-14,Mariposa,043,17540,623,584,14,598,5
2021-08-14,Mendocino,045,87422,5251,4977,165,5142,49
2021-08-14,Merced,047,269075,33672,33234,1217,34451,481
2021-08-14,Modoc,049,8938,436,421,151,572,5
2021-08-14,Mono,051,14174,1365,1332,18,1350,3
2021-08-14,Monterey,053,433212,45020,44514,2200,46714,527
2021-08-14,Napa,055,140530,11147,10878,67,10945,83
2021-08-14,Nevada,057,99092,6736,6419,225,6644,74
2021-08-14,Orange,059,3164182,279775,274732,12874,287606,5161
2021-08-14,Placer,061,380077,28679,27115,2315,29430,306
2021-08-14,Plumas,063,18699,900,849,14,863,5
2021-08-14,Riverside,065,2383286,320559,313264,15075,328339,4582
2021-08-14,Sacramento,067,1510023,128314,123438,2545,125983,1758
2021-08-14,San Benito,069,59416,6511,6428,126,6554,64
2021-08-14,San Bernardino,071,2135413,317362,312142,9745,321887,5301
2021-08-14,San Diego,073,3302833,319560,313589,18428,332017,3824
2021-08-14,San Francisco,075,870044,45688,44353,1849,46202,567
2021-08-14,San Joaquin,077,732212,82739,80585,4247,84832,1488
2021-08-14,San Luis Obispo,079,281455,23926,23328,903,24231,265
2021-08-14,San Mateo,081,765935,47957,46792,679,47471,548
2021-08-14,Santa Barbara,083,443738,37933,37118,1314,38432,475
2021-08-14,Santa Clara,085,1922200,130559,127432,952,128384,1772
2021-08-14,Santa Cruz,087,273765,17791,17384,885,18269,209
2021-08-14,Shasta,089,179085,14257,13813,1954,15767,211
2021-08-14,Sierra,091,2930,86,81,12,93,0
2021-08-14,Siskiyou,093,43540,2258,2160,546,2706,33
2021-08-14,Solano,095,438530,39240,37237,880,38117,263
2021-08-14,Sonoma,097,501317,35874,34606,425,35031,333
2021-08-14,Stanislaus,099,539301,62983,61564,6888,68452,1039
2021-08-14,Sutter,101,95872,11002,10808,118,10926,130
2021-08-14,Tehama,103,63373,5684,5530,696,6226,66
2021-08-14,Trinity,105,12862,556,399,130,529,3
2021-08-14,Tulare,107,460477,53350,51951,10532,62483,856
2021-08-14,Tuolumne,109,53932,5053,4924,50,4974,64
2021-08-14,Ventura,111,848112,88282,86569,3767,90336,1052
2021-08-14,Yolo,113,214977,16292,15815,669,16484,225
2021-08-14,Yuba,115,75493,7419,7223,169,7392,51
2021-08-13,Alameda,001,1643700,104345,100930,2329,103259,1284
2021-08-13,Alpine,003,1148,90,91,0,91,0
2021-08-13,Amador,005,37829,4327,4169,38,4207,49
2021-08-13,Butte,007,227075,14584,14100,2276,16376,206
2021-08-13,Calaveras,009,45235,2648,2564,18,2582,57
2021-08-13,Colusa,011,21464,2184,2123,423,2546,16
2021-08-13,Contra Costa,013,1133247,84488,81046,1663,82709,848
2021-08-13,Del Norte,015,27424,2262,1973,16,1989,8
2021-08-13,El Dorado,017,186661,12596,11951,1027,12978,118
2021-08-13,Fresno,019,978130,111751,108638,9760,118398,1753
2021-08-13,Glenn,021,27897,2633,2574,673,3247,20
2021-08-13,Humboldt,023,135768,6226,5882,112,5994,52
2021-08-13,Imperial,025,180216,29894,29654,2862,32516,745
2021-08-13,Inyo,027,18085,1490,1484,13,1497,39
2021-08-13,Kern,029,883053,104002,102029,13256,115285,1364
2021-08-13,Kings,031,150075,25245,24531,1305,25836,253
2021-08-13,Lake,033,64148,4973,4811,31,4842,68
2021-08-13,Lassen,035,31185,5551,5455,132,5587,21
2021-08-13,Los Angeles,037,10098052,1314863,1295406,48762,1344168,24891
2021-08-13,Madera,039,155013,18131,17614,1173,18787,246
2021-08-13,Marin,041,260295,15767,15380,316,15696,239
2021-08-13,Mariposa,043,17540,617,577,14,591,5
2021-08-13,Mendocino,045,87422,5198,4924,163,5087,49
2021-08-13,Merced,047,269075,33625,33111,1211,34322,480
2021-08-13,Modoc,049,8938,435,421,150,571,5
2021-08-13,Mono,051,14174,1362,1331,18,1349,3
2021-08-13,Monterey,053,433212,44960,44450,2198,46648,527
2021-08-13,Napa,055,140530,11111,10830,67,10897,83
2021-08-13,Nevada,057,99092,6695,6356,224,6580,74
2021-08-13,Orange,059,3164182,279280,274004,12825,286829,5159
2021-08-13,Placer,061,380077,28579,26987,2288,29275,306
2021-08-13,Plumas,063,18699,886,842,14,856,5
2021-08-13,Riverside,065,2383286,319821,312408,15050,327458,4581
2021-08-13,Sacramento,067,1510023,127844,122868,2518,125386,1758
2021-08-13,San Benito,069,59416,6505,6422,124,6546,64
2021-08-13,San Bernardino,071,2135413,316694,311378,9726,321104,5301
2021-08-13,San Diego,073,3302833,318514,312293,18349,330642,3821
2021-08-13,San Francisco,075,870044,45552,44196,1826,46022,567
2021-08-13,San Joaquin,077,732212,82522,80232,4231,84463,1481
2021-08-13,San Luis Obispo,079,281455,23863,23226,900,24126,265
2021-08-13,San Mateo,081,765935,47838,46660,678,47338,548
2021-08-13,Santa Barbara,083,443738,37848,37023,1310,38333,474
2021-08-13,Santa Clara,085,1922200,130272,126958,946,127904,1769
2021-08-13,Santa Cruz,087,273765,17751,17332,878,18210,209
2021-08-13,Shasta,089,179085,14194,13698,1940,15638,211
2021-08-13,Sierra,091,2930,85,81,12,93,0
2021-08-13,Siskiyou,093,43540,2249,2147,542,2689,33
2021-08-13,Solano,095,438530,39106,37104,872,37976,264
2021-08-13,Sonoma,097,501317,35769,34464,425,34889,333
2021-08-13,Stanislaus,099,539301,62813,61294,6845,68139,1039
2021-08-13,Sutter,101,95872,10958,10751,117,10868,130
2021-08-13,Tehama,103,63373,5660,5496,694,6190,66
2021-08-13,Trinity,105,12862,552,392,130,522,3
2021-08-13,Tulare,107,460477,53246,51770,10457,62227,856
2021-08-13,Tuolumne,109,53932,5020,4899,49,4948,64
2021-08-13,Ventura,111,848112,88124,86368,3754,90122,1052
2021-08-13,Yolo,113,214977,16239,15761,659,16420,225
2021-08-13,Yuba,115,75493,7381,7184,169,7353,51
2021-08-12,Alameda,001,1643700,103853,100472,2316,102788,1284
2021-08-12,Alpine,003,1148,90,91,0,91,0
2021-08-12,Amador,005,37829,4297,4161,37,4198,49
2021-08-12,Butte,007,227075,14514,14006,2258,16264,206
2021-08-12,Calaveras,009,45235,2633,2531,18,2549,57
2021-08-12,Colusa,011,21464,2179,2111,422,2533,17
2021-08-12,Contra Costa,013,1133247,84006,80738,1648,82386,846
2021-08-12,Del Norte,015,27424,2190,1923,16,1939,8
2021-08-12,El Dorado,017,186661,12482,11880,1019,12899,118
2021-08-12,Fresno,019,978130,111329,108193,9692,117885,1753
2021-08-12,Glenn,021,27897,2625,2559,661,3220,20
2021-08-12,Humboldt,023,135768,6157,5845,108,5953,52
2021-08-12,Imperial,025,180216,29838,29585,2856,32441,745
2021-08-12,Inyo,027,18085,1488,1483,13,1496,39
2021-08-12,Kern,029,883053,103713,101698,13176,114874,1364
2021-08-12,Kings,031,150075,25145,24423,1296,25719,252
2021-08-12,Lake,033,64148,4947,4774,31,4805,68
2021-08-12,Lassen,035,31185,5529,5428,131,5559,21
2021-08-12,Los Angeles,037,10098052,1311676,1291875,48627,1340502,24874
2021-08-12,Madera,039,155013,18067,17564,1161,18725,246
2021-08-12,Marin,041,260295,15718,15277,313,15590,239
2021-08-12,Mariposa,043,17540,608,568,13,581,5
2021-08-12,Mendocino,045,87422,5168,4873,157,5030,49
2021-08-12,Merced,047,269075,33501,32960,1204,34164,480
2021-08-12,Modoc,049,8938,434,423,150,573,5
2021-08-12,Mono,051,14174,1357,1325,18,1343,3
2021-08-12,Monterey,053,433212,44884,44383,2181,46564,527
2021-08-12,Napa,055,140530,11062,10780,66,10846,83
2021-08-12,Nevada,057,99092,6634,6283,224,6507,74
2021-08-12,Orange,059,3164182,278601,273167,12767,285934,5158
2021-08-12,Placer,061,380077,28381,26856,2265,29121,306
2021-08-12,Plumas,063,18699,878,829,14,843,5
2021-08-12,Riverside,065,2383286,318811,311304,15017,326321,4575
2021-08-12,Sacramento,067,1510023,127073,122222,2488,124710,1758
2021-08-12,San Benito,069,59416,6488,6398,122,6520,64
2021-08-12,San Bernardino,071,2135413,315820,310420,9697,320117,5297
2021-08-12,San Diego,073,3302833,317145,310596,18260,328856,3821
2021-08-12,San Francisco,075,870044,45345,43774,1813,45587,564
2021-08-12,San Joaquin,077,732212,82126,79945,4208,84153,1479
2021-08-12,San Luis Obispo,079,281455,23763,23101,886,23987,264
2021-08-12,San Mateo,081,765935,47694,46435,675,47110,548
2021-08-12,Santa Barbara,083,443738,37711,36881,1302,38183,473
2021-08-12,Santa Clara,085,1922200,129823,126614,940,127554,1769
2021-08-12,Santa Cruz,087,273765,17687,17261,877,18138,209
2021-08-12,Shasta,089,179085,14108,13621,1913,15534,211
2021-08-12,Sierra,091,2930,85,81,12,93,0
2021-08-12,Siskiyou,093,43540,2242,2134,532,2666,33
2021-08-12,Solano,095,438530,38877,36980,863,37843,262
2021-08-12,Sonoma,097,501317,35621,34299,422,34721,333
2021-08-12,Stanislaus,099,539301,62549,61026,6786,67812,1039
2021-08-12,Sutter,101,95872,10897,10695,115,10810,130
2021-08-12,Tehama,103,63373,5630,5462,685,6147,66
2021-08-12,Trinity,105,12862,548,386,129,515,3
2021-08-12,Tulare,107,460477,53100,51632,10408,62040,856
2021-08-12,Tuolumne,109,53932,4973,4845,47,4892,64
2021-08-12,Ventura,111,848112,87886,86106,3730,89836,1052
2021-08-12,Yolo,113,214977,16167,15686,646,16332,224
2021-08-12,Yuba,115,75493,7333,7128,168,7296,51
2021-08-11,Alameda,001,1643700,103335,100040,2312,102352,1281
2021-08-11,Alpine,003,1148,90,91,0,91,0
2021-08-11,Amador,005,37829,4273,4127,37,4164,49
2021-08-11,Butte,007,227075,14414,13905,2233,16138,206
2021-08-11,Calaveras,009,45235,2611,2505,18,2523,57
2021-08-11,Colusa,011,21464,2169,2101,420,2521,16
2021-08-11,Contra Costa,013,1133247,83506,80275,1630,81905,843
2021-08-11,Del Norte,015,27424,2131,1893,16,1909,8
2021-08-11,El Dorado,017,186661,12370,11799,1007,12806,119
2021-08-11,Fresno,019,978130,110875,107773,9645,117418,1751
2021-08-11,Glenn,021,27897,2616,2547,651,3198,20
2021-08-11,Humboldt,023,135768,6110,5765,107,5872,52
2021-08-11,Imperial,025,180216,29795,29565,2852,32417,745
2021-08-11,Inyo,027,18085,1488,1483,13,1496,39
2021-08-11,Kern,029,883053,103399,101448,13066,114514,1363
2021-08-11,Kings,031,150075,25032,24304,1287,25591,250
2021-08-11,Lake,033,64148,4910,4713,30,4743,68
2021-08-11,Lassen,035,31185,5520,5408,129,5537,21
2021-08-11,Los Angeles,037,10098052,1308354,1288238,48438,1336676,24851
2021-08-11,Madera,039,155013,18017,17511,1150,18661,245
2021-08-11,Marin,041,260295,15669,15235,313,15548,239
2021-08-11,Mariposa,043,17540,598,554,12,566,5
2021-08-11,Mendocino,045,87422,5099,4796,148,4944,49
2021-08-11,Merced,047,269075,33368,32802,1200,34002,479
2021-08-11,Modoc,049,8938,434,421,150,571,5
2021-08-11,Mono,051,14174,1352,1320,18,1338,3
2021-08-11,Monterey,053,433212,44785,44314,2163,46477,527
2021-08-11,Napa,055,140530,11021,10732,66,10798,83
2021-08-11,Nevada,057,99092,6580,6172,221,6393,74
2021-08-11,Orange,059,3164182,277744,272212,12720,284932,5155
2021-08-11,Placer,061,380077,28169,26687,2239,28926,305
2021-08-11,Plumas,063,18699,868,824,14,838,5
2021-08-11,Riverside,065,2383286,317818,310265,14982,325247,4570
2021-08-11,Sacramento,067,1510023,126280,121603,2446,124049,1757
2021-08-11,San Benito,069,59416,6475,6381,122,6503,64
2021-08-11,San Bernardino,071,2135413,314926,309498,9675,319173,5296
2021-08-11,San Diego,073,3302833,315675,309406,18156,327562,3818
2021-08-11,San Francisco,075,870044,45121,43555,1805,45360,564
2021-08-11,San Joaquin,077,732212,81719,79641,4180,83821,1478
2021-08-11,San Luis Obispo,079,281455,23659,22920,879,23799,264
2021-08-11,San Mateo,081,765935,47526,46300,672,46972,548
2021-08-11,Santa Barbara,083,443738,37547,36699,1293,37992,472
2021-08-11,Santa Clara,085,1922200,129342,126301,932,127233,1769
2021-08-11,Santa Cruz,087,273765,17622,17191,874,18065,209
2021-08-11,Shasta,089,179085,14034,13546,1897,15443,211
2021-08-11,Sierra,091,2930,84,81,12,93,0
2021-08-11,Siskiyou,093,43540,2228,2124,525,2649,33
2021-08-11,Solano,095,438530,38642,36862,849,37711,262
2021-08-11,Sonoma,097,501317,35442,34188,417,34605,333
2021-08-11,Stanislaus,099,539301,62219,60767,6756,67523,1037
2021-08-11,Sutter,101,95872,10825,10628,115,10743,130
2021-08-11,Tehama,103,63373,5600,5410,668,6078,66
2021-08-11,Trinity,105,12862,546,385,129,514,3
2021-08-11,Tulare,107,460477,52932,51464,10363,61827,854
2021-08-11,Tuolumne,109,53932,4941,4794,47,4841,64
2021-08-11,Ventura,111,848112,87634,85863,3709,89572,1051
2021-08-11,Yolo,113,214977,16092,15593,632,16225,218
2021-08-11,Yuba,115,75493,7274,7063,167,7230,53
2021-08-10,Alameda,001,1643700,102854,99771,2304,102075,1281
2021-08-10,Alpine,003,1148,90,91,0,91,0
2021-08-10,Amador,005,37829,4257,4093,37,4130,49
2021-08-10,Butte,007,227075,14331,13853,2212,16065,205
2021-08-10,Calaveras,009,45235,2586,2491,16,2507,57
2021-08-10,Colusa,011,21464,2156,2088,411,2499,16
2021-08-10,Contra Costa,013,1133247,82962,80018,1620,81638,840
2021-08-10,Del Norte,015,27424,2087,1870,16,1886,8
2021-08-10,El Dorado,017,186661,12271,11734,997,12731,117
2021-08-10,Fresno,019,978130,110418,107616,9588,117204,1747
2021-08-10,Glenn,021,27897,2603,2538,641,3179,20
2021-08-10,Humboldt,023,135768,6056,5718,104,5822,52
2021-08-10,Imperial,025,180216,29760,29522,2846,32368,745
2021-08-10,Inyo,027,18085,1488,1482,13,1495,39
2021-08-10,Kern,029,883053,103070,101254,12970,114224,1359
2021-08-10,Kings,031,150075,24906,24252,1271,25523,251
2021-08-10,Lake,033,64148,4869,4700,30,4730,67
2021-08-10,Lassen,035,31185,5502,5401,129,5530,21
2021-08-10,Los Angeles,037,10098052,1304603,1285140,48266,1333406,24821
2021-08-10,Madera,039,155013,17944,17481,1140,18621,245
2021-08-10,Marin,041,260295,15622,15194,313,15507,239
2021-08-10,Mariposa,043,17540,585,550,12,562,5
2021-08-10,Mendocino,045,87422,5054,4775,144,4919,49
2021-08-10,Merced,047,269075,33220,32721,1191,33912,477
2021-08-10,Modoc,049,8938,433,421,150,571,5
2021-08-10,Mono,051,14174,1347,1320,18,1338,3
2021-08-10,Monterey,053,433212,44722,44259,2148,46407,527
2021-08-10,Napa,055,140530,10965,10703,65,10768,83
2021-08-10,Nevada,057,99092,6515,6151,220,6371,73
2021-08-10,Orange,059,3164182,276865,271688,12672,284360,5155
2021-08-10,Placer,061,380077,27950,26561,2197,28758,305
2021-08-10,Plumas,063,18699,859,816,14,830,5
2021-08-10,Riverside,065,2383286,316703,309529,14956,324485,4564
2021-08-10,Sacramento,067,1510023,125427,121159,2416,123575,1755
2021-08-10,San Benito,069,59416,6461,6371,122,6493,64
2021-08-10,San Bernardino,071,2135413,314003,308672,9658,318330,5295
2021-08-10,San Diego,073,3302833,314033,308288,18064,326352,3815
2021-08-10,San Francisco,075,870044,44868,43389,1790,45179,564
2021-08-10,San Joaquin,077,732212,81321,79391,4163,83554,1478
2021-08-10,San Luis Obispo,079,281455,23533,22776,877,23653,264
2021-08-10,San Mateo,081,765935,47354,46184,670,46854,548
2021-08-10,Santa Barbara,083,443738,37382,36574,1286,37860,472
2021-08-10,Santa Clara,085,1922200,128879,126019,925,126944,1770
2021-08-10,Santa Cruz,087,273765,17539,17142,872,18014,209
2021-08-10,Shasta,089,179085,13956,13461,1873,15334,211
2021-08-10,Sierra,091,2930,84,76,12,88,0
2021-08-10,Siskiyou,093,43540,2219,2088,518,2606,33
2021-08-10,Solano,095,438530,38396,36767,838,37605,262
2021-08-10,Sonoma,097,501317,35297,34054,414,34468,333
2021-08-10,Stanislaus,099,539301,61874,60605,6719,67324,1037
2021-08-10,Sutter,101,95872,10760,10569,115,10684,130
2021-08-10,Tehama,103,63373,5571,5392,663,6055,66
2021-08-10,Trinity,105,12862,546,384,129,513,3
2021-08-10,Tulare,107,460477,52767,51390,10311,61701,854
2021-08-10,Tuolumne,109,53932,4912,4780,45,4825,64
2021-08-10,Ventura,111,848112,87344,85714,3688,89402,1051
2021-08-10,Yolo,113,214977,16005,15568,622,16190,218
2021-08-10,Yuba,115,75493,7224,7028,167,7195,50
2021-08-09,Alameda,001,1643700,102295,99496,2300,101796,1276
2021-08-09,Alpine,003,1148,90,91,0,91,0
2021-08-09,Amador,005,37829,4231,4078,37,4115,48
2021-08-09,Butte,007,227075,14232,13813,2184,15997,205
2021-08-09,Calaveras,009,45235,2560,2472,16,2488,57
2021-08-09,Colusa,011,21464,2146,2075,403,2478,16
2021-08-09,Contra Costa,013,1133247,82417,79740,1608,81348,840
2021-08-09,Del Norte,015,27424,2019,1848,16,1864,8
2021-08-09,El Dorado,017,186661,12163,11672,983,12655,117
2021-08-09,Fresno,019,978130,109924,107310,9549,116859,1747
2021-08-09,Glenn,021,27897,2592,2532,629,3161,20
2021-08-09,Humboldt,023,135768,5965,5632,102,5734,52
2021-08-09,Imperial,025,180216,29715,29512,2842,32354,745
2021-08-09,Inyo,027,18085,1488,1481,13,1494,39
2021-08-09,Kern,029,883053,102758,101069,12884,113953,1359
2021-08-09,Kings,031,150075,24798,24155,1256,25411,250
2021-08-09,Lake,033,64148,4834,4670,28,4698,66
2021-08-09,Lassen,035,31185,5480,5393,128,5521,21
2021-08-09,Los Angeles,037,10098052,1300591,1282891,48058,1330949,24798
2021-08-09,Madera,039,155013,17885,17429,1120,18549,245
2021-08-09,Marin,041,260295,15569,15154,312,15466,239
2021-08-09,Mariposa,043,17540,572,545,12,557,5
2021-08-09,Mendocino,045,87422,5003,4732,136,4868,49
2021-08-09,Merced,047,269075,33074,32666,1184,33850,477
2021-08-09,Modoc,049,8938,433,419,150,569,5
2021-08-09,Mono,051,14174,1344,1337,18,1355,3
2021-08-09,Monterey,053,433212,44649,44190,2132,46322,527
2021-08-09,Napa,055,140530,10918,10679,65,10744,83
2021-08-09,Nevada,057,99092,6444,6088,219,6307,73
2021-08-09,Orange,059,3164182,275828,271036,12620,283656,5153
2021-08-09,Placer,061,380077,27727,26457,2166,28623,305
2021-08-09,Plumas,063,18699,842,803,14,817,5
2021-08-09,Riverside,065,2383286,315627,308678,14936,323614,4562
2021-08-09,Sacramento,067,1510023,124592,120812,2391,123203,1748
2021-08-09,San Benito,069,59416,6441,6359,120,6479,63
2021-08-09,San Bernardino,071,2135413,313019,308038,9634,317672,5295
2021-08-09,San Diego,073,3302833,312374,306855,17965,324820,3811
2021-08-09,San Francisco,075,870044,44622,43261,1772,45033,564
2021-08-09,San Joaquin,077,732212,80938,79198,4145,83343,1469
2021-08-09,San Luis Obispo,079,281455,23394,22695,868,23563,264
2021-08-09,San Mateo,081,765935,47182,46040,666,46706,548
2021-08-09,Santa Barbara,083,443738,37198,36474,1278,37752,470
2021-08-09,Santa Clara,085,1922200,128376,125791,916,126707,2187
2021-08-09,Santa Cruz,087,273765,17477,17082,872,17954,209
2021-08-09,Shasta,089,179085,13839,13397,1862,15259,210
2021-08-09,Sierra,091,2930,83,75,12,87,0
2021-08-09,Siskiyou,093,43540,2207,2047,502,2549,32
2021-08-09,Solano,095,438530,38120,36653,836,37489,262
2021-08-09,Sonoma,097,501317,35116,33933,412,34345,333
2021-08-09,Stanislaus,099,539301,61597,60410,6668,67078,1037
2021-08-09,Sutter,101,95872,10711,10525,112,10637,129
2021-08-09,Tehama,103,63373,5528,5373,661,6034,66
2021-08-09,Trinity,105,12862,544,378,127,505,3
2021-08-09,Tulare,107,460477,52606,51274,10246,61520,854
2021-08-09,Tuolumne,109,53932,4870,4745,45,4790,64
2021-08-09,Ventura,111,848112,87072,85514,3677,89191,1047
2021-08-09,Yolo,113,214977,15927,15521,601,16122,218
2021-08-09,Yuba,115,75493,7165,6994,167,7161,50
2021-08-08,Alameda,001,1643700,101741,99135,2294,101429,1276
2021-08-08,Alpine,003,1148,90,91,0,91,0
2021-08-08,Amador,005,37829,4197,4057,36,4093,48
2021-08-08,Butte,007,227075,14150,13791,2166,15957,205
2021-08-08,Calaveras,009,45235,2529,2462,16,2478,57
2021-08-08,Colusa,011,21464,2129,2070,396,2466,16
2021-08-08,Contra Costa,013,1133247,81893,79454,1601,81055,840
2021-08-08,Del Norte,015,27424,1973,1810,16,1826,8
2021-08-08,El Dorado,017,186661,12043,11631,972,12603,117
2021-08-08,Fresno,019,978130,109481,107078,9512,116590,1747
2021-08-08,Glenn,021,27897,2584,2527,622,3149,20
2021-08-08,Humboldt,023,135768,5877,5571,102,5673,52
2021-08-08,Imperial,025,180216,29691,29485,2832,32317,745
2021-08-08,Inyo,027,18085,1488,1481,13,1494,39
2021-08-08,Kern,029,883053,102438,100909,12772,113681,1359
2021-08-08,Kings,031,150075,24683,24095,1247,25342,250
2021-08-08,Lake,033,64148,4784,4636,27,4663,66
2021-08-08,Lassen,035,31185,5465,5391,127,5518,21
2021-08-08,Los Angeles,037,10098052,1296339,1279982,47871,1327853,24793
2021-08-08,Madera,039,155013,17806,17398,1103,18501,245
2021-08-08,Marin,041,260295,15516,15124,310,15434,239
2021-08-08,Mariposa,043,17540,568,538,12,550,5
2021-08-08,Mendocino,045,87422,4941,4702,123,4825,49
2021-08-08,Merced,047,269075,32927,32634,1175,33809,477
2021-08-08,Modoc,049,8938,432,419,149,568,5
2021-08-08,Mono,051,14174,1340,1336,18,1354,3
2021-08-08,Monterey,053,433212,44579,44171,2121,46292,527
2021-08-08,Napa,055,140530,10882,10668,65,10733,83
2021-08-08,Nevada,057,99092,6360,6009,217,6226,73
2021-08-08,Orange,059,3164182,274915,270532,12581,283113,5153
2021-08-08,Placer,061,380077,27518,26332,2125,28457,305
2021-08-08,Plumas,063,18699,833,803,14,817,5
2021-08-08,Riverside,065,2383286,314506,308042,14912,322954,4562
2021-08-08,Sacramento,067,1510023,123764,120109,2379,122488,1744
2021-08-08,San Benito,069,59416,6424,6350,119,6469,63
2021-08-08,San Bernardino,071,2135413,311873,307378,9604,316982,5295
2021-08-08,San Diego,073,3302833,311033,305983,17867,323850,3811
2021-08-08,San Francisco,075,870044,44362,43098,1749,44847,564
2021-08-08,San Joaquin,077,732212,80488,79002,4129,83131,1469
2021-08-08,San Luis Obispo,079,281455,23220,22668,860,23528,263
2021-08-08,San Mateo,081,765935,46992,45927,663,46590,548
2021-08-08,Santa Barbara,083,443738,37021,36417,1271,37688,470
2021-08-08,Santa Clara,085,1922200,127925,125553,911,126464,2187
2021-08-08,Santa Cruz,087,273765,17406,17035,867,17902,209
2021-08-08,Shasta,089,179085,13753,13381,1851,15232,210
2021-08-08,Sierra,091,2930,83,74,12,86,0
2021-08-08,Siskiyou,093,43540,2191,2041,497,2538,32
2021-08-08,Solano,095,438530,37868,36551,832,37383,262
2021-08-08,Sonoma,097,501317,34872,33805,411,34216,333
2021-08-08,Stanislaus,099,539301,61275,60269,6623,66892,1037
2021-08-08,Sutter,101,95872,10651,10481,111,10592,129
2021-08-08,Tehama,103,63373,5490,5359,658,6017,66
2021-08-08,Trinity,105,12862,539,378,127,505,3
2021-08-08,Tulare,107,460477,52427,51220,10186,61406,854
2021-08-08,Tuolumne,109,53932,4831,4731,45,4776,64
2021-08-08,Ventura,111,848112,86781,85382,3667,89049,1047
2021-08-08,Yolo,113,214977,15835,15477,594,16071,218
2021-08-08,Yuba,115,75493,7126,6967,167,7134,50
2021-08-07,Alameda,001,1643700,101487,98812,2288,101100,1276
2021-08-07,Alpine,003,1148,90,91,0,91,0
2021-08-07,Amador,005,37829,4180,4041,35,4076,48
2021-08-07,Butte,007,227075,14097,13714,2154,15868,205
2021-08-07,Calaveras,009,45235,2518,2446,16,2462,57
2021-08-07,Colusa,011,21464,2124,2067,387,2454,16
2021-08-07,Contra Costa,013,1133247,81597,79168,1598,80766,840
2021-08-07,Del Norte,015,27424,1941,1791,16,1807,8
2021-08-07,El Dorado,017,186661,11993,11575,965,12540,117
2021-08-07,Fresno,019,978130,109277,106861,9486,116347,1747
2021-08-07,Glenn,021,27897,2576,2515,621,3136,20
2021-08-07,Humboldt,023,135768,5827,5510,99,5609,52
2021-08-07,Imperial,025,180216,29672,29470,2832,32302,745
2021-08-07,Inyo,027,18085,1486,1476,13,1489,39
2021-08-07,Kern,029,883053,102280,100693,12717,113410,1359
2021-08-07,Kings,031,150075,24623,24048,1241,25289,250
2021-08-07,Lake,033,64148,4763,4613,27,4640,66
2021-08-07,Lassen,035,31185,5461,5386,127,5513,21
2021-08-07,Los Angeles,037,10098052,1294313,1276853,47719,1324572,24786
2021-08-07,Madera,039,155013,17771,17366,1098,18464,245
2021-08-07,Marin,041,260295,15482,15085,309,15394,239
2021-08-07,Mariposa,043,17540,565,530,12,542,5
2021-08-07,Mendocino,045,87422,4905,4690,121,4811,49
2021-08-07,Merced,047,269075,32863,32569,1172,33741,477
2021-08-07,Modoc,049,8938,432,419,149,568,5
2021-08-07,Mono,051,14174,1337,1329,18,1347,3
2021-08-07,Monterey,053,433212,44527,44124,2116,46240,527
2021-08-07,Napa,055,140530,10861,10658,64,10722,83
2021-08-07,Nevada,057,99092,6310,5967,215,6182,73
2021-08-07,Orange,059,3164182,274322,269900,12550,282450,5153
2021-08-07,Placer,061,380077,27330,26244,2117,28361,305
2021-08-07,Plumas,063,18699,828,801,14,815,5
2021-08-07,Riverside,065,2383286,313834,307326,14905,322231,4562
2021-08-07,Sacramento,067,1510023,123263,119636,2375,122011,1744
2021-08-07,San Benito,069,59416,6414,6332,119,6451,63
2021-08-07,San Bernardino,071,2135413,311285,306663,9587,316250,5295
2021-08-07,San Diego,073,3302833,310279,304974,17832,322806,3811
2021-08-07,San Francisco,075,870044,44191,42926,1731,44657,564
2021-08-07,San Joaquin,077,732212,80324,78769,4115,82884,1469
2021-08-07,San Luis Obispo,079,281455,23151,22579,859,23438,263
2021-08-07,San Mateo,081,765935,46865,45804,661,46465,548
2021-08-07,Santa Barbara,083,443738,36925,36303,1265,37568,470
2021-08-07,Santa Clara,085,1922200,127653,125196,906,126102,2188
2021-08-07,Santa Cruz,087,273765,17363,16994,865,17859,209
2021-08-07,Shasta,089,179085,13698,13361,1843,15204,210
2021-08-07,Sierra,091,2930,83,74,12,86,0
2021-08-07,Siskiyou,093,43540,2179,2039,495,2534,32
2021-08-07,Solano,095,438530,37752,36458,824,37282,262
2021-08-07,Sonoma,097,501317,34750,33716,411,34127,333
2021-08-07,Stanislaus,099,539301,61107,60093,6593,66686,1037
2021-08-07,Sutter,101,95872,10614,10447,111,10558,129
2021-08-07,Tehama,103,63373,5480,5343,653,5996,66
2021-08-07,Trinity,105,12862,535,377,126,503,3
2021-08-07,Tulare,107,460477,52340,51133,10148,61281,854
2021-08-07,Tuolumne,109,53932,4801,4721,45,4766,64
2021-08-07,Ventura,111,848112,86601,85232,3652,88884,1047
2021-08-07,Yolo,113,214977,15791,15423,587,16010,218
2021-08-07,Yuba,115,75493,7101,6937,165,7102,50
2021-08-06,Alameda,001,1643700,101156,98487,2280,100767,1275
2021-08-06,Alpine,003,1148,90,91,0,91,0
2021-08-06,Amador,005,37829,4159,4002,35,4037,48
2021-08-06,Butte,007,227075,14047,13626,2139,15765,205
2021-08-06,Calaveras,009,45235,2506,2419,16,2435,57
2021-08-06,Colusa,011,21464,2117,2045,381,2426,16
2021-08-06,Contra Costa,013,1133247,81302,78796,1592,80388,840
2021-08-06,Del Norte,015,27424,1914,1755,15,1770,8
2021-08-06,El Dorado,017,186661,11944,11498,953,12451,117
2021-08-06,Fresno,019,978130,109013,106542,9459,116001,1747
2021-08-06,Glenn,021,27897,2561,2504,618,3122,20
2021-08-06,Humboldt,023,135768,5776,5421,96,5517,52
2021-08-06,Imperial,025,180216,29661,29404,2828,32232,745
2021-08-06,Inyo,027,18085,1483,1471,13,1484,39
2021-08-06,Kern,029,883053,102103,100427,12632,113059,1359
2021-08-06,Kings,031,150075,24568,23974,1237,25211,250
2021-08-06,Lake,033,64148,4740,4557,27,4584,66
2021-08-06,Lassen,035,31185,5439,5368,127,5495,21
2021-08-06,Los Angeles,037,10098052,1291828,1273081,47566,1320647,24772
2021-08-06,Madera,039,155013,17732,17324,1089,18413,245
2021-08-06,Marin,041,260295,15449,15051,309,15360,239
2021-08-06,Mariposa,043,17540,556,511,12,523,5
2021-08-06,Mendocino,045,87422,4863,4649,120,4769,49
2021-08-06,Merced,047,269075,32803,32456,1169,33625,477
2021-08-06,Modoc,049,8938,432,419,149,568,5
2021-08-06,Mono,051,14174,1336,1328,18,1346,3
2021-08-06,Monterey,053,433212,44459,44058,2103,46161,527
2021-08-06,Napa,055,140530,10834,10620,64,10684,83
2021-08-06,Nevada,057,99092,6254,5874,215,6089,73
2021-08-06,Orange,059,3164182,273757,269077,12533,281610,5151
2021-08-06,Placer,061,380077,27207,26086,2095,28181,305
2021-08-06,Plumas,063,18699,819,795,14,809,5
2021-08-06,Riverside,065,2383286,313124,306304,14894,321198,4562
2021-08-06,Sacramento,067,1510023,122775,119169,2355,121524,1740
2021-08-06,San Benito,069,59416,6397,6315,119,6434,63
2021-08-06,San Bernardino,071,2135413,310585,305806,9579,315385,5286
2021-08-06,San Diego,073,3302833,309239,303691,17783,321474,3810
2021-08-06,San Francisco,075,870044,44034,42659,1713,44372,565
2021-08-06,San Joaquin,077,732212,80175,78405,4103,82508,1469
2021-08-06,San Luis Obispo,079,281455,23083,22472,854,23326,263
2021-08-06,San Mateo,081,765935,46712,45665,656,46321,548
2021-08-06,Santa Barbara,083,443738,36836,36208,1261,37469,470
2021-08-06,Santa Clara,085,1922200,127362,124767,900,125667,2185
2021-08-06,Santa Cruz,087,273765,17319,16924,861,17785,207
2021-08-06,Shasta,089,179085,13632,13284,1837,15121,210
2021-08-06,Sierra,091,2930,83,73,12,85,0
2021-08-06,Siskiyou,093,43540,2169,2030,491,2521,32
2021-08-06,Solano,095,438530,37642,36351,815,37166,262
2021-08-06,Sonoma,097,501317,34664,33594,410,34004,333
2021-08-06,Stanislaus,099,539301,60969,59854,6572,66426,1037
2021-08-06,Sutter,101,95872,10571,10391,111,10502,128
2021-08-06,Tehama,103,63373,5456,5325,652,5977,66
2021-08-06,Trinity,105,12862,534,371,125,496,3
2021-08-06,Tulare,107,460477,52239,51018,10101,61119,854
2021-08-06,Tuolumne,109,53932,4774,4674,45,4719,64
2021-08-06,Ventura,111,848112,86430,85046,3640,88686,1047
2021-08-06,Yolo,113,214977,15738,15299,582,15881,218
2021-08-06,Yuba,115,75493,7078,6904,165,7069,50
2021-08-05,Alameda,001,1643700,100669,98052,2275,100327,1275
2021-08-05,Alpine,003,1148,90,91,0,91,0
2021-08-05,Amador,005,37829,4139,3992,35,4027,48
2021-08-05,Butte,007,227075,13986,13564,2116,15680,206
2021-08-05,Calaveras,009,45235,2486,2397,16,2413,57
2021-08-05,Colusa,011,21464,2105,2036,377,2413,16
2021-08-05,Contra Costa,013,1133247,80875,78514,1585,80099,840
2021-08-05,Del Norte,015,27424,1887,1731,15,1746,8
2021-08-05,El Dorado,017,186661,11860,11408,942,12350,117
2021-08-05,Fresno,019,978130,108642,106219,9421,115640,1747
2021-08-05,Glenn,021,27897,2555,2494,615,3109,20
2021-08-05,Humboldt,023,135768,5702,5328,95,5423,52
2021-08-05,Imperial,025,180216,29630,29383,2824,32207,745
2021-08-05,Inyo,027,18085,1479,1468,13,1481,38
2021-08-05,Kern,029,883053,101881,100091,12547,112638,1358
2021-08-05,Kings,031,150075,24484,23906,1231,25137,249
2021-08-05,Lake,033,64148,4701,4490,25,4515,66
2021-08-05,Lassen,035,31185,5431,5344,127,5471,21
2021-08-05,Los Angeles,037,10098052,1288608,1269445,47431,1316876,24756
2021-08-05,Madera,039,155013,17691,17301,1081,18382,245
2021-08-05,Marin,041,260295,15405,15005,305,15310,239
2021-08-05,Mariposa,043,17540,545,504,11,515,5
2021-08-05,Mendocino,045,87422,4820,4597,111,4708,49
2021-08-05,Merced,047,269075,32736,32381,1158,33539,477
2021-08-05,Modoc,049,8938,431,418,149,567,5
2021-08-05,Mono,051,14174,1328,1309,18,1327,3
2021-08-05,Monterey,053,433212,44402,43992,2085,46077,527
2021-08-05,Napa,055,140530,10798,10591,62,10653,83
2021-08-05,Nevada,057,99092,6172,5778,212,5990,73
2021-08-05,Orange,059,3164182,272976,268329,12508,280837,5149
2021-08-05,Placer,061,380077,27006,25965,2068,28033,305
2021-08-05,Plumas,063,18699,810,787,14,801,5
2021-08-05,Riverside,065,2383286,312207,305415,14867,320282,4562
2021-08-05,Sacramento,067,1510023,122065,118590,2342,120932,1739
2021-08-05,San Benito,069,59416,6379,6305,119,6424,63
2021-08-05,San Bernardino,071,2135413,309750,304956,9558,314514,5284
2021-08-05,San Diego,073,3302833,307967,302220,17701,319921,3806
2021-08-05,San Francisco,075,870044,43824,42301,1704,44005,564
2021-08-05,San Joaquin,077,732212,79814,78151,4085,82236,1468
2021-08-05,San Luis Obispo,079,281455,22968,22362,848,23210,263
2021-08-05,San Mateo,081,765935,46539,45554,654,46208,548
2021-08-05,Santa Barbara,083,443738,36729,36112,1258,37370,470
2021-08-05,Santa Clara,085,1922200,127029,124490,900,125390,2185
2021-08-05,Santa Cruz,087,273765,17275,16867,858,17725,207
2021-08-05,Shasta,089,179085,13574,13217,1829,15046,210
2021-08-05,Sierra,091,2930,78,73,12,85,0
2021-08-05,Siskiyou,093,43540,2148,2024,481,2505,32
2021-08-05,Solano,095,438530,37461,36250,808,37058,262
2021-08-05,Sonoma,097,501317,34529,33455,409,33864,330
2021-08-05,Stanislaus,099,539301,60752,59692,6533,66225,1037
2021-08-05,Sutter,101,95872,10516,10349,111,10460,127
2021-08-05,Tehama,103,63373,5438,5305,648,5953,66
2021-08-05,Trinity,105,12862,528,367,125,492,3
2021-08-05,Tulare,107,460477,52122,50889,10044,60933,854
2021-08-05,Tuolumne,109,53932,4744,4619,45,4664,64
2021-08-05,Ventura,111,848112,86179,84837,3626,88463,1047
2021-08-05,Yolo,113,214977,15672,15250,572,15822,218
2021-08-05,Yuba,115,75493,7035,6872,163,7035,50
2021-08-04,Alameda,001,1643700,100168,97477,2264,99741,1274
2021-08-04,Alpine,003,1148,90,91,0,91,0
2021-08-04,Amador,005,37829,4109,3962,34,3996,48
2021-08-04,Butte,007,227075,13917,13509,2099,15608,205
2021-08-04,Calaveras,009,45235,2461,2374,16,2390,57
2021-08-04,Colusa,011,21464,2093,2025,371,2396,16
2021-08-04,Contra Costa,013,1133247,80359,77966,1580,79546,840
2021-08-04,Del Norte,015,27424,1864,1701,15,1716,8
2021-08-04,El Dorado,017,186661,11782,11319,931,12250,117
2021-08-04,Fresno,019,978130,108274,105899,9380,115279,1747
2021-08-04,Glenn,021,27897,2547,2487,613,3100,20
2021-08-04,Humboldt,023,135768,5626,5271,94,5365,52
2021-08-04,Imperial,025,180216,29582,29375,2822,32197,745
2021-08-04,Inyo,027,18085,1478,1465,13,1478,38
2021-08-04,Kern,029,883053,101631,99868,12462,112330,1358
2021-08-04,Kings,031,150075,24412,23840,1223,25063,250
2021-08-04,Lake,033,64148,4671,4423,20,4443,65
2021-08-04,Lassen,035,31185,5423,5340,127,5467,21
2021-08-04,Los Angeles,037,10098052,1285122,1265788,47268,1313056,24737
2021-08-04,Madera,039,155013,17656,17251,1074,18325,245
2021-08-04,Marin,041,260295,15358,14950,303,15253,239
2021-08-04,Mariposa,043,17540,530,497,11,508,5
2021-08-04,Mendocino,045,87422,4796,4560,107,4667,49
2021-08-04,Merced,047,269075,32599,32274,1153,33427,476
2021-08-04,Modoc,049,8938,431,416,149,565,5
2021-08-04,Mono,051,14174,1324,1307,18,1325,3
2021-08-04,Monterey,053,433212,44337,43926,2074,46000,526
2021-08-04,Napa,055,140530,10761,10544,62,10606,82
2021-08-04,Nevada,057,99092,6108,5702,211,5913,73
2021-08-04,Orange,059,3164182,272103,267199,12471,279670,5146
2021-08-04,Placer,061,380077,26789,25688,2048,27736,305
2021-08-04,Plumas,063,18699,804,784,14,798,5
2021-08-04,Riverside,065,2383286,311282,304272,14841,319113,4562
2021-08-04,Sacramento,067,1510023,121307,117882,2316,120198,1736
2021-08-04,San Benito,069,59416,6364,6300,119,6419,63
2021-08-04,San Bernardino,071,2135413,308893,304164,9541,313705,5285
2021-08-04,San Diego,073,3302833,306453,301100,17635,318735,3805
2021-08-04,San Francisco,075,870044,43570,41913,1691,43604,562
2021-08-04,San Joaquin,077,732212,79457,77846,4073,81919,1466
2021-08-04,San Luis Obispo,079,281455,22860,22245,842,23087,262
2021-08-04,San Mateo,081,765935,46367,45392,653,46045,548
2021-08-04,Santa Barbara,083,443738,36600,36013,1250,37263,470
2021-08-04,Santa Clara,085,1922200,126638,124127,893,125020,2183
2021-08-04,Santa Cruz,087,273765,17213,16820,851,17671,208
2021-08-04,Shasta,089,179085,13522,13134,1818,14952,211
2021-08-04,Sierra,091,2930,78,73,12,85,0
2021-08-04,Siskiyou,093,43540,2128,2010,476,2486,32
2021-08-04,Solano,095,438530,37261,36025,799,36824,262
2021-08-04,Sonoma,097,501317,34357,33311,407,33718,330
2021-08-04,Stanislaus,099,539301,60529,59396,6495,65891,1037
2021-08-04,Sutter,101,95872,10479,10294,111,10405,127
2021-08-04,Tehama,103,63373,5412,5281,643,5924,66
2021-08-04,Trinity,105,12862,526,362,122,484,3
2021-08-04,Tulare,107,460477,52012,50797,10000,60797,855
2021-08-04,Tuolumne,109,53932,4719,4584,45,4629,64
2021-08-04,Ventura,111,848112,85921,84406,3604,88010,1047
2021-08-04,Yolo,113,214977,15593,15189,559,15748,215
2021-08-04,Yuba,115,75493,6995,6827,161,6988,50
2021-08-03,Alameda,001,1643700,99718,97275,2259,99534,1270
2021-08-03,Alpine,003,1148,90,91,0,91,0
2021-08-03,Amador,005,37829,4073,3953,34,3987,48
2021-08-03,Butte,007,227075,13849,13468,2084,15552,205
2021-08-03,Calaveras,009,45235,2439,2356,16,2372,57
2021-08-03,Colusa,011,21464,2080,2023,365,2388,16
2021-08-03,Contra Costa,013,1133247,79878,77739,1573,79312,836
2021-08-03,Del Norte,015,27424,1832,1691,14,1705,8
2021-08-03,El Dorado,017,186661,11692,11255,921,12176,117
2021-08-03,Fresno,019,978130,107912,105732,9348,115080,1746
2021-08-03,Glenn,021,27897,2540,2481,607,3088,20
2021-08-03,Humboldt,023,135768,5561,5199,89,5288,52
2021-08-03,Imperial,025,180216,29560,29333,2815,32148,745
2021-08-03,Inyo,027,18085,1475,1459,13,1472,38
2021-08-03,Kern,029,883053,101369,99708,12383,112091,1358
2021-08-03,Kings,031,150075,24324,23780,1216,24996,249
2021-08-03,Lake,033,64148,4615,4408,16,4424,66
2021-08-03,Lassen,035,31185,5413,5341,127,5468,21
2021-08-03,Los Angeles,037,10098052,1281385,1262678,47087,1309765,24721
2021-08-03,Madera,039,155013,17615,17220,1059,18279,245
2021-08-03,Marin,041,260295,15309,14906,300,15206,243
2021-08-03,Mariposa,043,17540,519,495,11,506,5
2021-08-03,Mendocino,045,87422,4747,4546,106,4652,49
2021-08-03,Merced,047,269075,32516,32197,1151,33348,476
2021-08-03,Modoc,049,8938,431,416,149,565,5
2021-08-03,Mono,051,14174,1319,1303,18,1321,3
2021-08-03,Monterey,053,433212,44273,43872,2061,45933,525
2021-08-03,Napa,055,140530,10718,10527,61,10588,82
2021-08-03,Nevada,057,99092,6027,5685,210,5895,73
2021-08-03,Orange,059,3164182,271364,266649,12441,279090,5146
2021-08-03,Placer,061,380077,26588,25624,2023,27647,305
2021-08-03,Plumas,063,18699,797,779,14,793,5
2021-08-03,Riverside,065,2383286,310358,303499,14814,318313,4562
2021-08-03,Sacramento,067,1510023,120563,117591,2295,119886,1732
2021-08-03,San Benito,069,59416,6348,6284,118,6402,63
2021-08-03,San Bernardino,071,2135413,307971,303386,9521,312907,5265
2021-08-03,San Diego,073,3302833,305018,300189,17525,317714,3803
2021-08-03,San Francisco,075,870044,43288,41758,1671,43429,562
2021-08-03,San Joaquin,077,732212,79108,77615,4052,81667,1461
2021-08-03,San Luis Obispo,079,281455,22720,22166,835,23001,264
2021-08-03,San Mateo,081,765935,46173,45255,648,45903,548
2021-08-03,Santa Barbara,083,443738,36481,35912,1244,37156,469
2021-08-03,Santa Clara,085,1922200,126217,123914,887,124801,2183
2021-08-03,Santa Cruz,087,273765,17147,16778,848,17626,207
2021-08-03,Shasta,089,179085,13449,13091,1807,14898,211
2021-08-03,Sierra,091,2930,78,72,12,84,0
2021-08-03,Siskiyou,093,43540,2117,1998,471,2469,32
2021-08-03,Solano,095,438530,37041,35953,787,36740,261
2021-08-03,Sonoma,097,501317,34176,33243,406,33649,330
2021-08-03,Stanislaus,099,539301,60308,59282,6476,65758,1037
2021-08-03,Sutter,101,95872,10439,10263,110,10373,127
2021-08-03,Tehama,103,63373,5387,5269,638,5907,66
2021-08-03,Trinity,105,12862,523,361,119,480,3
2021-08-03,Tulare,107,460477,51917,50729,9954,60683,854
2021-08-03,Tuolumne,109,53932,4684,4563,45,4608,64
2021-08-03,Ventura,111,848112,85677,84270,3583,87853,1046
2021-08-03,Yolo,113,214977,15502,15149,545,15694,215
2021-08-03,Yuba,115,75493,6958,6781,159,6940,50
2021-08-02,Alameda,001,1643700,99161,96954,2254,99208,1270
2021-08-02,Alpine,003,1148,90,91,0,91,0
2021-08-02,Amador,005,37829,4053,3927,34,3961,48
2021-08-02,Butte,007,227075,13769,13442,2065,15507,205
2021-08-02,Calaveras,009,45235,2413,2347,16,2363,57
2021-08-02,Colusa,011,21464,2068,2019,362,2381,16
2021-08-02,Contra Costa,013,1133247,79368,77516,1559,79075,836
2021-08-02,Del Norte,015,27424,1802,1653,14,1667,8
2021-08-02,El Dorado,017,186661,11589,11226,907,12133,116
2021-08-02,Fresno,019,978130,107566,105471,9310,114781,1744
2021-08-02,Glenn,021,27897,2532,2477,604,3081,20
2021-08-02,Humboldt,023,135768,5478,5161,87,5248,52
2021-08-02,Imperial,025,180216,29527,29302,2812,32114,743
2021-08-02,Inyo,027,18085,1469,1455,13,1468,38
2021-08-02,Kern,029,883053,101114,99556,12290,111846,1357
2021-08-02,Kings,031,150075,24254,23722,1210,24932,249
2021-08-02,Lake,033,64148,4572,4375,16,4391,66
2021-08-02,Lassen,035,31185,5390,5338,125,5463,21
2021-08-02,Los Angeles,037,10098052,1277666,1260807,46877,1307684,24705
2021-08-02,Madera,039,155013,17571,17158,1046,18204,245
2021-08-02,Marin,041,260295,15266,14859,298,15157,239
2021-08-02,Mariposa,043,17540,510,490,11,501,5
2021-08-02,Mendocino,045,87422,4707,4512,103,4615,49
2021-08-02,Merced,047,269075,32418,32163,1144,33307,474
2021-08-02,Modoc,049,8938,431,415,149,564,5
2021-08-02,Mono,051,14174,1312,1296,18,1314,3
2021-08-02,Monterey,053,433212,44213,43842,2053,45895,525
2021-08-02,Napa,055,140530,10675,10490,58,10548,82
2021-08-02,Nevada,057,99092,5956,5611,209,5820,73
2021-08-02,Orange,059,3164182,270450,266050,12395,278445,5146
2021-08-02,Placer,061,380077,26441,25516,1989,27505,306
2021-08-02,Plumas,063,18699,790,762,14,776,5
2021-08-02,Riverside,065,2383286,309420,302756,14799,317555,4562
2021-08-02,Sacramento,067,1510023,119866,117183,2274,119457,1728
2021-08-02,San Benito,069,59416,6329,6276,117,6393,63
2021-08-02,San Bernardino,071,2135413,307094,303000,9489,312489,5253
2021-08-02,San Diego,073,3302833,303538,299021,17445,316466,3798
2021-08-02,San Francisco,075,870044,43001,41553,1647,43200,562
2021-08-02,San Joaquin,077,732212,78765,77447,4025,81472,1461
2021-08-02,San Luis Obispo,079,281455,22626,22093,828,22921,261
2021-08-02,San Mateo,081,765935,45998,45154,635,45789,548
2021-08-02,Santa Barbara,083,443738,36342,35851,1238,37089,469
2021-08-02,Santa Clara,085,1922200,125747,123655,879,124534,2183
2021-08-02,Santa Cruz,087,273765,17089,16746,844,17590,207
2021-08-02,Shasta,089,179085,13386,13049,1793,14842,212
2021-08-02,Sierra,091,2930,78,71,12,83,0
2021-08-02,Siskiyou,093,43540,2106,1992,457,2449,31
2021-08-02,Solano,095,438530,36793,35852,774,36626,260
2021-08-02,Sonoma,097,501317,33950,33132,401,33533,330
2021-08-02,Stanislaus,099,539301,60089,59160,6448,65608,1037
2021-08-02,Sutter,101,95872,10393,10220,110,10330,127
2021-08-02,Tehama,103,63373,5363,5260,634,5894,66
2021-08-02,Trinity,105,12862,518,359,118,477,3
2021-08-02,Tulare,107,460477,51815,50640,9880,60520,854
2021-08-02,Tuolumne,109,53932,4617,4524,45,4569,64
2021-08-02,Ventura,111,848112,85492,84143,3560,87703,1044
2021-08-02,Yolo,113,214977,15404,15072,527,15599,215
2021-08-02,Yuba,115,75493,6916,6743,156,6899,50
2021-08-01,Alameda,001,1643700,98624,96775,2248,99023,1270
2021-08-01,Alpine,003,1148,90,91,0,91,0
2021-08-01,Amador,005,37829,4015,3923,34,3957,48
2021-08-01,Butte,007,227075,13688,13406,2048,15454,205
2021-08-01,Calaveras,009,45235,2389,2341,16,2357,57
2021-08-01,Colusa,011,21464,2057,2014,360,2374,16
2021-08-01,Contra Costa,013,1133247,78933,77360,1551,78911,836
2021-08-01,Del Norte,015,27424,1770,1642,14,1656,8
2021-08-01,El Dorado,017,186661,11488,11189,897,12086,116
2021-08-01,Fresno,019,978130,107240,105339,9263,114602,1744
2021-08-01,Glenn,021,27897,2526,2476,601,3077,20
2021-08-01,Humboldt,023,135768,5401,5118,83,5201,52
2021-08-01,Imperial,025,180216,29492,29297,2807,32104,743
2021-08-01,Inyo,027,18085,1467,1454,13,1467,38
2021-08-01,Kern,029,883053,100836,99396,12216,111612,1357
2021-08-01,Kings,031,150075,24167,23700,1205,24905,249
2021-08-01,Lake,033,64148,4493,4356,16,4372,66
2021-08-01,Lassen,035,31185,5377,5336,123,5459,21
2021-08-01,Los Angeles,037,10098052,1273979,1258461,46653,1305114,24700
2021-08-01,Madera,039,155013,17514,17146,1041,18187,245
2021-08-01,Marin,041,260295,15189,14844,297,15141,239
2021-08-01,Mariposa,043,17540,503,482,11,493,5
2021-08-01,Mendocino,045,87422,4661,4476,99,4575,49
2021-08-01,Merced,047,269075,32326,32144,1138,33282,474
2021-08-01,Modoc,049,8938,429,413,149,562,5
2021-08-01,Mono,051,14174,1309,1294,18,1312,3
2021-08-01,Monterey,053,433212,44166,43808,2040,45848,525
2021-08-01,Napa,055,140530,10627,10473,56,10529,82
2021-08-01,Nevada,057,99092,5869,5561,208,5769,73
2021-08-01,Orange,059,3164182,269637,265467,12352,277819,5146
2021-08-01,Placer,061,380077,26226,25464,1959,27423,306
2021-08-01,Plumas,063,18699,784,761,14,775,5
2021-08-01,Riverside,065,2383286,308487,302256,14781,317037,4562
2021-08-01,Sacramento,067,1510023,119130,116923,2258,119181,1727
2021-08-01,San Benito,069,59416,6312,6271,117,6388,63
2021-08-01,San Bernardino,071,2135413,306160,302542,9478,312020,5248
2021-08-01,San Diego,073,3302833,302352,298002,17380,315382,3798
2021-08-01,San Francisco,075,870044,42663,41432,1634,43066,562
2021-08-01,San Joaquin,077,732212,78399,77338,3998,81336,1461
2021-08-01,San Luis Obispo,079,281455,22523,22083,823,22906,261
2021-08-01,San Mateo,081,765935,45816,45036,627,45663,548
2021-08-01,Santa Barbara,083,443738,36218,35809,1234,37043,469
2021-08-01,Santa Clara,085,1922200,125335,123511,871,124382,2183
2021-08-01,Santa Cruz,087,273765,17010,16709,837,17546,207
2021-08-01,Shasta,089,179085,13315,13036,1784,14820,212
2021-08-01,Sierra,091,2930,76,71,12,83,0
2021-08-01,Siskiyou,093,43540,2100,1989,451,2440,31
2021-08-01,Solano,095,438530,36558,35800,765,36565,260
2021-08-01,Sonoma,097,501317,33758,33076,398,33474,330
2021-08-01,Stanislaus,099,539301,59852,59078,6416,65494,1037
2021-08-01,Sutter,101,95872,10338,10198,107,10305,127
2021-08-01,Tehama,103,63373,5346,5252,630,5882,66
2021-08-01,Trinity,105,12862,515,359,117,476,3
2021-08-01,Tulare,107,460477,51658,50600,9817,60417,854
2021-08-01,Tuolumne,109,53932,4579,4489,45,4534,64
2021-08-01,Ventura,111,848112,85262,84040,3545,87585,1044
2021-08-01,Yolo,113,214977,15332,15042,518,15560,215
2021-08-01,Yuba,115,75493,6879,6721,155,6876,50
2021-07-31,Alameda,001,1643700,98297,95279,2242,97521,1265
2021-07-31,Alpine,003,1148,90,89,0,89,0
2021-07-31,Amador,005,37829,3995,3877,34,3911,48
2021-07-31,Butte,007,227075,13655,13235,2028,15263,205
2021-07-31,Calaveras,009,45235,2380,2294,16,2310,57
2021-07-31,Colusa,011,21464,2051,2006,358,2364,16
2021-07-31,Contra Costa,013,1133247,78654,75866,1549,77415,832
2021-07-31,Del Norte,015,27424,1744,1576,14,1590,8
2021-07-31,El Dorado,017,186661,11435,11017,891,11908,116
2021-07-31,Fresno,019,978130,107081,104639,9249,113888,1744
2021-07-31,Glenn,021,27897,2521,2465,596,3061,20
2021-07-31,Humboldt,023,135768,5346,4978,82,5060,52
2021-07-31,Imperial,025,180216,29475,29164,2804,31968,743
2021-07-31,Inyo,027,18085,1464,1442,13,1455,38
2021-07-31,Kern,029,883053,100671,98903,12157,111060,1357
2021-07-31,Kings,031,150075,24114,23548,1200,24748,248
2021-07-31,Lake,033,64148,4468,4238,16,4254,66
2021-07-31,Lassen,035,31185,5370,5320,123,5443,21
2021-07-31,Los Angeles,037,10098052,1271783,1248545,46505,1295050,24691
2021-07-31,Madera,039,155013,17481,17058,1035,18093,245
2021-07-31,Marin,041,260295,15145,14701,296,14997,239
2021-07-31,Mariposa,043,17540,494,470,11,481,5
2021-07-31,Mendocino,045,87422,4636,4400,96,4496,49
2021-07-31,Merced,047,269075,32278,31959,1133,33092,474
2021-07-31,Modoc,049,8938,429,413,149,562,5
2021-07-31,Mono,051,14174,1307,1287,18,1305,3
2021-07-31,Monterey,053,433212,44127,43720,2030,45750,525
2021-07-31,Napa,055,140530,10607,10401,55,10456,82
2021-07-31,Nevada,057,99092,5830,5373,207,5580,72
2021-07-31,Orange,059,3164182,269063,263446,12333,275779,5144
2021-07-31,Placer,061,380077,26093,25104,1952,27056,306
2021-07-31,Plumas,063,18699,781,743,14,757,5
2021-07-31,Riverside,065,2383286,307871,300315,14771,315086,4554
2021-07-31,Sacramento,067,1510023,118718,115259,2252,117511,1720
2021-07-31,San Benito,069,59416,6301,6251,117,6368,63
2021-07-31,San Bernardino,071,2135413,305588,300726,9475,310201,5240
2021-07-31,San Diego,073,3302833,301679,295054,17334,312388,3798
2021-07-31,San Francisco,075,870044,42436,40412,1614,42026,562
2021-07-31,San Joaquin,077,732212,78234,76575,3985,80560,1443
2021-07-31,San Luis Obispo,079,281455,22469,21922,821,22743,260
2021-07-31,San Mateo,081,765935,45659,44622,622,45244,548
2021-07-31,Santa Barbara,083,443738,36137,35531,1233,36764,467
2021-07-31,Santa Clara,085,1922200,125080,122614,869,123483,2099
2021-07-31,Santa Cruz,087,273765,16971,16576,836,17412,207
2021-07-31,Shasta,089,179085,13278,12918,1776,14694,212
2021-07-31,Sierra,091,2930,76,68,12,80,0
2021-07-31,Siskiyou,093,43540,2091,1976,445,2421,31
2021-07-31,Solano,095,438530,36457,35340,757,36097,263
2021-07-31,Sonoma,097,501317,33632,32601,398,32999,329
2021-07-31,Stanislaus,099,539301,59693,58586,6393,64979,1035
2021-07-31,Sutter,101,95872,10304,10068,106,10174,127
2021-07-31,Tehama,103,63373,5331,5216,627,5843,66
2021-07-31,Trinity,105,12862,514,354,116,470,3
2021-07-31,Tulare,107,460477,51569,50409,9764,60173,854
2021-07-31,Tuolumne,109,53932,4540,4362,45,4407,64
2021-07-31,Ventura,111,848112,85101,83509,3528,87037,1044
2021-07-31,Yolo,113,214977,15284,14863,507,15370,215
2021-07-31,Yuba,115,75493,6856,6615,151,6766,50
2021-07-30,Alameda,001,1643700,97965,95279,2238,97517,1265
2021-07-30,Alpine,003,1148,90,89,0,89,0
2021-07-30,Amador,005,37829,3972,3877,34,3911,48
2021-07-30,Butte,007,227075,13600,13235,2015,15250,205
2021-07-30,Calaveras,009,45235,2370,2294,16,2310,57
2021-07-30,Colusa,011,21464,2047,2006,356,2362,16
2021-07-30,Contra Costa,013,1133247,78410,75866,1545,77411,832
2021-07-30,Del Norte,015,27424,1726,1576,14,1590,8
2021-07-30,El Dorado,017,186661,11402,11017,885,11902,116
2021-07-30,Fresno,019,978130,106887,104639,9237,113876,1744
2021-07-30,Glenn,021,27897,2516,2465,595,3060,20
2021-07-30,Humboldt,023,135768,5282,4978,79,5057,52
2021-07-30,Imperial,025,180216,29461,29164,2801,31965,743
2021-07-30,Inyo,027,18085,1463,1442,13,1455,38
2021-07-30,Kern,029,883053,100546,98903,12110,111013,1357
2021-07-30,Kings,031,150075,24074,23548,1196,24744,248
2021-07-30,Lake,033,64148,4440,4238,16,4254,66
2021-07-30,Lassen,035,31185,5366,5320,123,5443,21
2021-07-30,Los Angeles,037,10098052,1269462,1248545,46354,1294899,24691
2021-07-30,Madera,039,155013,17439,17058,1032,18090,245
2021-07-30,Marin,041,260295,15111,14701,296,14997,239
2021-07-30,Mariposa,043,17540,490,470,11,481,5
2021-07-30,Mendocino,045,87422,4606,4400,95,4495,49
2021-07-30,Merced,047,269075,32237,31959,1129,33088,474
2021-07-30,Modoc,049,8938,427,413,149,562,5
2021-07-30,Mono,051,14174,1302,1287,18,1305,3
2021-07-30,Monterey,053,433212,44093,43720,2021,45741,525
2021-07-30,Napa,055,140530,10585,10401,54,10455,82
2021-07-30,Nevada,057,99092,5773,5373,207,5580,72
2021-07-30,Orange,059,3164182,268437,263446,12307,275753,5144
2021-07-30,Placer,061,380077,26004,25104,1934,27038,306
2021-07-30,Plumas,063,18699,776,743,14,757,5
2021-07-30,Riverside,065,2383286,307233,300315,14761,315076,4554
2021-07-30,Sacramento,067,1510023,118267,115259,2248,117507,1720
2021-07-30,San Benito,069,59416,6294,6251,117,6368,63
2021-07-30,San Bernardino,071,2135413,305074,300726,9469,310195,5240
2021-07-30,San Diego,073,3302833,300906,295054,17276,312330,3798
2021-07-30,San Francisco,075,870044,42223,40412,1599,42011,562
2021-07-30,San Joaquin,077,732212,78080,76575,3980,80555,1443
2021-07-30,San Luis Obispo,079,281455,22431,21922,817,22739,260
2021-07-30,San Mateo,081,765935,45535,44622,609,45231,548
2021-07-30,Santa Barbara,083,443738,36068,35531,1227,36758,467
2021-07-30,Santa Clara,085,1922200,124856,122614,867,123481,2099
2021-07-30,Santa Cruz,087,273765,16945,16576,834,17410,207
2021-07-30,Shasta,089,179085,13232,12918,1776,14694,212
2021-07-30,Sierra,091,2930,75,68,12,80,0
2021-07-30,Siskiyou,093,43540,2082,1976,444,2420,31
2021-07-30,Solano,095,438530,36366,35340,741,36081,263
2021-07-30,Sonoma,097,501317,33537,32601,398,32999,329
2021-07-30,Stanislaus,099,539301,59549,58586,6373,64959,1035
2021-07-30,Sutter,101,95872,10269,10068,106,10174,127
2021-07-30,Tehama,103,63373,5320,5216,627,5843,66
2021-07-30,Trinity,105,12862,514,354,116,470,3
2021-07-30,Tulare,107,460477,51526,50409,9729,60138,854
2021-07-30,Tuolumne,109,53932,4522,4362,45,4407,64
2021-07-30,Ventura,111,848112,84937,83509,3513,87022,1044
2021-07-30,Yolo,113,214977,15223,14863,503,15366,215
2021-07-30,Yuba,115,75493,6820,6615,150,6765,50
2021-07-29,Alameda,001,1643700,97546,95279,2233,97512,1265
2021-07-29,Alpine,003,1148,90,89,0,89,0
2021-07-29,Amador,005,37829,3953,3877,34,3911,48
2021-07-29,Butte,007,227075,13553,13235,2007,15242,205
2021-07-29,Calaveras,009,45235,2356,2294,16,2310,57
2021-07-29,Colusa,011,21464,2040,2006,356,2362,16
2021-07-29,Contra Costa,013,1133247,77970,75866,1541,77407,832
2021-07-29,Del Norte,015,27424,1702,1576,14,1590,8
2021-07-29,El Dorado,017,186661,11338,11017,873,11890,116
2021-07-29,Fresno,019,978130,106622,104639,9209,113848,1744
2021-07-29,Glenn,021,27897,2506,2465,594,3059,20
2021-07-29,Humboldt,023,135768,5222,4978,77,5055,52
2021-07-29,Imperial,025,180216,29415,29164,2799,31963,743
2021-07-29,Inyo,027,18085,1459,1442,13,1455,38
2021-07-29,Kern,029,883053,100340,98903,12032,110935,1357
2021-07-29,Kings,031,150075,24028,23548,1192,24740,248
2021-07-29,Lake,033,64148,4405,4238,16,4254,66
2021-07-29,Lassen,035,31185,5358,5320,120,5440,21
2021-07-29,Los Angeles,037,10098052,1266372,1248545,46168,1294713,24691
2021-07-29,Madera,039,155013,17392,17058,1028,18086,245
2021-07-29,Marin,041,260295,15068,14701,296,14997,239
2021-07-29,Mariposa,043,17540,486,470,11,481,5
2021-07-29,Mendocino,045,87422,4583,4400,93,4493,49
2021-07-29,Merced,047,269075,32182,31959,1129,33088,474
2021-07-29,Modoc,049,8938,427,413,149,562,5
2021-07-29,Mono,051,14174,1300,1287,18,1305,3
2021-07-29,Monterey,053,433212,44044,43720,2011,45731,525
2021-07-29,Napa,055,140530,10553,10401,52,10453,82
2021-07-29,Nevada,057,99092,5721,5373,206,5579,72
2021-07-29,Orange,059,3164182,267725,263446,12275,275721,5144
2021-07-29,Placer,061,380077,25881,25104,1919,27023,306
2021-07-29,Plumas,063,18699,768,743,14,757,5
2021-07-29,Riverside,065,2383286,306528,300315,14737,315052,4554
2021-07-29,Sacramento,067,1510023,117712,115259,2235,117494,1720
2021-07-29,San Benito,069,59416,6283,6251,117,6368,63
2021-07-29,San Bernardino,071,2135413,304435,300726,9459,310185,5240
2021-07-29,San Diego,073,3302833,299848,295054,17208,312262,3798
2021-07-29,San Francisco,075,870044,41976,40412,1578,41990,562
2021-07-29,San Joaquin,077,732212,77824,76575,3972,80547,1443
2021-07-29,San Luis Obispo,079,281455,22377,21922,815,22737,260
2021-07-29,San Mateo,081,765935,45408,44622,599,45221,548
2021-07-29,Santa Barbara,083,443738,35982,35531,1226,36757,467
2021-07-29,Santa Clara,085,1922200,124559,122614,864,123478,2099
2021-07-29,Santa Cruz,087,273765,16892,16576,832,17408,207
2021-07-29,Shasta,089,179085,13178,12918,1767,14685,212
2021-07-29,Sierra,091,2930,75,68,12,80,0
2021-07-29,Siskiyou,093,43540,2077,1976,442,2418,31
2021-07-29,Solano,095,438530,36206,35340,731,36071,263
2021-07-29,Sonoma,097,501317,33363,32601,396,32997,329
2021-07-29,Stanislaus,099,539301,59377,58586,6358,64944,1035
2021-07-29,Sutter,101,95872,10223,10068,105,10173,127
2021-07-29,Tehama,103,63373,5308,5216,621,5837,66
2021-07-29,Trinity,105,12862,512,354,115,469,3
2021-07-29,Tulare,107,460477,51436,50409,9689,60098,854
2021-07-29,Tuolumne,109,53932,4482,4362,44,4406,64
2021-07-29,Ventura,111,848112,84771,83509,3506,87015,1044
2021-07-29,Yolo,113,214977,15155,14863,489,15352,215
2021-07-29,Yuba,115,75493,6771,6615,147,6762,50
2021-07-28,Alameda,001,1643700,97080,94965,2226,97191,1262
2021-07-28,Alpine,003,1148,90,89,0,89,0
2021-07-28,Amador,005,37829,3939,3870,34,3904,48
2021-07-28,Butte,007,227075,13496,13184,1994,15178,205
2021-07-28,Calaveras,009,45235,2336,2289,16,2305,57
2021-07-28,Colusa,011,21464,2037,2001,355,2356,16
2021-07-28,Contra Costa,013,1133247,77483,75487,1533,77020,832
2021-07-28,Del Norte,015,27424,1669,1545,14,1559,8
2021-07-28,El Dorado,017,186661,11289,10967,863,11830,116
2021-07-28,Fresno,019,978130,106374,104458,9188,113646,1744
2021-07-28,Glenn,021,27897,2503,2464,591,3055,20
2021-07-28,Humboldt,023,135768,5171,4946,76,5022,52
2021-07-28,Imperial,025,180216,29368,29096,2799,31895,743
2021-07-28,Inyo,027,18085,1453,1439,12,1451,38
2021-07-28,Kern,029,883053,100184,98781,11985,110766,1352
2021-07-28,Kings,031,150075,23964,23503,1182,24685,248
2021-07-28,Lake,033,64148,4359,4191,15,4206,65
2021-07-28,Lassen,035,31185,5350,5318,120,5438,21
2021-07-28,Los Angeles,037,10098052,1263208,1245485,45981,1291466,24673
2021-07-28,Madera,039,155013,17351,17024,1022,18046,245
2021-07-28,Marin,041,260295,15013,14652,296,14948,239
2021-07-28,Mariposa,043,17540,479,469,11,480,5
2021-07-28,Mendocino,045,87422,4555,4377,93,4470,49
2021-07-28,Merced,047,269075,32126,31886,1125,33011,474
2021-07-28,Modoc,049,8938,425,413,149,562,5
2021-07-28,Mono,051,14174,1299,1286,18,1304,3
2021-07-28,Monterey,053,433212,43997,43668,2001,45669,524
2021-07-28,Napa,055,140530,10513,10376,50,10426,82
2021-07-28,Nevada,057,99092,5667,5320,206,5526,72
2021-07-28,Orange,059,3164182,266932,262735,12245,274980,5143
2021-07-28,Placer,061,380077,25734,24978,1903,26881,306
2021-07-28,Plumas,063,18699,763,754,14,768,5
2021-07-28,Riverside,065,2383286,305760,299611,14718,314329,4554
2021-07-28,Sacramento,067,1510023,117061,114665,2215,116880,1714
2021-07-28,San Benito,069,59416,6272,6236,117,6353,63
2021-07-28,San Bernardino,071,2135413,303814,300121,9447,309568,5236
2021-07-28,San Diego,073,3302833,298567,294176,17142,311318,3798
2021-07-28,San Francisco,075,870044,41673,40144,1552,41696,561
2021-07-28,San Joaquin,077,732212,77573,76312,3942,80254,1443
2021-07-28,San Luis Obispo,079,281455,22318,21865,814,22679,260
2021-07-28,San Mateo,081,765935,45258,44477,590,45067,547
2021-07-28,Santa Barbara,083,443738,35907,35431,1221,36652,467
2021-07-28,Santa Clara,085,1922200,124298,122345,862,123207,2099
2021-07-28,Santa Cruz,087,273765,16854,16551,831,17382,207
2021-07-28,Shasta,089,179085,13134,12882,1757,14639,212
2021-07-28,Sierra,091,2930,71,67,12,79,0
2021-07-28,Siskiyou,093,43540,2068,1971,439,2410,31
2021-07-28,Solano,095,438530,36032,35204,724,35928,262
2021-07-28,Sonoma,097,501317,33220,32434,393,32827,328
2021-07-28,Stanislaus,099,539301,59180,58427,6342,64769,1035
2021-07-28,Sutter,101,95872,10191,10033,104,10137,126
2021-07-28,Tehama,103,63373,5296,5209,618,5827,66
2021-07-28,Trinity,105,12862,511,352,115,467,3
2021-07-28,Tulare,107,460477,51348,50363,9642,60005,854
2021-07-28,Tuolumne,109,53932,4443,4313,44,4357,64
2021-07-28,Ventura,111,848112,84575,83360,3490,86850,1043
2021-07-28,Yolo,113,214977,15083,14801,480,15281,215
2021-07-28,Yuba,115,75493,6738,6591,146,6737,51
2021-07-27,Alameda,001,1643700,96677,94682,2217,96899,1256
2021-07-27,Alpine,003,1148,90,89,0,89,0
2021-07-27,Amador,005,37829,3923,3861,34,3895,48
2021-07-27,Butte,007,227075,13448,13127,1983,15110,205
2021-07-27,Calaveras,009,45235,2326,2280,16,2296,57
2021-07-27,Colusa,011,21464,2028,1999,354,2353,16
2021-07-27,Contra Costa,013,1133247,76998,75227,1529,76756,830
2021-07-27,Del Norte,015,27424,1649,1538,14,1552,8
2021-07-27,El Dorado,017,186661,11229,10941,853,11794,116
2021-07-27,Fresno,019,978130,106081,104288,9164,113452,1746
2021-07-27,Glenn,021,27897,2495,2460,589,3049,20
2021-07-27,Humboldt,023,135768,5117,4925,75,5000,52
2021-07-27,Imperial,025,180216,29323,29048,2798,31846,743
2021-07-27,Inyo,027,18085,1451,1430,12,1442,38
2021-07-27,Kern,029,883053,100014,98724,11929,110653,1352
2021-07-27,Kings,031,150075,23907,23463,1172,24635,248
2021-07-27,Lake,033,64148,4320,4157,15,4172,65
2021-07-27,Lassen,035,31185,5344,5315,120,5435,21
2021-07-27,Los Angeles,037,10098052,1259753,1243336,45768,1289104,24658
2021-07-27,Madera,039,155013,17298,16998,1017,18015,245
2021-07-27,Marin,041,260295,14965,14631,293,14924,239
2021-07-27,Mariposa,043,17540,476,468,11,479,5
2021-07-27,Mendocino,045,87422,4532,4371,93,4464,49
2021-07-27,Merced,047,269075,32059,31825,1122,32947,473
2021-07-27,Modoc,049,8938,424,413,149,562,5
2021-07-27,Mono,051,14174,1295,1288,18,1306,3
2021-07-27,Monterey,053,433212,43957,43646,1990,45636,523
2021-07-27,Napa,055,140530,10483,10354,50,10404,82
2021-07-27,Nevada,057,99092,5590,5305,204,5509,72
2021-07-27,Orange,059,3164182,266188,262193,12220,274413,5143
2021-07-27,Placer,061,380077,25575,24916,1877,26793,306
2021-07-27,Plumas,063,18699,760,752,14,766,5
2021-07-27,Riverside,065,2383286,305031,299160,14699,313859,4554
2021-07-27,Sacramento,067,1510023,116458,114413,2206,116619,1710
2021-07-27,San Benito,069,59416,6263,6229,117,6346,63
2021-07-27,San Bernardino,071,2135413,303125,299593,9425,309018,5236
2021-07-27,San Diego,073,3302833,297476,293408,17068,310476,3798
2021-07-27,San Francisco,075,870044,41315,39939,1534,41473,561
2021-07-27,San Joaquin,077,732212,77310,76166,3922,80088,1442
2021-07-27,San Luis Obispo,079,281455,22263,21803,805,22608,260
2021-07-27,San Mateo,081,765935,45106,44378,587,44965,547
2021-07-27,Santa Barbara,083,443738,35812,35355,1219,36574,467
2021-07-27,Santa Clara,085,1922200,124004,122154,860,123014,2099
2021-07-27,Santa Cruz,087,273765,16808,16523,830,17353,207
2021-07-27,Shasta,089,179085,13084,12846,1744,14590,212
2021-07-27,Sierra,091,2930,71,65,12,77,0
2021-07-27,Siskiyou,093,43540,2063,1964,436,2400,31
2021-07-27,Solano,095,438530,35900,35093,714,35807,261
2021-07-27,Sonoma,097,501317,33076,32367,391,32758,328
2021-07-27,Stanislaus,099,539301,59011,58333,6314,64647,1033
2021-07-27,Sutter,101,95872,10150,9998,104,10102,115
2021-07-27,Tehama,103,63373,5275,5192,616,5808,66
2021-07-27,Trinity,105,12862,510,351,115,466,3
2021-07-27,Tulare,107,460477,51282,50324,9611,59935,854
2021-07-27,Tuolumne,109,53932,4391,4282,44,4326,64
2021-07-27,Ventura,111,848112,84367,83189,3478,86667,1043
2021-07-27,Yolo,113,214977,15009,14759,475,15234,215
2021-07-27,Yuba,115,75493,6716,6564,144,6708,51
2021-07-26,Alameda,001,1643700,96234,94436,2211,96647,1259
2021-07-26,Alpine,003,1148,90,89,0,89,0
2021-07-26,Amador,005,37829,3913,3854,34,3888,48
2021-07-26,Butte,007,227075,13393,13082,1972,15054,203
2021-07-26,Calaveras,009,45235,2320,2276,16,2292,57
2021-07-26,Colusa,011,21464,2021,1996,352,2348,16
2021-07-26,Contra Costa,013,1133247,76502,74854,1522,76376,830
2021-07-26,Del Norte,015,27424,1628,1530,14,1544,8
2021-07-26,El Dorado,017,186661,11165,10899,850,11749,116
2021-07-26,Fresno,019,978130,105877,104143,9140,113283,1742
2021-07-26,Glenn,021,27897,2493,2461,588,3049,20
2021-07-26,Humboldt,023,135768,5078,4906,73,4979,52
2021-07-26,Imperial,025,180216,29283,29034,2798,31832,743
2021-07-26,Inyo,027,18085,1446,1429,12,1441,38
2021-07-26,Kern,029,883053,99848,98633,11864,110497,1351
2021-07-26,Kings,031,150075,23858,23426,1168,24594,247
2021-07-26,Lake,033,64148,4299,4133,15,4148,65
2021-07-26,Lassen,035,31185,5340,5314,120,5434,21
2021-07-26,Los Angeles,037,10098052,1256417,1241527,45595,1287122,24647
2021-07-26,Madera,039,155013,17270,16971,1010,17981,245
2021-07-26,Marin,041,260295,14908,14579,292,14871,239
2021-07-26,Mariposa,043,17540,475,467,11,478,5
2021-07-26,Mendocino,045,87422,4511,4354,93,4447,49
2021-07-26,Merced,047,269075,31968,31774,1118,32892,473
2021-07-26,Modoc,049,8938,424,413,149,562,5
2021-07-26,Mono,051,14174,1294,1286,18,1304,3
2021-07-26,Monterey,053,433212,43914,43595,1977,45572,521
2021-07-26,Napa,055,140530,10460,10332,50,10382,82
2021-07-26,Nevada,057,99092,5504,5280,204,5484,72
2021-07-26,Orange,059,3164182,265550,261803,12199,274002,5142
2021-07-26,Placer,061,380077,25439,24842,1856,26698,304
2021-07-26,Plumas,063,18699,756,750,14,764,5
2021-07-26,Riverside,065,2383286,304338,298626,14685,313311,4553
2021-07-26,Sacramento,067,1510023,115859,113986,2190,116176,1705
2021-07-26,San Benito,069,59416,6257,6222,117,6339,63
2021-07-26,San Bernardino,071,2135413,302510,299238,9413,308651,5237
2021-07-26,San Diego,073,3302833,296365,292688,16990,309678,3793
2021-07-26,San Francisco,075,870044,40954,39800,1508,41308,561
2021-07-26,San Joaquin,077,732212,77075,76033,3918,79951,1440
2021-07-26,San Luis Obispo,079,281455,22214,21752,802,22554,260
2021-07-26,San Mateo,081,765935,44958,44297,578,44875,547
2021-07-26,Santa Barbara,083,443738,35739,35311,1207,36518,467
2021-07-26,Santa Clara,085,1922200,123695,121978,851,122829,2099
2021-07-26,Santa Cruz,087,273765,16768,16493,827,17320,207
2021-07-26,Shasta,089,179085,13035,12819,1731,14550,211
2021-07-26,Sierra,091,2930,70,65,12,77,0
2021-07-26,Siskiyou,093,43540,2060,1962,434,2396,31
2021-07-26,Solano,095,438530,35745,34990,706,35696,259
2021-07-26,Sonoma,097,501317,32940,32283,389,32672,328
2021-07-26,Stanislaus,099,539301,58866,58219,6294,64513,1033
2021-07-26,Sutter,101,95872,10110,9963,101,10064,115
2021-07-26,Tehama,103,63373,5265,5183,612,5795,66
2021-07-26,Trinity,105,12862,510,351,114,465,3
2021-07-26,Tulare,107,460477,51216,50265,9580,59845,854
2021-07-26,Tuolumne,109,53932,4360,4271,44,4315,64
2021-07-26,Ventura,111,848112,84194,83072,3463,86535,1041
2021-07-26,Yolo,113,214977,14948,14727,463,15190,215
2021-07-26,Yuba,115,75493,6682,6538,142,6680,51
2021-07-25,Alameda,001,1643700,95741,94146,2205,96351,1259
2021-07-25,Alpine,003,1148,88,89,0,89,0
2021-07-25,Amador,005,37829,3898,3848,34,3882,48
2021-07-25,Butte,007,227075,13354,13074,1962,15036,203
2021-07-25,Calaveras,009,45235,2311,2275,16,2291,57
2021-07-25,Colusa,011,21464,2012,1996,348,2344,16
2021-07-25,Contra Costa,013,1133247,76017,74634,1508,76142,830
2021-07-25,Del Norte,015,27424,1607,1526,14,1540,8
2021-07-25,El Dorado,017,186661,11108,10878,847,11725,116
2021-07-25,Fresno,019,978130,105636,104019,9124,113143,1742
2021-07-25,Glenn,021,27897,2484,2461,586,3047,20
2021-07-25,Humboldt,023,135768,5019,4892,72,4964,52
2021-07-25,Imperial,025,180216,29246,29037,2798,31835,743
2021-07-25,Inyo,027,18085,1441,1427,12,1439,38
2021-07-25,Kern,029,883053,99676,98503,11793,110296,1351
2021-07-25,Kings,031,150075,23804,23396,1164,24560,247
2021-07-25,Lake,033,64148,4246,4109,14,4123,65
2021-07-25,Lassen,035,31185,5335,5314,120,5434,21
2021-07-25,Los Angeles,037,10098052,1253006,1239596,45397,1284993,24643
2021-07-25,Madera,039,155013,17233,16947,1003,17950,245
2021-07-25,Marin,041,260295,14858,14558,289,14847,239
2021-07-25,Mariposa,043,17540,472,465,11,476,5
2021-07-25,Mendocino,045,87422,4482,4335,91,4426,49
2021-07-25,Merced,047,269075,31895,31760,1116,32876,473
2021-07-25,Modoc,049,8938,424,413,149,562,5
2021-07-25,Mono,051,14174,1291,1286,18,1304,3
2021-07-25,Monterey,053,433212,43876,43590,1969,45559,521
2021-07-25,Napa,055,140530,10424,10316,49,10365,82
2021-07-25,Nevada,057,99092,5439,5256,201,5457,72
2021-07-25,Orange,059,3164182,264842,261351,12176,273527,5142
2021-07-25,Placer,061,380077,25317,24755,1835,26590,304
2021-07-25,Plumas,063,18699,754,750,14,764,5
2021-07-25,Riverside,065,2383286,303574,298181,14667,312848,4553
2021-07-25,Sacramento,067,1510023,115309,113611,2174,115785,1704
2021-07-25,San Benito,069,59416,6250,6217,117,6334,63
2021-07-25,San Bernardino,071,2135413,301850,298982,9407,308389,5237
2021-07-25,San Diego,073,3302833,295299,290626,16918,307544,3793
2021-07-25,San Francisco,075,870044,40604,39663,1482,41145,561
2021-07-25,San Joaquin,077,732212,76820,75926,3899,79825,1440
2021-07-25,San Luis Obispo,079,281455,22141,21741,799,22540,260
2021-07-25,San Mateo,081,765935,44795,44189,572,44761,547
2021-07-25,Santa Barbara,083,443738,35659,35261,1204,36465,467
2021-07-25,Santa Clara,085,1922200,123365,121800,846,122646,2099
2021-07-25,Santa Cruz,087,273765,16721,16474,826,17300,207
2021-07-25,Shasta,089,179085,12988,12815,1726,14541,211
2021-07-25,Sierra,091,2930,70,65,12,77,0
2021-07-25,Siskiyou,093,43540,2052,1963,431,2394,31
2021-07-25,Solano,095,438530,35553,34863,703,35566,259
2021-07-25,Sonoma,097,501317,32815,32202,386,32588,328
2021-07-25,Stanislaus,099,539301,58700,58154,6289,64443,1033
2021-07-25,Sutter,101,95872,10057,9937,99,10036,115
2021-07-25,Tehama,103,63373,5249,5181,611,5792,66
2021-07-25,Trinity,105,12862,508,351,112,463,3
2021-07-25,Tulare,107,460477,51141,50221,9542,59763,854
2021-07-25,Tuolumne,109,53932,4308,4267,44,4311,64
2021-07-25,Ventura,111,848112,83980,82986,3440,86426,1041
2021-07-25,Yolo,113,214977,14887,14693,449,15142,215
2021-07-25,Yuba,115,75493,6649,6519,142,6661,51
2021-07-24,Alameda,001,1643700,95466,93170,2201,95371,1259
2021-07-24,Alpine,003,1148,88,89,0,89,0
2021-07-24,Amador,005,37829,3889,3816,34,3850,48
2021-07-24,Butte,007,227075,13325,12982,1960,14942,203
2021-07-24,Calaveras,009,45235,2306,2267,16,2283,57
2021-07-24,Colusa,011,21464,2011,1992,346,2338,16
2021-07-24,Contra Costa,013,1133247,75789,73682,1505,75187,830
2021-07-24,Del Norte,015,27424,1596,1497,14,1511,8
2021-07-24,El Dorado,017,186661,11074,10773,844,11617,116
2021-07-24,Fresno,019,978130,105518,103637,9114,112751,1736
2021-07-24,Glenn,021,27897,2482,2457,586,3043,20
2021-07-24,Humboldt,023,135768,4984,4780,71,4851,52
2021-07-24,Imperial,025,180216,29226,28996,2798,31794,742
2021-07-24,Inyo,027,18085,1438,1424,12,1436,38
2021-07-24,Kern,029,883053,99598,98261,11771,110032,1350
2021-07-24,Kings,031,150075,23773,23304,1161,24465,246
2021-07-24,Lake,033,64148,4223,3963,14,3977,64
2021-07-24,Lassen,035,31185,5334,5311,120,5431,21
2021-07-24,Los Angeles,037,10098052,1251231,1232164,45264,1277428,24623
2021-07-24,Madera,039,155013,17209,16885,1001,17886,245
2021-07-24,Marin,041,260295,14819,14454,289,14743,238
2021-07-24,Mariposa,043,17540,472,453,11,464,5
2021-07-24,Mendocino,045,87422,4457,4293,91,4384,49
2021-07-24,Merced,047,269075,31873,31661,1115,32776,473
2021-07-24,Modoc,049,8938,424,413,149,562,5
2021-07-24,Mono,051,14174,1289,1284,18,1302,3
2021-07-24,Monterey,053,433212,43851,43525,1962,45487,521
2021-07-24,Napa,055,140530,10408,10230,49,10279,81
2021-07-24,Nevada,057,99092,5407,5183,201,5384,72
2021-07-24,Orange,059,3164182,264378,259973,12164,272137,5141
2021-07-24,Placer,061,380077,25234,24530,1830,26360,303
2021-07-24,Plumas,063,18699,753,737,14,751,4
2021-07-24,Riverside,065,2383286,303106,296912,14657,311569,4552
2021-07-24,Sacramento,067,1510023,114994,112438,2170,114608,1698
2021-07-24,San Benito,069,59416,6246,6200,116,6316,63
2021-07-24,San Bernardino,071,2135413,301458,297899,9398,307297,5236
2021-07-24,San Diego,073,3302833,294833,289368,16890,306258,3788
2021-07-24,San Francisco,075,870044,40430,38954,1466,40420,561
2021-07-24,San Joaquin,077,732212,76692,75461,3888,79349,1436
2021-07-24,San Luis Obispo,079,281455,22110,21616,797,22413,260
2021-07-24,San Mateo,081,765935,44677,43880,566,44446,542
2021-07-24,Santa Barbara,083,443738,35600,35071,1200,36271,465
2021-07-24,Santa Clara,085,1922200,123153,121092,845,121937,2099
2021-07-24,Santa Cruz,087,273765,16698,16416,826,17242,207
2021-07-24,Shasta,089,179085,12960,12759,1723,14482,211
2021-07-24,Sierra,091,2930,69,64,12,76,0
2021-07-24,Siskiyou,093,43540,2052,1951,431,2382,31
2021-07-24,Solano,095,438530,35461,34499,694,35193,259
2021-07-24,Sonoma,097,501317,32690,31928,384,32312,327
2021-07-24,Stanislaus,099,539301,58608,57879,6279,64158,1030
2021-07-24,Sutter,101,95872,10030,9890,99,9989,115
2021-07-24,Tehama,103,63373,5242,5166,609,5775,65
2021-07-24,Trinity,105,12862,508,345,112,457,3
2021-07-24,Tulare,107,460477,51098,50104,9524,59628,854
2021-07-24,Tuolumne,109,53932,4282,4216,44,4260,64
2021-07-24,Ventura,111,848112,83853,82687,3423,86110,1041
2021-07-24,Yolo,113,214977,14849,14557,446,15003,214
2021-07-24,Yuba,115,75493,6630,6449,142,6591,51
2021-07-23,Alameda,001,1643700,95215,93170,2196,95366,1259
2021-07-23,Alpine,003,1148,88,89,0,89,0
2021-07-23,Amador,005,37829,3882,3816,34,3850,48
2021-07-23,Butte,007,227075,13296,12982,1952,14934,203
2021-07-23,Calaveras,009,45235,2296,2267,16,2283,57
2021-07-23,Colusa,011,21464,2010,1992,346,2338,16
2021-07-23,Contra Costa,013,1133247,75529,73682,1495,75177,830
2021-07-23,Del Norte,015,27424,1588,1497,14,1511,8
2021-07-23,El Dorado,017,186661,11045,10773,840,11613,116
2021-07-23,Fresno,019,978130,105386,103637,9104,112741,1736
2021-07-23,Glenn,021,27897,2480,2457,583,3040,20
2021-07-23,Humboldt,023,135768,4962,4780,68,4848,52
2021-07-23,Imperial,025,180216,29214,28996,2798,31794,742
2021-07-23,Inyo,027,18085,1435,1424,12,1436,38
2021-07-23,Kern,029,883053,99516,98261,11745,110006,1350
2021-07-23,Kings,031,150075,23742,23304,1158,24462,246
2021-07-23,Lake,033,64148,4194,3963,14,3977,64
2021-07-23,Lassen,035,31185,5332,5311,120,5431,21
2021-07-23,Los Angeles,037,10098052,1249298,1232164,45152,1277316,24623
2021-07-23,Madera,039,155013,17179,16885,996,17881,245
2021-07-23,Marin,041,260295,14782,14454,287,14741,238
2021-07-23,Mariposa,043,17540,469,453,11,464,5
2021-07-23,Mendocino,045,87422,4444,4293,91,4384,49
2021-07-23,Merced,047,269075,31848,31661,1115,32776,473
2021-07-23,Modoc,049,8938,424,413,149,562,5
2021-07-23,Mono,051,14174,1288,1284,18,1302,3
2021-07-23,Monterey,053,433212,43825,43525,1962,45487,521
2021-07-23,Napa,055,140530,10387,10230,49,10279,81
2021-07-23,Nevada,057,99092,5363,5183,201,5384,72
2021-07-23,Orange,059,3164182,263928,259973,12141,272114,5141
2021-07-23,Placer,061,380077,25154,24530,1814,26344,303
2021-07-23,Plumas,063,18699,751,737,14,751,4
2021-07-23,Riverside,065,2383286,302640,296912,14645,311557,4552
2021-07-23,Sacramento,067,1510023,114641,112438,2168,114606,1698
2021-07-23,San Benito,069,59416,6240,6200,116,6316,63
2021-07-23,San Bernardino,071,2135413,301078,297899,9389,307288,5236
2021-07-23,San Diego,073,3302833,294226,289368,16843,306211,3788
2021-07-23,San Francisco,075,870044,40243,38954,1453,40407,561
2021-07-23,San Joaquin,077,732212,76588,75461,3873,79334,1436
2021-07-23,San Luis Obispo,079,281455,22071,21616,797,22413,260
2021-07-23,San Mateo,081,765935,44572,43880,561,44441,542
2021-07-23,Santa Barbara,083,443738,35535,35071,1199,36270,465
2021-07-23,Santa Clara,085,1922200,122934,121092,842,121934,2099
2021-07-23,Santa Cruz,087,273765,16673,16416,826,17242,207
2021-07-23,Shasta,089,179085,12933,12759,1720,14479,211
2021-07-23,Sierra,091,2930,69,64,12,76,0
2021-07-23,Siskiyou,093,43540,2050,1951,431,2382,31
2021-07-23,Solano,095,438530,35369,34499,690,35189,259
2021-07-23,Sonoma,097,501317,32595,31928,383,32311,327
2021-07-23,Stanislaus,099,539301,58532,57879,6270,64149,1030
2021-07-23,Sutter,101,95872,10001,9890,99,9989,115
2021-07-23,Tehama,103,63373,5233,5166,609,5775,65
2021-07-23,Trinity,105,12862,507,345,111,456,3
2021-07-23,Tulare,107,460477,51051,50104,9499,59603,854
2021-07-23,Tuolumne,109,53932,4260,4216,44,4260,64
2021-07-23,Ventura,111,848112,83691,82687,3405,86092,1041
2021-07-23,Yolo,113,214977,14812,14557,439,14996,214
2021-07-23,Yuba,115,75493,6604,6449,141,6590,51
2021-07-22,Alameda,001,1643700,94861,93170,2191,95361,1259
2021-07-22,Alpine,003,1148,88,89,0,89,0
2021-07-22,Amador,005,37829,3873,3816,34,3850,48
2021-07-22,Butte,007,227075,13262,12982,1943,14925,203
2021-07-22,Calaveras,009,45235,2286,2267,16,2283,57
2021-07-22,Colusa,011,21464,2008,1992,343,2335,16
2021-07-22,Contra Costa,013,1133247,75190,73682,1490,75172,830
2021-07-22,Del Norte,015,27424,1571,1497,14,1511,8
2021-07-22,El Dorado,017,186661,11010,10773,832,11605,116
2021-07-22,Fresno,019,978130,105257,103637,9094,112731,1736
2021-07-22,Glenn,021,27897,2476,2457,583,3040,20
2021-07-22,Humboldt,023,135768,4931,4780,66,4846,52
2021-07-22,Imperial,025,180216,29184,28996,2798,31794,742
2021-07-22,Inyo,027,18085,1433,1424,12,1436,38
2021-07-22,Kern,029,883053,99401,98261,11704,109965,1350
2021-07-22,Kings,031,150075,23703,23304,1156,24460,246
2021-07-22,Lake,033,64148,4143,3963,14,3977,64
2021-07-22,Lassen,035,31185,5329,5311,120,5431,21
2021-07-22,Los Angeles,037,10098052,1246876,1232164,44965,1277129,24623
2021-07-22,Madera,039,155013,17144,16885,994,17879,245
2021-07-22,Marin,041,260295,14741,14454,286,14740,238
2021-07-22,Mariposa,043,17540,462,453,11,464,5
2021-07-22,Mendocino,045,87422,4431,4293,90,4383,49
2021-07-22,Merced,047,269075,31806,31661,1113,32774,473
2021-07-22,Modoc,049,8938,424,413,149,562,5
2021-07-22,Mono,051,14174,1287,1284,18,1302,3
2021-07-22,Monterey,053,433212,43797,43525,1956,45481,521
2021-07-22,Napa,055,140530,10369,10230,49,10279,81
2021-07-22,Nevada,057,99092,5337,5183,200,5383,72
2021-07-22,Orange,059,3164182,263375,259973,12132,272105,5141
2021-07-22,Placer,061,380077,25060,24530,1803,26333,303
2021-07-22,Plumas,063,18699,750,737,14,751,4
2021-07-22,Riverside,065,2383286,302131,296912,14624,311536,4552
2021-07-22,Sacramento,067,1510023,114203,112438,2159,114597,1698
2021-07-22,San Benito,069,59416,6232,6200,116,6316,63
2021-07-22,San Bernardino,071,2135413,300675,297899,9373,307272,5236
2021-07-22,San Diego,073,3302833,293496,289368,16785,306153,3788
2021-07-22,San Francisco,075,870044,40030,38954,1441,40395,561
2021-07-22,San Joaquin,077,732212,76445,75461,3860,79321,1436
2021-07-22,San Luis Obispo,079,281455,22034,21616,793,22409,260
2021-07-22,San Mateo,081,765935,44460,43880,556,44436,542
2021-07-22,Santa Barbara,083,443738,35469,35071,1197,36268,465
2021-07-22,Santa Clara,085,1922200,122692,121092,839,121931,2099
2021-07-22,Santa Cruz,087,273765,16636,16416,825,17241,207
2021-07-22,Shasta,089,179085,12909,12759,1716,14475,211
2021-07-22,Sierra,091,2930,67,64,12,76,0
2021-07-22,Siskiyou,093,43540,2047,1951,431,2382,31
2021-07-22,Solano,095,438530,35223,34499,683,35182,259
2021-07-22,Sonoma,097,501317,32485,31928,381,32309,327
2021-07-22,Stanislaus,099,539301,58404,57879,6258,64137,1030
2021-07-22,Sutter,101,95872,9980,9890,99,9989,115
2021-07-22,Tehama,103,63373,5227,5166,609,5775,65
2021-07-22,Trinity,105,12862,507,345,111,456,3
2021-07-22,Tulare,107,460477,51008,50104,9471,59575,854
2021-07-22,Tuolumne,109,53932,4248,4216,44,4260,64
2021-07-22,Ventura,111,848112,83557,82687,3392,86079,1041
2021-07-22,Yolo,113,214977,14774,14557,438,14995,214
2021-07-22,Yuba,115,75493,6573,6449,138,6587,51
2021-07-21,Alameda,001,1643700,94542,92840,2187,95027,1256
2021-07-21,Alpine,003,1148,88,89,0,89,0
2021-07-21,Amador,005,37829,3860,3813,34,3847,48
2021-07-21,Butte,007,227075,13221,12939,1938,14877,203
2021-07-21,Calaveras,009,45235,2282,2257,16,2273,57
2021-07-21,Colusa,011,21464,2004,1988,342,2330,16
2021-07-21,Contra Costa,013,1133247,74926,73320,1481,74801,827
2021-07-21,Del Norte,015,27424,1561,1492,14,1506,8
2021-07-21,El Dorado,017,186661,10974,10742,828,11570,116
2021-07-21,Fresno,019,978130,105109,103504,9085,112589,1736
2021-07-21,Glenn,021,27897,2474,2455,582,3037,20
2021-07-21,Humboldt,023,135768,4899,4763,64,4827,52
2021-07-21,Imperial,025,180216,29172,28964,2795,31759,742
2021-07-21,Inyo,027,18085,1433,1423,12,1435,38
2021-07-21,Kern,029,883053,99283,98152,11663,109815,1350
2021-07-21,Kings,031,150075,23675,23270,1152,24422,246
2021-07-21,Lake,033,64148,4077,3896,14,3910,64
2021-07-21,Lassen,035,31185,5326,5310,120,5430,21
2021-07-21,Los Angeles,037,10098052,1244370,1229598,44826,1274424,24609
2021-07-21,Madera,039,155013,17120,16858,991,17849,245
2021-07-21,Marin,041,260295,14692,14427,286,14713,238
2021-07-21,Mariposa,043,17540,458,449,11,460,5
2021-07-21,Mendocino,045,87422,4413,4274,90,4364,49
2021-07-21,Merced,047,269075,31767,31607,1109,32716,473
2021-07-21,Modoc,049,8938,424,413,149,562,5
2021-07-21,Mono,051,14174,1284,1282,18,1300,3
2021-07-21,Monterey,053,433212,43767,43502,1952,45454,515
2021-07-21,Napa,055,140530,10343,10209,49,10258,81
2021-07-21,Nevada,057,99092,5302,5152,200,5352,72
2021-07-21,Orange,059,3164182,262822,259615,12101,271716,5139
2021-07-21,Placer,061,380077,24951,24441,1792,26233,303
2021-07-21,Plumas,063,18699,750,736,14,750,4
2021-07-21,Riverside,065,2383286,301618,296419,14607,311026,4552
2021-07-21,Sacramento,067,1510023,113781,112043,2148,114191,1696
2021-07-21,San Benito,069,59416,6222,6196,116,6312,63
2021-07-21,San Bernardino,071,2135413,300224,297519,9365,306884,5230
2021-07-21,San Diego,073,3302833,292645,288682,16722,305404,3787
2021-07-21,San Francisco,075,870044,39805,38699,1436,40135,559
2021-07-21,San Joaquin,077,732212,76256,75288,3848,79136,1434
2021-07-21,San Luis Obispo,079,281455,21997,21579,790,22369,260
2021-07-21,San Mateo,081,765935,44368,43755,552,44307,542
2021-07-21,Santa Barbara,083,443738,35410,34998,1181,36179,465
2021-07-21,Santa Clara,085,1922200,122482,120838,837,121675,2099
2021-07-21,Santa Cruz,087,273765,16602,16407,825,17232,207
2021-07-21,Shasta,089,179085,12876,12751,1713,14464,211
2021-07-21,Sierra,091,2930,67,64,12,76,0
2021-07-21,Siskiyou,093,43540,2045,1943,429,2372,31
2021-07-21,Solano,095,438530,35065,34374,678,35052,258
2021-07-21,Sonoma,097,501317,32369,31789,381,32170,327
2021-07-21,Stanislaus,099,539301,58301,57774,6248,64022,1028
2021-07-21,Sutter,101,95872,9956,9862,99,9961,113
2021-07-21,Tehama,103,63373,5223,5161,609,5770,65
2021-07-21,Trinity,105,12862,505,345,110,455,3
2021-07-21,Tulare,107,460477,50948,50066,9445,59511,854
2021-07-21,Tuolumne,109,53932,4211,4156,44,4200,64
2021-07-21,Ventura,111,848112,83435,82573,3380,85953,1041
2021-07-21,Yolo,113,214977,14732,14525,437,14962,213
2021-07-21,Yuba,115,75493,6545,6425,138,6563,52
2021-07-20,Alameda,001,1643700,94168,92625,2173,94798,1256
2021-07-20,Alpine,003,1148,88,89,0,89,0
2021-07-20,Amador,005,37829,3849,3807,34,3841,48
2021-07-20,Butte,007,227075,13184,12916,1933,14849,203
2021-07-20,Calaveras,009,45235,2279,2249,16,2265,57
2021-07-20,Colusa,011,21464,2004,1985,342,2327,16
2021-07-20,Contra Costa,013,1133247,74642,73143,1463,74606,825
2021-07-20,Del Norte,015,27424,1551,1490,14,1504,8
2021-07-20,El Dorado,017,186661,10934,10727,824,11551,116
2021-07-20,Fresno,019,978130,104973,103438,9066,112504,1736
2021-07-20,Glenn,021,27897,2474,2453,582,3035,20
2021-07-20,Humboldt,023,135768,4854,4735,62,4797,52
2021-07-20,Imperial,025,180216,29152,28933,2795,31728,742
2021-07-20,Inyo,027,18085,1429,1420,12,1432,36
2021-07-20,Kern,029,883053,99171,98082,11635,109717,1350
2021-07-20,Kings,031,150075,23634,23254,1148,24402,246
2021-07-20,Lake,033,64148,4052,3871,14,3885,64
2021-07-20,Lassen,035,31185,5326,5306,120,5426,21
2021-07-20,Los Angeles,037,10098052,1241580,1227404,44657,1272061,24603
2021-07-20,Madera,039,155013,17099,16856,987,17843,245
2021-07-20,Marin,041,260295,14656,14396,283,14679,234
2021-07-20,Mariposa,043,17540,456,448,11,459,5
2021-07-20,Mendocino,045,87422,4396,4259,90,4349,49
2021-07-20,Merced,047,269075,31728,31578,1102,32680,473
2021-07-20,Modoc,049,8938,424,413,149,562,5
2021-07-20,Mono,051,14174,1280,1281,18,1299,3
2021-07-20,Monterey,053,433212,43736,43481,1949,45430,515
2021-07-20,Napa,055,140530,10320,10191,49,10240,81
2021-07-20,Nevada,057,99092,5283,5148,199,5347,72
2021-07-20,Orange,059,3164182,262265,259303,12069,271372,5139
2021-07-20,Placer,061,380077,24859,24408,1769,26177,303
2021-07-20,Plumas,063,18699,748,736,14,750,4
2021-07-20,Riverside,065,2383286,301083,296118,14593,310711,4543
2021-07-20,Sacramento,067,1510023,113341,111796,2118,113914,1695
2021-07-20,San Benito,069,59416,6215,6196,116,6312,63
2021-07-20,San Bernardino,071,2135413,299813,297222,9340,306562,5231
2021-07-20,San Diego,073,3302833,291719,288209,16625,304834,3786
2021-07-20,San Francisco,075,870044,39546,38536,1425,39961,558
2021-07-20,San Joaquin,077,732212,76084,75198,3835,79033,1433
2021-07-20,San Luis Obispo,079,281455,21951,21556,789,22345,259
2021-07-20,San Mateo,081,765935,44249,43670,551,44221,542
2021-07-20,Santa Barbara,083,443738,35340,34935,1175,36110,462
2021-07-20,Santa Clara,085,1922200,122225,120704,834,121538,2098
2021-07-20,Santa Cruz,087,273765,16573,16399,825,17224,207
2021-07-20,Shasta,089,179085,12850,12734,1709,14443,211
2021-07-20,Sierra,091,2930,67,64,12,76,0
2021-07-20,Siskiyou,093,43540,2041,1931,428,2359,31
2021-07-20,Solano,095,438530,34930,34337,671,35008,258
2021-07-20,Sonoma,097,501317,32250,31763,380,32143,326
2021-07-20,Stanislaus,099,539301,58186,57706,6242,63948,1028
2021-07-20,Sutter,101,95872,9929,9854,96,9950,114
2021-07-20,Tehama,103,63373,5221,5153,609,5762,65
2021-07-20,Trinity,105,12862,503,344,109,453,3
2021-07-20,Tulare,107,460477,50906,50047,9428,59475,854
2021-07-20,Tuolumne,109,53932,4192,4156,44,4200,64
2021-07-20,Ventura,111,848112,83282,82504,3363,85867,1041
2021-07-20,Yolo,113,214977,14667,14495,434,14929,213
2021-07-20,Yuba,115,75493,6520,6393,135,6528,52
2021-07-19,Alameda,001,1643700,93795,92357,2157,94514,1256
2021-07-19,Alpine,003,1148,88,89,0,89,0
2021-07-19,Amador,005,37829,3845,3802,34,3836,48
2021-07-19,Butte,007,227075,13140,12901,1927,14828,202
2021-07-19,Calaveras,009,45235,2275,2245,16,2261,57
2021-07-19,Colusa,011,21464,2002,1981,341,2322,16
2021-07-19,Contra Costa,013,1133247,74329,72935,1443,74378,825
2021-07-19,Del Norte,015,27424,1538,1484,14,1498,8
2021-07-19,El Dorado,017,186661,10904,10703,816,11519,114
2021-07-19,Fresno,019,978130,104843,103350,9053,112403,1731
2021-07-19,Glenn,021,27897,2474,2452,581,3033,20
2021-07-19,Humboldt,023,135768,4824,4719,60,4779,52
2021-07-19,Imperial,025,180216,29125,28888,2794,31682,742
2021-07-19,Inyo,027,18085,1428,1417,12,1429,36
2021-07-19,Kern,029,883053,99057,97999,11601,109600,1349
2021-07-19,Kings,031,150075,23604,23221,1142,24363,246
2021-07-19,Lake,033,64148,4016,3848,14,3862,64
2021-07-19,Lassen,035,31185,5325,5305,120,5425,21
2021-07-19,Los Angeles,037,10098052,1238982,1225946,44460,1270406,24600
2021-07-19,Madera,039,155013,17076,16846,984,17830,244
2021-07-19,Marin,041,260295,14621,14369,280,14649,234
2021-07-19,Mariposa,043,17540,450,447,11,458,5
2021-07-19,Mendocino,045,87422,4378,4251,90,4341,49
2021-07-19,Merced,047,269075,31664,31565,1095,32660,472
2021-07-19,Modoc,049,8938,423,413,149,562,5
2021-07-19,Mono,051,14174,1278,1280,18,1298,3
2021-07-19,Monterey,053,433212,43712,43436,1948,45384,515
2021-07-19,Napa,055,140530,10295,10180,47,10227,81
2021-07-19,Nevada,057,99092,5255,5133,198,5331,72
2021-07-19,Orange,059,3164182,261742,258927,12037,270964,5138
2021-07-19,Placer,061,380077,24760,24359,1747,26106,303
2021-07-19,Plumas,063,18699,748,730,14,744,4
2021-07-19,Riverside,065,2383286,300593,295736,14555,310291,4543
2021-07-19,Sacramento,067,1510023,112977,111470,2094,113564,1696
2021-07-19,San Benito,069,59416,6212,6193,116,6309,63
2021-07-19,San Bernardino,071,2135413,299439,296929,9322,306251,5235
2021-07-19,San Diego,073,3302833,290822,287695,16520,304215,3786
2021-07-19,San Francisco,075,870044,39274,38463,1412,39875,560
2021-07-19,San Joaquin,077,732212,75919,75086,3829,78915,1431
2021-07-19,San Luis Obispo,079,281455,21906,21531,785,22316,259
2021-07-19,San Mateo,081,765935,44107,43563,542,44105,542
2021-07-19,Santa Barbara,083,443738,35268,34904,1173,36077,461
2021-07-19,Santa Clara,085,1922200,121967,120554,833,121387,2098
2021-07-19,Santa Cruz,087,273765,16557,16387,825,17212,207
2021-07-19,Shasta,089,179085,12832,12723,1707,14430,209
2021-07-19,Sierra,091,2930,66,64,12,76,0
2021-07-19,Siskiyou,093,43540,2036,1927,426,2353,31
2021-07-19,Solano,095,438530,34755,34262,660,34922,261
2021-07-19,Sonoma,097,501317,32129,31713,379,32092,325
2021-07-19,Stanislaus,099,539301,58085,57644,6232,63876,1027
2021-07-19,Sutter,101,95872,9913,9834,96,9930,114
2021-07-19,Tehama,103,63373,5215,5152,607,5759,65
2021-07-19,Trinity,105,12862,503,344,108,452,3
2021-07-19,Tulare,107,460477,50860,49994,9411,59405,855
2021-07-19,Tuolumne,109,53932,4182,4151,44,4195,64
2021-07-19,Ventura,111,848112,83186,82409,3341,85750,1041
2021-07-19,Yolo,113,214977,14635,14439,432,14871,213
2021-07-19,Yuba,115,75493,6496,6370,135,6505,52
2021-07-18,Alameda,001,1643700,93439,92162,2144,94306,1256
2021-07-18,Alpine,003,1148,88,89,0,89,0
2021-07-18,Amador,005,37829,3834,3799,34,3833,48
2021-07-18,Butte,007,227075,13097,12888,1922,14810,202
2021-07-18,Calaveras,009,45235,2272,2243,16,2259,57
2021-07-18,Colusa,011,21464,2002,1981,340,2321,16
2021-07-18,Contra Costa,013,1133247,74013,72849,1425,74274,825
2021-07-18,Del Norte,015,27424,1529,1482,14,1496,8
2021-07-18,El Dorado,017,186661,10866,10687,808,11495,114
2021-07-18,Fresno,019,978130,104689,103298,9035,112333,1731
2021-07-18,Glenn,021,27897,2473,2452,580,3032,20
2021-07-18,Humboldt,023,135768,4788,4714,60,4774,52
2021-07-18,Imperial,025,180216,29088,28877,2793,31670,742
2021-07-18,Inyo,027,18085,1424,1417,12,1429,36
2021-07-18,Kern,029,883053,98931,97963,11559,109522,1349
2021-07-18,Kings,031,150075,23583,23203,1138,24341,246
2021-07-18,Lake,033,64148,3980,3825,14,3839,64
2021-07-18,Lassen,035,31185,5325,5305,120,5425,21
2021-07-18,Los Angeles,037,10098052,1236294,1224691,44267,1268958,24598
2021-07-18,Madera,039,155013,17051,16838,980,17818,244
2021-07-18,Marin,041,260295,14585,14358,278,14636,234
2021-07-18,Mariposa,043,17540,449,447,11,458,5
2021-07-18,Mendocino,045,87422,4357,4246,90,4336,49
2021-07-18,Merced,047,269075,31633,31537,1093,32630,471
2021-07-18,Modoc,049,8938,423,413,149,562,5
2021-07-18,Mono,051,14174,1277,1280,18,1298,3
2021-07-18,Monterey,053,433212,43694,43422,1939,45361,515
2021-07-18,Napa,055,140530,10278,10174,44,10218,81
2021-07-18,Nevada,057,99092,5229,5124,198,5322,72
2021-07-18,Orange,059,3164182,261257,258724,12007,270731,5138
2021-07-18,Placer,061,380077,24693,24313,1720,26033,303
2021-07-18,Plumas,063,18699,748,730,14,744,4
2021-07-18,Riverside,065,2383286,300101,295522,14513,310035,4543
2021-07-18,Sacramento,067,1510023,112545,111255,2062,113317,1696
2021-07-18,San Benito,069,59416,6204,6191,116,6307,63
2021-07-18,San Bernardino,071,2135413,298965,296739,9307,306046,5233
2021-07-18,San Diego,073,3302833,290004,286287,16438,302725,3786
2021-07-18,San Francisco,075,870044,39040,38367,1401,39768,560
2021-07-18,San Joaquin,077,732212,75742,74997,3816,78813,1431
2021-07-18,San Luis Obispo,079,281455,21871,21527,782,22309,259
2021-07-18,San Mateo,081,765935,43994,43506,536,44042,542
2021-07-18,Santa Barbara,083,443738,35203,34880,1171,36051,461
2021-07-18,Santa Clara,085,1922200,121753,120438,826,121264,2098
2021-07-18,Santa Cruz,087,273765,16525,16372,824,17196,207
2021-07-18,Shasta,089,179085,12807,12714,1703,14417,209
2021-07-18,Sierra,091,2930,66,64,12,76,0
2021-07-18,Siskiyou,093,43540,2030,1927,421,2348,31
2021-07-18,Solano,095,438530,34627,34215,656,34871,261
2021-07-18,Sonoma,097,501317,32024,31675,378,32053,325
2021-07-18,Stanislaus,099,539301,57974,57600,6207,63807,1028
2021-07-18,Sutter,101,95872,9881,9826,96,9922,114
2021-07-18,Tehama,103,63373,5212,5150,606,5756,65
2021-07-18,Trinity,105,12862,503,344,108,452,3
2021-07-18,Tulare,107,460477,50807,49985,9388,59373,855
2021-07-18,Tuolumne,109,53932,4164,4149,44,4193,64
2021-07-18,Ventura,111,848112,83072,82361,3317,85678,1041
2021-07-18,Yolo,113,214977,14576,14425,426,14851,213
2021-07-18,Yuba,115,75493,6455,6357,135,6492,52
2021-07-17,Alameda,001,1643700,93222,91346,2132,93478,1255
2021-07-17,Alpine,003,1148,88,89,0,89,0
2021-07-17,Amador,005,37829,3825,3785,34,3819,48
2021-07-17,Butte,007,227075,13083,12824,1917,14741,202
2021-07-17,Calaveras,009,45235,2266,2237,16,2253,57
2021-07-17,Colusa,011,21464,1999,1976,340,2316,16
2021-07-17,Contra Costa,013,1133247,73831,72254,1412,73666,824
2021-07-17,Del Norte,015,27424,1521,1475,14,1489,8
2021-07-17,El Dorado,017,186661,10839,10622,804,11426,114
2021-07-17,Fresno,019,978130,104616,103055,9021,112076,1730
2021-07-17,Glenn,021,27897,2472,2451,580,3031,20
2021-07-17,Humboldt,023,135768,4775,4654,59,4713,52
2021-07-17,Imperial,025,180216,29072,28840,2793,31633,742
2021-07-17,Inyo,027,18085,1424,1416,12,1428,36
2021-07-17,Kern,029,883053,98874,97796,11522,109318,1348
2021-07-17,Kings,031,150075,23563,23163,1137,24300,246
2021-07-17,Lake,033,64148,3955,3760,14,3774,64
2021-07-17,Lassen,035,31185,5325,5302,120,5422,21
2021-07-17,Los Angeles,037,10098052,1234773,1219733,44121,1263854,24582
2021-07-17,Madera,039,155013,17043,16804,980,17784,240
2021-07-17,Marin,041,260295,14567,14297,276,14573,234
2021-07-17,Mariposa,043,17540,449,445,11,456,5
2021-07-17,Mendocino,045,87422,4345,4209,90,4299,49
2021-07-17,Merced,047,269075,31612,31451,1089,32540,471
2021-07-17,Modoc,049,8938,423,412,149,561,5
2021-07-17,Mono,051,14174,1275,1277,18,1295,3
2021-07-17,Monterey,053,433212,43671,43367,1934,45301,515
2021-07-17,Napa,055,140530,10262,10129,44,10173,81
2021-07-17,Nevada,057,99092,5214,5066,198,5264,72
2021-07-17,Orange,059,3164182,260950,257805,11968,269773,5136
2021-07-17,Placer,061,380077,24626,24169,1706,25875,303
2021-07-17,Plumas,063,18699,743,721,14,735,4
2021-07-17,Riverside,065,2383286,299794,294751,14481,309232,4542
2021-07-17,Sacramento,067,1510023,112310,110432,2040,112472,1694
2021-07-17,San Benito,069,59416,6198,6181,116,6297,63
2021-07-17,San Bernardino,071,2135413,298729,296048,9288,305336,5218
2021-07-17,San Diego,073,3302833,289596,285698,16371,302069,3786
2021-07-17,San Francisco,075,870044,38918,37978,1397,39375,560
2021-07-17,San Joaquin,077,732212,75655,74695,3810,78505,1430
2021-07-17,San Luis Obispo,079,281455,21844,21462,782,22244,258
2021-07-17,San Mateo,081,765935,43923,43324,535,43859,542
2021-07-17,Santa Barbara,083,443738,35162,34769,1168,35937,461
2021-07-17,Santa Clara,085,1922200,121581,119980,823,120803,2097
2021-07-17,Santa Cruz,087,273765,16518,16337,824,17161,207
2021-07-17,Shasta,089,179085,12792,12683,1698,14381,210
2021-07-17,Sierra,091,2930,66,62,12,74,0
2021-07-17,Siskiyou,093,43540,2025,1922,418,2340,29
2021-07-17,Solano,095,438530,34562,34015,648,34663,263
2021-07-17,Sonoma,097,501317,31956,31536,377,31913,322
2021-07-17,Stanislaus,099,539301,57897,57400,6193,63593,1028
2021-07-17,Sutter,101,95872,9871,9778,96,9874,114
2021-07-17,Tehama,103,63373,5209,5145,606,5751,64
2021-07-17,Trinity,105,12862,502,341,108,449,3
2021-07-17,Tulare,107,460477,50786,49937,9376,59313,854
2021-07-17,Tuolumne,109,53932,4154,4131,44,4175,64
2021-07-17,Ventura,111,848112,83003,82125,3306,85431,1041
2021-07-17,Yolo,113,214977,14544,14356,419,14775,213
2021-07-17,Yuba,115,75493,6444,6309,135,6444,52
2021-07-16,Alameda,001,1643700,92982,91346,2120,93466,1255
2021-07-16,Alpine,003,1148,88,89,0,89,0
2021-07-16,Amador,005,37829,3822,3785,34,3819,48
2021-07-16,Butte,007,227075,13058,12824,1914,14738,202
2021-07-16,Calaveras,009,45235,2265,2237,16,2253,57
2021-07-16,Colusa,011,21464,1997,1976,339,2315,16
2021-07-16,Contra Costa,013,1133247,73643,72254,1408,73662,824
2021-07-16,Del Norte,015,27424,1519,1475,14,1489,8
2021-07-16,El Dorado,017,186661,10820,10622,803,11425,114
2021-07-16,Fresno,019,978130,104564,103055,9001,112056,1730
2021-07-16,Glenn,021,27897,2472,2451,580,3031,20
2021-07-16,Humboldt,023,135768,4753,4654,59,4713,52
2021-07-16,Imperial,025,180216,29060,28840,2793,31633,742
2021-07-16,Inyo,027,18085,1422,1416,12,1428,36
2021-07-16,Kern,029,883053,98812,97796,11482,109278,1348
2021-07-16,Kings,031,150075,23538,23163,1135,24298,246
2021-07-16,Lake,033,64148,3928,3760,14,3774,64
2021-07-16,Lassen,035,31185,5324,5302,120,5422,21
2021-07-16,Los Angeles,037,10098052,1233274,1219733,43974,1263707,24582
2021-07-16,Madera,039,155013,17025,16804,980,17784,240
2021-07-16,Marin,041,260295,14543,14297,273,14570,234
2021-07-16,Mariposa,043,17540,449,445,11,456,5
2021-07-16,Mendocino,045,87422,4336,4209,89,4298,49
2021-07-16,Merced,047,269075,31590,31451,1087,32538,471
2021-07-16,Modoc,049,8938,423,412,149,561,5
2021-07-16,Mono,051,14174,1274,1277,18,1295,3
2021-07-16,Monterey,053,433212,43649,43367,1933,45300,515
2021-07-16,Napa,055,140530,10238,10129,43,10172,81
2021-07-16,Nevada,057,99092,5204,5066,198,5264,72
2021-07-16,Orange,059,3164182,260678,257805,11928,269733,5136
2021-07-16,Placer,061,380077,24573,24169,1701,25870,303
2021-07-16,Plumas,063,18699,742,721,14,735,4
2021-07-16,Riverside,065,2383286,299518,294751,14455,309206,4542
2021-07-16,Sacramento,067,1510023,112093,110432,2027,112459,1694
2021-07-16,San Benito,069,59416,6196,6181,116,6297,63
2021-07-16,San Bernardino,071,2135413,298451,296048,9271,305319,5218
2021-07-16,San Diego,073,3302833,289153,285698,16324,302022,3786
2021-07-16,San Francisco,075,870044,38801,37978,1392,39370,560
2021-07-16,San Joaquin,077,732212,75560,74695,3807,78502,1430
2021-07-16,San Luis Obispo,079,281455,21827,21462,782,22244,258
2021-07-16,San Mateo,081,765935,43870,43324,534,43858,542
2021-07-16,Santa Barbara,083,443738,35124,34769,1168,35937,461
2021-07-16,Santa Clara,085,1922200,121434,119980,815,120795,2097
2021-07-16,Santa Cruz,087,273765,16505,16337,824,17161,207
2021-07-16,Shasta,089,179085,12782,12683,1697,14380,210
2021-07-16,Sierra,091,2930,66,62,12,74,0
2021-07-16,Siskiyou,093,43540,2023,1922,416,2338,29
2021-07-16,Solano,095,438530,34495,34015,640,34655,263
2021-07-16,Sonoma,097,501317,31904,31536,374,31910,322
2021-07-16,Stanislaus,099,539301,57847,57400,6183,63583,1028
2021-07-16,Sutter,101,95872,9859,9778,96,9874,114
2021-07-16,Tehama,103,63373,5207,5145,606,5751,64
2021-07-16,Trinity,105,12862,502,341,107,448,3
2021-07-16,Tulare,107,460477,50762,49937,9366,59303,854
2021-07-16,Tuolumne,109,53932,4148,4131,44,4175,64
2021-07-16,Ventura,111,848112,82938,82125,3299,85424,1041
2021-07-16,Yolo,113,214977,14518,14356,415,14771,213
2021-07-16,Yuba,115,75493,6422,6309,134,6443,52
2021-07-15,Alameda,001,1643700,92685,91346,2110,93456,1255
2021-07-15,Alpine,003,1148,88,89,0,89,0
2021-07-15,Amador,005,37829,3819,3785,34,3819,48
2021-07-15,Butte,007,227075,13032,12824,1912,14736,202
2021-07-15,Calaveras,009,45235,2262,2237,16,2253,57
2021-07-15,Colusa,011,21464,1996,1976,338,2314,16
2021-07-15,Contra Costa,013,1133247,73430,72254,1401,73655,824
2021-07-15,Del Norte,015,27424,1516,1475,14,1489,8
2021-07-15,El Dorado,017,186661,10793,10622,801,11423,114
2021-07-15,Fresno,019,978130,104467,103055,8981,112036,1730
2021-07-15,Glenn,021,27897,2472,2451,580,3031,20
2021-07-15,Humboldt,023,135768,4735,4654,58,4712,52
2021-07-15,Imperial,025,180216,29037,28840,2793,31633,742
2021-07-15,Inyo,027,18085,1422,1416,12,1428,36
2021-07-15,Kern,029,883053,98742,97796,11454,109250,1348
2021-07-15,Kings,031,150075,23500,23163,1132,24295,246
2021-07-15,Lake,033,64148,3889,3760,14,3774,64
2021-07-15,Lassen,035,31185,5323,5302,120,5422,21
2021-07-15,Los Angeles,037,10098052,1231298,1219733,43812,1263545,24582
2021-07-15,Madera,039,155013,17003,16804,976,17780,240
2021-07-15,Marin,041,260295,14518,14297,273,14570,234
2021-07-15,Mariposa,043,17540,449,445,11,456,5
2021-07-15,Mendocino,045,87422,4328,4209,88,4297,49
2021-07-15,Merced,047,269075,31560,31451,1087,32538,471
2021-07-15,Modoc,049,8938,423,412,149,561,5
2021-07-15,Mono,051,14174,1274,1277,18,1295,3
2021-07-15,Monterey,053,433212,43620,43367,1930,45297,515
2021-07-15,Napa,055,140530,10213,10129,42,10171,81
2021-07-15,Nevada,057,99092,5187,5066,197,5263,72
2021-07-15,Orange,059,3164182,260327,257805,11897,269702,5136
2021-07-15,Placer,061,380077,24514,24169,1684,25853,303
2021-07-15,Plumas,063,18699,741,721,14,735,4
2021-07-15,Riverside,065,2383286,299196,294751,14440,309191,4542
2021-07-15,Sacramento,067,1510023,111789,110432,2010,112442,1694
2021-07-15,San Benito,069,59416,6194,6181,116,6297,63
2021-07-15,San Bernardino,071,2135413,298146,296048,9256,305304,5218
2021-07-15,San Diego,073,3302833,288515,285698,16246,301944,3786
2021-07-15,San Francisco,075,870044,38649,37978,1384,39362,560
2021-07-15,San Joaquin,077,732212,75443,74695,3802,78497,1430
2021-07-15,San Luis Obispo,079,281455,21795,21462,782,22244,258
2021-07-15,San Mateo,081,765935,43766,43324,529,43853,542
2021-07-15,Santa Barbara,083,443738,35068,34769,1167,35936,461
2021-07-15,Santa Clara,085,1922200,121312,119980,812,120792,2097
2021-07-15,Santa Cruz,087,273765,16492,16337,824,17161,207
2021-07-15,Shasta,089,179085,12774,12683,1693,14376,210
2021-07-15,Sierra,091,2930,66,62,12,74,0
2021-07-15,Siskiyou,093,43540,2022,1922,416,2338,29
2021-07-15,Solano,095,438530,34420,34015,634,34649,263
2021-07-15,Sonoma,097,501317,31843,31536,374,31910,322
2021-07-15,Stanislaus,099,539301,57779,57400,6170,63570,1028
2021-07-15,Sutter,101,95872,9839,9778,95,9873,114
2021-07-15,Tehama,103,63373,5201,5145,605,5750,64
2021-07-15,Trinity,105,12862,502,341,107,448,3
2021-07-15,Tulare,107,460477,50742,49937,9349,59286,854
2021-07-15,Tuolumne,109,53932,4136,4131,44,4175,64
2021-07-15,Ventura,111,848112,82861,82125,3294,85419,1041
2021-07-15,Yolo,113,214977,14491,14356,414,14770,213
2021-07-15,Yuba,115,75493,6407,6309,133,6442,52
2021-07-14,Alameda,001,1643700,92423,91092,2091,93183,1255
2021-07-14,Alpine,003,1148,88,89,0,89,0
2021-07-14,Amador,005,37829,3811,3784,34,3818,48
2021-07-14,Butte,007,227075,13005,12813,1905,14718,202
2021-07-14,Calaveras,009,45235,2255,2234,16,2250,57
2021-07-14,Colusa,011,21464,1993,1974,338,2312,16
2021-07-14,Contra Costa,013,1133247,73204,72091,1389,73480,823
2021-07-14,Del Norte,015,27424,1515,1472,14,1486,8
2021-07-14,El Dorado,017,186661,10767,10598,798,11396,114
2021-07-14,Fresno,019,978130,104387,102966,8970,111936,1728
2021-07-14,Glenn,021,27897,2472,2449,580,3029,20
2021-07-14,Humboldt,023,135768,4712,4644,56,4700,52
2021-07-14,Imperial,025,180216,29008,28822,2793,31615,742
2021-07-14,Inyo,027,18085,1421,1415,12,1427,36
2021-07-14,Kern,029,883053,98678,97736,11429,109165,1346
2021-07-14,Kings,031,150075,23487,23142,1132,24274,246
2021-07-14,Lake,033,64148,3856,3739,14,3753,63
2021-07-14,Lassen,035,31185,5322,5298,120,5418,21
2021-07-14,Los Angeles,037,10098052,1229288,1218265,43668,1261933,24578
2021-07-14,Madera,039,155013,16991,16786,974,17760,240
2021-07-14,Marin,041,260295,14484,14269,271,14540,233
2021-07-14,Mariposa,043,17540,447,445,11,456,5
2021-07-14,Mendocino,045,87422,4315,4193,88,4281,49
2021-07-14,Merced,047,269075,31523,31412,1083,32495,471
2021-07-14,Modoc,049,8938,423,412,149,561,4
2021-07-14,Mono,051,14174,1274,1278,18,1296,3
2021-07-14,Monterey,053,433212,43596,43347,1928,45275,504
2021-07-14,Napa,055,140530,10191,10121,42,10163,81
2021-07-14,Nevada,057,99092,5167,5058,197,5255,72
2021-07-14,Orange,059,3164182,260010,257558,11867,269425,5137
2021-07-14,Placer,061,380077,24461,24125,1672,25797,303
2021-07-14,Plumas,063,18699,734,719,14,733,4
2021-07-14,Riverside,065,2383286,298871,294511,14424,308935,4542
2021-07-14,Sacramento,067,1510023,111461,110193,1986,112179,1688
2021-07-14,San Benito,069,59416,6191,6177,116,6293,63
2021-07-14,San Bernardino,071,2135413,297844,295820,9241,305061,5193
2021-07-14,San Diego,073,3302833,287943,285269,16166,301435,3786
2021-07-14,San Francisco,075,870044,38510,37836,1378,39214,559
2021-07-14,San Joaquin,077,732212,75351,74599,3793,78392,1416
2021-07-14,San Luis Obispo,079,281455,21773,21444,780,22224,258
2021-07-14,San Mateo,081,765935,43667,43249,525,43774,542
2021-07-14,Santa Barbara,083,443738,35026,34719,1165,35884,461
2021-07-14,Santa Clara,085,1922200,121162,119844,809,120653,2098
2021-07-14,Santa Cruz,087,273765,16480,16326,824,17150,207
2021-07-14,Shasta,089,179085,12754,12669,1690,14359,209
2021-07-14,Sierra,091,2930,66,62,12,74,0
2021-07-14,Siskiyou,093,43540,2015,1922,413,2335,29
2021-07-14,Solano,095,438530,34347,33948,634,34582,268
2021-07-14,Sonoma,097,501317,31791,31470,374,31844,322
2021-07-14,Stanislaus,099,539301,57704,57340,6158,63498,1028
2021-07-14,Sutter,101,95872,9817,9766,95,9861,114
2021-07-14,Tehama,103,63373,5199,5142,605,5747,64
2021-07-14,Trinity,105,12862,502,341,107,448,3
2021-07-14,Tulare,107,460477,50725,49908,9335,59243,853
2021-07-14,Tuolumne,109,53932,4133,4128,43,4171,64
2021-07-14,Ventura,111,848112,82767,82041,3283,85324,1040
2021-07-14,Yolo,113,214977,14458,14332,411,14743,213
2021-07-14,Yuba,115,75493,6389,6294,133,6427,52
2021-07-13,Alameda,001,1643700,92158,90874,2081,92955,1255
2021-07-13,Alpine,003,1148,88,89,0,89,0
2021-07-13,Amador,005,37829,3804,3783,34,3817,48
2021-07-13,Butte,007,227075,12991,12802,1904,14706,202
2021-07-13,Calaveras,009,45235,2251,2230,16,2246,57
2021-07-13,Colusa,011,21464,1991,1972,334,2306,16
2021-07-13,Contra Costa,013,1133247,72978,71963,1380,73343,823
2021-07-13,Del Norte,015,27424,1511,1471,14,1485,8
2021-07-13,El Dorado,017,186661,10749,10581,795,11376,114
2021-07-13,Fresno,019,978130,104311,102909,8960,111869,1727
2021-07-13,Glenn,021,27897,2470,2448,580,3028,20
2021-07-13,Humboldt,023,135768,4697,4634,56,4690,51
2021-07-13,Imperial,025,180216,28997,28792,2793,31585,741
2021-07-13,Inyo,027,18085,1420,1415,12,1427,36
2021-07-13,Kern,029,883053,98589,97698,11390,109088,1346
2021-07-13,Kings,031,150075,23469,23132,1132,24264,246
2021-07-13,Lake,033,64148,3829,3719,13,3732,63
2021-07-13,Lassen,035,31185,5320,5292,120,5412,21
2021-07-13,Los Angeles,037,10098052,1227440,1217184,43497,1260681,24569
2021-07-13,Madera,039,155013,16981,16773,970,17743,240
2021-07-13,Marin,041,260295,14455,14254,270,14524,233
2021-07-13,Mariposa,043,17540,446,443,11,454,5
2021-07-13,Mendocino,045,87422,4308,4185,88,4273,49
2021-07-13,Merced,047,269075,31502,31379,1080,32459,471
2021-07-13,Modoc,049,8938,423,411,149,560,4
2021-07-13,Mono,051,14174,1273,1277,18,1295,3
2021-07-13,Monterey,053,433212,43578,43333,1924,45257,504
2021-07-13,Napa,055,140530,10170,10118,42,10160,81
2021-07-13,Nevada,057,99092,5142,5053,197,5250,72
2021-07-13,Orange,059,3164182,259680,257339,11838,269177,5136
2021-07-13,Placer,061,380077,24415,24091,1659,25750,303
2021-07-13,Plumas,063,18699,733,716,14,730,4
2021-07-13,Riverside,065,2383286,298548,294302,14397,308699,4541
2021-07-13,Sacramento,067,1510023,111151,109990,1964,111954,1687
2021-07-13,San Benito,069,59416,6189,6173,116,6289,63
2021-07-13,San Bernardino,071,2135413,297567,295596,9219,304815,5183
2021-07-13,San Diego,073,3302833,287394,284997,16088,301085,3785
2021-07-13,San Francisco,075,870044,38366,37725,1372,39097,559
2021-07-13,San Joaquin,077,732212,75235,74500,3790,78290,1417
2021-07-13,San Luis Obispo,079,281455,21747,21423,777,22200,258
2021-07-13,San Mateo,081,765935,43599,43180,524,43704,542
2021-07-13,Santa Barbara,083,443738,34977,34679,1162,35841,461
2021-07-13,Santa Clara,085,1922200,121008,119727,805,120532,2098
2021-07-13,Santa Cruz,087,273765,16471,16315,822,17137,207
2021-07-13,Shasta,089,179085,12741,12659,1683,14342,209
2021-07-13,Sierra,091,2930,66,62,12,74,0
2021-07-13,Siskiyou,093,43540,2014,1916,411,2327,29
2021-07-13,Solano,095,438530,34282,33918,628,34546,268
2021-07-13,Sonoma,097,501317,31732,31431,374,31805,322
2021-07-13,Stanislaus,099,539301,57634,57282,6143,63425,1028
2021-07-13,Sutter,101,95872,9799,9752,94,9846,114
2021-07-13,Tehama,103,63373,5192,5144,605,5749,64
2021-07-13,Trinity,105,12862,502,341,106,447,3
2021-07-13,Tulare,107,460477,50700,49891,9319,59210,853
2021-07-13,Tuolumne,109,53932,4125,4122,42,4164,64
2021-07-13,Ventura,111,848112,82682,81982,3258,85240,1040
2021-07-13,Yolo,113,214977,14430,14320,404,14724,213
2021-07-13,Yuba,115,75493,6372,6279,133,6412,52
2021-07-12,Alameda,001,1643700,91898,90720,2074,92794,1254
2021-07-12,Alpine,003,1148,88,89,0,89,0
2021-07-12,Amador,005,37829,3797,3781,34,3815,47
2021-07-12,Butte,007,227075,12971,12796,1902,14698,202
2021-07-12,Calaveras,009,45235,2249,2228,16,2244,57
2021-07-12,Colusa,011,21464,1987,1971,333,2304,16
2021-07-12,Contra Costa,013,1133247,72777,71833,1375,73208,823
2021-07-12,Del Norte,015,27424,1508,1469,14,1483,8
2021-07-12,El Dorado,017,186661,10721,10569,793,11362,114
2021-07-12,Fresno,019,978130,104217,102853,8947,111800,1728
2021-07-12,Glenn,021,27897,2470,2446,580,3026,20
2021-07-12,Humboldt,023,135768,4681,4621,56,4677,51
2021-07-12,Imperial,025,180216,28967,28789,2793,31582,741
2021-07-12,Inyo,027,18085,1420,1415,12,1427,36
2021-07-12,Kern,029,883053,98520,97660,11365,109025,1346
2021-07-12,Kings,031,150075,23449,23124,1130,24254,246
2021-07-12,Lake,033,64148,3808,3706,13,3719,63
2021-07-12,Lassen,035,31185,5319,5292,120,5412,21
2021-07-12,Los Angeles,037,10098052,1225652,1216230,43358,1259588,24559
2021-07-12,Madera,039,155013,16970,16772,970,17742,240
2021-07-12,Marin,041,260295,14430,14238,269,14507,233
2021-07-12,Mariposa,043,17540,446,442,11,453,5
2021-07-12,Mendocino,045,87422,4297,4175,88,4263,49
2021-07-12,Merced,047,269075,31471,31374,1079,32453,471
2021-07-12,Modoc,049,8938,422,411,149,560,4
2021-07-12,Mono,051,14174,1271,1275,18,1293,3
2021-07-12,Monterey,053,433212,43557,43315,1920,45235,504
2021-07-12,Napa,055,140530,10152,10104,41,10145,81
2021-07-12,Nevada,057,99092,5119,5046,197,5243,72
2021-07-12,Orange,059,3164182,259327,257171,11813,268984,5136
2021-07-12,Placer,061,380077,24364,24052,1653,25705,302
2021-07-12,Plumas,063,18699,733,716,14,730,4
2021-07-12,Riverside,065,2383286,298240,294108,14367,308475,4541
2021-07-12,Sacramento,067,1510023,110936,109849,1938,111787,1685
2021-07-12,San Benito,069,59416,6186,6166,116,6282,63
2021-07-12,San Bernardino,071,2135413,297296,295447,9205,304652,5171
2021-07-12,San Diego,073,3302833,286925,284648,16012,300660,3785
2021-07-12,San Francisco,075,870044,38219,37656,1369,39025,559
2021-07-12,San Joaquin,077,732212,75141,74424,3780,78204,1415
2021-07-12,San Luis Obispo,079,281455,21728,21408,776,22184,258
2021-07-12,San Mateo,081,765935,43506,43138,517,43655,542
2021-07-12,Santa Barbara,083,443738,34934,34664,1160,35824,461
2021-07-12,Santa Clara,085,1922200,120843,119634,802,120436,2098
2021-07-12,Santa Cruz,087,273765,16446,16310,821,17131,207
2021-07-12,Shasta,089,179085,12734,12648,1680,14328,208
2021-07-12,Sierra,091,2930,66,62,12,74,0
2021-07-12,Siskiyou,093,43540,2009,1916,406,2322,29
2021-07-12,Solano,095,438530,34192,33859,619,34478,268
2021-07-12,Sonoma,097,501317,31684,31377,373,31750,322
2021-07-12,Stanislaus,099,539301,57565,57243,6136,63379,1028
2021-07-12,Sutter,101,95872,9782,9736,93,9829,114
2021-07-12,Tehama,103,63373,5187,5138,604,5742,63
2021-07-12,Trinity,105,12862,498,340,104,444,3
2021-07-12,Tulare,107,460477,50672,49882,9306,59188,853
2021-07-12,Tuolumne,109,53932,4121,4116,42,4158,64
2021-07-12,Ventura,111,848112,82581,81919,3237,85156,1040
2021-07-12,Yolo,113,214977,14402,14303,400,14703,213
2021-07-12,Yuba,115,75493,6357,6266,133,6399,52
2021-07-11,Alameda,001,1643700,91569,90597,2060,92657,1254
2021-07-11,Alpine,003,1148,88,89,0,89,0
2021-07-11,Amador,005,37829,3795,3779,34,3813,47
2021-07-11,Butte,007,227075,12949,12794,1896,14690,202
2021-07-11,Calaveras,009,45235,2247,2226,15,2241,57
2021-07-11,Colusa,011,21464,1986,1971,332,2303,16
2021-07-11,Contra Costa,013,1133247,72567,71744,1368,73112,823
2021-07-11,Del Norte,015,27424,1504,1467,13,1480,8
2021-07-11,El Dorado,017,186661,10692,10554,791,11345,114
2021-07-11,Fresno,019,978130,104122,102813,8927,111740,1728
2021-07-11,Glenn,021,27897,2469,2446,580,3026,20
2021-07-11,Humboldt,023,135768,4668,4611,55,4666,51
2021-07-11,Imperial,025,180216,28949,28787,2792,31579,741
2021-07-11,Inyo,027,18085,1418,1415,12,1427,36
2021-07-11,Kern,029,883053,98447,97637,11349,108986,1346
2021-07-11,Kings,031,150075,23418,23116,1127,24243,246
2021-07-11,Lake,033,64148,3777,3699,13,3712,63
2021-07-11,Lassen,035,31185,5316,5291,120,5411,21
2021-07-11,Los Angeles,037,10098052,1223904,1215182,43199,1258381,24558
2021-07-11,Madera,039,155013,16951,16766,969,17735,240
2021-07-11,Marin,041,260295,14404,14231,269,14500,233
2021-07-11,Mariposa,043,17540,445,442,11,453,5
2021-07-11,Mendocino,045,87422,4277,4167,88,4255,49
2021-07-11,Merced,047,269075,31447,31366,1074,32440,471
2021-07-11,Modoc,049,8938,421,411,149,560,4
2021-07-11,Mono,051,14174,1271,1275,18,1293,3
2021-07-11,Monterey,053,433212,43538,43307,1916,45223,504
2021-07-11,Napa,055,140530,10148,10100,41,10141,81
2021-07-11,Nevada,057,99092,5108,5035,196,5231,72
2021-07-11,Orange,059,3164182,259014,257009,11784,268793,5136
2021-07-11,Placer,061,380077,24307,24017,1641,25658,302
2021-07-11,Plumas,063,18699,733,716,14,730,4
2021-07-11,Riverside,065,2383286,297976,293969,14349,308318,4541
2021-07-11,Sacramento,067,1510023,110657,109696,1928,111624,1685
2021-07-11,San Benito,069,59416,6181,6163,116,6279,63
2021-07-11,San Bernardino,071,2135413,296991,295342,9180,304522,5167
2021-07-11,San Diego,073,3302833,286511,283819,15926,299745,3784
2021-07-11,San Francisco,075,870044,38090,37596,1363,38959,559
2021-07-11,San Joaquin,077,732212,75024,74376,3763,78139,1415
2021-07-11,San Luis Obispo,079,281455,21695,21403,775,22178,258
2021-07-11,San Mateo,081,765935,43427,43107,510,43617,542
2021-07-11,Santa Barbara,083,443738,34887,34646,1160,35806,461
2021-07-11,Santa Clara,085,1922200,120689,119549,801,120350,2098
2021-07-11,Santa Cruz,087,273765,16430,16303,821,17124,207
2021-07-11,Shasta,089,179085,12717,12647,1678,14325,208
2021-07-11,Sierra,091,2930,66,62,12,74,0
2021-07-11,Siskiyou,093,43540,2005,1915,404,2319,29
2021-07-11,Solano,095,438530,34110,33837,615,34452,268
2021-07-11,Sonoma,097,501317,31602,31352,373,31725,322
2021-07-11,Stanislaus,099,539301,57501,57230,6125,63355,1028
2021-07-11,Sutter,101,95872,9768,9728,93,9821,114
2021-07-11,Tehama,103,63373,5184,5138,604,5742,63
2021-07-11,Trinity,105,12862,497,340,104,444,3
2021-07-11,Tulare,107,460477,50646,49877,9287,59164,853
2021-07-11,Tuolumne,109,53932,4115,4116,42,4158,64
2021-07-11,Ventura,111,848112,82508,81875,3217,85092,1040
2021-07-11,Yolo,113,214977,14376,14285,394,14679,213
2021-07-11,Yuba,115,75493,6346,6260,133,6393,52
2021-07-10,Alameda,001,1643700,91419,90090,2056,92146,1252
2021-07-10,Alpine,003,1148,88,89,0,89,0
2021-07-10,Amador,005,37829,3789,3773,34,3807,47
2021-07-10,Butte,007,227075,12938,12764,1893,14657,202
2021-07-10,Calaveras,009,45235,2246,2214,15,2229,57
2021-07-10,Colusa,011,21464,1984,1969,332,2301,16
2021-07-10,Contra Costa,013,1133247,72467,71376,1367,72743,821
2021-07-10,Del Norte,015,27424,1502,1451,13,1464,8
2021-07-10,El Dorado,017,186661,10676,10508,787,11295,114
2021-07-10,Fresno,019,978130,104089,102675,8920,111595,1730
2021-07-10,Glenn,021,27897,2466,2440,579,3019,20
2021-07-10,Humboldt,023,135768,4659,4574,55,4629,51
2021-07-10,Imperial,025,180216,28936,28729,2792,31521,741
2021-07-10,Inyo,027,18085,1417,1415,12,1427,36
2021-07-10,Kern,029,883053,98407,97538,11332,108870,1346
2021-07-10,Kings,031,150075,23411,23090,1126,24216,246
2021-07-10,Lake,033,64148,3760,3667,13,3680,63
2021-07-10,Lassen,035,31185,5316,5290,120,5410,21
2021-07-10,Los Angeles,037,10098052,1222882,1212043,43096,1255139,24542
2021-07-10,Madera,039,155013,16945,16744,966,17710,241
2021-07-10,Marin,041,260295,14390,14194,269,14463,233
2021-07-10,Mariposa,043,17540,445,442,11,453,5
2021-07-10,Mendocino,045,87422,4270,4153,87,4240,49
2021-07-10,Merced,047,269075,31434,31328,1074,32402,470
2021-07-10,Modoc,049,8938,421,410,149,559,4
2021-07-10,Mono,051,14174,1271,1275,18,1293,3
2021-07-10,Monterey,053,433212,43524,43251,1914,45165,499
2021-07-10,Napa,055,140530,10136,10077,41,10118,81
2021-07-10,Nevada,057,99092,5099,5000,196,5196,72
2021-07-10,Orange,059,3164182,258836,256438,11768,268206,5135
2021-07-10,Placer,061,380077,24278,23916,1631,25547,302
2021-07-10,Plumas,063,18699,732,717,14,731,4
2021-07-10,Riverside,065,2383286,297786,293474,14335,307809,4541
2021-07-10,Sacramento,067,1510023,110508,109091,1923,111014,1682
2021-07-10,San Benito,069,59416,6176,6141,116,6257,63
2021-07-10,San Bernardino,071,2135413,296803,294932,9168,304100,5117
2021-07-10,San Diego,073,3302833,286222,283577,15873,299450,3783
2021-07-10,San Francisco,075,870044,38007,37338,1360,38698,559
2021-07-10,San Joaquin,077,732212,74967,74150,3757,77907,1412
2021-07-10,San Luis Obispo,079,281455,21684,21375,774,22149,258
2021-07-10,San Mateo,081,765935,43375,42948,508,43456,542
2021-07-10,Santa Barbara,083,443738,34860,34595,1160,35755,460
2021-07-10,Santa Clara,085,1922200,120586,119330,798,120128,2094
2021-07-10,Santa Cruz,087,273765,16423,16286,821,17107,207
2021-07-10,Shasta,089,179085,12704,12623,1673,14296,206
2021-07-10,Sierra,091,2930,66,61,12,73,0
2021-07-10,Siskiyou,093,43540,2003,1909,401,2310,29
2021-07-10,Solano,095,438530,34068,33678,609,34287,268
2021-07-10,Sonoma,097,501317,31551,31231,373,31604,317
2021-07-10,Stanislaus,099,539301,57465,57104,6115,63219,1026
2021-07-10,Sutter,101,95872,9756,9692,93,9785,114
2021-07-10,Tehama,103,63373,5181,5131,604,5735,63
2021-07-10,Trinity,105,12862,497,341,104,445,3
2021-07-10,Tulare,107,460477,50636,49850,9281,59131,853
2021-07-10,Tuolumne,109,53932,4113,4114,42,4156,64
2021-07-10,Ventura,111,848112,82463,81713,3199,84912,1039
2021-07-10,Yolo,113,214977,14355,14250,391,14641,213
2021-07-10,Yuba,115,75493,6336,6238,133,6371,52
2021-07-09,Alameda,001,1643700,91259,90090,2051,92141,1252
2021-07-09,Alpine,003,1148,88,89,0,89,0
2021-07-09,Amador,005,37829,3788,3773,34,3807,47
2021-07-09,Butte,007,227075,12927,12764,1891,14655,202
2021-07-09,Calaveras,009,45235,2244,2214,15,2229,57
2021-07-09,Colusa,011,21464,1983,1969,332,2301,16
2021-07-09,Contra Costa,013,1133247,72342,71376,1365,72741,821
2021-07-09,Del Norte,015,27424,1497,1451,13,1464,8
2021-07-09,El Dorado,017,186661,10661,10508,786,11294,114
2021-07-09,Fresno,019,978130,104033,102675,8913,111588,1730
2021-07-09,Glenn,021,27897,2465,2440,577,3017,20
2021-07-09,Humboldt,023,135768,4640,4574,55,4629,51
2021-07-09,Imperial,025,180216,28928,28729,2791,31520,741
2021-07-09,Inyo,027,18085,1416,1415,12,1427,36
2021-07-09,Kern,029,883053,98369,97538,11320,108858,1346
2021-07-09,Kings,031,150075,23400,23090,1125,24215,246
2021-07-09,Lake,033,64148,3746,3667,13,3680,63
2021-07-09,Lassen,035,31185,5314,5290,119,5409,21
2021-07-09,Los Angeles,037,10098052,1221878,1212043,43023,1255066,24542
2021-07-09,Madera,039,155013,16935,16744,965,17709,241
2021-07-09,Marin,041,260295,14369,14194,268,14462,233
2021-07-09,Mariposa,043,17540,445,442,11,453,5
2021-07-09,Mendocino,045,87422,4263,4153,87,4240,49
2021-07-09,Merced,047,269075,31419,31328,1074,32402,470
2021-07-09,Modoc,049,8938,421,410,149,559,4
2021-07-09,Mono,051,14174,1271,1275,18,1293,3
2021-07-09,Monterey,053,433212,43515,43251,1914,45165,499
2021-07-09,Napa,055,140530,10129,10077,41,10118,81
2021-07-09,Nevada,057,99092,5090,5000,196,5196,72
2021-07-09,Orange,059,3164182,258631,256438,11754,268192,5135
2021-07-09,Placer,061,380077,24256,23916,1625,25541,302
2021-07-09,Plumas,063,18699,730,717,14,731,4
2021-07-09,Riverside,065,2383286,297600,293474,14322,307796,4541
2021-07-09,Sacramento,067,1510023,110354,109091,1914,111005,1682
2021-07-09,San Benito,069,59416,6174,6141,116,6257,63
2021-07-09,San Bernardino,071,2135413,296649,294932,9161,304093,5117
2021-07-09,San Diego,073,3302833,285933,283577,15825,299402,3783
2021-07-09,San Francisco,075,870044,37927,37338,1353,38691,559
2021-07-09,San Joaquin,077,732212,74893,74150,3750,77900,1412
2021-07-09,San Luis Obispo,079,281455,21672,21375,774,22149,258
2021-07-09,San Mateo,081,765935,43331,42948,504,43452,542
2021-07-09,Santa Barbara,083,443738,34839,34595,1159,35754,460
2021-07-09,Santa Clara,085,1922200,120476,119330,798,120128,2094
2021-07-09,Santa Cruz,087,273765,16420,16286,821,17107,207
2021-07-09,Shasta,089,179085,12698,12623,1668,14291,206
2021-07-09,Sierra,091,2930,66,61,12,73,0
2021-07-09,Siskiyou,093,43540,2001,1909,400,2309,29
2021-07-09,Solano,095,438530,34032,33678,605,34283,268
2021-07-09,Sonoma,097,501317,31515,31231,373,31604,317
2021-07-09,Stanislaus,099,539301,57436,57104,6113,63217,1026
2021-07-09,Sutter,101,95872,9747,9692,93,9785,114
2021-07-09,Tehama,103,63373,5179,5131,604,5735,63
2021-07-09,Trinity,105,12862,496,341,101,442,3
2021-07-09,Tulare,107,460477,50623,49850,9275,59125,853
2021-07-09,Tuolumne,109,53932,4109,4114,42,4156,64
2021-07-09,Ventura,111,848112,82408,81713,3190,84903,1039
2021-07-09,Yolo,113,214977,14340,14250,387,14637,213
2021-07-09,Yuba,115,75493,6323,6238,133,6371,52
2021-07-08,Alameda,001,1643700,91052,90090,2048,92138,1252
2021-07-08,Alpine,003,1148,88,89,0,89,0
2021-07-08,Amador,005,37829,3786,3773,34,3807,47
2021-07-08,Butte,007,227075,12914,12764,1888,14652,202
2021-07-08,Calaveras,009,45235,2241,2214,14,2228,57
2021-07-08,Colusa,011,21464,1983,1969,332,2301,16
2021-07-08,Contra Costa,013,1133247,72214,71376,1360,72736,821
2021-07-08,Del Norte,015,27424,1495,1451,13,1464,8
2021-07-08,El Dorado,017,186661,10644,10508,781,11289,114
2021-07-08,Fresno,019,978130,103971,102675,8902,111577,1730
2021-07-08,Glenn,021,27897,2465,2440,577,3017,20
2021-07-08,Humboldt,023,135768,4624,4574,54,4628,51
2021-07-08,Imperial,025,180216,28916,28729,2790,31519,741
2021-07-08,Inyo,027,18085,1416,1415,12,1427,36
2021-07-08,Kern,029,883053,98321,97538,11305,108843,1346
2021-07-08,Kings,031,150075,23391,23090,1125,24215,246
2021-07-08,Lake,033,64148,3732,3667,13,3680,63
2021-07-08,Lassen,035,31185,5311,5290,119,5409,21
2021-07-08,Los Angeles,037,10098052,1220664,1212043,42927,1254970,24542
2021-07-08,Madera,039,155013,16919,16744,965,17709,241
2021-07-08,Marin,041,260295,14355,14194,268,14462,233
2021-07-08,Mariposa,043,17540,444,442,11,453,5
2021-07-08,Mendocino,045,87422,4260,4153,87,4240,49
2021-07-08,Merced,047,269075,31405,31328,1072,32400,470
2021-07-08,Modoc,049,8938,421,410,149,559,4
2021-07-08,Mono,051,14174,1271,1275,18,1293,3
2021-07-08,Monterey,053,433212,43495,43251,1908,45159,499
2021-07-08,Napa,055,140530,10125,10077,41,10118,81
2021-07-08,Nevada,057,99092,5084,5000,196,5196,72
2021-07-08,Orange,059,3164182,258436,256438,11733,268171,5135
2021-07-08,Placer,061,380077,24217,23916,1617,25533,302
2021-07-08,Plumas,063,18699,729,717,14,731,4
2021-07-08,Riverside,065,2383286,297399,293474,14306,307780,4541
2021-07-08,Sacramento,067,1510023,110132,109091,1907,110998,1682
2021-07-08,San Benito,069,59416,6171,6141,116,6257,63
2021-07-08,San Bernardino,071,2135413,296473,294932,9152,304084,5117
2021-07-08,San Diego,073,3302833,285606,283577,15777,299354,3783
2021-07-08,San Francisco,075,870044,37847,37338,1349,38687,559
2021-07-08,San Joaquin,077,732212,74805,74150,3737,77887,1412
2021-07-08,San Luis Obispo,079,281455,21660,21375,771,22146,258
2021-07-08,San Mateo,081,765935,43280,42948,503,43451,542
2021-07-08,Santa Barbara,083,443738,34812,34595,1157,35752,460
2021-07-08,Santa Clara,085,1922200,120383,119330,797,120127,2094
2021-07-08,Santa Cruz,087,273765,16414,16286,821,17107,207
2021-07-08,Shasta,089,179085,12692,12623,1664,14287,206
2021-07-08,Sierra,091,2930,66,61,12,73,0
2021-07-08,Siskiyou,093,43540,1996,1909,397,2306,29
2021-07-08,Solano,095,438530,33977,33678,599,34277,268
2021-07-08,Sonoma,097,501317,31484,31231,372,31603,317
2021-07-08,Stanislaus,099,539301,57410,57104,6109,63213,1026
2021-07-08,Sutter,101,95872,9733,9692,91,9783,114
2021-07-08,Tehama,103,63373,5176,5131,603,5734,63
2021-07-08,Trinity,105,12862,496,341,101,442,3
2021-07-08,Tulare,107,460477,50605,49850,9267,59117,853
2021-07-08,Tuolumne,109,53932,4107,4114,42,4156,64
2021-07-08,Ventura,111,848112,82344,81713,3174,84887,1039
2021-07-08,Yolo,113,214977,14321,14250,385,14635,213
2021-07-08,Yuba,115,75493,6315,6238,133,6371,52
2021-07-07,Alameda,001,1643700,90867,89995,2042,92037,1253
2021-07-07,Alpine,003,1148,88,89,0,89,0
2021-07-07,Amador,005,37829,3781,3770,34,3804,47
2021-07-07,Butte,007,227075,12901,12750,1883,14633,202
2021-07-07,Calaveras,009,45235,2234,2212,14,2226,57
2021-07-07,Colusa,011,21464,1979,1969,332,2301,16
2021-07-07,Contra Costa,013,1133247,72067,71308,1358,72666,821
2021-07-07,Del Norte,015,27424,1490,1446,13,1459,8
2021-07-07,El Dorado,017,186661,10624,10494,779,11273,114
2021-07-07,Fresno,019,978130,103921,102639,8895,111534,1729
2021-07-07,Glenn,021,27897,2465,2441,577,3018,20
2021-07-07,Humboldt,023,135768,4610,4566,54,4620,51
2021-07-07,Imperial,025,180216,28909,28701,2790,31491,740
2021-07-07,Inyo,027,18085,1415,1415,12,1427,36
2021-07-07,Kern,029,883053,98277,97507,11290,108797,1348
2021-07-07,Kings,031,150075,23378,23085,1122,24207,245
2021-07-07,Lake,033,64148,3713,3660,13,3673,63
2021-07-07,Lassen,035,31185,5311,5286,119,5405,21
2021-07-07,Los Angeles,037,10098052,1219485,1211316,42821,1254137,24531
2021-07-07,Madera,039,155013,16908,16733,963,17696,241
2021-07-07,Marin,041,260295,14336,14183,267,14450,233
2021-07-07,Mariposa,043,17540,442,442,11,453,5
2021-07-07,Mendocino,045,87422,4251,4145,87,4232,49
2021-07-07,Merced,047,269075,31390,31317,1072,32389,470
2021-07-07,Modoc,049,8938,421,410,149,559,4
2021-07-07,Mono,051,14174,1270,1274,18,1292,3
2021-07-07,Monterey,053,433212,43470,43233,1906,45139,494
2021-07-07,Napa,055,140530,10114,10078,41,10119,81
2021-07-07,Nevada,057,99092,5077,4996,196,5192,72
2021-07-07,Orange,059,3164182,258210,256301,11711,268012,5132
2021-07-07,Placer,061,380077,24181,23901,1607,25508,302
2021-07-07,Plumas,063,18699,729,710,14,724,4
2021-07-07,Riverside,065,2383286,297184,293331,14296,307627,4538
2021-07-07,Sacramento,067,1510023,109941,108954,1899,110853,1682
2021-07-07,San Benito,069,59416,6166,6137,116,6253,63
2021-07-07,San Bernardino,071,2135413,296305,294787,9145,303932,5087
2021-07-07,San Diego,073,3302833,285286,283377,15737,299114,3782
2021-07-07,San Francisco,075,870044,37755,37284,1346,38630,558
2021-07-07,San Joaquin,077,732212,74729,74095,3721,77816,1410
2021-07-07,San Luis Obispo,079,281455,21651,21360,769,22129,258
2021-07-07,San Mateo,081,765935,43225,42908,500,43408,542
2021-07-07,Santa Barbara,083,443738,34786,34582,1157,35739,460
2021-07-07,Santa Clara,085,1922200,120285,119250,796,120046,2094
2021-07-07,Santa Cruz,087,273765,16405,16279,820,17099,207
2021-07-07,Shasta,089,179085,12684,12613,1661,14274,206
2021-07-07,Sierra,091,2930,66,60,12,72,0
2021-07-07,Siskiyou,093,43540,1990,1908,393,2301,29
2021-07-07,Solano,095,438530,33928,33659,592,34251,268
2021-07-07,Sonoma,097,501317,31438,31172,372,31544,316
2021-07-07,Stanislaus,099,539301,57378,57102,6104,63206,1028
2021-07-07,Sutter,101,95872,9723,9683,91,9774,114
2021-07-07,Tehama,103,63373,5175,5129,603,5732,63
2021-07-07,Trinity,105,12862,496,341,101,442,3
2021-07-07,Tulare,107,460477,50601,49835,9258,59093,853
2021-07-07,Tuolumne,109,53932,4103,4115,41,4156,64
2021-07-07,Ventura,111,848112,82300,81608,3160,84768,1036
2021-07-07,Yolo,113,214977,14311,14236,382,14618,213
2021-07-07,Yuba,115,75493,6299,6233,133,6366,51
2021-07-06,Alameda,001,1643700,90668,89918,2034,91952,1253
2021-07-06,Alpine,003,1148,88,89,0,89,0
2021-07-06,Amador,005,37829,3780,3768,33,3801,47
2021-07-06,Butte,007,227075,12888,12744,1880,14624,201
2021-07-06,Calaveras,009,45235,2234,2211,14,2225,55
2021-07-06,Colusa,011,21464,1978,1967,329,2296,16
2021-07-06,Contra Costa,013,1133247,71939,71262,1355,72617,820
2021-07-06,Del Norte,015,27424,1486,1445,13,1458,8
2021-07-06,El Dorado,017,186661,10606,10484,778,11262,113
2021-07-06,Fresno,019,978130,103869,102616,8883,111499,1727
2021-07-06,Glenn,021,27897,2464,2438,577,3015,20
2021-07-06,Humboldt,023,135768,4596,4565,53,4618,49
2021-07-06,Imperial,025,180216,28894,28693,2788,31481,739
2021-07-06,Inyo,027,18085,1415,1412,12,1424,36
2021-07-06,Kern,029,883053,98235,97491,11279,108770,1346
2021-07-06,Kings,031,150075,23370,23077,1121,24198,245
2021-07-06,Lake,033,64148,3703,3659,13,3672,63
2021-07-06,Lassen,035,31185,5310,5288,118,5406,21
2021-07-06,Los Angeles,037,10098052,1218266,1210965,42722,1253687,24525
2021-07-06,Madera,039,155013,16896,16730,963,17693,241
2021-07-06,Marin,041,260295,14322,14181,267,14448,233
2021-07-06,Mariposa,043,17540,442,442,11,453,5
2021-07-06,Mendocino,045,87422,4244,4143,87,4230,49
2021-07-06,Merced,047,269075,31373,31317,1071,32388,470
2021-07-06,Modoc,049,8938,421,411,149,560,4
2021-07-06,Mono,051,14174,1269,1274,18,1292,3
2021-07-06,Monterey,053,433212,43447,43224,1905,45129,494
2021-07-06,Napa,055,140530,10103,10081,41,10122,81
2021-07-06,Nevada,057,99092,5068,4988,196,5184,72
2021-07-06,Orange,059,3164182,257966,256227,11694,267921,5129
2021-07-06,Placer,061,380077,24140,23876,1601,25477,302
2021-07-06,Plumas,063,18699,728,708,14,722,4
2021-07-06,Riverside,065,2383286,296982,293227,14278,307505,4539
2021-07-06,Sacramento,067,1510023,109730,108850,1891,110741,1679
2021-07-06,San Benito,069,59416,6162,6137,116,6253,63
2021-07-06,San Bernardino,071,2135413,296126,294712,9132,303844,5056
2021-07-06,San Diego,073,3302833,284929,283278,15678,298956,3782
2021-07-06,San Francisco,075,870044,37638,37251,1345,38596,558
2021-07-06,San Joaquin,077,732212,74659,74019,3709,77728,1410
2021-07-06,San Luis Obispo,079,281455,21634,21354,768,22122,257
2021-07-06,San Mateo,081,765935,43150,42895,500,43395,541
2021-07-06,Santa Barbara,083,443738,34767,34572,1155,35727,460
2021-07-06,Santa Clara,085,1922200,120167,119194,793,119987,2095
2021-07-06,Santa Cruz,087,273765,16400,16274,819,17093,207
2021-07-06,Shasta,089,179085,12674,12606,1659,14265,205
2021-07-06,Sierra,091,2930,65,60,12,72,0
2021-07-06,Siskiyou,093,43540,1987,1905,389,2294,29
2021-07-06,Solano,095,438530,33877,33619,589,34208,268
2021-07-06,Sonoma,097,501317,31375,31130,371,31501,316
2021-07-06,Stanislaus,099,539301,57331,57120,6092,63212,1029
2021-07-06,Sutter,101,95872,9714,9674,90,9764,114
2021-07-06,Tehama,103,63373,5172,5126,602,5728,63
2021-07-06,Trinity,105,12862,496,341,101,442,3
2021-07-06,Tulare,107,460477,50586,49826,9247,59073,853
2021-07-06,Tuolumne,109,53932,4101,4113,41,4154,64
2021-07-06,Ventura,111,848112,82260,81534,3134,84668,1033
2021-07-06,Yolo,113,214977,14289,14227,379,14606,213
2021-07-06,Yuba,115,75493,6288,6231,133,6364,51
2021-07-05,Alameda,001,1643700,90490,89892,2029,91921,1253
2021-07-05,Alpine,003,1148,88,89,0,89,0
2021-07-05,Amador,005,37829,3778,3768,33,3801,47
2021-07-05,Butte,007,227075,12880,12740,1870,14610,201
2021-07-05,Calaveras,009,45235,2232,2211,14,2225,55
2021-07-05,Colusa,011,21464,1976,1966,328,2294,16
2021-07-05,Contra Costa,013,1133247,71811,71235,1355,72590,820
2021-07-05,Del Norte,015,27424,1482,1446,13,1459,8
2021-07-05,El Dorado,017,186661,10581,10481,778,11259,113
2021-07-05,Fresno,019,978130,103810,102592,8868,111460,1727
2021-07-05,Glenn,021,27897,2461,2438,576,3014,20
2021-07-05,Humboldt,023,135768,4582,4563,53,4616,49
2021-07-05,Imperial,025,180216,28875,28689,2788,31477,739
2021-07-05,Inyo,027,18085,1415,1412,12,1424,36
2021-07-05,Kern,029,883053,98188,97479,11258,108737,1346
2021-07-05,Kings,031,150075,23362,23065,1118,24183,245
2021-07-05,Lake,033,64148,3685,3645,13,3658,63
2021-07-05,Lassen,035,31185,5307,5288,117,5405,21
2021-07-05,Los Angeles,037,10098052,1217075,1210653,42619,1253272,24522
2021-07-05,Madera,039,155013,16885,16722,962,17684,241
2021-07-05,Marin,041,260295,14301,14178,267,14445,233
2021-07-05,Mariposa,043,17540,442,441,11,452,5
2021-07-05,Mendocino,045,87422,4239,4139,86,4225,49
2021-07-05,Merced,047,269075,31353,31312,1071,32383,470
2021-07-05,Modoc,049,8938,421,410,149,559,4
2021-07-05,Mono,051,14174,1269,1273,18,1291,3
2021-07-05,Monterey,053,433212,43427,43218,1900,45118,494
2021-07-05,Napa,055,140530,10097,10074,41,10115,81
2021-07-05,Nevada,057,99092,5050,4980,195,5175,72
2021-07-05,Orange,059,3164182,257765,256173,11676,267849,5129
2021-07-05,Placer,061,380077,24093,23867,1593,25460,302
2021-07-05,Plumas,063,18699,727,708,14,722,4
2021-07-05,Riverside,065,2383286,296790,293193,14266,307459,4539
2021-07-05,Sacramento,067,1510023,109547,108758,1882,110640,1679
2021-07-05,San Benito,069,59416,6155,6137,116,6253,63
2021-07-05,San Bernardino,071,2135413,295964,294647,9125,303772,5037
2021-07-05,San Diego,073,3302833,284566,282834,15634,298468,3782
2021-07-05,San Francisco,075,870044,37552,37237,1340,38577,558
2021-07-05,San Joaquin,077,732212,74589,73999,3704,77703,1410
2021-07-05,San Luis Obispo,079,281455,21621,21351,767,22118,257
2021-07-05,San Mateo,081,765935,43098,42876,497,43373,541
2021-07-05,Santa Barbara,083,443738,34747,34569,1155,35724,460
2021-07-05,Santa Clara,085,1922200,120061,119184,791,119975,2095
2021-07-05,Santa Cruz,087,273765,16391,16273,818,17091,208
2021-07-05,Shasta,089,179085,12665,12603,1657,14260,205
2021-07-05,Sierra,091,2930,65,60,12,72,0
2021-07-05,Siskiyou,093,43540,1985,1904,388,2292,29
2021-07-05,Solano,095,438530,33807,33612,583,34195,268
2021-07-05,Sonoma,097,501317,31322,31116,371,31487,316
2021-07-05,Stanislaus,099,539301,57301,57109,6082,63191,1029
2021-07-05,Sutter,101,95872,9702,9667,90,9757,114
2021-07-05,Tehama,103,63373,5171,5125,602,5727,63
2021-07-05,Trinity,105,12862,495,341,100,441,3
2021-07-05,Tulare,107,460477,50568,49818,9244,59062,853
2021-07-05,Tuolumne,109,53932,4097,4112,41,4153,64
2021-07-05,Ventura,111,848112,82209,81519,3115,84634,1033
2021-07-05,Yolo,113,214977,14270,14225,371,14596,213
2021-07-05,Yuba,115,75493,6280,6223,133,6356,51
2021-07-04,Alameda,001,1643700,90325,89683,2026,91709,1253
2021-07-04,Alpine,003,1148,88,89,0,89,0
2021-07-04,Amador,005,37829,3777,3758,33,3791,46
2021-07-04,Butte,007,227075,12870,12684,1870,14554,201
2021-07-04,Calaveras,009,45235,2228,2200,14,2214,55
2021-07-04,Colusa,011,21464,1976,1969,328,2297,15
2021-07-04,Contra Costa,013,1133247,71705,70941,1350,72291,818
2021-07-04,Del Norte,015,27424,1479,1439,13,1452,8
2021-07-04,El Dorado,017,186661,10572,10433,777,11210,113
2021-07-04,Fresno,019,978130,103764,102512,8851,111363,1727
2021-07-04,Glenn,021,27897,2459,2442,575,3017,20
2021-07-04,Humboldt,023,135768,4574,4530,53,4583,49
2021-07-04,Imperial,025,180216,28869,28661,2788,31449,739
2021-07-04,Inyo,027,18085,1415,1412,12,1424,35
2021-07-04,Kern,029,883053,98169,97421,11249,108670,1347
2021-07-04,Kings,031,150075,23354,23051,1118,24169,245
2021-07-04,Lake,033,64148,3675,3623,13,3636,62
2021-07-04,Lassen,035,31185,5306,5277,117,5394,20
2021-07-04,Los Angeles,037,10098052,1216217,1208705,42531,1251236,24506
2021-07-04,Madera,039,155013,16873,16696,960,17656,240
2021-07-04,Marin,041,260295,14286,14143,267,14410,233
2021-07-04,Mariposa,043,17540,442,441,11,452,5
2021-07-04,Mendocino,045,87422,4229,4122,86,4208,49
2021-07-04,Merced,047,269075,31342,31297,1071,32368,469
2021-07-04,Modoc,049,8938,421,410,149,559,4
2021-07-04,Mono,051,14174,1269,1275,18,1293,3
2021-07-04,Monterey,053,433212,43411,43212,1899,45111,492
2021-07-04,Napa,055,140530,10089,10045,40,10085,81
2021-07-04,Nevada,057,99092,5040,4966,195,5161,72
2021-07-04,Orange,059,3164182,257590,255823,11655,267478,5126
2021-07-04,Placer,061,380077,24056,23764,1586,25350,299
2021-07-04,Plumas,063,18699,727,707,14,721,4
2021-07-04,Riverside,065,2383286,296630,293260,14260,307520,4536
2021-07-04,Sacramento,067,1510023,109377,108257,1876,110133,1676
2021-07-04,San Benito,069,59416,6148,6108,116,6224,63
2021-07-04,San Bernardino,071,2135413,295797,294294,9118,303412,5003
2021-07-04,San Diego,073,3302833,284342,282692,15596,298288,3780
2021-07-04,San Francisco,075,870044,37494,37107,1334,38441,558
2021-07-04,San Joaquin,077,732212,74523,73841,3696,77537,1409
2021-07-04,San Luis Obispo,079,281455,21615,21330,766,22096,256
2021-07-04,San Mateo,081,765935,43064,42691,497,43188,541
2021-07-04,Santa Barbara,083,443738,34724,34526,1154,35680,456
2021-07-04,Santa Clara,085,1922200,119971,118966,790,119756,2090
2021-07-04,Santa Cruz,087,273765,16380,16254,818,17072,208
2021-07-04,Shasta,089,179085,12661,12582,1656,14238,204
2021-07-04,Sierra,091,2930,64,60,12,72,0
2021-07-04,Siskiyou,093,43540,1981,1899,387,2286,29
2021-07-04,Solano,095,438530,33766,33486,581,34067,268
2021-07-04,Sonoma,097,501317,31292,31000,370,31370,316
2021-07-04,Stanislaus,099,539301,57286,57018,6076,63094,1018
2021-07-04,Sutter,101,95872,9691,9644,90,9734,114
2021-07-04,Tehama,103,63373,5167,5124,602,5726,63
2021-07-04,Trinity,105,12862,494,341,100,441,3
2021-07-04,Tulare,107,460477,50558,49789,9241,59030,853
2021-07-04,Tuolumne,109,53932,4089,4113,41,4154,64
2021-07-04,Ventura,111,848112,82151,81425,3104,84529,1033
2021-07-04,Yolo,113,214977,14250,14188,368,14556,213
2021-07-04,Yuba,115,75493,6272,6197,133,6330,51
2021-07-03,Alameda,001,1643700,90236,89683,2018,91701,1253
2021-07-03,Alpine,003,1148,88,89,0,89,0
2021-07-03,Amador,005,37829,3777,3758,33,3791,46
2021-07-03,Butte,007,227075,12866,12684,1869,14553,201
2021-07-03,Calaveras,009,45235,2226,2200,14,2214,55
2021-07-03,Colusa,011,21464,1975,1969,328,2297,15
2021-07-03,Contra Costa,013,1133247,71646,70941,1347,72288,818
2021-07-03,Del Norte,015,27424,1476,1439,13,1452,8
2021-07-03,El Dorado,017,186661,10565,10433,775,11208,113
2021-07-03,Fresno,019,978130,103740,102512,8842,111354,1727
2021-07-03,Glenn,021,27897,2459,2442,575,3017,20
2021-07-03,Humboldt,023,135768,4569,4530,53,4583,49
2021-07-03,Imperial,025,180216,28859,28661,2788,31449,739
2021-07-03,Inyo,027,18085,1415,1412,12,1424,35
2021-07-03,Kern,029,883053,98149,97421,11241,108662,1347
2021-07-03,Kings,031,150075,23354,23051,1117,24168,245
2021-07-03,Lake,033,64148,3665,3623,13,3636,62
2021-07-03,Lassen,035,31185,5305,5277,117,5394,20
2021-07-03,Los Angeles,037,10098052,1215789,1208705,42500,1251205,24506
2021-07-03,Madera,039,155013,16864,16696,957,17653,240
2021-07-03,Marin,041,260295,14282,14143,267,14410,233
2021-07-03,Mariposa,043,17540,442,441,11,452,5
2021-07-03,Mendocino,045,87422,4228,4122,86,4208,49
2021-07-03,Merced,047,269075,31329,31297,1070,32367,469
2021-07-03,Modoc,049,8938,420,410,149,559,4
2021-07-03,Mono,051,14174,1268,1275,18,1293,3
2021-07-03,Monterey,053,433212,43399,43212,1896,45108,492
2021-07-03,Napa,055,140530,10084,10045,40,10085,81
2021-07-03,Nevada,057,99092,5026,4966,195,5161,72
2021-07-03,Orange,059,3164182,257506,255823,11648,267471,5126
2021-07-03,Placer,061,380077,24037,23764,1583,25347,299
2021-07-03,Plumas,063,18699,727,707,14,721,4
2021-07-03,Riverside,065,2383286,296538,293260,14256,307516,4536
2021-07-03,Sacramento,067,1510023,109303,108257,1873,110130,1676
2021-07-03,San Benito,069,59416,6141,6108,116,6224,63
2021-07-03,San Bernardino,071,2135413,295707,294294,9115,303409,5003
2021-07-03,San Diego,073,3302833,284211,282692,15577,298269,3780
2021-07-03,San Francisco,075,870044,37453,37107,1331,38438,558
2021-07-03,San Joaquin,077,732212,74487,73841,3691,77532,1409
2021-07-03,San Luis Obispo,079,281455,21603,21330,766,22096,256
2021-07-03,San Mateo,081,765935,43039,42691,496,43187,541
2021-07-03,Santa Barbara,083,443738,34715,34526,1153,35679,456
2021-07-03,Santa Clara,085,1922200,119924,118966,790,119756,2090
2021-07-03,Santa Cruz,087,273765,16373,16254,818,17072,208
2021-07-03,Shasta,089,179085,12657,12582,1654,14236,204
2021-07-03,Sierra,091,2930,64,60,12,72,0
2021-07-03,Siskiyou,093,43540,1980,1899,386,2285,29
2021-07-03,Solano,095,438530,33722,33486,581,34067,268
2021-07-03,Sonoma,097,501317,31258,31000,370,31370,316
2021-07-03,Stanislaus,099,539301,57275,57018,6068,63086,1018
2021-07-03,Sutter,101,95872,9681,9644,90,9734,114
2021-07-03,Tehama,103,63373,5165,5124,602,5726,63
2021-07-03,Trinity,105,12862,494,341,100,441,3
2021-07-03,Tulare,107,460477,50552,49789,9235,59024,853
2021-07-03,Tuolumne,109,53932,4088,4113,41,4154,64
2021-07-03,Ventura,111,848112,82121,81425,3096,84521,1033
2021-07-03,Yolo,113,214977,14240,14188,365,14553,213
2021-07-03,Yuba,115,75493,6266,6197,133,6330,51
2021-07-02,Alameda,001,1643700,90154,89683,2017,91700,1253
2021-07-02,Alpine,003,1148,88,89,0,89,0
2021-07-02,Amador,005,37829,3775,3758,33,3791,46
2021-07-02,Butte,007,227075,12859,12684,1869,14553,201
2021-07-02,Calaveras,009,45235,2224,2200,14,2214,55
2021-07-02,Colusa,011,21464,1974,1969,327,2296,15
2021-07-02,Contra Costa,013,1133247,71576,70941,1343,72284,818
2021-07-02,Del Norte,015,27424,1476,1439,13,1452,8
2021-07-02,El Dorado,017,186661,10557,10433,775,11208,113
2021-07-02,Fresno,019,978130,103711,102512,8836,111348,1727
2021-07-02,Glenn,021,27897,2458,2442,574,3016,20
2021-07-02,Humboldt,023,135768,4566,4530,52,4582,49
2021-07-02,Imperial,025,180216,28853,28661,2787,31448,739
2021-07-02,Inyo,027,18085,1415,1412,12,1424,35
2021-07-02,Kern,029,883053,98131,97421,11232,108653,1347
2021-07-02,Kings,031,150075,23344,23051,1117,24168,245
2021-07-02,Lake,033,64148,3659,3623,13,3636,62
2021-07-02,Lassen,035,31185,5305,5277,117,5394,20
2021-07-02,Los Angeles,037,10098052,1215315,1208705,42461,1251166,24506
2021-07-02,Madera,039,155013,16855,16696,956,17652,240
2021-07-02,Marin,041,260295,14278,14143,267,14410,233
2021-07-02,Mariposa,043,17540,442,441,11,452,5
2021-07-02,Mendocino,045,87422,4224,4122,85,4207,49
2021-07-02,Merced,047,269075,31320,31297,1070,32367,469
2021-07-02,Modoc,049,8938,420,410,149,559,4
2021-07-02,Mono,051,14174,1267,1275,18,1293,3
2021-07-02,Monterey,053,433212,43391,43212,1895,45107,492
2021-07-02,Napa,055,140530,10079,10045,40,10085,81
2021-07-02,Nevada,057,99092,5017,4966,195,5161,72
2021-07-02,Orange,059,3164182,257395,255823,11641,267464,5126
2021-07-02,Placer,061,380077,24020,23764,1576,25340,299
2021-07-02,Plumas,063,18699,727,707,14,721,4
2021-07-02,Riverside,065,2383286,296441,293260,14251,307511,4536
2021-07-02,Sacramento,067,1510023,109225,108257,1872,110129,1676
2021-07-02,San Benito,069,59416,6138,6108,116,6224,63
2021-07-02,San Bernardino,071,2135413,295620,294294,9113,303407,5003
2021-07-02,San Diego,073,3302833,284066,282692,15551,298243,3780
2021-07-02,San Francisco,075,870044,37404,37107,1329,38436,558
2021-07-02,San Joaquin,077,732212,74454,73841,3685,77526,1409
2021-07-02,San Luis Obispo,079,281455,21597,21330,765,22095,256
2021-07-02,San Mateo,081,765935,43003,42691,496,43187,541
2021-07-02,Santa Barbara,083,443738,34705,34526,1153,35679,456
2021-07-02,Santa Clara,085,1922200,119846,118966,790,119756,2090
2021-07-02,Santa Cruz,087,273765,16369,16254,818,17072,208
2021-07-02,Shasta,089,179085,12653,12582,1654,14236,204
2021-07-02,Sierra,091,2930,63,60,12,72,0
2021-07-02,Siskiyou,093,43540,1977,1899,385,2284,29
2021-07-02,Solano,095,438530,33697,33486,581,34067,268
2021-07-02,Sonoma,097,501317,31235,31000,370,31370,316
2021-07-02,Stanislaus,099,539301,57260,57018,6067,63085,1018
2021-07-02,Sutter,101,95872,9677,9644,90,9734,114
2021-07-02,Tehama,103,63373,5163,5124,600,5724,63
2021-07-02,Trinity,105,12862,494,341,100,441,3
2021-07-02,Tulare,107,460477,50542,49789,9227,59016,853
2021-07-02,Tuolumne,109,53932,4085,4113,41,4154,64
2021-07-02,Ventura,111,848112,82078,81425,3088,84513,1033
2021-07-02,Yolo,113,214977,14224,14188,363,14551,213
2021-07-02,Yuba,115,75493,6258,6197,133,6330,51
2021-07-01,Alameda,001,1643700,90054,89683,2015,91698,1253
2021-07-01,Alpine,003,1148,88,89,0,89,0
2021-07-01,Amador,005,37829,3774,3758,33,3791,46
2021-07-01,Butte,007,227075,12847,12684,1867,14551,201
2021-07-01,Calaveras,009,45235,2222,2200,14,2214,55
2021-07-01,Colusa,011,21464,1974,1969,325,2294,15
2021-07-01,Contra Costa,013,1133247,71504,70941,1343,72284,818
2021-07-01,Del Norte,015,27424,1475,1439,13,1452,8
2021-07-01,El Dorado,017,186661,10545,10433,775,11208,113
2021-07-01,Fresno,019,978130,103672,102512,8831,111343,1727
2021-07-01,Glenn,021,27897,2458,2442,574,3016,20
2021-07-01,Humboldt,023,135768,4564,4530,52,4582,49
2021-07-01,Imperial,025,180216,28836,28661,2787,31448,739
2021-07-01,Inyo,027,18085,1415,1412,12,1424,35
2021-07-01,Kern,029,883053,98105,97421,11222,108643,1347
2021-07-01,Kings,031,150075,23330,23051,1117,24168,245
2021-07-01,Lake,033,64148,3656,3623,13,3636,62
2021-07-01,Lassen,035,31185,5303,5277,117,5394,20
2021-07-01,Los Angeles,037,10098052,1214717,1208705,42405,1251110,24506
2021-07-01,Madera,039,155013,16846,16696,955,17651,240
2021-07-01,Marin,041,260295,14274,14143,267,14410,233
2021-07-01,Mariposa,043,17540,442,441,11,452,5
2021-07-01,Mendocino,045,87422,4220,4122,84,4206,49
2021-07-01,Merced,047,269075,31314,31297,1070,32367,469
2021-07-01,Modoc,049,8938,420,410,149,559,4
2021-07-01,Mono,051,14174,1266,1275,18,1293,3
2021-07-01,Monterey,053,433212,43383,43212,1891,45103,492
2021-07-01,Napa,055,140530,10072,10045,40,10085,81
2021-07-01,Nevada,057,99092,5012,4966,195,5161,72
2021-07-01,Orange,059,3164182,257274,255823,11622,267445,5126
2021-07-01,Placer,061,380077,24001,23764,1573,25337,299
2021-07-01,Plumas,063,18699,724,707,12,719,4
2021-07-01,Riverside,065,2383286,296332,293260,14243,307503,4536
2021-07-01,Sacramento,067,1510023,109099,108257,1865,110122,1676
2021-07-01,San Benito,069,59416,6134,6108,116,6224,63
2021-07-01,San Bernardino,071,2135413,295500,294294,9108,303402,5003
2021-07-01,San Diego,073,3302833,283888,282692,15514,298206,3780
2021-07-01,San Francisco,075,870044,37368,37107,1327,38434,558
2021-07-01,San Joaquin,077,732212,74403,73841,3681,77522,1409
2021-07-01,San Luis Obispo,079,281455,21582,21330,764,22094,256
2021-07-01,San Mateo,081,765935,42975,42691,495,43186,541
2021-07-01,Santa Barbara,083,443738,34692,34526,1153,35679,456
2021-07-01,Santa Clara,085,1922200,119797,118966,790,119756,2090
2021-07-01,Santa Cruz,087,273765,16364,16254,818,17072,208
2021-07-01,Shasta,089,179085,12645,12582,1653,14235,204
2021-07-01,Sierra,091,2930,63,60,12,72,0
2021-07-01,Siskiyou,093,43540,1977,1899,385,2284,29
2021-07-01,Solano,095,438530,33656,33486,580,34066,268
2021-07-01,Sonoma,097,501317,31191,31000,370,31370,316
2021-07-01,Stanislaus,099,539301,57243,57018,6063,63081,1018
2021-07-01,Sutter,101,95872,9668,9644,90,9734,114
2021-07-01,Tehama,103,63373,5163,5124,599,5723,63
2021-07-01,Trinity,105,12862,494,341,100,441,3
2021-07-01,Tulare,107,460477,50533,49789,9220,59009,853
2021-07-01,Tuolumne,109,53932,4078,4113,41,4154,64
2021-07-01,Ventura,111,848112,82047,81425,3077,84502,1033
2021-07-01,Yolo,113,214977,14209,14188,361,14549,213
2021-07-01,Yuba,115,75493,6251,6197,133,6330,51
2021-06-30,Alameda,001,1643700,89975,89597,2010,91607,1256
2021-06-30,Alpine,003,1148,88,89,0,89,0
2021-06-30,Amador,005,37829,3772,3756,33,3789,46
2021-06-30,Butte,007,227075,12840,12676,1858,14534,201
2021-06-30,Calaveras,009,45235,2216,2198,14,2212,55
2021-06-30,Colusa,011,21464,1972,1967,322,2289,15
2021-06-30,Contra Costa,013,1133247,71439,70869,1340,72209,818
2021-06-30,Del Norte,015,27424,1470,1435,13,1448,8
2021-06-30,El Dorado,017,186661,10526,10420,775,11195,113
2021-06-30,Fresno,019,978130,103635,102490,8828,111318,1727
2021-06-30,Glenn,021,27897,2456,2440,574,3014,20
2021-06-30,Humboldt,023,135768,4548,4522,50,4572,49
2021-06-30,Imperial,025,180216,28828,28651,2787,31438,739
2021-06-30,Inyo,027,18085,1415,1409,12,1421,35
2021-06-30,Kern,029,883053,98064,97267,11210,108477,1348
2021-06-30,Kings,031,150075,23325,23038,1116,24154,245
2021-06-30,Lake,033,64148,3643,3601,13,3614,56
2021-06-30,Lassen,035,31185,5298,5269,117,5386,20
2021-06-30,Los Angeles,037,10098052,1214045,1208246,42361,1250607,24499
2021-06-30,Madera,039,155013,16838,16688,953,17641,240
2021-06-30,Marin,041,260295,14265,14133,266,14399,232
2021-06-30,Mariposa,043,17540,441,441,11,452,5
2021-06-30,Mendocino,045,87422,4210,4115,84,4199,49
2021-06-30,Merced,047,269075,31304,31286,1070,32356,469
2021-06-30,Modoc,049,8938,420,410,149,559,4
2021-06-30,Mono,051,14174,1266,1275,18,1293,3
2021-06-30,Monterey,053,433212,43378,43209,1889,45098,492
2021-06-30,Napa,055,140530,10064,10039,40,10079,81
2021-06-30,Nevada,057,99092,5001,4958,195,5153,72
2021-06-30,Orange,059,3164182,257147,255764,11611,267375,5125
2021-06-30,Placer,061,380077,23977,23721,1570,25291,299
2021-06-30,Plumas,063,18699,724,705,12,717,4
2021-06-30,Riverside,065,2383286,296218,293280,14233,307513,4535
2021-06-30,Sacramento,067,1510023,108960,108137,1861,109998,1676
2021-06-30,San Benito,069,59416,6130,6105,116,6221,63
2021-06-30,San Bernardino,071,2135413,295341,294211,9103,303314,4975
2021-06-30,San Diego,073,3302833,283752,282583,15486,298069,3780
2021-06-30,San Francisco,075,870044,37319,37065,1322,38387,558
2021-06-30,San Joaquin,077,732212,74341,73777,3680,77457,1409
2021-06-30,San Luis Obispo,079,281455,21569,21326,763,22089,256
2021-06-30,San Mateo,081,765935,42938,42599,494,43093,537
2021-06-30,Santa Barbara,083,443738,34676,34521,1153,35674,456
2021-06-30,Santa Clara,085,1922200,119750,118930,787,119717,2090
2021-06-30,Santa Cruz,087,273765,16358,16250,818,17068,208
2021-06-30,Shasta,089,179085,12639,12564,1653,14217,204
2021-06-30,Sierra,091,2930,63,60,12,72,0
2021-06-30,Siskiyou,093,43540,1975,1900,382,2282,29
2021-06-30,Solano,095,438530,33617,33453,578,34031,268
2021-06-30,Sonoma,097,501317,31161,30947,370,31317,316
2021-06-30,Stanislaus,099,539301,57226,56997,6062,63059,1018
2021-06-30,Sutter,101,95872,9658,9638,90,9728,114
2021-06-30,Tehama,103,63373,5161,5124,599,5723,63
2021-06-30,Trinity,105,12862,494,341,100,441,3
2021-06-30,Tulare,107,460477,50522,49764,9209,58973,853
2021-06-30,Tuolumne,109,53932,4075,4112,41,4153,64
2021-06-30,Ventura,111,848112,82004,81392,3072,84464,1032
2021-06-30,Yolo,113,214977,14203,14178,358,14536,213
2021-06-30,Yuba,115,75493,6244,6191,133,6324,51
2021-06-29,Alameda,001,1643700,89868,89519,2009,91528,1257
2021-06-29,Alpine,003,1148,88,89,0,89,0
2021-06-29,Amador,005,37829,3768,3754,33,3787,46
2021-06-29,Butte,007,227075,12832,12669,1858,14527,201
2021-06-29,Calaveras,009,45235,2210,2198,14,2212,55
2021-06-29,Colusa,011,21464,1970,1967,322,2289,15
2021-06-29,Contra Costa,013,1133247,71365,70775,1339,72114,817
2021-06-29,Del Norte,015,27424,1469,1435,13,1448,8
2021-06-29,El Dorado,017,186661,10513,10403,771,11174,113
2021-06-29,Fresno,019,978130,103602,102464,8825,111289,1725
2021-06-29,Glenn,021,27897,2455,2439,574,3013,20
2021-06-29,Humboldt,023,135768,4544,4514,49,4563,49
2021-06-29,Imperial,025,180216,28819,28645,2786,31431,737
2021-06-29,Inyo,027,18085,1415,1408,12,1420,35
2021-06-29,Kern,029,883053,98043,97173,11204,108377,1347
2021-06-29,Kings,031,150075,23316,23035,1115,24150,245
2021-06-29,Lake,033,64148,3637,3594,13,3607,56
2021-06-29,Lassen,035,31185,5291,5268,117,5385,20
2021-06-29,Los Angeles,037,10098052,1213436,1207895,42330,1250225,24498
2021-06-29,Madera,039,155013,16834,16680,952,17632,240
2021-06-29,Marin,041,260295,14253,14127,266,14393,232
2021-06-29,Mariposa,043,17540,441,441,11,452,5
2021-06-29,Mendocino,045,87422,4206,4107,83,4190,49
2021-06-29,Merced,047,269075,31292,31277,1070,32347,469
2021-06-29,Modoc,049,8938,419,408,149,557,3
2021-06-29,Mono,051,14174,1266,1275,18,1293,3
2021-06-29,Monterey,053,433212,43368,43196,1887,45083,471
2021-06-29,Napa,055,140530,10058,10033,40,10073,81
2021-06-29,Nevada,057,99092,4994,4952,195,5147,72
2021-06-29,Orange,059,3164182,257047,255686,11596,267282,5124
2021-06-29,Placer,061,380077,23957,23693,1568,25261,299
2021-06-29,Plumas,063,18699,724,704,12,716,4
2021-06-29,Riverside,065,2383286,296119,292962,14226,307188,4524
2021-06-29,Sacramento,067,1510023,108808,108067,1858,109925,1677
2021-06-29,San Benito,069,59416,6119,6099,116,6215,63
2021-06-29,San Bernardino,071,2135413,295229,294118,9101,303219,4940
2021-06-29,San Diego,073,3302833,283596,282499,15459,297958,3780
2021-06-29,San Francisco,075,870044,37281,37041,1319,38360,558
2021-06-29,San Joaquin,077,732212,74293,73724,3677,77401,1409
2021-06-29,San Luis Obispo,079,281455,21559,21324,762,22086,256
2021-06-29,San Mateo,081,765935,42904,42540,494,43034,540
2021-06-29,Santa Barbara,083,443738,34666,34507,1152,35659,455
2021-06-29,Santa Clara,085,1922200,119696,118893,786,119679,2090
2021-06-29,Santa Cruz,087,273765,16352,16249,818,17067,208
2021-06-29,Shasta,089,179085,12627,12564,1652,14216,204
2021-06-29,Sierra,091,2930,63,59,12,71,0
2021-06-29,Siskiyou,093,43540,1972,1897,378,2275,29
2021-06-29,Solano,095,438530,33584,33440,576,34016,268
2021-06-29,Sonoma,097,501317,31119,30950,368,31318,316
2021-06-29,Stanislaus,099,539301,57205,56980,6055,63035,1018
2021-06-29,Sutter,101,95872,9647,9634,90,9724,114
2021-06-29,Tehama,103,63373,5161,5124,599,5723,63
2021-06-29,Trinity,105,12862,494,341,100,441,3
2021-06-29,Tulare,107,460477,50509,49751,9204,58955,852
2021-06-29,Tuolumne,109,53932,4073,4111,41,4152,64
2021-06-29,Ventura,111,848112,81966,81363,3066,84429,1032
2021-06-29,Yolo,113,214977,14191,14171,357,14528,213
2021-06-29,Yuba,115,75493,6234,6188,133,6321,51
2021-06-28,Alameda,001,1643700,89775,89638,2006,91644,1259
2021-06-28,Alpine,003,1148,88,89,0,89,0
2021-06-28,Amador,005,37829,3767,3753,33,3786,46
2021-06-28,Butte,007,227075,12823,12697,1856,14553,198
2021-06-28,Calaveras,009,45235,2207,2203,14,2217,55
2021-06-28,Colusa,011,21464,1968,1974,322,2296,15
2021-06-28,Contra Costa,013,1133247,71291,70807,1337,72144,816
2021-06-28,Del Norte,015,27424,1469,1436,13,1449,8
2021-06-28,El Dorado,017,186661,10503,10422,767,11189,115
2021-06-28,Fresno,019,978130,103571,103121,8823,111944,1727
2021-06-28,Glenn,021,27897,2455,2439,574,3013,20
2021-06-28,Humboldt,023,135768,4537,4520,48,4568,49
2021-06-28,Imperial,025,180216,28811,28981,2785,31766,741
2021-06-28,Inyo,027,18085,1412,1407,12,1419,35
2021-06-28,Kern,029,883053,98024,97252,11199,108451,1348
2021-06-28,Kings,031,150075,23310,23134,1115,24249,246
2021-06-28,Lake,033,64148,3629,3591,13,3604,56
2021-06-28,Lassen,035,31185,5289,5268,117,5385,20
2021-06-28,Los Angeles,037,10098052,1212917,1207714,42294,1250008,24496
2021-06-28,Madera,039,155013,16823,16683,951,17634,240
2021-06-28,Marin,041,260295,14238,14186,266,14452,232
2021-06-28,Mariposa,043,17540,441,440,11,451,5
2021-06-28,Mendocino,045,87422,4197,4102,82,4184,49
2021-06-28,Merced,047,269075,31280,31277,1070,32347,469
2021-06-28,Modoc,049,8938,419,411,148,559,3
2021-06-28,Mono,051,14174,1266,1276,18,1294,3
2021-06-28,Monterey,053,433212,43364,43202,1886,45088,462
2021-06-28,Napa,055,140530,10049,10050,39,10089,81
2021-06-28,Nevada,057,99092,4990,4951,195,5146,72
2021-06-28,Orange,059,3164182,256957,255755,11582,267337,5123
2021-06-28,Placer,061,380077,23937,23756,1564,25320,299
2021-06-28,Plumas,063,18699,722,704,12,716,4
2021-06-28,Riverside,065,2383286,295993,292647,14213,306860,4507
2021-06-28,Sacramento,067,1510023,108676,108342,1853,110195,1675
2021-06-28,San Benito,069,59416,6117,6101,116,6217,63
2021-06-28,San Bernardino,071,2135413,295128,294151,9096,303247,4928
2021-06-28,San Diego,073,3302833,283432,282417,15430,297847,3780
2021-06-28,San Francisco,075,870044,37245,37372,1317,38689,559
2021-06-28,San Joaquin,077,732212,74246,73973,3673,77646,1411
2021-06-28,San Luis Obispo,079,281455,21555,21340,761,22101,256
2021-06-28,San Mateo,081,765935,42870,42927,493,43420,540
2021-06-28,Santa Barbara,083,443738,34659,34534,1150,35684,455
2021-06-28,Santa Clara,085,1922200,119632,120377,785,121162,2103
2021-06-28,Santa Cruz,087,273765,16347,16245,818,17063,208
2021-06-28,Shasta,089,179085,12623,12642,1650,14292,203
2021-06-28,Sierra,091,2930,63,58,12,70,0
2021-06-28,Siskiyou,093,43540,1971,1896,378,2274,29
2021-06-28,Solano,095,438530,33548,33524,574,34098,267
2021-06-28,Sonoma,097,501317,31082,31137,367,31504,315
2021-06-28,Stanislaus,099,539301,57187,57047,6051,63098,1018
2021-06-28,Sutter,101,95872,9643,9682,90,9772,114
2021-06-28,Tehama,103,63373,5159,5122,599,5721,63
2021-06-28,Trinity,105,12862,494,341,100,441,3
2021-06-28,Tulare,107,460477,50499,49751,9200,58951,850
2021-06-28,Tuolumne,109,53932,4066,4121,41,4162,64
2021-06-28,Ventura,111,848112,81909,81393,3061,84454,1032
2021-06-28,Yolo,113,214977,14182,14199,354,14553,213
2021-06-28,Yuba,115,75493,6229,6207,133,6340,51
2021-06-27,Alameda,001,1643700,89689,89611,2001,91612,1259
2021-06-27,Alpine,003,1148,88,89,0,89,0
2021-06-27,Amador,005,37829,3766,3752,33,3785,46
2021-06-27,Butte,007,227075,12814,12696,1855,14551,198
2021-06-27,Calaveras,009,45235,2206,2203,14,2217,55
2021-06-27,Colusa,011,21464,1968,1974,322,2296,15
2021-06-27,Contra Costa,013,1133247,71205,70762,1333,72095,816
2021-06-27,Del Norte,015,27424,1466,1436,13,1449,8
2021-06-27,El Dorado,017,186661,10491,10418,764,11182,115
2021-06-27,Fresno,019,978130,103542,103110,8821,111931,1727
2021-06-27,Glenn,021,27897,2454,2439,573,3012,20
2021-06-27,Humboldt,023,135768,4525,4513,45,4558,49
2021-06-27,Imperial,025,180216,28797,28987,2785,31772,741
2021-06-27,Inyo,027,18085,1412,1407,12,1419,35
2021-06-27,Kern,029,883053,97998,97249,11192,108441,1348
2021-06-27,Kings,031,150075,23300,23132,1115,24247,246
2021-06-27,Lake,033,64148,3622,3581,13,3594,56
2021-06-27,Lassen,035,31185,5288,5265,117,5382,20
2021-06-27,Los Angeles,037,10098052,1212372,1207461,42253,1249714,24493
2021-06-27,Madera,039,155013,16815,16680,951,17631,240
2021-06-27,Marin,041,260295,14229,14182,266,14448,232
2021-06-27,Mariposa,043,17540,441,440,11,451,5
2021-06-27,Mendocino,045,87422,4190,4100,82,4182,49
2021-06-27,Merced,047,269075,31268,31266,1070,32336,469
2021-06-27,Modoc,049,8938,419,411,148,559,3
2021-06-27,Mono,051,14174,1266,1279,18,1297,3
2021-06-27,Monterey,053,433212,43351,43199,1886,45085,462
2021-06-27,Napa,055,140530,10043,10046,39,10085,81
2021-06-27,Nevada,057,99092,4984,4946,195,5141,72
2021-06-27,Orange,059,3164182,256843,255710,11571,267281,5123
2021-06-27,Placer,061,380077,23904,23731,1561,25292,299
2021-06-27,Plumas,063,18699,722,704,12,716,4
2021-06-27,Riverside,065,2383286,295891,292641,14206,306847,4507
2021-06-27,Sacramento,067,1510023,108541,108279,1849,110128,1675
2021-06-27,San Benito,069,59416,6111,6101,116,6217,63
2021-06-27,San Bernardino,071,2135413,295015,294115,9094,303209,4927
2021-06-27,San Diego,073,3302833,283292,282359,15404,297763,3780
2021-06-27,San Francisco,075,870044,37208,37360,1316,38676,559
2021-06-27,San Joaquin,077,732212,74210,73960,3671,77631,1411
2021-06-27,San Luis Obispo,079,281455,21548,21340,760,22100,256
2021-06-27,San Mateo,081,765935,42841,42925,490,43415,539
2021-06-27,Santa Barbara,083,443738,34645,34533,1148,35681,455
2021-06-27,Santa Clara,085,1922200,119581,120352,784,121136,2103
2021-06-27,Santa Cruz,087,273765,16338,16241,818,17059,208
2021-06-27,Shasta,089,179085,12617,12640,1649,14289,203
2021-06-27,Sierra,091,2930,63,58,12,70,0
2021-06-27,Siskiyou,093,43540,1969,1896,377,2273,29
2021-06-27,Solano,095,438530,33520,33516,574,34090,267
2021-06-27,Sonoma,097,501317,31044,31129,367,31496,315
2021-06-27,Stanislaus,099,539301,57147,57021,6048,63069,1018
2021-06-27,Sutter,101,95872,9637,9678,90,9768,114
2021-06-27,Tehama,103,63373,5155,5122,599,5721,63
2021-06-27,Trinity,105,12862,494,341,99,440,3
2021-06-27,Tulare,107,460477,50486,49749,9193,58942,850
2021-06-27,Tuolumne,109,53932,4064,4121,41,4162,64
2021-06-27,Ventura,111,848112,81875,81361,3052,84413,1032
2021-06-27,Yolo,113,214977,14167,14194,350,14544,213
2021-06-27,Yuba,115,75493,6223,6205,133,6338,51
2021-06-26,Alameda,001,1643700,89632,89560,1999,91559,1259
2021-06-26,Alpine,003,1148,88,89,0,89,0
2021-06-26,Amador,005,37829,3766,3748,33,3781,46
2021-06-26,Butte,007,227075,12810,12693,1852,14545,198
2021-06-26,Calaveras,009,45235,2204,2202,14,2216,55
2021-06-26,Colusa,011,21464,1968,1973,322,2295,15
2021-06-26,Contra Costa,013,1133247,71162,70712,1332,72044,816
2021-06-26,Del Norte,015,27424,1465,1432,13,1445,8
2021-06-26,El Dorado,017,186661,10483,10414,763,11177,115
2021-06-26,Fresno,019,978130,103522,103091,8819,111910,1727
2021-06-26,Glenn,021,27897,2452,2441,573,3014,20
2021-06-26,Humboldt,023,135768,4522,4509,45,4554,49
2021-06-26,Imperial,025,180216,28793,28970,2785,31755,741
2021-06-26,Inyo,027,18085,1412,1407,12,1419,35
2021-06-26,Kern,029,883053,97972,97239,11183,108422,1348
2021-06-26,Kings,031,150075,23296,23128,1114,24242,246
2021-06-26,Lake,033,64148,3611,3576,13,3589,56
2021-06-26,Lassen,035,31185,5285,5263,117,5380,20
2021-06-26,Los Angeles,037,10098052,1212066,1207198,42220,1249418,24490
2021-06-26,Madera,039,155013,16808,16679,950,17629,240
2021-06-26,Marin,041,260295,14220,14180,266,14446,232
2021-06-26,Mariposa,043,17540,441,440,11,451,5
2021-06-26,Mendocino,045,87422,4188,4096,82,4178,49
2021-06-26,Merced,047,269075,31262,31259,1069,32328,469
2021-06-26,Modoc,049,8938,419,411,148,559,3
2021-06-26,Mono,051,14174,1266,1279,18,1297,3
2021-06-26,Monterey,053,433212,43348,43192,1886,45078,462
2021-06-26,Napa,055,140530,10037,10043,39,10082,81
2021-06-26,Nevada,057,99092,4979,4939,195,5134,72
2021-06-26,Orange,059,3164182,256764,255640,11564,267204,5123
2021-06-26,Placer,061,380077,23890,23702,1559,25261,299
2021-06-26,Plumas,063,18699,722,704,12,716,4
2021-06-26,Riverside,065,2383286,295833,292480,14200,306680,4505
2021-06-26,Sacramento,067,1510023,108470,108179,1847,110026,1675
2021-06-26,San Benito,069,59416,6107,6100,116,6216,63
2021-06-26,San Bernardino,071,2135413,294920,294034,9089,303123,4928
2021-06-26,San Diego,073,3302833,283207,282263,15386,297649,3780
2021-06-26,San Francisco,075,870044,37176,37348,1315,38663,559
2021-06-26,San Joaquin,077,732212,74181,73928,3670,77598,1411
2021-06-26,San Luis Obispo,079,281455,21547,21330,759,22089,256
2021-06-26,San Mateo,081,765935,42821,42898,490,43388,539
2021-06-26,Santa Barbara,083,443738,34636,34525,1148,35673,455
2021-06-26,Santa Clara,085,1922200,119548,120321,784,121105,2103
2021-06-26,Santa Cruz,087,273765,16335,16239,818,17057,208
2021-06-26,Shasta,089,179085,12613,12635,1645,14280,203
2021-06-26,Sierra,091,2930,63,58,12,70,0
2021-06-26,Siskiyou,093,43540,1968,1896,376,2272,29
2021-06-26,Solano,095,438530,33502,33489,572,34061,267
2021-06-26,Sonoma,097,501317,31018,31088,367,31455,315
2021-06-26,Stanislaus,099,539301,57131,57006,6046,63052,1018
2021-06-26,Sutter,101,95872,9636,9669,90,9759,114
2021-06-26,Tehama,103,63373,5155,5119,599,5718,63
2021-06-26,Trinity,105,12862,494,341,99,440,3
2021-06-26,Tulare,107,460477,50480,49745,9193,58938,850
2021-06-26,Tuolumne,109,53932,4064,4121,41,4162,64
2021-06-26,Ventura,111,848112,81851,81352,3051,84403,1032
2021-06-26,Yolo,113,214977,14159,14184,350,14534,213
2021-06-26,Yuba,115,75493,6220,6200,133,6333,51
2021-06-25,Alameda,001,1643700,89566,89453,1996,91449,1271
2021-06-25,Alpine,003,1148,88,89,0,89,0
2021-06-25,Amador,005,37829,3765,3746,33,3779,46
2021-06-25,Butte,007,227075,12805,12682,1849,14531,198
2021-06-25,Calaveras,009,45235,2203,2201,14,2215,55
2021-06-25,Colusa,011,21464,1968,1972,322,2294,15
2021-06-25,Contra Costa,013,1133247,71126,70659,1332,71991,815
2021-06-25,Del Norte,015,27424,1465,1426,13,1439,8
2021-06-25,El Dorado,017,186661,10475,10406,760,11166,115
2021-06-25,Fresno,019,978130,103504,103073,8815,111888,1727
2021-06-25,Glenn,021,27897,2452,2441,573,3014,20
2021-06-25,Humboldt,023,135768,4516,4503,43,4546,49
2021-06-25,Imperial,025,180216,28790,28968,2785,31753,740
2021-06-25,Inyo,027,18085,1411,1406,12,1418,35
2021-06-25,Kern,029,883053,97953,97182,11179,108361,1347
2021-06-25,Kings,031,150075,23290,23118,1114,24232,246
2021-06-25,Lake,033,64148,3605,3571,13,3584,56
2021-06-25,Lassen,035,31185,5284,5259,117,5376,20
2021-06-25,Los Angeles,037,10098052,1211785,1206909,42203,1249112,24483
2021-06-25,Madera,039,155013,16805,16670,950,17620,240
2021-06-25,Marin,041,260295,14217,14179,266,14445,232
2021-06-25,Mariposa,043,17540,441,440,11,451,5
2021-06-25,Mendocino,045,87422,4185,4089,82,4171,49
2021-06-25,Merced,047,269075,31254,31256,1069,32325,467
2021-06-25,Modoc,049,8938,419,411,148,559,3
2021-06-25,Mono,051,14174,1266,1279,18,1297,3
2021-06-25,Monterey,053,433212,43343,43184,1885,45069,462
2021-06-25,Napa,055,140530,10032,10037,39,10076,81
2021-06-25,Nevada,057,99092,4976,4932,195,5127,72
2021-06-25,Orange,059,3164182,256693,255574,11562,267136,5119
2021-06-25,Placer,061,380077,23871,23672,1558,25230,299
2021-06-25,Plumas,063,18699,722,702,11,713,4
2021-06-25,Riverside,065,2383286,295765,291663,14193,305856,4490
2021-06-25,Sacramento,067,1510023,108398,108034,1844,109878,1673
2021-06-25,San Benito,069,59416,6103,6098,116,6214,63
2021-06-25,San Bernardino,071,2135413,294865,293941,9087,303028,4911
2021-06-25,San Diego,073,3302833,283147,282157,15373,297530,3779
2021-06-25,San Francisco,075,870044,37153,37338,1314,38652,559
2021-06-25,San Joaquin,077,732212,74148,73860,3668,77528,1410
2021-06-25,San Luis Obispo,079,281455,21544,21325,758,22083,256
2021-06-25,San Mateo,081,765935,42803,42849,490,43339,537
2021-06-25,Santa Barbara,083,443738,34627,34518,1147,35665,454
2021-06-25,Santa Clara,085,1922200,119528,120272,784,121056,2103
2021-06-25,Santa Cruz,087,273765,16332,16230,816,17046,208
2021-06-25,Shasta,089,179085,12603,12633,1644,14277,202
2021-06-25,Sierra,091,2930,63,58,12,70,0
2021-06-25,Siskiyou,093,43540,1967,1894,376,2270,29
2021-06-25,Solano,095,438530,33482,33449,572,34021,267
2021-06-25,Sonoma,097,501317,30995,31043,367,31410,314
2021-06-25,Stanislaus,099,539301,57115,56973,6039,63012,1018
2021-06-25,Sutter,101,95872,9629,9664,90,9754,114
2021-06-25,Tehama,103,63373,5154,5119,599,5718,63
2021-06-25,Trinity,105,12862,494,338,99,437,3
2021-06-25,Tulare,107,460477,50473,49731,9190,58921,850
2021-06-25,Tuolumne,109,53932,4063,4121,41,4162,64
2021-06-25,Ventura,111,848112,81822,81342,3045,84387,1032
2021-06-25,Yolo,113,214977,14153,14172,350,14522,213
2021-06-25,Yuba,115,75493,6216,6195,133,6328,51
2021-06-24,Alameda,001,1643700,89495,89358,1993,91351,1268
2021-06-24,Alpine,003,1148,88,89,0,89,0
2021-06-24,Amador,005,37829,3761,3745,33,3778,46
2021-06-24,Butte,007,227075,12799,12673,1847,14520,198
2021-06-24,Calaveras,009,45235,2200,2202,14,2216,55
2021-06-24,Colusa,011,21464,1967,1972,322,2294,15
2021-06-24,Contra Costa,013,1133247,71067,70590,1332,71922,813
2021-06-24,Del Norte,015,27424,1464,1421,13,1434,8
2021-06-24,El Dorado,017,186661,10468,10402,760,11162,115
2021-06-24,Fresno,019,978130,103484,103061,8812,111873,1727
2021-06-24,Glenn,021,27897,2451,2439,573,3012,20
2021-06-24,Humboldt,023,135768,4511,4493,43,4536,49
2021-06-24,Imperial,025,180216,28787,28981,2785,31766,740
2021-06-24,Inyo,027,18085,1410,1406,12,1418,35
2021-06-24,Kern,029,883053,97934,97129,11166,108295,1346
2021-06-24,Kings,031,150075,23286,23114,1112,24226,246
2021-06-24,Lake,033,64148,3599,3571,13,3584,56
2021-06-24,Lassen,035,31185,5283,5258,117,5375,20
2021-06-24,Los Angeles,037,10098052,1211461,1206590,42180,1248770,24480
2021-06-24,Madera,039,155013,16794,16662,949,17611,240
2021-06-24,Marin,041,260295,14213,14180,266,14446,232
2021-06-24,Mariposa,043,17540,441,440,11,451,5
2021-06-24,Mendocino,045,87422,4177,4085,82,4167,49
2021-06-24,Merced,047,269075,31244,31248,1068,32316,466
2021-06-24,Modoc,049,8938,419,411,148,559,3
2021-06-24,Mono,051,14174,1266,1276,18,1294,3
2021-06-24,Monterey,053,433212,43336,43180,1885,45065,451
2021-06-24,Napa,055,140530,10030,10036,39,10075,80
2021-06-24,Nevada,057,99092,4974,4927,195,5122,72
2021-06-24,Orange,059,3164182,256629,255520,11554,267074,5117
2021-06-24,Placer,061,380077,23846,23659,1556,25215,299
2021-06-24,Plumas,063,18699,721,702,11,713,4
2021-06-24,Riverside,065,2383286,295685,291067,14182,305249,4473
2021-06-24,Sacramento,067,1510023,108310,107965,1842,109807,1672
2021-06-24,San Benito,069,59416,6100,6098,116,6214,63
2021-06-24,San Bernardino,071,2135413,294796,293895,9082,302977,4898
2021-06-24,San Diego,073,3302833,283043,282053,15360,297413,3778
2021-06-24,San Francisco,075,870044,37131,37320,1312,38632,559
2021-06-24,San Joaquin,077,732212,74100,73814,3668,77482,1408
2021-06-24,San Luis Obispo,079,281455,21538,21326,758,22084,256
2021-06-24,San Mateo,081,765935,42777,42814,489,43303,542
2021-06-24,Santa Barbara,083,443738,34621,34512,1146,35658,454
2021-06-24,Santa Clara,085,1922200,119497,120274,783,121057,2103
2021-06-24,Santa Cruz,087,273765,16331,16227,816,17043,208
2021-06-24,Shasta,089,179085,12598,12629,1640,14269,202
2021-06-24,Sierra,091,2930,63,58,12,70,0
2021-06-24,Siskiyou,093,43540,1967,1892,376,2268,28
2021-06-24,Solano,095,438530,33459,33432,570,34002,267
2021-06-24,Sonoma,097,501317,30966,31020,367,31387,314
2021-06-24,Stanislaus,099,539301,57089,56946,6039,62985,1018
2021-06-24,Sutter,101,95872,9622,9660,90,9750,113
2021-06-24,Tehama,103,63373,5151,5115,599,5714,63
2021-06-24,Trinity,105,12862,493,338,99,437,3
2021-06-24,Tulare,107,460477,50462,49730,9188,58918,850
2021-06-24,Tuolumne,109,53932,4061,4120,41,4161,64
2021-06-24,Ventura,111,848112,81794,81332,3044,84376,1032
2021-06-24,Yolo,113,214977,14144,14169,347,14516,213
2021-06-24,Yuba,115,75493,6211,6195,133,6328,51
2021-06-23,Alameda,001,1643700,89422,89338,1992,91330,1266
2021-06-23,Alpine,003,1148,88,88,0,88,0
2021-06-23,Amador,005,37829,3759,3743,33,3776,46
2021-06-23,Butte,007,227075,12792,12666,1847,14513,198
2021-06-23,Calaveras,009,45235,2199,2199,14,2213,55
2021-06-23,Colusa,011,21464,1966,1972,322,2294,15
2021-06-23,Contra Costa,013,1133247,71002,70526,1331,71857,813
2021-06-23,Del Norte,015,27424,1460,1418,13,1431,8
2021-06-23,El Dorado,017,186661,10459,10395,757,11152,115
2021-06-23,Fresno,019,978130,103455,103020,8810,111830,1724
2021-06-23,Glenn,021,27897,2451,2437,572,3009,20
2021-06-23,Humboldt,023,135768,4502,4490,43,4533,48
2021-06-23,Imperial,025,180216,28780,28908,2785,31693,740
2021-06-23,Inyo,027,18085,1410,1406,12,1418,35
2021-06-23,Kern,029,883053,97906,97078,11153,108231,1345
2021-06-23,Kings,031,150075,23279,23105,1110,24215,245
2021-06-23,Lake,033,64148,3590,3566,13,3579,53
2021-06-23,Lassen,035,31185,5280,5257,117,5374,20
2021-06-23,Los Angeles,037,10098052,1211124,1206358,42170,1248528,24472
2021-06-23,Madera,039,155013,16787,16660,949,17609,240
2021-06-23,Marin,041,260295,14207,14177,266,14443,230
2021-06-23,Mariposa,043,17540,441,439,11,450,5
2021-06-23,Mendocino,045,87422,4173,4078,82,4160,49
2021-06-23,Merced,047,269075,31235,31260,1068,32328,465
2021-06-23,Modoc,049,8938,417,407,148,555,3
2021-06-23,Mono,051,14174,1266,1279,18,1297,3
2021-06-23,Monterey,053,433212,43327,43166,1885,45051,439
2021-06-23,Napa,055,140530,10021,10032,39,10071,80
2021-06-23,Nevada,057,99092,4971,4924,195,5119,72
2021-06-23,Orange,059,3164182,256563,255479,11546,267025,5116
2021-06-23,Placer,061,380077,23817,23630,1551,25181,299
2021-06-23,Plumas,063,18699,720,701,11,712,4
2021-06-23,Riverside,065,2383286,295602,290343,14180,304523,4462
2021-06-23,Sacramento,067,1510023,108218,107868,1837,109705,1671
2021-06-23,San Benito,069,59416,6096,6097,116,6213,63
2021-06-23,San Bernardino,071,2135413,294717,293816,9077,302893,4886
2021-06-23,San Diego,073,3302833,282943,281937,15339,297276,3777
2021-06-23,San Francisco,075,870044,37107,37304,1310,38614,559
2021-06-23,San Joaquin,077,732212,74061,73764,3666,77430,1405
2021-06-23,San Luis Obispo,079,281455,21534,21323,757,22080,257
2021-06-23,San Mateo,081,765935,42761,42756,489,43245,542
2021-06-23,Santa Barbara,083,443738,34611,34505,1146,35651,454
2021-06-23,Santa Clara,085,1922200,119468,120233,783,121016,2098
2021-06-23,Santa Cruz,087,273765,16327,16215,816,17031,209
2021-06-23,Shasta,089,179085,12591,12604,1638,14242,202
2021-06-23,Sierra,091,2930,63,57,12,69,0
2021-06-23,Siskiyou,093,43540,1965,1892,376,2268,28
2021-06-23,Solano,095,438530,33415,33408,570,33978,267
2021-06-23,Sonoma,097,501317,30926,30959,365,31324,314
2021-06-23,Stanislaus,099,539301,57059,56926,6038,62964,1017
2021-06-23,Sutter,101,95872,9616,9653,90,9743,113
2021-06-23,Tehama,103,63373,5151,5119,598,5717,63
2021-06-23,Trinity,105,12862,493,338,99,437,3
2021-06-23,Tulare,107,460477,50455,49711,9184,58895,850
2021-06-23,Tuolumne,109,53932,4058,4120,41,4161,64
2021-06-23,Ventura,111,848112,81771,81312,3041,84353,1032
2021-06-23,Yolo,113,214977,14134,14161,347,14508,212
2021-06-23,Yuba,115,75493,6208,6190,133,6323,51
2021-06-22,Alameda,001,1643700,89355,89308,1992,91300,1263
2021-06-22,Alpine,003,1148,88,88,0,88,0
2021-06-22,Amador,005,37829,3756,3743,33,3776,46
2021-06-22,Butte,007,227075,12788,12662,1844,14506,198
2021-06-22,Calaveras,009,45235,2198,2198,14,2212,55
2021-06-22,Colusa,011,21464,1965,1971,322,2293,15
2021-06-22,Contra Costa,013,1133247,70946,70480,1330,71810,813
2021-06-22,Del Norte,015,27424,1457,1417,13,1430,8
2021-06-22,El Dorado,017,186661,10454,10380,756,11136,113
2021-06-22,Fresno,019,978130,103436,102996,8806,111802,1724
2021-06-22,Glenn,021,27897,2450,2435,570,3005,19
2021-06-22,Humboldt,023,135768,4492,4483,43,4526,42
2021-06-22,Imperial,025,180216,28775,28880,2785,31665,740
2021-06-22,Inyo,027,18085,1410,1405,12,1417,35
2021-06-22,Kern,029,883053,97893,97013,11149,108162,1342
2021-06-22,Kings,031,150075,23271,23098,1109,24207,245
2021-06-22,Lake,033,64148,3588,3564,13,3577,45
2021-06-22,Lassen,035,31185,5275,5254,117,5371,20
2021-06-22,Los Angeles,037,10098052,1210810,1206146,42158,1248304,24461
2021-06-22,Madera,039,155013,16782,16652,949,17601,240
2021-06-22,Marin,041,260295,14205,14174,266,14440,230
2021-06-22,Mariposa,043,17540,441,439,11,450,5
2021-06-22,Mendocino,045,87422,4167,4072,82,4154,49
2021-06-22,Merced,047,269075,31224,31267,1068,32335,464
2021-06-22,Modoc,049,8938,415,405,147,552,3
2021-06-22,Mono,051,14174,1266,1277,18,1295,3
2021-06-22,Monterey,053,433212,43324,43162,1884,45046,427
2021-06-22,Napa,055,140530,10017,10029,39,10068,80
2021-06-22,Nevada,057,99092,4965,4923,195,5118,72
2021-06-22,Orange,059,3164182,256494,255452,11535,266987,5114
2021-06-22,Placer,061,380077,23795,23603,1551,25154,299
2021-06-22,Plumas,063,18699,720,697,11,708,4
2021-06-22,Riverside,065,2383286,295541,289839,14176,304015,4456
2021-06-22,Sacramento,067,1510023,108117,107801,1832,109633,1670
2021-06-22,San Benito,069,59416,6095,6098,116,6214,63
2021-06-22,San Bernardino,071,2135413,294642,293770,9071,302841,4873
2021-06-22,San Diego,073,3302833,282839,281867,15316,297183,3771
2021-06-22,San Francisco,075,870044,37093,37287,1310,38597,556
2021-06-22,San Joaquin,077,732212,74031,73723,3664,77387,1405
2021-06-22,San Luis Obispo,079,281455,21531,21321,756,22077,257
2021-06-22,San Mateo,081,765935,42747,42725,484,43209,542
2021-06-22,Santa Barbara,083,443738,34600,34500,1145,35645,454
2021-06-22,Santa Clara,085,1922200,119436,120194,783,120977,2095
2021-06-22,Santa Cruz,087,273765,16322,16218,816,17034,209
2021-06-22,Shasta,089,179085,12580,12616,1635,14251,202
2021-06-22,Sierra,091,2930,62,57,12,69,0
2021-06-22,Siskiyou,093,43540,1965,1892,376,2268,28
2021-06-22,Solano,095,438530,33397,33397,569,33966,267
2021-06-22,Sonoma,097,501317,30886,30933,365,31298,314
2021-06-22,Stanislaus,099,539301,57043,56915,6036,62951,1017
2021-06-22,Sutter,101,95872,9609,9649,90,9739,113
2021-06-22,Tehama,103,63373,5149,5118,597,5715,63
2021-06-22,Trinity,105,12862,491,337,99,436,3
2021-06-22,Tulare,107,460477,50446,49706,9179,58885,850
2021-06-22,Tuolumne,109,53932,4056,4119,41,4160,64
2021-06-22,Ventura,111,848112,81757,81300,3040,84340,1032
2021-06-22,Yolo,113,214977,14129,14157,345,14502,212
2021-06-22,Yuba,115,75493,6204,6181,133,6314,51
2021-06-21,Alameda,001,1643700,89298,89281,1991,91272,1262
2021-06-21,Alpine,003,1148,88,88,0,88,0
2021-06-21,Amador,005,37829,3750,3742,33,3775,46
2021-06-21,Butte,007,227075,12782,12668,1842,14510,195
2021-06-21,Calaveras,009,45235,2196,2194,14,2208,55
2021-06-21,Colusa,011,21464,1964,1970,321,2291,15
2021-06-21,Contra Costa,013,1133247,70875,70439,1328,71767,813
2021-06-21,Del Norte,015,27424,1453,1416,13,1429,8
2021-06-21,El Dorado,017,186661,10448,10375,755,11130,113
2021-06-21,Fresno,019,978130,103416,102971,8803,111774,1724
2021-06-21,Glenn,021,27897,2449,2433,570,3003,19
2021-06-21,Humboldt,023,135768,4483,4478,42,4520,42
2021-06-21,Imperial,025,180216,28771,28855,2785,31640,740
2021-06-21,Inyo,027,18085,1409,1405,12,1417,35
2021-06-21,Kern,029,883053,97864,96995,11140,108135,1342
2021-06-21,Kings,031,150075,23264,23091,1106,24197,245
2021-06-21,Lake,033,64148,3582,3563,13,3576,45
2021-06-21,Lassen,035,31185,5273,5233,117,5350,19
2021-06-21,Los Angeles,037,10098052,1210518,1205994,42137,1248131,24459
2021-06-21,Madera,039,155013,16773,16647,949,17596,240
2021-06-21,Marin,041,260295,14201,14173,266,14439,230
2021-06-21,Mariposa,043,17540,441,439,11,450,5
2021-06-21,Mendocino,045,87422,4164,4085,82,4167,49
2021-06-21,Merced,047,269075,31214,31264,1067,32331,465
2021-06-21,Modoc,049,8938,415,405,147,552,3
2021-06-21,Mono,051,14174,1266,1277,18,1295,3
2021-06-21,Monterey,053,433212,43321,43157,1884,45041,427
2021-06-21,Napa,055,140530,10012,10028,39,10067,80
2021-06-21,Nevada,057,99092,4961,4921,195,5116,72
2021-06-21,Orange,059,3164182,256421,255400,11528,266928,5113
2021-06-21,Placer,061,380077,23771,23577,1551,25128,298
2021-06-21,Plumas,063,18699,718,697,11,708,4
2021-06-21,Riverside,065,2383286,295465,289797,14171,303968,4456
2021-06-21,Sacramento,067,1510023,108005,107757,1831,109588,1669
2021-06-21,San Benito,069,59416,6091,6098,116,6214,63
2021-06-21,San Bernardino,071,2135413,294555,293736,9067,302803,4850
2021-06-21,San Diego,073,3302833,282734,281811,15296,297107,3771
2021-06-21,San Francisco,075,870044,37077,37275,1309,38584,556
2021-06-21,San Joaquin,077,732212,73990,73687,3663,77350,1405
2021-06-21,San Luis Obispo,079,281455,21522,21316,756,22072,257
2021-06-21,San Mateo,081,765935,42731,42685,483,43168,542
2021-06-21,Santa Barbara,083,443738,34595,34492,1145,35637,455
2021-06-21,Santa Clara,085,1922200,119403,120192,782,120974,2093
2021-06-21,Santa Cruz,087,273765,16320,16212,816,17028,208
2021-06-21,Shasta,089,179085,12567,12617,1632,14249,201
2021-06-21,Sierra,091,2930,62,57,12,69,0
2021-06-21,Siskiyou,093,43540,1965,1892,376,2268,27
2021-06-21,Solano,095,438530,33374,33383,568,33951,266
2021-06-21,Sonoma,097,501317,30863,30912,365,31277,314
2021-06-21,Stanislaus,099,539301,57013,56891,6031,62922,1017
2021-06-21,Sutter,101,95872,9606,9649,90,9739,113
2021-06-21,Tehama,103,63373,5149,5115,596,5711,63
2021-06-21,Trinity,105,12862,491,337,99,436,3
2021-06-21,Tulare,107,460477,50435,49689,9175,58864,849
2021-06-21,Tuolumne,109,53932,4052,4119,41,4160,63
2021-06-21,Ventura,111,848112,81729,81291,3036,84327,1031
2021-06-21,Yolo,113,214977,14123,14165,345,14510,212
2021-06-21,Yuba,115,75493,6203,6172,133,6305,51
2021-06-20,Alameda,001,1643700,89233,89255,1990,91245,1263
2021-06-20,Alpine,003,1148,88,88,0,88,0
2021-06-20,Amador,005,37829,3747,3740,33,3773,46
2021-06-20,Butte,007,227075,12775,12668,1841,14509,194
2021-06-20,Calaveras,009,45235,2195,2193,14,2207,55
2021-06-20,Colusa,011,21464,1964,1970,321,2291,15
2021-06-20,Contra Costa,013,1133247,70818,70401,1326,71727,813
2021-06-20,Del Norte,015,27424,1449,1416,13,1429,8
2021-06-20,El Dorado,017,186661,10434,10372,752,11124,113
2021-06-20,Fresno,019,978130,103375,102947,8800,111747,1724
2021-06-20,Glenn,021,27897,2449,2434,570,3004,19
2021-06-20,Humboldt,023,135768,4477,4472,42,4514,42
2021-06-20,Imperial,025,180216,28762,28855,2785,31640,740
2021-06-20,Inyo,027,18085,1408,1405,12,1417,35
2021-06-20,Kern,029,883053,97843,96985,11129,108114,1342
2021-06-20,Kings,031,150075,23259,23088,1104,24192,245
2021-06-20,Lake,033,64148,3580,3563,13,3576,45
2021-06-20,Lassen,035,31185,5270,5230,117,5347,19
2021-06-20,Los Angeles,037,10098052,1210219,1205874,42129,1248003,24456
2021-06-20,Madera,039,155013,16765,16638,947,17585,240
2021-06-20,Marin,041,260295,14198,14166,266,14432,230
2021-06-20,Mariposa,043,17540,439,439,11,450,5
2021-06-20,Mendocino,045,87422,4157,4080,82,4162,49
2021-06-20,Merced,047,269075,31201,31265,1067,32332,465
2021-06-20,Modoc,049,8938,415,405,147,552,3
2021-06-20,Mono,051,14174,1266,1275,18,1293,3
2021-06-20,Monterey,053,433212,43312,43156,1883,45039,427
2021-06-20,Napa,055,140530,10005,10026,38,10064,80
2021-06-20,Nevada,057,99092,4954,4919,195,5114,72
2021-06-20,Orange,059,3164182,256357,255377,11517,266894,5113
2021-06-20,Placer,061,380077,23737,23562,1547,25109,298
2021-06-20,Plumas,063,18699,717,697,11,708,4
2021-06-20,Riverside,065,2383286,295386,289770,14160,303930,4456
2021-06-20,Sacramento,067,1510023,107894,107700,1828,109528,1669
2021-06-20,San Benito,069,59416,6091,6098,116,6214,63
2021-06-20,San Bernardino,071,2135413,294455,293713,9063,302776,4845
2021-06-20,San Diego,073,3302833,282628,281750,15274,297024,3771
2021-06-20,San Francisco,075,870044,37054,37269,1309,38578,556
2021-06-20,San Joaquin,077,732212,73945,73676,3654,77330,1405
2021-06-20,San Luis Obispo,079,281455,21520,21313,756,22069,257
2021-06-20,San Mateo,081,765935,42702,42681,483,43164,542
2021-06-20,Santa Barbara,083,443738,34586,34487,1145,35632,455
2021-06-20,Santa Clara,085,1922200,119368,120163,782,120945,2093
2021-06-20,Santa Cruz,087,273765,16314,16210,816,17026,208
2021-06-20,Shasta,089,179085,12562,12617,1630,14247,201
2021-06-20,Sierra,091,2930,62,57,12,69,0
2021-06-20,Siskiyou,093,43540,1964,1891,376,2267,27
2021-06-20,Solano,095,438530,33352,33361,566,33927,266
2021-06-20,Sonoma,097,501317,30816,30884,362,31246,314
2021-06-20,Stanislaus,099,539301,56982,56868,6030,62898,1017
2021-06-20,Sutter,101,95872,9603,9645,90,9735,113
2021-06-20,Tehama,103,63373,5145,5115,596,5711,63
2021-06-20,Trinity,105,12862,491,337,99,436,3
2021-06-20,Tulare,107,460477,50426,49685,9173,58858,849
2021-06-20,Tuolumne,109,53932,4049,4117,41,4158,63
2021-06-20,Ventura,111,848112,81713,81282,3034,84316,1031
2021-06-20,Yolo,113,214977,14116,14160,345,14505,212
2021-06-20,Yuba,115,75493,6196,6167,133,6300,51
2021-06-19,Alameda,001,1643700,89198,89202,1990,91192,1263
2021-06-19,Alpine,003,1148,88,88,0,88,0
2021-06-19,Amador,005,37829,3745,3739,33,3772,46
2021-06-19,Butte,007,227075,12771,12659,1841,14500,194
2021-06-19,Calaveras,009,45235,2195,2192,14,2206,55
2021-06-19,Colusa,011,21464,1964,1969,321,2290,15
2021-06-19,Contra Costa,013,1133247,70787,70334,1325,71659,813
2021-06-19,Del Norte,015,27424,1448,1416,13,1429,8
2021-06-19,El Dorado,017,186661,10433,10363,751,11114,113
2021-06-19,Fresno,019,978130,103362,102922,8797,111719,1724
2021-06-19,Glenn,021,27897,2448,2434,569,3003,19
2021-06-19,Humboldt,023,135768,4466,4463,42,4505,42
2021-06-19,Imperial,025,180216,28761,28813,2785,31598,740
2021-06-19,Inyo,027,18085,1408,1405,12,1417,35
2021-06-19,Kern,029,883053,97827,96966,11125,108091,1342
2021-06-19,Kings,031,150075,23256,23086,1104,24190,245
2021-06-19,Lake,033,64148,3576,3563,13,3576,45
2021-06-19,Lassen,035,31185,5269,5225,117,5342,19
2021-06-19,Los Angeles,037,10098052,1210019,1205602,42114,1247716,24454
2021-06-19,Madera,039,155013,16763,16632,947,17579,240
2021-06-19,Marin,041,260295,14190,14152,266,14418,230
2021-06-19,Mariposa,043,17540,439,439,11,450,5
2021-06-19,Mendocino,045,87422,4151,4077,82,4159,49
2021-06-19,Merced,047,269075,31199,31256,1067,32323,465
2021-06-19,Modoc,049,8938,414,402,147,549,3
2021-06-19,Mono,051,14174,1266,1275,18,1293,3
2021-06-19,Monterey,053,433212,43306,43153,1883,45036,427
2021-06-19,Napa,055,140530,10001,10025,38,10063,80
2021-06-19,Nevada,057,99092,4949,4910,195,5105,72
2021-06-19,Orange,059,3164182,256310,255329,11514,266843,5112
2021-06-19,Placer,061,380077,23721,23537,1544,25081,298
2021-06-19,Plumas,063,18699,716,697,11,708,4
2021-06-19,Riverside,065,2383286,295340,289720,14160,303880,4456
2021-06-19,Sacramento,067,1510023,107848,107631,1825,109456,1669
2021-06-19,San Benito,069,59416,6090,6098,116,6214,63
2021-06-19,San Bernardino,071,2135413,294411,293673,9060,302733,4844
2021-06-19,San Diego,073,3302833,282568,281682,15260,296942,3771
2021-06-19,San Francisco,075,870044,37041,37256,1309,38565,556
2021-06-19,San Joaquin,077,732212,73929,73652,3650,77302,1405
2021-06-19,San Luis Obispo,079,281455,21518,21308,756,22064,257
2021-06-19,San Mateo,081,765935,42684,42646,481,43127,542
2021-06-19,Santa Barbara,083,443738,34584,34472,1145,35617,455
2021-06-19,Santa Clara,085,1922200,119345,120110,781,120891,2093
2021-06-19,Santa Cruz,087,273765,16309,16206,816,17022,208
2021-06-19,Shasta,089,179085,12560,12615,1629,14244,201
2021-06-19,Sierra,091,2930,62,57,12,69,0
2021-06-19,Siskiyou,093,43540,1964,1891,375,2266,27
2021-06-19,Solano,095,438530,33342,33341,565,33906,266
2021-06-19,Sonoma,097,501317,30775,30841,361,31202,314
2021-06-19,Stanislaus,099,539301,56963,56847,6027,62874,1017
2021-06-19,Sutter,101,95872,9600,9645,90,9735,113
2021-06-19,Tehama,103,63373,5144,5115,596,5711,63
2021-06-19,Trinity,105,12862,491,337,99,436,3
2021-06-19,Tulare,107,460477,50419,49681,9168,58849,849
2021-06-19,Tuolumne,109,53932,4049,4117,41,4158,63
2021-06-19,Ventura,111,848112,81700,81270,3033,84303,1031
2021-06-19,Yolo,113,214977,14112,14156,344,14500,212
2021-06-19,Yuba,115,75493,6195,6157,133,6290,51
2021-06-18,Alameda,001,1643700,89161,89123,1990,91113,1263
2021-06-18,Alpine,003,1148,88,88,0,88,0
2021-06-18,Amador,005,37829,3745,3739,33,3772,46
2021-06-18,Butte,007,227075,12768,12653,1838,14491,194
2021-06-18,Calaveras,009,45235,2195,2191,14,2205,55
2021-06-18,Colusa,011,21464,1963,1969,321,2290,15
2021-06-18,Contra Costa,013,1133247,70745,70271,1323,71594,813
2021-06-18,Del Norte,015,27424,1448,1415,13,1428,8
2021-06-18,El Dorado,017,186661,10430,10348,749,11097,113
2021-06-18,Fresno,019,978130,103346,102894,8795,111689,1722
2021-06-18,Glenn,021,27897,2447,2430,569,2999,19
2021-06-18,Humboldt,023,135768,4458,4450,42,4492,42
2021-06-18,Imperial,025,180216,28759,28809,2785,31594,740
2021-06-18,Inyo,027,18085,1408,1405,12,1417,35
2021-06-18,Kern,029,883053,97816,96948,11119,108067,1341
2021-06-18,Kings,031,150075,23251,23082,1104,24186,245
2021-06-18,Lake,033,64148,3572,3563,13,3576,45
2021-06-18,Lassen,035,31185,5268,5224,117,5341,19
2021-06-18,Los Angeles,037,10098052,1209862,1205472,42097,1247569,24451
2021-06-18,Madera,039,155013,16757,16625,947,17572,241
2021-06-18,Marin,041,260295,14187,14147,266,14413,230
2021-06-18,Mariposa,043,17540,439,439,11,450,5
2021-06-18,Mendocino,045,87422,4146,4068,82,4150,49
2021-06-18,Merced,047,269075,31197,31262,1067,32329,464
2021-06-18,Modoc,049,8938,414,402,147,549,3
2021-06-18,Mono,051,14174,1265,1275,17,1292,3
2021-06-18,Monterey,053,433212,43303,43148,1883,45031,427
2021-06-18,Napa,055,140530,9997,10021,38,10059,80
2021-06-18,Nevada,057,99092,4941,4903,195,5098,72
2021-06-18,Orange,059,3164182,256273,255274,11511,266785,5108
2021-06-18,Placer,061,380077,23713,23500,1541,25041,298
2021-06-18,Plumas,063,18699,716,697,11,708,4
2021-06-18,Riverside,065,2383286,295292,289676,14159,303835,4457
2021-06-18,Sacramento,067,1510023,107800,107570,1825,109395,1669
2021-06-18,San Benito,069,59416,6089,6097,116,6213,63
2021-06-18,San Bernardino,071,2135413,294366,293629,9056,302685,4826
2021-06-18,San Diego,073,3302833,282492,281608,15249,296857,3771
2021-06-18,San Francisco,075,870044,37032,37246,1309,38555,556
2021-06-18,San Joaquin,077,732212,73911,73623,3648,77271,1403
2021-06-18,San Luis Obispo,079,281455,21514,21301,755,22056,257
2021-06-18,San Mateo,081,765935,42673,42630,480,43110,542
2021-06-18,Santa Barbara,083,443738,34574,34469,1145,35614,455
2021-06-18,Santa Clara,085,1922200,119324,120081,779,120860,2093
2021-06-18,Santa Cruz,087,273765,16305,16202,816,17018,208
2021-06-18,Shasta,089,179085,12556,12607,1627,14234,201
2021-06-18,Sierra,091,2930,61,57,12,69,0
2021-06-18,Siskiyou,093,43540,1964,1890,375,2265,27
2021-06-18,Solano,095,438530,33328,33323,565,33888,266
2021-06-18,Sonoma,097,501317,30757,30816,360,31176,313
2021-06-18,Stanislaus,099,539301,56948,56803,6025,62828,1012
2021-06-18,Sutter,101,95872,9597,9643,90,9733,113
2021-06-18,Tehama,103,63373,5142,5114,596,5710,63
2021-06-18,Trinity,105,12862,491,337,98,435,3
2021-06-18,Tulare,107,460477,50417,49664,9161,58825,849
2021-06-18,Tuolumne,109,53932,4047,4116,41,4157,63
2021-06-18,Ventura,111,848112,81690,81256,3028,84284,1031
2021-06-18,Yolo,113,214977,14109,14148,342,14490,212
2021-06-18,Yuba,115,75493,6189,6150,133,6283,51
2021-06-17,Alameda,001,1643700,89114,89087,1990,91077,1262
2021-06-17,Alpine,003,1148,88,88,0,88,0
2021-06-17,Amador,005,37829,3743,3731,33,3764,46
2021-06-17,Butte,007,227075,12758,12644,1837,14481,194
2021-06-17,Calaveras,009,45235,2194,2189,14,2203,55
2021-06-17,Colusa,011,21464,1962,1969,321,2290,15
2021-06-17,Contra Costa,013,1133247,70706,70190,1319,71509,810
2021-06-17,Del Norte,015,27424,1446,1413,13,1426,8
2021-06-17,El Dorado,017,186661,10420,10341,749,11090,113
2021-06-17,Fresno,019,978130,103320,102867,8791,111658,1722
2021-06-17,Glenn,021,27897,2447,2430,569,2999,19
2021-06-17,Humboldt,023,135768,4449,4438,42,4480,42
2021-06-17,Imperial,025,180216,28751,28801,2785,31586,741
2021-06-17,Inyo,027,18085,1408,1405,12,1417,35
2021-06-17,Kern,029,883053,97801,96840,11113,107953,1340
2021-06-17,Kings,031,150075,23247,23078,1103,24181,245
2021-06-17,Lake,033,64148,3569,3563,9,3572,45
2021-06-17,Lassen,035,31185,5264,5223,117,5340,19
2021-06-17,Los Angeles,037,10098052,1209650,1205301,42068,1247369,24444
2021-06-17,Madera,039,155013,16752,16618,947,17565,241
2021-06-17,Marin,041,260295,14187,14141,266,14407,229
2021-06-17,Mariposa,043,17540,439,439,11,450,5
2021-06-17,Mendocino,045,87422,4139,4054,82,4136,49
2021-06-17,Merced,047,269075,31192,31262,1067,32329,464
2021-06-17,Modoc,049,8938,413,401,147,548,3
2021-06-17,Mono,051,14174,1264,1275,17,1292,3
2021-06-17,Monterey,053,433212,43295,43140,1883,45023,416
2021-06-17,Napa,055,140530,9997,10014,38,10052,80
2021-06-17,Nevada,057,99092,4937,4898,195,5093,72
2021-06-17,Orange,059,3164182,256227,255240,11500,266740,5109
2021-06-17,Placer,061,380077,23697,23461,1539,25000,298
2021-06-17,Plumas,063,18699,715,697,11,708,4
2021-06-17,Riverside,065,2383286,295238,289627,14157,303784,4458
2021-06-17,Sacramento,067,1510023,107736,107492,1823,109315,1666
2021-06-17,San Benito,069,59416,6089,6097,116,6213,63
2021-06-17,San Bernardino,071,2135413,294325,293560,9056,302616,4811
2021-06-17,San Diego,073,3302833,282416,281531,15235,296766,3771
2021-06-17,San Francisco,075,870044,37021,37243,1308,38551,556
2021-06-17,San Joaquin,077,732212,73888,73560,3643,77203,1403
2021-06-17,San Luis Obispo,079,281455,21512,21297,755,22052,257
2021-06-17,San Mateo,081,765935,42667,42615,480,43095,542
2021-06-17,Santa Barbara,083,443738,34568,34466,1145,35611,453
2021-06-17,Santa Clara,085,1922200,119299,120032,778,120810,2093
2021-06-17,Santa Cruz,087,273765,16301,16197,816,17013,208
2021-06-17,Shasta,089,179085,12548,12597,1627,14224,201
2021-06-17,Sierra,091,2930,61,56,12,68,0
2021-06-17,Siskiyou,093,43540,1963,1889,375,2264,27
2021-06-17,Solano,095,438530,33307,33296,564,33860,266
2021-06-17,Sonoma,097,501317,30726,30793,360,31153,323
2021-06-17,Stanislaus,099,539301,56917,56752,6020,62772,1012
2021-06-17,Sutter,101,95872,9594,9629,90,9719,113
2021-06-17,Tehama,103,63373,5141,5112,594,5706,63
2021-06-17,Trinity,105,12862,490,337,98,435,3
2021-06-17,Tulare,107,460477,50412,49649,9153,58802,849
2021-06-17,Tuolumne,109,53932,4046,4116,41,4157,63
2021-06-17,Ventura,111,848112,81681,81248,3025,84273,1030
2021-06-17,Yolo,113,214977,14101,14141,342,14483,212
2021-06-17,Yuba,115,75493,6180,6140,133,6273,51
2021-06-16,Alameda,001,1643700,89065,89045,1989,91034,1265
2021-06-16,Alpine,003,1148,88,88,0,88,0
2021-06-16,Amador,005,37829,3742,3730,33,3763,46
2021-06-16,Butte,007,227075,12756,12635,1835,14470,194
2021-06-16,Calaveras,009,45235,2192,2188,14,2202,55
2021-06-16,Colusa,011,21464,1962,1967,321,2288,15
2021-06-16,Contra Costa,013,1133247,70654,70136,1318,71454,810
2021-06-16,Del Norte,015,27424,1443,1413,13,1426,8
2021-06-16,El Dorado,017,186661,10414,10334,748,11082,113
2021-06-16,Fresno,019,978130,103290,102842,8787,111629,1722
2021-06-16,Glenn,021,27897,2447,2430,569,2999,19
2021-06-16,Humboldt,023,135768,4440,4427,41,4468,42
2021-06-16,Imperial,025,180216,28748,28796,2785,31581,741
2021-06-16,Inyo,027,18085,1407,1405,12,1417,35
2021-06-16,Kern,029,883053,97779,96789,11106,107895,1339
2021-06-16,Kings,031,150075,23246,23072,1102,24174,245
2021-06-16,Lake,033,64148,3569,3562,9,3571,45
2021-06-16,Lassen,035,31185,5261,5216,117,5333,19
2021-06-16,Los Angeles,037,10098052,1209427,1205102,42057,1247159,24439
2021-06-16,Madera,039,155013,16748,16603,947,17550,240
2021-06-16,Marin,041,260295,14185,14137,266,14403,229
2021-06-16,Mariposa,043,17540,439,437,11,448,5
2021-06-16,Mendocino,045,87422,4131,4041,82,4123,49
2021-06-16,Merced,047,269075,31184,31250,1067,32317,463
2021-06-16,Modoc,049,8938,412,383,146,529,3
2021-06-16,Mono,051,14174,1264,1275,17,1292,3
2021-06-16,Monterey,053,433212,43292,43122,1883,45005,416
2021-06-16,Napa,055,140530,9993,10011,38,10049,80
2021-06-16,Nevada,057,99092,4932,4894,195,5089,72
2021-06-16,Orange,059,3164182,256173,255188,11493,266681,5109
2021-06-16,Placer,061,380077,23687,23425,1535,24960,298
2021-06-16,Plumas,063,18699,715,697,11,708,4
2021-06-16,Riverside,065,2383286,295177,289539,14155,303694,4457
2021-06-16,Sacramento,067,1510023,107666,107422,1819,109241,1665
2021-06-16,San Benito,069,59416,6089,6090,116,6206,63
2021-06-16,San Bernardino,071,2135413,294276,293499,9054,302553,4797
2021-06-16,San Diego,073,3302833,282337,281423,15222,296645,3770
2021-06-16,San Francisco,075,870044,37008,37222,1306,38528,555
2021-06-16,San Joaquin,077,732212,73849,73530,3639,77169,1399
2021-06-16,San Luis Obispo,079,281455,21507,21294,755,22049,257
2021-06-16,San Mateo,081,765935,42651,42601,480,43081,542
2021-06-16,Santa Barbara,083,443738,34562,34459,1145,35604,460
2021-06-16,Santa Clara,085,1922200,119267,119982,778,120760,2087
2021-06-16,Santa Cruz,087,273765,16298,16187,816,17003,208
2021-06-16,Shasta,089,179085,12543,12592,1626,14218,200
2021-06-16,Sierra,091,2930,61,56,12,68,0
2021-06-16,Siskiyou,093,43540,1962,1886,375,2261,26
2021-06-16,Solano,095,438530,33279,33276,564,33840,266
2021-06-16,Sonoma,097,501317,30690,30741,360,31101,323
2021-06-16,Stanislaus,099,539301,56886,56738,6018,62756,984
2021-06-16,Sutter,101,95872,9590,9620,90,9710,113
2021-06-16,Tehama,103,63373,5139,5106,594,5700,63
2021-06-16,Trinity,105,12862,489,332,98,430,3
2021-06-16,Tulare,107,460477,50407,49578,9149,58727,849
2021-06-16,Tuolumne,109,53932,4046,4110,41,4151,63
2021-06-16,Ventura,111,848112,81667,81229,3023,84252,1029
2021-06-16,Yolo,113,214977,14092,14135,341,14476,212
2021-06-16,Yuba,115,75493,6170,6134,133,6267,51
2021-06-15,Alameda,001,1643700,89022,89008,1989,90997,1262
2021-06-15,Alpine,003,1148,88,88,0,88,0
2021-06-15,Amador,005,37829,3739,3723,33,3756,46
2021-06-15,Butte,007,227075,12748,12620,1834,14454,194
2021-06-15,Calaveras,009,45235,2191,2188,14,2202,55
2021-06-15,Colusa,011,21464,1962,1967,319,2286,15
2021-06-15,Contra Costa,013,1133247,70592,70101,1318,71419,810
2021-06-15,Del Norte,015,27424,1442,1411,13,1424,8
2021-06-15,El Dorado,017,186661,10405,10330,748,11078,113
2021-06-15,Fresno,019,978130,103258,102828,8786,111614,1722
2021-06-15,Glenn,021,27897,2446,2426,569,2995,19
2021-06-15,Humboldt,023,135768,4431,4414,40,4454,42
2021-06-15,Imperial,025,180216,28742,28789,2785,31574,741
2021-06-15,Inyo,027,18085,1407,1405,12,1417,35
2021-06-15,Kern,029,883053,97751,96782,11098,107880,1338
2021-06-15,Kings,031,150075,23240,23070,1100,24170,245
2021-06-15,Lake,033,64148,3568,3559,9,3568,45
2021-06-15,Lassen,035,31185,5260,5211,117,5328,19
2021-06-15,Los Angeles,037,10098052,1209195,1204926,42049,1246975,24435
2021-06-15,Madera,039,155013,16741,16600,946,17546,240
2021-06-15,Marin,041,260295,14177,14135,266,14401,229
2021-06-15,Mariposa,043,17540,439,437,11,448,5
2021-06-15,Mendocino,045,87422,4124,4034,82,4116,49
2021-06-15,Merced,047,269075,31178,31244,1067,32311,461
2021-06-15,Modoc,049,8938,411,383,146,529,3
2021-06-15,Mono,051,14174,1264,1275,17,1292,3
2021-06-15,Monterey,053,433212,43286,43118,1883,45001,416
2021-06-15,Napa,055,140530,9991,10010,38,10048,80
2021-06-15,Nevada,057,99092,4929,4888,195,5083,72
2021-06-15,Orange,059,3164182,256132,255127,11484,266611,5105
2021-06-15,Placer,061,380077,23665,23396,1534,24930,298
2021-06-15,Plumas,063,18699,714,697,11,708,4
2021-06-15,Riverside,065,2383286,295117,289508,14151,303659,4455
2021-06-15,Sacramento,067,1510023,107591,107370,1813,109183,1662
2021-06-15,San Benito,069,59416,6088,6089,116,6205,63
2021-06-15,San Bernardino,071,2135413,294226,293463,9048,302511,4790
2021-06-15,San Diego,073,3302833,282253,281375,15207,296582,3770
2021-06-15,San Francisco,075,870044,36999,37210,1305,38515,555
2021-06-15,San Joaquin,077,732212,73809,73494,3634,77128,1399
2021-06-15,San Luis Obispo,079,281455,21502,21293,754,22047,257
2021-06-15,San Mateo,081,765935,42637,42593,480,43073,543
2021-06-15,Santa Barbara,083,443738,34557,34451,1145,35596,460
2021-06-15,Santa Clara,085,1922200,119229,119963,778,120741,2086
2021-06-15,Santa Cruz,087,273765,16292,16180,815,16995,208
2021-06-15,Shasta,089,179085,12537,12583,1626,14209,201
2021-06-15,Sierra,091,2930,60,55,12,67,0
2021-06-15,Siskiyou,093,43540,1961,1887,375,2262,26
2021-06-15,Solano,095,438530,33260,33264,564,33828,266
2021-06-15,Sonoma,097,501317,30651,30707,359,31066,323
2021-06-15,Stanislaus,099,539301,56858,56724,6015,62739,979
2021-06-15,Sutter,101,95872,9581,9616,90,9706,113
2021-06-15,Tehama,103,63373,5137,5102,594,5696,63
2021-06-15,Trinity,105,12862,488,332,97,429,3
2021-06-15,Tulare,107,460477,50400,49561,9146,58707,848
2021-06-15,Tuolumne,109,53932,4046,4111,41,4152,63
2021-06-15,Ventura,111,848112,81656,81215,3020,84235,1029
2021-06-15,Yolo,113,214977,14088,14127,339,14466,212
2021-06-15,Yuba,115,75493,6159,6130,133,6263,51
2021-06-14,Alameda,001,1643700,88973,88966,1989,90955,1264
2021-06-14,Alpine,003,1148,88,88,0,88,0
2021-06-14,Amador,005,37829,3738,3722,33,3755,46
2021-06-14,Butte,007,227075,12737,12613,1830,14443,194
2021-06-14,Calaveras,009,45235,2190,2190,14,2204,55
2021-06-14,Colusa,011,21464,1961,1966,319,2285,15
2021-06-14,Contra Costa,013,1133247,70539,70069,1316,71385,810
2021-06-14,Del Norte,015,27424,1442,1411,13,1424,8
2021-06-14,El Dorado,017,186661,10396,10327,747,11074,113
2021-06-14,Fresno,019,978130,103236,102812,8784,111596,1719
2021-06-14,Glenn,021,27897,2446,2426,569,2995,19
2021-06-14,Humboldt,023,135768,4423,4407,39,4446,42
2021-06-14,Imperial,025,180216,28730,28836,2785,31621,741
2021-06-14,Inyo,027,18085,1406,1405,12,1417,35
2021-06-14,Kern,029,883053,97731,96760,11088,107848,1337
2021-06-14,Kings,031,150075,23237,23071,1099,24170,245
2021-06-14,Lake,033,64148,3567,3557,9,3566,45
2021-06-14,Lassen,035,31185,5257,5209,116,5325,19
2021-06-14,Los Angeles,037,10098052,1208960,1204748,42039,1246787,24434
2021-06-14,Madera,039,155013,16735,16597,945,17542,240
2021-06-14,Marin,041,260295,14175,14133,266,14399,229
2021-06-14,Mariposa,043,17540,438,437,11,448,5
2021-06-14,Mendocino,045,87422,4118,4028,82,4110,49
2021-06-14,Merced,047,269075,31169,31241,1066,32307,461
2021-06-14,Modoc,049,8938,402,382,144,526,3
2021-06-14,Mono,051,14174,1264,1275,17,1292,3
2021-06-14,Monterey,053,433212,43283,43110,1883,44993,415
2021-06-14,Napa,055,140530,9987,10000,38,10038,80
2021-06-14,Nevada,057,99092,4922,4885,195,5080,72
2021-06-14,Orange,059,3164182,256094,255069,11480,266549,5103
2021-06-14,Placer,061,380077,23640,23379,1533,24912,298
2021-06-14,Plumas,063,18699,714,696,11,707,4
2021-06-14,Riverside,065,2383286,295063,289476,14151,303627,4453
2021-06-14,Sacramento,067,1510023,107537,107334,1808,109142,1661
2021-06-14,San Benito,069,59416,6088,6087,116,6203,63
2021-06-14,San Bernardino,071,2135413,294170,293446,9044,302490,4790
2021-06-14,San Diego,073,3302833,282147,281314,15187,296501,3770
2021-06-14,San Francisco,075,870044,36986,37206,1305,38511,555
2021-06-14,San Joaquin,077,732212,73780,73453,3634,77087,1398
2021-06-14,San Luis Obispo,079,281455,21500,21302,754,22056,256
2021-06-14,San Mateo,081,765935,42624,42619,479,43098,543
2021-06-14,Santa Barbara,083,443738,34554,34449,1145,35594,460
2021-06-14,Santa Clara,085,1922200,119198,119957,777,120734,2085
2021-06-14,Santa Cruz,087,273765,16289,16175,815,16990,208
2021-06-14,Shasta,089,179085,12526,12561,1623,14184,201
2021-06-14,Sierra,091,2930,59,55,12,67,0
2021-06-14,Siskiyou,093,43540,1961,1886,375,2261,26
2021-06-14,Solano,095,438530,33243,33243,563,33806,266
2021-06-14,Sonoma,097,501317,30619,30679,358,31037,323
2021-06-14,Stanislaus,099,539301,56822,56689,6012,62701,975
2021-06-14,Sutter,101,95872,9578,9607,90,9697,112
2021-06-14,Tehama,103,63373,5135,5102,594,5696,63
2021-06-14,Trinity,105,12862,488,332,97,429,3
2021-06-14,Tulare,107,460477,50395,49538,9143,58681,848
2021-06-14,Tuolumne,109,53932,4043,4108,41,4149,63
2021-06-14,Ventura,111,848112,81646,81209,3020,84229,1028
2021-06-14,Yolo,113,214977,14080,14123,339,14462,212
2021-06-14,Yuba,115,75493,6152,6127,133,6260,50
2021-06-13,Alameda,001,1643700,88916,88947,1988,90935,1264
2021-06-13,Alpine,003,1148,87,88,0,88,0
2021-06-13,Amador,005,37829,3734,3721,33,3754,46
2021-06-13,Butte,007,227075,12726,12586,1827,14413,194
2021-06-13,Calaveras,009,45235,2190,2189,14,2203,55
2021-06-13,Colusa,011,21464,1961,1965,318,2283,15
2021-06-13,Contra Costa,013,1133247,70485,70040,1314,71354,810
2021-06-13,Del Norte,015,27424,1440,1412,13,1425,8
2021-06-13,El Dorado,017,186661,10387,10324,747,11071,113
2021-06-13,Fresno,019,978130,103205,102795,8779,111574,1719
2021-06-13,Glenn,021,27897,2445,2425,567,2992,19
2021-06-13,Humboldt,023,135768,4410,4401,39,4440,42
2021-06-13,Imperial,025,180216,28721,28800,2785,31585,741
2021-06-13,Inyo,027,18085,1406,1405,12,1417,35
2021-06-13,Kern,029,883053,97707,96743,11076,107819,1337
2021-06-13,Kings,031,150075,23232,23069,1098,24167,245
2021-06-13,Lake,033,64148,3567,3556,9,3565,45
2021-06-13,Lassen,035,31185,5252,5209,116,5325,19
2021-06-13,Los Angeles,037,10098052,1208697,1204614,42026,1246640,24433
2021-06-13,Madera,039,155013,16721,16590,945,17535,240
2021-06-13,Marin,041,260295,14169,14126,266,14392,229
2021-06-13,Mariposa,043,17540,438,434,11,445,5
2021-06-13,Mendocino,045,87422,4111,4026,82,4108,49
2021-06-13,Merced,047,269075,31163,31240,1065,32305,461
2021-06-13,Modoc,049,8938,400,382,142,524,3
2021-06-13,Mono,051,14174,1264,1275,17,1292,3
2021-06-13,Monterey,053,433212,43275,43108,1883,44991,415
2021-06-13,Napa,055,140530,9981,9995,38,10033,80
2021-06-13,Nevada,057,99092,4917,4883,195,5078,72
2021-06-13,Orange,059,3164182,256039,255043,11478,266521,5103
2021-06-13,Placer,061,380077,23614,23365,1531,24896,295
2021-06-13,Plumas,063,18699,713,696,11,707,4
2021-06-13,Riverside,065,2383286,294996,289447,14148,303595,4453
2021-06-13,Sacramento,067,1510023,107461,107289,1805,109094,1658
2021-06-13,San Benito,069,59416,6088,6086,116,6202,63
2021-06-13,San Bernardino,071,2135413,294119,293416,9039,302455,4788
2021-06-13,San Diego,073,3302833,282068,281268,15171,296439,3770
2021-06-13,San Francisco,075,870044,36973,37197,1305,38502,555
2021-06-13,San Joaquin,077,732212,73744,73438,3632,77070,1398
2021-06-13,San Luis Obispo,079,281455,21494,21298,753,22051,256
2021-06-13,San Mateo,081,765935,42611,42611,479,43090,542
2021-06-13,Santa Barbara,083,443738,34543,34449,1144,35593,460
2021-06-13,Santa Clara,085,1922200,119174,119946,777,120723,2085
2021-06-13,Santa Cruz,087,273765,16282,16172,815,16987,208
2021-06-13,Shasta,089,179085,12517,12560,1622,14182,201
2021-06-13,Sierra,091,2930,59,55,12,67,0
2021-06-13,Siskiyou,093,43540,1960,1885,375,2260,26
2021-06-13,Solano,095,438530,33222,33234,563,33797,266
2021-06-13,Sonoma,097,501317,30584,30663,356,31019,323
2021-06-13,Stanislaus,099,539301,56796,56671,6009,62680,975
2021-06-13,Sutter,101,95872,9571,9603,90,9693,112
2021-06-13,Tehama,103,63373,5133,5100,594,5694,63
2021-06-13,Trinity,105,12862,487,332,97,429,3
2021-06-13,Tulare,107,460477,50386,49537,9138,58675,848
2021-06-13,Tuolumne,109,53932,4041,4107,40,4147,63
2021-06-13,Ventura,111,848112,81632,81201,3020,84221,1028
2021-06-13,Yolo,113,214977,14072,14120,337,14457,212
2021-06-13,Yuba,115,75493,6145,6125,133,6258,50
2021-06-12,Alameda,001,1643700,88889,88901,1988,90889,1271
2021-06-12,Alpine,003,1148,87,88,0,88,0
2021-06-12,Amador,005,37829,3733,3721,33,3754,46
2021-06-12,Butte,007,227075,12722,12576,1827,14403,194
2021-06-12,Calaveras,009,45235,2190,2189,14,2203,55
2021-06-12,Colusa,011,21464,1961,1965,318,2283,15
2021-06-12,Contra Costa,013,1133247,70454,69989,1311,71300,810
2021-06-12,Del Norte,015,27424,1440,1412,13,1425,8
2021-06-12,El Dorado,017,186661,10382,10320,746,11066,113
2021-06-12,Fresno,019,978130,103195,102783,8778,111561,1720
2021-06-12,Glenn,021,27897,2443,2425,567,2992,19
2021-06-12,Humboldt,023,135768,4402,4396,39,4435,42
2021-06-12,Imperial,025,180216,28718,28799,2785,31584,741
2021-06-12,Inyo,027,18085,1406,1405,12,1417,35
2021-06-12,Kern,029,883053,97692,96731,11072,107803,1337
2021-06-12,Kings,031,150075,23230,23067,1098,24165,245
2021-06-12,Lake,033,64148,3566,3552,9,3561,45
2021-06-12,Lassen,035,31185,5252,5208,116,5324,19
2021-06-12,Los Angeles,037,10098052,1208559,1204439,42020,1246459,24434
2021-06-12,Madera,039,155013,16717,16586,945,17531,240
2021-06-12,Marin,041,260295,14166,14121,266,14387,229
2021-06-12,Mariposa,043,17540,438,434,11,445,5
2021-06-12,Mendocino,045,87422,4108,4024,82,4106,49
2021-06-12,Merced,047,269075,31160,31236,1065,32301,461
2021-06-12,Modoc,049,8938,399,382,142,524,3
2021-06-12,Mono,051,14174,1264,1275,17,1292,3
2021-06-12,Monterey,053,433212,43269,43103,1883,44986,415
2021-06-12,Napa,055,140530,9977,9986,38,10024,80
2021-06-12,Nevada,057,99092,4911,4878,195,5073,72
2021-06-12,Orange,059,3164182,256006,255004,11476,266480,5103
2021-06-12,Placer,061,380077,23595,23345,1531,24876,295
2021-06-12,Plumas,063,18699,713,696,11,707,4
2021-06-12,Riverside,065,2383286,294954,289413,14145,303558,4453
2021-06-12,Sacramento,067,1510023,107401,107199,1802,109001,1658
2021-06-12,San Benito,069,59416,6086,6083,116,6199,63
2021-06-12,San Bernardino,071,2135413,294085,293375,9037,302412,4788
2021-06-12,San Diego,073,3302833,282011,281203,15162,296365,3770
2021-06-12,San Francisco,075,870044,36963,37189,1305,38494,555
2021-06-12,San Joaquin,077,732212,73725,73413,3631,77044,1398
2021-06-12,San Luis Obispo,079,281455,21491,21293,753,22046,256
2021-06-12,San Mateo,081,765935,42606,42604,479,43083,542
2021-06-12,Santa Barbara,083,443738,34538,34450,1144,35594,460
2021-06-12,Santa Clara,085,1922200,119134,119894,777,120671,2085
2021-06-12,Santa Cruz,087,273765,16274,16170,815,16985,208
2021-06-12,Shasta,089,179085,12514,12556,1621,14177,201
2021-06-12,Sierra,091,2930,59,55,12,67,0
2021-06-12,Siskiyou,093,43540,1959,1884,375,2259,25
2021-06-12,Solano,095,438530,33213,33219,563,33782,266
2021-06-12,Sonoma,097,501317,30555,30647,356,31003,323
2021-06-12,Stanislaus,099,539301,56779,56649,6008,62657,974
2021-06-12,Sutter,101,95872,9567,9603,90,9693,112
2021-06-12,Tehama,103,63373,5133,5099,593,5692,63
2021-06-12,Trinity,105,12862,487,332,97,429,3
2021-06-12,Tulare,107,460477,50381,49533,9131,58664,848
2021-06-12,Tuolumne,109,53932,4040,4105,40,4145,63
2021-06-12,Ventura,111,848112,81620,81197,3020,84217,1028
2021-06-12,Yolo,113,214977,14069,14118,336,14454,212
2021-06-12,Yuba,115,75493,6140,6120,133,6253,50
2021-06-11,Alameda,001,1643700,88861,88844,1988,90832,1278
2021-06-11,Alpine,003,1148,87,88,0,88,0
2021-06-11,Amador,005,37829,3732,3710,33,3743,46
2021-06-11,Butte,007,227075,12718,12576,1825,14401,194
2021-06-11,Calaveras,009,45235,2190,2188,14,2202,55
2021-06-11,Colusa,011,21464,1960,1964,318,2282,15
2021-06-11,Contra Costa,013,1133247,70421,69940,1309,71249,808
2021-06-11,Del Norte,015,27424,1440,1409,13,1422,8
2021-06-11,El Dorado,017,186661,10379,10316,746,11062,113
2021-06-11,Fresno,019,978130,103176,102770,8777,111547,1720
2021-06-11,Glenn,021,27897,2443,2425,567,2992,19
2021-06-11,Humboldt,023,135768,4398,4389,39,4428,42
2021-06-11,Imperial,025,180216,28713,28793,2785,31578,741
2021-06-11,Inyo,027,18085,1406,1405,12,1417,35
2021-06-11,Kern,029,883053,97680,96718,11069,107787,1340
2021-06-11,Kings,031,150075,23226,23069,1097,24166,245
2021-06-11,Lake,033,64148,3565,3550,9,3559,45
2021-06-11,Lassen,035,31185,5251,5204,116,5320,18
2021-06-11,Los Angeles,037,10098052,1208412,1204259,42005,1246264,24434
2021-06-11,Madera,039,155013,16714,16582,945,17527,240
2021-06-11,Marin,041,260295,14163,14116,266,14382,229
2021-06-11,Mariposa,043,17540,438,434,11,445,5
2021-06-11,Mendocino,045,87422,4105,4022,82,4104,49
2021-06-11,Merced,047,269075,31155,31231,1065,32296,461
2021-06-11,Modoc,049,8938,399,382,141,523,3
2021-06-11,Mono,051,14174,1264,1274,17,1291,3
2021-06-11,Monterey,053,433212,43265,43097,1883,44980,415
2021-06-11,Napa,055,140530,9974,9977,38,10015,80
2021-06-11,Nevada,057,99092,4909,4873,195,5068,72
2021-06-11,Orange,059,3164182,255972,254975,11473,266448,5101
2021-06-11,Placer,061,380077,23590,23330,1531,24861,294
2021-06-11,Plumas,063,18699,713,696,11,707,4
2021-06-11,Riverside,065,2383286,294916,289376,14140,303516,4451
2021-06-11,Sacramento,067,1510023,107341,107119,1801,108920,1659
2021-06-11,San Benito,069,59416,6085,6082,116,6198,63
2021-06-11,San Bernardino,071,2135413,294050,293335,9033,302368,4788
2021-06-11,San Diego,073,3302833,281971,281144,15155,296299,3768
2021-06-11,San Francisco,075,870044,36958,37177,1305,38482,555
2021-06-11,San Joaquin,077,732212,73708,73347,3628,76975,1397
2021-06-11,San Luis Obispo,079,281455,21490,21288,753,22041,256
2021-06-11,San Mateo,081,765935,42592,42585,479,43064,542
2021-06-11,Santa Barbara,083,443738,34535,34438,1144,35582,460
2021-06-11,Santa Clara,085,1922200,119114,119860,777,120637,2083
2021-06-11,Santa Cruz,087,273765,16266,16164,815,16979,208
2021-06-11,Shasta,089,179085,12506,12550,1619,14169,201
2021-06-11,Sierra,091,2930,59,55,12,67,0
2021-06-11,Siskiyou,093,43540,1958,1882,375,2257,25
2021-06-11,Solano,095,438530,33193,33179,562,33741,266
2021-06-11,Sonoma,097,501317,30537,30624,356,30980,323
2021-06-11,Stanislaus,099,539301,56754,56617,6004,62621,974
2021-06-11,Sutter,101,95872,9564,9600,89,9689,112
2021-06-11,Tehama,103,63373,5132,5099,593,5692,63
2021-06-11,Trinity,105,12862,487,331,97,428,3
2021-06-11,Tulare,107,460477,50375,49516,9130,58646,848
2021-06-11,Tuolumne,109,53932,4037,4104,40,4144,63
2021-06-11,Ventura,111,848112,81610,81189,3020,84209,1026
2021-06-11,Yolo,113,214977,14062,14111,332,14443,212
2021-06-11,Yuba,115,75493,6136,6113,133,6246,50
2021-06-10,Alameda,001,1643700,88817,88806,1987,90793,1275
2021-06-10,Alpine,003,1148,87,88,0,88,0
2021-06-10,Amador,005,37829,3728,3709,33,3742,46
2021-06-10,Butte,007,227075,12701,12565,1825,14390,194
2021-06-10,Calaveras,009,45235,2189,2188,14,2202,55
2021-06-10,Colusa,011,21464,1958,1964,318,2282,15
2021-06-10,Contra Costa,013,1133247,70367,69876,1309,71185,807
2021-06-10,Del Norte,015,27424,1440,1405,13,1418,8
2021-06-10,El Dorado,017,186661,10372,10314,742,11056,113
2021-06-10,Fresno,019,978130,103150,102724,8776,111500,1717
2021-06-10,Glenn,021,27897,2443,2425,567,2992,19
2021-06-10,Humboldt,023,135768,4390,4384,39,4423,42
2021-06-10,Imperial,025,180216,28707,28779,2785,31564,739
2021-06-10,Inyo,027,18085,1406,1405,12,1417,35
2021-06-10,Kern,029,883053,97666,96706,11064,107770,1336
2021-06-10,Kings,031,150075,23225,23067,1097,24164,245
2021-06-10,Lake,033,64148,3560,3550,9,3559,45
2021-06-10,Lassen,035,31185,5249,5201,116,5317,18
2021-06-10,Los Angeles,037,10098052,1208247,1204110,41988,1246098,24440
2021-06-10,Madera,039,155013,16707,16581,944,17525,240
2021-06-10,Marin,041,260295,14160,14118,266,14384,229
2021-06-10,Mariposa,043,17540,436,434,11,445,5
2021-06-10,Mendocino,045,87422,4100,4016,82,4098,48
2021-06-10,Merced,047,269075,31147,31231,1062,32293,461
2021-06-10,Modoc,049,8938,398,381,141,522,3
2021-06-10,Mono,051,14174,1263,1274,17,1291,3
2021-06-10,Monterey,053,433212,43259,43090,1883,44973,415
2021-06-10,Napa,055,140530,9973,9974,38,10012,80
2021-06-10,Nevada,057,99092,4904,4866,195,5061,72
2021-06-10,Orange,059,3164182,255942,254950,11466,266416,5097
2021-06-10,Placer,061,380077,23577,23296,1531,24827,293
2021-06-10,Plumas,063,18699,713,696,11,707,4
2021-06-10,Riverside,065,2383286,294874,289335,14135,303470,4450
2021-06-10,Sacramento,067,1510023,107279,107049,1801,108850,1658
2021-06-10,San Benito,069,59416,6085,6079,116,6195,63
2021-06-10,San Bernardino,071,2135413,294009,293281,9030,302311,4782
2021-06-10,San Diego,073,3302833,281913,281052,15138,296190,3766
2021-06-10,San Francisco,075,870044,36948,37159,1303,38462,552
2021-06-10,San Joaquin,077,732212,73674,73276,3627,76903,1393
2021-06-10,San Luis Obispo,079,281455,21487,21280,753,22033,256
2021-06-10,San Mateo,081,765935,42585,42562,479,43041,666
2021-06-10,Santa Barbara,083,443738,34531,34434,1144,35578,460
2021-06-10,Santa Clara,085,1922200,119079,119832,776,120608,2075
2021-06-10,Santa Cruz,087,273765,16265,16159,815,16974,208
2021-06-10,Shasta,089,179085,12496,12536,1618,14154,201
2021-06-10,Sierra,091,2930,58,55,12,67,0
2021-06-10,Siskiyou,093,43540,1958,1881,375,2256,25
2021-06-10,Solano,095,438530,33176,33150,561,33711,265
2021-06-10,Sonoma,097,501317,30502,30571,354,30925,323
2021-06-10,Stanislaus,099,539301,56733,56588,6000,62588,974
2021-06-10,Sutter,101,95872,9557,9594,89,9683,112
2021-06-10,Tehama,103,63373,5132,5096,593,5689,63
2021-06-10,Trinity,105,12862,487,331,97,428,3
2021-06-10,Tulare,107,460477,50367,49503,9130,58633,848
2021-06-10,Tuolumne,109,53932,4037,4100,40,4140,63
2021-06-10,Ventura,111,848112,81599,81172,3019,84191,1026
2021-06-10,Yolo,113,214977,14059,14107,332,14439,212
2021-06-10,Yuba,115,75493,6132,6112,133,6245,50
2021-06-09,Alameda,001,1643700,88774,88762,1986,90748,1271
2021-06-09,Alpine,003,1148,87,88,0,88,0
2021-06-09,Amador,005,37829,3724,3706,33,3739,46
2021-06-09,Butte,007,227075,12695,12555,1823,14378,194
2021-06-09,Calaveras,009,45235,2187,2184,14,2198,55
2021-06-09,Colusa,011,21464,1958,1962,317,2279,15
2021-06-09,Contra Costa,013,1133247,70330,69829,1308,71137,803
2021-06-09,Del Norte,015,27424,1436,1403,13,1416,8
2021-06-09,El Dorado,017,186661,10369,10312,741,11053,113
2021-06-09,Fresno,019,978130,103130,102690,8772,111462,1717
2021-06-09,Glenn,021,27897,2442,2424,567,2991,19
2021-06-09,Humboldt,023,135768,4385,4379,38,4417,42
2021-06-09,Imperial,025,180216,28704,28754,2785,31539,739
2021-06-09,Inyo,027,18085,1406,1405,12,1417,35
2021-06-09,Kern,029,883053,97652,96697,11055,107752,1328
2021-06-09,Kings,031,150075,23223,23061,1097,24158,245
2021-06-09,Lake,033,64148,3557,3541,9,3550,45
2021-06-09,Lassen,035,31185,5248,5200,116,5316,18
2021-06-09,Los Angeles,037,10098052,1208062,1203955,41975,1245930,24432
2021-06-09,Madera,039,155013,16702,16580,944,17524,240
2021-06-09,Marin,041,260295,14155,14114,266,14380,229
2021-06-09,Mariposa,043,17540,436,434,11,445,5
2021-06-09,Mendocino,045,87422,4094,4008,82,4090,47
2021-06-09,Merced,047,269075,31143,31225,1062,32287,461
2021-06-09,Modoc,049,8938,396,377,140,517,3
2021-06-09,Mono,051,14174,1263,1274,17,1291,3
2021-06-09,Monterey,053,433212,43252,43082,1883,44965,415
2021-06-09,Napa,055,140530,9967,9971,38,10009,80
2021-06-09,Nevada,057,99092,4894,4863,194,5057,72
2021-06-09,Orange,059,3164182,255898,254893,11462,266355,5080
2021-06-09,Placer,061,380077,23558,23237,1531,24768,293
2021-06-09,Plumas,063,18699,712,697,11,708,4
2021-06-09,Riverside,065,2383286,294828,289299,14133,303432,4450
2021-06-09,Sacramento,067,1510023,107217,106971,1798,108769,1657
2021-06-09,San Benito,069,59416,6081,6078,116,6194,63
2021-06-09,San Bernardino,071,2135413,293967,293222,9030,302252,4782
2021-06-09,San Diego,073,3302833,281849,280941,15126,296067,3765
2021-06-09,San Francisco,075,870044,36935,37143,1302,38445,552
2021-06-09,San Joaquin,077,732212,73648,73232,3626,76858,1392
2021-06-09,San Luis Obispo,079,281455,21486,21259,753,22012,256
2021-06-09,San Mateo,081,765935,42569,42502,477,42979,666
2021-06-09,Santa Barbara,083,443738,34520,34422,1144,35566,460
2021-06-09,Santa Clara,085,1922200,119041,119793,775,120568,2068
2021-06-09,Santa Cruz,087,273765,16262,16155,815,16970,208
2021-06-09,Shasta,089,179085,12486,12521,1616,14137,201
2021-06-09,Sierra,091,2930,57,55,12,67,0
2021-06-09,Siskiyou,093,43540,1957,1871,375,2246,25
2021-06-09,Solano,095,438530,33160,33137,560,33697,264
2021-06-09,Sonoma,097,501317,30480,30540,354,30894,323
2021-06-09,Stanislaus,099,539301,56713,56560,5997,62557,974
2021-06-09,Sutter,101,95872,9548,9586,88,9674,111
2021-06-09,Tehama,103,63373,5131,5093,593,5686,63
2021-06-09,Trinity,105,12862,486,331,97,428,3
2021-06-09,Tulare,107,460477,50363,49496,9128,58624,847
2021-06-09,Tuolumne,109,53932,4034,4100,40,4140,63
2021-06-09,Ventura,111,848112,81589,81154,3018,84172,1026
2021-06-09,Yolo,113,214977,14057,14102,331,14433,212
2021-06-09,Yuba,115,75493,6128,6109,133,6242,50
2021-06-08,Alameda,001,1643700,88726,88731,1986,90717,1267
2021-06-08,Alpine,003,1148,87,88,0,88,0
2021-06-08,Amador,005,37829,3723,3704,33,3737,46
2021-06-08,Butte,007,227075,12689,12540,1821,14361,194
2021-06-08,Calaveras,009,45235,2186,2181,14,2195,55
2021-06-08,Colusa,011,21464,1958,1961,317,2278,15
2021-06-08,Contra Costa,013,1133247,70282,69762,1307,71069,803
2021-06-08,Del Norte,015,27424,1434,1402,13,1415,8
2021-06-08,El Dorado,017,186661,10364,10306,739,11045,113
2021-06-08,Fresno,019,978130,103105,102680,8770,111450,1717
2021-06-08,Glenn,021,27897,2441,2423,567,2990,19
2021-06-08,Humboldt,023,135768,4380,4363,38,4401,42
2021-06-08,Imperial,025,180216,28695,28752,2785,31537,738
2021-06-08,Inyo,027,18085,1406,1405,12,1417,35
2021-06-08,Kern,029,883053,97633,96671,11048,107719,1325
2021-06-08,Kings,031,150075,23222,23036,1097,24133,245
2021-06-08,Lake,033,64148,3556,3540,9,3549,45
2021-06-08,Lassen,035,31185,5248,5200,116,5316,18
2021-06-08,Los Angeles,037,10098052,1207865,1203794,41963,1245757,24426
2021-06-08,Madera,039,155013,16696,16579,943,17522,240
2021-06-08,Marin,041,260295,14153,14111,265,14376,229
2021-06-08,Mariposa,043,17540,436,434,11,445,5
2021-06-08,Mendocino,045,87422,4087,4002,82,4084,47
2021-06-08,Merced,047,269075,31135,31225,1062,32287,461
2021-06-08,Modoc,049,8938,390,377,139,516,3
2021-06-08,Mono,051,14174,1263,1274,17,1291,3
2021-06-08,Monterey,053,433212,43246,43078,1882,44960,415
2021-06-08,Napa,055,140530,9963,9962,38,10000,80
2021-06-08,Nevada,057,99092,4889,4861,194,5055,72
2021-06-08,Orange,059,3164182,255856,254852,11455,266307,5078
2021-06-08,Placer,061,380077,23540,23209,1527,24736,293
2021-06-08,Plumas,063,18699,712,692,11,703,4
2021-06-08,Riverside,065,2383286,294792,289268,14125,303393,4452
2021-06-08,Sacramento,067,1510023,107155,106901,1795,108696,1654
2021-06-08,San Benito,069,59416,6079,6076,116,6192,63
2021-06-08,San Bernardino,071,2135413,293918,293186,9026,302212,4778
2021-06-08,San Diego,073,3302833,281786,280879,15117,295996,3764
2021-06-08,San Francisco,075,870044,36920,37134,1301,38435,552
2021-06-08,San Joaquin,077,732212,73604,73186,3621,76807,1390
2021-06-08,San Luis Obispo,079,281455,21480,21251,752,22003,255
2021-06-08,San Mateo,081,765935,42556,42488,477,42965,663
2021-06-08,Santa Barbara,083,443738,34516,34418,1144,35562,459
2021-06-08,Santa Clara,085,1922200,119020,119770,774,120544,2068
2021-06-08,Santa Cruz,087,273765,16259,16160,815,16975,208
2021-06-08,Shasta,089,179085,12471,12498,1616,14114,201
2021-06-08,Sierra,091,2930,57,55,12,67,0
2021-06-08,Siskiyou,093,43540,1955,1870,373,2243,21
2021-06-08,Solano,095,438530,33139,33130,560,33690,259
2021-06-08,Sonoma,097,501317,30453,30523,352,30875,323
2021-06-08,Stanislaus,099,539301,56686,56548,5995,62543,973
2021-06-08,Sutter,101,95872,9545,9581,88,9669,111
2021-06-08,Tehama,103,63373,5128,5093,593,5686,63
2021-06-08,Trinity,105,12862,486,330,96,426,3
2021-06-08,Tulare,107,460477,50351,49485,9123,58608,847
2021-06-08,Tuolumne,109,53932,4031,4099,40,4139,63
2021-06-08,Ventura,111,848112,81573,81142,3017,84159,1026
2021-06-08,Yolo,113,214977,14052,14099,330,14429,212
2021-06-08,Yuba,115,75493,6126,6103,133,6236,50
2021-06-07,Alameda,001,1643700,88668,88688,1986,90674,1267
2021-06-07,Alpine,003,1148,87,88,0,88,0
2021-06-07,Amador,005,37829,3713,3697,33,3730,46
2021-06-07,Butte,007,227075,12682,12533,1820,14353,194
2021-06-07,Calaveras,009,45235,2185,2181,14,2195,55
2021-06-07,Colusa,011,21464,1957,1960,317,2277,15
2021-06-07,Contra Costa,013,1133247,70225,69718,1306,71024,817
2021-06-07,Del Norte,015,27424,1434,1401,13,1414,8
2021-06-07,El Dorado,017,186661,10359,10305,739,11044,113
2021-06-07,Fresno,019,978130,103074,102659,8762,111421,1717
2021-06-07,Glenn,021,27897,2441,2423,567,2990,19
2021-06-07,Humboldt,023,135768,4372,4354,38,4392,42
2021-06-07,Imperial,025,180216,28693,28754,2785,31539,738
2021-06-07,Inyo,027,18085,1406,1404,12,1416,35
2021-06-07,Kern,029,883053,97617,96645,11041,107686,1324
2021-06-07,Kings,031,150075,23218,23023,1097,24120,244
2021-06-07,Lake,033,64148,3554,3540,9,3549,45
2021-06-07,Lassen,035,31185,5243,5198,116,5314,18
2021-06-07,Los Angeles,037,10098052,1207641,1203664,41948,1245612,24413
2021-06-07,Madera,039,155013,16689,16572,943,17515,240
2021-06-07,Marin,041,260295,14149,14108,264,14372,229
2021-06-07,Mariposa,043,17540,436,434,11,445,5
2021-06-07,Mendocino,045,87422,4081,3998,82,4080,47
2021-06-07,Merced,047,269075,31123,31212,1061,32273,459
2021-06-07,Modoc,049,8938,389,375,136,511,3
2021-06-07,Mono,051,14174,1263,1275,17,1292,3
2021-06-07,Monterey,053,433212,43239,43077,1882,44959,415
2021-06-07,Napa,055,140530,9955,9962,38,10000,80
2021-06-07,Nevada,057,99092,4887,4860,194,5054,72
2021-06-07,Orange,059,3164182,255816,254808,11448,266256,5073
2021-06-07,Placer,061,380077,23521,23176,1525,24701,293
2021-06-07,Plumas,063,18699,712,692,11,703,4
2021-06-07,Riverside,065,2383286,294749,289232,14121,303353,4451
2021-06-07,Sacramento,067,1510023,107079,106841,1792,108633,1655
2021-06-07,San Benito,069,59416,6078,6074,116,6190,63
2021-06-07,San Bernardino,071,2135413,293880,293129,9025,302154,4775
2021-06-07,San Diego,073,3302833,281704,280808,15104,295912,3764
2021-06-07,San Francisco,075,870044,36904,37122,1301,38423,552
2021-06-07,San Joaquin,077,732212,73559,73130,3614,76744,1388
2021-06-07,San Luis Obispo,079,281455,21467,21252,752,22004,255
2021-06-07,San Mateo,081,765935,42540,42479,477,42956,664
2021-06-07,Santa Barbara,083,443738,34510,34407,1144,35551,459
2021-06-07,Santa Clara,085,1922200,118988,119743,774,120517,2066
2021-06-07,Santa Cruz,087,273765,16258,16159,815,16974,208
2021-06-07,Shasta,089,179085,12457,12483,1611,14094,200
2021-06-07,Sierra,091,2930,57,55,12,67,0
2021-06-07,Siskiyou,093,43540,1955,1869,373,2242,21
2021-06-07,Solano,095,438530,33117,33124,559,33683,258
2021-06-07,Sonoma,097,501317,30417,30504,351,30855,323
2021-06-07,Stanislaus,099,539301,56653,56521,5993,62514,972
2021-06-07,Sutter,101,95872,9541,9571,88,9659,111
2021-06-07,Tehama,103,63373,5124,5092,591,5683,63
2021-06-07,Trinity,105,12862,486,329,96,425,3
2021-06-07,Tulare,107,460477,50345,49471,9123,58594,847
2021-06-07,Tuolumne,109,53932,4030,4098,40,4138,63
2021-06-07,Ventura,111,848112,81556,81137,3016,84153,1025
2021-06-07,Yolo,113,214977,14047,14097,329,14426,211
2021-06-07,Yuba,115,75493,6124,6099,130,6229,49
2021-06-06,Alameda,001,1643700,88630,88636,1985,90621,1267
2021-06-06,Alpine,003,1148,87,88,0,88,0
2021-06-06,Amador,005,37829,3710,3696,33,3729,46
2021-06-06,Butte,007,227075,12671,12527,1819,14346,194
2021-06-06,Calaveras,009,45235,2184,2181,14,2195,55
2021-06-06,Colusa,011,21464,1955,1959,317,2276,15
2021-06-06,Contra Costa,013,1133247,70160,69659,1304,70963,817
2021-06-06,Del Norte,015,27424,1429,1401,13,1414,8
2021-06-06,El Dorado,017,186661,10352,10294,739,11033,113
2021-06-06,Fresno,019,978130,103041,102642,8759,111401,1717
2021-06-06,Glenn,021,27897,2440,2423,567,2990,19
2021-06-06,Humboldt,023,135768,4361,4353,38,4391,42
2021-06-06,Imperial,025,180216,28687,28762,2785,31547,738
2021-06-06,Inyo,027,18085,1405,1404,12,1416,35
2021-06-06,Kern,029,883053,97599,96623,11034,107657,1324
2021-06-06,Kings,031,150075,23212,23021,1097,24118,244
2021-06-06,Lake,033,64148,3554,3535,9,3544,45
2021-06-06,Lassen,035,31185,5241,5191,116,5307,18
2021-06-06,Los Angeles,037,10098052,1207441,1203539,41933,1245472,24410
2021-06-06,Madera,039,155013,16682,16567,943,17510,240
2021-06-06,Marin,041,260295,14143,14106,263,14369,229
2021-06-06,Mariposa,043,17540,435,435,11,446,5
2021-06-06,Mendocino,045,87422,4077,3993,82,4075,47
2021-06-06,Merced,047,269075,31117,31215,1060,32275,459
2021-06-06,Modoc,049,8938,389,375,135,510,3
2021-06-06,Mono,051,14174,1263,1275,17,1292,3
2021-06-06,Monterey,053,433212,43234,43078,1882,44960,415
2021-06-06,Napa,055,140530,9949,9963,38,10001,80
2021-06-06,Nevada,057,99092,4880,4854,193,5047,72
2021-06-06,Orange,059,3164182,255780,254782,11443,266225,5073
2021-06-06,Placer,061,380077,23496,23156,1522,24678,293
2021-06-06,Plumas,063,18699,712,692,11,703,4
2021-06-06,Riverside,065,2383286,294710,289201,14115,303316,4451
2021-06-06,Sacramento,067,1510023,106993,106749,1791,108540,1655
2021-06-06,San Benito,069,59416,6072,6074,116,6190,63
2021-06-06,San Bernardino,071,2135413,293824,293117,9016,302133,4773
2021-06-06,San Diego,073,3302833,281624,280743,15087,295830,3764
2021-06-06,San Francisco,075,870044,36891,37118,1299,38417,552
2021-06-06,San Joaquin,077,732212,73527,73105,3610,76715,1388
2021-06-06,San Luis Obispo,079,281455,21464,21246,752,21998,255
2021-06-06,San Mateo,081,765935,42523,42457,477,42934,664
2021-06-06,Santa Barbara,083,443738,34506,34403,1143,35546,459
2021-06-06,Santa Clara,085,1922200,118966,119711,774,120485,2066
2021-06-06,Santa Cruz,087,273765,16257,16158,815,16973,208
2021-06-06,Shasta,089,179085,12442,12478,1608,14086,200
2021-06-06,Sierra,091,2930,57,55,12,67,0
2021-06-06,Siskiyou,093,43540,1952,1869,373,2242,21
2021-06-06,Solano,095,438530,33090,33093,559,33652,258
2021-06-06,Sonoma,097,501317,30386,30478,350,30828,323
2021-06-06,Stanislaus,099,539301,56617,56486,5990,62476,972
2021-06-06,Sutter,101,95872,9534,9567,88,9655,111
2021-06-06,Tehama,103,63373,5114,5092,589,5681,63
2021-06-06,Trinity,105,12862,486,328,96,424,3
2021-06-06,Tulare,107,460477,50337,49466,9118,58584,847
2021-06-06,Tuolumne,109,53932,4028,4097,40,4137,63
2021-06-06,Ventura,111,848112,81545,81130,3013,84143,1025
2021-06-06,Yolo,113,214977,14039,14089,328,14417,210
2021-06-06,Yuba,115,75493,6116,6096,130,6226,49
2021-06-05,Alameda,001,1643700,88597,88612,1985,90597,1268
2021-06-05,Alpine,003,1148,87,88,0,88,0
2021-06-05,Amador,005,37829,3710,3694,33,3727,46
2021-06-05,Butte,007,227075,12665,12514,1818,14332,194
2021-06-05,Calaveras,009,45235,2184,2181,14,2195,55
2021-06-05,Colusa,011,21464,1955,1959,317,2276,15
2021-06-05,Contra Costa,013,1133247,70131,69601,1304,70905,817
2021-06-05,Del Norte,015,27424,1429,1400,13,1413,8
2021-06-05,El Dorado,017,186661,10350,10288,738,11026,113
2021-06-05,Fresno,019,978130,103032,102626,8759,111385,1717
2021-06-05,Glenn,021,27897,2439,2423,567,2990,19
2021-06-05,Humboldt,023,135768,4356,4346,38,4384,42
2021-06-05,Imperial,025,180216,28684,28764,2785,31549,738
2021-06-05,Inyo,027,18085,1405,1405,12,1417,35
2021-06-05,Kern,029,883053,97586,96597,11030,107627,1324
2021-06-05,Kings,031,150075,23209,23017,1097,24114,244
2021-06-05,Lake,033,64148,3551,3534,9,3543,45
2021-06-05,Lassen,035,31185,5240,5191,116,5307,18
2021-06-05,Los Angeles,037,10098052,1207314,1203338,41922,1245260,24411
2021-06-05,Madera,039,155013,16678,16563,943,17506,240
2021-06-05,Marin,041,260295,14141,14101,263,14364,229
2021-06-05,Mariposa,043,17540,435,435,11,446,5
2021-06-05,Mendocino,045,87422,4074,3989,82,4071,47
2021-06-05,Merced,047,269075,31115,31212,1059,32271,459
2021-06-05,Modoc,049,8938,389,375,134,509,3
2021-06-05,Mono,051,14174,1263,1274,17,1291,3
2021-06-05,Monterey,053,433212,43230,43071,1881,44952,415
2021-06-05,Napa,055,140530,9944,9960,38,9998,80
2021-06-05,Nevada,057,99092,4878,4849,193,5042,72
2021-06-05,Orange,059,3164182,255756,254752,11440,266192,5069
2021-06-05,Placer,061,380077,23480,23133,1522,24655,293
2021-06-05,Plumas,063,18699,712,692,11,703,4
2021-06-05,Riverside,065,2383286,294675,289157,14111,303268,4451
2021-06-05,Sacramento,067,1510023,106941,106688,1789,108477,1655
2021-06-05,San Benito,069,59416,6070,6074,116,6190,63
2021-06-05,San Bernardino,071,2135413,293791,293081,9014,302095,4772
2021-06-05,San Diego,073,3302833,281583,280676,15074,295750,3764
2021-06-05,San Francisco,075,870044,36882,37111,1299,38410,552
2021-06-05,San Joaquin,077,732212,73511,73078,3604,76682,1388
2021-06-05,San Luis Obispo,079,281455,21461,21236,752,21988,255
2021-06-05,San Mateo,081,765935,42513,42433,477,42910,664
2021-06-05,Santa Barbara,083,443738,34503,34399,1142,35541,459
2021-06-05,Santa Clara,085,1922200,118944,119676,772,120448,2066
2021-06-05,Santa Cruz,087,273765,16257,16154,815,16969,208
2021-06-05,Shasta,089,179085,12432,12472,1607,14079,200
2021-06-05,Sierra,091,2930,57,55,12,67,0
2021-06-05,Siskiyou,093,43540,1952,1867,373,2240,21
2021-06-05,Solano,095,438530,33075,33074,559,33633,257
2021-06-05,Sonoma,097,501317,30359,30450,348,30798,323
2021-06-05,Stanislaus,099,539301,56609,56463,5988,62451,973
2021-06-05,Sutter,101,95872,9531,9559,88,9647,111
2021-06-05,Tehama,103,63373,5113,5092,588,5680,63
2021-06-05,Trinity,105,12862,486,328,96,424,3
2021-06-05,Tulare,107,460477,50331,49463,9118,58581,847
2021-06-05,Tuolumne,109,53932,4026,4098,40,4138,63
2021-06-05,Ventura,111,848112,81536,81119,3011,84130,1025
2021-06-05,Yolo,113,214977,14037,14088,328,14416,210
2021-06-05,Yuba,115,75493,6115,6087,130,6217,49
2021-06-04,Alameda,001,1643700,88570,88585,1982,90567,1263
2021-06-04,Alpine,003,1148,87,88,0,88,0
2021-06-04,Amador,005,37829,3710,3690,33,3723,46
2021-06-04,Butte,007,227075,12654,12494,1815,14309,193
2021-06-04,Calaveras,009,45235,2184,2179,14,2193,55
2021-06-04,Colusa,011,21464,1955,1959,317,2276,15
2021-06-04,Contra Costa,013,1133247,70096,69540,1301,70841,816
2021-06-04,Del Norte,015,27424,1429,1398,13,1411,8
2021-06-04,El Dorado,017,186661,10346,10284,736,11020,112
2021-06-04,Fresno,019,978130,103016,102601,8759,111360,1712
2021-06-04,Glenn,021,27897,2439,2423,566,2989,19
2021-06-04,Humboldt,023,135768,4351,4327,38,4365,42
2021-06-04,Imperial,025,180216,28680,28753,2785,31538,738
2021-06-04,Inyo,027,18085,1405,1404,12,1416,35
2021-06-04,Kern,029,883053,97568,96573,11028,107601,1327
2021-06-04,Kings,031,150075,23208,23002,1097,24099,244
2021-06-04,Lake,033,64148,3549,3528,9,3537,45
2021-06-04,Lassen,035,31185,5240,5180,116,5296,18
2021-06-04,Los Angeles,037,10098052,1207190,1203106,41913,1245019,24400
2021-06-04,Madera,039,155013,16676,16557,943,17500,240
2021-06-04,Marin,041,260295,14140,14099,262,14361,229
2021-06-04,Mariposa,043,17540,435,435,11,446,5
2021-06-04,Mendocino,045,87422,4065,3983,82,4065,47
2021-06-04,Merced,047,269075,31110,31204,1058,32262,459
2021-06-04,Modoc,049,8938,387,375,134,509,3
2021-06-04,Mono,051,14174,1263,1275,17,1292,3
2021-06-04,Monterey,053,433212,43226,43068,1881,44949,415
2021-06-04,Napa,055,140530,9940,9958,38,9996,80
2021-06-04,Nevada,057,99092,4874,4844,193,5037,72
2021-06-04,Orange,059,3164182,255719,254730,11437,266167,5059
2021-06-04,Placer,061,380077,23464,23110,1521,24631,293
2021-06-04,Plumas,063,18699,712,691,11,702,4
2021-06-04,Riverside,065,2383286,294649,289098,14107,303205,4452
2021-06-04,Sacramento,067,1510023,106887,106616,1788,108404,1654
2021-06-04,San Benito,069,59416,6068,6073,116,6189,63
2021-06-04,San Bernardino,071,2135413,293768,293056,9012,302068,4768
2021-06-04,San Diego,073,3302833,281540,280556,15067,295623,3763
2021-06-04,San Francisco,075,870044,36877,37079,1298,38377,551
2021-06-04,San Joaquin,077,732212,73492,73039,3602,76641,1388
2021-06-04,San Luis Obispo,079,281455,21458,21234,751,21985,255
2021-06-04,San Mateo,081,765935,42501,42413,477,42890,478
2021-06-04,Santa Barbara,083,443738,34497,34402,1141,35543,459
2021-06-04,Santa Clara,085,1922200,118914,119619,772,120391,2065
2021-06-04,Santa Cruz,087,273765,16254,16150,815,16965,207
2021-06-04,Shasta,089,179085,12426,12458,1602,14060,200
2021-06-04,Sierra,091,2930,57,55,12,67,0
2021-06-04,Siskiyou,093,43540,1951,1865,373,2238,21
2021-06-04,Solano,095,438530,33064,33058,559,33617,256
2021-06-04,Sonoma,097,501317,30338,30411,348,30759,323
2021-06-04,Stanislaus,099,539301,56594,56442,5986,62428,973
2021-06-04,Sutter,101,95872,9526,9554,88,9642,111
2021-06-04,Tehama,103,63373,5108,5090,588,5678,63
2021-06-04,Trinity,105,12862,486,328,96,424,3
2021-06-04,Tulare,107,460477,50322,49452,9116,58568,847
2021-06-04,Tuolumne,109,53932,4025,4095,40,4135,63
2021-06-04,Ventura,111,848112,81529,81104,3009,84113,1023
2021-06-04,Yolo,113,214977,14035,14083,328,14411,210
2021-06-04,Yuba,115,75493,6112,6084,130,6214,49
2021-06-03,Alameda,001,1643700,88532,88555,1979,90534,1257
2021-06-03,Alpine,003,1148,87,88,0,88,0
2021-06-03,Amador,005,37829,3702,3688,33,3721,46
2021-06-03,Butte,007,227075,12650,12478,1814,14292,193
2021-06-03,Calaveras,009,45235,2184,2179,14,2193,55
2021-06-03,Colusa,011,21464,1955,1957,317,2274,15
2021-06-03,Contra Costa,013,1133247,70042,69500,1296,70796,816
2021-06-03,Del Norte,015,27424,1427,1397,13,1410,8
2021-06-03,El Dorado,017,186661,10340,10284,733,11017,112
2021-06-03,Fresno,019,978130,102999,102566,8759,111325,1709
2021-06-03,Glenn,021,27897,2439,2421,566,2987,19
2021-06-03,Humboldt,023,135768,4343,4314,38,4352,42
2021-06-03,Imperial,025,180216,28668,28737,2785,31522,738
2021-06-03,Inyo,027,18085,1405,1404,12,1416,35
2021-06-03,Kern,029,883053,97541,96507,11014,107521,1326
2021-06-03,Kings,031,150075,23204,22982,1097,24079,244
2021-06-03,Lake,033,64148,3547,3526,9,3535,45
2021-06-03,Lassen,035,31185,5231,5177,116,5293,12
2021-06-03,Los Angeles,037,10098052,1207015,1202923,41905,1244828,24386
2021-06-03,Madera,039,155013,16669,16554,943,17497,240
2021-06-03,Marin,041,260295,14135,14095,262,14357,230
2021-06-03,Mariposa,043,17540,435,435,11,446,5
2021-06-03,Mendocino,045,87422,4058,3978,82,4060,47
2021-06-03,Merced,047,269075,31107,31199,1058,32257,459
2021-06-03,Modoc,049,8938,386,376,133,509,3
2021-06-03,Mono,051,14174,1263,1275,17,1292,3
2021-06-03,Monterey,053,433212,43223,43063,1881,44944,415
2021-06-03,Napa,055,140530,9933,9957,38,9995,81
2021-06-03,Nevada,057,99092,4870,4837,193,5030,72
2021-06-03,Orange,059,3164182,255691,254676,11427,266103,5056
2021-06-03,Placer,061,380077,23455,23100,1520,24620,293
2021-06-03,Plumas,063,18699,712,691,11,702,4
2021-06-03,Riverside,065,2383286,294594,289035,14103,303138,4447
2021-06-03,Sacramento,067,1510023,106809,106526,1786,108312,1654
2021-06-03,San Benito,069,59416,6068,6073,116,6189,63
2021-06-03,San Bernardino,071,2135413,293736,293021,9012,302033,4762
2021-06-03,San Diego,073,3302833,281476,280430,15057,295487,3761
2021-06-03,San Francisco,075,870044,36871,37072,1298,38370,551
2021-06-03,San Joaquin,077,732212,73464,72989,3598,76587,1388
2021-06-03,San Luis Obispo,079,281455,21453,21224,751,21975,255
2021-06-03,San Mateo,081,765935,42488,42396,477,42873,467
2021-06-03,Santa Barbara,083,443738,34494,34391,1141,35532,459
2021-06-03,Santa Clara,085,1922200,118892,119592,770,120362,2058
2021-06-03,Santa Cruz,087,273765,16252,16144,815,16959,207
2021-06-03,Shasta,089,179085,12411,12441,1599,14040,199
2021-06-03,Sierra,091,2930,57,55,12,67,0
2021-06-03,Siskiyou,093,43540,1951,1862,372,2234,21
2021-06-03,Solano,095,438530,33050,33019,559,33578,256
2021-06-03,Sonoma,097,501317,30316,30383,347,30730,322
2021-06-03,Stanislaus,099,539301,56576,56401,5980,62381,973
2021-06-03,Sutter,101,95872,9517,9539,88,9627,111
2021-06-03,Tehama,103,63373,5108,5087,588,5675,63
2021-06-03,Trinity,105,12862,486,328,96,424,3
2021-06-03,Tulare,107,460477,50319,49442,9112,58554,848
2021-06-03,Tuolumne,109,53932,4023,4095,40,4135,63
2021-06-03,Ventura,111,848112,81517,81078,3007,84085,1023
2021-06-03,Yolo,113,214977,14031,14078,325,14403,210
2021-06-03,Yuba,115,75493,6105,6077,130,6207,49
2021-06-02,Alameda,001,1643700,88487,88525,1977,90502,1254
2021-06-02,Alpine,003,1148,87,88,0,88,0
2021-06-02,Amador,005,37829,3700,3687,33,3720,46
2021-06-02,Butte,007,227075,12630,12432,1811,14243,193
2021-06-02,Calaveras,009,45235,2181,2174,14,2188,55
2021-06-02,Colusa,011,21464,1954,1957,317,2274,15
2021-06-02,Contra Costa,013,1133247,69991,69455,1294,70749,814
2021-06-02,Del Norte,015,27424,1425,1395,13,1408,8
2021-06-02,El Dorado,017,186661,10336,10275,733,11008,110
2021-06-02,Fresno,019,978130,102975,102547,8756,111303,1707
2021-06-02,Glenn,021,27897,2439,2421,566,2987,19
2021-06-02,Humboldt,023,135768,4328,4302,38,4340,42
2021-06-02,Imperial,025,180216,28662,28737,2784,31521,738
2021-06-02,Inyo,027,18085,1404,1403,12,1415,35
2021-06-02,Kern,029,883053,97514,96481,11007,107488,1326
2021-06-02,Kings,031,150075,23202,22981,1097,24078,244
2021-06-02,Lake,033,64148,3542,3522,9,3531,45
2021-06-02,Lassen,035,31185,5230,5177,116,5293,6
2021-06-02,Los Angeles,037,10098052,1206811,1202760,41895,1244655,24375
2021-06-02,Madera,039,155013,16661,16550,943,17493,240
2021-06-02,Marin,041,260295,14133,14091,261,14352,229
2021-06-02,Mariposa,043,17540,435,434,11,445,5
2021-06-02,Mendocino,045,87422,4052,3970,82,4052,47
2021-06-02,Merced,047,269075,31094,31195,1057,32252,458
2021-06-02,Modoc,049,8938,385,375,132,507,3
2021-06-02,Mono,051,14174,1263,1275,17,1292,3
2021-06-02,Monterey,053,433212,43221,43056,1881,44937,380
2021-06-02,Napa,055,140530,9932,9953,38,9991,82
2021-06-02,Nevada,057,99092,4867,4833,193,5026,72
2021-06-02,Orange,059,3164182,255642,254637,11421,266058,5055
2021-06-02,Placer,061,380077,23434,23058,1518,24576,293
2021-06-02,Plumas,063,18699,712,690,11,701,4
2021-06-02,Riverside,065,2383286,294536,289012,14093,303105,4445
2021-06-02,Sacramento,067,1510023,106744,106435,1780,108215,1649
2021-06-02,San Benito,069,59416,6067,6073,116,6189,63
2021-06-02,San Bernardino,071,2135413,293688,293004,9007,302011,4760
2021-06-02,San Diego,073,3302833,281396,280347,15036,295383,3760
2021-06-02,San Francisco,075,870044,36851,37050,1297,38347,550
2021-06-02,San Joaquin,077,732212,73433,72893,3595,76488,1387
2021-06-02,San Luis Obispo,079,281455,21446,21214,750,21964,255
2021-06-02,San Mateo,081,765935,42478,42383,476,42859,464
2021-06-02,Santa Barbara,083,443738,34487,34381,1141,35522,456
2021-06-02,Santa Clara,085,1922200,118864,119553,769,120322,2058
2021-06-02,Santa Cruz,087,273765,16249,16144,815,16959,207
2021-06-02,Shasta,089,179085,12393,12426,1594,14020,199
2021-06-02,Sierra,091,2930,57,55,12,67,0
2021-06-02,Siskiyou,093,43540,1951,1861,370,2231,21
2021-06-02,Solano,095,438530,33038,33007,558,33565,256
2021-06-02,Sonoma,097,501317,30297,30359,342,30701,322
2021-06-02,Stanislaus,099,539301,56558,56377,5975,62352,973
2021-06-02,Sutter,101,95872,9514,9533,88,9621,111
2021-06-02,Tehama,103,63373,5105,5081,588,5669,63
2021-06-02,Trinity,105,12862,484,328,96,424,3
2021-06-02,Tulare,107,460477,50310,49434,9108,58542,846
2021-06-02,Tuolumne,109,53932,4022,4095,40,4135,63
2021-06-02,Ventura,111,848112,81492,81033,3007,84040,1020
2021-06-02,Yolo,113,214977,14028,14074,324,14398,210
2021-06-02,Yuba,115,75493,6099,6072,130,6202,48
2021-06-01,Alameda,001,1643700,88452,88472,1975,90447,1253
2021-06-01,Alpine,003,1148,87,88,0,88,0
2021-06-01,Amador,005,37829,3698,3687,33,3720,46
2021-06-01,Butte,007,227075,12616,12427,1810,14237,193
2021-06-01,Calaveras,009,45235,2179,2173,14,2187,55
2021-06-01,Colusa,011,21464,1953,1955,316,2271,15
2021-06-01,Contra Costa,013,1133247,69933,69404,1294,70698,813
2021-06-01,Del Norte,015,27424,1424,1394,13,1407,8
2021-06-01,El Dorado,017,186661,10330,10271,733,11004,110
2021-06-01,Fresno,019,978130,102951,102534,8753,111287,1706
2021-06-01,Glenn,021,27897,2439,2422,566,2988,18
2021-06-01,Humboldt,023,135768,4318,4299,38,4337,42
2021-06-01,Imperial,025,180216,28658,28722,2781,31503,736
2021-06-01,Inyo,027,18085,1404,1403,12,1415,35
2021-06-01,Kern,029,883053,97487,96477,10999,107476,1319
2021-06-01,Kings,031,150075,23198,22977,1097,24074,244
2021-06-01,Lake,033,64148,3541,3523,9,3532,45
2021-06-01,Lassen,035,31185,5223,5172,116,5288,6
2021-06-01,Los Angeles,037,10098052,1206576,1202673,41881,1244554,24367
2021-06-01,Madera,039,155013,16652,16549,942,17491,240
2021-06-01,Marin,041,260295,14131,14081,261,14342,229
2021-06-01,Mariposa,043,17540,435,431,11,442,5
2021-06-01,Mendocino,045,87422,4045,3966,82,4048,47
2021-06-01,Merced,047,269075,31084,31195,1057,32252,456
2021-06-01,Modoc,049,8938,383,375,132,507,3
2021-06-01,Mono,051,14174,1263,1275,17,1292,3
2021-06-01,Monterey,053,433212,43215,43051,1881,44932,379
2021-06-01,Napa,055,140530,9930,9949,38,9987,82
2021-06-01,Nevada,057,99092,4862,4825,193,5018,72
2021-06-01,Orange,059,3164182,255606,254603,11413,266016,5051
2021-06-01,Placer,061,380077,23404,23021,1516,24537,293
2021-06-01,Plumas,063,18699,711,690,11,701,4
2021-06-01,Riverside,065,2383286,294483,288996,14087,303083,4442
2021-06-01,Sacramento,067,1510023,106672,106330,1778,108108,1644
2021-06-01,San Benito,069,59416,6066,6073,115,6188,63
2021-06-01,San Bernardino,071,2135413,293663,292990,9006,301996,4758
2021-06-01,San Diego,073,3302833,281292,280305,15019,295324,3756
2021-06-01,San Francisco,075,870044,36835,37031,1297,38328,550
2021-06-01,San Joaquin,077,732212,73401,72858,3593,76451,1383
2021-06-01,San Luis Obispo,079,281455,21441,21217,750,21967,256
2021-06-01,San Mateo,081,765935,42462,42383,475,42858,462
2021-06-01,Santa Barbara,083,443738,34483,34374,1141,35515,456
2021-06-01,Santa Clara,085,1922200,118836,119528,769,120297,2057
2021-06-01,Santa Cruz,087,273765,16245,16143,814,16957,207
2021-06-01,Shasta,089,179085,12384,12409,1589,13998,199
2021-06-01,Sierra,091,2930,57,55,12,67,0
2021-06-01,Siskiyou,093,43540,1944,1860,369,2229,21
2021-06-01,Solano,095,438530,33013,32974,557,33531,256
2021-06-01,Sonoma,097,501317,30258,30324,341,30665,322
2021-06-01,Stanislaus,099,539301,56542,56348,5973,62321,973
2021-06-01,Sutter,101,95872,9507,9528,88,9616,111
2021-06-01,Tehama,103,63373,5103,5079,588,5667,63
2021-06-01,Trinity,105,12862,483,328,95,423,3
2021-06-01,Tulare,107,460477,50302,49419,9104,58523,845
2021-06-01,Tuolumne,109,53932,4022,4094,40,4134,63
2021-06-01,Ventura,111,848112,81476,81018,3006,84024,1021
2021-06-01,Yolo,113,214977,14022,14067,324,14391,210
2021-06-01,Yuba,115,75493,6095,6067,130,6197,48
2021-05-31,Alameda,001,1643700,88415,88458,1971,90429,1253
2021-05-31,Alpine,003,1148,87,88,0,88,0
2021-05-31,Amador,005,37829,3692,3687,33,3720,46
2021-05-31,Butte,007,227075,12603,12429,1810,14239,193
2021-05-31,Calaveras,009,45235,2178,2171,14,2185,55
2021-05-31,Colusa,011,21464,1953,1956,315,2271,15
2021-05-31,Contra Costa,013,1133247,69896,69390,1292,70682,813
2021-05-31,Del Norte,015,27424,1421,1394,13,1407,8
2021-05-31,El Dorado,017,186661,10324,10271,731,11002,110
2021-05-31,Fresno,019,978130,102915,102507,8753,111260,1706
2021-05-31,Glenn,021,27897,2438,2422,565,2987,18
2021-05-31,Humboldt,023,135768,4306,4295,38,4333,42
2021-05-31,Imperial,025,180216,28652,28732,2778,31510,736
2021-05-31,Inyo,027,18085,1403,1403,12,1415,35
2021-05-31,Kern,029,883053,97451,96457,10990,107447,1319
2021-05-31,Kings,031,150075,23194,22977,1097,24074,244
2021-05-31,Lake,033,64148,3536,3523,9,3532,45
2021-05-31,Lassen,035,31185,5221,5172,115,5287,6
2021-05-31,Los Angeles,037,10098052,1206334,1202567,41873,1244440,24364
2021-05-31,Madera,039,155013,16651,16543,941,17484,240
2021-05-31,Marin,041,260295,14129,14080,261,14341,229
2021-05-31,Mariposa,043,17540,435,430,11,441,5
2021-05-31,Mendocino,045,87422,4035,3961,82,4043,47
2021-05-31,Merced,047,269075,31079,31194,1057,32251,456
2021-05-31,Modoc,049,8938,382,374,132,506,3
2021-05-31,Mono,051,14174,1263,1275,17,1292,3
2021-05-31,Monterey,053,433212,43211,43051,1881,44932,379
2021-05-31,Napa,055,140530,9923,9948,38,9986,82
2021-05-31,Nevada,057,99092,4852,4823,192,5015,72
2021-05-31,Orange,059,3164182,255578,254572,11405,265977,5051
2021-05-31,Placer,061,380077,23377,23019,1512,24531,293
2021-05-31,Plumas,063,18699,710,690,11,701,4
2021-05-31,Riverside,065,2383286,294426,288970,14075,303045,4442
2021-05-31,Sacramento,067,1510023,106575,106278,1772,108050,1644
2021-05-31,San Benito,069,59416,6066,6072,115,6187,63
2021-05-31,San Bernardino,071,2135413,293615,292973,9005,301978,4758
2021-05-31,San Diego,073,3302833,281188,280254,15007,295261,3756
2021-05-31,San Francisco,075,870044,36820,37022,1296,38318,550
2021-05-31,San Joaquin,077,732212,73352,72856,3587,76443,1383
2021-05-31,San Luis Obispo,079,281455,21433,21215,750,21965,256
2021-05-31,San Mateo,081,765935,42446,42389,475,42864,442
2021-05-31,Santa Barbara,083,443738,34470,34369,1139,35508,456
2021-05-31,Santa Clara,085,1922200,118792,119515,769,120284,2057
2021-05-31,Santa Cruz,087,273765,16242,16139,814,16953,207
2021-05-31,Shasta,089,179085,12368,12408,1586,13994,199
2021-05-31,Sierra,091,2930,57,55,12,67,0
2021-05-31,Siskiyou,093,43540,1943,1856,368,2224,21
2021-05-31,Solano,095,438530,32963,32973,557,33530,256
2021-05-31,Sonoma,097,501317,30215,30314,341,30655,322
2021-05-31,Stanislaus,099,539301,56501,56335,5970,62305,973
2021-05-31,Sutter,101,95872,9488,9523,88,9611,111
2021-05-31,Tehama,103,63373,5100,5076,587,5663,63
2021-05-31,Trinity,105,12862,483,328,95,423,3
2021-05-31,Tulare,107,460477,50291,49404,9099,58503,845
2021-05-31,Tuolumne,109,53932,4020,4095,40,4135,63
2021-05-31,Ventura,111,848112,81461,81017,3003,84020,1021
2021-05-31,Yolo,113,214977,14018,14064,324,14388,210
2021-05-31,Yuba,115,75493,6089,6063,127,6190,48
2021-05-30,Alameda,001,1643700,88392,88429,1971,90400,1253
2021-05-30,Alpine,003,1148,87,88,0,88,0
2021-05-30,Amador,005,37829,3688,3685,33,3718,46
2021-05-30,Butte,007,227075,12593,12427,1808,14235,190
2021-05-30,Calaveras,009,45235,2174,2166,14,2180,55
2021-05-30,Colusa,011,21464,1953,1954,315,2269,15
2021-05-30,Contra Costa,013,1133247,69862,69381,1290,70671,813
2021-05-30,Del Norte,015,27424,1420,1393,13,1406,8
2021-05-30,El Dorado,017,186661,10321,10271,731,11002,110
2021-05-30,Fresno,019,978130,102898,102499,8749,111248,1706
2021-05-30,Glenn,021,27897,2438,2422,564,2986,18
2021-05-30,Humboldt,023,135768,4298,4291,38,4329,42
2021-05-30,Imperial,025,180216,28647,28732,2777,31509,736
2021-05-30,Inyo,027,18085,1403,1403,12,1415,35
2021-05-30,Kern,029,883053,97435,96443,10987,107430,1319
2021-05-30,Kings,031,150075,23193,22974,1096,24070,244
2021-05-30,Lake,033,64148,3536,3517,9,3526,45
2021-05-30,Lassen,035,31185,5219,5171,115,5286,6
2021-05-30,Los Angeles,037,10098052,1206225,1202425,41866,1244291,24360
2021-05-30,Madera,039,155013,16647,16538,941,17479,240
2021-05-30,Marin,041,260295,14125,14083,260,14343,229
2021-05-30,Mariposa,043,17540,435,430,11,441,5
2021-05-30,Mendocino,045,87422,4028,3955,82,4037,47
2021-05-30,Merced,047,269075,31075,31189,1056,32245,456
2021-05-30,Modoc,049,8938,382,374,132,506,3
2021-05-30,Mono,051,14174,1263,1275,17,1292,3
2021-05-30,Monterey,053,433212,43208,43049,1881,44930,379
2021-05-30,Napa,055,140530,9922,9948,38,9986,82
2021-05-30,Nevada,057,99092,4846,4818,192,5010,72
2021-05-30,Orange,059,3164182,255555,254559,11404,265963,5051
2021-05-30,Placer,061,380077,23371,23016,1512,24528,293
2021-05-30,Plumas,063,18699,708,690,11,701,4
2021-05-30,Riverside,065,2383286,294405,288961,14073,303034,4442
2021-05-30,Sacramento,067,1510023,106530,106252,1770,108022,1644
2021-05-30,San Benito,069,59416,6066,6072,115,6187,63
2021-05-30,San Bernardino,071,2135413,293589,292981,9004,301985,4758
2021-05-30,San Diego,073,3302833,281132,280209,15002,295211,3756
2021-05-30,San Francisco,075,870044,36801,37016,1296,38312,550
2021-05-30,San Joaquin,077,732212,73335,72853,3586,76439,1383
2021-05-30,San Luis Obispo,079,281455,21424,21211,749,21960,256
2021-05-30,San Mateo,081,765935,42438,42386,475,42861,439
2021-05-30,Santa Barbara,083,443738,34466,34369,1139,35508,456
2021-05-30,Santa Clara,085,1922200,118770,119510,765,120275,2057
2021-05-30,Santa Cruz,087,273765,16240,16140,814,16954,207
2021-05-30,Shasta,089,179085,12366,12408,1583,13991,199
2021-05-30,Sierra,091,2930,57,55,12,67,0
2021-05-30,Siskiyou,093,43540,1943,1856,368,2224,21
2021-05-30,Solano,095,438530,32952,32952,556,33508,256
2021-05-30,Sonoma,097,501317,30198,30310,340,30650,322
2021-05-30,Stanislaus,099,539301,56490,56323,5969,62292,973
2021-05-30,Sutter,101,95872,9487,9519,87,9606,111
2021-05-30,Tehama,103,63373,5100,5073,587,5660,63
2021-05-30,Trinity,105,12862,483,328,95,423,3
2021-05-30,Tulare,107,460477,50284,49397,9090,58487,845
2021-05-30,Tuolumne,109,53932,4020,4094,40,4134,63
2021-05-30,Ventura,111,848112,81457,81012,3002,84014,1021
2021-05-30,Yolo,113,214977,14013,14059,323,14382,210
2021-05-30,Yuba,115,75493,6082,6063,126,6189,48
2021-05-29,Alameda,001,1643700,88369,88433,1969,90402,1253
2021-05-29,Alpine,003,1148,87,88,0,88,0
2021-05-29,Amador,005,37829,3687,3683,33,3716,46
2021-05-29,Butte,007,227075,12587,12425,1808,14233,190
2021-05-29,Calaveras,009,45235,2173,2166,14,2180,55
2021-05-29,Colusa,011,21464,1950,1954,315,2269,15
2021-05-29,Contra Costa,013,1133247,69829,69351,1290,70641,813
2021-05-29,Del Norte,015,27424,1420,1391,13,1404,8
2021-05-29,El Dorado,017,186661,10320,10269,729,10998,110
2021-05-29,Fresno,019,978130,102886,102470,8746,111216,1706
2021-05-29,Glenn,021,27897,2438,2422,563,2985,18
2021-05-29,Humboldt,023,135768,4292,4283,38,4321,42
2021-05-29,Imperial,025,180216,28644,28729,2776,31505,736
2021-05-29,Inyo,027,18085,1403,1404,12,1416,35
2021-05-29,Kern,029,883053,97424,96424,10974,107398,1319
2021-05-29,Kings,031,150075,23192,22970,1095,24065,244
2021-05-29,Lake,033,64148,3536,3515,9,3524,45
2021-05-29,Lassen,035,31185,5219,5171,115,5286,6
2021-05-29,Los Angeles,037,10098052,1206102,1202264,41862,1244126,24359
2021-05-29,Madera,039,155013,16645,16535,941,17476,240
2021-05-29,Marin,041,260295,14121,14071,259,14330,229
2021-05-29,Mariposa,043,17540,434,428,11,439,5
2021-05-29,Mendocino,045,87422,4022,3952,82,4034,47
2021-05-29,Merced,047,269075,31063,31187,1056,32243,456
2021-05-29,Modoc,049,8938,382,374,132,506,3
2021-05-29,Mono,051,14174,1263,1275,17,1292,3
2021-05-29,Monterey,053,433212,43206,43042,1881,44923,379
2021-05-29,Napa,055,140530,9919,9948,38,9986,82
2021-05-29,Nevada,057,99092,4845,4816,192,5008,72
2021-05-29,Orange,059,3164182,255533,254537,11394,265931,5049
2021-05-29,Placer,061,380077,23356,23009,1511,24520,293
2021-05-29,Plumas,063,18699,708,689,11,700,4
2021-05-29,Riverside,065,2383286,294385,288908,14072,302980,4442
2021-05-29,Sacramento,067,1510023,106500,106218,1769,107987,1643
2021-05-29,San Benito,069,59416,6065,6072,115,6187,63
2021-05-29,San Bernardino,071,2135413,293557,292961,9003,301964,4757
2021-05-29,San Diego,073,3302833,281073,280151,14997,295148,3756
2021-05-29,San Francisco,075,870044,36792,37008,1296,38304,550
2021-05-29,San Joaquin,077,732212,73319,72827,3584,76411,1383
2021-05-29,San Luis Obispo,079,281455,21422,21201,749,21950,256
2021-05-29,San Mateo,081,765935,42430,42375,474,42849,439
2021-05-29,Santa Barbara,083,443738,34462,34367,1139,35506,456
2021-05-29,Santa Clara,085,1922200,118746,119498,764,120262,2056
2021-05-29,Santa Cruz,087,273765,16239,16137,814,16951,207
2021-05-29,Shasta,089,179085,12358,12401,1582,13983,199
2021-05-29,Sierra,091,2930,57,55,12,67,0
2021-05-29,Siskiyou,093,43540,1938,1856,368,2224,21
2021-05-29,Solano,095,438530,32943,32917,556,33473,256
2021-05-29,Sonoma,097,501317,30175,30298,339,30637,322
2021-05-29,Stanislaus,099,539301,56472,56305,5967,62272,974
2021-05-29,Sutter,101,95872,9483,9516,87,9603,111
2021-05-29,Tehama,103,63373,5099,5070,587,5657,63
2021-05-29,Trinity,105,12862,483,328,95,423,3
2021-05-29,Tulare,107,460477,50274,49392,9086,58478,845
2021-05-29,Tuolumne,109,53932,4020,4093,40,4133,63
2021-05-29,Ventura,111,848112,81449,81008,3002,84010,1021
2021-05-29,Yolo,113,214977,14012,14055,323,14378,210
2021-05-29,Yuba,115,75493,6082,6059,126,6185,48
2021-05-28,Alameda,001,1643700,88345,88391,1965,90356,1261
2021-05-28,Alpine,003,1148,87,88,0,88,0
2021-05-28,Amador,005,37829,3687,3680,33,3713,46
2021-05-28,Butte,007,227075,12584,12407,1807,14214,190
2021-05-28,Calaveras,009,45235,2172,2165,14,2179,55
2021-05-28,Colusa,011,21464,1950,1954,313,2267,15
2021-05-28,Contra Costa,013,1133247,69793,69290,1289,70579,813
2021-05-28,Del Norte,015,27424,1419,1390,13,1403,8
2021-05-28,El Dorado,017,186661,10317,10265,729,10994,110
2021-05-28,Fresno,019,978130,102871,102437,8746,111183,1705
2021-05-28,Glenn,021,27897,2438,2419,563,2982,18
2021-05-28,Humboldt,023,135768,4285,4265,38,4303,42
2021-05-28,Imperial,025,180216,28641,28722,2776,31498,736
2021-05-28,Inyo,027,18085,1403,1404,12,1416,35
2021-05-28,Kern,029,883053,97407,96396,10966,107362,1320
2021-05-28,Kings,031,150075,23190,22962,1095,24057,244
2021-05-28,Lake,033,64148,3534,3515,9,3524,45
2021-05-28,Lassen,035,31185,5219,5169,115,5284,6
2021-05-28,Los Angeles,037,10098052,1205992,1202103,41851,1243954,24357
2021-05-28,Madera,039,155013,16643,16530,941,17471,240
2021-05-28,Marin,041,260295,14120,14063,258,14321,229
2021-05-28,Mariposa,043,17540,434,428,11,439,5
2021-05-28,Mendocino,045,87422,4017,3947,82,4029,47
2021-05-28,Merced,047,269075,31060,31176,1056,32232,455
2021-05-28,Modoc,049,8938,382,374,132,506,3
2021-05-28,Mono,051,14174,1263,1274,17,1291,3
2021-05-28,Monterey,053,433212,43205,43036,1881,44917,379
2021-05-28,Napa,055,140530,9919,9941,38,9979,82
2021-05-28,Nevada,057,99092,4843,4813,192,5005,71
2021-05-28,Orange,059,3164182,255513,254494,11392,265886,5047
2021-05-28,Placer,061,380077,23346,22987,1509,24496,293
2021-05-28,Plumas,063,18699,706,688,11,699,4
2021-05-28,Riverside,065,2383286,294363,288872,14070,302942,4442
2021-05-28,Sacramento,067,1510023,106444,106131,1767,107898,1642
2021-05-28,San Benito,069,59416,6065,6074,115,6189,63
2021-05-28,San Bernardino,071,2135413,293534,292905,9003,301908,4757
2021-05-28,San Diego,073,3302833,281010,280043,14986,295029,3756
2021-05-28,San Francisco,075,870044,36786,36987,1296,38283,546
2021-05-28,San Joaquin,077,732212,73289,72793,3582,76375,1383
2021-05-28,San Luis Obispo,079,281455,21417,21190,747,21937,256
2021-05-28,San Mateo,081,765935,42424,42364,474,42838,439
2021-05-28,Santa Barbara,083,443738,34461,34371,1139,35510,455
2021-05-28,Santa Clara,085,1922200,118722,119462,764,120226,2056
2021-05-28,Santa Cruz,087,273765,16238,16129,814,16943,207
2021-05-28,Shasta,089,179085,12349,12383,1580,13963,198
2021-05-28,Sierra,091,2930,57,54,12,66,0
2021-05-28,Siskiyou,093,43540,1936,1850,368,2218,19
2021-05-28,Solano,095,438530,32928,32892,556,33448,256
2021-05-28,Sonoma,097,501317,30156,30270,339,30609,321
2021-05-28,Stanislaus,099,539301,56454,56278,5964,62242,974
2021-05-28,Sutter,101,95872,9479,9511,87,9598,111
2021-05-28,Tehama,103,63373,5093,5064,587,5651,63
2021-05-28,Trinity,105,12862,483,328,95,423,3
2021-05-28,Tulare,107,460477,50269,49375,9077,58452,846
2021-05-28,Tuolumne,109,53932,4020,4090,40,4130,63
2021-05-28,Ventura,111,848112,81438,80985,3001,83986,1021
2021-05-28,Yolo,113,214977,14009,14050,322,14372,210
2021-05-28,Yuba,115,75493,6080,6050,125,6175,48
2021-05-27,Alameda,001,1643700,88310,88342,1964,90306,1274
2021-05-27,Alpine,003,1148,87,88,0,88,0
2021-05-27,Amador,005,37829,3684,3680,33,3713,46
2021-05-27,Butte,007,227075,12579,12401,1806,14207,190
2021-05-27,Calaveras,009,45235,2171,2163,14,2177,55
2021-05-27,Colusa,011,21464,1947,1952,313,2265,15
2021-05-27,Contra Costa,013,1133247,69751,69245,1287,70532,813
2021-05-27,Del Norte,015,27424,1419,1388,13,1401,8
2021-05-27,El Dorado,017,186661,10316,10248,729,10977,112
2021-05-27,Fresno,019,978130,102854,102413,8743,111156,1704
2021-05-27,Glenn,021,27897,2438,2415,563,2978,18
2021-05-27,Humboldt,023,135768,4277,4260,38,4298,42
2021-05-27,Imperial,025,180216,28630,28728,2776,31504,736
2021-05-27,Inyo,027,18085,1403,1404,12,1416,35
2021-05-27,Kern,029,883053,97391,96364,10958,107322,1322
2021-05-27,Kings,031,150075,23187,22953,1095,24048,245
2021-05-27,Lake,033,64148,3529,3509,9,3518,45
2021-05-27,Lassen,035,31185,5218,5170,114,5284,6
2021-05-27,Los Angeles,037,10098052,1205829,1201927,41835,1243762,24348
2021-05-27,Madera,039,155013,16634,16527,941,17468,240
2021-05-27,Marin,041,260295,14116,14061,258,14319,229
2021-05-27,Mariposa,043,17540,432,427,11,438,5
2021-05-27,Mendocino,045,87422,4011,3945,82,4027,47
2021-05-27,Merced,047,269075,31048,31161,1056,32217,455
2021-05-27,Modoc,049,8938,381,374,132,506,3
2021-05-27,Mono,051,14174,1263,1276,17,1293,3
2021-05-27,Monterey,053,433212,43199,43032,1881,44913,379
2021-05-27,Napa,055,140530,9918,9934,38,9972,82
2021-05-27,Nevada,057,99092,4839,4807,190,4997,71
2021-05-27,Orange,059,3164182,255476,254438,11388,265826,5059
2021-05-27,Placer,061,380077,23337,22966,1509,24475,293
2021-05-27,Plumas,063,18699,706,687,11,698,4
2021-05-27,Riverside,065,2383286,294327,288835,14065,302900,4443
2021-05-27,Sacramento,067,1510023,106369,106015,1765,107780,1642
2021-05-27,San Benito,069,59416,6064,6074,115,6189,63
2021-05-27,San Bernardino,071,2135413,293498,292755,9001,301756,4756
2021-05-27,San Diego,073,3302833,280936,279960,14972,294932,3756
2021-05-27,San Francisco,075,870044,36780,36980,1293,38273,546
2021-05-27,San Joaquin,077,732212,73257,72714,3578,76292,1388
2021-05-27,San Luis Obispo,079,281455,21412,21171,747,21918,256
2021-05-27,San Mateo,081,765935,42415,42345,474,42819,436
2021-05-27,Santa Barbara,083,443738,34456,34355,1139,35494,456
2021-05-27,Santa Clara,085,1922200,118701,119452,764,120216,2053
2021-05-27,Santa Cruz,087,273765,16236,16134,814,16948,207
2021-05-27,Shasta,089,179085,12338,12380,1580,13960,202
2021-05-27,Sierra,091,2930,57,54,12,66,0
2021-05-27,Siskiyou,093,43540,1933,1846,368,2214,18
2021-05-27,Solano,095,438530,32887,32855,555,33410,257
2021-05-27,Sonoma,097,501317,30129,30253,335,30588,321
2021-05-27,Stanislaus,099,539301,56429,56207,5963,62170,974
2021-05-27,Sutter,101,95872,9475,9501,87,9588,111
2021-05-27,Tehama,103,63373,5090,5064,586,5650,63
2021-05-27,Trinity,105,12862,483,328,95,423,3
2021-05-27,Tulare,107,460477,50255,49366,9068,58434,840
2021-05-27,Tuolumne,109,53932,4019,4090,40,4130,66
2021-05-27,Ventura,111,848112,81425,80965,2998,83963,1023
2021-05-27,Yolo,113,214977,14006,14036,322,14358,213
2021-05-27,Yuba,115,75493,6075,6040,124,6164,48
2021-05-26,Alameda,001,1643700,88281,88297,1964,90261,1266
2021-05-26,Alpine,003,1148,87,88,0,88,0
2021-05-26,Amador,005,37829,3684,3679,33,3712,46
2021-05-26,Butte,007,227075,12570,12332,1805,14137,190
2021-05-26,Calaveras,009,45235,2170,2154,14,2168,55
2021-05-26,Colusa,011,21464,1946,1952,313,2265,15
2021-05-26,Contra Costa,013,1133247,69714,69210,1287,70497,812
2021-05-26,Del Norte,015,27424,1419,1386,12,1398,8
2021-05-26,El Dorado,017,186661,10312,10242,728,10970,112
2021-05-26,Fresno,019,978130,102822,102374,8738,111112,1702
2021-05-26,Glenn,021,27897,2437,2415,563,2978,18
2021-05-26,Humboldt,023,135768,4272,4246,38,4284,42
2021-05-26,Imperial,025,180216,28625,28712,2774,31486,734
2021-05-26,Inyo,027,18085,1403,1403,12,1415,36
2021-05-26,Kern,029,883053,97366,96343,10951,107294,1320
2021-05-26,Kings,031,150075,23183,22950,1094,24044,245
2021-05-26,Lake,033,64148,3528,3508,9,3517,45
2021-05-26,Lassen,035,31185,5217,5164,114,5278,6
2021-05-26,Los Angeles,037,10098052,1205663,1198100,41818,1239918,24221
2021-05-26,Madera,039,155013,16631,16520,941,17461,240
2021-05-26,Marin,041,260295,14113,14061,257,14318,227
2021-05-26,Mariposa,043,17540,432,427,11,438,5
2021-05-26,Mendocino,045,87422,4005,3938,82,4020,47
2021-05-26,Merced,047,269075,31039,31139,1056,32195,455
2021-05-26,Modoc,049,8938,381,371,131,502,3
2021-05-26,Mono,051,14174,1263,1274,17,1291,3
2021-05-26,Monterey,053,433212,43193,43018,1880,44898,379
2021-05-26,Napa,055,140530,9911,9932,36,9968,82
2021-05-26,Nevada,057,99092,4834,4803,190,4993,70
2021-05-26,Orange,059,3164182,255440,254368,11385,265753,5058
2021-05-26,Placer,061,380077,23313,22940,1509,24449,293
2021-05-26,Plumas,063,18699,705,685,11,696,4
2021-05-26,Riverside,065,2383286,294281,288782,14058,302840,4443
2021-05-26,Sacramento,067,1510023,106283,105919,1761,107680,1637
2021-05-26,San Benito,069,59416,6064,6074,115,6189,63
2021-05-26,San Bernardino,071,2135413,293462,292662,9000,301662,4755
2021-05-26,San Diego,073,3302833,280861,279859,14962,294821,3755
2021-05-26,San Francisco,075,870044,36768,36954,1293,38247,546
2021-05-26,San Joaquin,077,732212,73215,72681,3575,76256,1388
2021-05-26,San Luis Obispo,079,281455,21406,21163,747,21910,256
2021-05-26,San Mateo,081,765935,42406,42331,474,42805,436
2021-05-26,Santa Barbara,083,443738,34447,34348,1139,35487,459
2021-05-26,Santa Clara,085,1922200,118674,119421,763,120184,2031
2021-05-26,Santa Cruz,087,273765,16235,16139,814,16953,207
2021-05-26,Shasta,089,179085,12324,12357,1577,13934,202
2021-05-26,Sierra,091,2930,57,54,12,66,0
2021-05-26,Siskiyou,093,43540,1931,1847,366,2213,18
2021-05-26,Solano,095,438530,32851,32831,555,33386,257
2021-05-26,Sonoma,097,501317,30102,30230,335,30565,321
2021-05-26,Stanislaus,099,539301,56407,56193,5961,62154,974
2021-05-26,Sutter,101,95872,9470,9495,87,9582,112
2021-05-26,Tehama,103,63373,5089,5054,583,5637,63
2021-05-26,Trinity,105,12862,483,328,95,423,3
2021-05-26,Tulare,107,460477,50248,49352,9064,58416,839
2021-05-26,Tuolumne,109,53932,4015,4088,39,4127,66
2021-05-26,Ventura,111,848112,81402,80944,2996,83940,1023
2021-05-26,Yolo,113,214977,14003,14025,322,14347,213
2021-05-26,Yuba,115,75493,6070,6036,124,6160,49
2021-05-25,Alameda,001,1643700,88251,88237,1964,90201,1263
2021-05-25,Alpine,003,1148,87,88,0,88,0
2021-05-25,Amador,005,37829,3679,3676,33,3709,46
2021-05-25,Butte,007,227075,12559,12295,1804,14099,189
2021-05-25,Calaveras,009,45235,2168,2148,14,2162,55
2021-05-25,Colusa,011,21464,1945,1949,313,2262,15
2021-05-25,Contra Costa,013,1133247,69662,69167,1282,70449,809
2021-05-25,Del Norte,015,27424,1419,1385,12,1397,8
2021-05-25,El Dorado,017,186661,10305,10240,727,10967,112
2021-05-25,Fresno,019,978130,102800,102329,8736,111065,1701
2021-05-25,Glenn,021,27897,2436,2414,562,2976,17
2021-05-25,Humboldt,023,135768,4265,4231,36,4267,42
2021-05-25,Imperial,025,180216,28618,28586,2774,31360,735
2021-05-25,Inyo,027,18085,1403,1402,12,1414,36
2021-05-25,Kern,029,883053,97335,96319,10937,107256,1319
2021-05-25,Kings,031,150075,23176,22944,1094,24038,245
2021-05-25,Lake,033,64148,3527,3508,9,3517,44
2021-05-25,Lassen,035,31185,5213,5164,114,5278,6
2021-05-25,Los Angeles,037,10098052,1205484,1197940,41799,1239739,24212
2021-05-25,Madera,039,155013,16626,16519,940,17459,240
2021-05-25,Marin,041,260295,14107,14053,257,14310,227
2021-05-25,Mariposa,043,17540,431,427,11,438,5
2021-05-25,Mendocino,045,87422,4000,3928,82,4010,47
2021-05-25,Merced,047,269075,31018,31132,1056,32188,455
2021-05-25,Modoc,049,8938,380,367,131,498,3
2021-05-25,Mono,051,14174,1263,1274,17,1291,3
2021-05-25,Monterey,053,433212,43189,43012,1879,44891,379
2021-05-25,Napa,055,140530,9909,9926,36,9962,82
2021-05-25,Nevada,057,99092,4828,4795,190,4985,70
2021-05-25,Orange,059,3164182,255411,254321,11384,265705,5057
2021-05-25,Placer,061,380077,23302,22920,1507,24427,292
2021-05-25,Plumas,063,18699,705,684,11,695,4
2021-05-25,Riverside,065,2383286,294242,288725,14055,302780,4443
2021-05-25,Sacramento,067,1510023,106202,105828,1757,107585,1633
2021-05-25,San Benito,069,59416,6064,6073,115,6188,63
2021-05-25,San Bernardino,071,2135413,293402,292485,8998,301483,4755
2021-05-25,San Diego,073,3302833,280779,279786,14957,294743,3753
2021-05-25,San Francisco,075,870044,36745,36939,1293,38232,546
2021-05-25,San Joaquin,077,732212,73173,72628,3572,76200,1387
2021-05-25,San Luis Obispo,079,281455,21403,21153,747,21900,256
2021-05-25,San Mateo,081,765935,42396,42268,474,42742,435
2021-05-25,Santa Barbara,083,443738,34444,34337,1139,35476,459
2021-05-25,Santa Clara,085,1922200,118650,119393,762,120155,2032
2021-05-25,Santa Cruz,087,273765,16230,16141,814,16955,207
2021-05-25,Shasta,089,179085,12315,12328,1575,13903,202
2021-05-25,Sierra,091,2930,56,54,12,66,0
2021-05-25,Siskiyou,093,43540,1930,1845,365,2210,18
2021-05-25,Solano,095,438530,32832,32817,554,33371,256
2021-05-25,Sonoma,097,501317,30073,30207,334,30541,321
2021-05-25,Stanislaus,099,539301,56371,56168,5958,62126,974
2021-05-25,Sutter,101,95872,9466,9495,87,9582,112
2021-05-25,Tehama,103,63373,5086,5048,582,5630,63
2021-05-25,Trinity,105,12862,483,328,94,422,3
2021-05-25,Tulare,107,460477,50238,49326,9056,58382,838
2021-05-25,Tuolumne,109,53932,4015,4084,39,4123,66
2021-05-25,Ventura,111,848112,81384,80905,2996,83901,1022
2021-05-25,Yolo,113,214977,13995,14018,320,14338,213
2021-05-25,Yuba,115,75493,6063,6028,124,6152,49
2021-05-24,Alameda,001,1643700,88209,88182,1963,90145,1263
2021-05-24,Alpine,003,1148,87,88,0,88,0
2021-05-24,Amador,005,37829,3677,3675,33,3708,46
2021-05-24,Butte,007,227075,12546,12279,1801,14080,189
2021-05-24,Calaveras,009,45235,2166,2146,14,2160,54
2021-05-24,Colusa,011,21464,1945,1949,313,2262,15
2021-05-24,Contra Costa,013,1133247,69621,69107,1278,70385,809
2021-05-24,Del Norte,015,27424,1418,1384,12,1396,8
2021-05-24,El Dorado,017,186661,10295,10227,726,10953,112
2021-05-24,Fresno,019,978130,102758,102289,8735,111024,1698
2021-05-24,Glenn,021,27897,2436,2413,562,2975,17
2021-05-24,Humboldt,023,135768,4258,4225,36,4261,42
2021-05-24,Imperial,025,180216,28616,28575,2774,31349,735
2021-05-24,Inyo,027,18085,1403,1402,12,1414,36
2021-05-24,Kern,029,883053,97308,96296,10932,107228,1319
2021-05-24,Kings,031,150075,23172,22940,1094,24034,246
2021-05-24,Lake,033,64148,3525,3506,9,3515,43
2021-05-24,Lassen,035,31185,5209,5163,114,5277,6
2021-05-24,Los Angeles,037,10098052,1205310,1197782,41784,1239566,24201
2021-05-24,Madera,039,155013,16622,16513,939,17452,239
2021-05-24,Marin,041,260295,14105,14051,257,14308,227
2021-05-24,Mariposa,043,17540,430,427,11,438,5
2021-05-24,Mendocino,045,87422,3998,3919,82,4001,47
2021-05-24,Merced,047,269075,31008,31128,1055,32183,455
2021-05-24,Modoc,049,8938,380,366,130,496,3
2021-05-24,Mono,051,14174,1263,1270,17,1287,3
2021-05-24,Monterey,053,433212,43184,43005,1878,44883,379
2021-05-24,Napa,055,140530,9909,9924,36,9960,82
2021-05-24,Nevada,057,99092,4825,4790,190,4980,70
2021-05-24,Orange,059,3164182,255377,254287,11374,265661,5056
2021-05-24,Placer,061,380077,23283,22895,1506,24401,292
2021-05-24,Plumas,063,18699,704,683,11,694,4
2021-05-24,Riverside,065,2383286,294185,288669,14045,302714,4442
2021-05-24,Sacramento,067,1510023,106087,105716,1755,107471,1632
2021-05-24,San Benito,069,59416,6064,6072,115,6187,63
2021-05-24,San Bernardino,071,2135413,293362,292343,8997,301340,4747
2021-05-24,San Diego,073,3302833,280670,279715,14947,294662,3749
2021-05-24,San Francisco,075,870044,36725,36934,1291,38225,547
2021-05-24,San Joaquin,077,732212,73141,72586,3571,76157,1371
2021-05-24,San Luis Obispo,079,281455,21385,21146,746,21892,256
2021-05-24,San Mateo,081,765935,42386,42249,474,42723,433
2021-05-24,Santa Barbara,083,443738,34439,34322,1139,35461,459
2021-05-24,Santa Clara,085,1922200,118618,119358,762,120120,2030
2021-05-24,Santa Cruz,087,273765,16224,16135,814,16949,207
2021-05-24,Shasta,089,179085,12298,12315,1572,13887,201
2021-05-24,Sierra,091,2930,56,54,12,66,0
2021-05-24,Siskiyou,093,43540,1927,1840,365,2205,17
2021-05-24,Solano,095,438530,32807,32792,553,33345,254
2021-05-24,Sonoma,097,501317,30058,30187,334,30521,321
2021-05-24,Stanislaus,099,539301,56337,56128,5954,62082,974
2021-05-24,Sutter,101,95872,9460,9486,87,9573,113
2021-05-24,Tehama,103,63373,5083,5043,580,5623,63
2021-05-24,Trinity,105,12862,483,328,94,422,3
2021-05-24,Tulare,107,460477,50231,49318,9052,58370,838
2021-05-24,Tuolumne,109,53932,4015,4083,39,4122,65
2021-05-24,Ventura,111,848112,81371,80876,2994,83870,1022
2021-05-24,Yolo,113,214977,13978,14012,318,14330,213
2021-05-24,Yuba,115,75493,6054,6022,124,6146,49
2021-05-23,Alameda,001,1643700,88145,88157,1960,90117,1263
2021-05-23,Alpine,003,1148,87,88,0,88,0
2021-05-23,Amador,005,37829,3676,3673,33,3706,46
2021-05-23,Butte,007,227075,12532,12271,1800,14071,189
2021-05-23,Calaveras,009,45235,2158,2144,14,2158,54
2021-05-23,Colusa,011,21464,1945,1949,311,2260,15
2021-05-23,Contra Costa,013,1133247,69577,69075,1276,70351,809
2021-05-23,Del Norte,015,27424,1414,1383,12,1395,8
2021-05-23,El Dorado,017,186661,10289,10222,726,10948,112
2021-05-23,Fresno,019,978130,102713,102270,8730,111000,1698
2021-05-23,Glenn,021,27897,2434,2413,562,2975,17
2021-05-23,Humboldt,023,135768,4241,4216,36,4252,42
2021-05-23,Imperial,025,180216,28610,28569,2773,31342,735
2021-05-23,Inyo,027,18085,1403,1402,12,1414,36
2021-05-23,Kern,029,883053,97284,96282,10924,107206,1319
2021-05-23,Kings,031,150075,23159,22939,1092,24031,246
2021-05-23,Lake,033,64148,3522,3504,9,3513,43
2021-05-23,Lassen,035,31185,5205,5163,113,5276,6
2021-05-23,Los Angeles,037,10098052,1205123,1197633,41772,1239405,24197
2021-05-23,Madera,039,155013,16616,16504,939,17443,239
2021-05-23,Marin,041,260295,14096,14048,256,14304,227
2021-05-23,Mariposa,043,17540,430,427,11,438,5
2021-05-23,Mendocino,045,87422,3992,3913,81,3994,47
2021-05-23,Merced,047,269075,30998,31118,1055,32173,455
2021-05-23,Modoc,049,8938,376,366,130,496,3
2021-05-23,Mono,051,14174,1262,1270,17,1287,3
2021-05-23,Monterey,053,433212,43174,43003,1878,44881,379
2021-05-23,Napa,055,140530,9905,9923,36,9959,82
2021-05-23,Nevada,057,99092,4815,4790,190,4980,70
2021-05-23,Orange,059,3164182,255339,254277,11368,265645,5050
2021-05-23,Placer,061,380077,23263,22888,1506,24394,292
2021-05-23,Plumas,063,18699,703,683,11,694,4
2021-05-23,Riverside,065,2383286,294117,288641,14041,302682,4442
2021-05-23,Sacramento,067,1510023,105971,105663,1752,107415,1632
2021-05-23,San Benito,069,59416,6063,6072,115,6187,63
2021-05-23,San Bernardino,071,2135413,293311,292327,8996,301323,4747
2021-05-23,San Diego,073,3302833,280580,279690,14936,294626,3751
2021-05-23,San Francisco,075,870044,36714,36927,1290,38217,547
2021-05-23,San Joaquin,077,732212,73092,72571,3568,76139,1371
2021-05-23,San Luis Obispo,079,281455,21375,21141,745,21886,256
2021-05-23,San Mateo,081,765935,42369,42248,474,42722,433
2021-05-23,Santa Barbara,083,443738,34432,34319,1139,35458,459
2021-05-23,Santa Clara,085,1922200,118594,119333,762,120095,2030
2021-05-23,Santa Cruz,087,273765,16221,16130,814,16944,207
2021-05-23,Shasta,089,179085,12281,12313,1568,13881,201
2021-05-23,Sierra,091,2930,56,54,12,66,0
2021-05-23,Siskiyou,093,43540,1922,1826,358,2184,17
2021-05-23,Solano,095,438530,32789,32780,552,33332,254
2021-05-23,Sonoma,097,501317,30029,30168,333,30501,321
2021-05-23,Stanislaus,099,539301,56289,56104,5951,62055,974
2021-05-23,Sutter,101,95872,9451,9479,87,9566,113
2021-05-23,Tehama,103,63373,5076,5041,578,5619,63
2021-05-23,Trinity,105,12862,483,328,94,422,3
2021-05-23,Tulare,107,460477,50217,49310,9048,58358,838
2021-05-23,Tuolumne,109,53932,4012,4081,39,4120,65
2021-05-23,Ventura,111,848112,81341,80872,2993,83865,1022
2021-05-23,Yolo,113,214977,13966,14004,315,14319,213
2021-05-23,Yuba,115,75493,6049,6017,124,6141,49
2021-05-22,Alameda,001,1643700,88118,88101,1960,90061,1263
2021-05-22,Alpine,003,1148,87,88,0,88,0
2021-05-22,Amador,005,37829,3675,3672,33,3705,46
2021-05-22,Butte,007,227075,12520,12265,1799,14064,189
2021-05-22,Calaveras,009,45235,2154,2141,14,2155,54
2021-05-22,Colusa,011,21464,1941,1949,310,2259,15
2021-05-22,Contra Costa,013,1133247,69544,69004,1275,70279,809
2021-05-22,Del Norte,015,27424,1413,1381,12,1393,8
2021-05-22,El Dorado,017,186661,10284,10215,726,10941,112
2021-05-22,Fresno,019,978130,102699,102238,8728,110966,1698
2021-05-22,Glenn,021,27897,2434,2412,562,2974,17
2021-05-22,Humboldt,023,135768,4232,4194,35,4229,42
2021-05-22,Imperial,025,180216,28601,28574,2773,31347,735
2021-05-22,Inyo,027,18085,1403,1402,12,1414,36
2021-05-22,Kern,029,883053,97272,96260,10917,107177,1319
2021-05-22,Kings,031,150075,23159,22936,1092,24028,246
2021-05-22,Lake,033,64148,3519,3502,9,3511,43
2021-05-22,Lassen,035,31185,5205,5163,113,5276,6
2021-05-22,Los Angeles,037,10098052,1205017,1197454,41763,1239217,24192
2021-05-22,Madera,039,155013,16613,16503,939,17442,239
2021-05-22,Marin,041,260295,14093,14043,256,14299,227
2021-05-22,Mariposa,043,17540,430,427,11,438,5
2021-05-22,Mendocino,045,87422,3986,3908,81,3989,47
2021-05-22,Merced,047,269075,30988,31099,1055,32154,455
2021-05-22,Modoc,049,8938,376,366,130,496,3
2021-05-22,Mono,051,14174,1260,1270,17,1287,3
2021-05-22,Monterey,053,433212,43168,42998,1878,44876,379
2021-05-22,Napa,055,140530,9903,9918,36,9954,82
2021-05-22,Nevada,057,99092,4808,4787,189,4976,70
2021-05-22,Orange,059,3164182,255318,254238,11362,265600,5048
2021-05-22,Placer,061,380077,23249,22865,1505,24370,292
2021-05-22,Plumas,063,18699,702,683,11,694,4
2021-05-22,Riverside,065,2383286,294085,288580,14040,302620,4442
2021-05-22,Sacramento,067,1510023,105896,105551,1749,107300,1632
2021-05-22,San Benito,069,59416,6063,6071,115,6186,63
2021-05-22,San Bernardino,071,2135413,293286,292292,8996,301288,4747
2021-05-22,San Diego,073,3302833,280521,279614,14928,294542,3751
2021-05-22,San Francisco,075,870044,36704,36906,1288,38194,547
2021-05-22,San Joaquin,077,732212,73070,72528,3565,76093,1371
2021-05-22,San Luis Obispo,079,281455,21367,21134,744,21878,256
2021-05-22,San Mateo,081,765935,42359,42218,474,42692,433
2021-05-22,Santa Barbara,083,443738,34428,34313,1138,35451,459
2021-05-22,Santa Clara,085,1922200,118570,119292,762,120054,2030
2021-05-22,Santa Cruz,087,273765,16221,16125,814,16939,207
2021-05-22,Shasta,089,179085,12274,12307,1565,13872,201
2021-05-22,Sierra,091,2930,56,54,12,66,0
2021-05-22,Siskiyou,093,43540,1921,1824,357,2181,17
2021-05-22,Solano,095,438530,32776,32753,552,33305,254
2021-05-22,Sonoma,097,501317,30017,30154,333,30487,321
2021-05-22,Stanislaus,099,539301,56266,56069,5949,62018,974
2021-05-22,Sutter,101,95872,9446,9476,87,9563,113
2021-05-22,Tehama,103,63373,5075,5036,578,5614,63
2021-05-22,Trinity,105,12862,483,328,94,422,3
2021-05-22,Tulare,107,460477,50211,49299,9043,58342,838
2021-05-22,Tuolumne,109,53932,4012,4078,39,4117,65
2021-05-22,Ventura,111,848112,81337,80859,2993,83852,1022
2021-05-22,Yolo,113,214977,13964,13997,315,14312,213
2021-05-22,Yuba,115,75493,6046,6010,124,6134,49
2021-05-21,Alameda,001,1643700,88092,88041,1959,90000,1263
2021-05-21,Alpine,003,1148,87,88,0,88,0
2021-05-21,Amador,005,37829,3672,3672,33,3705,46
2021-05-21,Butte,007,227075,12514,12236,1797,14033,188
2021-05-21,Calaveras,009,45235,2152,2138,14,2152,54
2021-05-21,Colusa,011,21464,1941,1947,310,2257,15
2021-05-21,Contra Costa,013,1133247,69501,68965,1274,70239,810
2021-05-21,Del Norte,015,27424,1412,1376,12,1388,8
2021-05-21,El Dorado,017,186661,10280,10204,726,10930,112
2021-05-21,Fresno,019,978130,102671,102189,8726,110915,1698
2021-05-21,Glenn,021,27897,2433,2408,562,2970,17
2021-05-21,Humboldt,023,135768,4225,4175,35,4210,42
2021-05-21,Imperial,025,180216,28594,28572,2772,31344,732
2021-05-21,Inyo,027,18085,1403,1402,12,1414,36
2021-05-21,Kern,029,883053,97258,96233,10910,107143,1318
2021-05-21,Kings,031,150075,23159,22927,1092,24019,246
2021-05-21,Lake,033,64148,3517,3500,9,3509,43
2021-05-21,Lassen,035,31185,5204,5161,113,5274,6
2021-05-21,Los Angeles,037,10098052,1204906,1197263,41754,1239017,24180
2021-05-21,Madera,039,155013,16612,16500,938,17438,238
2021-05-21,Marin,041,260295,14088,14042,256,14298,227
2021-05-21,Mariposa,043,17540,429,427,11,438,5
2021-05-21,Mendocino,045,87422,3980,3897,81,3978,47
2021-05-21,Merced,047,269075,30980,31076,1055,32131,455
2021-05-21,Modoc,049,8938,376,365,130,495,3
2021-05-21,Mono,051,14174,1260,1269,17,1286,3
2021-05-21,Monterey,053,433212,43166,42995,1878,44873,379
2021-05-21,Napa,055,140530,9899,9913,36,9949,82
2021-05-21,Nevada,057,99092,4807,4779,189,4968,70
2021-05-21,Orange,059,3164182,255299,254171,11360,265531,5042
2021-05-21,Placer,061,380077,23240,22853,1505,24358,292
2021-05-21,Plumas,063,18699,702,683,10,693,4
2021-05-21,Riverside,065,2383286,294058,288499,14033,302532,4442
2021-05-21,Sacramento,067,1510023,105829,105476,1746,107222,1632
2021-05-21,San Benito,069,59416,6063,6068,115,6183,63
2021-05-21,San Bernardino,071,2135413,293254,292205,8993,301198,4744
2021-05-21,San Diego,073,3302833,280449,279554,14918,294472,3748
2021-05-21,San Francisco,075,870044,36699,36879,1288,38167,546
2021-05-21,San Joaquin,077,732212,73050,72467,3563,76030,1371
2021-05-21,San Luis Obispo,079,281455,21361,21128,741,21869,256
2021-05-21,San Mateo,081,765935,42346,42163,473,42636,432
2021-05-21,Santa Barbara,083,443738,34423,34302,1138,35440,459
2021-05-21,Santa Clara,085,1922200,118543,119247,762,120009,2029
2021-05-21,Santa Cruz,087,273765,16217,16120,814,16934,207
2021-05-21,Shasta,089,179085,12257,12289,1563,13852,201
2021-05-21,Sierra,091,2930,56,54,12,66,0
2021-05-21,Siskiyou,093,43540,1920,1815,357,2172,16
2021-05-21,Solano,095,438530,32761,32742,552,33294,254
2021-05-21,Sonoma,097,501317,30004,30126,333,30459,321
2021-05-21,Stanislaus,099,539301,56237,56036,5947,61983,975
2021-05-21,Sutter,101,95872,9444,9470,87,9557,113
2021-05-21,Tehama,103,63373,5069,5030,578,5608,63
2021-05-21,Trinity,105,12862,483,329,93,422,3
2021-05-21,Tulare,107,460477,50206,49271,9041,58312,838
2021-05-21,Tuolumne,109,53932,4010,4079,39,4118,65
2021-05-21,Ventura,111,848112,81329,80821,2990,83811,1021
2021-05-21,Yolo,113,214977,13958,13983,315,14298,213
2021-05-21,Yuba,115,75493,6040,6006,124,6130,49
2021-05-20,Alameda,001,1643700,88048,87975,1958,89933,1264
2021-05-20,Alpine,003,1148,87,88,0,88,0
2021-05-20,Amador,005,37829,3671,3671,33,3704,46
2021-05-20,Butte,007,227075,12507,12220,1794,14014,188
2021-05-20,Calaveras,009,45235,2148,2138,14,2152,54
2021-05-20,Colusa,011,21464,1940,1946,308,2254,15
2021-05-20,Contra Costa,013,1133247,69456,68913,1272,70185,809
2021-05-20,Del Norte,015,27424,1412,1373,12,1385,8
2021-05-20,El Dorado,017,186661,10270,10188,726,10914,112
2021-05-20,Fresno,019,978130,102649,102135,8724,110859,1696
2021-05-20,Glenn,021,27897,2430,2406,562,2968,17
2021-05-20,Humboldt,023,135768,4208,4162,34,4196,42
2021-05-20,Imperial,025,180216,28589,28551,2772,31323,732
2021-05-20,Inyo,027,18085,1403,1402,12,1414,36
2021-05-20,Kern,029,883053,97237,96204,10903,107107,1317
2021-05-20,Kings,031,150075,23157,22922,1092,24014,246
2021-05-20,Lake,033,64148,3514,3500,9,3509,43
2021-05-20,Lassen,035,31185,5202,5160,112,5272,6
2021-05-20,Los Angeles,037,10098052,1204750,1197073,41745,1238818,24168
2021-05-20,Madera,039,155013,16606,16499,936,17435,238
2021-05-20,Marin,041,260295,14084,14036,255,14291,227
2021-05-20,Mariposa,043,17540,429,426,11,437,5
2021-05-20,Mendocino,045,87422,3973,3897,81,3978,47
2021-05-20,Merced,047,269075,30967,31046,1054,32100,454
2021-05-20,Modoc,049,8938,376,365,130,495,3
2021-05-20,Mono,051,14174,1259,1269,17,1286,3
2021-05-20,Monterey,053,433212,43160,42984,1877,44861,379
2021-05-20,Napa,055,140530,9896,9913,36,9949,82
2021-05-20,Nevada,057,99092,4806,4775,189,4964,70
2021-05-20,Orange,059,3164182,255256,254127,11357,265484,5038
2021-05-20,Placer,061,380077,23227,22823,1504,24327,292
2021-05-20,Plumas,063,18699,700,682,10,692,4
2021-05-20,Riverside,065,2383286,294010,288453,14028,302481,4442
2021-05-20,Sacramento,067,1510023,105733,105414,1743,107157,1629
2021-05-20,San Benito,069,59416,6062,6067,115,6182,63
2021-05-20,San Bernardino,071,2135413,293208,292153,8992,301145,4728
2021-05-20,San Diego,073,3302833,280361,279490,14906,294396,3749
2021-05-20,San Francisco,075,870044,36690,36860,1288,38148,546
2021-05-20,San Joaquin,077,732212,73012,72388,3561,75949,1371
2021-05-20,San Luis Obispo,079,281455,21349,21095,739,21834,256
2021-05-20,San Mateo,081,765935,42332,42152,471,42623,432
2021-05-20,Santa Barbara,083,443738,34419,34293,1138,35431,459
2021-05-20,Santa Clara,085,1922200,118522,119222,762,119984,2029
2021-05-20,Santa Cruz,087,273765,16212,16119,814,16933,207
2021-05-20,Shasta,089,179085,12244,12266,1560,13826,200
2021-05-20,Sierra,091,2930,56,54,12,66,0
2021-05-20,Siskiyou,093,43540,1913,1811,356,2167,16
2021-05-20,Solano,095,438530,32746,32725,552,33277,253
2021-05-20,Sonoma,097,501317,29987,30107,332,30439,321
2021-05-20,Stanislaus,099,539301,56213,55979,5945,61924,970
2021-05-20,Sutter,101,95872,9440,9467,87,9554,113
2021-05-20,Tehama,103,63373,5067,5029,578,5607,63
2021-05-20,Trinity,105,12862,483,329,92,421,3
2021-05-20,Tulare,107,460477,50195,49217,9038,58255,837
2021-05-20,Tuolumne,109,53932,4009,4077,39,4116,65
2021-05-20,Ventura,111,848112,81318,80800,2990,83790,1019
2021-05-20,Yolo,113,214977,13953,13973,315,14288,211
2021-05-20,Yuba,115,75493,6031,6002,124,6126,49
2021-05-19,Alameda,001,1643700,88008,87889,1956,89845,1260
2021-05-19,Alpine,003,1148,87,88,0,88,0
2021-05-19,Amador,005,37829,3671,3669,33,3702,46
2021-05-19,Butte,007,227075,12497,12198,1794,13992,188
2021-05-19,Calaveras,009,45235,2144,2132,14,2146,54
2021-05-19,Colusa,011,21464,1940,1945,306,2251,15
2021-05-19,Contra Costa,013,1133247,69409,68836,1272,70108,808
2021-05-19,Del Norte,015,27424,1410,1371,12,1383,8
2021-05-19,El Dorado,017,186661,10265,10179,725,10904,112
2021-05-19,Fresno,019,978130,102619,102085,8721,110806,1693
2021-05-19,Glenn,021,27897,2430,2404,562,2966,17
2021-05-19,Humboldt,023,135768,4198,4143,34,4177,42
2021-05-19,Imperial,025,180216,28580,28550,2772,31322,732
2021-05-19,Inyo,027,18085,1403,1402,12,1414,36
2021-05-19,Kern,029,883053,97208,96173,10895,107068,1316
2021-05-19,Kings,031,150075,23151,22919,1092,24011,246
2021-05-19,Lake,033,64148,3514,3497,9,3506,43
2021-05-19,Lassen,035,31185,5201,5157,112,5269,6
2021-05-19,Los Angeles,037,10098052,1204557,1196856,41730,1238586,24143
2021-05-19,Madera,039,155013,16603,16496,936,17432,238
2021-05-19,Marin,041,260295,14080,14033,253,14286,227
2021-05-19,Mariposa,043,17540,429,425,11,436,5
2021-05-19,Mendocino,045,87422,3969,3886,81,3967,47
2021-05-19,Merced,047,269075,30951,31044,1054,32098,452
2021-05-19,Modoc,049,8938,376,364,127,491,3
2021-05-19,Mono,051,14174,1259,1266,17,1283,3
2021-05-19,Monterey,053,433212,43155,42973,1876,44849,379
2021-05-19,Napa,055,140530,9893,9906,36,9942,82
2021-05-19,Nevada,057,99092,4804,4769,189,4958,70
2021-05-19,Orange,059,3164182,255219,254087,11347,265434,5035
2021-05-19,Placer,061,380077,23208,22784,1499,24283,291
2021-05-19,Plumas,063,18699,700,682,10,692,4
2021-05-19,Riverside,065,2383286,293963,288398,14026,302424,4442
2021-05-19,Sacramento,067,1510023,105656,105225,1742,106967,1629
2021-05-19,San Benito,069,59416,6061,6064,115,6179,63
2021-05-19,San Bernardino,071,2135413,293164,292078,8989,301067,4725
2021-05-19,San Diego,073,3302833,280276,279345,14885,294230,3746
2021-05-19,San Francisco,075,870044,36677,36835,1287,38122,546
2021-05-19,San Joaquin,077,732212,72969,72338,3556,75894,1369
2021-05-19,San Luis Obispo,079,281455,21341,21085,738,21823,256
2021-05-19,San Mateo,081,765935,42325,42126,471,42597,429
2021-05-19,Santa Barbara,083,443738,34411,34292,1138,35430,459
2021-05-19,Santa Clara,085,1922200,118482,119176,761,119937,2015
2021-05-19,Santa Cruz,087,273765,16208,16121,813,16934,207
2021-05-19,Shasta,089,179085,12226,12233,1557,13790,200
2021-05-19,Sierra,091,2930,56,54,12,66,0
2021-05-19,Siskiyou,093,43540,1910,1803,355,2158,16
2021-05-19,Solano,095,438530,32719,32678,550,33228,253
2021-05-19,Sonoma,097,501317,29972,30080,332,30412,321
2021-05-19,Stanislaus,099,539301,56195,55912,5940,61852,967
2021-05-19,Sutter,101,95872,9433,9459,86,9545,113
2021-05-19,Tehama,103,63373,5058,5026,572,5598,63
2021-05-19,Trinity,105,12862,483,329,92,421,3
2021-05-19,Tulare,107,460477,50182,49163,9033,58196,837
2021-05-19,Tuolumne,109,53932,4009,4074,39,4113,64
2021-05-19,Ventura,111,848112,81303,80747,2989,83736,1019
2021-05-19,Yolo,113,214977,13946,13961,314,14275,211
2021-05-19,Yuba,115,75493,6027,5993,124,6117,49
2021-05-18,Alameda,001,1643700,87934,87816,1956,89772,1254
2021-05-18,Alpine,003,1148,87,88,0,88,0
2021-05-18,Amador,005,37829,3671,3669,33,3702,46
2021-05-18,Butte,007,227075,12484,12164,1791,13955,191
2021-05-18,Calaveras,009,45235,2140,2131,14,2145,54
2021-05-18,Colusa,011,21464,1940,1943,306,2249,14
2021-05-18,Contra Costa,013,1133247,69352,68750,1271,70021,808
2021-05-18,Del Norte,015,27424,1407,1371,12,1383,8
2021-05-18,El Dorado,017,186661,10254,10169,724,10893,112
2021-05-18,Fresno,019,978130,102583,102056,8718,110774,1690
2021-05-18,Glenn,021,27897,2424,2403,561,2964,17
2021-05-18,Humboldt,023,135768,4180,4132,34,4166,42
2021-05-18,Imperial,025,180216,28574,28538,2770,31308,730
2021-05-18,Inyo,027,18085,1403,1401,12,1413,36
2021-05-18,Kern,029,883053,97174,96128,10881,107009,1315
2021-05-18,Kings,031,150075,23145,22916,1092,24008,247
2021-05-18,Lake,033,64148,3512,3495,9,3504,43
2021-05-18,Lassen,035,31185,5200,5157,111,5268,6
2021-05-18,Los Angeles,037,10098052,1204378,1196668,41719,1238387,24133
2021-05-18,Madera,039,155013,16593,16491,935,17426,238
2021-05-18,Marin,041,260295,14077,14026,253,14279,227
2021-05-18,Mariposa,043,17540,429,424,11,435,5
2021-05-18,Mendocino,045,87422,3958,3877,80,3957,47
2021-05-18,Merced,047,269075,30932,31036,1054,32090,452
2021-05-18,Modoc,049,8938,375,364,126,490,3
2021-05-18,Mono,051,14174,1258,1265,17,1282,3
2021-05-18,Monterey,053,433212,43149,43001,1876,44877,379
2021-05-18,Napa,055,140530,9893,9905,36,9941,82
2021-05-18,Nevada,057,99092,4797,4762,189,4951,70
2021-05-18,Orange,059,3164182,255178,254041,11337,265378,5031
2021-05-18,Placer,061,380077,23175,22726,1495,24221,291
2021-05-18,Plumas,063,18699,700,682,10,692,4
2021-05-18,Riverside,065,2383286,293908,288354,14019,302373,4438
2021-05-18,Sacramento,067,1510023,105554,105083,1740,106823,1629
2021-05-18,San Benito,069,59416,6060,6065,115,6180,63
2021-05-18,San Bernardino,071,2135413,293106,292014,8984,300998,4722
2021-05-18,San Diego,073,3302833,280168,279254,14876,294130,3742
2021-05-18,San Francisco,075,870044,36657,36818,1287,38105,546
2021-05-18,San Joaquin,077,732212,72922,72282,3552,75834,1368
2021-05-18,San Luis Obispo,079,281455,21331,21080,736,21816,256
2021-05-18,San Mateo,081,765935,42313,42099,470,42569,428
2021-05-18,Santa Barbara,083,443738,34402,34278,1138,35416,459
2021-05-18,Santa Clara,085,1922200,118455,119171,761,119932,2014
2021-05-18,Santa Cruz,087,273765,16200,16137,813,16950,207
2021-05-18,Shasta,089,179085,12208,12197,1551,13748,200
2021-05-18,Sierra,091,2930,56,54,12,66,0
2021-05-18,Siskiyou,093,43540,1909,1799,355,2154,16
2021-05-18,Solano,095,438530,32694,32644,550,33194,253
2021-05-18,Sonoma,097,501317,29952,30054,331,30385,321
2021-05-18,Stanislaus,099,539301,56159,55860,5940,61800,959
2021-05-18,Sutter,101,95872,9425,9453,86,9539,113
2021-05-18,Tehama,103,63373,5052,5020,569,5589,63
2021-05-18,Trinity,105,12862,483,329,91,420,3
2021-05-18,Tulare,107,460477,50174,49142,9028,58170,836
2021-05-18,Tuolumne,109,53932,4007,4073,39,4112,64
2021-05-18,Ventura,111,848112,81287,80726,2986,83712,1017
2021-05-18,Yolo,113,214977,13939,13951,313,14264,211
2021-05-18,Yuba,115,75493,6023,5989,123,6112,49
2021-05-17,Alameda,001,1643700,87881,87766,1953,89719,1253
2021-05-17,Alpine,003,1148,87,88,0,88,0
2021-05-17,Amador,005,37829,3668,3668,33,3701,46
2021-05-17,Butte,007,227075,12476,12144,1791,13935,192
2021-05-17,Calaveras,009,45235,2140,2131,14,2145,53
2021-05-17,Colusa,011,21464,1940,1943,306,2249,14
2021-05-17,Contra Costa,013,1133247,69297,68720,1270,69990,805
2021-05-17,Del Norte,015,27424,1402,1369,12,1381,8
2021-05-17,El Dorado,017,186661,10237,10163,724,10887,112
2021-05-17,Fresno,019,978130,102539,102013,8710,110723,1690
2021-05-17,Glenn,021,27897,2424,2401,561,2962,17
2021-05-17,Humboldt,023,135768,4169,4112,34,4146,42
2021-05-17,Imperial,025,180216,28568,28533,2768,31301,729
2021-05-17,Inyo,027,18085,1403,1401,12,1413,36
2021-05-17,Kern,029,883053,97145,96095,10864,106959,1315
2021-05-17,Kings,031,150075,23142,22918,1092,24010,246
2021-05-17,Lake,033,64148,3507,3489,9,3498,43
2021-05-17,Lassen,035,31185,5197,5156,110,5266,6
2021-05-17,Los Angeles,037,10098052,1204203,1196556,41713,1238269,24123
2021-05-17,Madera,039,155013,16586,16486,935,17421,238
2021-05-17,Marin,041,260295,14071,14021,253,14274,227
2021-05-17,Mariposa,043,17540,428,423,11,434,5
2021-05-17,Mendocino,045,87422,3949,3868,80,3948,46
2021-05-17,Merced,047,269075,30917,31031,1054,32085,450
2021-05-17,Modoc,049,8938,374,362,126,488,3
2021-05-17,Mono,051,14174,1254,1265,17,1282,3
2021-05-17,Monterey,053,433212,43142,42995,1876,44871,379
2021-05-17,Napa,055,140530,9892,9894,36,9930,82
2021-05-17,Nevada,057,99092,4793,4761,188,4949,70
2021-05-17,Orange,059,3164182,255131,253993,11330,265323,5031
2021-05-17,Placer,061,380077,23149,22706,1488,24194,289
2021-05-17,Plumas,063,18699,700,682,10,692,4
2021-05-17,Riverside,065,2383286,293839,288304,14015,302319,4433
2021-05-17,Sacramento,067,1510023,105446,105035,1738,106773,1629
2021-05-17,San Benito,069,59416,6057,6067,115,6182,63
2021-05-17,San Bernardino,071,2135413,293057,291989,8976,300965,4724
2021-05-17,San Diego,073,3302833,280036,279146,14854,294000,3742
2021-05-17,San Francisco,075,870044,36645,36816,1285,38101,546
2021-05-17,San Joaquin,077,732212,72884,72234,3549,75783,1359
2021-05-17,San Luis Obispo,079,281455,21322,21079,734,21813,256
2021-05-17,San Mateo,081,765935,42285,42083,470,42553,428
2021-05-17,Santa Barbara,083,443738,34395,34275,1138,35413,459
2021-05-17,Santa Clara,085,1922200,118418,119116,759,119875,2015
2021-05-17,Santa Cruz,087,273765,16197,16151,813,16964,206
2021-05-17,Shasta,089,179085,12186,12163,1550,13713,200
2021-05-17,Sierra,091,2930,56,54,12,66,0
2021-05-17,Siskiyou,093,43540,1900,1795,352,2147,15
2021-05-17,Solano,095,438530,32676,32627,549,33176,253
2021-05-17,Sonoma,097,501317,29929,30043,330,30373,321
2021-05-17,Stanislaus,099,539301,56114,55839,5933,61772,951
2021-05-17,Sutter,101,95872,9418,9447,86,9533,113
2021-05-17,Tehama,103,63373,5048,5016,568,5584,63
2021-05-17,Trinity,105,12862,483,328,91,419,3
2021-05-17,Tulare,107,460477,50152,49107,9022,58129,836
2021-05-17,Tuolumne,109,53932,4007,4071,39,4110,64
2021-05-17,Ventura,111,848112,81267,80699,2986,83685,1017
2021-05-17,Yolo,113,214977,13932,13941,313,14254,211
2021-05-17,Yuba,115,75493,6015,5987,123,6110,49
2021-05-16,Alameda,001,1643700,87817,87743,1953,89696,1253
2021-05-16,Alpine,003,1148,87,88,0,88,0
2021-05-16,Amador,005,37829,3667,3667,33,3700,46
2021-05-16,Butte,007,227075,12462,12140,1791,13931,192
2021-05-16,Calaveras,009,45235,2138,2129,14,2143,53
2021-05-16,Colusa,011,21464,1938,1943,306,2249,14
2021-05-16,Contra Costa,013,1133247,69229,68694,1267,69961,805
2021-05-16,Del Norte,015,27424,1399,1365,12,1377,8
2021-05-16,El Dorado,017,186661,10221,10159,723,10882,112
2021-05-16,Fresno,019,978130,102495,101987,8704,110691,1690
2021-05-16,Glenn,021,27897,2424,2401,560,2961,17
2021-05-16,Humboldt,023,135768,4154,4104,34,4138,42
2021-05-16,Imperial,025,180216,28557,28516,2767,31283,729
2021-05-16,Inyo,027,18085,1403,1401,12,1413,36
2021-05-16,Kern,029,883053,97112,96083,10844,106927,1315
2021-05-16,Kings,031,150075,23138,22918,1089,24007,246
2021-05-16,Lake,033,64148,3504,3489,9,3498,43
2021-05-16,Lassen,035,31185,5196,5156,110,5266,6
2021-05-16,Los Angeles,037,10098052,1203980,1196397,41697,1238094,24120
2021-05-16,Madera,039,155013,16581,16483,932,17415,238
2021-05-16,Marin,041,260295,14068,14015,253,14268,227
2021-05-16,Mariposa,043,17540,428,423,11,434,5
2021-05-16,Mendocino,045,87422,3939,3863,80,3943,46
2021-05-16,Merced,047,269075,30896,31023,1052,32075,450
2021-05-16,Modoc,049,8938,374,362,126,488,3
2021-05-16,Mono,051,14174,1254,1265,17,1282,3
2021-05-16,Monterey,053,433212,43137,42991,1876,44867,379
2021-05-16,Napa,055,140530,9889,9891,36,9927,82
2021-05-16,Nevada,057,99092,4789,4755,188,4943,70
2021-05-16,Orange,059,3164182,255099,253962,11327,265289,5031
2021-05-16,Placer,061,380077,23117,22696,1482,24178,289
2021-05-16,Plumas,063,18699,699,682,10,692,4
2021-05-16,Riverside,065,2383286,293763,288259,14007,302266,4433
2021-05-16,Sacramento,067,1510023,105332,105013,1736,106749,1628
2021-05-16,San Benito,069,59416,6056,6067,114,6181,63
2021-05-16,San Bernardino,071,2135413,292985,291940,8974,300914,4724
2021-05-16,San Diego,073,3302833,279918,279099,14841,293940,3742
2021-05-16,San Francisco,075,870044,36622,36808,1284,38092,546
2021-05-16,San Joaquin,077,732212,72835,72218,3544,75762,1359
2021-05-16,San Luis Obispo,079,281455,21314,21072,732,21804,256
2021-05-16,San Mateo,081,765935,42274,42063,469,42532,428
2021-05-16,Santa Barbara,083,443738,34388,34270,1138,35408,459
2021-05-16,Santa Clara,085,1922200,118389,119098,758,119856,2015
2021-05-16,Santa Cruz,087,273765,16195,16143,813,16956,206
2021-05-16,Shasta,089,179085,12170,12156,1546,13702,200
2021-05-16,Sierra,091,2930,56,54,12,66,0
2021-05-16,Siskiyou,093,43540,1896,1790,351,2141,15
2021-05-16,Solano,095,438530,32643,32619,547,33166,253
2021-05-16,Sonoma,097,501317,29910,30033,330,30363,321
2021-05-16,Stanislaus,099,539301,56065,55814,5921,61735,951
2021-05-16,Sutter,101,95872,9411,9445,86,9531,113
2021-05-16,Tehama,103,63373,5044,5013,567,5580,63
2021-05-16,Trinity,105,12862,483,328,91,419,3
2021-05-16,Tulare,107,460477,50135,49091,9019,58110,837
2021-05-16,Tuolumne,109,53932,4003,4070,39,4109,64
2021-05-16,Ventura,111,848112,81236,80689,2986,83675,1017
2021-05-16,Yolo,113,214977,13917,13938,313,14251,211
2021-05-16,Yuba,115,75493,6012,5987,123,6110,49
2021-05-15,Alameda,001,1643700,87791,87677,1952,89629,1252
2021-05-15,Alpine,003,1148,87,88,0,88,0
2021-05-15,Amador,005,37829,3667,3666,33,3699,46
2021-05-15,Butte,007,227075,12455,12095,1790,13885,192
2021-05-15,Calaveras,009,45235,2137,2126,14,2140,53
2021-05-15,Colusa,011,21464,1938,1941,304,2245,14
2021-05-15,Contra Costa,013,1133247,69183,68658,1267,69925,805
2021-05-15,Del Norte,015,27424,1394,1359,12,1371,8
2021-05-15,El Dorado,017,186661,10209,10156,722,10878,112
2021-05-15,Fresno,019,978130,102458,101957,8701,110658,1690
2021-05-15,Glenn,021,27897,2424,2400,560,2960,17
2021-05-15,Humboldt,023,135768,4144,4080,34,4114,42
2021-05-15,Imperial,025,180216,28554,28504,2766,31270,729
2021-05-15,Inyo,027,18085,1403,1402,12,1414,36
2021-05-15,Kern,029,883053,97098,96061,10829,106890,1315
2021-05-15,Kings,031,150075,23137,22913,1089,24002,246
2021-05-15,Lake,033,64148,3503,3485,9,3494,43
2021-05-15,Lassen,035,31185,5193,5156,109,5265,6
2021-05-15,Los Angeles,037,10098052,1203856,1196255,41684,1237939,24115
2021-05-15,Madera,039,155013,16578,16482,932,17414,238
2021-05-15,Marin,041,260295,14064,14012,253,14265,227
2021-05-15,Mariposa,043,17540,428,423,11,434,5
2021-05-15,Mendocino,045,87422,3936,3861,80,3941,46
2021-05-15,Merced,047,269075,30875,31012,1052,32064,450
2021-05-15,Modoc,049,8938,374,362,126,488,3
2021-05-15,Mono,051,14174,1254,1265,17,1282,3
2021-05-15,Monterey,053,433212,43133,42982,1876,44858,379
2021-05-15,Napa,055,140530,9886,9887,36,9923,82
2021-05-15,Nevada,057,99092,4788,4755,188,4943,70
2021-05-15,Orange,059,3164182,255072,253919,11320,265239,5030
2021-05-15,Placer,061,380077,23096,22688,1482,24170,289
2021-05-15,Plumas,063,18699,699,681,10,691,4
2021-05-15,Riverside,065,2383286,293721,288203,14002,302205,4433
2021-05-15,Sacramento,067,1510023,105260,104929,1733,106662,1628
2021-05-15,San Benito,069,59416,6056,6066,114,6180,63
2021-05-15,San Bernardino,071,2135413,292943,291892,8972,300864,4724
2021-05-15,San Diego,073,3302833,279847,278991,14826,293817,3737
2021-05-15,San Francisco,075,870044,36606,36795,1282,38077,546
2021-05-15,San Joaquin,077,732212,72809,72197,3542,75739,1359
2021-05-15,San Luis Obispo,079,281455,21311,21061,731,21792,256
2021-05-15,San Mateo,081,765935,42258,42059,469,42528,428
2021-05-15,Santa Barbara,083,443738,34380,34259,1138,35397,459
2021-05-15,Santa Clara,085,1922200,118368,119060,758,119818,2016
2021-05-15,Santa Cruz,087,273765,16191,16137,813,16950,206
2021-05-15,Shasta,089,179085,12158,12152,1543,13695,200
2021-05-15,Sierra,091,2930,56,54,12,66,0
2021-05-15,Siskiyou,093,43540,1890,1788,349,2137,15
2021-05-15,Solano,095,438530,32634,32604,546,33150,253
2021-05-15,Sonoma,097,501317,29891,30020,330,30350,321
2021-05-15,Stanislaus,099,539301,56036,55795,5914,61709,952
2021-05-15,Sutter,101,95872,9409,9436,86,9522,113
2021-05-15,Tehama,103,63373,5040,5012,566,5578,63
2021-05-15,Trinity,105,12862,483,328,91,419,3
2021-05-15,Tulare,107,460477,50125,49080,9015,58095,837
2021-05-15,Tuolumne,109,53932,4001,4064,39,4103,63
2021-05-15,Ventura,111,848112,81225,80662,2986,83648,1017
2021-05-15,Yolo,113,214977,13910,13932,312,14244,211
2021-05-15,Yuba,115,75493,6009,5979,122,6101,49
2021-05-14,Alameda,001,1643700,87757,87621,1949,89570,1249
2021-05-14,Alpine,003,1148,87,88,0,88,0
2021-05-14,Amador,005,37829,3667,3665,33,3698,46
2021-05-14,Butte,007,227075,12446,12076,1787,13863,192
2021-05-14,Calaveras,009,45235,2133,2121,14,2135,53
2021-05-14,Colusa,011,21464,1937,1940,303,2243,14
2021-05-14,Contra Costa,013,1133247,69141,68589,1265,69854,806
2021-05-14,Del Norte,015,27424,1394,1355,12,1367,8
2021-05-14,El Dorado,017,186661,10202,10143,721,10864,113
2021-05-14,Fresno,019,978130,102429,101917,8695,110612,1688
2021-05-14,Glenn,021,27897,2423,2398,560,2958,17
2021-05-14,Humboldt,023,135768,4137,4050,34,4084,37
2021-05-14,Imperial,025,180216,28547,28485,2765,31250,728
2021-05-14,Inyo,027,18085,1403,1400,12,1412,36
2021-05-14,Kern,029,883053,97068,96033,10820,106853,1311
2021-05-14,Kings,031,150075,23136,22910,1089,23999,246
2021-05-14,Lake,033,64148,3499,3483,9,3492,43
2021-05-14,Lassen,035,31185,5193,5154,109,5263,6
2021-05-14,Los Angeles,037,10098052,1203722,1196038,41679,1237717,24101
2021-05-14,Madera,039,155013,16575,16474,932,17406,238
2021-05-14,Marin,041,260295,14060,14010,253,14263,227
2021-05-14,Mariposa,043,17540,428,422,11,433,5
2021-05-14,Mendocino,045,87422,3934,3855,80,3935,46
2021-05-14,Merced,047,269075,30865,31010,1052,32062,450
2021-05-14,Modoc,049,8938,374,362,126,488,3
2021-05-14,Mono,051,14174,1253,1265,17,1282,3
2021-05-14,Monterey,053,433212,43128,42973,1876,44849,380
2021-05-14,Napa,055,140530,9883,9883,36,9919,82
2021-05-14,Nevada,057,99092,4783,4745,188,4933,70
2021-05-14,Orange,059,3164182,255038,253855,11313,265168,5028
2021-05-14,Placer,061,380077,23077,22660,1476,24136,287
2021-05-14,Plumas,063,18699,698,680,10,690,4
2021-05-14,Riverside,065,2383286,293671,288140,13999,302139,4433
2021-05-14,Sacramento,067,1510023,105171,104828,1732,106560,1627
2021-05-14,San Benito,069,59416,6056,6064,114,6178,63
2021-05-14,San Bernardino,071,2135413,292895,291834,8972,300806,4721
2021-05-14,San Diego,073,3302833,279774,278853,14815,293668,3732
2021-05-14,San Francisco,075,870044,36597,36771,1278,38049,545
2021-05-14,San Joaquin,077,732212,72777,72160,3535,75695,1359
2021-05-14,San Luis Obispo,079,281455,21307,21051,731,21782,256
2021-05-14,San Mateo,081,765935,42247,42041,469,42510,428
2021-05-14,Santa Barbara,083,443738,34370,34243,1138,35381,456
2021-05-14,Santa Clara,085,1922200,118339,119006,758,119764,2014
2021-05-14,Santa Cruz,087,273765,16186,16130,813,16943,207
2021-05-14,Shasta,089,179085,12152,12130,1538,13668,200
2021-05-14,Sierra,091,2930,56,54,12,66,0
2021-05-14,Siskiyou,093,43540,1883,1779,348,2127,14
2021-05-14,Solano,095,438530,32614,32585,545,33130,252
2021-05-14,Sonoma,097,501317,29872,30007,330,30337,321
2021-05-14,Stanislaus,099,539301,56003,55752,5908,61660,950
2021-05-14,Sutter,101,95872,9400,9433,84,9517,113
2021-05-14,Tehama,103,63373,5033,5005,566,5571,63
2021-05-14,Trinity,105,12862,483,328,91,419,3
2021-05-14,Tulare,107,460477,50108,49060,9010,58070,836
2021-05-14,Tuolumne,109,53932,4001,4060,39,4099,63
2021-05-14,Ventura,111,848112,81211,80628,2986,83614,1014
2021-05-14,Yolo,113,214977,13905,13922,308,14230,210
2021-05-14,Yuba,115,75493,6005,5970,122,6092,47
2021-05-13,Alameda,001,1643700,87714,87557,1948,89505,1250
2021-05-13,Alpine,003,1148,87,88,0,88,0
2021-05-13,Amador,005,37829,3667,3662,33,3695,46
2021-05-13,Butte,007,227075,12431,12051,1786,13837,196
2021-05-13,Calaveras,009,45235,2133,2120,14,2134,53
2021-05-13,Colusa,011,21464,1936,1939,299,2238,14
2021-05-13,Contra Costa,013,1133247,69093,68522,1264,69786,806
2021-05-13,Del Norte,015,27424,1392,1354,12,1366,8
2021-05-13,El Dorado,017,186661,10199,10133,721,10854,112
2021-05-13,Fresno,019,978130,102400,101862,8694,110556,1687
2021-05-13,Glenn,021,27897,2422,2395,560,2955,17
2021-05-13,Humboldt,023,135768,4119,4027,34,4061,37
2021-05-13,Imperial,025,180216,28532,28468,2763,31231,729
2021-05-13,Inyo,027,18085,1403,1400,12,1412,36
2021-05-13,Kern,029,883053,97044,95996,10802,106798,1311
2021-05-13,Kings,031,150075,23135,22904,1089,23993,246
2021-05-13,Lake,033,64148,3498,3479,9,3488,43
2021-05-13,Lassen,035,31185,5193,5152,108,5260,6
2021-05-13,Los Angeles,037,10098052,1203534,1195504,41664,1237168,24083
2021-05-13,Madera,039,155013,16567,16467,932,17399,238
2021-05-13,Marin,041,260295,14055,14004,251,14255,227
2021-05-13,Mariposa,043,17540,428,422,11,433,5
2021-05-13,Mendocino,045,87422,3930,3846,80,3926,46
2021-05-13,Merced,047,269075,30858,30989,1051,32040,450
2021-05-13,Modoc,049,8938,374,362,126,488,3
2021-05-13,Mono,051,14174,1253,1265,17,1282,3
2021-05-13,Monterey,053,433212,43113,42966,1876,44842,380
2021-05-13,Napa,055,140530,9876,9877,36,9913,82
2021-05-13,Nevada,057,99092,4779,4743,187,4930,70
2021-05-13,Orange,059,3164182,254993,253778,11311,265089,5026
2021-05-13,Placer,061,380077,23053,22668,1469,24137,288
2021-05-13,Plumas,063,18699,698,680,10,690,4
2021-05-13,Riverside,065,2383286,293605,288067,13994,302061,4433
2021-05-13,Sacramento,067,1510023,105085,104711,1730,106441,1626
2021-05-13,San Benito,069,59416,6054,6062,114,6176,63
2021-05-13,San Bernardino,071,2135413,292829,291765,8972,300737,4722
2021-05-13,San Diego,073,3302833,279660,278592,14798,293390,3729
2021-05-13,San Francisco,075,870044,36573,36741,1276,38017,544
2021-05-13,San Joaquin,077,732212,72735,72096,3531,75627,1357
2021-05-13,San Luis Obispo,079,281455,21292,21043,730,21773,255
2021-05-13,San Mateo,081,765935,42230,42059,469,42528,426
2021-05-13,Santa Barbara,083,443738,34358,34242,1138,35380,456
2021-05-13,Santa Clara,085,1922200,118312,118952,758,119710,2013
2021-05-13,Santa Cruz,087,273765,16180,16129,813,16942,208
2021-05-13,Shasta,089,179085,12132,12111,1534,13645,200
2021-05-13,Sierra,091,2930,56,54,12,66,0
2021-05-13,Siskiyou,093,43540,1876,1769,345,2114,14
2021-05-13,Solano,095,438530,32601,32548,543,33091,252
2021-05-13,Sonoma,097,501317,29847,29991,330,30321,321
2021-05-13,Stanislaus,099,539301,55966,55678,5902,61580,949
2021-05-13,Sutter,101,95872,9395,9431,83,9514,112
2021-05-13,Tehama,103,63373,5028,4997,566,5563,63
2021-05-13,Trinity,105,12862,482,327,90,417,3
2021-05-13,Tulare,107,460477,50082,49032,9002,58034,837
2021-05-13,Tuolumne,109,53932,4000,4059,39,4098,63
2021-05-13,Ventura,111,848112,81181,80615,2985,83600,1012
2021-05-13,Yolo,113,214977,13896,13914,306,14220,210
2021-05-13,Yuba,115,75493,5996,5962,122,6084,47
2021-05-12,Alameda,001,1643700,87681,87482,1946,89428,1261
2021-05-12,Alpine,003,1148,87,88,0,88,0
2021-05-12,Amador,005,37829,3667,3658,33,3691,46
2021-05-12,Butte,007,227075,12421,12026,1786,13812,199
2021-05-12,Calaveras,009,45235,2130,2119,14,2133,53
2021-05-12,Colusa,011,21464,1934,1939,298,2237,14
2021-05-12,Contra Costa,013,1133247,69034,68462,1258,69720,805
2021-05-12,Del Norte,015,27424,1390,1352,12,1364,8
2021-05-12,El Dorado,017,186661,10190,10123,721,10844,112
2021-05-12,Fresno,019,978130,102351,101838,8683,110521,1688
2021-05-12,Glenn,021,27897,2419,2391,560,2951,17
2021-05-12,Humboldt,023,135768,4091,3982,34,4016,37
2021-05-12,Imperial,025,180216,28514,28443,2760,31203,726
2021-05-12,Inyo,027,18085,1403,1400,12,1412,36
2021-05-12,Kern,029,883053,97008,95955,10795,106750,1310
2021-05-12,Kings,031,150075,23133,22896,1089,23985,246
2021-05-12,Lake,033,64148,3496,3476,9,3485,43
2021-05-12,Lassen,035,31185,5191,5151,108,5259,6
2021-05-12,Los Angeles,037,10098052,1203352,1195318,41647,1236965,24067
2021-05-12,Madera,039,155013,16560,16462,931,17393,238
2021-05-12,Marin,041,260295,14050,13997,251,14248,227
2021-05-12,Mariposa,043,17540,428,422,11,433,5
2021-05-12,Mendocino,045,87422,3920,3836,80,3916,46
2021-05-12,Merced,047,269075,30842,30941,1051,31992,450
2021-05-12,Modoc,049,8938,373,362,126,488,3
2021-05-12,Mono,051,14174,1253,1265,17,1282,3
2021-05-12,Monterey,053,433212,43101,42950,1875,44825,380
2021-05-12,Napa,055,140530,9870,9870,36,9906,82
2021-05-12,Nevada,057,99092,4775,4738,187,4925,70
2021-05-12,Orange,059,3164182,254942,253587,11308,264895,5024
2021-05-12,Placer,061,380077,23035,22652,1462,24114,288
2021-05-12,Plumas,063,18699,698,681,10,691,4
2021-05-12,Riverside,065,2383286,293535,287830,13990,301820,4431
2021-05-12,Sacramento,067,1510023,104989,104592,1728,106320,1621
2021-05-12,San Benito,069,59416,6054,6062,114,6176,63
2021-05-12,San Bernardino,071,2135413,292781,291505,8967,300472,4715
2021-05-12,San Diego,073,3302833,279555,278402,14777,293179,3729
2021-05-12,San Francisco,075,870044,36553,36720,1275,37995,544
2021-05-12,San Joaquin,077,732212,72681,72043,3527,75570,1356
2021-05-12,San Luis Obispo,079,281455,21282,21021,730,21751,255
2021-05-12,San Mateo,081,765935,42221,42038,467,42505,426
2021-05-12,Santa Barbara,083,443738,34350,34218,1138,35356,456
2021-05-12,Santa Clara,085,1922200,118269,118897,758,119655,2005
2021-05-12,Santa Cruz,087,273765,16174,16123,813,16936,207
2021-05-12,Shasta,089,179085,12112,12092,1532,13624,200
2021-05-12,Sierra,091,2930,56,54,12,66,0
2021-05-12,Siskiyou,093,43540,1872,1760,344,2104,13
2021-05-12,Solano,095,438530,32577,32519,543,33062,252
2021-05-12,Sonoma,097,501317,29835,29976,330,30306,320
2021-05-12,Stanislaus,099,539301,55926,55632,5895,61527,919
2021-05-12,Sutter,101,95872,9392,9427,83,9510,112
2021-05-12,Tehama,103,63373,5023,4989,566,5555,62
2021-05-12,Trinity,105,12862,482,327,90,417,3
2021-05-12,Tulare,107,460477,50066,49001,8994,57995,838
2021-05-12,Tuolumne,109,53932,3999,4056,39,4095,63
2021-05-12,Ventura,111,848112,81162,80577,2985,83562,1010
2021-05-12,Yolo,113,214977,13889,13910,305,14215,210
2021-05-12,Yuba,115,75493,5993,5956,122,6078,47
2021-05-11,Alameda,001,1643700,87616,87413,1942,89355,1290
2021-05-11,Alpine,003,1148,87,88,0,88,0
2021-05-11,Amador,005,37829,3665,3657,33,3690,46
2021-05-11,Butte,007,227075,12406,12008,1783,13791,199
2021-05-11,Calaveras,009,45235,2130,2118,14,2132,52
2021-05-11,Colusa,011,21464,1933,1939,298,2237,14
2021-05-11,Contra Costa,013,1133247,68974,68406,1257,69663,806
2021-05-11,Del Norte,015,27424,1388,1347,12,1359,8
2021-05-11,El Dorado,017,186661,10184,10108,720,10828,112
2021-05-11,Fresno,019,978130,102305,101792,8678,110470,1686
2021-05-11,Glenn,021,27897,2418,2387,559,2946,17
2021-05-11,Humboldt,023,135768,4070,3964,33,3997,37
2021-05-11,Imperial,025,180216,28506,28413,2756,31169,722
2021-05-11,Inyo,027,18085,1402,1402,12,1414,36
2021-05-11,Kern,029,883053,96980,95938,10782,106720,1310
2021-05-11,Kings,031,150075,23125,22887,1089,23976,246
2021-05-11,Lake,033,64148,3496,3473,9,3482,43
2021-05-11,Lassen,035,31185,5189,5148,108,5256,6
2021-05-11,Los Angeles,037,10098052,1203112,1195100,41631,1236731,24048
2021-05-11,Madera,039,155013,16556,16459,930,17389,238
2021-05-11,Marin,041,260295,14043,13987,251,14238,227
2021-05-11,Mariposa,043,17540,428,421,11,432,5
2021-05-11,Mendocino,045,87422,3912,3821,80,3901,46
2021-05-11,Merced,047,269075,30833,30893,1051,31944,449
2021-05-11,Modoc,049,8938,373,362,125,487,3
2021-05-11,Mono,051,14174,1253,1265,17,1282,3
2021-05-11,Monterey,053,433212,43093,42934,1874,44808,380
2021-05-11,Napa,055,140530,9863,9870,36,9906,81
2021-05-11,Nevada,057,99092,4771,4737,187,4924,70
2021-05-11,Orange,059,3164182,254879,253545,11300,264845,5017
2021-05-11,Placer,061,380077,23013,22615,1458,24073,287
2021-05-11,Plumas,063,18699,696,679,10,689,4
2021-05-11,Riverside,065,2383286,293473,287757,13985,301742,4429
2021-05-11,Sacramento,067,1510023,104890,104496,1725,106221,1616
2021-05-11,San Benito,069,59416,6051,6058,114,6172,63
2021-05-11,San Bernardino,071,2135413,292721,291421,8965,300386,4707
2021-05-11,San Diego,073,3302833,279420,278308,14758,293066,3725
2021-05-11,San Francisco,075,870044,36533,36707,1275,37982,543
2021-05-11,San Joaquin,077,732212,72633,71999,3524,75523,1356
2021-05-11,San Luis Obispo,079,281455,21275,21008,728,21736,255
2021-05-11,San Mateo,081,765935,42202,41985,466,42451,425
2021-05-11,Santa Barbara,083,443738,34340,34207,1138,35345,456
2021-05-11,Santa Clara,085,1922200,118222,118857,757,119614,2005
2021-05-11,Santa Cruz,087,273765,16170,16113,813,16926,206
2021-05-11,Shasta,089,179085,12089,12050,1526,13576,200
2021-05-11,Sierra,091,2930,56,54,12,66,0
2021-05-11,Siskiyou,093,43540,1862,1756,342,2098,13
2021-05-11,Solano,095,438530,32559,32499,541,33040,250
2021-05-11,Sonoma,097,501317,29820,29966,330,30296,318
2021-05-11,Stanislaus,099,539301,55878,55589,5891,61480,909
2021-05-11,Sutter,101,95872,9385,9417,83,9500,112
2021-05-11,Tehama,103,63373,5019,4985,565,5550,62
2021-05-11,Trinity,105,12862,482,327,89,416,3
2021-05-11,Tulare,107,460477,50039,48974,8980,57954,837
2021-05-11,Tuolumne,109,53932,3998,4056,39,4095,63
2021-05-11,Ventura,111,848112,81138,80544,2982,83526,1008
2021-05-11,Yolo,113,214977,13876,13902,302,14204,210
2021-05-11,Yuba,115,75493,5984,5950,122,6072,46
2021-05-10,Alameda,001,1643700,87546,87366,1941,89307,1284
2021-05-10,Alpine,003,1148,87,88,0,88,0
2021-05-10,Amador,005,37829,3664,3657,33,3690,46
2021-05-10,Butte,007,227075,12390,11993,1779,13772,199
2021-05-10,Calaveras,009,45235,2123,2118,14,2132,52
2021-05-10,Colusa,011,21464,1933,1939,298,2237,14
2021-05-10,Contra Costa,013,1133247,68910,68357,1257,69614,806
2021-05-10,Del Norte,015,27424,1385,1339,12,1351,8
2021-05-10,El Dorado,017,186661,10170,10093,720,10813,113
2021-05-10,Fresno,019,978130,102273,101755,8671,110426,1682
2021-05-10,Glenn,021,27897,2417,2384,557,2941,17
2021-05-10,Humboldt,023,135768,4040,3961,33,3994,36
2021-05-10,Imperial,025,180216,28492,28397,2752,31149,722
2021-05-10,Inyo,027,18085,1402,1401,12,1413,36
2021-05-10,Kern,029,883053,96937,95920,10768,106688,1310
2021-05-10,Kings,031,150075,23114,22884,1088,23972,246
2021-05-10,Lake,033,64148,3488,3471,9,3480,43
2021-05-10,Lassen,035,31185,5185,5148,108,5256,5
2021-05-10,Los Angeles,037,10098052,1202849,1194976,41615,1236591,24030
2021-05-10,Madera,039,155013,16546,16450,930,17380,238
2021-05-10,Marin,041,260295,14040,13981,251,14232,228
2021-05-10,Mariposa,043,17540,427,420,11,431,5
2021-05-10,Mendocino,045,87422,3906,3818,80,3898,46
2021-05-10,Merced,047,269075,30822,30880,1051,31931,448
2021-05-10,Modoc,049,8938,373,361,125,486,3
2021-05-10,Mono,051,14174,1253,1265,17,1282,3
2021-05-10,Monterey,053,433212,43087,42927,1869,44796,380
2021-05-10,Napa,055,140530,9861,9860,36,9896,81
2021-05-10,Nevada,057,99092,4764,4735,187,4922,70
2021-05-10,Orange,059,3164182,254826,253484,11294,264778,5008
2021-05-10,Placer,061,380077,22991,22590,1455,24045,286
2021-05-10,Plumas,063,18699,695,679,10,689,4
2021-05-10,Riverside,065,2383286,293404,287689,13979,301668,4427
2021-05-10,Sacramento,067,1510023,104777,104378,1720,106098,1613
2021-05-10,San Benito,069,59416,6050,6058,114,6172,63
2021-05-10,San Bernardino,071,2135413,292669,291360,8964,300324,4707
2021-05-10,San Diego,073,3302833,279255,278183,14731,292914,3725
2021-05-10,San Francisco,075,870044,36514,36683,1275,37958,543
2021-05-10,San Joaquin,077,732212,72596,71954,3509,75463,1356
2021-05-10,San Luis Obispo,079,281455,21257,20993,727,21720,256
2021-05-10,San Mateo,081,765935,42184,41926,466,42392,424
2021-05-10,Santa Barbara,083,443738,34332,34201,1138,35339,456
2021-05-10,Santa Clara,085,1922200,118163,118822,757,119579,2003
2021-05-10,Santa Cruz,087,273765,16165,16114,813,16927,206
2021-05-10,Shasta,089,179085,12075,12036,1522,13558,200
2021-05-10,Sierra,091,2930,56,54,12,66,0
2021-05-10,Siskiyou,093,43540,1852,1752,340,2092,13
2021-05-10,Solano,095,438530,32539,32466,539,33005,250
2021-05-10,Sonoma,097,501317,29805,29955,329,30284,318
2021-05-10,Stanislaus,099,539301,55804,55541,5885,61426,898
2021-05-10,Sutter,101,95872,9379,9412,83,9495,111
2021-05-10,Tehama,103,63373,5015,4980,565,5545,62
2021-05-10,Trinity,105,12862,482,327,87,414,3
2021-05-10,Tulare,107,460477,50015,48956,8974,57930,837
2021-05-10,Tuolumne,109,53932,3994,4054,38,4092,63
2021-05-10,Ventura,111,848112,81122,80501,2980,83481,1008
2021-05-10,Yolo,113,214977,13864,13898,300,14198,209
2021-05-10,Yuba,115,75493,5982,5942,122,6064,46
2021-05-09,Alameda,001,1643700,87475,87292,1938,89230,1284
2021-05-09,Alpine,003,1148,87,88,0,88,0
2021-05-09,Amador,005,37829,3662,3655,33,3688,46
2021-05-09,Butte,007,227075,12372,11985,1775,13760,199
2021-05-09,Calaveras,009,45235,2122,2116,14,2130,52
2021-05-09,Colusa,011,21464,1932,1940,298,2238,14
2021-05-09,Contra Costa,013,1133247,68847,68302,1255,69557,806
2021-05-09,Del Norte,015,27424,1378,1338,12,1350,8
2021-05-09,El Dorado,017,186661,10156,10089,717,10806,113
2021-05-09,Fresno,019,978130,102235,101729,8662,110391,1682
2021-05-09,Glenn,021,27897,2410,2382,554,2936,17
2021-05-09,Humboldt,023,135768,4020,3950,33,3983,36
2021-05-09,Imperial,025,180216,28469,28388,2744,31132,722
2021-05-09,Inyo,027,18085,1402,1401,11,1412,36
2021-05-09,Kern,029,883053,96909,95903,10758,106661,1310
2021-05-09,Kings,031,150075,23105,22878,1088,23966,246
2021-05-09,Lake,033,64148,3484,3471,9,3480,43
2021-05-09,Lassen,035,31185,5183,5147,108,5255,5
2021-05-09,Los Angeles,037,10098052,1202588,1194820,41599,1236419,24026
2021-05-09,Madera,039,155013,16537,16444,924,17368,238
2021-05-09,Marin,041,260295,14029,13979,250,14229,228
2021-05-09,Mariposa,043,17540,424,420,11,431,5
2021-05-09,Mendocino,045,87422,3896,3814,80,3894,46
2021-05-09,Merced,047,269075,30799,30883,1051,31934,448
2021-05-09,Modoc,049,8938,373,360,125,485,3
2021-05-09,Mono,051,14174,1253,1264,17,1281,3
2021-05-09,Monterey,053,433212,43069,42918,1869,44787,380
2021-05-09,Napa,055,140530,9850,9857,36,9893,81
2021-05-09,Nevada,057,99092,4757,4727,187,4914,70
2021-05-09,Orange,059,3164182,254772,253451,11286,264737,5008
2021-05-09,Placer,061,380077,22965,22566,1452,24018,286
2021-05-09,Plumas,063,18699,694,679,10,689,4
2021-05-09,Riverside,065,2383286,293324,287644,13973,301617,4427
2021-05-09,Sacramento,067,1510023,104628,104309,1714,106023,1612
2021-05-09,San Benito,069,59416,6048,6056,114,6170,63
2021-05-09,San Bernardino,071,2135413,292586,291337,8958,300295,4707
2021-05-09,San Diego,073,3302833,279088,277950,14709,292659,3725
2021-05-09,San Francisco,075,870044,36488,36669,1273,37942,543
2021-05-09,San Joaquin,077,732212,72550,71927,3508,75435,1356
2021-05-09,San Luis Obispo,079,281455,21246,20999,727,21726,256
2021-05-09,San Mateo,081,765935,42155,41903,466,42369,424
2021-05-09,Santa Barbara,083,443738,34319,34196,1137,35333,456
2021-05-09,Santa Clara,085,1922200,118109,118798,756,119554,2003
2021-05-09,Santa Cruz,087,273765,16159,16094,813,16907,206
2021-05-09,Shasta,089,179085,12045,12034,1517,13551,200
2021-05-09,Sierra,091,2930,56,54,12,66,0
2021-05-09,Siskiyou,093,43540,1845,1741,337,2078,13
2021-05-09,Solano,095,438530,32500,32434,536,32970,250
2021-05-09,Sonoma,097,501317,29791,29953,328,30281,318
2021-05-09,Stanislaus,099,539301,55738,55511,5881,61392,898
2021-05-09,Sutter,101,95872,9373,9413,83,9496,111
2021-05-09,Tehama,103,63373,5010,4979,565,5544,62
2021-05-09,Trinity,105,12862,482,327,87,414,3
2021-05-09,Tulare,107,460477,49988,48948,8969,57917,837
2021-05-09,Tuolumne,109,53932,3993,4053,38,4091,63
2021-05-09,Ventura,111,848112,81107,80487,2979,83466,1008
2021-05-09,Yolo,113,214977,13854,13897,299,14196,209
2021-05-09,Yuba,115,75493,5976,5934,122,6056,46
2021-05-08,Alameda,001,1643700,87433,87213,1934,89147,1284
2021-05-08,Alpine,003,1148,87,88,0,88,0
2021-05-08,Amador,005,37829,3660,3652,33,3685,46
2021-05-08,Butte,007,227075,12360,11962,1774,13736,199
2021-05-08,Calaveras,009,45235,2121,2114,14,2128,52
2021-05-08,Colusa,011,21464,1932,1939,298,2237,14
2021-05-08,Contra Costa,013,1133247,68814,68223,1253,69476,803
2021-05-08,Del Norte,015,27424,1375,1335,12,1347,8
2021-05-08,El Dorado,017,186661,10142,10079,717,10796,113
2021-05-08,Fresno,019,978130,102199,101676,8657,110333,1682
2021-05-08,Glenn,021,27897,2408,2382,552,2934,17
2021-05-08,Humboldt,023,135768,4004,3939,33,3972,36
2021-05-08,Imperial,025,180216,28461,28373,2744,31117,721
2021-05-08,Inyo,027,18085,1402,1402,11,1413,36
2021-05-08,Kern,029,883053,96884,95880,10745,106625,1310
2021-05-08,Kings,031,150075,23102,22872,1087,23959,246
2021-05-08,Lake,033,64148,3483,3470,9,3479,43
2021-05-08,Lassen,035,31185,5182,5145,108,5253,5
2021-05-08,Los Angeles,037,10098052,1202437,1194584,41582,1236166,24022
2021-05-08,Madera,039,155013,16533,16442,924,17366,238
2021-05-08,Marin,041,260295,14026,13974,249,14223,228
2021-05-08,Mariposa,043,17540,424,420,11,431,5
2021-05-08,Mendocino,045,87422,3891,3810,79,3889,46
2021-05-08,Merced,047,269075,30790,30876,1051,31927,448
2021-05-08,Modoc,049,8938,373,360,124,484,3
2021-05-08,Mono,051,14174,1253,1262,17,1279,3
2021-05-08,Monterey,053,433212,43064,42914,1868,44782,380
2021-05-08,Napa,055,140530,9843,9853,36,9889,81
2021-05-08,Nevada,057,99092,4754,4716,187,4903,70
2021-05-08,Orange,059,3164182,254738,253412,11283,264695,5006
2021-05-08,Placer,061,380077,22947,22547,1450,23997,286
2021-05-08,Plumas,063,18699,693,679,10,689,4
2021-05-08,Riverside,065,2383286,293281,287574,13971,301545,4427
2021-05-08,Sacramento,067,1510023,104543,104208,1711,105919,1610
2021-05-08,San Benito,069,59416,6047,6048,114,6162,63
2021-05-08,San Bernardino,071,2135413,292543,291296,8958,300254,4707
2021-05-08,San Diego,073,3302833,279004,277760,14691,292451,3725
2021-05-08,San Francisco,075,870044,36465,36642,1273,37915,543
2021-05-08,San Joaquin,077,732212,72521,71869,3499,75368,1356
2021-05-08,San Luis Obispo,079,281455,21235,20992,727,21719,256
2021-05-08,San Mateo,081,765935,42144,41871,466,42337,424
2021-05-08,Santa Barbara,083,443738,34306,34185,1137,35322,456
2021-05-08,Santa Clara,085,1922200,118078,118751,756,119507,2003
2021-05-08,Santa Cruz,087,273765,16156,16089,813,16902,206
2021-05-08,Shasta,089,179085,12035,12030,1513,13543,200
2021-05-08,Sierra,091,2930,56,54,12,66,0
2021-05-08,Siskiyou,093,43540,1844,1741,333,2074,13
2021-05-08,Solano,095,438530,32476,32395,534,32929,249
2021-05-08,Sonoma,097,501317,29778,29942,328,30270,318
2021-05-08,Stanislaus,099,539301,55707,55467,5877,61344,898
2021-05-08,Sutter,101,95872,9370,9413,83,9496,111
2021-05-08,Tehama,103,63373,5008,4977,565,5542,62
2021-05-08,Trinity,105,12862,482,327,87,414,3
2021-05-08,Tulare,107,460477,49974,48929,8959,57888,837
2021-05-08,Tuolumne,109,53932,3992,4050,38,4088,63
2021-05-08,Ventura,111,848112,81096,80481,2976,83457,1008
2021-05-08,Yolo,113,214977,13851,13894,298,14192,209
2021-05-08,Yuba,115,75493,5968,5928,122,6050,46
2021-05-07,Alameda,001,1643700,87379,87128,1933,89061,1280
2021-05-07,Alpine,003,1148,87,88,0,88,0
2021-05-07,Amador,005,37829,3657,3651,33,3684,46
2021-05-07,Butte,007,227075,12339,11943,1771,13714,199
2021-05-07,Calaveras,009,45235,2119,2114,14,2128,52
2021-05-07,Colusa,011,21464,1932,1937,298,2235,14
2021-05-07,Contra Costa,013,1133247,68767,68156,1251,69407,804
2021-05-07,Del Norte,015,27424,1370,1329,12,1341,8
2021-05-07,El Dorado,017,186661,10129,10065,715,10780,112
2021-05-07,Fresno,019,978130,102166,101625,8656,110281,1684
2021-05-07,Glenn,021,27897,2405,2381,551,2932,17
2021-05-07,Humboldt,023,135768,3989,3919,33,3952,36
2021-05-07,Imperial,025,180216,28453,28352,2744,31096,721
2021-05-07,Inyo,027,18085,1402,1402,11,1413,36
2021-05-07,Kern,029,883053,96871,95839,10733,106572,1308
2021-05-07,Kings,031,150075,23101,22857,1086,23943,246
2021-05-07,Lake,033,64148,3481,3467,9,3476,43
2021-05-07,Lassen,035,31185,5181,5144,107,5251,5
2021-05-07,Los Angeles,037,10098052,1202259,1194294,41574,1235868,24008
2021-05-07,Madera,039,155013,16528,16439,923,17362,238
2021-05-07,Marin,041,260295,14022,13968,249,14217,228
2021-05-07,Mariposa,043,17540,423,419,11,430,5
2021-05-07,Mendocino,045,87422,3885,3805,79,3884,46
2021-05-07,Merced,047,269075,30787,30862,1051,31913,446
2021-05-07,Modoc,049,8938,373,360,124,484,3
2021-05-07,Mono,051,14174,1252,1261,17,1278,3
2021-05-07,Monterey,053,433212,43058,42909,1866,44775,380
2021-05-07,Napa,055,140530,9842,9849,36,9885,81
2021-05-07,Nevada,057,99092,4750,4704,187,4891,70
2021-05-07,Orange,059,3164182,254698,253338,11274,264612,5000
2021-05-07,Placer,061,380077,22927,22524,1448,23972,286
2021-05-07,Plumas,063,18699,693,678,10,688,4
2021-05-07,Riverside,065,2383286,293223,287479,13970,301449,4426
2021-05-07,Sacramento,067,1510023,104471,104068,1706,105774,1609
2021-05-07,San Benito,069,59416,6046,6048,114,6162,63
2021-05-07,San Bernardino,071,2135413,292501,291185,8953,300138,4697
2021-05-07,San Diego,073,3302833,278918,277534,14676,292210,3718
2021-05-07,San Francisco,075,870044,36452,36616,1272,37888,543
2021-05-07,San Joaquin,077,732212,72481,71804,3497,75301,1351
2021-05-07,San Luis Obispo,079,281455,21228,20979,727,21706,256
2021-05-07,San Mateo,081,765935,42128,41844,466,42310,424
2021-05-07,Santa Barbara,083,443738,34296,34166,1137,35303,453
2021-05-07,Santa Clara,085,1922200,118045,118691,755,119446,2002
2021-05-07,Santa Cruz,087,273765,16153,16074,813,16887,206
2021-05-07,Shasta,089,179085,12013,12005,1511,13516,200
2021-05-07,Sierra,091,2930,56,54,12,66,0
2021-05-07,Siskiyou,093,43540,1841,1723,333,2056,13
2021-05-07,Solano,095,438530,32448,32352,532,32884,249
2021-05-07,Sonoma,097,501317,29760,29925,326,30251,318
2021-05-07,Stanislaus,099,539301,55666,55407,5872,61279,896
2021-05-07,Sutter,101,95872,9370,9407,82,9489,111
2021-05-07,Tehama,103,63373,5001,4974,565,5539,57
2021-05-07,Trinity,105,12862,482,327,87,414,3
2021-05-07,Tulare,107,460477,49957,48913,8954,57867,837
2021-05-07,Tuolumne,109,53932,3990,4048,38,4086,63
2021-05-07,Ventura,111,848112,81072,80444,2976,83420,1008
2021-05-07,Yolo,113,214977,13845,13875,297,14172,209
2021-05-07,Yuba,115,75493,5958,5910,122,6032,46
2021-05-06,Alameda,001,1643700,87302,87028,1930,88958,1278
2021-05-06,Alpine,003,1148,87,88,0,88,0
2021-05-06,Amador,005,37829,3655,3650,33,3683,46
2021-05-06,Butte,007,227075,12319,11929,1766,13695,198
2021-05-06,Calaveras,009,45235,2118,2111,14,2125,52
2021-05-06,Colusa,011,21464,1932,1935,298,2233,14
2021-05-06,Contra Costa,013,1133247,68712,68076,1248,69324,802
2021-05-06,Del Norte,015,27424,1362,1324,12,1336,6
2021-05-06,El Dorado,017,186661,10122,10048,715,10763,112
2021-05-06,Fresno,019,978130,102122,101536,8652,110188,1680
2021-05-06,Glenn,021,27897,2404,2380,550,2930,17
2021-05-06,Humboldt,023,135768,3964,3898,33,3931,36
2021-05-06,Imperial,025,180216,28442,28311,2743,31054,720
2021-05-06,Inyo,027,18085,1402,1401,11,1412,36
2021-05-06,Kern,029,883053,96846,95801,10716,106517,1307
2021-05-06,Kings,031,150075,23094,22848,1085,23933,246
2021-05-06,Lake,033,64148,3480,3465,9,3474,43
2021-05-06,Lassen,035,31185,5180,5143,107,5250,1
2021-05-06,Los Angeles,037,10098052,1202018,1193954,41557,1235511,23991
2021-05-06,Madera,039,155013,16520,16430,923,17353,238
2021-05-06,Marin,041,260295,14018,13956,249,14205,228
2021-05-06,Mariposa,043,17540,422,419,11,430,5
2021-05-06,Mendocino,045,87422,3874,3802,79,3881,46
2021-05-06,Merced,047,269075,30772,30863,1050,31913,444
2021-05-06,Modoc,049,8938,373,360,124,484,3
2021-05-06,Mono,051,14174,1250,1261,17,1278,3
2021-05-06,Monterey,053,433212,43043,42899,1866,44765,379
2021-05-06,Napa,055,140530,9836,9843,36,9879,81
2021-05-06,Nevada,057,99092,4749,4687,187,4874,70
2021-05-06,Orange,059,3164182,254630,253286,11268,264554,4991
2021-05-06,Placer,061,380077,22905,22493,1448,23941,286
2021-05-06,Plumas,063,18699,693,678,10,688,4
2021-05-06,Riverside,065,2383286,293150,287399,13965,301364,4422
2021-05-06,Sacramento,067,1510023,104354,103956,1703,105659,1609
2021-05-06,San Benito,069,59416,6045,6045,114,6159,63
2021-05-06,San Bernardino,071,2135413,292431,291085,8952,300037,4683
2021-05-06,San Diego,073,3302833,278793,277324,14653,291977,3716
2021-05-06,San Francisco,075,870044,36437,36599,1272,37871,543
2021-05-06,San Joaquin,077,732212,72426,71729,3494,75223,1350
2021-05-06,San Luis Obispo,079,281455,21216,20965,725,21690,256
2021-05-06,San Mateo,081,765935,42109,41802,465,42267,424
2021-05-06,Santa Barbara,083,443738,34283,34152,1137,35289,453
2021-05-06,Santa Clara,085,1922200,118004,118591,755,119346,2001
2021-05-06,Santa Cruz,087,273765,16146,16050,813,16863,206
2021-05-06,Shasta,089,179085,11991,11983,1505,13488,199
2021-05-06,Sierra,091,2930,56,54,12,66,0
2021-05-06,Siskiyou,093,43540,1831,1711,332,2043,12
2021-05-06,Solano,095,438530,32422,32320,524,32844,249
2021-05-06,Sonoma,097,501317,29752,29911,326,30237,318
2021-05-06,Stanislaus,099,539301,55610,55323,5867,61190,834
2021-05-06,Sutter,101,95872,9364,9396,82,9478,111
2021-05-06,Tehama,103,63373,4996,4970,565,5535,53
2021-05-06,Trinity,105,12862,482,327,87,414,3
2021-05-06,Tulare,107,460477,49932,48890,8939,57829,836
2021-05-06,Tuolumne,109,53932,3986,4047,38,4085,63
2021-05-06,Ventura,111,848112,81041,80411,2973,83384,1005
2021-05-06,Yolo,113,214977,13838,13871,293,14164,209
2021-05-06,Yuba,115,75493,5946,5901,122,6023,46
2021-05-05,Alameda,001,1643700,87240,86950,1928,88878,1278
2021-05-05,Alpine,003,1148,87,88,0,88,0
2021-05-05,Amador,005,37829,3652,3650,33,3683,46
2021-05-05,Butte,007,227075,12301,11907,1763,13670,198
2021-05-05,Calaveras,009,45235,2114,2103,14,2117,52
2021-05-05,Colusa,011,21464,1931,1933,298,2231,14
2021-05-05,Contra Costa,013,1133247,68647,67997,1244,69241,803
2021-05-05,Del Norte,015,27424,1359,1317,12,1329,6
2021-05-05,El Dorado,017,186661,10111,10020,714,10734,111
2021-05-05,Fresno,019,978130,102073,101491,8643,110134,1680
2021-05-05,Glenn,021,27897,2401,2380,549,2929,17
2021-05-05,Humboldt,023,135768,3945,3886,32,3918,36
2021-05-05,Imperial,025,180216,28401,28295,2736,31031,720
2021-05-05,Inyo,027,18085,1401,1401,11,1412,36
2021-05-05,Kern,029,883053,96802,95753,10712,106465,1304
2021-05-05,Kings,031,150075,23088,22840,1084,23924,246
2021-05-05,Lake,033,64148,3477,3458,9,3467,43
2021-05-05,Lassen,035,31185,5180,5143,106,5249,1
2021-05-05,Los Angeles,037,10098052,1201747,1193608,41543,1235151,23977
2021-05-05,Madera,039,155013,16518,16423,923,17346,235
2021-05-05,Marin,041,260295,14010,13950,248,14198,228
2021-05-05,Mariposa,043,17540,422,418,11,429,5
2021-05-05,Mendocino,045,87422,3870,3799,79,3878,46
2021-05-05,Merced,047,269075,30751,30844,1050,31894,444
2021-05-05,Modoc,049,8938,372,361,123,484,3
2021-05-05,Mono,051,14174,1250,1260,17,1277,3
2021-05-05,Monterey,053,433212,43029,42870,1863,44733,379
2021-05-05,Napa,055,140530,9830,9833,36,9869,81
2021-05-05,Nevada,057,99092,4746,4666,187,4853,70
2021-05-05,Orange,059,3164182,254572,253237,11263,264500,4978
2021-05-05,Placer,061,380077,22873,22362,1444,23806,287
2021-05-05,Plumas,063,18699,693,677,10,687,4
2021-05-05,Riverside,065,2383286,293055,287353,13955,301308,4414
2021-05-05,Sacramento,067,1510023,104266,103476,1698,105174,1607
2021-05-05,San Benito,069,59416,6036,6046,114,6160,63
2021-05-05,San Bernardino,071,2135413,292356,291008,8948,299956,4677
2021-05-05,San Diego,073,3302833,278656,277098,14633,291731,3716
2021-05-05,San Francisco,075,870044,36423,36577,1271,37848,543
2021-05-05,San Joaquin,077,732212,72373,71638,3491,75129,1345
2021-05-05,San Luis Obispo,079,281455,21208,20958,725,21683,256
2021-05-05,San Mateo,081,765935,42079,41755,464,42219,415
2021-05-05,Santa Barbara,083,443738,34268,34139,1136,35275,453
2021-05-05,Santa Clara,085,1922200,117974,118482,751,119233,1992
2021-05-05,Santa Cruz,087,273765,16140,16013,813,16826,207
2021-05-05,Shasta,089,179085,11975,11939,1501,13440,200
2021-05-05,Sierra,091,2930,56,54,12,66,0
2021-05-05,Siskiyou,093,43540,1814,1706,324,2030,11
2021-05-05,Solano,095,438530,32387,32250,522,32772,249
2021-05-05,Sonoma,097,501317,29739,29879,326,30205,318
2021-05-05,Stanislaus,099,539301,55553,55231,5865,61096,807
2021-05-05,Sutter,101,95872,9358,9387,82,9469,111
2021-05-05,Tehama,103,63373,4992,4968,565,5533,53
2021-05-05,Trinity,105,12862,482,326,87,413,3
2021-05-05,Tulare,107,460477,49908,48875,8932,57807,835
2021-05-05,Tuolumne,109,53932,3983,4040,38,4078,63
2021-05-05,Ventura,111,848112,81013,80372,2969,83341,1005
2021-05-05,Yolo,113,214977,13834,13846,291,14137,209
2021-05-05,Yuba,115,75493,5936,5895,121,6016,44
2021-05-04,Alameda,001,1643700,87148,86894,1928,88822,1277
2021-05-04,Alpine,003,1148,87,88,0,88,0
2021-05-04,Amador,005,37829,3652,3650,33,3683,46
2021-05-04,Butte,007,227075,12277,11883,1762,13645,198
2021-05-04,Calaveras,009,45235,2109,2100,14,2114,52
2021-05-04,Colusa,011,21464,1930,1933,298,2231,14
2021-05-04,Contra Costa,013,1133247,68567,67931,1242,69173,799
2021-05-04,Del Norte,015,27424,1359,1314,12,1326,6
2021-05-04,El Dorado,017,186661,10100,10009,710,10719,110
2021-05-04,Fresno,019,978130,102018,101451,8636,110087,1677
2021-05-04,Glenn,021,27897,2398,2379,546,2925,17
2021-05-04,Humboldt,023,135768,3919,3877,32,3909,36
2021-05-04,Imperial,025,180216,28381,28276,2732,31008,720
2021-05-04,Inyo,027,18085,1401,1399,11,1410,36
2021-05-04,Kern,029,883053,96766,95720,10694,106414,1301
2021-05-04,Kings,031,150075,23074,22822,1081,23903,246
2021-05-04,Lake,033,64148,3476,3454,9,3463,43
2021-05-04,Lassen,035,31185,5179,5142,106,5248,1
2021-05-04,Los Angeles,037,10098052,1201460,1193453,41531,1234984,23957
2021-05-04,Madera,039,155013,16517,16418,923,17341,235
2021-05-04,Marin,041,260295,14002,13935,248,14183,228
2021-05-04,Mariposa,043,17540,422,418,11,429,5
2021-05-04,Mendocino,045,87422,3865,3794,79,3873,46
2021-05-04,Merced,047,269075,30734,30829,1050,31879,444
2021-05-04,Modoc,049,8938,371,360,122,482,3
2021-05-04,Mono,051,14174,1250,1260,17,1277,3
2021-05-04,Monterey,053,433212,43017,42845,1862,44707,380
2021-05-04,Napa,055,140530,9821,9824,36,9860,81
2021-05-04,Nevada,057,99092,4739,4656,187,4843,70
2021-05-04,Orange,059,3164182,254504,253177,11253,264430,4977
2021-05-04,Placer,061,380077,22844,22326,1441,23767,287
2021-05-04,Plumas,063,18699,692,675,10,685,4
2021-05-04,Riverside,065,2383286,292971,287285,13948,301233,4411
2021-05-04,Sacramento,067,1510023,104137,103383,1693,105076,1604
2021-05-04,San Benito,069,59416,6035,6039,114,6153,63
2021-05-04,San Bernardino,071,2135413,292279,290934,8941,299875,4668
2021-05-04,San Diego,073,3302833,278490,276879,14616,291495,3713
2021-05-04,San Francisco,075,870044,36405,36550,1271,37821,541
2021-05-04,San Joaquin,077,732212,72312,71582,3486,75068,1342
2021-05-04,San Luis Obispo,079,281455,21202,20923,723,21646,255
2021-05-04,San Mateo,081,765935,42053,41708,464,42172,415
2021-05-04,Santa Barbara,083,443738,34252,34131,1135,35266,453
2021-05-04,Santa Clara,085,1922200,117911,118431,750,119181,1988
2021-05-04,Santa Cruz,087,273765,16134,16005,813,16818,207
2021-05-04,Shasta,089,179085,11955,11923,1495,13418,198
2021-05-04,Sierra,091,2930,56,54,12,66,0
2021-05-04,Siskiyou,093,43540,1807,1694,322,2016,11
2021-05-04,Solano,095,438530,32346,32220,520,32740,249
2021-05-04,Sonoma,097,501317,29719,29867,325,30192,318
2021-05-04,Stanislaus,099,539301,55497,55165,5862,61027,807
2021-05-04,Sutter,101,95872,9353,9375,82,9457,111
2021-05-04,Tehama,103,63373,4989,4959,564,5523,53
2021-05-04,Trinity,105,12862,482,326,87,413,3
2021-05-04,Tulare,107,460477,49881,48857,8923,57780,835
2021-05-04,Tuolumne,109,53932,3981,4041,38,4079,61
2021-05-04,Ventura,111,848112,80984,80351,2967,83318,1005
2021-05-04,Yolo,113,214977,13821,13820,289,14109,208
2021-05-04,Yuba,115,75493,5930,5891,121,6012,44
2021-05-03,Alameda,001,1643700,87072,86845,1922,88767,1272
2021-05-03,Alpine,003,1148,87,88,0,88,0
2021-05-03,Amador,005,37829,3652,3651,33,3684,46
2021-05-03,Butte,007,227075,12267,11864,1759,13623,198
2021-05-03,Calaveras,009,45235,2108,2099,14,2113,50
2021-05-03,Colusa,011,21464,1929,1931,296,2227,14
2021-05-03,Contra Costa,013,1133247,68508,67895,1238,69133,799
2021-05-03,Del Norte,015,27424,1354,1306,11,1317,6
2021-05-03,El Dorado,017,186661,10082,9984,705,10689,110
2021-05-03,Fresno,019,978130,101962,101405,8625,110030,1678
2021-05-03,Glenn,021,27897,2398,2375,545,2920,17
2021-05-03,Humboldt,023,135768,3904,3865,32,3897,36
2021-05-03,Imperial,025,180216,28359,28280,2729,31009,720
2021-05-03,Inyo,027,18085,1400,1398,11,1409,36
2021-05-03,Kern,029,883053,96729,95693,10682,106375,1299
2021-05-03,Kings,031,150075,23065,22821,1081,23902,246
2021-05-03,Lake,033,64148,3474,3446,9,3455,43
2021-05-03,Lassen,035,31185,5178,5142,106,5248,1
2021-05-03,Los Angeles,037,10098052,1201191,1193261,41505,1234766,23942
2021-05-03,Madera,039,155013,16512,16414,922,17336,235
2021-05-03,Marin,041,260295,13996,13927,248,14175,228
2021-05-03,Mariposa,043,17540,422,418,11,429,5
2021-05-03,Mendocino,045,87422,3858,3792,79,3871,46
2021-05-03,Merced,047,269075,30723,30814,1048,31862,444
2021-05-03,Modoc,049,8938,371,360,122,482,3
2021-05-03,Mono,051,14174,1250,1259,17,1276,3
2021-05-03,Monterey,053,433212,43005,42837,1860,44697,380
2021-05-03,Napa,055,140530,9816,9815,36,9851,81
2021-05-03,Nevada,057,99092,4731,4650,187,4837,70
2021-05-03,Orange,059,3164182,254445,253107,11244,264351,4968
2021-05-03,Placer,061,380077,22813,22289,1435,23724,287
2021-05-03,Plumas,063,18699,691,675,10,685,4
2021-05-03,Riverside,065,2383286,292897,287233,13947,301180,4412
2021-05-03,Sacramento,067,1510023,103984,103303,1683,104986,1602
2021-05-03,San Benito,069,59416,6034,6038,114,6152,63
2021-05-03,San Bernardino,071,2135413,292211,290886,8938,299824,4659
2021-05-03,San Diego,073,3302833,278327,276693,14591,291284,3712
2021-05-03,San Francisco,075,870044,36379,36538,1271,37809,541
2021-05-03,San Joaquin,077,732212,72262,71504,3483,74987,1325
2021-05-03,San Luis Obispo,079,281455,21186,20915,720,21635,254
2021-05-03,San Mateo,081,765935,42030,41689,463,42152,413
2021-05-03,Santa Barbara,083,443738,34240,34119,1135,35254,453
2021-05-03,Santa Clara,085,1922200,117857,118373,749,119122,1988
2021-05-03,Santa Cruz,087,273765,16131,16000,813,16813,207
2021-05-03,Shasta,089,179085,11932,11890,1490,13380,197
2021-05-03,Sierra,091,2930,56,54,12,66,0
2021-05-03,Siskiyou,093,43540,1801,1683,316,1999,11
2021-05-03,Solano,095,438530,32305,32201,519,32720,249
2021-05-03,Sonoma,097,501317,29707,29855,322,30177,318
2021-05-03,Stanislaus,099,539301,55431,55116,5853,60969,774
2021-05-03,Sutter,101,95872,9341,9370,82,9452,111
2021-05-03,Tehama,103,63373,4981,4952,564,5516,53
2021-05-03,Trinity,105,12862,482,326,87,413,3
2021-05-03,Tulare,107,460477,49864,48844,8913,57757,835
2021-05-03,Tuolumne,109,53932,3980,4038,38,4076,61
2021-05-03,Ventura,111,848112,80962,80291,2967,83258,1005
2021-05-03,Yolo,113,214977,13808,13809,287,14096,208
2021-05-03,Yuba,115,75493,5925,5880,121,6001,44
2021-05-02,Alameda,001,1643700,86987,86784,1921,88705,1272
2021-05-02,Alpine,003,1148,87,88,0,88,0
2021-05-02,Amador,005,37829,3652,3650,33,3683,46
2021-05-02,Butte,007,227075,12243,11859,1756,13615,198
2021-05-02,Calaveras,009,45235,2104,2098,14,2112,50
2021-05-02,Colusa,011,21464,1928,1931,295,2226,14
2021-05-02,Contra Costa,013,1133247,68423,67843,1236,69079,800
2021-05-02,Del Norte,015,27424,1347,1305,11,1316,6
2021-05-02,El Dorado,017,186661,10067,9962,704,10666,110
2021-05-02,Fresno,019,978130,101890,101372,8614,109986,1678
2021-05-02,Glenn,021,27897,2397,2374,543,2917,17
2021-05-02,Humboldt,023,135768,3892,3858,31,3889,36
2021-05-02,Imperial,025,180216,28325,28275,2720,30995,721
2021-05-02,Inyo,027,18085,1398,1398,11,1409,36
2021-05-02,Kern,029,883053,96671,95668,10675,106343,1299
2021-05-02,Kings,031,150075,23047,22816,1080,23896,246
2021-05-02,Lake,033,64148,3472,3443,9,3452,43
2021-05-02,Lassen,035,31185,5177,5142,105,5247,1
2021-05-02,Los Angeles,037,10098052,1200841,1193056,41482,1234538,23943
2021-05-02,Madera,039,155013,16506,16410,922,17332,235
2021-05-02,Marin,041,260295,13986,13917,248,14165,228
2021-05-02,Mariposa,043,17540,422,419,11,430,5
2021-05-02,Mendocino,045,87422,3853,3787,79,3866,46
2021-05-02,Merced,047,269075,30703,30793,1044,31837,444
2021-05-02,Modoc,049,8938,370,360,122,482,3
2021-05-02,Mono,051,14174,1249,1259,17,1276,3
2021-05-02,Monterey,053,433212,42991,42837,1859,44696,380
2021-05-02,Napa,055,140530,9812,9805,36,9841,81
2021-05-02,Nevada,057,99092,4715,4635,187,4822,70
2021-05-02,Orange,059,3164182,254371,253025,11230,264255,4968
2021-05-02,Placer,061,380077,22784,22264,1432,23696,287
2021-05-02,Plumas,063,18699,691,675,10,685,4
2021-05-02,Riverside,065,2383286,292797,287197,13937,301134,4412
2021-05-02,Sacramento,067,1510023,103844,103153,1676,104829,1602
2021-05-02,San Benito,069,59416,6029,6037,114,6151,63
2021-05-02,San Bernardino,071,2135413,292112,290859,8936,299795,4655
2021-05-02,San Diego,073,3302833,278130,276521,14564,291085,3712
2021-05-02,San Francisco,075,870044,36353,36522,1271,37793,541
2021-05-02,San Joaquin,077,732212,72198,71447,3476,74923,1325
2021-05-02,San Luis Obispo,079,281455,21165,20910,719,21629,254
2021-05-02,San Mateo,081,765935,42014,41656,462,42118,412
2021-05-02,Santa Barbara,083,443738,34226,34106,1135,35241,453
2021-05-02,Santa Clara,085,1922200,117783,118321,749,119070,1988
2021-05-02,Santa Cruz,087,273765,16126,15995,812,16807,207
2021-05-02,Shasta,089,179085,11916,11885,1482,13367,197
2021-05-02,Sierra,091,2930,56,54,12,66,0
2021-05-02,Siskiyou,093,43540,1790,1661,315,1976,11
2021-05-02,Solano,095,438530,32266,32151,515,32666,249
2021-05-02,Sonoma,097,501317,29685,29842,322,30164,318
2021-05-02,Stanislaus,099,539301,55357,55057,5846,60903,774
2021-05-02,Sutter,101,95872,9335,9363,82,9445,111
2021-05-02,Tehama,103,63373,4976,4950,562,5512,53
2021-05-02,Trinity,105,12862,482,326,87,413,3
2021-05-02,Tulare,107,460477,49846,48834,8905,57739,835
2021-05-02,Tuolumne,109,53932,3977,4038,38,4076,61
2021-05-02,Ventura,111,848112,80925,80284,2966,83250,1005
2021-05-02,Yolo,113,214977,13796,13799,286,14085,208
2021-05-02,Yuba,115,75493,5915,5879,121,6000,44
2021-05-01,Alameda,001,1643700,86944,86704,1918,88622,1270
2021-05-01,Alpine,003,1148,87,88,0,88,0
2021-05-01,Amador,005,37829,3652,3650,33,3683,46
2021-05-01,Butte,007,227075,12229,11845,1751,13596,198
2021-05-01,Calaveras,009,45235,2102,2096,14,2110,50
2021-05-01,Colusa,011,21464,1927,1931,295,2226,14
2021-05-01,Contra Costa,013,1133247,68371,67779,1233,69012,800
2021-05-01,Del Norte,015,27424,1346,1292,11,1303,6
2021-05-01,El Dorado,017,186661,10053,9944,702,10646,110
2021-05-01,Fresno,019,978130,101845,101326,8608,109934,1678
2021-05-01,Glenn,021,27897,2394,2369,542,2911,17
2021-05-01,Humboldt,023,135768,3878,3845,31,3876,36
2021-05-01,Imperial,025,180216,28318,28262,2720,30982,721
2021-05-01,Inyo,027,18085,1398,1397,11,1408,36
2021-05-01,Kern,029,883053,96644,95645,10664,106309,1299
2021-05-01,Kings,031,150075,23044,22797,1079,23876,246
2021-05-01,Lake,033,64148,3470,3441,9,3450,43
2021-05-01,Lassen,035,31185,5175,5142,105,5247,1
2021-05-01,Los Angeles,037,10098052,1200672,1192781,41467,1234248,23946
2021-05-01,Madera,039,155013,16502,16408,922,17330,235
2021-05-01,Marin,041,260295,13979,13902,248,14150,228
2021-05-01,Mariposa,043,17540,422,418,11,429,5
2021-05-01,Mendocino,045,87422,3851,3782,79,3861,46
2021-05-01,Merced,047,269075,30686,30771,1043,31814,444
2021-05-01,Modoc,049,8938,370,361,122,483,3
2021-05-01,Mono,051,14174,1249,1258,17,1275,3
2021-05-01,Monterey,053,433212,42985,42828,1859,44687,379
2021-05-01,Napa,055,140530,9809,9800,36,9836,81
2021-05-01,Nevada,057,99092,4710,4625,187,4812,70
2021-05-01,Orange,059,3164182,254328,252969,11219,264188,4964
2021-05-01,Placer,061,380077,22758,22240,1430,23670,287
2021-05-01,Plumas,063,18699,690,675,10,685,4
2021-05-01,Riverside,065,2383286,292758,287129,13935,301064,4412
2021-05-01,Sacramento,067,1510023,103763,103043,1675,104718,1602
2021-05-01,San Benito,069,59416,6026,6030,114,6144,63
2021-05-01,San Bernardino,071,2135413,292069,290802,8934,299736,4652
2021-05-01,San Diego,073,3302833,278006,276367,14543,290910,3706
2021-05-01,San Francisco,075,870044,36338,36496,1271,37767,541
2021-05-01,San Joaquin,077,732212,72149,71389,3474,74863,1325
2021-05-01,San Luis Obispo,079,281455,21160,20896,719,21615,254
2021-05-01,San Mateo,081,765935,41985,41617,461,42078,411
2021-05-01,Santa Barbara,083,443738,34221,34085,1134,35219,453
2021-05-01,Santa Clara,085,1922200,117731,118265,747,119012,1988
2021-05-01,Santa Cruz,087,273765,16123,15984,812,16796,207
2021-05-01,Shasta,089,179085,11896,11878,1474,13352,197
2021-05-01,Sierra,091,2930,56,53,12,65,0
2021-05-01,Siskiyou,093,43540,1782,1653,314,1967,11
2021-05-01,Solano,095,438530,32236,32124,507,32631,249
2021-05-01,Sonoma,097,501317,29682,29835,322,30157,318
2021-05-01,Stanislaus,099,539301,55322,55005,5840,60845,774
2021-05-01,Sutter,101,95872,9332,9358,82,9440,110
2021-05-01,Tehama,103,63373,4975,4950,561,5511,53
2021-05-01,Trinity,105,12862,482,326,86,412,3
2021-05-01,Tulare,107,460477,49839,48818,8899,57717,835
2021-05-01,Tuolumne,109,53932,3971,4035,38,4073,61
2021-05-01,Ventura,111,848112,80907,80268,2966,83234,1005
2021-05-01,Yolo,113,214977,13789,13784,284,14068,208
2021-05-01,Yuba,115,75493,5913,5875,121,5996,44
2021-04-30,Alameda,001,1643700,86883,86602,1915,88517,1268
2021-04-30,Alpine,003,1148,87,88,0,88,0
2021-04-30,Amador,005,37829,3650,3650,33,3683,46
2021-04-30,Butte,007,227075,12210,11812,1747,13559,197
2021-04-30,Calaveras,009,45235,2101,2087,14,2101,50
2021-04-30,Colusa,011,21464,1927,1931,294,2225,14
2021-04-30,Contra Costa,013,1133247,68323,67684,1230,68914,800
2021-04-30,Del Norte,015,27424,1334,1276,11,1287,6
2021-04-30,El Dorado,017,186661,10039,9906,702,10608,110
2021-04-30,Fresno,019,978130,101799,101263,8604,109867,1670
2021-04-30,Glenn,021,27897,2393,2369,542,2911,17
2021-04-30,Humboldt,023,135768,3865,3834,31,3865,36
2021-04-30,Imperial,025,180216,28309,28244,2717,30961,721
2021-04-30,Inyo,027,18085,1398,1397,11,1408,36
2021-04-30,Kern,029,883053,96627,95605,10660,106265,1298
2021-04-30,Kings,031,150075,23041,22793,1078,23871,246
2021-04-30,Lake,033,64148,3466,3440,9,3449,43
2021-04-30,Lassen,035,31185,5174,5140,105,5245,1
2021-04-30,Los Angeles,037,10098052,1200461,1192393,41454,1233847,23919
2021-04-30,Madera,039,155013,16496,16395,922,17317,235
2021-04-30,Marin,041,260295,13971,13895,246,14141,228
2021-04-30,Mariposa,043,17540,422,417,11,428,5
2021-04-30,Mendocino,045,87422,3847,3777,79,3856,46
2021-04-30,Merced,047,269075,30673,30740,1042,31782,444
2021-04-30,Modoc,049,8938,369,360,122,482,3
2021-04-30,Mono,051,14174,1249,1258,17,1275,3
2021-04-30,Monterey,053,433212,42971,42810,1858,44668,379
2021-04-30,Napa,055,140530,9805,9792,36,9828,81
2021-04-30,Nevada,057,99092,4702,4608,187,4795,70
2021-04-30,Orange,059,3164182,254271,252883,11213,264096,4956
2021-04-30,Placer,061,380077,22739,22190,1426,23616,287
2021-04-30,Plumas,063,18699,690,677,10,687,4
2021-04-30,Riverside,065,2383286,292700,287030,13928,300958,4412
2021-04-30,Sacramento,067,1510023,103662,102864,1671,104535,1596
2021-04-30,San Benito,069,59416,6022,6024,113,6137,63
2021-04-30,San Bernardino,071,2135413,292008,290704,8933,299637,4640
2021-04-30,San Diego,073,3302833,277911,276157,14532,290689,3702
2021-04-30,San Francisco,075,870044,36327,36453,1270,37723,538
2021-04-30,San Joaquin,077,732212,72097,71311,3471,74782,1306
2021-04-30,San Luis Obispo,079,281455,21154,20884,719,21603,255
2021-04-30,San Mateo,081,765935,41970,41583,460,42043,380
2021-04-30,Santa Barbara,083,443738,34208,34061,1134,35195,451
2021-04-30,Santa Clara,085,1922200,117673,118170,743,118913,1988
2021-04-30,Santa Cruz,087,273765,16118,15975,812,16787,207
2021-04-30,Shasta,089,179085,11875,11848,1471,13319,197
2021-04-30,Sierra,091,2930,56,53,12,65,0
2021-04-30,Siskiyou,093,43540,1771,1628,311,1939,11
2021-04-30,Solano,095,438530,32204,32050,504,32554,249
2021-04-30,Sonoma,097,501317,29672,29816,320,30136,318
2021-04-30,Stanislaus,099,539301,55271,54938,5837,60775,774
2021-04-30,Sutter,101,95872,9330,9353,82,9435,110
2021-04-30,Tehama,103,63373,4972,4944,561,5505,53
2021-04-30,Trinity,105,12862,482,326,86,412,3
2021-04-30,Tulare,107,460477,49829,48797,8883,57680,836
2021-04-30,Tuolumne,109,53932,3970,4033,38,4071,61
2021-04-30,Ventura,111,848112,80867,80232,2961,83193,1004
2021-04-30,Yolo,113,214977,13777,13756,284,14040,208
2021-04-30,Yuba,115,75493,5905,5870,121,5991,44
2021-04-29,Alameda,001,1643700,86817,86490,1914,88404,1263
2021-04-29,Alpine,003,1148,87,88,0,88,0
2021-04-29,Amador,005,37829,3650,3649,33,3682,46
2021-04-29,Butte,007,227075,12195,11787,1745,13532,196
2021-04-29,Calaveras,009,45235,2098,2082,14,2096,50
2021-04-29,Colusa,011,21464,1927,1929,294,2223,14
2021-04-29,Contra Costa,013,1133247,68268,67606,1227,68833,795
2021-04-29,Del Norte,015,27424,1330,1271,11,1282,6
2021-04-29,El Dorado,017,186661,10019,9884,699,10583,107
2021-04-29,Fresno,019,978130,101745,101189,8593,109782,1667
2021-04-29,Glenn,021,27897,2390,2369,542,2911,17
2021-04-29,Humboldt,023,135768,3851,3815,31,3846,36
2021-04-29,Imperial,025,180216,28297,28235,2716,30951,720
2021-04-29,Inyo,027,18085,1398,1396,11,1407,36
2021-04-29,Kern,029,883053,96594,95547,10656,106203,1295
2021-04-29,Kings,031,150075,23031,22777,1073,23850,245
2021-04-29,Lake,033,64148,3458,3438,9,3447,43
2021-04-29,Lassen,035,31185,5174,5140,105,5245,1
2021-04-29,Los Angeles,037,10098052,1200183,1192068,41434,1233502,23899
2021-04-29,Madera,039,155013,16491,16383,921,17304,235
2021-04-29,Marin,041,260295,13967,13884,238,14122,228
2021-04-29,Mariposa,043,17540,421,416,11,427,5
2021-04-29,Mendocino,045,87422,3841,3774,79,3853,46
2021-04-29,Merced,047,269075,30654,30706,1041,31747,444
2021-04-29,Modoc,049,8938,369,360,122,482,3
2021-04-29,Mono,051,14174,1246,1259,17,1276,3
2021-04-29,Monterey,053,433212,42954,42797,1857,44654,379
2021-04-29,Napa,055,140530,9791,9789,36,9825,81
2021-04-29,Nevada,057,99092,4691,4590,187,4777,70
2021-04-29,Orange,059,3164182,254201,252823,11198,264021,4934
2021-04-29,Placer,061,380077,22714,22161,1424,23585,286
2021-04-29,Plumas,063,18699,689,676,10,686,4
2021-04-29,Riverside,065,2383286,292632,286947,13925,300872,4409
2021-04-29,Sacramento,067,1510023,103529,102686,1661,104347,1593
2021-04-29,San Benito,069,59416,6021,6023,113,6136,63
2021-04-29,San Bernardino,071,2135413,291936,290606,8928,299534,4609
2021-04-29,San Diego,073,3302833,277761,275961,14515,290476,3700
2021-04-29,San Francisco,075,870044,36301,36412,1270,37682,537
2021-04-29,San Joaquin,077,732212,72031,71225,3466,74691,1301
2021-04-29,San Luis Obispo,079,281455,21143,20876,719,21595,255
2021-04-29,San Mateo,081,765935,41942,41538,459,41997,358
2021-04-29,Santa Barbara,083,443738,34192,34039,1132,35171,448
2021-04-29,Santa Clara,085,1922200,117618,118082,740,118822,1984
2021-04-29,Santa Cruz,087,273765,16112,15961,812,16773,205
2021-04-29,Shasta,089,179085,11844,11836,1463,13299,193
2021-04-29,Sierra,091,2930,56,53,12,65,0
2021-04-29,Siskiyou,093,43540,1762,1615,308,1923,11
2021-04-29,Solano,095,438530,32163,32002,500,32502,248
2021-04-29,Sonoma,097,501317,29657,29785,317,30102,318
2021-04-29,Stanislaus,099,539301,55204,54836,5832,60668,774
2021-04-29,Sutter,101,95872,9323,9346,82,9428,110
2021-04-29,Tehama,103,63373,4964,4939,561,5500,53
2021-04-29,Trinity,105,12862,482,326,86,412,3
2021-04-29,Tulare,107,460477,49811,48785,8871,57656,832
2021-04-29,Tuolumne,109,53932,3969,4030,38,4068,58
2021-04-29,Ventura,111,848112,80833,80188,2959,83147,1002
2021-04-29,Yolo,113,214977,13757,13745,283,14028,205
2021-04-29,Yuba,115,75493,5895,5865,121,5986,44
2021-04-28,Alameda,001,1643700,86745,86390,1910,88300,1260
2021-04-28,Alpine,003,1148,87,88,0,88,0
2021-04-28,Amador,005,37829,3650,3646,33,3679,46
2021-04-28,Butte,007,227075,12175,11762,1740,13502,196
2021-04-28,Calaveras,009,45235,2094,2078,13,2091,50
2021-04-28,Colusa,011,21464,1924,1927,293,2220,14
2021-04-28,Contra Costa,013,1133247,68208,67539,1226,68765,795
2021-04-28,Del Norte,015,27424,1322,1267,11,1278,6
2021-04-28,El Dorado,017,186661,9994,9873,699,10572,107
2021-04-28,Fresno,019,978130,101698,101161,8583,109744,1666
2021-04-28,Glenn,021,27897,2387,2368,542,2910,17
2021-04-28,Humboldt,023,135768,3835,3796,31,3827,36
2021-04-28,Imperial,025,180216,28283,28177,2715,30892,720
2021-04-28,Inyo,027,18085,1398,1396,10,1406,36
2021-04-28,Kern,029,883053,96565,95494,10647,106141,1295
2021-04-28,Kings,031,150075,23019,22767,1071,23838,245
2021-04-28,Lake,033,64148,3455,3433,9,3442,43
2021-04-28,Lassen,035,31185,5174,5138,105,5243,1
2021-04-28,Los Angeles,037,10098052,1199884,1191729,41408,1233137,23858
2021-04-28,Madera,039,155013,16487,16372,921,17293,235
2021-04-28,Marin,041,260295,13956,13866,238,14104,227
2021-04-28,Mariposa,043,17540,418,415,11,426,5
2021-04-28,Mendocino,045,87422,3835,3770,77,3847,46
2021-04-28,Merced,047,269075,30635,30649,1041,31690,443
2021-04-28,Modoc,049,8938,369,360,122,482,3
2021-04-28,Mono,051,14174,1246,1258,17,1275,3
2021-04-28,Monterey,053,433212,42949,42776,1857,44633,379
2021-04-28,Napa,055,140530,9780,9777,36,9813,81
2021-04-28,Nevada,057,99092,4671,4570,187,4757,70
2021-04-28,Orange,059,3164182,254121,252747,11185,263932,4931
2021-04-28,Placer,061,380077,22687,22115,1423,23538,285
2021-04-28,Plumas,063,18699,689,676,10,686,4
2021-04-28,Riverside,065,2383286,292576,286868,13919,300787,4407
2021-04-28,Sacramento,067,1510023,103407,102613,1657,104270,1591
2021-04-28,San Benito,069,59416,6019,6021,113,6134,63
2021-04-28,San Bernardino,071,2135413,291857,290548,8918,299466,4582
2021-04-28,San Diego,073,3302833,277606,275821,14501,290322,3698
2021-04-28,San Francisco,075,870044,36271,36382,1269,37651,534
2021-04-28,San Joaquin,077,732212,71951,71171,3458,74629,1301
2021-04-28,San Luis Obispo,079,281455,21135,20851,719,21570,255
2021-04-28,San Mateo,081,765935,41917,41498,457,41955,358
2021-04-28,Santa Barbara,083,443738,34178,34003,1132,35135,448
2021-04-28,Santa Clara,085,1922200,117549,117997,738,118735,1969
2021-04-28,Santa Cruz,087,273765,16108,15943,811,16754,205
2021-04-28,Shasta,089,179085,11828,11815,1456,13271,192
2021-04-28,Sierra,091,2930,56,51,12,63,0
2021-04-28,Siskiyou,093,43540,1749,1603,305,1908,11
2021-04-28,Solano,095,438530,32131,31982,495,32477,248
2021-04-28,Sonoma,097,501317,29643,29773,313,30086,318
2021-04-28,Stanislaus,099,539301,55149,54745,5829,60574,774
2021-04-28,Sutter,101,95872,9318,9343,82,9425,110
2021-04-28,Tehama,103,63373,4959,4930,560,5490,53
2021-04-28,Trinity,105,12862,482,326,86,412,3
2021-04-28,Tulare,107,460477,49793,48754,8856,57610,832
2021-04-28,Tuolumne,109,53932,3966,4029,38,4067,58
2021-04-28,Ventura,111,848112,80798,80172,2957,83129,1000
2021-04-28,Yolo,113,214977,13743,13721,282,14003,205
2021-04-28,Yuba,115,75493,5889,5857,121,5978,44
2021-04-27,Alameda,001,1643700,86654,86301,1904,88205,1260
2021-04-27,Alpine,003,1148,87,88,0,88,0
2021-04-27,Amador,005,37829,3650,3645,33,3678,46
2021-04-27,Butte,007,227075,12150,11738,1734,13472,196
2021-04-27,Calaveras,009,45235,2092,2076,13,2089,50
2021-04-27,Colusa,011,21464,1923,1926,293,2219,14
2021-04-27,Contra Costa,013,1133247,68139,67470,1222,68692,791
2021-04-27,Del Norte,015,27424,1310,1266,11,1277,6
2021-04-27,El Dorado,017,186661,9965,9866,696,10562,106
2021-04-27,Fresno,019,978130,101633,101138,8573,109711,1663
2021-04-27,Glenn,021,27897,2387,2368,542,2910,17
2021-04-27,Humboldt,023,135768,3823,3780,31,3811,35
2021-04-27,Imperial,025,180216,28267,28149,2709,30858,720
2021-04-27,Inyo,027,18085,1398,1396,10,1406,36
2021-04-27,Kern,029,883053,96508,95466,10636,106102,1295
2021-04-27,Kings,031,150075,23004,22759,1069,23828,244
2021-04-27,Lake,033,64148,3454,3431,9,3440,43
2021-04-27,Lassen,035,31185,5174,5137,105,5242,1
2021-04-27,Los Angeles,037,10098052,1199560,1191504,41378,1232882,23825
2021-04-27,Madera,039,155013,16480,16365,921,17286,235
2021-04-27,Marin,041,260295,13934,13855,238,14093,227
2021-04-27,Mariposa,043,17540,417,413,11,424,5
2021-04-27,Mendocino,045,87422,3831,3765,77,3842,46
2021-04-27,Merced,047,269075,30595,30620,1041,31661,443
2021-04-27,Modoc,049,8938,368,360,122,482,3
2021-04-27,Mono,051,14174,1246,1257,17,1274,3
2021-04-27,Monterey,053,433212,42931,42752,1854,44606,379
2021-04-27,Napa,055,140530,9773,9774,34,9808,81
2021-04-27,Nevada,057,99092,4656,4557,187,4744,70
2021-04-27,Orange,059,3164182,254052,252667,11180,263847,4925
2021-04-27,Placer,061,380077,22658,22050,1419,23469,285
2021-04-27,Plumas,063,18699,688,675,10,685,4
2021-04-27,Riverside,065,2383286,292500,286820,13915,300735,4405
2021-04-27,Sacramento,067,1510023,103278,102595,1647,104242,1589
2021-04-27,San Benito,069,59416,6014,6016,113,6129,63
2021-04-27,San Bernardino,071,2135413,291789,290461,8913,299374,4575
2021-04-27,San Diego,073,3302833,277449,275685,14481,290166,3692
2021-04-27,San Francisco,075,870044,36243,36358,1268,37626,533
2021-04-27,San Joaquin,077,732212,71898,71104,3452,74556,1301
2021-04-27,San Luis Obispo,079,281455,21128,20841,719,21560,255
2021-04-27,San Mateo,081,765935,41882,41474,456,41930,358
2021-04-27,Santa Barbara,083,443738,34154,33973,1131,35104,448
2021-04-27,Santa Clara,085,1922200,117499,117945,737,118682,1969
2021-04-27,Santa Cruz,087,273765,16101,15905,810,16715,205
2021-04-27,Shasta,089,179085,11800,11802,1449,13251,192
2021-04-27,Sierra,091,2930,56,51,12,63,0
2021-04-27,Siskiyou,093,43540,1734,1597,304,1901,11
2021-04-27,Solano,095,438530,32083,31964,494,32458,248
2021-04-27,Sonoma,097,501317,29625,29761,312,30073,318
2021-04-27,Stanislaus,099,539301,55079,54695,5821,60516,752
2021-04-27,Sutter,101,95872,9313,9342,82,9424,110
2021-04-27,Tehama,103,63373,4956,4922,556,5478,53
2021-04-27,Trinity,105,12862,482,326,86,412,3
2021-04-27,Tulare,107,460477,49777,48744,8847,57591,832
2021-04-27,Tuolumne,109,53932,3963,4028,38,4066,58
2021-04-27,Ventura,111,848112,80769,80152,2955,83107,1000
2021-04-27,Yolo,113,214977,13730,13697,280,13977,205
2021-04-27,Yuba,115,75493,5889,5853,121,5974,44
2021-04-26,Alameda,001,1643700,86560,86230,1901,88131,1256
2021-04-26,Alpine,003,1148,87,88,0,88,0
2021-04-26,Amador,005,37829,3649,3645,33,3678,46
2021-04-26,Butte,007,227075,12126,11720,1730,13450,196
2021-04-26,Calaveras,009,45235,2086,2074,13,2087,50
2021-04-26,Colusa,011,21464,1923,1925,292,2217,14
2021-04-26,Contra Costa,013,1133247,68072,67392,1218,68610,789
2021-04-26,Del Norte,015,27424,1301,1263,11,1274,6
2021-04-26,El Dorado,017,186661,9944,9849,695,10544,106
2021-04-26,Fresno,019,978130,101578,101099,8559,109658,1662
2021-04-26,Glenn,021,27897,2385,2367,542,2909,17
2021-04-26,Humboldt,023,135768,3813,3764,30,3794,35
2021-04-26,Imperial,025,180216,28254,28148,2706,30854,720
2021-04-26,Inyo,027,18085,1397,1396,10,1406,36
2021-04-26,Kern,029,883053,96481,95429,10630,106059,1295
2021-04-26,Kings,031,150075,23001,22756,1066,23822,244
2021-04-26,Lake,033,64148,3449,3428,9,3437,43
2021-04-26,Lassen,035,31185,5174,5138,105,5243,1
2021-04-26,Los Angeles,037,10098052,1199230,1191253,41359,1232612,23802
2021-04-26,Madera,039,155013,16468,16353,920,17273,231
2021-04-26,Marin,041,260295,13919,13849,238,14087,227
2021-04-26,Mariposa,043,17540,416,410,11,421,5
2021-04-26,Mendocino,045,87422,3829,3757,76,3833,46
2021-04-26,Merced,047,269075,30578,30611,1038,31649,443
2021-04-26,Modoc,049,8938,368,360,122,482,3
2021-04-26,Mono,051,14174,1246,1258,17,1275,3
2021-04-26,Monterey,053,433212,42915,42740,1853,44593,379
2021-04-26,Napa,055,140530,9761,9769,34,9803,79
2021-04-26,Nevada,057,99092,4635,4548,187,4735,70
2021-04-26,Orange,059,3164182,253968,252592,11169,263761,4919
2021-04-26,Placer,061,380077,22630,22032,1414,23446,285
2021-04-26,Plumas,063,18699,688,670,10,680,4
2021-04-26,Riverside,065,2383286,292438,286724,13907,300631,4401
2021-04-26,Sacramento,067,1510023,103106,102459,1634,104093,1587
2021-04-26,San Benito,069,59416,6012,6013,113,6126,63
2021-04-26,San Bernardino,071,2135413,291738,290394,8912,299306,4572
2021-04-26,San Diego,073,3302833,277275,275541,14453,289994,3692
2021-04-26,San Francisco,075,870044,36215,36330,1267,37597,532
2021-04-26,San Joaquin,077,732212,71832,71050,3444,74494,1301
2021-04-26,San Luis Obispo,079,281455,21120,20830,718,21548,255
2021-04-26,San Mateo,081,765935,41852,41457,456,41913,357
2021-04-26,Santa Barbara,083,443738,34123,33948,1131,35079,448
2021-04-26,Santa Clara,085,1922200,117399,117874,734,118608,1968
2021-04-26,Santa Cruz,087,273765,16092,15877,810,16687,205
2021-04-26,Shasta,089,179085,11783,11787,1443,13230,192
2021-04-26,Sierra,091,2930,55,51,12,63,0
2021-04-26,Siskiyou,093,43540,1724,1592,301,1893,11
2021-04-26,Solano,095,438530,32038,31913,492,32405,247
2021-04-26,Sonoma,097,501317,29602,29755,310,30065,318
2021-04-26,Stanislaus,099,539301,54989,54638,5815,60453,744
2021-04-26,Sutter,101,95872,9308,9328,82,9410,110
2021-04-26,Tehama,103,63373,4951,4920,553,5473,53
2021-04-26,Trinity,105,12862,482,326,86,412,3
2021-04-26,Tulare,107,460477,49757,48735,8838,57573,831
2021-04-26,Tuolumne,109,53932,3962,4024,38,4062,58
2021-04-26,Ventura,111,848112,80744,80137,2952,83089,999
2021-04-26,Yolo,113,214977,13710,13684,277,13961,205
2021-04-26,Yuba,115,75493,5887,5851,121,5972,44
2021-04-25,Alameda,001,1643700,86457,86162,1894,88056,1256
2021-04-25,Alpine,003,1148,87,87,0,87,0
2021-04-25,Amador,005,37829,3648,3643,33,3676,46
2021-04-25,Butte,007,227075,12097,11709,1723,13432,196
2021-04-25,Calaveras,009,45235,2081,2072,12,2084,50
2021-04-25,Colusa,011,21464,1922,1924,292,2216,14
2021-04-25,Contra Costa,013,1133247,67980,67316,1217,68533,789
2021-04-25,Del Norte,015,27424,1295,1259,11,1270,6
2021-04-25,El Dorado,017,186661,9928,9837,693,10530,106
2021-04-25,Fresno,019,978130,101519,101061,8547,109608,1662
2021-04-25,Glenn,021,27897,2385,2366,542,2908,17
2021-04-25,Humboldt,023,135768,3800,3751,30,3781,35
2021-04-25,Imperial,025,180216,28228,28136,2703,30839,720
2021-04-25,Inyo,027,18085,1397,1396,10,1406,36
2021-04-25,Kern,029,883053,96415,95398,10617,106015,1295
2021-04-25,Kings,031,150075,22987,22755,1064,23819,244
2021-04-25,Lake,033,64148,3447,3427,9,3436,43
2021-04-25,Lassen,035,31185,5172,5138,105,5243,1
2021-04-25,Los Angeles,037,10098052,1198896,1190970,41339,1232309,23799
2021-04-25,Madera,039,155013,16456,16346,920,17266,231
2021-04-25,Marin,041,260295,13910,13852,238,14090,227
2021-04-25,Mariposa,043,17540,416,410,11,421,5
2021-04-25,Mendocino,045,87422,3822,3757,76,3833,46
2021-04-25,Merced,047,269075,30544,30586,1037,31623,443
2021-04-25,Modoc,049,8938,368,360,122,482,3
2021-04-25,Mono,051,14174,1246,1257,17,1274,3
2021-04-25,Monterey,053,433212,42902,42737,1851,44588,379
2021-04-25,Napa,055,140530,9756,9762,34,9796,79
2021-04-25,Nevada,057,99092,4623,4536,187,4723,70
2021-04-25,Orange,059,3164182,253892,252531,11162,263693,4919
2021-04-25,Placer,061,380077,22584,22011,1406,23417,285
2021-04-25,Plumas,063,18699,687,670,10,680,4
2021-04-25,Riverside,065,2383286,292344,286651,13901,300552,4401
2021-04-25,Sacramento,067,1510023,102938,102319,1624,103943,1587
2021-04-25,San Benito,069,59416,6010,6014,112,6126,63
2021-04-25,San Bernardino,071,2135413,291663,290357,8904,299261,4571
2021-04-25,San Diego,073,3302833,277062,275412,14420,289832,3692
2021-04-25,San Francisco,075,870044,36184,36310,1267,37577,532
2021-04-25,San Joaquin,077,732212,71737,70987,3434,74421,1301
2021-04-25,San Luis Obispo,079,281455,21101,20820,716,21536,255
2021-04-25,San Mateo,081,765935,41817,41465,455,41920,356
2021-04-25,Santa Barbara,083,443738,34097,33931,1131,35062,448
2021-04-25,Santa Clara,085,1922200,117320,117778,732,118510,1968
2021-04-25,Santa Cruz,087,273765,16086,15868,808,16676,205
2021-04-25,Shasta,089,179085,11760,11784,1438,13222,192
2021-04-25,Sierra,091,2930,55,51,12,63,0
2021-04-25,Siskiyou,093,43540,1713,1580,299,1879,11
2021-04-25,Solano,095,438530,31991,31864,484,32348,247
2021-04-25,Sonoma,097,501317,29584,29756,310,30066,318
2021-04-25,Stanislaus,099,539301,54893,54543,5807,60350,744
2021-04-25,Sutter,101,95872,9302,9326,82,9408,110
2021-04-25,Tehama,103,63373,4947,4916,551,5467,53
2021-04-25,Trinity,105,12862,482,326,86,412,3
2021-04-25,Tulare,107,460477,49741,48728,8824,57552,831
2021-04-25,Tuolumne,109,53932,3960,4022,38,4060,58
2021-04-25,Ventura,111,848112,80720,80110,2952,83062,999
2021-04-25,Yolo,113,214977,13687,13667,275,13942,205
2021-04-25,Yuba,115,75493,5884,5849,120,5969,44
2021-04-24,Alameda,001,1643700,86403,86016,1892,87908,1257
2021-04-24,Alpine,003,1148,87,86,0,86,0
2021-04-24,Amador,005,37829,3647,3640,33,3673,46
2021-04-24,Butte,007,227075,12081,11678,1721,13399,196
2021-04-24,Calaveras,009,45235,2077,2067,12,2079,50
2021-04-24,Colusa,011,21464,1921,1921,292,2213,14
2021-04-24,Contra Costa,013,1133247,67910,67222,1215,68437,789
2021-04-24,Del Norte,015,27424,1290,1255,11,1266,6
2021-04-24,El Dorado,017,186661,9917,9814,692,10506,106
2021-04-24,Fresno,019,978130,101488,100991,8541,109532,1662
2021-04-24,Glenn,021,27897,2385,2363,542,2905,17
2021-04-24,Humboldt,023,135768,3786,3722,30,3752,35
2021-04-24,Imperial,025,180216,28221,28124,2702,30826,720
2021-04-24,Inyo,027,18085,1396,1396,10,1406,36
2021-04-24,Kern,029,883053,96396,95365,10607,105972,1295
2021-04-24,Kings,031,150075,22984,22749,1064,23813,244
2021-04-24,Lake,033,64148,3446,3426,9,3435,43
2021-04-24,Lassen,035,31185,5171,5137,105,5242,1
2021-04-24,Los Angeles,037,10098052,1198668,1190603,41323,1231926,23802
2021-04-24,Madera,039,155013,16453,16338,920,17258,231
2021-04-24,Marin,041,260295,13902,13847,238,14085,227
2021-04-24,Mariposa,043,17540,416,409,11,420,5
2021-04-24,Mendocino,045,87422,3820,3754,74,3828,46
2021-04-24,Merced,047,269075,30524,30559,1037,31596,443
2021-04-24,Modoc,049,8938,368,360,122,482,3
2021-04-24,Mono,051,14174,1246,1256,17,1273,3
2021-04-24,Monterey,053,433212,42890,42727,1850,44577,379
2021-04-24,Napa,055,140530,9750,9756,34,9790,79
2021-04-24,Nevada,057,99092,4616,4522,187,4709,70
2021-04-24,Orange,059,3164182,253848,252441,11156,263597,4910
2021-04-24,Placer,061,380077,22571,21983,1405,23388,285
2021-04-24,Plumas,063,18699,686,670,10,680,4
2021-04-24,Riverside,065,2383286,292276,286552,13897,300449,4400
2021-04-24,Sacramento,067,1510023,102855,102179,1617,103796,1587
2021-04-24,San Benito,069,59416,6008,6007,112,6119,63
2021-04-24,San Bernardino,071,2135413,291614,290264,8903,299167,4568
2021-04-24,San Diego,073,3302833,276958,275252,14400,289652,3688
2021-04-24,San Francisco,075,870044,36155,36285,1263,37548,532
2021-04-24,San Joaquin,077,732212,71694,70911,3431,74342,1301
2021-04-24,San Luis Obispo,079,281455,21091,20797,715,21512,255
2021-04-24,San Mateo,081,765935,41804,41424,453,41877,355
2021-04-24,Santa Barbara,083,443738,34082,33911,1130,35041,448
2021-04-24,Santa Clara,085,1922200,117265,117674,730,118404,1968
2021-04-24,Santa Cruz,087,273765,16078,15840,808,16648,205
2021-04-24,Shasta,089,179085,11742,11770,1435,13205,192
2021-04-24,Sierra,091,2930,55,51,12,63,0
2021-04-24,Siskiyou,093,43540,1703,1574,298,1872,11
2021-04-24,Solano,095,438530,31968,31821,481,32302,247
2021-04-24,Sonoma,097,501317,29582,29739,310,30049,318
2021-04-24,Stanislaus,099,539301,54844,54455,5804,60259,744
2021-04-24,Sutter,101,95872,9299,9316,82,9398,110
2021-04-24,Tehama,103,63373,4942,4907,551,5458,53
2021-04-24,Trinity,105,12862,482,326,86,412,3
2021-04-24,Tulare,107,460477,49730,48705,8814,57519,830
2021-04-24,Tuolumne,109,53932,3956,4020,38,4058,58
2021-04-24,Ventura,111,848112,80707,80097,2950,83047,999
2021-04-24,Yolo,113,214977,13676,13653,275,13928,205
2021-04-24,Yuba,115,75493,5882,5837,120,5957,44
2021-04-23,Alameda,001,1643700,86329,85935,1889,87824,1256
2021-04-23,Alpine,003,1148,86,86,0,86,0
2021-04-23,Amador,005,37829,3646,3637,33,3670,46
2021-04-23,Butte,007,227075,12060,11672,1716,13388,196
2021-04-23,Calaveras,009,45235,2074,2064,12,2076,50
2021-04-23,Colusa,011,21464,1920,1921,292,2213,14
2021-04-23,Contra Costa,013,1133247,67856,67164,1213,68377,785
2021-04-23,Del Norte,015,27424,1289,1254,11,1265,6
2021-04-23,El Dorado,017,186661,9900,9788,689,10477,106
2021-04-23,Fresno,019,978130,101447,100928,8535,109463,1662
2021-04-23,Glenn,021,27897,2385,2361,541,2902,17
2021-04-23,Humboldt,023,135768,3776,3698,30,3728,35
2021-04-23,Imperial,025,180216,28206,28108,2701,30809,720
2021-04-23,Inyo,027,18085,1396,1395,10,1405,36
2021-04-23,Kern,029,883053,96371,95330,10601,105931,1295
2021-04-23,Kings,031,150075,22981,22735,1064,23799,244
2021-04-23,Lake,033,64148,3444,3425,9,3434,43
2021-04-23,Lassen,035,31185,5171,5141,105,5246,1
2021-04-23,Los Angeles,037,10098052,1198404,1190264,41297,1231561,23785
2021-04-23,Madera,039,155013,16444,16328,920,17248,231
2021-04-23,Marin,041,260295,13897,13838,238,14076,227
2021-04-23,Mariposa,043,17540,415,405,11,416,5
2021-04-23,Mendocino,045,87422,3818,3745,73,3818,46
2021-04-23,Merced,047,269075,30507,30530,1036,31566,443
2021-04-23,Modoc,049,8938,368,360,122,482,3
2021-04-23,Mono,051,14174,1244,1256,17,1273,3
2021-04-23,Monterey,053,433212,42884,42722,1850,44572,377
2021-04-23,Napa,055,140530,9745,9752,34,9786,79
2021-04-23,Nevada,057,99092,4607,4510,187,4697,70
2021-04-23,Orange,059,3164182,253804,252399,11149,263548,4904
2021-04-23,Placer,061,380077,22548,21959,1404,23363,282
2021-04-23,Plumas,063,18699,685,670,10,680,4
2021-04-23,Riverside,065,2383286,292217,286456,13892,300348,4399
2021-04-23,Sacramento,067,1510023,102768,102041,1614,103655,1586
2021-04-23,San Benito,069,59416,6006,6005,112,6117,63
2021-04-23,San Bernardino,071,2135413,291563,290189,8902,299091,4568
2021-04-23,San Diego,073,3302833,276820,275097,14377,289474,3684
2021-04-23,San Francisco,075,870044,36139,36252,1262,37514,532
2021-04-23,San Joaquin,077,732212,71638,70840,3428,74268,1295
2021-04-23,San Luis Obispo,079,281455,21082,20781,714,21495,255
2021-04-23,San Mateo,081,765935,41777,41386,453,41839,355
2021-04-23,Santa Barbara,083,443738,34072,33895,1128,35023,447
2021-04-23,Santa Clara,085,1922200,117203,117593,729,118322,1965
2021-04-23,Santa Cruz,087,273765,16071,15802,808,16610,205
2021-04-23,Shasta,089,179085,11735,11759,1434,13193,192
2021-04-23,Sierra,091,2930,55,51,12,63,0
2021-04-23,Siskiyou,093,43540,1691,1567,297,1864,11
2021-04-23,Solano,095,438530,31936,31784,477,32261,247
2021-04-23,Sonoma,097,501317,29568,29727,310,30037,318
2021-04-23,Stanislaus,099,539301,54781,54391,5796,60187,744
2021-04-23,Sutter,101,95872,9297,9312,82,9394,110
2021-04-23,Tehama,103,63373,4939,4906,551,5457,53
2021-04-23,Trinity,105,12862,482,326,86,412,3
2021-04-23,Tulare,107,460477,49713,48694,8806,57500,829
2021-04-23,Tuolumne,109,53932,3955,4020,38,4058,58
2021-04-23,Ventura,111,848112,80688,80095,2950,83045,996
2021-04-23,Yolo,113,214977,13665,13647,274,13921,205
2021-04-23,Yuba,115,75493,5879,5828,120,5948,44
2021-04-22,Alameda,001,1643700,86240,85829,1888,87717,1253
2021-04-22,Alpine,003,1148,86,86,0,86,0
2021-04-22,Amador,005,37829,3645,3633,33,3666,46
2021-04-22,Butte,007,227075,12046,11656,1713,13369,196
2021-04-22,Calaveras,009,45235,2072,2059,12,2071,50
2021-04-22,Colusa,011,21464,1918,1920,290,2210,14
2021-04-22,Contra Costa,013,1133247,67784,67029,1208,68237,782
2021-04-22,Del Norte,015,27424,1284,1252,11,1263,6
2021-04-22,El Dorado,017,186661,9889,9773,686,10459,106
2021-04-22,Fresno,019,978130,101402,100864,8524,109388,1657
2021-04-22,Glenn,021,27897,2384,2361,541,2902,17
2021-04-22,Humboldt,023,135768,3767,3680,30,3710,35
2021-04-22,Imperial,025,180216,28185,28096,2698,30794,720
2021-04-22,Inyo,027,18085,1395,1394,10,1404,36
2021-04-22,Kern,029,883053,96328,95292,10585,105877,1299
2021-04-22,Kings,031,150075,22971,22725,1064,23789,243
2021-04-22,Lake,033,64148,3442,3423,9,3432,43
2021-04-22,Lassen,035,31185,5171,5155,105,5260,1
2021-04-22,Los Angeles,037,10098052,1198084,1189878,41275,1231153,23762
2021-04-22,Madera,039,155013,16425,16316,920,17236,231
2021-04-22,Marin,041,260295,13889,13832,238,14070,227
2021-04-22,Mariposa,043,17540,414,403,11,414,5
2021-04-22,Mendocino,045,87422,3812,3729,73,3802,46
2021-04-22,Merced,047,269075,30472,30490,1035,31525,443
2021-04-22,Modoc,049,8938,368,360,122,482,3
2021-04-22,Mono,051,14174,1244,1254,17,1271,3
2021-04-22,Monterey,053,433212,42877,42708,1848,44556,377
2021-04-22,Napa,055,140530,9735,9734,34,9768,79
2021-04-22,Nevada,057,99092,4598,4504,185,4689,70
2021-04-22,Orange,059,3164182,253731,252307,11137,263444,4898
2021-04-22,Placer,061,380077,22516,21916,1400,23316,282
2021-04-22,Plumas,063,18699,684,670,10,680,4
2021-04-22,Riverside,065,2383286,292118,286362,13883,300245,4398
2021-04-22,Sacramento,067,1510023,102619,101870,1605,103475,1585
2021-04-22,San Benito,069,59416,6002,5998,112,6110,63
2021-04-22,San Bernardino,071,2135413,291492,290125,8893,299018,4571
2021-04-22,San Diego,073,3302833,276654,275913,14355,290268,3684
2021-04-22,San Francisco,075,870044,36116,36218,1259,37477,532
2021-04-22,San Joaquin,077,732212,71579,70751,3421,74172,1295
2021-04-22,San Luis Obispo,079,281455,21068,20761,714,21475,255
2021-04-22,San Mateo,081,765935,41750,41345,451,41796,355
2021-04-22,Santa Barbara,083,443738,34049,33870,1127,34997,446
2021-04-22,Santa Clara,085,1922200,117115,117457,725,118182,1954
2021-04-22,Santa Cruz,087,273765,16068,15737,807,16544,205
2021-04-22,Shasta,089,179085,11720,11738,1432,13170,192
2021-04-22,Sierra,091,2930,55,51,12,63,0
2021-04-22,Siskiyou,093,43540,1687,1564,296,1860,11
2021-04-22,Solano,095,438530,31890,31731,474,32205,247
2021-04-22,Sonoma,097,501317,29553,29705,306,30011,318
2021-04-22,Stanislaus,099,539301,54708,54313,5790,60103,744
2021-04-22,Sutter,101,95872,9293,9302,82,9384,110
2021-04-22,Tehama,103,63373,4933,4896,547,5443,53
2021-04-22,Trinity,105,12862,482,326,86,412,3
2021-04-22,Tulare,107,460477,49693,48669,8797,57466,828
2021-04-22,Tuolumne,109,53932,3951,4020,38,4058,58
2021-04-22,Ventura,111,848112,80662,80073,2948,83021,996
2021-04-22,Yolo,113,214977,13644,13616,274,13890,205
2021-04-22,Yuba,115,75493,5869,5825,120,5945,44
2021-04-21,Alameda,001,1643700,86161,85762,1886,87648,1249
2021-04-21,Alpine,003,1148,86,86,0,86,0
2021-04-21,Amador,005,37829,3642,3632,33,3665,46
2021-04-21,Butte,007,227075,12026,11643,1711,13354,196
2021-04-21,Calaveras,009,45235,2062,2057,12,2069,50
2021-04-21,Colusa,011,21464,1916,1920,289,2209,14
2021-04-21,Contra Costa,013,1133247,67718,66981,1207,68188,782
2021-04-21,Del Norte,015,27424,1280,1252,11,1263,6
2021-04-21,El Dorado,017,186661,9872,9760,684,10444,106
2021-04-21,Fresno,019,978130,101346,100838,8518,109356,1654
2021-04-21,Glenn,021,27897,2383,2361,541,2902,17
2021-04-21,Humboldt,023,135768,3748,3642,30,3672,35
2021-04-21,Imperial,025,180216,28173,28052,2697,30749,719
2021-04-21,Inyo,027,18085,1395,1392,10,1402,36
2021-04-21,Kern,029,883053,96282,95257,10575,105832,1297
2021-04-21,Kings,031,150075,22964,22713,1063,23776,243
2021-04-21,Lake,033,64148,3439,3421,9,3430,43
2021-04-21,Lassen,035,31185,5170,5156,105,5261,1
2021-04-21,Los Angeles,037,10098052,1197744,1189530,41254,1230784,23729
2021-04-21,Madera,039,155013,16420,16309,920,17229,231
2021-04-21,Marin,041,260295,13874,13822,238,14060,227
2021-04-21,Mariposa,043,17540,413,402,11,413,5
2021-04-21,Mendocino,045,87422,3810,3729,73,3802,46
2021-04-21,Merced,047,269075,30452,30471,1033,31504,442
2021-04-21,Modoc,049,8938,368,360,122,482,3
2021-04-21,Mono,051,14174,1244,1254,17,1271,3
2021-04-21,Monterey,053,433212,42862,42699,1846,44545,377
2021-04-21,Napa,055,140530,9729,9727,34,9761,79
2021-04-21,Nevada,057,99092,4584,4499,185,4684,70
2021-04-21,Orange,059,3164182,253655,252243,11124,263367,4889
2021-04-21,Placer,061,380077,22485,21896,1395,23291,282
2021-04-21,Plumas,063,18699,684,670,10,680,4
2021-04-21,Riverside,065,2383286,292024,286299,13876,300175,4388
2021-04-21,Sacramento,067,1510023,102490,101803,1599,103402,1579
2021-04-21,San Benito,069,59416,5999,5998,112,6110,63
2021-04-21,San Bernardino,071,2135413,291417,290049,8891,298940,4572
2021-04-21,San Diego,073,3302833,276445,275632,14317,289949,3681
2021-04-21,San Francisco,075,870044,36096,36194,1258,37452,529
2021-04-21,San Joaquin,077,732212,71524,70687,3411,74098,1295
2021-04-21,San Luis Obispo,079,281455,21053,20724,713,21437,255
2021-04-21,San Mateo,081,765935,41718,41318,450,41768,355
2021-04-21,Santa Barbara,083,443738,34030,33830,1126,34956,445
2021-04-21,Santa Clara,085,1922200,117037,117318,719,118037,1946
2021-04-21,Santa Cruz,087,273765,16059,15698,807,16505,204
2021-04-21,Shasta,089,179085,11701,11722,1430,13152,192
2021-04-21,Sierra,091,2930,55,51,12,63,0
2021-04-21,Siskiyou,093,43540,1680,1557,296,1853,11
2021-04-21,Solano,095,438530,31851,31712,473,32185,244
2021-04-21,Sonoma,097,501317,29541,29697,304,30001,318
2021-04-21,Stanislaus,099,539301,54647,54290,5784,60074,742
2021-04-21,Sutter,101,95872,9285,9297,82,9379,110
2021-04-21,Tehama,103,63373,4926,4893,546,5439,53
2021-04-21,Trinity,105,12862,482,326,86,412,3
2021-04-21,Tulare,107,460477,49678,48653,8784,57437,828
2021-04-21,Tuolumne,109,53932,3948,4019,38,4057,58
2021-04-21,Ventura,111,848112,80630,80039,2945,82984,996
2021-04-21,Yolo,113,214977,13624,13606,273,13879,200
2021-04-21,Yuba,115,75493,5862,5822,119,5941,44
2021-04-20,Alameda,001,1643700,86066,85652,1884,87536,1248
2021-04-20,Alpine,003,1148,85,85,0,85,0
2021-04-20,Amador,005,37829,3641,3631,33,3664,46
2021-04-20,Butte,007,227075,12007,11619,1709,13328,196
2021-04-20,Calaveras,009,45235,2061,2053,12,2065,50
2021-04-20,Colusa,011,21464,1916,1915,288,2203,14
2021-04-20,Contra Costa,013,1133247,67634,66889,1204,68093,782
2021-04-20,Del Norte,015,27424,1279,1250,11,1261,6
2021-04-20,El Dorado,017,186661,9844,9743,682,10425,106
2021-04-20,Fresno,019,978130,101288,100768,8508,109276,1650
2021-04-20,Glenn,021,27897,2381,2359,540,2899,17
2021-04-20,Humboldt,023,135768,3730,3612,30,3642,35
2021-04-20,Imperial,025,180216,28154,28024,2693,30717,719
2021-04-20,Inyo,027,18085,1395,1393,10,1403,36
2021-04-20,Kern,029,883053,96246,95223,10558,105781,1295
2021-04-20,Kings,031,150075,22958,22693,1060,23753,243
2021-04-20,Lake,033,64148,3437,3418,9,3427,43
2021-04-20,Lassen,035,31185,5170,5155,105,5260,1
2021-04-20,Los Angeles,037,10098052,1197397,1189256,41224,1230480,23694
2021-04-20,Madera,039,155013,16414,16301,920,17221,231
2021-04-20,Marin,041,260295,13860,13807,238,14045,227
2021-04-20,Mariposa,043,17540,412,402,11,413,5
2021-04-20,Mendocino,045,87422,3809,3726,73,3799,46
2021-04-20,Merced,047,269075,30425,30439,1032,31471,441
2021-04-20,Modoc,049,8938,368,359,122,481,3
2021-04-20,Mono,051,14174,1243,1254,17,1271,3
2021-04-20,Monterey,053,433212,42851,42663,1843,44506,363
2021-04-20,Napa,055,140530,9725,9711,34,9745,79
2021-04-20,Nevada,057,99092,4566,4485,185,4670,70
2021-04-20,Orange,059,3164182,253565,252134,11112,263246,4887
2021-04-20,Placer,061,380077,22451,21846,1391,23237,282
2021-04-20,Plumas,063,18699,683,670,10,680,4
2021-04-20,Riverside,065,2383286,291927,286194,13871,300065,4388
2021-04-20,Sacramento,067,1510023,102352,101629,1591,103220,1574
2021-04-20,San Benito,069,59416,5996,5988,112,6100,63
2021-04-20,San Bernardino,071,2135413,291337,289905,8889,298794,4569
2021-04-20,San Diego,073,3302833,276214,275369,14284,289653,3674
2021-04-20,San Francisco,075,870044,36077,36117,1257,37374,529
2021-04-20,San Joaquin,077,732212,71451,70590,3402,73992,1289
2021-04-20,San Luis Obispo,079,281455,21030,20691,705,21396,254
2021-04-20,San Mateo,081,765935,41687,41251,450,41701,355
2021-04-20,Santa Barbara,083,443738,34011,33803,1126,34929,445
2021-04-20,Santa Clara,085,1922200,116939,117228,715,117943,1944
2021-04-20,Santa Cruz,087,273765,16047,15647,807,16454,204
2021-04-20,Shasta,089,179085,11685,11677,1427,13104,189
2021-04-20,Sierra,091,2930,55,51,12,63,0
2021-04-20,Siskiyou,093,43540,1672,1551,295,1846,10
2021-04-20,Solano,095,438530,31796,31673,469,32142,243
2021-04-20,Sonoma,097,501317,29532,29676,302,29978,311
2021-04-20,Stanislaus,099,539301,54582,54236,5771,60007,735
2021-04-20,Sutter,101,95872,9281,9279,82,9361,109
2021-04-20,Tehama,103,63373,4921,4887,545,5432,52
2021-04-20,Trinity,105,12862,482,326,86,412,3
2021-04-20,Tulare,107,460477,49655,48650,8776,57426,831
2021-04-20,Tuolumne,109,53932,3948,4014,38,4052,58
2021-04-20,Ventura,111,848112,80602,80018,2943,82961,995
2021-04-20,Yolo,113,214977,13604,13581,272,13853,200
2021-04-20,Yuba,115,75493,5852,5814,119,5933,44
2021-04-19,Alameda,001,1643700,85946,85583,1881,87464,1247
2021-04-19,Alpine,003,1148,85,85,0,85,0
2021-04-19,Amador,005,37829,3640,3629,33,3662,46
2021-04-19,Butte,007,227075,11989,11601,1704,13305,196
2021-04-19,Calaveras,009,45235,2059,2050,12,2062,50
2021-04-19,Colusa,011,21464,1916,1913,287,2200,14
2021-04-19,Contra Costa,013,1133247,67556,66833,1202,68035,782
2021-04-19,Del Norte,015,27424,1277,1247,11,1258,6
2021-04-19,El Dorado,017,186661,9828,9726,677,10403,106
2021-04-19,Fresno,019,978130,101220,100702,8496,109198,1646
2021-04-19,Glenn,021,27897,2381,2358,539,2897,17
2021-04-19,Humboldt,023,135768,3710,3602,28,3630,35
2021-04-19,Imperial,025,180216,28133,27995,2693,30688,719
2021-04-19,Inyo,027,18085,1395,1392,10,1402,36
2021-04-19,Kern,029,883053,96216,95162,10543,105705,1290
2021-04-19,Kings,031,150075,22942,22688,1060,23748,243
2021-04-19,Lake,033,64148,3436,3416,9,3425,43
2021-04-19,Lassen,035,31185,5169,5156,105,5261,1
2021-04-19,Los Angeles,037,10098052,1197020,1188945,41199,1230144,23666
2021-04-19,Madera,039,155013,16403,16289,919,17208,231
2021-04-19,Marin,041,260295,13849,13804,237,14041,226
2021-04-19,Mariposa,043,17540,411,401,11,412,5
2021-04-19,Mendocino,045,87422,3807,3722,73,3795,46
2021-04-19,Merced,047,269075,30396,30422,1031,31453,441
2021-04-19,Modoc,049,8938,368,359,122,481,3
2021-04-19,Mono,051,14174,1242,1254,17,1271,3
2021-04-19,Monterey,053,433212,42838,42642,1838,44480,356
2021-04-19,Napa,055,140530,9717,9680,34,9714,79
2021-04-19,Nevada,057,99092,4550,4477,185,4662,70
2021-04-19,Orange,059,3164182,253447,252013,11098,263111,4883
2021-04-19,Placer,061,380077,22428,21814,1387,23201,282
2021-04-19,Plumas,063,18699,683,665,10,675,4
2021-04-19,Riverside,065,2383286,291831,286087,13861,299948,4371
2021-04-19,Sacramento,067,1510023,102217,101482,1581,103063,1572
2021-04-19,San Benito,069,59416,5988,5989,112,6101,63
2021-04-19,San Bernardino,071,2135413,291251,289738,8883,298621,4561
2021-04-19,San Diego,073,3302833,275966,275113,14251,289364,3674
2021-04-19,San Francisco,075,870044,36041,36094,1254,37348,529
2021-04-19,San Joaquin,077,732212,71371,70514,3395,73909,1289
2021-04-19,San Luis Obispo,079,281455,21004,20669,699,21368,254
2021-04-19,San Mateo,081,765935,41654,41226,449,41675,355
2021-04-19,Santa Barbara,083,443738,33997,33786,1126,34912,446
2021-04-19,Santa Clara,085,1922200,116828,117099,711,117810,1944
2021-04-19,Santa Cruz,087,273765,16035,15600,807,16407,204
2021-04-19,Shasta,089,179085,11670,11662,1419,13081,189
2021-04-19,Sierra,091,2930,55,51,12,63,0
2021-04-19,Siskiyou,093,43540,1662,1544,295,1839,10
2021-04-19,Solano,095,438530,31757,31643,464,32107,239
2021-04-19,Sonoma,097,501317,29513,29667,302,29969,311
2021-04-19,Stanislaus,099,539301,54506,54179,5767,59946,728
2021-04-19,Sutter,101,95872,9270,9269,82,9351,109
2021-04-19,Tehama,103,63373,4915,4878,545,5423,52
2021-04-19,Trinity,105,12862,482,326,85,411,3
2021-04-19,Tulare,107,460477,49639,48630,8763,57393,831
2021-04-19,Tuolumne,109,53932,3947,4010,38,4048,58
2021-04-19,Ventura,111,848112,80576,80000,2941,82941,996
2021-04-19,Yolo,113,214977,13592,13572,269,13841,200
2021-04-19,Yuba,115,75493,5845,5804,118,5922,44
2021-04-18,Alameda,001,1643700,85832,85481,1873,87354,1247
2021-04-18,Alpine,003,1148,85,85,0,85,0
2021-04-18,Amador,005,37829,3637,3627,33,3660,46
2021-04-18,Butte,007,227075,11971,11591,1699,13290,196
2021-04-18,Calaveras,009,45235,2053,2047,12,2059,50
2021-04-18,Colusa,011,21464,1912,1912,286,2198,14
2021-04-18,Contra Costa,013,1133247,67453,66750,1198,67948,782
2021-04-18,Del Norte,015,27424,1277,1240,11,1251,6
2021-04-18,El Dorado,017,186661,9805,9710,675,10385,106
2021-04-18,Fresno,019,978130,101162,100621,8490,109111,1646
2021-04-18,Glenn,021,27897,2376,2358,539,2897,17
2021-04-18,Humboldt,023,135768,3682,3590,28,3618,35
2021-04-18,Imperial,025,180216,28118,27991,2688,30679,719
2021-04-18,Inyo,027,18085,1394,1392,10,1402,36
2021-04-18,Kern,029,883053,96180,95129,10527,105656,1290
2021-04-18,Kings,031,150075,22933,22685,1060,23745,243
2021-04-18,Lake,033,64148,3435,3413,9,3422,43
2021-04-18,Lassen,035,31185,5166,5156,105,5261,1
2021-04-18,Los Angeles,037,10098052,1196559,1188620,41176,1229796,23648
2021-04-18,Madera,039,155013,16392,16277,918,17195,231
2021-04-18,Marin,041,260295,13842,13801,236,14037,226
2021-04-18,Mariposa,043,17540,410,400,10,410,5
2021-04-18,Mendocino,045,87422,3804,3722,73,3795,46
2021-04-18,Merced,047,269075,30359,30405,1029,31434,441
2021-04-18,Modoc,049,8938,368,359,122,481,3
2021-04-18,Mono,051,14174,1242,1254,17,1271,3
2021-04-18,Monterey,053,433212,42826,42638,1837,44475,356
2021-04-18,Napa,055,140530,9701,9674,34,9708,79
2021-04-18,Nevada,057,99092,4535,4464,185,4649,70
2021-04-18,Orange,059,3164182,253333,251940,11090,263030,4883
2021-04-18,Placer,061,380077,22385,21783,1381,23164,282
2021-04-18,Plumas,063,18699,682,665,10,675,4
2021-04-18,Riverside,065,2383286,291741,286043,13857,299900,4371
2021-04-18,Sacramento,067,1510023,102042,101354,1575,102929,1572
2021-04-18,San Benito,069,59416,5986,5989,112,6101,63
2021-04-18,San Bernardino,071,2135413,291158,289691,8874,298565,4556
2021-04-18,San Diego,073,3302833,275687,274961,14216,289177,3674
2021-04-18,San Francisco,075,870044,36004,36073,1250,37323,525
2021-04-18,San Joaquin,077,732212,71290,70466,3386,73852,1289
2021-04-18,San Luis Obispo,079,281455,20982,20656,693,21349,254
2021-04-18,San Mateo,081,765935,41625,41201,448,41649,352
2021-04-18,Santa Barbara,083,443738,33962,33769,1125,34894,446
2021-04-18,Santa Clara,085,1922200,116660,116996,705,117701,1944
2021-04-18,Santa Cruz,087,273765,16025,15580,806,16386,204
2021-04-18,Shasta,089,179085,11649,11658,1416,13074,189
2021-04-18,Sierra,091,2930,55,51,12,63,0
2021-04-18,Siskiyou,093,43540,1651,1538,293,1831,10
2021-04-18,Solano,095,438530,31707,31606,463,32069,239
2021-04-18,Sonoma,097,501317,29497,29660,300,29960,311
2021-04-18,Stanislaus,099,539301,54424,54132,5760,59892,728
2021-04-18,Sutter,101,95872,9256,9261,82,9343,109
2021-04-18,Tehama,103,63373,4906,4877,544,5421,52
2021-04-18,Trinity,105,12862,482,326,85,411,3
2021-04-18,Tulare,107,460477,49627,48618,8757,57375,829
2021-04-18,Tuolumne,109,53932,3946,4008,37,4045,58
2021-04-18,Ventura,111,848112,80545,79984,2937,82921,996
2021-04-18,Yolo,113,214977,13580,13562,267,13829,200
2021-04-18,Yuba,115,75493,5838,5804,118,5922,44
2021-04-17,Alameda,001,1643700,85759,85367,1869,87236,1247
2021-04-17,Alpine,003,1148,85,85,0,85,0
2021-04-17,Amador,005,37829,3635,3625,33,3658,46
2021-04-17,Butte,007,227075,11951,11573,1695,13268,196
2021-04-17,Calaveras,009,45235,2051,2045,12,2057,50
2021-04-17,Colusa,011,21464,1912,1912,286,2198,14
2021-04-17,Contra Costa,013,1133247,67405,66657,1190,67847,782
2021-04-17,Del Norte,015,27424,1277,1238,11,1249,6
2021-04-17,El Dorado,017,186661,9790,9692,672,10364,106
2021-04-17,Fresno,019,978130,101129,100562,8485,109047,1646
2021-04-17,Glenn,021,27897,2376,2357,539,2896,17
2021-04-17,Humboldt,023,135768,3658,3579,28,3607,35
2021-04-17,Imperial,025,180216,28107,27987,2686,30673,719
2021-04-17,Inyo,027,18085,1391,1392,10,1402,36
2021-04-17,Kern,029,883053,96162,95102,10523,105625,1290
2021-04-17,Kings,031,150075,22928,22678,1059,23737,243
2021-04-17,Lake,033,64148,3434,3409,9,3418,43
2021-04-17,Lassen,035,31185,5166,5154,105,5259,1
2021-04-17,Los Angeles,037,10098052,1196303,1188262,41143,1229405,23653
2021-04-17,Madera,039,155013,16388,16260,917,17177,231
2021-04-17,Marin,041,260295,13838,13797,236,14033,226
2021-04-17,Mariposa,043,17540,409,398,10,408,5
2021-04-17,Mendocino,045,87422,3801,3721,73,3794,46
2021-04-17,Merced,047,269075,30343,30392,1028,31420,441
2021-04-17,Modoc,049,8938,368,357,122,479,3
2021-04-17,Mono,051,14174,1242,1253,17,1270,3
2021-04-17,Monterey,053,433212,42817,42630,1835,44465,356
2021-04-17,Napa,055,140530,9697,9666,34,9700,79
2021-04-17,Nevada,057,99092,4527,4457,185,4642,70
2021-04-17,Orange,059,3164182,253264,251873,11078,262951,4878
2021-04-17,Placer,061,380077,22362,21736,1376,23112,282
2021-04-17,Plumas,063,18699,681,666,10,676,4
2021-04-17,Riverside,065,2383286,291672,285963,13849,299812,4371
2021-04-17,Sacramento,067,1510023,101932,101172,1564,102736,1572
2021-04-17,San Benito,069,59416,5980,5986,112,6098,63
2021-04-17,San Bernardino,071,2135413,291103,289624,8871,298495,4555
2021-04-17,San Diego,073,3302833,275540,274812,14182,288994,3674
2021-04-17,San Francisco,075,870044,35982,36032,1247,37279,523
2021-04-17,San Joaquin,077,732212,71250,70372,3376,73748,1288
2021-04-17,San Luis Obispo,079,281455,20969,20642,690,21332,254
2021-04-17,San Mateo,081,765935,41602,41157,448,41605,352
2021-04-17,Santa Barbara,083,443738,33931,33738,1123,34861,446
2021-04-17,Santa Clara,085,1922200,116568,116887,703,117590,1944
2021-04-17,Santa Cruz,087,273765,16019,15571,806,16377,204
2021-04-17,Shasta,089,179085,11634,11647,1415,13062,189
2021-04-17,Sierra,091,2930,55,51,12,63,0
2021-04-17,Siskiyou,093,43540,1646,1539,290,1829,10
2021-04-17,Solano,095,438530,31676,31541,460,32001,239
2021-04-17,Sonoma,097,501317,29490,29637,300,29937,311
2021-04-17,Stanislaus,099,539301,54387,54058,5755,59813,728
2021-04-17,Sutter,101,95872,9250,9252,82,9334,109
2021-04-17,Tehama,103,63373,4900,4875,543,5418,52
2021-04-17,Trinity,105,12862,482,326,85,411,3
2021-04-17,Tulare,107,460477,49615,48603,8753,57356,829
2021-04-17,Tuolumne,109,53932,3944,4005,37,4042,58
2021-04-17,Ventura,111,848112,80524,79964,2937,82901,996
2021-04-17,Yolo,113,214977,13570,13580,267,13847,200
2021-04-17,Yuba,115,75493,5833,5802,117,5919,44
2021-04-16,Alameda,001,1643700,85680,85243,1867,87110,1245
2021-04-16,Alpine,003,1148,85,85,0,85,0
2021-04-16,Amador,005,37829,3630,3621,33,3654,46
2021-04-16,Butte,007,227075,11939,11549,1693,13242,196
2021-04-16,Calaveras,009,45235,2049,2042,12,2054,50
2021-04-16,Colusa,011,21464,1910,1911,286,2197,14
2021-04-16,Contra Costa,013,1133247,67351,66569,1187,67756,782
2021-04-16,Del Norte,015,27424,1276,1237,11,1248,6
2021-04-16,El Dorado,017,186661,9770,9665,668,10333,106
2021-04-16,Fresno,019,978130,101079,100500,8479,108979,1643
2021-04-16,Glenn,021,27897,2376,2355,539,2894,17
2021-04-16,Humboldt,023,135768,3637,3570,27,3597,35
2021-04-16,Imperial,025,180216,28097,27962,2685,30647,719
2021-04-16,Inyo,027,18085,1391,1392,10,1402,36
2021-04-16,Kern,029,883053,96133,95066,10520,105586,1288
2021-04-16,Kings,031,150075,22924,22667,1058,23725,243
2021-04-16,Lake,033,64148,3428,3406,9,3415,43
2021-04-16,Lassen,035,31185,5165,5155,105,5260,1
2021-04-16,Los Angeles,037,10098052,1196002,1187818,41107,1228925,23627
2021-04-16,Madera,039,155013,16382,16250,916,17166,231
2021-04-16,Marin,041,260295,13835,13788,236,14024,226
2021-04-16,Mariposa,043,17540,408,396,9,405,5
2021-04-16,Mendocino,045,87422,3799,3719,73,3792,46
2021-04-16,Merced,047,269075,30328,30355,1028,31383,438
2021-04-16,Modoc,049,8938,368,355,122,477,3
2021-04-16,Mono,051,14174,1242,1253,17,1270,3
2021-04-16,Monterey,053,433212,42806,42620,1832,44452,351
2021-04-16,Napa,055,140530,9689,9653,34,9687,79
2021-04-16,Nevada,057,99092,4518,4443,185,4628,70
2021-04-16,Orange,059,3164182,253200,251770,11069,262839,4873
2021-04-16,Placer,061,380077,22335,21680,1371,23051,282
2021-04-16,Plumas,063,18699,680,665,10,675,4
2021-04-16,Riverside,065,2383286,291595,285818,13847,299665,4369
2021-04-16,Sacramento,067,1510023,101835,100993,1559,102552,1572
2021-04-16,San Benito,069,59416,5978,5982,112,6094,63
2021-04-16,San Bernardino,071,2135413,291056,289424,8870,298294,4550
2021-04-16,San Diego,073,3302833,275386,274567,14164,288731,3662
2021-04-16,San Francisco,075,870044,35956,35993,1243,37236,517
2021-04-16,San Joaquin,077,732212,71183,70280,3368,73648,1288
2021-04-16,San Luis Obispo,079,281455,20957,20623,689,21312,253
2021-04-16,San Mateo,081,765935,41573,41107,447,41554,352
2021-04-16,Santa Barbara,083,443738,33913,33703,1123,34826,446
2021-04-16,Santa Clara,085,1922200,116468,116693,700,117393,1941
2021-04-16,Santa Cruz,087,273765,16017,15539,806,16345,204
2021-04-16,Shasta,089,179085,11622,11623,1413,13036,189
2021-04-16,Sierra,091,2930,55,51,12,63,0
2021-04-16,Siskiyou,093,43540,1642,1530,288,1818,10
2021-04-16,Solano,095,438530,31637,31470,457,31927,239
2021-04-16,Sonoma,097,501317,29479,29617,300,29917,311
2021-04-16,Stanislaus,099,539301,54339,53983,5753,59736,728
2021-04-16,Sutter,101,95872,9244,9247,82,9329,109
2021-04-16,Tehama,103,63373,4899,4866,543,5409,52
2021-04-16,Trinity,105,12862,482,326,85,411,3
2021-04-16,Tulare,107,460477,49603,48583,8749,57332,830
2021-04-16,Tuolumne,109,53932,3941,4005,37,4042,58
2021-04-16,Ventura,111,848112,80499,79942,2932,82874,994
2021-04-16,Yolo,113,214977,13557,13559,265,13824,198
2021-04-16,Yuba,115,75493,5830,5795,116,5911,44
2021-04-15,Alameda,001,1643700,85573,85089,1865,86954,1246
2021-04-15,Alpine,003,1148,85,85,0,85,0
2021-04-15,Amador,005,37829,3629,3616,33,3649,46
2021-04-15,Butte,007,227075,11924,11529,1689,13218,196
2021-04-15,Calaveras,009,45235,2049,2039,12,2051,50
2021-04-15,Colusa,011,21464,1908,1909,285,2194,14
2021-04-15,Contra Costa,013,1133247,67277,66480,1183,67663,781
2021-04-15,Del Norte,015,27424,1269,1235,11,1246,6
2021-04-15,El Dorado,017,186661,9757,9639,666,10305,106
2021-04-15,Fresno,019,978130,101017,100431,8473,108904,1642
2021-04-15,Glenn,021,27897,2376,2354,539,2893,17
2021-04-15,Humboldt,023,135768,3616,3561,27,3588,35
2021-04-15,Imperial,025,180216,28069,27920,2682,30602,718
2021-04-15,Inyo,027,18085,1391,1393,10,1403,36
2021-04-15,Kern,029,883053,96100,94989,10506,105495,1289
2021-04-15,Kings,031,150075,22910,22648,1058,23706,242
2021-04-15,Lake,033,64148,3427,3399,9,3408,43
2021-04-15,Lassen,035,31185,5164,5152,105,5257,1
2021-04-15,Los Angeles,037,10098052,1195600,1187274,41071,1228345,23598
2021-04-15,Madera,039,155013,16367,16234,916,17150,231
2021-04-15,Marin,041,260295,13831,13783,235,14018,226
2021-04-15,Mariposa,043,17540,406,395,9,404,5
2021-04-15,Mendocino,045,87422,3798,3714,73,3787,46
2021-04-15,Merced,047,269075,30302,30325,1027,31352,437
2021-04-15,Modoc,049,8938,368,355,122,477,3
2021-04-15,Mono,051,14174,1241,1253,17,1270,3
2021-04-15,Monterey,053,433212,42796,42604,1830,44434,347
2021-04-15,Napa,055,140530,9681,9645,34,9679,79
2021-04-15,Nevada,057,99092,4506,4434,184,4618,70
2021-04-15,Orange,059,3164182,253105,251679,11056,262735,4857
2021-04-15,Placer,061,380077,22304,21614,1364,22978,281
2021-04-15,Plumas,063,18699,678,665,10,675,4
2021-04-15,Riverside,065,2383286,291491,285698,13840,299538,4363
2021-04-15,Sacramento,067,1510023,101705,100782,1545,102327,1570
2021-04-15,San Benito,069,59416,5975,5969,111,6080,63
2021-04-15,San Bernardino,071,2135413,290967,289288,8863,298151,4544
2021-04-15,San Diego,073,3302833,275140,274250,14105,288355,3653
2021-04-15,San Francisco,075,870044,35937,35947,1241,37188,510
2021-04-15,San Joaquin,077,732212,71102,70189,3360,73549,1288
2021-04-15,San Luis Obispo,079,281455,20941,20591,686,21277,253
2021-04-15,San Mateo,081,765935,41534,41050,446,41496,352
2021-04-15,Santa Barbara,083,443738,33895,33672,1119,34791,446
2021-04-15,Santa Clara,085,1922200,116362,116602,696,117298,1927
2021-04-15,Santa Cruz,087,273765,16007,15509,806,16315,203
2021-04-15,Shasta,089,179085,11608,11597,1409,13006,191
2021-04-15,Sierra,091,2930,55,51,12,63,0
2021-04-15,Siskiyou,093,43540,1636,1524,287,1811,10
2021-04-15,Solano,095,438530,31599,31394,456,31850,239
2021-04-15,Sonoma,097,501317,29465,29587,300,29887,311
2021-04-15,Stanislaus,099,539301,54285,53918,5744,59662,728
2021-04-15,Sutter,101,95872,9237,9237,82,9319,109
2021-04-15,Tehama,103,63373,4898,4854,542,5396,52
2021-04-15,Trinity,105,12862,482,326,85,411,3
2021-04-15,Tulare,107,460477,49582,48556,8749,57305,829
2021-04-15,Tuolumne,109,53932,3941,4003,37,4040,57
2021-04-15,Ventura,111,848112,80480,79917,2930,82847,989
2021-04-15,Yolo,113,214977,13538,13547,263,13810,198
2021-04-15,Yuba,115,75493,5827,5788,116,5904,44
2021-04-14,Alameda,001,1643700,85476,85009,1864,86873,1247
2021-04-14,Alpine,003,1148,85,85,0,85,0
2021-04-14,Amador,005,37829,3628,3613,33,3646,46
2021-04-14,Butte,007,227075,11911,11513,1688,13201,196
2021-04-14,Calaveras,009,45235,2048,2037,12,2049,50
2021-04-14,Colusa,011,21464,1908,1905,285,2190,14
2021-04-14,Contra Costa,013,1133247,67191,66400,1177,67577,781
2021-04-14,Del Norte,015,27424,1269,1228,11,1239,6
2021-04-14,El Dorado,017,186661,9742,9625,661,10286,106
2021-04-14,Fresno,019,978130,100960,100376,8460,108836,1640
2021-04-14,Glenn,021,27897,2376,2353,539,2892,17
2021-04-14,Humboldt,023,135768,3594,3551,26,3577,35
2021-04-14,Imperial,025,180216,28047,27907,2680,30587,718
2021-04-14,Inyo,027,18085,1391,1392,10,1402,36
2021-04-14,Kern,029,883053,96075,94947,10499,105446,1287
2021-04-14,Kings,031,150075,22901,22641,1056,23697,243
2021-04-14,Lake,033,64148,3422,3396,9,3405,43
2021-04-14,Lassen,035,31185,5163,5151,105,5256,1
2021-04-14,Los Angeles,037,10098052,1195202,1186821,41026,1227847,23579
2021-04-14,Madera,039,155013,16358,16218,916,17134,231
2021-04-14,Marin,041,260295,13829,13768,234,14002,226
2021-04-14,Mariposa,043,17540,405,394,9,403,5
2021-04-14,Mendocino,045,87422,3793,3711,73,3784,46
2021-04-14,Merced,047,269075,30286,30296,1025,31321,436
2021-04-14,Modoc,049,8938,368,355,122,477,3
2021-04-14,Mono,051,14174,1240,1252,17,1269,3
2021-04-14,Monterey,053,433212,42780,42595,1826,44421,347
2021-04-14,Napa,055,140530,9670,9643,34,9677,79
2021-04-14,Nevada,057,99092,4499,4421,184,4605,70
2021-04-14,Orange,059,3164182,253000,251568,11036,262604,4849
2021-04-14,Placer,061,380077,22271,21575,1363,22938,280
2021-04-14,Plumas,063,18699,678,665,10,675,4
2021-04-14,Riverside,065,2383286,291381,285583,13834,299417,4358
2021-04-14,Sacramento,067,1510023,101530,100645,1531,102176,1570
2021-04-14,San Benito,069,59416,5973,5960,111,6071,62
2021-04-14,San Bernardino,071,2135413,290900,289078,8860,297938,4523
2021-04-14,San Diego,073,3302833,274929,273969,14076,288045,3648
2021-04-14,San Francisco,075,870044,35899,35898,1240,37138,510
2021-04-14,San Joaquin,077,732212,71032,70095,3354,73449,1288
2021-04-14,San Luis Obispo,079,281455,20918,20561,676,21237,253
2021-04-14,San Mateo,081,765935,41494,40982,443,41425,352
2021-04-14,Santa Barbara,083,443738,33866,33650,1119,34769,445
2021-04-14,Santa Clara,085,1922200,116245,116488,693,117181,1922
2021-04-14,Santa Cruz,087,273765,15997,15481,806,16287,203
2021-04-14,Shasta,089,179085,11582,11581,1407,12988,190
2021-04-14,Sierra,091,2930,55,51,12,63,0
2021-04-14,Siskiyou,093,43540,1628,1518,286,1804,10
2021-04-14,Solano,095,438530,31546,31357,449,31806,239
2021-04-14,Sonoma,097,501317,29457,29572,298,29870,311
2021-04-14,Stanislaus,099,539301,54214,53836,5735,59571,727
2021-04-14,Sutter,101,95872,9229,9230,82,9312,106
2021-04-14,Tehama,103,63373,4892,4853,541,5394,52
2021-04-14,Trinity,105,12862,482,326,85,411,3
2021-04-14,Tulare,107,460477,49556,48527,8746,57273,827
2021-04-14,Tuolumne,109,53932,3940,3997,37,4034,57
2021-04-14,Ventura,111,848112,80444,79891,2928,82819,986
2021-04-14,Yolo,113,214977,13522,13530,261,13791,198
2021-04-14,Yuba,115,75493,5825,5778,116,5894,44
2021-04-13,Alameda,001,1643700,85370,84921,1861,86782,1239
2021-04-13,Alpine,003,1148,85,85,0,85,0
2021-04-13,Amador,005,37829,3625,3609,33,3642,46
2021-04-13,Butte,007,227075,11893,11497,1685,13182,196
2021-04-13,Calaveras,009,45235,2045,2035,12,2047,50
2021-04-13,Colusa,011,21464,1906,1905,283,2188,14
2021-04-13,Contra Costa,013,1133247,67102,66304,1177,67481,778
2021-04-13,Del Norte,015,27424,1264,1221,11,1232,6
2021-04-13,El Dorado,017,186661,9716,9609,658,10267,106
2021-04-13,Fresno,019,978130,100878,100357,8454,108811,1636
2021-04-13,Glenn,021,27897,2375,2351,539,2890,17
2021-04-13,Humboldt,023,135768,3577,3540,26,3566,35
2021-04-13,Imperial,025,180216,28028,27887,2672,30559,718
2021-04-13,Inyo,027,18085,1391,1391,10,1401,36
2021-04-13,Kern,029,883053,96031,94908,10487,105395,1285
2021-04-13,Kings,031,150075,22885,22636,1055,23691,243
2021-04-13,Lake,033,64148,3419,3390,9,3399,43
2021-04-13,Lassen,035,31185,5162,5147,105,5252,1
2021-04-13,Los Angeles,037,10098052,1194746,1186482,40984,1227466,23526
2021-04-13,Madera,039,155013,16348,16207,914,17121,231
2021-04-13,Marin,041,260295,13821,13760,233,13993,224
2021-04-13,Mariposa,043,17540,404,394,6,400,5
2021-04-13,Mendocino,045,87422,3787,3702,73,3775,46
2021-04-13,Merced,047,269075,30256,30276,1022,31298,435
2021-04-13,Modoc,049,8938,368,355,122,477,3
2021-04-13,Mono,051,14174,1240,1251,17,1268,3
2021-04-13,Monterey,053,433212,42769,42577,1826,44403,347
2021-04-13,Napa,055,140530,9660,9627,34,9661,79
2021-04-13,Nevada,057,99092,4487,4415,184,4599,69
2021-04-13,Orange,059,3164182,252905,251491,11018,262509,4836
2021-04-13,Placer,061,380077,22234,21534,1360,22894,280
2021-04-13,Plumas,063,18699,677,665,10,675,4
2021-04-13,Riverside,065,2383286,291262,285505,13828,299333,4348
2021-04-13,Sacramento,067,1510023,101355,100551,1526,102077,1569
2021-04-13,San Benito,069,59416,5970,5946,111,6057,62
2021-04-13,San Bernardino,071,2135413,290784,288929,8854,297783,4521
2021-04-13,San Diego,073,3302833,274675,273709,14041,287750,3623
2021-04-13,San Francisco,075,870044,35863,35869,1236,37105,506
2021-04-13,San Joaquin,077,732212,70924,70034,3346,73380,1288
2021-04-13,San Luis Obispo,079,281455,20891,20536,666,21202,253
2021-04-13,San Mateo,081,765935,41449,40955,443,41398,353
2021-04-13,Santa Barbara,083,443738,33843,33613,1116,34729,444
2021-04-13,Santa Clara,085,1922200,116116,116363,692,117055,1923
2021-04-13,Santa Cruz,087,273765,15990,15449,806,16255,203
2021-04-13,Shasta,089,179085,11562,11536,1404,12940,189
2021-04-13,Sierra,091,2930,55,51,12,63,0
2021-04-13,Siskiyou,093,43540,1620,1511,281,1792,10
2021-04-13,Solano,095,438530,31497,31335,445,31780,239
2021-04-13,Sonoma,097,501317,29449,29544,297,29841,311
2021-04-13,Stanislaus,099,539301,54141,53797,5726,59523,722
2021-04-13,Sutter,101,95872,9225,9226,82,9308,106
2021-04-13,Tehama,103,63373,4885,4850,538,5388,52
2021-04-13,Trinity,105,12862,482,326,85,411,3
2021-04-13,Tulare,107,460477,49543,48511,8743,57254,825
2021-04-13,Tuolumne,109,53932,3938,3995,37,4032,57
2021-04-13,Ventura,111,848112,80412,79854,2926,82780,986
2021-04-13,Yolo,113,214977,13510,13516,260,13776,198
2021-04-13,Yuba,115,75493,5816,5776,116,5892,44
2021-04-12,Alameda,001,1643700,85268,84817,1860,86677,1238
2021-04-12,Alpine,003,1148,85,85,0,85,0
2021-04-12,Amador,005,37829,3624,3607,33,3640,46
2021-04-12,Butte,007,227075,11878,11488,1681,13169,193
2021-04-12,Calaveras,009,45235,2042,2033,12,2045,50
2021-04-12,Colusa,011,21464,1904,1904,281,2185,14
2021-04-12,Contra Costa,013,1133247,67021,66176,1177,67353,777
2021-04-12,Del Norte,015,27424,1261,1216,11,1227,6
2021-04-12,El Dorado,017,186661,9699,9588,656,10244,106
2021-04-12,Fresno,019,978130,100817,100277,8430,108707,1633
2021-04-12,Glenn,021,27897,2374,2349,539,2888,17
2021-04-12,Humboldt,023,135768,3563,3533,25,3558,35
2021-04-12,Imperial,025,180216,27998,27851,2667,30518,717
2021-04-12,Inyo,027,18085,1391,1390,10,1400,36
2021-04-12,Kern,029,883053,95994,94861,10476,105337,1283
2021-04-12,Kings,031,150075,22877,22621,1054,23675,241
2021-04-12,Lake,033,64148,3415,3380,9,3389,43
2021-04-12,Lassen,035,31185,5161,5147,105,5252,1
2021-04-12,Los Angeles,037,10098052,1194242,1186145,40944,1227089,23505
2021-04-12,Madera,039,155013,16336,16174,912,17086,231
2021-04-12,Marin,041,260295,13808,13751,231,13982,224
2021-04-12,Mariposa,043,17540,403,394,6,400,5
2021-04-12,Mendocino,045,87422,3786,3699,73,3772,46
2021-04-12,Merced,047,269075,30225,30261,1019,31280,435
2021-04-12,Modoc,049,8938,366,352,122,474,3
2021-04-12,Mono,051,14174,1240,1251,17,1268,3
2021-04-12,Monterey,053,433212,42755,42555,1824,44379,346
2021-04-12,Napa,055,140530,9646,9603,34,9637,80
2021-04-12,Nevada,057,99092,4476,4408,184,4592,69
2021-04-12,Orange,059,3164182,252819,251350,10996,262346,4826
2021-04-12,Placer,061,380077,22183,21475,1357,22832,278
2021-04-12,Plumas,063,18699,675,666,10,676,4
2021-04-12,Riverside,065,2383286,291151,285361,13822,299183,4336
2021-04-12,Sacramento,067,1510023,101181,100394,1521,101915,1566
2021-04-12,San Benito,069,59416,5962,5942,110,6052,62
2021-04-12,San Bernardino,071,2135413,290677,288736,8842,297578,4493
2021-04-12,San Diego,073,3302833,274415,273431,14012,287443,3621
2021-04-12,San Francisco,075,870044,35829,35841,1235,37076,506
2021-04-12,San Joaquin,077,732212,70852,69968,3339,73307,1288
2021-04-12,San Luis Obispo,079,281455,20846,20515,653,21168,253
2021-04-12,San Mateo,081,765935,41407,40920,439,41359,353
2021-04-12,Santa Barbara,083,443738,33812,33606,1116,34722,444
2021-04-12,Santa Clara,085,1922200,115988,116252,690,116942,1923
2021-04-12,Santa Cruz,087,273765,15970,15406,806,16212,203
2021-04-12,Shasta,089,179085,11545,11509,1400,12909,189
2021-04-12,Sierra,091,2930,55,51,12,63,0
2021-04-12,Siskiyou,093,43540,1609,1511,278,1789,7
2021-04-12,Solano,095,438530,31455,31305,442,31747,238
2021-04-12,Sonoma,097,501317,29421,29500,297,29797,310
2021-04-12,Stanislaus,099,539301,54075,53722,5719,59441,707
2021-04-12,Sutter,101,95872,9214,9221,82,9303,106
2021-04-12,Tehama,103,63373,4876,4834,534,5368,52
2021-04-12,Trinity,105,12862,482,324,85,409,3
2021-04-12,Tulare,107,460477,49523,48495,8733,57228,824
2021-04-12,Tuolumne,109,53932,3934,3993,37,4030,57
2021-04-12,Ventura,111,848112,80379,79818,2924,82742,985
2021-04-12,Yolo,113,214977,13496,13510,259,13769,198
2021-04-12,Yuba,115,75493,5810,5773,116,5889,43
2021-04-11,Alameda,001,1643700,85131,84756,1854,86610,1238
2021-04-11,Alpine,003,1148,85,85,0,85,0
2021-04-11,Amador,005,37829,3622,3605,33,3638,46
2021-04-11,Butte,007,227075,11844,11487,1677,13164,193
2021-04-11,Calaveras,009,45235,2038,2036,12,2048,50
2021-04-11,Colusa,011,21464,1903,1904,280,2184,14
2021-04-11,Contra Costa,013,1133247,66912,66107,1175,67282,777
2021-04-11,Del Norte,015,27424,1255,1214,11,1225,6
2021-04-11,El Dorado,017,186661,9685,9575,653,10228,106
2021-04-11,Fresno,019,978130,100749,100230,8420,108650,1633
2021-04-11,Glenn,021,27897,2369,2348,539,2887,17
2021-04-11,Humboldt,023,135768,3553,3523,25,3548,35
2021-04-11,Imperial,025,180216,27974,27841,2665,30506,717
2021-04-11,Inyo,027,18085,1391,1390,10,1400,36
2021-04-11,Kern,029,883053,95933,94830,10468,105298,1283
2021-04-11,Kings,031,150075,22868,22618,1051,23669,241
2021-04-11,Lake,033,64148,3411,3377,9,3386,43
2021-04-11,Lassen,035,31185,5157,5147,105,5252,1
2021-04-11,Los Angeles,037,10098052,1193730,1185757,40902,1226659,23503
2021-04-11,Madera,039,155013,16317,16166,911,17077,231
2021-04-11,Marin,041,260295,13801,13741,230,13971,226
2021-04-11,Mariposa,043,17540,403,394,6,400,5
2021-04-11,Mendocino,045,87422,3784,3696,73,3769,46
2021-04-11,Merced,047,269075,30187,30249,1018,31267,435
2021-04-11,Modoc,049,8938,365,352,120,472,3
2021-04-11,Mono,051,14174,1239,1250,17,1267,3
2021-04-11,Monterey,053,433212,42748,42547,1817,44364,346
2021-04-11,Napa,055,140530,9635,9592,34,9626,80
2021-04-11,Nevada,057,99092,4462,4394,184,4578,69
2021-04-11,Orange,059,3164182,252692,251233,10985,262218,4826
2021-04-11,Placer,061,380077,22126,21458,1352,22810,278
2021-04-11,Plumas,063,18699,675,666,10,676,4
2021-04-11,Riverside,065,2383286,291018,285269,13812,299081,4336
2021-04-11,Sacramento,067,1510023,101011,100296,1509,101805,1566
2021-04-11,San Benito,069,59416,5954,5941,109,6050,62
2021-04-11,San Bernardino,071,2135413,290568,288686,8836,297522,4492
2021-04-11,San Diego,073,3302833,274117,273287,13953,287240,3621
2021-04-11,San Francisco,075,870044,35793,35815,1232,37047,498
2021-04-11,San Joaquin,077,732212,70766,69939,3328,73267,1288
2021-04-11,San Luis Obispo,079,281455,20820,20501,650,21151,253
2021-04-11,San Mateo,081,765935,41349,40901,438,41339,353
2021-04-11,Santa Barbara,083,443738,33777,33591,1115,34706,444
2021-04-11,Santa Clara,085,1922200,115852,116161,687,116848,1923
2021-04-11,Santa Cruz,087,273765,15958,15382,806,16188,203
2021-04-11,Shasta,089,179085,11501,11504,1399,12903,189
2021-04-11,Sierra,091,2930,55,51,12,63,0
2021-04-11,Siskiyou,093,43540,1602,1509,275,1784,7
2021-04-11,Solano,095,438530,31402,31268,438,31706,238
2021-04-11,Sonoma,097,501317,29395,29496,293,29789,310
2021-04-11,Stanislaus,099,539301,53992,53683,5710,59393,707
2021-04-11,Sutter,101,95872,9205,9222,82,9304,106
2021-04-11,Tehama,103,63373,4873,4832,532,5364,52
2021-04-11,Trinity,105,12862,482,324,85,409,3
2021-04-11,Tulare,107,460477,49509,48479,8726,57205,824
2021-04-11,Tuolumne,109,53932,3932,3993,37,4030,57
2021-04-11,Ventura,111,848112,80331,79800,2918,82718,985
2021-04-11,Yolo,113,214977,13476,13496,257,13753,198
2021-04-11,Yuba,115,75493,5800,5768,116,5884,43
2021-04-10,Alameda,001,1643700,85067,84626,1854,86480,1238
2021-04-10,Alpine,003,1148,85,85,0,85,0
2021-04-10,Amador,005,37829,3620,3603,33,3636,46
2021-04-10,Butte,007,227075,11833,11482,1676,13158,193
2021-04-10,Calaveras,009,45235,2036,2032,12,2044,50
2021-04-10,Colusa,011,21464,1903,1902,280,2182,14
2021-04-10,Contra Costa,013,1133247,66851,66001,1172,67173,778
2021-04-10,Del Norte,015,27424,1252,1212,11,1223,6
2021-04-10,El Dorado,017,186661,9673,9549,650,10199,106
2021-04-10,Fresno,019,978130,100716,100135,8413,108548,1633
2021-04-10,Glenn,021,27897,2369,2343,539,2882,17
2021-04-10,Humboldt,023,135768,3543,3508,25,3533,35
2021-04-10,Imperial,025,180216,27960,27816,2665,30481,717
2021-04-10,Inyo,027,18085,1391,1387,10,1397,36
2021-04-10,Kern,029,883053,95919,94802,10462,105264,1284
2021-04-10,Kings,031,150075,22864,22614,1049,23663,241
2021-04-10,Lake,033,64148,3406,3368,9,3377,43
2021-04-10,Lassen,035,31185,5157,5146,104,5250,1
2021-04-10,Los Angeles,037,10098052,1193456,1185246,40884,1226130,23493
2021-04-10,Madera,039,155013,16309,16143,910,17053,231
2021-04-10,Marin,041,260295,13796,13731,230,13961,226
2021-04-10,Mariposa,043,17540,400,393,6,399,5
2021-04-10,Mendocino,045,87422,3782,3696,73,3769,46
2021-04-10,Merced,047,269075,30167,30225,1017,31242,435
2021-04-10,Modoc,049,8938,365,352,120,472,3
2021-04-10,Mono,051,14174,1239,1249,17,1266,3
2021-04-10,Monterey,053,433212,42737,42527,1816,44343,346
2021-04-10,Napa,055,140530,9628,9569,34,9603,79
2021-04-10,Nevada,057,99092,4455,4379,184,4563,69
2021-04-10,Orange,059,3164182,252599,251139,10978,262117,4818
2021-04-10,Placer,061,380077,22095,21402,1346,22748,278
2021-04-10,Plumas,063,18699,675,666,10,676,4
2021-04-10,Riverside,065,2383286,290938,285082,13804,298886,4336
2021-04-10,Sacramento,067,1510023,100908,100048,1507,101555,1566
2021-04-10,San Benito,069,59416,5943,5932,108,6040,62
2021-04-10,San Bernardino,071,2135413,290504,288590,8829,297419,4489
2021-04-10,San Diego,073,3302833,273901,273058,13933,286991,3613
2021-04-10,San Francisco,075,870044,35763,35774,1229,37003,498
2021-04-10,San Joaquin,077,732212,70731,69852,3318,73170,1288
2021-04-10,San Luis Obispo,079,281455,20804,20461,649,21110,253
2021-04-10,San Mateo,081,765935,41316,40878,438,41316,350
2021-04-10,Santa Barbara,083,443738,33749,33541,1113,34654,444
2021-04-10,Santa Clara,085,1922200,115756,116015,686,116701,1923
2021-04-10,Santa Cruz,087,273765,15952,15360,806,16166,203
2021-04-10,Shasta,089,179085,11492,11492,1396,12888,189
2021-04-10,Sierra,091,2930,55,51,12,63,0
2021-04-10,Siskiyou,093,43540,1599,1512,275,1787,7
2021-04-10,Solano,095,438530,31368,31218,434,31652,238
2021-04-10,Sonoma,097,501317,29380,29469,293,29762,310
2021-04-10,Stanislaus,099,539301,53957,53596,5704,59300,707
2021-04-10,Sutter,101,95872,9203,9214,82,9296,106
2021-04-10,Tehama,103,63373,4871,4820,530,5350,52
2021-04-10,Trinity,105,12862,482,324,85,409,3
2021-04-10,Tulare,107,460477,49500,48470,8720,57190,824
2021-04-10,Tuolumne,109,53932,3929,3991,37,4028,57
2021-04-10,Ventura,111,848112,80303,79758,2916,82674,985
2021-04-10,Yolo,113,214977,13468,13494,256,13750,198
2021-04-10,Yuba,115,75493,5797,5757,115,5872,43
2021-04-09,Alameda,001,1643700,85000,84404,1846,86250,1237
2021-04-09,Alpine,003,1148,85,85,0,85,0
2021-04-09,Amador,005,37829,3619,3600,33,3633,46
2021-04-09,Butte,007,227075,11823,11454,1675,13129,193
2021-04-09,Calaveras,009,45235,2035,2028,12,2040,50
2021-04-09,Colusa,011,21464,1903,1898,280,2178,14
2021-04-09,Contra Costa,013,1133247,66758,65857,1166,67023,777
2021-04-09,Del Norte,015,27424,1251,1207,11,1218,6
2021-04-09,El Dorado,017,186661,9650,9528,646,10174,106
2021-04-09,Fresno,019,978130,100682,100027,8408,108435,1630
2021-04-09,Glenn,021,27897,2369,2337,539,2876,17
2021-04-09,Humboldt,023,135768,3534,3496,25,3521,35
2021-04-09,Imperial,025,180216,27945,27764,2663,30427,717
2021-04-09,Inyo,027,18085,1390,1386,10,1396,36
2021-04-09,Kern,029,883053,95881,94675,10460,105135,1282
2021-04-09,Kings,031,150075,22855,22595,1046,23641,242
2021-04-09,Lake,033,64148,3402,3362,9,3371,43
2021-04-09,Lassen,035,31185,5157,5140,104,5244,1
2021-04-09,Los Angeles,037,10098052,1193086,1184501,40855,1225356,23458
2021-04-09,Madera,039,155013,16306,16118,910,17028,231
2021-04-09,Marin,041,260295,13789,13721,230,13951,226
2021-04-09,Mariposa,043,17540,400,393,6,399,5
2021-04-09,Mendocino,045,87422,3780,3693,73,3766,46
2021-04-09,Merced,047,269075,30138,30179,1016,31195,435
2021-04-09,Modoc,049,8938,364,352,120,472,3
2021-04-09,Mono,051,14174,1239,1247,17,1264,3
2021-04-09,Monterey,053,433212,42728,42481,1812,44293,344
2021-04-09,Napa,055,140530,9609,9574,34,9608,80
2021-04-09,Nevada,057,99092,4447,4373,184,4557,69
2021-04-09,Orange,059,3164182,252525,250852,10973,261825,4813
2021-04-09,Placer,061,380077,22064,21327,1338,22665,278
2021-04-09,Plumas,063,18699,674,666,10,676,4
2021-04-09,Riverside,065,2383286,290855,284562,13798,298360,4325
2021-04-09,Sacramento,067,1510023,100753,99722,1501,101223,1564
2021-04-09,San Benito,069,59416,5938,5925,107,6032,62
2021-04-09,San Bernardino,071,2135413,290435,288000,8826,296826,4467
2021-04-09,San Diego,073,3302833,273703,272697,13891,286588,3600
2021-04-09,San Francisco,075,870044,35722,35716,1224,36940,497
2021-04-09,San Joaquin,077,732212,70667,69675,3306,72981,1281
2021-04-09,San Luis Obispo,079,281455,20789,20427,649,21076,252
2021-04-09,San Mateo,081,765935,41280,40800,437,41237,350
2021-04-09,Santa Barbara,083,443738,33726,33424,1110,34534,444
2021-04-09,Santa Clara,085,1922200,115672,115749,684,116433,1923
2021-04-09,Santa Cruz,087,273765,15947,15331,806,16137,203
2021-04-09,Shasta,089,179085,11482,11478,1393,12871,188
2021-04-09,Sierra,091,2930,55,51,12,63,0
2021-04-09,Siskiyou,093,43540,1596,1510,274,1784,7
2021-04-09,Solano,095,438530,31335,31166,429,31595,238
2021-04-09,Sonoma,097,501317,29367,29433,293,29726,310
2021-04-09,Stanislaus,099,539301,53902,53504,5695,59199,705
2021-04-09,Sutter,101,95872,9196,9201,82,9283,106
2021-04-09,Tehama,103,63373,4865,4806,530,5336,52
2021-04-09,Trinity,105,12862,481,324,85,409,3
2021-04-09,Tulare,107,460477,49496,48430,8714,57144,824
2021-04-09,Tuolumne,109,53932,3928,3986,37,4023,57
2021-04-09,Ventura,111,848112,80275,79698,2916,82614,987
2021-04-09,Yolo,113,214977,13457,13478,254,13732,198
2021-04-09,Yuba,115,75493,5790,5754,115,5869,43
2021-04-08,Alameda,001,1643700,84894,84213,1843,86056,1232
2021-04-08,Alpine,003,1148,85,85,0,85,0
2021-04-08,Amador,005,37829,3615,3595,33,3628,46
2021-04-08,Butte,007,227075,11812,11414,1674,13088,193
2021-04-08,Calaveras,009,45235,2033,2027,12,2039,50
2021-04-08,Colusa,011,21464,1902,1897,280,2177,14
2021-04-08,Contra Costa,013,1133247,66648,65706,1163,66869,775
2021-04-08,Del Norte,015,27424,1245,1201,11,1212,6
2021-04-08,El Dorado,017,186661,9634,9513,641,10154,106
2021-04-08,Fresno,019,978130,100619,99935,8401,108336,1627
2021-04-08,Glenn,021,27897,2368,2337,539,2876,17
2021-04-08,Humboldt,023,135768,3524,3486,25,3511,35
2021-04-08,Imperial,025,180216,27917,27744,2659,30403,713
2021-04-08,Inyo,027,18085,1389,1386,10,1396,36
2021-04-08,Kern,029,883053,95835,94493,10447,104940,1281
2021-04-08,Kings,031,150075,22848,22589,1044,23633,243
2021-04-08,Lake,033,64148,3395,3360,9,3369,43
2021-04-08,Lassen,035,31185,5156,5136,104,5240,1
2021-04-08,Los Angeles,037,10098052,1192589,1184443,40817,1225260,23416
2021-04-08,Madera,039,155013,16294,16103,910,17013,231
2021-04-08,Marin,041,260295,13782,13704,230,13934,226
2021-04-08,Mariposa,043,17540,399,393,6,399,5
2021-04-08,Mendocino,045,87422,3778,3690,73,3763,45
2021-04-08,Merced,047,269075,30116,30163,1016,31179,430
2021-04-08,Modoc,049,8938,364,352,120,472,3
2021-04-08,Mono,051,14174,1237,1247,17,1264,3
2021-04-08,Monterey,053,433212,42706,42437,1807,44244,342
2021-04-08,Napa,055,140530,9592,9569,34,9603,80
2021-04-08,Nevada,057,99092,4436,4367,184,4551,69
2021-04-08,Orange,059,3164182,252415,250529,10958,261487,4797
2021-04-08,Placer,061,380077,22022,21258,1329,22587,277
2021-04-08,Plumas,063,18699,674,665,10,675,4
2021-04-08,Riverside,065,2383286,290741,283853,13793,297646,4296
2021-04-08,Sacramento,067,1510023,100613,99319,1490,100809,1561
2021-04-08,San Benito,069,59416,5935,5914,105,6019,62
2021-04-08,San Bernardino,071,2135413,290337,287190,8823,296013,4445
2021-04-08,San Diego,073,3302833,273473,272495,13855,286350,3592
2021-04-08,San Francisco,075,870044,35699,35657,1223,36880,494
2021-04-08,San Joaquin,077,732212,70595,69479,3300,72779,1279
2021-04-08,San Luis Obispo,079,281455,20770,20402,647,21049,252
2021-04-08,San Mateo,081,765935,41240,40749,437,41186,350
2021-04-08,Santa Barbara,083,443738,33702,33309,1109,34418,444
2021-04-08,Santa Clara,085,1922200,115566,115487,683,116170,1905
2021-04-08,Santa Cruz,087,273765,15940,15296,806,16102,203
2021-04-08,Shasta,089,179085,11472,11466,1389,12855,186
2021-04-08,Sierra,091,2930,55,51,12,63,0
2021-04-08,Siskiyou,093,43540,1593,1511,274,1785,7
2021-04-08,Solano,095,438530,31286,31120,429,31549,238
2021-04-08,Sonoma,097,501317,29347,29410,292,29702,310
2021-04-08,Stanislaus,099,539301,53825,53401,5685,59086,706
2021-04-08,Sutter,101,95872,9192,9195,82,9277,106
2021-04-08,Tehama,103,63373,4861,4802,530,5332,52
2021-04-08,Trinity,105,12862,481,324,85,409,3
2021-04-08,Tulare,107,460477,49483,48409,8704,57113,821
2021-04-08,Tuolumne,109,53932,3928,3986,37,4023,57
2021-04-08,Ventura,111,848112,80238,79626,2912,82538,986
2021-04-08,Yolo,113,214977,13448,13468,253,13721,198
2021-04-08,Yuba,115,75493,5786,5743,115,5858,43
2021-04-07,Alameda,001,1643700,84810,84130,1841,85971,1224
2021-04-07,Alpine,003,1148,85,85,0,85,0
2021-04-07,Amador,005,37829,3612,3590,33,3623,46
2021-04-07,Butte,007,227075,11808,11405,1671,13076,193
2021-04-07,Calaveras,009,45235,2032,2022,12,2034,50
2021-04-07,Colusa,011,21464,1898,1894,279,2173,14
2021-04-07,Contra Costa,013,1133247,66562,65619,1162,66781,775
2021-04-07,Del Norte,015,27424,1243,1198,11,1209,6
2021-04-07,El Dorado,017,186661,9613,9500,636,10136,106
2021-04-07,Fresno,019,978130,100554,99865,8390,108255,1627
2021-04-07,Glenn,021,27897,2366,2337,538,2875,17
2021-04-07,Humboldt,023,135768,3511,3484,25,3509,35
2021-04-07,Imperial,025,180216,27893,27704,2653,30357,713
2021-04-07,Inyo,027,18085,1388,1386,10,1396,36
2021-04-07,Kern,029,883053,95799,94456,10432,104888,1275
2021-04-07,Kings,031,150075,22846,22589,1044,23633,243
2021-04-07,Lake,033,64148,3393,3358,9,3367,43
2021-04-07,Lassen,035,31185,5156,5137,104,5241,1
2021-04-07,Los Angeles,037,10098052,1192153,1183862,40795,1224657,23372
2021-04-07,Madera,039,155013,16275,16090,909,16999,231
2021-04-07,Marin,041,260295,13771,13688,228,13916,225
2021-04-07,Mariposa,043,17540,398,391,6,397,5
2021-04-07,Mendocino,045,87422,3777,3691,73,3764,45
2021-04-07,Merced,047,269075,30093,30132,1011,31143,430
2021-04-07,Modoc,049,8938,364,351,120,471,3
2021-04-07,Mono,051,14174,1237,1246,17,1263,3
2021-04-07,Monterey,053,433212,42688,42427,1806,44233,341
2021-04-07,Napa,055,140530,9578,9556,34,9590,80
2021-04-07,Nevada,057,99092,4430,4364,184,4548,69
2021-04-07,Orange,059,3164182,252291,250378,10935,261313,4778
2021-04-07,Placer,061,380077,21977,21227,1321,22548,276
2021-04-07,Plumas,063,18699,674,665,10,675,4
2021-04-07,Riverside,065,2383286,290621,283749,13783,297532,4285
2021-04-07,Sacramento,067,1510023,100445,99202,1484,100686,1544
2021-04-07,San Benito,069,59416,5930,5912,104,6016,62
2021-04-07,San Bernardino,071,2135413,290219,286978,8818,295796,4433
2021-04-07,San Diego,073,3302833,273247,272195,13826,286021,3588
2021-04-07,San Francisco,075,870044,35659,35618,1219,36837,493
2021-04-07,San Joaquin,077,732212,70525,69375,3295,72670,1278
2021-04-07,San Luis Obispo,079,281455,20744,20373,644,21017,252
2021-04-07,San Mateo,081,765935,41196,40693,437,41130,350
2021-04-07,Santa Barbara,083,443738,33676,33289,1106,34395,444
2021-04-07,Santa Clara,085,1922200,115434,115311,681,115992,1900
2021-04-07,Santa Cruz,087,273765,15929,15275,806,16081,203
2021-04-07,Shasta,089,179085,11460,11456,1384,12840,184
2021-04-07,Sierra,091,2930,55,51,12,63,0
2021-04-07,Siskiyou,093,43540,1587,1512,273,1785,7
2021-04-07,Solano,095,438530,31235,31097,428,31525,238
2021-04-07,Sonoma,097,501317,29329,29394,291,29685,310
2021-04-07,Stanislaus,099,539301,53756,53344,5675,59019,686
2021-04-07,Sutter,101,95872,9189,9188,82,9270,106
2021-04-07,Tehama,103,63373,4853,4802,528,5330,52
2021-04-07,Trinity,105,12862,481,322,85,407,3
2021-04-07,Tulare,107,460477,49468,48386,8693,57079,820
2021-04-07,Tuolumne,109,53932,3926,3982,37,4019,57
2021-04-07,Ventura,111,848112,80204,79595,2910,82505,986
2021-04-07,Yolo,113,214977,13433,13450,251,13701,198
2021-04-07,Yuba,115,75493,5782,5737,115,5852,43
2021-04-06,Alameda,001,1643700,84697,84091,1837,85928,1223
2021-04-06,Alpine,003,1148,85,85,0,85,0
2021-04-06,Amador,005,37829,3611,3587,33,3620,45
2021-04-06,Butte,007,227075,11793,11396,1669,13065,193
2021-04-06,Calaveras,009,45235,2028,2021,12,2033,50
2021-04-06,Colusa,011,21464,1896,1894,277,2171,14
2021-04-06,Contra Costa,013,1133247,66484,65575,1161,66736,774
2021-04-06,Del Norte,015,27424,1238,1197,11,1208,6
2021-04-06,El Dorado,017,186661,9583,9489,634,10123,106
2021-04-06,Fresno,019,978130,100490,99814,8384,108198,1626
2021-04-06,Glenn,021,27897,2365,2335,537,2872,17
2021-04-06,Humboldt,023,135768,3502,3477,25,3502,35
2021-04-06,Imperial,025,180216,27859,27661,2643,30304,713
2021-04-06,Inyo,027,18085,1388,1379,10,1389,36
2021-04-06,Kern,029,883053,95755,94422,10426,104848,1259
2021-04-06,Kings,031,150075,22840,22587,1044,23631,240
2021-04-06,Lake,033,64148,3390,3358,9,3367,43
2021-04-06,Lassen,035,31185,5154,5137,104,5241,1
2021-04-06,Los Angeles,037,10098052,1191641,1183499,40755,1224254,23323
2021-04-06,Madera,039,155013,16255,16085,904,16989,230
2021-04-06,Marin,041,260295,13762,13675,225,13900,224
2021-04-06,Mariposa,043,17540,398,390,6,396,5
2021-04-06,Mendocino,045,87422,3775,3686,73,3759,45
2021-04-06,Merced,047,269075,30064,30100,1006,31106,430
2021-04-06,Modoc,049,8938,363,351,120,471,3
2021-04-06,Mono,051,14174,1237,1246,17,1263,3
2021-04-06,Monterey,053,433212,42679,42412,1805,44217,341
2021-04-06,Napa,055,140530,9559,9509,34,9543,78
2021-04-06,Nevada,057,99092,4420,4356,182,4538,69
2021-04-06,Orange,059,3164182,252182,250304,10921,261225,4771
2021-04-06,Placer,061,380077,21929,21184,1319,22503,276
2021-04-06,Plumas,063,18699,674,665,10,675,4
2021-04-06,Riverside,065,2383286,290440,283622,13772,297394,4264
2021-04-06,Sacramento,067,1510023,100236,99110,1478,100588,1537
2021-04-06,San Benito,069,59416,5921,5907,104,6011,62
2021-04-06,San Bernardino,071,2135413,290105,286792,8808,295600,4428
2021-04-06,San Diego,073,3302833,272985,271867,13798,285665,3585
2021-04-06,San Francisco,075,870044,35616,35572,1219,36791,488
2021-04-06,San Joaquin,077,732212,70442,69316,3283,72599,1278
2021-04-06,San Luis Obispo,079,281455,20722,20350,641,20991,252
2021-04-06,San Mateo,081,765935,41148,40649,436,41085,350
2021-04-06,Santa Barbara,083,443738,33658,33257,1105,34362,443
2021-04-06,Santa Clara,085,1922200,115263,115184,680,115864,1900
2021-04-06,Santa Cruz,087,273765,15919,15252,806,16058,203
2021-04-06,Shasta,089,179085,11439,11443,1382,12825,184
2021-04-06,Sierra,091,2930,55,51,12,63,0
2021-04-06,Siskiyou,093,43540,1583,1510,272,1782,7
2021-04-06,Solano,095,438530,31188,31078,427,31505,237
2021-04-06,Sonoma,097,501317,29304,29386,289,29675,311
2021-04-06,Stanislaus,099,539301,53699,53304,5669,58973,686
2021-04-06,Sutter,101,95872,9179,9179,82,9261,106
2021-04-06,Tehama,103,63373,4844,4798,528,5326,52
2021-04-06,Trinity,105,12862,481,321,85,406,3
2021-04-06,Tulare,107,460477,49425,48372,8689,57061,819
2021-04-06,Tuolumne,109,53932,3926,3981,37,4018,57
2021-04-06,Ventura,111,848112,80167,79556,2908,82464,983
2021-04-06,Yolo,113,214977,13420,13443,250,13693,198
2021-04-06,Yuba,115,75493,5778,5733,114,5847,43
2021-04-05,Alameda,001,1643700,84581,84007,1833,85840,1219
2021-04-05,Alpine,003,1148,85,85,0,85,0
2021-04-05,Amador,005,37829,3608,3584,33,3617,45
2021-04-05,Butte,007,227075,11778,11384,1668,13052,193
2021-04-05,Calaveras,009,45235,2026,2019,12,2031,50
2021-04-05,Colusa,011,21464,1896,1894,276,2170,14
2021-04-05,Contra Costa,013,1133247,66418,65457,1159,66616,774
2021-04-05,Del Norte,015,27424,1236,1189,11,1200,6
2021-04-05,El Dorado,017,186661,9568,9463,634,10097,106
2021-04-05,Fresno,019,978130,100402,99755,8376,108131,1622
2021-04-05,Glenn,021,27897,2364,2335,537,2872,17
2021-04-05,Humboldt,023,135768,3493,3475,25,3500,35
2021-04-05,Imperial,025,180216,27827,27604,2638,30242,710
2021-04-05,Inyo,027,18085,1385,1377,10,1387,36
2021-04-05,Kern,029,883053,95700,94401,10401,104802,1249
2021-04-05,Kings,031,150075,22836,22580,1044,23624,239
2021-04-05,Lake,033,64148,3382,3359,9,3368,43
2021-04-05,Lassen,035,31185,5154,5138,103,5241,1
2021-04-05,Los Angeles,037,10098052,1191107,1183200,40704,1223904,23302
2021-04-05,Madera,039,155013,16241,16065,903,16968,230
2021-04-05,Marin,041,260295,13748,13666,221,13887,221
2021-04-05,Mariposa,043,17540,398,390,6,396,5
2021-04-05,Mendocino,045,87422,3773,3687,73,3760,45
2021-04-05,Merced,047,269075,30038,30068,1004,31072,427
2021-04-05,Modoc,049,8938,361,346,120,466,3
2021-04-05,Mono,051,14174,1237,1246,17,1263,3
2021-04-05,Monterey,053,433212,42666,42396,1801,44197,341
2021-04-05,Napa,055,140530,9536,9492,34,9526,78
2021-04-05,Nevada,057,99092,4409,4346,182,4528,69
2021-04-05,Orange,059,3164182,252067,250177,10897,261074,4759
2021-04-05,Placer,061,380077,21883,21133,1312,22445,276
2021-04-05,Plumas,063,18699,674,666,10,676,4
2021-04-05,Riverside,065,2383286,290303,283549,13760,297309,4237
2021-04-05,Sacramento,067,1510023,100074,98908,1470,100378,1533
2021-04-05,San Benito,069,59416,5915,5904,104,6008,61
2021-04-05,San Bernardino,071,2135413,289995,286597,8805,295402,4425
2021-04-05,San Diego,073,3302833,272736,271655,13757,285412,3583
2021-04-05,San Francisco,075,870044,35585,35538,1219,36757,488
2021-04-05,San Joaquin,077,732212,70353,69214,3274,72488,1268
2021-04-05,San Luis Obispo,079,281455,20685,20333,641,20974,252
2021-04-05,San Mateo,081,765935,41104,40609,435,41044,350
2021-04-05,Santa Barbara,083,443738,33623,33235,1105,34340,443
2021-04-05,Santa Clara,085,1922200,115096,115091,677,115768,1893
2021-04-05,Santa Cruz,087,273765,15912,15228,806,16034,201
2021-04-05,Shasta,089,179085,11418,11435,1379,12814,184
2021-04-05,Sierra,091,2930,55,50,12,62,0
2021-04-05,Siskiyou,093,43540,1580,1509,270,1779,7
2021-04-05,Solano,095,438530,31147,31026,425,31451,237
2021-04-05,Sonoma,097,501317,29272,29361,287,29648,311
2021-04-05,Stanislaus,099,539301,53619,53238,5666,58904,686
2021-04-05,Sutter,101,95872,9172,9169,82,9251,106
2021-04-05,Tehama,103,63373,4838,4794,528,5322,52
2021-04-05,Trinity,105,12862,480,321,85,406,3
2021-04-05,Tulare,107,460477,49413,48356,8682,57038,818
2021-04-05,Tuolumne,109,53932,3925,3980,37,4017,57
2021-04-05,Ventura,111,848112,80136,79549,2905,82454,983
2021-04-05,Yolo,113,214977,13406,13427,249,13676,198
2021-04-05,Yuba,115,75493,5773,5728,113,5841,43
2021-04-04,Alameda,001,1643700,84463,83951,1829,85780,1219
2021-04-04,Alpine,003,1148,85,85,0,85,0
2021-04-04,Amador,005,37829,3602,3582,33,3615,45
2021-04-04,Butte,007,227075,11763,11375,1667,13042,193
2021-04-04,Calaveras,009,45235,2022,2020,12,2032,50
2021-04-04,Colusa,011,21464,1895,1893,276,2169,14
2021-04-04,Contra Costa,013,1133247,66312,65408,1154,66562,774
2021-04-04,Del Norte,015,27424,1228,1186,11,1197,6
2021-04-04,El Dorado,017,186661,9549,9455,630,10085,106
2021-04-04,Fresno,019,978130,100328,99702,8363,108065,1622
2021-04-04,Glenn,021,27897,2361,2335,536,2871,17
2021-04-04,Humboldt,023,135768,3482,3472,25,3497,35
2021-04-04,Imperial,025,180216,27771,27588,2636,30224,710
2021-04-04,Inyo,027,18085,1381,1377,10,1387,36
2021-04-04,Kern,029,883053,95656,94388,10380,104768,1247
2021-04-04,Kings,031,150075,22834,22580,1043,23623,239
2021-04-04,Lake,033,64148,3376,3355,8,3363,43
2021-04-04,Lassen,035,31185,5152,5138,103,5241,1
2021-04-04,Los Angeles,037,10098052,1190563,1182872,40659,1223531,23301
2021-04-04,Madera,039,155013,16215,16052,899,16951,230
2021-04-04,Marin,041,260295,13735,13663,220,13883,221
2021-04-04,Mariposa,043,17540,398,390,6,396,5
2021-04-04,Mendocino,045,87422,3770,3684,73,3757,45
2021-04-04,Merced,047,269075,29995,30048,1001,31049,427
2021-04-04,Modoc,049,8938,361,346,120,466,3
2021-04-04,Mono,051,14174,1236,1245,17,1262,3
2021-04-04,Monterey,053,433212,42649,42391,1800,44191,341
2021-04-04,Napa,055,140530,9524,9486,34,9520,78
2021-04-04,Nevada,057,99092,4397,4337,182,4519,69
2021-04-04,Orange,059,3164182,251933,250117,10881,260998,4759
2021-04-04,Placer,061,380077,21837,21104,1294,22398,276
2021-04-04,Plumas,063,18699,674,666,10,676,4
2021-04-04,Riverside,065,2383286,290177,283537,13756,297293,4237
2021-04-04,Sacramento,067,1510023,99875,98821,1461,100282,1531
2021-04-04,San Benito,069,59416,5905,5901,100,6001,61
2021-04-04,San Bernardino,071,2135413,289855,286561,8797,295358,4423
2021-04-04,San Diego,073,3302833,272424,271528,13716,285244,3583
2021-04-04,San Francisco,075,870044,35531,35525,1216,36741,488
2021-04-04,San Joaquin,077,732212,70252,69147,3262,72409,1268
2021-04-04,San Luis Obispo,079,281455,20653,20328,633,20961,252
2021-04-04,San Mateo,081,765935,41061,40587,432,41019,350
2021-04-04,Santa Barbara,083,443738,33587,33213,1105,34318,443
2021-04-04,Santa Clara,085,1922200,114930,114976,670,115646,1893
2021-04-04,Santa Cruz,087,273765,15903,15219,806,16025,201
2021-04-04,Shasta,089,179085,11392,11433,1378,12811,184
2021-04-04,Sierra,091,2930,55,50,12,62,0
2021-04-04,Siskiyou,093,43540,1577,1509,266,1775,7
2021-04-04,Solano,095,438530,31100,31002,423,31425,237
2021-04-04,Sonoma,097,501317,29240,29340,285,29625,311
2021-04-04,Stanislaus,099,539301,53526,53181,5658,58839,686
2021-04-04,Sutter,101,95872,9165,9164,82,9246,106
2021-04-04,Tehama,103,63373,4826,4792,527,5319,52
2021-04-04,Trinity,105,12862,478,321,85,406,3
2021-04-04,Tulare,107,460477,49398,48343,8674,57017,818
2021-04-04,Tuolumne,109,53932,3917,3980,37,4017,57
2021-04-04,Ventura,111,848112,80093,79526,2903,82429,983
2021-04-04,Yolo,113,214977,13385,13425,248,13673,198
2021-04-04,Yuba,115,75493,5766,5722,113,5835,43
2021-04-03,Alameda,001,1643700,84396,83861,1827,85688,1218
2021-04-03,Alpine,003,1148,85,85,0,85,0
2021-04-03,Amador,005,37829,3599,3577,33,3610,45
2021-04-03,Butte,007,227075,11759,11359,1663,13022,193
2021-04-03,Calaveras,009,45235,2020,2019,12,2031,50
2021-04-03,Colusa,011,21464,1895,1891,276,2167,14
2021-04-03,Contra Costa,013,1133247,66240,65338,1154,66492,774
2021-04-03,Del Norte,015,27424,1223,1183,11,1194,6
2021-04-03,El Dorado,017,186661,9540,9448,629,10077,106
2021-04-03,Fresno,019,978130,100271,99602,8357,107959,1622
2021-04-03,Glenn,021,27897,2360,2334,535,2869,17
2021-04-03,Humboldt,023,135768,3480,3467,25,3492,35
2021-04-03,Imperial,025,180216,27755,27572,2633,30205,710
2021-04-03,Inyo,027,18085,1380,1376,10,1386,36
2021-04-03,Kern,029,883053,95630,94369,10364,104733,1243
2021-04-03,Kings,031,150075,22832,22580,1043,23623,239
2021-04-03,Lake,033,64148,3375,3350,8,3358,43
2021-04-03,Lassen,035,31185,5151,5136,103,5239,1
2021-04-03,Los Angeles,037,10098052,1190260,1182402,40642,1223044,23301
2021-04-03,Madera,039,155013,16206,16051,897,16948,230
2021-04-03,Marin,041,260295,13727,13658,219,13877,221
2021-04-03,Mariposa,043,17540,398,390,5,395,5
2021-04-03,Mendocino,045,87422,3769,3684,73,3757,45
2021-04-03,Merced,047,269075,29980,30031,1001,31032,427
2021-04-03,Modoc,049,8938,361,346,120,466,3
2021-04-03,Mono,051,14174,1236,1245,17,1262,3
2021-04-03,Monterey,053,433212,42636,42376,1798,44174,341
2021-04-03,Napa,055,140530,9515,9473,34,9507,78
2021-04-03,Nevada,057,99092,4393,4323,182,4505,69
2021-04-03,Orange,059,3164182,251853,249982,10863,260845,4755
2021-04-03,Placer,061,380077,21806,21060,1290,22350,276
2021-04-03,Plumas,063,18699,674,666,10,676,4
2021-04-03,Riverside,065,2383286,290099,283423,13753,297176,4237
2021-04-03,Sacramento,067,1510023,99767,98660,1455,100115,1531
2021-04-03,San Benito,069,59416,5902,5893,99,5992,61
2021-04-03,San Bernardino,071,2135413,289790,286473,8791,295264,4422
2021-04-03,San Diego,073,3302833,272255,271335,13699,285034,3571
2021-04-03,San Francisco,075,870044,35512,35488,1214,36702,489
2021-04-03,San Joaquin,077,732212,70211,69100,3246,72346,1268
2021-04-03,San Luis Obispo,079,281455,20634,20301,633,20934,252
2021-04-03,San Mateo,081,765935,41036,40560,432,40992,350
2021-04-03,Santa Barbara,083,443738,33561,33172,1104,34276,443
2021-04-03,Santa Clara,085,1922200,114822,114865,668,115533,1893
2021-04-03,Santa Cruz,087,273765,15896,15205,806,16011,201
2021-04-03,Shasta,089,179085,11384,11418,1378,12796,184
2021-04-03,Sierra,091,2930,55,50,12,62,0
2021-04-03,Siskiyou,093,43540,1576,1509,266,1775,7
2021-04-03,Solano,095,438530,31079,30970,420,31390,237
2021-04-03,Sonoma,097,501317,29224,29315,284,29599,311
2021-04-03,Stanislaus,099,539301,53491,53137,5652,58789,686
2021-04-03,Sutter,101,95872,9159,9158,82,9240,106
2021-04-03,Tehama,103,63373,4818,4788,527,5315,52
2021-04-03,Trinity,105,12862,478,321,85,406,3
2021-04-03,Tulare,107,460477,49388,48327,8670,56997,818
2021-04-03,Tuolumne,109,53932,3917,3980,37,4017,57
2021-04-03,Ventura,111,848112,80072,79489,2901,82390,983
2021-04-03,Yolo,113,214977,13379,13414,248,13662,198
2021-04-03,Yuba,115,75493,5760,5716,113,5829,43
2021-04-02,Alameda,001,1643700,84322,83776,1824,85600,1217
2021-04-02,Alpine,003,1148,85,85,0,85,0
2021-04-02,Amador,005,37829,3595,3573,32,3605,45
2021-04-02,Butte,007,227075,11751,11350,1663,13013,193
2021-04-02,Calaveras,009,45235,2018,2010,12,2022,50
2021-04-02,Colusa,011,21464,1895,1891,276,2167,14
2021-04-02,Contra Costa,013,1133247,66176,65299,1153,66452,774
2021-04-02,Del Norte,015,27424,1220,1174,11,1185,6
2021-04-02,El Dorado,017,186661,9527,9437,626,10063,106
2021-04-02,Fresno,019,978130,100217,99551,8346,107897,1620
2021-04-02,Glenn,021,27897,2360,2331,535,2866,17
2021-04-02,Humboldt,023,135768,3476,3465,25,3490,35
2021-04-02,Imperial,025,180216,27742,27553,2627,30180,710
2021-04-02,Inyo,027,18085,1380,1377,10,1387,36
2021-04-02,Kern,029,883053,95612,94348,10361,104709,1233
2021-04-02,Kings,031,150075,22832,22571,1040,23611,239
2021-04-02,Lake,033,64148,3373,3348,8,3356,43
2021-04-02,Lassen,035,31185,5151,5134,103,5237,1
2021-04-02,Los Angeles,037,10098052,1189951,1181682,40619,1222301,23264
2021-04-02,Madera,039,155013,16197,16036,896,16932,230
2021-04-02,Marin,041,260295,13719,13649,219,13868,221
2021-04-02,Mariposa,043,17540,396,390,5,395,5
2021-04-02,Mendocino,045,87422,3766,3682,73,3755,45
2021-04-02,Merced,047,269075,29955,29998,1001,30999,426
2021-04-02,Modoc,049,8938,358,346,120,466,3
2021-04-02,Mono,051,14174,1236,1246,17,1263,3
2021-04-02,Monterey,053,433212,42626,42359,1795,44154,341
2021-04-02,Napa,055,140530,9500,9453,34,9487,78
2021-04-02,Nevada,057,99092,4389,4323,182,4505,69
2021-04-02,Orange,059,3164182,251757,249891,10850,260741,4748
2021-04-02,Placer,061,380077,21770,21035,1284,22319,275
2021-04-02,Plumas,063,18699,674,666,10,676,4
2021-04-02,Riverside,065,2383286,290013,283328,13744,297072,4213
2021-04-02,Sacramento,067,1510023,99660,98648,1448,100096,1527
2021-04-02,San Benito,069,59416,5900,5888,97,5985,61
2021-04-02,San Bernardino,071,2135413,289717,286308,8787,295095,4417
2021-04-02,San Diego,073,3302833,272069,271036,13673,284709,3568
2021-04-02,San Francisco,075,870044,35477,35451,1212,36663,488
2021-04-02,San Joaquin,077,732212,70146,68996,3231,72227,1268
2021-04-02,San Luis Obispo,079,281455,20617,20271,632,20903,252
2021-04-02,San Mateo,081,765935,40994,40514,432,40946,350
2021-04-02,Santa Barbara,083,443738,33533,33145,1104,34249,443
2021-04-02,Santa Clara,085,1922200,114711,114777,666,115443,1882
2021-04-02,Santa Cruz,087,273765,15888,15216,806,16022,202
2021-04-02,Shasta,089,179085,11379,11377,1370,12747,181
2021-04-02,Sierra,091,2930,55,50,12,62,0
2021-04-02,Siskiyou,093,43540,1576,1508,265,1773,7
2021-04-02,Solano,095,438530,31050,30951,417,31368,237
2021-04-02,Sonoma,097,501317,29203,29288,283,29571,311
2021-04-02,Stanislaus,099,539301,53446,53073,5646,58719,687
2021-04-02,Sutter,101,95872,9151,9131,82,9213,106
2021-04-02,Tehama,103,63373,4811,4775,526,5301,52
2021-04-02,Trinity,105,12862,478,320,85,405,3
2021-04-02,Tulare,107,460477,49382,48306,8664,56970,818
2021-04-02,Tuolumne,109,53932,3914,3980,37,4017,57
2021-04-02,Ventura,111,848112,80044,79434,2899,82333,982
2021-04-02,Yolo,113,214977,13369,13381,248,13629,197
2021-04-02,Yuba,115,75493,5756,5709,113,5822,44
2021-04-01,Alameda,001,1643700,84243,83574,1819,85393,1216
2021-04-01,Alpine,003,1148,85,85,0,85,0
2021-04-01,Amador,005,37829,3591,3558,32,3590,45
2021-04-01,Butte,007,227075,11733,11328,1661,12989,193
2021-04-01,Calaveras,009,45235,2014,2006,12,2018,50
2021-04-01,Colusa,011,21464,1892,1890,276,2166,14
2021-04-01,Contra Costa,013,1133247,66116,65176,1151,66327,771
2021-04-01,Del Norte,015,27424,1215,1138,11,1149,6
2021-04-01,El Dorado,017,186661,9518,9393,622,10015,106
2021-04-01,Fresno,019,978130,100164,99317,8338,107655,1616
2021-04-01,Glenn,021,27897,2360,2322,534,2856,17
2021-04-01,Humboldt,023,135768,3472,3464,25,3489,35
2021-04-01,Imperial,025,180216,27712,27520,2621,30141,710
2021-04-01,Inyo,027,18085,1379,1374,10,1384,36
2021-04-01,Kern,029,883053,95576,94244,10349,104593,1233
2021-04-01,Kings,031,150075,22825,22560,1039,23599,239
2021-04-01,Lake,033,64148,3368,3337,8,3345,43
2021-04-01,Lassen,035,31185,5150,5132,103,5235,1
2021-04-01,Los Angeles,037,10098052,1189459,1181101,40590,1221691,23220
2021-04-01,Madera,039,155013,16181,16023,896,16919,230
2021-04-01,Marin,041,260295,13709,13635,219,13854,221
2021-04-01,Mariposa,043,17540,394,389,5,394,5
2021-04-01,Mendocino,045,87422,3766,3680,73,3753,45
2021-04-01,Merced,047,269075,29921,29820,1001,30821,425
2021-04-01,Modoc,049,8938,357,346,120,466,3
2021-04-01,Mono,051,14174,1236,1245,17,1262,3
2021-04-01,Monterey,053,433212,42618,42324,1793,44117,339
2021-04-01,Napa,055,140530,9488,9410,34,9444,78
2021-04-01,Nevada,057,99092,4379,4288,181,4469,68
2021-04-01,Orange,059,3164182,251637,249617,10833,260450,4742
2021-04-01,Placer,061,380077,21731,20909,1272,22181,274
2021-04-01,Plumas,063,18699,674,664,10,674,4
2021-04-01,Riverside,065,2383286,289908,283128,13741,296869,4193
2021-04-01,Sacramento,067,1510023,99516,97952,1434,99386,1521
2021-04-01,San Benito,069,59416,5892,5878,96,5974,61
2021-04-01,San Bernardino,071,2135413,289599,286086,8778,294864,4404
2021-04-01,San Diego,073,3302833,271845,270540,13643,284183,3555
2021-04-01,San Francisco,075,870044,35456,35386,1209,36595,488
2021-04-01,San Joaquin,077,732212,70064,68802,3223,72025,1262
2021-04-01,San Luis Obispo,079,281455,20588,20235,631,20866,252
2021-04-01,San Mateo,081,765935,40953,40454,432,40886,350
2021-04-01,Santa Barbara,083,443738,33486,33096,1099,34195,443
2021-04-01,Santa Clara,085,1922200,114598,114606,665,115271,1874
2021-04-01,Santa Cruz,087,273765,15873,15271,806,16077,202
2021-04-01,Shasta,089,179085,11364,11355,1365,12720,181
2021-04-01,Sierra,091,2930,55,50,12,62,0
2021-04-01,Siskiyou,093,43540,1574,1507,264,1771,7
2021-04-01,Solano,095,438530,31017,30850,414,31264,237
2021-04-01,Sonoma,097,501317,29172,29241,276,29517,311
2021-04-01,Stanislaus,099,539301,53383,52825,5640,58465,687
2021-04-01,Sutter,101,95872,9139,9105,82,9187,106
2021-04-01,Tehama,103,63373,4805,4764,523,5287,52
2021-04-01,Trinity,105,12862,478,319,85,404,3
2021-04-01,Tulare,107,460477,49359,48279,8654,56933,817
2021-04-01,Tuolumne,109,53932,3912,3978,37,4015,57
2021-04-01,Ventura,111,848112,80020,79369,2898,82267,977
2021-04-01,Yolo,113,214977,13356,13342,248,13590,197
2021-04-01,Yuba,115,75493,5751,5694,113,5807,44
2021-03-31,Alameda,001,1643700,84162,83475,1814,85289,1215
2021-03-31,Alpine,003,1148,85,85,0,85,0
2021-03-31,Amador,005,37829,3588,3556,32,3588,45
2021-03-31,Butte,007,227075,11723,11321,1658,12979,193
2021-03-31,Calaveras,009,45235,2012,2005,12,2017,50
2021-03-31,Colusa,011,21464,1892,1890,276,2166,14
2021-03-31,Contra Costa,013,1133247,66031,65109,1150,66259,769
2021-03-31,Del Norte,015,27424,1206,1129,11,1140,6
2021-03-31,El Dorado,017,186661,9501,9390,622,10012,106
2021-03-31,Fresno,019,978130,100071,99240,8321,107561,1616
2021-03-31,Glenn,021,27897,2356,2318,532,2850,17
2021-03-31,Humboldt,023,135768,3466,3460,25,3485,35
2021-03-31,Imperial,025,180216,27692,27506,2620,30126,710
2021-03-31,Inyo,027,18085,1376,1373,9,1382,35
2021-03-31,Kern,029,883053,95533,94205,10340,104545,1229
2021-03-31,Kings,031,150075,22822,22540,1039,23579,239
2021-03-31,Lake,033,64148,3364,3332,8,3340,43
2021-03-31,Lassen,035,31185,5146,5132,103,5235,1
2021-03-31,Los Angeles,037,10098052,1188991,1180538,40550,1221088,23171
2021-03-31,Madera,039,155013,16167,16015,895,16910,229
2021-03-31,Marin,041,260295,13698,13624,219,13843,221
2021-03-31,Mariposa,043,17540,394,389,5,394,5
2021-03-31,Mendocino,045,87422,3760,3675,73,3748,45
2021-03-31,Merced,047,269075,29892,29780,1001,30781,423
2021-03-31,Modoc,049,8938,357,346,120,466,3
2021-03-31,Mono,051,14174,1236,1245,17,1262,3
2021-03-31,Monterey,053,433212,42601,42309,1791,44100,338
2021-03-31,Napa,055,140530,9470,9401,34,9435,78
2021-03-31,Nevada,057,99092,4373,4283,181,4464,68
2021-03-31,Orange,059,3164182,251526,249518,10818,260336,4731
2021-03-31,Placer,061,380077,21681,20885,1265,22150,271
2021-03-31,Plumas,063,18699,673,663,10,673,4
2021-03-31,Riverside,065,2383286,289806,283006,13731,296737,4171
2021-03-31,Sacramento,067,1510023,99341,97760,1427,99187,1519
2021-03-31,San Benito,069,59416,5882,5875,96,5971,61
2021-03-31,San Bernardino,071,2135413,289504,285916,8775,294691,4356
2021-03-31,San Diego,073,3302833,271614,270288,13608,283896,3555
2021-03-31,San Francisco,075,870044,35411,35347,1208,36555,474
2021-03-31,San Joaquin,077,732212,69975,68685,3207,71892,1259
2021-03-31,San Luis Obispo,079,281455,20567,20215,630,20845,251
2021-03-31,San Mateo,081,765935,40923,40423,432,40855,350
2021-03-31,Santa Barbara,083,443738,33454,33052,1097,34149,443
2021-03-31,Santa Clara,085,1922200,114471,114499,665,115164,1874
2021-03-31,Santa Cruz,087,273765,15860,15295,805,16100,201
2021-03-31,Shasta,089,179085,11352,11327,1357,12684,179
2021-03-31,Sierra,091,2930,55,50,12,62,0
2021-03-31,Siskiyou,093,43540,1573,1505,264,1769,7
2021-03-31,Solano,095,438530,30971,30824,413,31237,235
2021-03-31,Sonoma,097,501317,29145,29216,276,29492,311
2021-03-31,Stanislaus,099,539301,53315,52782,5628,58410,687
2021-03-31,Sutter,101,95872,9128,9111,82,9193,106
2021-03-31,Tehama,103,63373,4800,4762,520,5282,52
2021-03-31,Trinity,105,12862,478,319,85,404,3
2021-03-31,Tulare,107,460477,49339,48261,8638,56899,816
2021-03-31,Tuolumne,109,53932,3911,3976,37,4013,57
2021-03-31,Ventura,111,848112,79988,79326,2894,82220,969
2021-03-31,Yolo,113,214977,13339,13359,247,13606,197
2021-03-31,Yuba,115,75493,5744,5686,113,5799,44
2021-03-30,Alameda,001,1643700,84062,83395,1811,85206,1211
2021-03-30,Alpine,003,1148,85,85,0,85,0
2021-03-30,Amador,005,37829,3585,3551,32,3583,45
2021-03-30,Butte,007,227075,11711,11296,1655,12951,193
2021-03-30,Calaveras,009,45235,2008,1997,12,2009,50
2021-03-30,Colusa,011,21464,1891,1890,275,2165,14
2021-03-30,Contra Costa,013,1133247,65942,65041,1148,66189,767
2021-03-30,Del Norte,015,27424,1198,1118,10,1128,6
2021-03-30,El Dorado,017,186661,9482,9381,619,10000,105
2021-03-30,Fresno,019,978130,100006,99156,8308,107464,1609
2021-03-30,Glenn,021,27897,2356,2310,531,2841,17
2021-03-30,Humboldt,023,135768,3464,3461,25,3486,35
2021-03-30,Imperial,025,180216,27663,27471,2618,30089,706
2021-03-30,Inyo,027,18085,1376,1374,9,1383,35
2021-03-30,Kern,029,883053,95491,94151,10331,104482,1221
2021-03-30,Kings,031,150075,22818,22530,1037,23567,238
2021-03-30,Lake,033,64148,3358,3330,8,3338,43
2021-03-30,Lassen,035,31185,5146,5132,103,5235,1
2021-03-30,Los Angeles,037,10098052,1188494,1180044,40528,1220572,23136
2021-03-30,Madera,039,155013,16157,16003,891,16894,229
2021-03-30,Marin,041,260295,13689,13611,211,13822,221
2021-03-30,Mariposa,043,17540,394,388,5,393,5
2021-03-30,Mendocino,045,87422,3758,3670,73,3743,45
2021-03-30,Merced,047,269075,29856,29731,1001,30732,423
2021-03-30,Modoc,049,8938,356,346,120,466,3
2021-03-30,Mono,051,14174,1235,1245,17,1262,3
2021-03-30,Monterey,053,433212,42575,42308,1788,44096,338
2021-03-30,Napa,055,140530,9455,9391,34,9425,78
2021-03-30,Nevada,057,99092,4361,4266,180,4446,68
2021-03-30,Orange,059,3164182,251397,249412,10791,260203,4727
2021-03-30,Placer,061,380077,21641,20866,1259,22125,271
2021-03-30,Plumas,063,18699,673,661,10,671,4
2021-03-30,Riverside,065,2383286,289681,282930,13722,296652,4154
2021-03-30,Sacramento,067,1510023,99204,97718,1423,99141,1516
2021-03-30,San Benito,069,59416,5876,5870,96,5966,61
2021-03-30,San Bernardino,071,2135413,289396,285758,8766,294524,4343
2021-03-30,San Diego,073,3302833,271375,269998,13570,283568,3555
2021-03-30,San Francisco,075,870044,35361,35325,1207,36532,474
2021-03-30,San Joaquin,077,732212,69887,68613,3197,71810,1232
2021-03-30,San Luis Obispo,079,281455,20547,20194,630,20824,251
2021-03-30,San Mateo,081,765935,40878,40377,432,40809,349
2021-03-30,Santa Barbara,083,443738,33429,33016,1097,34113,441
2021-03-30,Santa Clara,085,1922200,114348,114413,664,115077,1873
2021-03-30,Santa Cruz,087,273765,15854,15278,805,16083,201
2021-03-30,Shasta,089,179085,11344,11316,1356,12672,184
2021-03-30,Sierra,091,2930,55,50,12,62,0
2021-03-30,Siskiyou,093,43540,1572,1501,264,1765,7
2021-03-30,Solano,095,438530,30941,30802,412,31214,232
2021-03-30,Sonoma,097,501317,29113,29198,276,29474,311
2021-03-30,Stanislaus,099,539301,53237,52690,5620,58310,677
2021-03-30,Sutter,101,95872,9124,9107,81,9188,106
2021-03-30,Tehama,103,63373,4791,4748,519,5267,52
2021-03-30,Trinity,105,12862,478,316,85,401,3
2021-03-30,Tulare,107,460477,49324,48249,8629,56878,815
2021-03-30,Tuolumne,109,53932,3906,3972,37,4009,57
2021-03-30,Ventura,111,848112,79944,79282,2891,82173,958
2021-03-30,Yolo,113,214977,13327,13353,247,13600,195
2021-03-30,Yuba,115,75493,5733,5679,107,5786,42
2021-03-29,Alameda,001,1643700,83961,83338,1809,85147,1211
2021-03-29,Alpine,003,1148,85,85,0,85,0
2021-03-29,Amador,005,37829,3579,3549,32,3581,45
2021-03-29,Butte,007,227075,11702,11291,1652,12943,191
2021-03-29,Calaveras,009,45235,2006,1998,12,2010,50
2021-03-29,Colusa,011,21464,1891,1889,274,2163,14
2021-03-29,Contra Costa,013,1133247,65873,64971,1147,66118,767
2021-03-29,Del Norte,015,27424,1193,1116,9,1125,6
2021-03-29,El Dorado,017,186661,9462,9374,613,9987,105
2021-03-29,Fresno,019,978130,99923,99085,8293,107378,1606
2021-03-29,Glenn,021,27897,2349,2310,531,2841,17
2021-03-29,Humboldt,023,135768,3459,3459,25,3484,34
2021-03-29,Imperial,025,180216,27642,27442,2616,30058,704
2021-03-29,Inyo,027,18085,1376,1372,9,1381,35
2021-03-29,Kern,029,883053,95444,94098,10311,104409,1220
2021-03-29,Kings,031,150075,22806,22522,1036,23558,238
2021-03-29,Lake,033,64148,3355,3325,8,3333,43
2021-03-29,Lassen,035,31185,5146,5131,103,5234,1
2021-03-29,Los Angeles,037,10098052,1188000,1179736,40487,1220223,23108
2021-03-29,Madera,039,155013,16137,15987,889,16876,210
2021-03-29,Marin,041,260295,13677,13600,207,13807,220
2021-03-29,Mariposa,043,17540,393,388,5,393,5
2021-03-29,Mendocino,045,87422,3755,3667,73,3740,45
2021-03-29,Merced,047,269075,29832,29699,1001,30700,422
2021-03-29,Modoc,049,8938,355,344,120,464,3
2021-03-29,Mono,051,14174,1234,1243,17,1260,3
2021-03-29,Monterey,053,433212,42559,42305,1783,44088,337
2021-03-29,Napa,055,140530,9439,9379,34,9413,78
2021-03-29,Nevada,057,99092,4354,4258,180,4438,68
2021-03-29,Orange,059,3164182,251285,249295,10779,260074,4713
2021-03-29,Placer,061,380077,21606,20827,1252,22079,267
2021-03-29,Plumas,063,18699,672,660,10,670,4
2021-03-29,Riverside,065,2383286,289578,282867,13721,296588,4133
2021-03-29,Sacramento,067,1510023,99010,97577,1415,98992,1514
2021-03-29,San Benito,069,59416,5869,5865,96,5961,61
2021-03-29,San Bernardino,071,2135413,289299,285615,8762,294377,4335
2021-03-29,San Diego,073,3302833,271109,269771,13544,283315,3547
2021-03-29,San Francisco,075,870044,35326,35291,1204,36495,474
2021-03-29,San Joaquin,077,732212,69801,68537,3184,71721,1211
2021-03-29,San Luis Obispo,079,281455,20512,20176,629,20805,250
2021-03-29,San Mateo,081,765935,40836,40357,431,40788,348
2021-03-29,Santa Barbara,083,443738,33395,32983,1096,34079,439
2021-03-29,Santa Clara,085,1922200,114240,114335,659,114994,1871
2021-03-29,Santa Cruz,087,273765,15843,15249,804,16053,201
2021-03-29,Shasta,089,179085,11326,11313,1354,12667,183
2021-03-29,Sierra,091,2930,55,50,12,62,0
2021-03-29,Siskiyou,093,43540,1570,1497,263,1760,6
2021-03-29,Solano,095,438530,30902,30762,410,31172,232
2021-03-29,Sonoma,097,501317,29090,29184,273,29457,310
2021-03-29,Stanislaus,099,539301,53154,52614,5612,58226,677
2021-03-29,Sutter,101,95872,9117,9105,81,9186,106
2021-03-29,Tehama,103,63373,4783,4742,518,5260,52
2021-03-29,Trinity,105,12862,478,314,85,399,3
2021-03-29,Tulare,107,460477,49296,48226,8618,56844,815
2021-03-29,Tuolumne,109,53932,3904,3969,37,4006,57
2021-03-29,Ventura,111,848112,79902,79252,2891,82143,956
2021-03-29,Yolo,113,214977,13309,13346,247,13593,195
2021-03-29,Yuba,115,75493,5726,5671,106,5777,42
2021-03-28,Alameda,001,1643700,83840,83239,1807,85046,1212
2021-03-28,Alpine,003,1148,85,85,0,85,0
2021-03-28,Amador,005,37829,3575,3541,32,3573,45
2021-03-28,Butte,007,227075,11689,11285,1650,12935,191
2021-03-28,Calaveras,009,45235,2004,1995,12,2007,50
2021-03-28,Colusa,011,21464,1890,1889,274,2163,14
2021-03-28,Contra Costa,013,1133247,65799,64878,1143,66021,767
2021-03-28,Del Norte,015,27424,1186,1107,7,1114,6
2021-03-28,El Dorado,017,186661,9447,9371,611,9982,105
2021-03-28,Fresno,019,978130,99841,99004,8281,107285,1606
2021-03-28,Glenn,021,27897,2345,2309,529,2838,17
2021-03-28,Humboldt,023,135768,3456,3452,24,3476,34
2021-03-28,Imperial,025,180216,27615,27426,2613,30039,704
2021-03-28,Inyo,027,18085,1375,1372,9,1381,35
2021-03-28,Kern,029,883053,95399,94084,10300,104384,1219
2021-03-28,Kings,031,150075,22801,22514,1033,23547,238
2021-03-28,Lake,033,64148,3350,3320,8,3328,43
2021-03-28,Lassen,035,31185,5146,5131,102,5233,1
2021-03-28,Los Angeles,037,10098052,1187450,1179316,40428,1219744,23101
2021-03-28,Madera,039,155013,16122,15973,888,16861,210
2021-03-28,Marin,041,260295,13664,13594,205,13799,221
2021-03-28,Mariposa,043,17540,393,388,5,393,5
2021-03-28,Mendocino,045,87422,3753,3666,73,3739,45
2021-03-28,Merced,047,269075,29775,29679,1001,30680,422
2021-03-28,Modoc,049,8938,355,344,120,464,3
2021-03-28,Mono,051,14174,1233,1242,17,1259,3
2021-03-28,Monterey,053,433212,42536,42294,1779,44073,337
2021-03-28,Napa,055,140530,9425,9368,34,9402,78
2021-03-28,Nevada,057,99092,4340,4239,180,4419,68
2021-03-28,Orange,059,3164182,251130,249238,10769,260007,4713
2021-03-28,Placer,061,380077,21562,20796,1246,22042,267
2021-03-28,Plumas,063,18699,670,657,10,667,4
2021-03-28,Riverside,065,2383286,289464,282811,13712,296523,4132
2021-03-28,Sacramento,067,1510023,98836,97425,1409,98834,1514
2021-03-28,San Benito,069,59416,5864,5862,96,5958,61
2021-03-28,San Bernardino,071,2135413,289180,285570,8753,294323,4332
2021-03-28,San Diego,073,3302833,270833,269476,13515,282991,3547
2021-03-28,San Francisco,075,870044,35280,35286,1200,36486,474
2021-03-28,San Joaquin,077,732212,69676,68459,3165,71624,1211
2021-03-28,San Luis Obispo,079,281455,20477,20172,626,20798,250
2021-03-28,San Mateo,081,765935,40791,40305,431,40736,348
2021-03-28,Santa Barbara,083,443738,33353,32953,1095,34048,439
2021-03-28,Santa Clara,085,1922200,114140,114232,655,114887,1871
2021-03-28,Santa Cruz,087,273765,15828,15238,803,16041,201
2021-03-28,Shasta,089,179085,11300,11308,1343,12651,183
2021-03-28,Sierra,091,2930,55,50,12,62,0
2021-03-28,Siskiyou,093,43540,1570,1497,262,1759,6
2021-03-28,Solano,095,438530,30865,30719,408,31127,232
2021-03-28,Sonoma,097,501317,29054,29161,271,29432,310
2021-03-28,Stanislaus,099,539301,53066,52567,5597,58164,678
2021-03-28,Sutter,101,95872,9108,9094,81,9175,106
2021-03-28,Tehama,103,63373,4773,4740,516,5256,52
2021-03-28,Trinity,105,12862,476,314,84,398,3
2021-03-28,Tulare,107,460477,49267,48218,8612,56830,815
2021-03-28,Tuolumne,109,53932,3901,3969,36,4005,57
2021-03-28,Ventura,111,848112,79851,79222,2886,82108,956
2021-03-28,Yolo,113,214977,13292,13325,246,13571,194
2021-03-28,Yuba,115,75493,5722,5662,106,5768,42
2021-03-27,Alameda,001,1643700,83769,83169,1803,84972,1211
2021-03-27,Alpine,003,1148,85,85,0,85,0
2021-03-27,Amador,005,37829,3570,3538,32,3570,45
2021-03-27,Butte,007,227075,11682,11278,1649,12927,191
2021-03-27,Calaveras,009,45235,2001,1992,12,2004,50
2021-03-27,Colusa,011,21464,1890,1889,274,2163,14
2021-03-27,Contra Costa,013,1133247,65729,64804,1140,65944,767
2021-03-27,Del Norte,015,27424,1176,1104,7,1111,6
2021-03-27,El Dorado,017,186661,9433,9367,611,9978,105
2021-03-27,Fresno,019,978130,99788,98901,8275,107176,1606
2021-03-27,Glenn,021,27897,2344,2308,529,2837,17
2021-03-27,Humboldt,023,135768,3451,3442,24,3466,34
2021-03-27,Imperial,025,180216,27603,27406,2610,30016,704
2021-03-27,Inyo,027,18085,1373,1372,9,1381,35
2021-03-27,Kern,029,883053,95379,94041,10288,104329,1217
2021-03-27,Kings,031,150075,22798,22502,1033,23535,238
2021-03-27,Lake,033,64148,3348,3317,8,3325,43
2021-03-27,Lassen,035,31185,5146,5129,102,5231,1
2021-03-27,Los Angeles,037,10098052,1187135,1178831,40401,1219232,23103
2021-03-27,Madera,039,155013,16115,15968,886,16854,210
2021-03-27,Marin,041,260295,13659,13579,205,13784,222
2021-03-27,Mariposa,043,17540,393,386,5,391,5
2021-03-27,Mendocino,045,87422,3751,3666,73,3739,45
2021-03-27,Merced,047,269075,29742,29647,999,30646,422
2021-03-27,Modoc,049,8938,355,344,120,464,3
2021-03-27,Mono,051,14174,1231,1241,17,1258,3
2021-03-27,Monterey,053,433212,42526,42271,1779,44050,337
2021-03-27,Napa,055,140530,9413,9360,34,9394,78
2021-03-27,Nevada,057,99092,4330,4231,180,4411,68
2021-03-27,Orange,059,3164182,251037,249160,10753,259913,4698
2021-03-27,Placer,061,380077,21542,20717,1239,21956,267
2021-03-27,Plumas,063,18699,669,655,10,665,4
2021-03-27,Riverside,065,2383286,289402,282707,13704,296411,4132
2021-03-27,Sacramento,067,1510023,98746,97247,1407,98654,1513
2021-03-27,San Benito,069,59416,5862,5862,94,5956,61
2021-03-27,San Bernardino,071,2135413,289117,285480,8751,294231,4325
2021-03-27,San Diego,073,3302833,270662,269271,13493,282764,3540
2021-03-27,San Francisco,075,870044,35257,35244,1198,36442,474
2021-03-27,San Joaquin,077,732212,69616,68365,3157,71522,1211
2021-03-27,San Luis Obispo,079,281455,20466,20153,623,20776,250
2021-03-27,San Mateo,081,765935,40768,40264,431,40695,348
2021-03-27,Santa Barbara,083,443738,33330,32921,1095,34016,439
2021-03-27,Santa Clara,085,1922200,114044,114124,653,114777,1871
2021-03-27,Santa Cruz,087,273765,15822,15215,803,16018,201
2021-03-27,Shasta,089,179085,11289,11288,1341,12629,183
2021-03-27,Sierra,091,2930,55,50,12,62,0
2021-03-27,Siskiyou,093,43540,1570,1497,262,1759,6
2021-03-27,Solano,095,438530,30837,30669,407,31076,232
2021-03-27,Sonoma,097,501317,29039,29133,269,29402,310
2021-03-27,Stanislaus,099,539301,53001,52497,5589,58086,678
2021-03-27,Sutter,101,95872,9101,9093,81,9174,106
2021-03-27,Tehama,103,63373,4767,4738,514,5252,52
2021-03-27,Trinity,105,12862,476,313,84,397,3
2021-03-27,Tulare,107,460477,49251,48203,8604,56807,813
2021-03-27,Tuolumne,109,53932,3898,3968,36,4004,57
2021-03-27,Ventura,111,848112,79824,79184,2884,82068,956
2021-03-27,Yolo,113,214977,13287,13317,245,13562,194
2021-03-27,Yuba,115,75493,5720,5657,106,5763,42
2021-03-26,Alameda,001,1643700,83707,83043,1801,84844,1208
2021-03-26,Alpine,003,1148,85,85,0,85,0
2021-03-26,Amador,005,37829,3565,3532,32,3564,45
2021-03-26,Butte,007,227075,11672,11278,1649,12927,191
2021-03-26,Calaveras,009,45235,1999,1989,12,2001,50
2021-03-26,Colusa,011,21464,1890,1889,274,2163,14
2021-03-26,Contra Costa,013,1133247,65669,64699,1137,65836,761
2021-03-26,Del Norte,015,27424,1173,1101,7,1108,6
2021-03-26,El Dorado,017,186661,9428,9353,611,9964,105
2021-03-26,Fresno,019,978130,99726,98731,8265,106996,1601
2021-03-26,Glenn,021,27897,2344,2307,528,2835,17
2021-03-26,Humboldt,023,135768,3449,3431,24,3455,34
2021-03-26,Imperial,025,180216,27579,27374,2610,29984,701
2021-03-26,Inyo,027,18085,1372,1369,9,1378,35
2021-03-26,Kern,029,883053,95353,93949,10282,104231,1211
2021-03-26,Kings,031,150075,22790,22493,1031,23524,239
2021-03-26,Lake,033,64148,3347,3314,8,3322,43
2021-03-26,Lassen,035,31185,5145,5131,102,5233,1
2021-03-26,Los Angeles,037,10098052,1186798,1178213,40388,1218601,23080
2021-03-26,Madera,039,155013,16105,15952,886,16838,210
2021-03-26,Marin,041,260295,13653,13553,200,13753,221
2021-03-26,Mariposa,043,17540,393,386,5,391,5
2021-03-26,Mendocino,045,87422,3750,3664,73,3737,45
2021-03-26,Merced,047,269075,29719,29613,997,30610,419
2021-03-26,Modoc,049,8938,355,344,120,464,3
2021-03-26,Mono,051,14174,1230,1236,17,1253,3
2021-03-26,Monterey,053,433212,42513,42241,1775,44016,338
2021-03-26,Napa,055,140530,9403,9349,34,9383,78
2021-03-26,Nevada,057,99092,4310,4222,180,4402,83
2021-03-26,Orange,059,3164182,250974,248995,10739,259734,4671
2021-03-26,Placer,061,380077,21516,20679,1238,21917,259
2021-03-26,Plumas,063,18699,668,654,10,664,4
2021-03-26,Riverside,065,2383286,289324,282602,13698,296300,4109
2021-03-26,Sacramento,067,1510023,98646,97040,1402,98442,1509
2021-03-26,San Benito,069,59416,5859,5855,94,5949,61
2021-03-26,San Bernardino,071,2135413,289061,285313,8749,294062,4288
2021-03-26,San Diego,073,3302833,270484,269045,13467,282512,3525
2021-03-26,San Francisco,075,870044,35231,35186,1198,36384,472
2021-03-26,San Joaquin,077,732212,69553,68249,3153,71402,1202
2021-03-26,San Luis Obispo,079,281455,20453,20118,623,20741,250
2021-03-26,San Mateo,081,765935,40733,40199,431,40630,348
2021-03-26,Santa Barbara,083,443738,33300,32895,1094,33989,439
2021-03-26,Santa Clara,085,1922200,113946,113959,652,114611,1868
2021-03-26,Santa Cruz,087,273765,15807,15199,802,16001,201
2021-03-26,Shasta,089,179085,11280,11276,1335,12611,182
2021-03-26,Sierra,091,2930,55,50,12,62,0
2021-03-26,Siskiyou,093,43540,1570,1493,261,1754,6
2021-03-26,Solano,095,438530,30812,30640,407,31047,205
2021-03-26,Sonoma,097,501317,29023,29101,266,29367,310
2021-03-26,Stanislaus,099,539301,52933,52420,5585,58005,678
2021-03-26,Sutter,101,95872,9098,9082,81,9163,104
2021-03-26,Tehama,103,63373,4766,4722,513,5235,51
2021-03-26,Trinity,105,12862,476,311,84,395,3
2021-03-26,Tulare,107,460477,49236,48179,8596,56775,813
2021-03-26,Tuolumne,109,53932,3897,3965,36,4001,57
2021-03-26,Ventura,111,848112,79790,79122,2882,82004,953
2021-03-26,Yolo,113,214977,13280,13299,243,13542,194
2021-03-26,Yuba,115,75493,5710,5653,106,5759,42
2021-03-25,Alameda,001,1643700,83612,82945,1799,84744,1206
2021-03-25,Alpine,003,1148,85,84,0,84,0
2021-03-25,Amador,005,37829,3563,3530,32,3562,45
2021-03-25,Butte,007,227075,11662,11270,1649,12919,188
2021-03-25,Calaveras,009,45235,1998,1982,12,1994,50
2021-03-25,Colusa,011,21464,1890,1888,274,2162,14
2021-03-25,Contra Costa,013,1133247,65602,64606,1133,65739,757
2021-03-25,Del Norte,015,27424,1167,1095,7,1102,6
2021-03-25,El Dorado,017,186661,9418,9331,611,9942,105
2021-03-25,Fresno,019,978130,99608,98602,8252,106854,1593
2021-03-25,Glenn,021,27897,2343,2302,527,2829,17
2021-03-25,Humboldt,023,135768,3444,3423,24,3447,34
2021-03-25,Imperial,025,180216,27563,27352,2609,29961,699
2021-03-25,Inyo,027,18085,1372,1369,9,1378,35
2021-03-25,Kern,029,883053,95321,93857,10277,104134,1206
2021-03-25,Kings,031,150075,22780,22472,1031,23503,237
2021-03-25,Lake,033,64148,3342,3312,8,3320,43
2021-03-25,Lassen,035,31185,5145,5129,102,5231,1
2021-03-25,Los Angeles,037,10098052,1186365,1177490,40353,1217843,23051
2021-03-25,Madera,039,155013,16086,15937,884,16821,210
2021-03-25,Marin,041,260295,13643,13538,197,13735,219
2021-03-25,Mariposa,043,17540,393,386,5,391,5
2021-03-25,Mendocino,045,87422,3749,3664,73,3737,45
2021-03-25,Merced,047,269075,29685,29576,989,30565,416
2021-03-25,Modoc,049,8938,355,343,120,463,3
2021-03-25,Mono,051,14174,1230,1235,17,1252,3
2021-03-25,Monterey,053,433212,42492,42220,1770,43990,336
2021-03-25,Napa,055,140530,9384,9321,34,9355,78
2021-03-25,Nevada,057,99092,4292,4202,178,4380,84
2021-03-25,Orange,059,3164182,250858,248871,10719,259590,4655
2021-03-25,Placer,061,380077,21475,20639,1231,21870,252
2021-03-25,Plumas,063,18699,668,654,10,664,4
2021-03-25,Riverside,065,2383286,289227,282492,13687,296179,4078
2021-03-25,Sacramento,067,1510023,98501,96823,1399,98222,1505
2021-03-25,San Benito,069,59416,5856,5850,94,5944,61
2021-03-25,San Bernardino,071,2135413,288979,285134,8744,293878,4222
2021-03-25,San Diego,073,3302833,270256,268623,13436,282059,3520
2021-03-25,San Francisco,075,870044,35192,35154,1196,36350,468
2021-03-25,San Joaquin,077,732212,69456,68089,3114,71203,1196
2021-03-25,San Luis Obispo,079,281455,20435,20076,623,20699,250
2021-03-25,San Mateo,081,765935,40693,40147,431,40578,348
2021-03-25,Santa Barbara,083,443738,33273,32857,1094,33951,439
2021-03-25,Santa Clara,085,1922200,113842,113877,650,114527,1868
2021-03-25,Santa Cruz,087,273765,15786,15170,802,15972,201
2021-03-25,Shasta,089,179085,11263,11262,1332,12594,181
2021-03-25,Sierra,091,2930,55,50,12,62,0
2021-03-25,Siskiyou,093,43540,1568,1491,260,1751,6
2021-03-25,Solano,095,438530,30751,30583,405,30988,193
2021-03-25,Sonoma,097,501317,28988,29060,262,29322,310
2021-03-25,Stanislaus,099,539301,52866,52321,5578,57899,678
2021-03-25,Sutter,101,95872,9089,9069,81,9150,104
2021-03-25,Tehama,103,63373,4764,4719,512,5231,52
2021-03-25,Trinity,105,12862,476,310,84,394,3
2021-03-25,Tulare,107,460477,49209,48148,8583,56731,811
2021-03-25,Tuolumne,109,53932,3896,3962,36,3998,57
2021-03-25,Ventura,111,848112,79749,79045,2878,81923,952
2021-03-25,Yolo,113,214977,13274,13287,243,13530,194
2021-03-25,Yuba,115,75493,5704,5647,100,5747,42
2021-03-24,Alameda,001,1643700,83518,82871,1796,84667,1199
2021-03-24,Alpine,003,1148,85,84,0,84,0
2021-03-24,Amador,005,37829,3557,3529,32,3561,45
2021-03-24,Butte,007,227075,11652,11252,1645,12897,187
2021-03-24,Calaveras,009,45235,1995,1975,12,1987,50
2021-03-24,Colusa,011,21464,1890,1886,274,2160,14
2021-03-24,Contra Costa,013,1133247,65522,64539,1132,65671,755
2021-03-24,Del Norte,015,27424,1162,1087,7,1094,6
2021-03-24,El Dorado,017,186661,9412,9319,610,9929,105
2021-03-24,Fresno,019,978130,99518,98437,8237,106674,1585
2021-03-24,Glenn,021,27897,2342,2297,526,2823,17
2021-03-24,Humboldt,023,135768,3441,3414,24,3438,34
2021-03-24,Imperial,025,180216,27554,27325,2609,29934,699
2021-03-24,Inyo,027,18085,1372,1368,9,1377,35
2021-03-24,Kern,029,883053,95273,93800,10268,104068,1198
2021-03-24,Kings,031,150075,22765,22456,1029,23485,237
2021-03-24,Lake,033,64148,3338,3307,8,3315,43
2021-03-24,Lassen,035,31185,5143,5130,101,5231,1
2021-03-24,Los Angeles,037,10098052,1185887,1177015,40318,1217333,22993
2021-03-24,Madera,039,155013,16077,15918,883,16801,210
2021-03-24,Marin,041,260295,13629,13526,195,13721,219
2021-03-24,Mariposa,043,17540,393,384,5,389,5
2021-03-24,Mendocino,045,87422,3746,3660,73,3733,45
2021-03-24,Merced,047,269075,29644,29525,989,30514,415
2021-03-24,Modoc,049,8938,354,341,120,461,3
2021-03-24,Mono,051,14174,1229,1243,17,1260,3
2021-03-24,Monterey,053,433212,42470,42201,1767,43968,335
2021-03-24,Napa,055,140530,9364,9310,34,9344,78
2021-03-24,Nevada,057,99092,4278,4191,177,4368,85
2021-03-24,Orange,059,3164182,250744,248775,10701,259476,4638
2021-03-24,Placer,061,380077,21445,20606,1223,21829,250
2021-03-24,Plumas,063,18699,666,652,10,662,4
2021-03-24,Riverside,065,2383286,289143,282410,13684,296094,4058
2021-03-24,Sacramento,067,1510023,98326,96628,1387,98015,1500
2021-03-24,San Benito,069,59416,5855,5847,94,5941,61
2021-03-24,San Bernardino,071,2135413,288893,284983,8742,293725,4170
2021-03-24,San Diego,073,3302833,270041,268413,13408,281821,3509
2021-03-24,San Francisco,075,870044,35164,35103,1193,36296,462
2021-03-24,San Joaquin,077,732212,69385,67978,3102,71080,1196
2021-03-24,San Luis Obispo,079,281455,20405,20021,622,20643,250
2021-03-24,San Mateo,081,765935,40643,40083,431,40514,348
2021-03-24,Santa Barbara,083,443738,33245,32810,1094,33904,438
2021-03-24,Santa Clara,085,1922200,113726,113757,647,114404,1851
2021-03-24,Santa Cruz,087,273765,15772,15138,801,15939,202
2021-03-24,Shasta,089,179085,11244,11243,1330,12573,181
2021-03-24,Sierra,091,2930,55,50,12,62,0
2021-03-24,Siskiyou,093,43540,1566,1490,260,1750,6
2021-03-24,Solano,095,438530,30714,30552,404,30956,178
2021-03-24,Sonoma,097,501317,28968,29034,258,29292,310
2021-03-24,Stanislaus,099,539301,52790,52259,5569,57828,677
2021-03-24,Sutter,101,95872,9073,9049,81,9130,104
2021-03-24,Tehama,103,63373,4758,4719,511,5230,49
2021-03-24,Trinity,105,12862,475,310,84,394,3
2021-03-24,Tulare,107,460477,49198,48109,8570,56679,808
2021-03-24,Tuolumne,109,53932,3895,3961,36,3997,57
2021-03-24,Ventura,111,848112,79697,78993,2871,81864,944
2021-03-24,Yolo,113,214977,13263,13269,243,13512,194
2021-03-24,Yuba,115,75493,5698,5634,97,5731,42
2021-03-23,Alameda,001,1643700,83416,82799,1792,84591,1190
2021-03-23,Alpine,003,1148,85,84,0,84,0
2021-03-23,Amador,005,37829,3551,3524,32,3556,45
2021-03-23,Butte,007,227075,11640,11227,1644,12871,187
2021-03-23,Calaveras,009,45235,1993,1971,12,1983,50
2021-03-23,Colusa,011,21464,1888,1885,273,2158,14
2021-03-23,Contra Costa,013,1133247,65423,64491,1131,65622,750
2021-03-23,Del Norte,015,27424,1157,1082,7,1089,6
2021-03-23,El Dorado,017,186661,9402,9318,608,9926,105
2021-03-23,Fresno,019,978130,99405,98362,8211,106573,1575
2021-03-23,Glenn,021,27897,2337,2293,524,2817,17
2021-03-23,Humboldt,023,135768,3432,3405,24,3429,34
2021-03-23,Imperial,025,180216,27546,27320,2609,29929,699
2021-03-23,Inyo,027,18085,1370,1364,9,1373,35
2021-03-23,Kern,029,883053,95166,93728,10261,103989,1191
2021-03-23,Kings,031,150075,22754,22439,1027,23466,237
2021-03-23,Lake,033,64148,3336,3294,8,3302,43
2021-03-23,Lassen,035,31185,5143,5130,101,5231,1
2021-03-23,Los Angeles,037,10098052,1185367,1176572,40280,1216852,22904
2021-03-23,Madera,039,155013,16061,15908,882,16790,210
2021-03-23,Marin,041,260295,13606,13514,193,13707,221
2021-03-23,Mariposa,043,17540,392,384,5,389,5
2021-03-23,Mendocino,045,87422,3744,3652,73,3725,45
2021-03-23,Merced,047,269075,29611,29485,989,30474,415
2021-03-23,Modoc,049,8938,353,342,120,462,3
2021-03-23,Mono,051,14174,1228,1263,17,1280,3
2021-03-23,Monterey,053,433212,42459,42180,1765,43945,335
2021-03-23,Napa,055,140530,9339,9299,34,9333,78
2021-03-23,Nevada,057,99092,4259,4179,176,4355,89
2021-03-23,Orange,059,3164182,250618,248661,10683,259344,4626
2021-03-23,Placer,061,380077,21410,20567,1219,21786,248
2021-03-23,Plumas,063,18699,666,652,10,662,4
2021-03-23,Riverside,065,2383286,289043,282317,13677,295994,4035
2021-03-23,Sacramento,067,1510023,98134,96521,1381,97902,1496
2021-03-23,San Benito,069,59416,5850,5845,93,5938,61
2021-03-23,San Bernardino,071,2135413,288809,284875,8734,293609,4134
2021-03-23,San Diego,073,3302833,269796,268156,13376,281532,3498
2021-03-23,San Francisco,075,870044,35106,35071,1187,36258,462
2021-03-23,San Joaquin,077,732212,69289,67903,3084,70987,1182
2021-03-23,San Luis Obispo,079,281455,20364,20009,621,20630,250
2021-03-23,San Mateo,081,765935,40587,40032,430,40462,348
2021-03-23,Santa Barbara,083,443738,33207,32771,1093,33864,438
2021-03-23,Santa Clara,085,1922200,113610,113645,644,114289,1848
2021-03-23,Santa Cruz,087,273765,15757,15106,801,15907,201
2021-03-23,Shasta,089,179085,11231,11234,1329,12563,175
2021-03-23,Sierra,091,2930,55,50,12,62,0
2021-03-23,Siskiyou,093,43540,1561,1485,258,1743,6
2021-03-23,Solano,095,438530,30673,30524,403,30927,178
2021-03-23,Sonoma,097,501317,28931,29020,257,29277,310
2021-03-23,Stanislaus,099,539301,52691,52148,5561,57709,677
2021-03-23,Sutter,101,95872,9065,9039,81,9120,104
2021-03-23,Tehama,103,63373,4749,4707,510,5217,46
2021-03-23,Trinity,105,12862,475,310,84,394,3
2021-03-23,Tulare,107,460477,49171,48095,8554,56649,808
2021-03-23,Tuolumne,109,53932,3892,3957,36,3993,57
2021-03-23,Ventura,111,848112,79636,78930,2868,81798,932
2021-03-23,Yolo,113,214977,13252,13255,243,13498,194
2021-03-23,Yuba,115,75493,5693,5628,97,5725,42
2021-03-22,Alameda,001,1643700,83323,82748,1786,84534,1189
2021-03-22,Alpine,003,1148,84,83,0,83,0
2021-03-22,Amador,005,37829,3543,3522,32,3554,44
2021-03-22,Butte,007,227075,11631,11211,1642,12853,185
2021-03-22,Calaveras,009,45235,1989,1963,12,1975,49
2021-03-22,Colusa,011,21464,1886,1885,273,2158,13
2021-03-22,Contra Costa,013,1133247,65328,64432,1129,65561,740
2021-03-22,Del Norte,015,27424,1151,1082,7,1089,6
2021-03-22,El Dorado,017,186661,9386,9310,605,9915,105
2021-03-22,Fresno,019,978130,99307,98276,8198,106474,1556
2021-03-22,Glenn,021,27897,2329,2291,524,2815,17
2021-03-22,Humboldt,023,135768,3427,3403,24,3427,34
2021-03-22,Imperial,025,180216,27531,27302,2605,29907,699
2021-03-22,Inyo,027,18085,1367,1363,9,1372,35
2021-03-22,Kern,029,883053,95095,93675,10244,103919,1178
2021-03-22,Kings,031,150075,22741,22433,1022,23455,236
2021-03-22,Lake,033,64148,3335,3290,8,3298,43
2021-03-22,Lassen,035,31185,5141,5129,101,5230,1
2021-03-22,Los Angeles,037,10098052,1184855,1176205,40247,1216452,22843
2021-03-22,Madera,039,155013,16046,15904,882,16786,210
2021-03-22,Marin,041,260295,13597,13501,192,13693,221
2021-03-22,Mariposa,043,17540,391,381,5,386,5
2021-03-22,Mendocino,045,87422,3742,3653,73,3726,45
2021-03-22,Merced,047,269075,29568,29468,986,30454,413
2021-03-22,Modoc,049,8938,351,342,120,462,3
2021-03-22,Mono,051,14174,1223,1263,17,1280,3
2021-03-22,Monterey,053,433212,42443,42161,1763,43924,335
2021-03-22,Napa,055,140530,9328,9288,34,9322,77
2021-03-22,Nevada,057,99092,4248,4174,172,4346,89
2021-03-22,Orange,059,3164182,250467,248517,10649,259166,4599
2021-03-22,Placer,061,380077,21375,20543,1214,21757,242
2021-03-22,Plumas,063,18699,666,652,10,662,4
2021-03-22,Riverside,065,2383286,288943,282242,13666,295908,4009
2021-03-22,Sacramento,067,1510023,97956,96385,1372,97757,1493
2021-03-22,San Benito,069,59416,5847,5844,92,5936,61
2021-03-22,San Bernardino,071,2135413,288721,284771,8722,293493,4107
2021-03-22,San Diego,073,3302833,269584,267913,13356,281269,3494
2021-03-22,San Francisco,075,870044,35064,35040,1183,36223,462
2021-03-22,San Joaquin,077,732212,69197,67815,3066,70881,1182
2021-03-22,San Luis Obispo,079,281455,20340,20000,620,20620,250
2021-03-22,San Mateo,081,765935,40536,40024,429,40453,348
2021-03-22,Santa Barbara,083,443738,33163,32756,1091,33847,437
2021-03-22,Santa Clara,085,1922200,113490,113575,644,114219,1845
2021-03-22,Santa Cruz,087,273765,15745,15077,800,15877,201
2021-03-22,Shasta,089,179085,11217,11218,1328,12546,150
2021-03-22,Sierra,091,2930,55,50,12,62,0
2021-03-22,Siskiyou,093,43540,1560,1487,257,1744,5
2021-03-22,Solano,095,438530,30633,30490,399,30889,171
2021-03-22,Sonoma,097,501317,28902,29010,253,29263,310
2021-03-22,Stanislaus,099,539301,52607,52083,5556,57639,677
2021-03-22,Sutter,101,95872,9052,9024,81,9105,104
2021-03-22,Tehama,103,63373,4741,4704,510,5214,45
2021-03-22,Trinity,105,12862,475,310,84,394,3
2021-03-22,Tulare,107,460477,49156,48074,8534,56608,807
2021-03-22,Tuolumne,109,53932,3889,3954,36,3990,57
2021-03-22,Ventura,111,848112,79590,78890,2865,81755,927
2021-03-22,Yolo,113,214977,13240,13243,242,13485,190
2021-03-22,Yuba,115,75493,5682,5627,95,5722,42
2021-03-21,Alameda,001,1643700,83231,82684,1783,84467,1187
2021-03-21,Alpine,003,1148,84,83,0,83,0
2021-03-21,Amador,005,37829,3539,3519,32,3551,44
2021-03-21,Butte,007,227075,11615,11208,1637,12845,185
2021-03-21,Calaveras,009,45235,1983,1962,12,1974,49
2021-03-21,Colusa,011,21464,1886,1885,273,2158,13
2021-03-21,Contra Costa,013,1133247,65246,64382,1125,65507,740
2021-03-21,Del Norte,015,27424,1136,1076,7,1083,6
2021-03-21,El Dorado,017,186661,9376,9302,600,9902,105
2021-03-21,Fresno,019,978130,99193,98211,8174,106385,1556
2021-03-21,Glenn,021,27897,2326,2288,523,2811,17
2021-03-21,Humboldt,023,135768,3422,3402,24,3426,34
2021-03-21,Imperial,025,180216,27514,27267,2600,29867,699
2021-03-21,Inyo,027,18085,1367,1363,9,1372,35
2021-03-21,Kern,029,883053,95029,93649,10235,103884,1170
2021-03-21,Kings,031,150075,22724,22422,1022,23444,236
2021-03-21,Lake,033,64148,3331,3286,8,3294,43
2021-03-21,Lassen,035,31185,5141,5129,101,5230,1
2021-03-21,Los Angeles,037,10098052,1184321,1175684,40200,1215884,22834
2021-03-21,Madera,039,155013,16026,15895,880,16775,210
2021-03-21,Marin,041,260295,13581,13495,191,13686,220
2021-03-21,Mariposa,043,17540,391,381,5,386,5
2021-03-21,Mendocino,045,87422,3739,3651,73,3724,45
2021-03-21,Merced,047,269075,29508,29446,980,30426,413
2021-03-21,Modoc,049,8938,351,341,120,461,3
2021-03-21,Mono,051,14174,1218,1263,17,1280,3
2021-03-21,Monterey,053,433212,42418,42153,1760,43913,335
2021-03-21,Napa,055,140530,9308,9282,34,9316,77
2021-03-21,Nevada,057,99092,4235,4169,172,4341,89
2021-03-21,Orange,059,3164182,250333,248442,10623,259065,4598
2021-03-21,Placer,061,380077,21339,20520,1206,21726,242
2021-03-21,Plumas,063,18699,666,653,10,663,4
2021-03-21,Riverside,065,2383286,288836,282187,13655,295842,4009
2021-03-21,Sacramento,067,1510023,97762,96269,1365,97634,1489
2021-03-21,San Benito,069,59416,5841,5842,92,5934,61
2021-03-21,San Bernardino,071,2135413,288631,284732,8716,293448,4094
2021-03-21,San Diego,073,3302833,269324,267724,13330,281054,3494
2021-03-21,San Francisco,075,870044,35017,35012,1176,36188,460
2021-03-21,San Joaquin,077,732212,69075,67729,3048,70777,1182
2021-03-21,San Luis Obispo,079,281455,20308,19979,618,20597,250
2021-03-21,San Mateo,081,765935,40491,39988,428,40416,344
2021-03-21,Santa Barbara,083,443738,33124,32743,1090,33833,437
2021-03-21,Santa Clara,085,1922200,113361,113487,641,114128,1840
2021-03-21,Santa Cruz,087,273765,15738,15064,800,15864,199
2021-03-21,Shasta,089,179085,11197,11215,1327,12542,150
2021-03-21,Sierra,091,2930,55,50,12,62,0
2021-03-21,Siskiyou,093,43540,1560,1486,256,1742,5
2021-03-21,Solano,095,438530,30593,30474,396,30870,171
2021-03-21,Sonoma,097,501317,28873,28986,252,29238,310
2021-03-21,Stanislaus,099,539301,52517,52014,5554,57568,677
2021-03-21,Sutter,101,95872,9039,9021,81,9102,104
2021-03-21,Tehama,103,63373,4737,4701,510,5211,45
2021-03-21,Trinity,105,12862,473,310,84,394,3
2021-03-21,Tulare,107,460477,49140,48060,8522,56582,807
2021-03-21,Tuolumne,109,53932,3887,3953,36,3989,57
2021-03-21,Ventura,111,848112,79527,78863,2860,81723,927
2021-03-21,Yolo,113,214977,13219,13235,242,13477,190
2021-03-21,Yuba,115,75493,5672,5624,95,5719,42
2021-03-20,Alameda,001,1643700,83163,82614,1781,84395,1178
2021-03-20,Alpine,003,1148,84,83,0,83,0
2021-03-20,Amador,005,37829,3537,3518,32,3550,44
2021-03-20,Butte,007,227075,11609,11199,1635,12834,185
2021-03-20,Calaveras,009,45235,1979,1961,12,1973,49
2021-03-20,Colusa,011,21464,1886,1883,273,2156,12
2021-03-20,Contra Costa,013,1133247,65186,64313,1125,65438,713
2021-03-20,Del Norte,015,27424,1135,1075,7,1082,6
2021-03-20,El Dorado,017,186661,9370,9290,600,9890,105
2021-03-20,Fresno,019,978130,99133,98112,8167,106279,1532
2021-03-20,Glenn,021,27897,2325,2288,521,2809,17
2021-03-20,Humboldt,023,135768,3415,3399,24,3423,33
2021-03-20,Imperial,025,180216,27508,27239,2598,29837,695
2021-03-20,Inyo,027,18085,1367,1362,9,1371,35
2021-03-20,Kern,029,883053,95000,93606,10231,103837,1155
2021-03-20,Kings,031,150075,22719,22415,1021,23436,236
2021-03-20,Lake,033,64148,3327,3280,8,3288,43
2021-03-20,Lassen,035,31185,5141,5128,101,5229,1
2021-03-20,Los Angeles,037,10098052,1184019,1175290,40176,1215466,22810
2021-03-20,Madera,039,155013,16018,15891,879,16770,210
2021-03-20,Marin,041,260295,13569,13470,187,13657,220
2021-03-20,Mariposa,043,17540,390,381,5,386,5
2021-03-20,Mendocino,045,87422,3738,3639,73,3712,43
2021-03-20,Merced,047,269075,29477,29411,977,30388,412
2021-03-20,Modoc,049,8938,350,341,120,461,3
2021-03-20,Mono,051,14174,1218,1256,17,1273,3
2021-03-20,Monterey,053,433212,42409,42146,1759,43905,334
2021-03-20,Napa,055,140530,9300,9274,34,9308,77
2021-03-20,Nevada,057,99092,4224,4164,171,4335,89
2021-03-20,Orange,059,3164182,250252,248348,10611,258959,4522
2021-03-20,Placer,061,380077,21316,20505,1204,21709,242
2021-03-20,Plumas,063,18699,663,652,10,662,4
2021-03-20,Riverside,065,2383286,288761,282081,13651,295732,4000
2021-03-20,Sacramento,067,1510023,97651,96126,1362,97488,1488
2021-03-20,San Benito,069,59416,5837,5840,92,5932,61
2021-03-20,San Bernardino,071,2135413,288566,284690,8712,293402,3965
2021-03-20,San Diego,073,3302833,269153,267532,13323,280855,3493
2021-03-20,San Francisco,075,870044,34994,34968,1169,36137,453
2021-03-20,San Joaquin,077,732212,69034,67662,3041,70703,1161
2021-03-20,San Luis Obispo,079,281455,20292,19951,612,20563,250
2021-03-20,San Mateo,081,765935,40457,39958,427,40385,344
2021-03-20,Santa Barbara,083,443738,33099,32723,1089,33812,434
2021-03-20,Santa Clara,085,1922200,113269,113384,640,114024,1799
2021-03-20,Santa Cruz,087,273765,15722,15053,800,15853,199
2021-03-20,Shasta,089,179085,11191,11211,1327,12538,147
2021-03-20,Sierra,091,2930,55,50,12,62,0
2021-03-20,Siskiyou,093,43540,1560,1483,256,1739,5
2021-03-20,Solano,095,438530,30563,30439,396,30835,170
2021-03-20,Sonoma,097,501317,28858,28962,252,29214,309
2021-03-20,Stanislaus,099,539301,52461,51925,5547,57472,673
2021-03-20,Sutter,101,95872,9031,9014,81,9095,103
2021-03-20,Tehama,103,63373,4732,4696,508,5204,33
2021-03-20,Trinity,105,12862,472,310,84,394,3
2021-03-20,Tulare,107,460477,49125,48030,8505,56535,804
2021-03-20,Tuolumne,109,53932,3884,3950,36,3986,57
2021-03-20,Ventura,111,848112,79492,78818,2858,81676,922
2021-03-20,Yolo,113,214977,13215,13226,242,13468,190
2021-03-20,Yuba,115,75493,5669,5621,94,5715,42
2021-03-19,Alameda,001,1643700,83091,82499,1780,84279,1187
2021-03-19,Alpine,003,1148,83,82,0,82,0
2021-03-19,Amador,005,37829,3534,3515,32,3547,44
2021-03-19,Butte,007,227075,11601,11191,1632,12823,185
2021-03-19,Calaveras,009,45235,1978,1957,12,1969,49
2021-03-19,Colusa,011,21464,1885,1883,273,2156,12
2021-03-19,Contra Costa,013,1133247,65127,64195,1122,65317,737
2021-03-19,Del Norte,015,27424,1129,1071,5,1076,6
2021-03-19,El Dorado,017,186661,9361,9274,600,9874,105
2021-03-19,Fresno,019,978130,99049,97969,8153,106122,1527
2021-03-19,Glenn,021,27897,2325,2282,521,2803,17
2021-03-19,Humboldt,023,135768,3406,3388,24,3412,33
2021-03-19,Imperial,025,180216,27496,27218,2594,29812,695
2021-03-19,Inyo,027,18085,1365,1356,9,1365,35
2021-03-19,Kern,029,883053,94967,93534,10218,103752,1152
2021-03-19,Kings,031,150075,22710,22369,1018,23387,235
2021-03-19,Lake,033,64148,3321,3262,8,3270,43
2021-03-19,Lassen,035,31185,5141,5126,101,5227,1
2021-03-19,Los Angeles,037,10098052,1183684,1174818,40159,1214977,22752
2021-03-19,Madera,039,155013,16011,15877,878,16755,210
2021-03-19,Marin,041,260295,13557,13441,187,13628,220
2021-03-19,Mariposa,043,17540,389,380,5,385,5
2021-03-19,Mendocino,045,87422,3737,3639,73,3712,45
2021-03-19,Merced,047,269075,29450,29376,974,30350,412
2021-03-19,Modoc,049,8938,350,341,120,461,3
2021-03-19,Mono,051,14174,1216,1244,17,1261,3
2021-03-19,Monterey,053,433212,42400,42125,1757,43882,335
2021-03-19,Napa,055,140530,9288,9256,34,9290,77
2021-03-19,Nevada,057,99092,4213,4156,171,4327,88
2021-03-19,Orange,059,3164182,250152,248146,10601,258747,4501
2021-03-19,Placer,061,380077,21298,20451,1202,21653,242
2021-03-19,Plumas,063,18699,663,650,10,660,4
2021-03-19,Riverside,065,2383286,288678,281937,13646,295583,3989
2021-03-19,Sacramento,067,1510023,97548,95934,1359,97293,1486
2021-03-19,San Benito,069,59416,5837,5845,92,5937,61
2021-03-19,San Bernardino,071,2135413,288493,284501,8710,293211,4017
2021-03-19,San Diego,073,3302833,269018,267173,13313,280486,3491
2021-03-19,San Francisco,075,870044,34949,34936,1166,36102,461
2021-03-19,San Joaquin,077,732212,68964,67515,3027,70542,1180
2021-03-19,San Luis Obispo,079,281455,20272,19913,610,20523,249
2021-03-19,San Mateo,081,765935,40433,39893,427,40320,344
2021-03-19,Santa Barbara,083,443738,33069,32685,1088,33773,435
2021-03-19,Santa Clara,085,1922200,113194,113232,639,113871,1797
2021-03-19,Santa Cruz,087,273765,15715,15026,800,15826,199
2021-03-19,Shasta,089,179085,11184,11104,1325,12429,103
2021-03-19,Sierra,091,2930,54,49,12,61,0
2021-03-19,Siskiyou,093,43540,1560,1480,255,1735,5
2021-03-19,Solano,095,438530,30533,30395,394,30789,172
2021-03-19,Sonoma,097,501317,28837,28932,250,29182,292
2021-03-19,Stanislaus,099,539301,52403,51755,5544,57299,679
2021-03-19,Sutter,101,95872,9029,9005,81,9086,103
2021-03-19,Tehama,103,63373,4725,4685,508,5193,33
2021-03-19,Trinity,105,12862,472,310,84,394,3
2021-03-19,Tulare,107,460477,49102,47989,8482,56471,805
2021-03-19,Tuolumne,109,53932,3881,3946,36,3982,57
2021-03-19,Ventura,111,848112,79459,78753,2854,81607,920
2021-03-19,Yolo,113,214977,13207,13197,242,13439,189
2021-03-19,Yuba,115,75493,5666,5615,93,5708,42
2021-03-18,Alameda,001,1643700,83011,82419,1777,84196,1189
2021-03-18,Alpine,003,1148,83,82,0,82,0
2021-03-18,Amador,005,37829,3530,3513,32,3545,44
2021-03-18,Butte,007,227075,11590,11179,1630,12809,185
2021-03-18,Calaveras,009,45235,1976,1954,12,1966,49
2021-03-18,Colusa,011,21464,1885,1882,273,2155,12
2021-03-18,Contra Costa,013,1133247,65054,64103,1119,65222,739
2021-03-18,Del Norte,015,27424,1120,1059,5,1064,6
2021-03-18,El Dorado,017,186661,9348,9261,599,9860,105
2021-03-18,Fresno,019,978130,98952,97856,8138,105994,1527
2021-03-18,Glenn,021,27897,2321,2275,520,2795,17
2021-03-18,Humboldt,023,135768,3398,3381,24,3405,34
2021-03-18,Imperial,025,180216,27481,27190,2589,29779,695
2021-03-18,Inyo,027,18085,1362,1354,9,1363,35
2021-03-18,Kern,029,883053,94910,93458,10204,103662,1158
2021-03-18,Kings,031,150075,22703,22354,1017,23371,235
2021-03-18,Lake,033,64148,3318,3260,8,3268,43
2021-03-18,Lassen,035,31185,5140,5126,101,5227,1
2021-03-18,Los Angeles,037,10098052,1183251,1174205,40130,1214335,22689
2021-03-18,Madera,039,155013,15999,15860,875,16735,211
2021-03-18,Marin,041,260295,13539,13435,186,13621,219
2021-03-18,Mariposa,043,17540,387,380,5,385,5
2021-03-18,Mendocino,045,87422,3727,3630,73,3703,45
2021-03-18,Merced,047,269075,29415,29317,974,30291,410
2021-03-18,Modoc,049,8938,350,341,120,461,3
2021-03-18,Mono,051,14174,1212,1215,16,1231,3
2021-03-18,Monterey,053,433212,42388,42105,1757,43862,335
2021-03-18,Napa,055,140530,9279,9243,34,9277,77
2021-03-18,Nevada,057,99092,4206,4154,171,4325,74
2021-03-18,Orange,059,3164182,250049,248050,10588,258638,4514
2021-03-18,Placer,061,380077,21266,20421,1199,21620,243
2021-03-18,Plumas,063,18699,661,648,10,658,4
2021-03-18,Riverside,065,2383286,288597,281789,13639,295428,3957
2021-03-18,Sacramento,067,1510023,97400,95819,1355,97174,1481
2021-03-18,San Benito,069,59416,5835,5842,92,5934,61
2021-03-18,San Bernardino,071,2135413,288412,284294,8680,292974,4076
2021-03-18,San Diego,073,3302833,268866,266752,13303,280055,3478
2021-03-18,San Francisco,075,870044,34910,34904,1165,36069,461
2021-03-18,San Joaquin,077,732212,68864,67301,3015,70316,1169
2021-03-18,San Luis Obispo,079,281455,20243,19894,609,20503,249
2021-03-18,San Mateo,081,765935,40392,39874,427,40301,344
2021-03-18,Santa Barbara,083,443738,33028,32640,1088,33728,434
2021-03-18,Santa Clara,085,1922200,113077,113119,635,113754,1808
2021-03-18,Santa Cruz,087,273765,15705,14998,800,15798,198
2021-03-18,Shasta,089,179085,11170,11059,1323,12382,100
2021-03-18,Sierra,091,2930,54,49,12,61,0
2021-03-18,Siskiyou,093,43540,1557,1480,254,1734,5
2021-03-18,Solano,095,438530,30491,30352,391,30743,172
2021-03-18,Sonoma,097,501317,28816,28915,248,29163,292
2021-03-18,Stanislaus,099,539301,52332,51615,5540,57155,682
2021-03-18,Sutter,101,95872,9017,8999,81,9080,103
2021-03-18,Tehama,103,63373,4719,4683,507,5190,35
2021-03-18,Trinity,105,12862,472,310,84,394,3
2021-03-18,Tulare,107,460477,49083,47964,8467,56431,805
2021-03-18,Tuolumne,109,53932,3880,3942,36,3978,57
2021-03-18,Ventura,111,848112,79399,78697,2854,81551,918
2021-03-18,Yolo,113,214977,13194,13183,242,13425,191
2021-03-18,Yuba,115,75493,5662,5612,93,5705,42
2021-03-17,Alameda,001,1643700,82935,82353,1772,84125,1185
2021-03-17,Alpine,003,1148,83,82,0,82,0
2021-03-17,Amador,005,37829,3528,3511,32,3543,44
2021-03-17,Butte,007,227075,11581,11170,1628,12798,185
2021-03-17,Calaveras,009,45235,1973,1946,12,1958,49
2021-03-17,Colusa,011,21464,1884,1882,273,2155,12
2021-03-17,Contra Costa,013,1133247,64985,64026,1118,65144,737
2021-03-17,Del Norte,015,27424,1116,1053,5,1058,6
2021-03-17,El Dorado,017,186661,9338,9252,599,9851,105
2021-03-17,Fresno,019,978130,98841,97727,8120,105847,1507
2021-03-17,Glenn,021,27897,2314,2269,519,2788,17
2021-03-17,Humboldt,023,135768,3390,3365,24,3389,33
2021-03-17,Imperial,025,180216,27464,27168,2586,29754,691
2021-03-17,Inyo,027,18085,1360,1351,9,1360,35
2021-03-17,Kern,029,883053,94854,93392,10191,103583,1149
2021-03-17,Kings,031,150075,22687,22336,1016,23352,233
2021-03-17,Lake,033,64148,3311,3251,8,3259,43
2021-03-17,Lassen,035,31185,5139,5125,101,5226,1
2021-03-17,Los Angeles,037,10098052,1182798,1173416,40097,1213513,22602
2021-03-17,Madera,039,155013,15992,15835,875,16710,214
2021-03-17,Marin,041,260295,13522,13428,185,13613,218
2021-03-17,Mariposa,043,17540,387,379,5,384,5
2021-03-17,Mendocino,045,87422,3723,3625,73,3698,44
2021-03-17,Merced,047,269075,29387,29250,970,30220,408
2021-03-17,Modoc,049,8938,350,341,120,461,3
2021-03-17,Mono,051,14174,1210,1212,16,1228,3
2021-03-17,Monterey,053,433212,42370,42061,1754,43815,334
2021-03-17,Napa,055,140530,9264,9219,34,9253,76
2021-03-17,Nevada,057,99092,4196,4145,171,4316,74
2021-03-17,Orange,059,3164182,249930,247943,10560,258503,4502
2021-03-17,Placer,061,380077,21239,20369,1197,21566,243
2021-03-17,Plumas,063,18699,660,645,10,655,4
2021-03-17,Riverside,065,2383286,288481,281649,13631,295280,3925
2021-03-17,Sacramento,067,1510023,97272,95650,1350,97000,1477
2021-03-17,San Benito,069,59416,5832,5841,92,5933,61
2021-03-17,San Bernardino,071,2135413,288295,284170,8675,292845,4049
2021-03-17,San Diego,073,3302833,268655,266313,13285,279598,3470
2021-03-17,San Francisco,075,870044,34875,34873,1164,36037,457
2021-03-17,San Joaquin,077,732212,68779,67093,2999,70092,1164
2021-03-17,San Luis Obispo,079,281455,20220,19858,605,20463,249
2021-03-17,San Mateo,081,765935,40362,39838,426,40264,344
2021-03-17,Santa Barbara,083,443738,33006,32585,1087,33672,433
2021-03-17,Santa Clara,085,1922200,112984,112983,634,113617,1805
2021-03-17,Santa Cruz,087,273765,15697,14967,800,15767,199
2021-03-17,Shasta,089,179085,11165,11045,1320,12365,100
2021-03-17,Sierra,091,2930,54,49,12,61,0
2021-03-17,Siskiyou,093,43540,1556,1479,252,1731,5
2021-03-17,Solano,095,438530,30465,30320,389,30709,171
2021-03-17,Sonoma,097,501317,28792,28877,247,29124,292
2021-03-17,Stanislaus,099,539301,52257,51524,5533,57057,682
2021-03-17,Sutter,101,95872,9007,8982,81,9063,103
2021-03-17,Tehama,103,63373,4714,4670,507,5177,34
2021-03-17,Trinity,105,12862,472,308,84,392,3
2021-03-17,Tulare,107,460477,49063,47929,8457,56386,805
2021-03-17,Tuolumne,109,53932,3877,3938,36,3974,57
2021-03-17,Ventura,111,848112,79343,78648,2851,81499,916
2021-03-17,Yolo,113,214977,13177,13169,242,13411,190
2021-03-17,Yuba,115,75493,5659,5603,93,5696,42
2021-03-16,Alameda,001,1643700,82823,82259,1770,84029,1177
2021-03-16,Alpine,003,1148,83,82,0,82,0
2021-03-16,Amador,005,37829,3526,3510,32,3542,44
2021-03-16,Butte,007,227075,11569,11154,1627,12781,184
2021-03-16,Calaveras,009,45235,1968,1945,12,1957,49
2021-03-16,Colusa,011,21464,1883,1882,273,2155,12
2021-03-16,Contra Costa,013,1133247,64902,63951,1115,65066,736
2021-03-16,Del Norte,015,27424,1108,1048,5,1053,6
2021-03-16,El Dorado,017,186661,9323,9249,599,9848,105
2021-03-16,Fresno,019,978130,98703,97638,8098,105736,1498
2021-03-16,Glenn,021,27897,2306,2267,515,2782,17
2021-03-16,Humboldt,023,135768,3386,3351,24,3375,33
2021-03-16,Imperial,025,180216,27453,27143,2583,29726,689
2021-03-16,Inyo,027,18085,1359,1346,9,1355,35
2021-03-16,Kern,029,883053,94788,93340,10176,103516,1144
2021-03-16,Kings,031,150075,22651,22320,1015,23335,233
2021-03-16,Lake,033,64148,3303,3246,8,3254,43
2021-03-16,Lassen,035,31185,5138,5126,101,5227,1
2021-03-16,Los Angeles,037,10098052,1182265,1172676,40059,1212735,22527
2021-03-16,Madera,039,155013,15976,15822,873,16695,214
2021-03-16,Marin,041,260295,13504,13419,185,13604,218
2021-03-16,Mariposa,043,17540,384,379,5,384,5
2021-03-16,Mendocino,045,87422,3718,3623,73,3696,44
2021-03-16,Merced,047,269075,29334,29198,969,30167,407
2021-03-16,Modoc,049,8938,350,341,120,461,3
2021-03-16,Mono,051,14174,1209,1207,16,1223,3
2021-03-16,Monterey,053,433212,42351,42023,1754,43777,334
2021-03-16,Napa,055,140530,9254,9209,34,9243,75
2021-03-16,Nevada,057,99092,4187,4132,170,4302,67
2021-03-16,Orange,059,3164182,249791,247843,10541,258384,4479
2021-03-16,Placer,061,380077,21206,20339,1193,21532,240
2021-03-16,Plumas,063,18699,659,643,10,653,4
2021-03-16,Riverside,065,2383286,288367,281540,13618,295158,3893
2021-03-16,Sacramento,067,1510023,97129,95522,1346,96868,1466
2021-03-16,San Benito,069,59416,5827,5831,92,5923,61
2021-03-16,San Bernardino,071,2135413,288165,283980,8668,292648,4032
2021-03-16,San Diego,073,3302833,268423,265903,13272,279175,3462
2021-03-16,San Francisco,075,870044,34846,34833,1159,35992,456
2021-03-16,San Joaquin,077,732212,68677,66856,2986,69842,1163
2021-03-16,San Luis Obispo,079,281455,20190,19832,603,20435,248
2021-03-16,San Mateo,081,765935,40328,39806,424,40230,344
2021-03-16,Santa Barbara,083,443738,32974,32556,1086,33642,433
2021-03-16,Santa Clara,085,1922200,112866,112845,631,113476,1797
2021-03-16,Santa Cruz,087,273765,15691,14926,800,15726,199
2021-03-16,Shasta,089,179085,11149,11035,1317,12352,100
2021-03-16,Sierra,091,2930,53,49,12,61,0
2021-03-16,Siskiyou,093,43540,1553,1477,252,1729,5
2021-03-16,Solano,095,438530,30431,30298,387,30685,171
2021-03-16,Sonoma,097,501317,28759,28850,245,29095,291
2021-03-16,Stanislaus,099,539301,52177,51410,5526,56936,683
2021-03-16,Sutter,101,95872,8999,8970,81,9051,102
2021-03-16,Tehama,103,63373,4711,4660,506,5166,34
2021-03-16,Trinity,105,12862,472,308,83,391,3
2021-03-16,Tulare,107,460477,49015,47895,8449,56344,803
2021-03-16,Tuolumne,109,53932,3874,3938,36,3974,57
2021-03-16,Ventura,111,848112,79277,78671,2844,81515,916
2021-03-16,Yolo,113,214977,13162,13162,242,13404,190
2021-03-16,Yuba,115,75493,5656,5596,92,5688,42
2021-03-15,Alameda,001,1643700,82734,82159,1770,83929,1167
2021-03-15,Alpine,003,1148,83,82,0,82,0
2021-03-15,Amador,005,37829,3525,3506,32,3538,44
2021-03-15,Butte,007,227075,11556,11141,1623,12764,185
2021-03-15,Calaveras,009,45235,1967,1941,12,1953,49
2021-03-15,Colusa,011,21464,1883,1883,273,2156,12
2021-03-15,Contra Costa,013,1133247,64840,63847,1114,64961,732
2021-03-15,Del Norte,015,27424,1105,1048,5,1053,6
2021-03-15,El Dorado,017,186661,9317,9235,598,9833,103
2021-03-15,Fresno,019,978130,98576,97520,8083,105603,1496
2021-03-15,Glenn,021,27897,2301,2261,512,2773,15
2021-03-15,Humboldt,023,135768,3380,3337,24,3361,32
2021-03-15,Imperial,025,180216,27433,27122,2580,29702,684
2021-03-15,Inyo,027,18085,1359,1346,9,1355,35
2021-03-15,Kern,029,883053,94728,93266,10169,103435,1141
2021-03-15,Kings,031,150075,22634,22294,1009,23303,233
2021-03-15,Lake,033,64148,3291,3237,8,3245,43
2021-03-15,Lassen,035,31185,5138,5125,101,5226,1
2021-03-15,Los Angeles,037,10098052,1181696,1172445,40024,1212469,22477
2021-03-15,Madera,039,155013,15965,15806,871,16677,214
2021-03-15,Marin,041,260295,13498,13408,184,13592,218
2021-03-15,Mariposa,043,17540,384,376,5,381,5
2021-03-15,Mendocino,045,87422,3714,3615,73,3688,44
2021-03-15,Merced,047,269075,29296,29169,967,30136,407
2021-03-15,Modoc,049,8938,350,340,120,460,3
2021-03-15,Mono,051,14174,1208,1206,16,1222,3
2021-03-15,Monterey,053,433212,42323,42011,1751,43762,333
2021-03-15,Napa,055,140530,9243,9196,34,9230,75
2021-03-15,Nevada,057,99092,4182,4123,169,4292,66
2021-03-15,Orange,059,3164182,249678,247697,10520,258217,4481
2021-03-15,Placer,061,380077,21183,20308,1193,21501,238
2021-03-15,Plumas,063,18699,659,642,10,652,4
2021-03-15,Riverside,065,2383286,288215,281367,13608,294975,3856
2021-03-15,Sacramento,067,1510023,96976,95414,1340,96754,1463
2021-03-15,San Benito,069,59416,5824,5831,92,5923,61
2021-03-15,San Bernardino,071,2135413,288073,283815,8660,292475,4004
2021-03-15,San Diego,073,3302833,268174,265646,13256,278902,3452
2021-03-15,San Francisco,075,870044,34811,34820,1155,35975,456
2021-03-15,San Joaquin,077,732212,68573,66622,2973,69595,1140
2021-03-15,San Luis Obispo,079,281455,20159,19813,599,20412,247
2021-03-15,San Mateo,081,765935,40274,39765,424,40189,344
2021-03-15,Santa Barbara,083,443738,32951,32529,1083,33612,431
2021-03-15,Santa Clara,085,1922200,112765,112729,629,113358,1798
2021-03-15,Santa Cruz,087,273765,15685,14899,798,15697,200
2021-03-15,Shasta,089,179085,11133,11019,1312,12331,92
2021-03-15,Sierra,091,2930,53,49,12,61,0
2021-03-15,Siskiyou,093,43540,1553,1475,252,1727,5
2021-03-15,Solano,095,438530,30402,30258,386,30644,171
2021-03-15,Sonoma,097,501317,28741,28814,242,29056,285
2021-03-15,Stanislaus,099,539301,52099,51357,5519,56876,683
2021-03-15,Sutter,101,95872,8993,8962,81,9043,102
2021-03-15,Tehama,103,63373,4696,4650,505,5155,34
2021-03-15,Trinity,105,12862,472,308,83,391,3
2021-03-15,Tulare,107,460477,48985,47857,8434,56291,800
2021-03-15,Tuolumne,109,53932,3872,3937,35,3972,57
2021-03-15,Ventura,111,848112,79221,78626,2843,81469,910
2021-03-15,Yolo,113,214977,13143,13131,240,13371,190
2021-03-15,Yuba,115,75493,5651,5585,91,5676,42
2021-03-14,Alameda,001,1643700,82650,82116,1767,83883,1168
2021-03-14,Alpine,003,1148,83,82,0,82,0
2021-03-14,Amador,005,37829,3520,3504,32,3536,44
2021-03-14,Butte,007,227075,11543,11140,1619,12759,185
2021-03-14,Calaveras,009,45235,1963,1939,12,1951,49
2021-03-14,Colusa,011,21464,1883,1883,273,2156,12
2021-03-14,Contra Costa,013,1133247,64735,63808,1113,64921,731
2021-03-14,Del Norte,015,27424,1091,1048,5,1053,6
2021-03-14,El Dorado,017,186661,9307,9231,598,9829,103
2021-03-14,Fresno,019,978130,98468,97461,8065,105526,1496
2021-03-14,Glenn,021,27897,2296,2260,509,2769,15
2021-03-14,Humboldt,023,135768,3366,3335,24,3359,32
2021-03-14,Imperial,025,180216,27418,27122,2575,29697,685
2021-03-14,Inyo,027,18085,1355,1346,9,1355,35
2021-03-14,Kern,029,883053,94645,93252,10151,103403,1141
2021-03-14,Kings,031,150075,22615,22292,1007,23299,232
2021-03-14,Lake,033,64148,3286,3237,8,3245,43
2021-03-14,Lassen,035,31185,5136,5125,101,5226,1
2021-03-14,Los Angeles,037,10098052,1181127,1172100,39988,1212088,22476
2021-03-14,Madera,039,155013,15940,15804,871,16675,214
2021-03-14,Marin,041,260295,13482,13405,182,13587,218
2021-03-14,Mariposa,043,17540,382,376,5,381,5
2021-03-14,Mendocino,045,87422,3709,3613,73,3686,44
2021-03-14,Merced,047,269075,29228,29149,963,30112,407
2021-03-14,Modoc,049,8938,350,340,120,460,3
2021-03-14,Mono,051,14174,1202,1206,16,1222,3
2021-03-14,Monterey,053,433212,42299,42007,1747,43754,333
2021-03-14,Napa,055,140530,9225,9194,34,9228,75
2021-03-14,Nevada,057,99092,4176,4122,167,4289,66
2021-03-14,Orange,059,3164182,249545,247656,10500,258156,4460
2021-03-14,Placer,061,380077,21148,20288,1185,21473,238
2021-03-14,Plumas,063,18699,657,642,10,652,4
2021-03-14,Riverside,065,2383286,288057,281332,13600,294932,3845
2021-03-14,Sacramento,067,1510023,96798,95343,1335,96678,1462
2021-03-14,San Benito,069,59416,5815,5829,92,5921,61
2021-03-14,San Bernardino,071,2135413,287949,283791,8649,292440,3996
2021-03-14,San Diego,073,3302833,267939,265468,13243,278711,3452
2021-03-14,San Francisco,075,870044,34772,34810,1152,35962,455
2021-03-14,San Joaquin,077,732212,68445,66563,2956,69519,1140
2021-03-14,San Luis Obispo,079,281455,20130,19806,597,20403,247
2021-03-14,San Mateo,081,765935,40235,39744,424,40168,342
2021-03-14,Santa Barbara,083,443738,32907,32514,1081,33595,431
2021-03-14,Santa Clara,085,1922200,112637,112648,628,113276,1796
2021-03-14,Santa Cruz,087,273765,15668,14887,796,15683,200
2021-03-14,Shasta,089,179085,11117,11019,1305,12324,92
2021-03-14,Sierra,091,2930,53,49,12,61,0
2021-03-14,Siskiyou,093,43540,1550,1473,251,1724,5
2021-03-14,Solano,095,438530,30370,30230,381,30611,171
2021-03-14,Sonoma,097,501317,28706,28798,238,29036,284
2021-03-14,Stanislaus,099,539301,51979,51306,5511,56817,690
2021-03-14,Sutter,101,95872,8977,8958,81,9039,102
2021-03-14,Tehama,103,63373,4689,4650,504,5154,34
2021-03-14,Trinity,105,12862,471,308,82,390,3
2021-03-14,Tulare,107,460477,48952,47845,8413,56258,800
2021-03-14,Tuolumne,109,53932,3870,3937,35,3972,57
2021-03-14,Ventura,111,848112,79173,78611,2837,81448,910
2021-03-14,Yolo,113,214977,13121,13128,236,13364,189
2021-03-14,Yuba,115,75493,5641,5583,91,5674,42
2021-03-13,Alameda,001,1643700,82590,82010,1767,83777,1168
2021-03-13,Alpine,003,1148,83,82,0,82,0
2021-03-13,Amador,005,37829,3517,3504,32,3536,44
2021-03-13,Butte,007,227075,11534,11131,1618,12749,185
2021-03-13,Calaveras,009,45235,1962,1939,12,1951,49
2021-03-13,Colusa,011,21464,1883,1882,273,2155,12
2021-03-13,Contra Costa,013,1133247,64674,63689,1113,64802,731
2021-03-13,Del Norte,015,27424,1087,1041,5,1046,6
2021-03-13,El Dorado,017,186661,9299,9221,598,9819,103
2021-03-13,Fresno,019,978130,98409,97324,8045,105369,1495
2021-03-13,Glenn,021,27897,2295,2260,508,2768,15
2021-03-13,Humboldt,023,135768,3359,3325,24,3349,32
2021-03-13,Imperial,025,180216,27412,27099,2571,29670,677
2021-03-13,Inyo,027,18085,1354,1344,9,1353,35
2021-03-13,Kern,029,883053,94606,93197,10145,103342,1140
2021-03-13,Kings,031,150075,22599,22265,1006,23271,232
2021-03-13,Lake,033,64148,3279,3234,7,3241,43
2021-03-13,Lassen,035,31185,5136,5125,101,5226,1
2021-03-13,Los Angeles,037,10098052,1180812,1171505,39944,1211449,22451
2021-03-13,Madera,039,155013,15928,15780,871,16651,214
2021-03-13,Marin,041,260295,13476,13391,180,13571,218
2021-03-13,Mariposa,043,17540,381,376,5,381,5
2021-03-13,Mendocino,045,87422,3705,3611,73,3684,44
2021-03-13,Merced,047,269075,29197,29106,963,30069,406
2021-03-13,Modoc,049,8938,350,340,119,459,3
2021-03-13,Mono,051,14174,1202,1207,16,1223,3
2021-03-13,Monterey,053,433212,42289,41989,1745,43734,332
2021-03-13,Napa,055,140530,9219,9190,34,9224,75
2021-03-13,Nevada,057,99092,4169,4111,166,4277,66
2021-03-13,Orange,059,3164182,249464,247514,10484,257998,4423
2021-03-13,Placer,061,380077,21127,20238,1182,21420,239
2021-03-13,Plumas,063,18699,655,642,10,652,4
2021-03-13,Riverside,065,2383286,287965,281191,13592,294783,3848
2021-03-13,Sacramento,067,1510023,96712,95192,1333,96525,1461
2021-03-13,San Benito,069,59416,5812,5823,92,5915,61
2021-03-13,San Bernardino,071,2135413,287894,283727,8643,292370,3972
2021-03-13,San Diego,073,3302833,267784,265270,13229,278499,3444
2021-03-13,San Francisco,075,870044,34755,34784,1143,35927,455
2021-03-13,San Joaquin,077,732212,68389,66480,2934,69414,1141
2021-03-13,San Luis Obispo,079,281455,20112,19789,596,20385,247
2021-03-13,San Mateo,081,765935,40208,39689,423,40112,341
2021-03-13,Santa Barbara,083,443738,32882,32486,1080,33566,431
2021-03-13,Santa Clara,085,1922200,112552,112531,627,113158,1790
2021-03-13,Santa Cruz,087,273765,15661,14875,796,15671,199
2021-03-13,Shasta,089,179085,11109,11021,1302,12323,108
2021-03-13,Sierra,091,2930,52,49,12,61,0
2021-03-13,Siskiyou,093,43540,1548,1470,251,1721,5
2021-03-13,Solano,095,438530,30353,30198,381,30579,171
2021-03-13,Sonoma,097,501317,28686,28762,234,28996,285
2021-03-13,Stanislaus,099,539301,51928,51257,5506,56763,695
2021-03-13,Sutter,101,95872,8970,8948,81,9029,102
2021-03-13,Tehama,103,63373,4687,4647,504,5151,33
2021-03-13,Trinity,105,12862,471,306,82,388,3
2021-03-13,Tulare,107,460477,48926,47818,8405,56223,798
2021-03-13,Tuolumne,109,53932,3867,3937,35,3972,57
2021-03-13,Ventura,111,848112,79121,78693,2837,81530,906
2021-03-13,Yolo,113,214977,13113,13087,235,13322,189
2021-03-13,Yuba,115,75493,5640,5577,91,5668,42
2021-03-12,Alameda,001,1643700,82513,81898,1766,83664,1164
2021-03-12,Alpine,003,1148,83,82,0,82,0
2021-03-12,Amador,005,37829,3514,3503,32,3535,44
2021-03-12,Butte,007,227075,11524,11126,1616,12742,184
2021-03-12,Calaveras,009,45235,1962,1916,12,1928,49
2021-03-12,Colusa,011,21464,1883,1883,273,2156,12
2021-03-12,Contra Costa,013,1133247,64598,63583,1113,64696,728
2021-03-12,Del Norte,015,27424,1081,1033,5,1038,6
2021-03-12,El Dorado,017,186661,9290,9219,598,9817,103
2021-03-12,Fresno,019,978130,98312,97185,8034,105219,1489
2021-03-12,Glenn,021,27897,2294,2258,507,2765,15
2021-03-12,Humboldt,023,135768,3354,3315,24,3339,32
2021-03-12,Imperial,025,180216,27401,27071,2569,29640,677
2021-03-12,Inyo,027,18085,1352,1339,9,1348,35
2021-03-12,Kern,029,883053,94572,93142,10129,103271,1132
2021-03-12,Kings,031,150075,22580,22233,1006,23239,232
2021-03-12,Lake,033,64148,3273,3226,6,3232,43
2021-03-12,Lassen,035,31185,5136,5125,100,5225,1
2021-03-12,Los Angeles,037,10098052,1180413,1170860,39927,1210787,22409
2021-03-12,Madera,039,155013,15916,15761,868,16629,214
2021-03-12,Marin,041,260295,13469,13375,180,13555,218
2021-03-12,Mariposa,043,17540,379,376,5,381,5
2021-03-12,Mendocino,045,87422,3702,3605,73,3678,43
2021-03-12,Merced,047,269075,29166,29064,963,30027,403
2021-03-12,Modoc,049,8938,350,340,119,459,3
2021-03-12,Mono,051,14174,1201,1206,16,1222,3
2021-03-12,Monterey,053,433212,42275,41964,1740,43704,329
2021-03-12,Napa,055,140530,9210,9180,34,9214,75
2021-03-12,Nevada,057,99092,4159,4101,166,4267,66
2021-03-12,Orange,059,3164182,249371,247388,10473,257861,4401
2021-03-12,Placer,061,380077,21094,20210,1177,21387,239
2021-03-12,Plumas,063,18699,654,641,10,651,4
2021-03-12,Riverside,065,2383286,287866,281037,13584,294621,3854
2021-03-12,Sacramento,067,1510023,96588,95061,1326,96387,1460
2021-03-12,San Benito,069,59416,5809,5817,92,5909,61
2021-03-12,San Bernardino,071,2135413,287837,283558,8638,292196,3917
2021-03-12,San Diego,073,3302833,267621,264886,13221,278107,3434
2021-03-12,San Francisco,075,870044,34734,34758,1140,35898,452
2021-03-12,San Joaquin,077,732212,68318,66482,2925,69407,1144
2021-03-12,San Luis Obispo,079,281455,20098,19769,594,20363,247
2021-03-12,San Mateo,081,765935,40172,39638,421,40059,341
2021-03-12,Santa Barbara,083,443738,32859,32457,1077,33534,429
2021-03-12,Santa Clara,085,1922200,112457,112396,626,113022,1766
2021-03-12,Santa Cruz,087,273765,15649,14846,794,15640,195
2021-03-12,Shasta,089,179085,11100,11143,1300,12443,153
2021-03-12,Sierra,091,2930,52,49,12,61,0
2021-03-12,Siskiyou,093,43540,1548,1468,250,1718,5
2021-03-12,Solano,095,438530,30334,30180,380,30560,171
2021-03-12,Sonoma,097,501317,28659,28714,234,28948,285
2021-03-12,Stanislaus,099,539301,51870,51146,5499,56645,701
2021-03-12,Sutter,101,95872,8964,8940,81,9021,101
2021-03-12,Tehama,103,63373,4683,4638,503,5141,33
2021-03-12,Trinity,105,12862,470,306,81,387,3
2021-03-12,Tulare,107,460477,48901,47772,8399,56171,798
2021-03-12,Tuolumne,109,53932,3866,3936,35,3971,57
2021-03-12,Ventura,111,848112,79075,78698,2833,81531,899
2021-03-12,Yolo,113,214977,13103,13061,228,13289,189
2021-03-12,Yuba,115,75493,5633,5563,90,5653,42
2021-03-11,Alameda,001,1643700,82421,81809,1761,83570,1164
2021-03-11,Alpine,003,1148,83,78,0,78,0
2021-03-11,Amador,005,37829,3513,3498,32,3530,42
2021-03-11,Butte,007,227075,11513,11110,1614,12724,185
2021-03-11,Calaveras,009,45235,1959,1915,12,1927,49
2021-03-11,Colusa,011,21464,1883,1883,273,2156,12
2021-03-11,Contra Costa,013,1133247,64525,63469,1111,64580,728
2021-03-11,Del Norte,015,27424,1076,1027,5,1032,6
2021-03-11,El Dorado,017,186661,9276,9211,598,9809,101
2021-03-11,Fresno,019,978130,98196,97026,8005,105031,1481
2021-03-11,Glenn,021,27897,2291,2255,507,2762,15
2021-03-11,Humboldt,023,135768,3337,3302,24,3326,32
2021-03-11,Imperial,025,180216,27394,27045,2565,29610,675
2021-03-11,Inyo,027,18085,1347,1335,9,1344,35
2021-03-11,Kern,029,883053,94516,93052,10090,103142,1121
2021-03-11,Kings,031,150075,22565,22183,1003,23186,230
2021-03-11,Lake,033,64148,3269,3214,6,3220,42
2021-03-11,Lassen,035,31185,5135,5124,100,5224,1
2021-03-11,Los Angeles,037,10098052,1179881,1170111,39895,1210006,22316
2021-03-11,Madera,039,155013,15905,15725,866,16591,214
2021-03-11,Marin,041,260295,13457,13356,179,13535,217
2021-03-11,Mariposa,043,17540,379,376,5,381,5
2021-03-11,Mendocino,045,87422,3695,3604,73,3677,42
2021-03-11,Merced,047,269075,29117,29001,962,29963,401
2021-03-11,Modoc,049,8938,350,340,119,459,3
2021-03-11,Mono,051,14174,1200,1206,16,1222,3
2021-03-11,Monterey,053,433212,42252,41936,1734,43670,329
2021-03-11,Napa,055,140530,9197,9173,34,9207,75
2021-03-11,Nevada,057,99092,4147,4085,164,4249,66
2021-03-11,Orange,059,3164182,249233,247217,10455,257672,4373
2021-03-11,Placer,061,380077,21052,20178,1173,21351,239
2021-03-11,Plumas,063,18699,653,640,10,650,4
2021-03-11,Riverside,065,2383286,287696,280881,13571,294452,3842
2021-03-11,Sacramento,067,1510023,96447,94912,1323,96235,1455
2021-03-11,San Benito,069,59416,5806,5816,92,5908,61
2021-03-11,San Bernardino,071,2135413,287739,283312,8632,291944,3869
2021-03-11,San Diego,073,3302833,267457,264524,13205,277729,3422
2021-03-11,San Francisco,075,870044,34698,34722,1134,35856,452
2021-03-11,San Joaquin,077,732212,68206,66522,2917,69439,1157
2021-03-11,San Luis Obispo,079,281455,20073,19748,593,20341,247
2021-03-11,San Mateo,081,765935,40135,39590,420,40010,341
2021-03-11,Santa Barbara,083,443738,32831,32408,1072,33480,430
2021-03-11,Santa Clara,085,1922200,112328,112246,623,112869,1765
2021-03-11,Santa Cruz,087,273765,15637,14812,793,15605,193
2021-03-11,Shasta,089,179085,11090,11139,1295,12434,158
2021-03-11,Sierra,091,2930,52,48,12,60,0
2021-03-11,Siskiyou,093,43540,1545,1466,250,1716,5
2021-03-11,Solano,095,438530,30306,30138,379,30517,171
2021-03-11,Sonoma,097,501317,28630,28677,234,28911,285
2021-03-11,Stanislaus,099,539301,51785,51038,5491,56529,707
2021-03-11,Sutter,101,95872,8958,8933,81,9014,101
2021-03-11,Tehama,103,63373,4675,4632,503,5135,33
2021-03-11,Trinity,105,12862,469,304,80,384,3
2021-03-11,Tulare,107,460477,48864,47709,8388,56097,797
2021-03-11,Tuolumne,109,53932,3864,3934,35,3969,57
2021-03-11,Ventura,111,848112,79025,78697,2829,81526,889
2021-03-11,Yolo,113,214977,13086,13041,226,13267,190
2021-03-11,Yuba,115,75493,5629,5553,90,5643,42
2021-03-10,Alameda,001,1643700,82314,81701,1756,83457,1160
2021-03-10,Alpine,003,1148,82,78,0,78,0
2021-03-10,Amador,005,37829,3511,3496,32,3528,42
2021-03-10,Butte,007,227075,11503,11096,1614,12710,185
2021-03-10,Calaveras,009,45235,1953,1913,12,1925,48
2021-03-10,Colusa,011,21464,1883,1882,273,2155,12
2021-03-10,Contra Costa,013,1133247,64426,63372,1107,64479,725
2021-03-10,Del Norte,015,27424,1074,1020,5,1025,5
2021-03-10,El Dorado,017,186661,9263,9203,598,9801,100
2021-03-10,Fresno,019,978130,98089,96866,7989,104855,1471
2021-03-10,Glenn,021,27897,2288,2253,505,2758,15
2021-03-10,Humboldt,023,135768,3327,3296,23,3319,32
2021-03-10,Imperial,025,180216,27379,27051,2565,29616,675
2021-03-10,Inyo,027,18085,1347,1328,9,1337,35
2021-03-10,Kern,029,883053,94450,92965,10069,103034,1102
2021-03-10,Kings,031,150075,22546,22166,1001,23167,226
2021-03-10,Lake,033,64148,3259,3207,6,3213,42
2021-03-10,Lassen,035,31185,5135,5120,100,5220,1
2021-03-10,Los Angeles,037,10098052,1179334,1169079,39868,1208947,22199
2021-03-10,Madera,039,155013,15884,15705,863,16568,212
2021-03-10,Marin,041,260295,13447,13348,178,13526,216
2021-03-10,Mariposa,043,17540,379,376,5,381,5
2021-03-10,Mendocino,045,87422,3690,3602,73,3675,42
2021-03-10,Merced,047,269075,29080,28927,959,29886,401
2021-03-10,Modoc,049,8938,349,338,119,457,3
2021-03-10,Mono,051,14174,1196,1204,16,1220,3
2021-03-10,Monterey,053,433212,42230,41920,1730,43650,329
2021-03-10,Napa,055,140530,9188,9165,34,9199,75
2021-03-10,Nevada,057,99092,4143,4074,164,4238,66
2021-03-10,Orange,059,3164182,249085,247075,10440,257515,4342
2021-03-10,Placer,061,380077,21018,20144,1167,21311,239
2021-03-10,Plumas,063,18699,652,639,10,649,4
2021-03-10,Riverside,065,2383286,287555,280708,13557,294265,3822
2021-03-10,Sacramento,067,1510023,96317,94796,1317,96113,1452
2021-03-10,San Benito,069,59416,5797,5811,92,5903,61
2021-03-10,San Bernardino,071,2135413,287647,283140,8626,291766,3841
2021-03-10,San Diego,073,3302833,267235,264094,13193,277287,3413
2021-03-10,San Francisco,075,870044,34663,34688,1126,35814,450
2021-03-10,San Joaquin,077,732212,68104,66483,2900,69383,1156
2021-03-10,San Luis Obispo,079,281455,20049,19710,589,20299,247
2021-03-10,San Mateo,081,765935,40111,39571,420,39991,338
2021-03-10,Santa Barbara,083,443738,32804,32356,1069,33425,429
2021-03-10,Santa Clara,085,1922200,112219,112103,619,112722,1759
2021-03-10,Santa Cruz,087,273765,15622,14790,792,15582,192
2021-03-10,Shasta,089,179085,11080,11125,1292,12417,155
2021-03-10,Sierra,091,2930,52,48,12,60,0
2021-03-10,Siskiyou,093,43540,1543,1458,250,1708,5
2021-03-10,Solano,095,438530,30276,30111,378,30489,170
2021-03-10,Sonoma,097,501317,28595,28638,233,28871,286
2021-03-10,Stanislaus,099,539301,51698,50968,5472,56440,706
2021-03-10,Sutter,101,95872,8947,8918,81,8999,101
2021-03-10,Tehama,103,63373,4664,4623,502,5125,33
2021-03-10,Trinity,105,12862,469,304,80,384,3
2021-03-10,Tulare,107,460477,48816,47659,8370,56029,793
2021-03-10,Tuolumne,109,53932,3863,3931,35,3966,57
2021-03-10,Ventura,111,848112,78948,78609,2827,81436,878
2021-03-10,Yolo,113,214977,13063,13021,225,13246,189
2021-03-10,Yuba,115,75493,5616,5545,89,5634,42
2021-03-09,Alameda,001,1643700,82229,81618,1756,83374,1151
2021-03-09,Alpine,003,1148,82,78,0,78,0
2021-03-09,Amador,005,37829,3509,3494,32,3526,42
2021-03-09,Butte,007,227075,11490,11092,1613,12705,185
2021-03-09,Calaveras,009,45235,1951,1913,12,1925,48
2021-03-09,Colusa,011,21464,1883,1880,273,2153,11
2021-03-09,Contra Costa,013,1133247,64335,63314,1105,64419,723
2021-03-09,Del Norte,015,27424,1066,1017,5,1022,5
2021-03-09,El Dorado,017,186661,9255,9198,598,9796,98
2021-03-09,Fresno,019,978130,97970,96744,7962,104706,1463
2021-03-09,Glenn,021,27897,2284,2251,503,2754,15
2021-03-09,Humboldt,023,135768,3315,3288,22,3310,32
2021-03-09,Imperial,025,180216,27369,27045,2561,29606,675
2021-03-09,Inyo,027,18085,1345,1324,9,1333,35
2021-03-09,Kern,029,883053,94371,92924,10051,102975,1088
2021-03-09,Kings,031,150075,22521,22143,999,23142,226
2021-03-09,Lake,033,64148,3253,3202,6,3208,42
2021-03-09,Lassen,035,31185,5135,5120,100,5220,1
2021-03-09,Los Angeles,037,10098052,1178736,1167967,39834,1207801,22080
2021-03-09,Madera,039,155013,15873,15701,861,16562,211
2021-03-09,Marin,041,260295,13429,13335,176,13511,214
2021-03-09,Mariposa,043,17540,379,376,5,381,5
2021-03-09,Mendocino,045,87422,3686,3595,73,3668,42
2021-03-09,Merced,047,269075,29020,28876,956,29832,399
2021-03-09,Modoc,049,8938,349,338,118,456,3
2021-03-09,Mono,051,14174,1195,1203,16,1219,3
2021-03-09,Monterey,053,433212,42211,41894,1722,43616,329
2021-03-09,Napa,055,140530,9174,9155,34,9189,75
2021-03-09,Nevada,057,99092,4135,4062,164,4226,66
2021-03-09,Orange,059,3164182,248943,246989,10420,257409,4310
2021-03-09,Placer,061,380077,20976,20122,1162,21284,239
2021-03-09,Plumas,063,18699,649,639,10,649,4
2021-03-09,Riverside,065,2383286,287420,280562,13553,294115,3821
2021-03-09,Sacramento,067,1510023,96149,94720,1311,96031,1442
2021-03-09,San Benito,069,59416,5793,5800,92,5892,61
2021-03-09,San Bernardino,071,2135413,287533,282971,8620,291591,3823
2021-03-09,San Diego,073,3302833,267003,263745,13172,276917,3405
2021-03-09,San Francisco,075,870044,34632,34654,1122,35776,450
2021-03-09,San Joaquin,077,732212,67976,66383,2890,69273,1150
2021-03-09,San Luis Obispo,079,281455,20031,19672,582,20254,245
2021-03-09,San Mateo,081,765935,40064,39535,418,39953,336
2021-03-09,Santa Barbara,083,443738,32763,32314,1067,33381,428
2021-03-09,Santa Clara,085,1922200,112108,111963,614,112577,1756
2021-03-09,Santa Cruz,087,273765,15600,14764,791,15555,188
2021-03-09,Shasta,089,179085,11073,11113,1287,12400,155
2021-03-09,Sierra,091,2930,52,48,12,60,0
2021-03-09,Siskiyou,093,43540,1539,1447,248,1695,5
2021-03-09,Solano,095,438530,30240,30090,376,30466,169
2021-03-09,Sonoma,097,501317,28545,28601,230,28831,284
2021-03-09,Stanislaus,099,539301,51600,50884,5463,56347,703
2021-03-09,Sutter,101,95872,8934,8914,81,8995,101
2021-03-09,Tehama,103,63373,4659,4620,502,5122,33
2021-03-09,Trinity,105,12862,469,304,80,384,3
2021-03-09,Tulare,107,460477,48789,47637,8349,55986,792
2021-03-09,Tuolumne,109,53932,3861,3929,35,3964,56
2021-03-09,Ventura,111,848112,78885,78526,2825,81351,863
2021-03-09,Yolo,113,214977,13052,13015,224,13239,189
2021-03-09,Yuba,115,75493,5609,5539,89,5628,42
2021-03-08,Alameda,001,1643700,82118,81543,1755,83298,1142
2021-03-08,Alpine,003,1148,82,78,0,78,0
2021-03-08,Amador,005,37829,3506,3490,32,3522,42
2021-03-08,Butte,007,227075,11477,11082,1612,12694,185
2021-03-08,Calaveras,009,45235,1947,1909,12,1921,48
2021-03-08,Colusa,011,21464,1883,1877,273,2150,11
2021-03-08,Contra Costa,013,1133247,64239,63240,1105,64345,719
2021-03-08,Del Norte,015,27424,1061,1012,5,1017,5
2021-03-08,El Dorado,017,186661,9252,9188,597,9785,97
2021-03-08,Fresno,019,978130,97871,96665,7941,104606,1442
2021-03-08,Glenn,021,27897,2283,2249,503,2752,15
2021-03-08,Humboldt,023,135768,3301,3278,22,3300,31
2021-03-08,Imperial,025,180216,27361,27033,2558,29591,663
2021-03-08,Inyo,027,18085,1343,1320,9,1329,35
2021-03-08,Kern,029,883053,94304,92857,10031,102888,1087
2021-03-08,Kings,031,150075,22500,22130,997,23127,226
2021-03-08,Lake,033,64148,3241,3195,6,3201,42
2021-03-08,Lassen,035,31185,5135,5119,100,5219,1
2021-03-08,Los Angeles,037,10098052,1178118,1163409,39802,1203211,21868
2021-03-08,Madera,039,155013,15863,15691,859,16550,211
2021-03-08,Marin,041,260295,13409,13328,174,13502,214
2021-03-08,Mariposa,043,17540,379,376,5,381,5
2021-03-08,Mendocino,045,87422,3684,3590,72,3662,42
2021-03-08,Merced,047,269075,28960,28841,955,29796,398
2021-03-08,Modoc,049,8938,349,338,118,456,3
2021-03-08,Mono,051,14174,1194,1200,16,1216,3
2021-03-08,Monterey,053,433212,42190,41863,1721,43584,328
2021-03-08,Napa,055,140530,9171,9146,34,9180,75
2021-03-08,Nevada,057,99092,4127,4059,164,4223,66
2021-03-08,Orange,059,3164182,248769,246900,10388,257288,4243
2021-03-08,Placer,061,380077,20941,20102,1151,21253,239
2021-03-08,Plumas,063,18699,648,635,10,645,4
2021-03-08,Riverside,065,2383286,287268,280463,13543,294006,3783
2021-03-08,Sacramento,067,1510023,95979,94654,1306,95960,1438
2021-03-08,San Benito,069,59416,5790,5797,92,5889,61
2021-03-08,San Bernardino,071,2135413,287423,282894,8613,291507,3811
2021-03-08,San Diego,073,3302833,266762,263272,13157,276429,3390
2021-03-08,San Francisco,075,870044,34606,34634,1118,35752,446
2021-03-08,San Joaquin,077,732212,67859,66307,2881,69188,1139
2021-03-08,San Luis Obispo,079,281455,19988,19656,579,20235,245
2021-03-08,San Mateo,081,765935,40015,39492,416,39908,335
2021-03-08,Santa Barbara,083,443738,32731,32293,1067,33360,427
2021-03-08,Santa Clara,085,1922200,111980,111882,612,112494,1756
2021-03-08,Santa Cruz,087,273765,15580,14729,791,15520,188
2021-03-08,Shasta,089,179085,11065,11088,1282,12370,155
2021-03-08,Sierra,091,2930,52,48,12,60,0
2021-03-08,Siskiyou,093,43540,1538,1440,248,1688,5
2021-03-08,Solano,095,438530,30200,30068,374,30442,169
2021-03-08,Sonoma,097,501317,28501,28571,229,28800,284
2021-03-08,Stanislaus,099,539301,51521,50825,5458,56283,690
2021-03-08,Sutter,101,95872,8931,8905,81,8986,100
2021-03-08,Tehama,103,63373,4655,4615,502,5117,33
2021-03-08,Trinity,105,12862,468,302,80,382,3
2021-03-08,Tulare,107,460477,48748,47587,8324,55911,791
2021-03-08,Tuolumne,109,53932,3860,3921,35,3956,56
2021-03-08,Ventura,111,848112,78812,78526,2817,81343,852
2021-03-08,Yolo,113,214977,13029,13000,223,13223,189
2021-03-08,Yuba,115,75493,5599,5530,89,5619,42
2021-03-07,Alameda,001,1643700,81998,81413,1754,83167,1145
2021-03-07,Alpine,003,1148,82,78,0,78,0
2021-03-07,Amador,005,37829,3503,3489,32,3521,42
2021-03-07,Butte,007,227075,11461,11075,1611,12686,185
2021-03-07,Calaveras,009,45235,1943,1906,12,1918,48
2021-03-07,Colusa,011,21464,1883,1876,273,2149,11
2021-03-07,Contra Costa,013,1133247,64140,63148,1103,64251,719
2021-03-07,Del Norte,015,27424,1056,1010,5,1015,5
2021-03-07,El Dorado,017,186661,9249,9184,596,9780,97
2021-03-07,Fresno,019,978130,97693,96549,7919,104468,1442
2021-03-07,Glenn,021,27897,2281,2244,503,2747,15
2021-03-07,Humboldt,023,135768,3291,3274,22,3296,31
2021-03-07,Imperial,025,180216,27352,27019,2556,29575,658
2021-03-07,Inyo,027,18085,1340,1320,9,1329,35
2021-03-07,Kern,029,883053,94217,92746,10001,102747,1086
2021-03-07,Kings,031,150075,22478,22103,997,23100,224
2021-03-07,Lake,033,64148,3235,3192,6,3198,42
2021-03-07,Lassen,035,31185,5134,5119,100,5219,1
2021-03-07,Los Angeles,037,10098052,1177394,1162749,39765,1202514,21857
2021-03-07,Madera,039,155013,15844,15675,859,16534,211
2021-03-07,Marin,041,260295,13401,13313,172,13485,214
2021-03-07,Mariposa,043,17540,378,376,5,381,5
2021-03-07,Mendocino,045,87422,3680,3581,72,3653,42
2021-03-07,Merced,047,269075,28886,28829,951,29780,399
2021-03-07,Modoc,049,8938,349,338,118,456,3
2021-03-07,Mono,051,14174,1192,1199,16,1215,3
2021-03-07,Monterey,053,433212,42169,41858,1718,43576,328
2021-03-07,Napa,055,140530,9161,9137,34,9171,75
2021-03-07,Nevada,057,99092,4113,4052,163,4215,66
2021-03-07,Orange,059,3164182,248578,246771,10360,257131,4218
2021-03-07,Placer,061,380077,20900,20070,1147,21217,239
2021-03-07,Plumas,063,18699,647,635,10,645,4
2021-03-07,Riverside,065,2383286,287119,280379,13534,293913,3779
2021-03-07,Sacramento,067,1510023,95802,94513,1299,95812,1437
2021-03-07,San Benito,069,59416,5783,5795,92,5887,61
2021-03-07,San Bernardino,071,2135413,287271,282860,8608,291468,3810
2021-03-07,San Diego,073,3302833,266481,262965,13133,276098,3390
2021-03-07,San Francisco,075,870044,34572,34594,1113,35707,445
2021-03-07,San Joaquin,077,732212,67723,66252,2867,69119,1139
2021-03-07,San Luis Obispo,079,281455,19951,19614,577,20191,245
2021-03-07,San Mateo,081,765935,39975,39436,413,39849,329
2021-03-07,Santa Barbara,083,443738,32684,32218,1066,33284,425
2021-03-07,Santa Clara,085,1922200,111835,111745,608,112353,1752
2021-03-07,Santa Cruz,087,273765,15558,14715,790,15505,189
2021-03-07,Shasta,089,179085,11052,11083,1274,12357,156
2021-03-07,Sierra,091,2930,51,48,12,60,0
2021-03-07,Siskiyou,093,43540,1537,1435,244,1679,5
2021-03-07,Solano,095,438530,30163,30027,374,30401,169
2021-03-07,Sonoma,097,501317,28452,28533,227,28760,284
2021-03-07,Stanislaus,099,539301,51389,50783,5441,56224,699
2021-03-07,Sutter,101,95872,8921,8900,81,8981,100
2021-03-07,Tehama,103,63373,4647,4614,501,5115,33
2021-03-07,Trinity,105,12862,468,302,80,382,3
2021-03-07,Tulare,107,460477,48689,47569,8293,55862,790
2021-03-07,Tuolumne,109,53932,3859,3922,34,3956,56
2021-03-07,Ventura,111,848112,78720,78487,2815,81302,851
2021-03-07,Yolo,113,214977,13010,12988,223,13211,189
2021-03-07,Yuba,115,75493,5594,5516,89,5605,42
2021-03-06,Alameda,001,1643700,81941,81310,1753,83063,1143
2021-03-06,Alpine,003,1148,82,78,0,78,0
2021-03-06,Amador,005,37829,3499,3487,32,3519,42
2021-03-06,Butte,007,227075,11456,11065,1610,12675,185
2021-03-06,Calaveras,009,45235,1939,1904,12,1916,48
2021-03-06,Colusa,011,21464,1881,1874,273,2147,11
2021-03-06,Contra Costa,013,1133247,64079,63040,1099,64139,719
2021-03-06,Del Norte,015,27424,1051,1000,5,1005,5
2021-03-06,El Dorado,017,186661,9245,9166,596,9762,97
2021-03-06,Fresno,019,978130,97598,96366,7908,104274,1440
2021-03-06,Glenn,021,27897,2281,2241,503,2744,15
2021-03-06,Humboldt,023,135768,3281,3260,22,3282,31
2021-03-06,Imperial,025,180216,27347,27009,2551,29560,658
2021-03-06,Inyo,027,18085,1337,1312,9,1321,35
2021-03-06,Kern,029,883053,94171,92684,9981,102665,1082
2021-03-06,Kings,031,150075,22463,22094,997,23091,224
2021-03-06,Lake,033,64148,3233,3189,6,3195,42
2021-03-06,Lassen,035,31185,5134,5119,100,5219,1
2021-03-06,Los Angeles,037,10098052,1176956,1161745,39735,1201480,21843
2021-03-06,Madera,039,155013,15835,15646,857,16503,211
2021-03-06,Marin,041,260295,13392,13289,172,13461,213
2021-03-06,Mariposa,043,17540,378,376,5,381,5
2021-03-06,Mendocino,045,87422,3678,3579,72,3651,42
2021-03-06,Merced,047,269075,28844,28771,951,29722,399
2021-03-06,Modoc,049,8938,348,338,118,456,3
2021-03-06,Mono,051,14174,1191,1198,16,1214,3
2021-03-06,Monterey,053,433212,42164,41838,1715,43553,327
2021-03-06,Napa,055,140530,9153,9129,34,9163,75
2021-03-06,Nevada,057,99092,4107,4044,163,4207,66
2021-03-06,Orange,059,3164182,248485,246634,10346,256980,4165
2021-03-06,Placer,061,380077,20877,20030,1145,21175,239
2021-03-06,Plumas,063,18699,647,634,10,644,4
2021-03-06,Riverside,065,2383286,287026,280225,13526,293751,3781
2021-03-06,Sacramento,067,1510023,95714,94332,1290,95622,1436
2021-03-06,San Benito,069,59416,5778,5793,92,5885,61
2021-03-06,San Bernardino,071,2135413,287187,282737,8606,291343,3791
2021-03-06,San Diego,073,3302833,266294,262778,13116,275894,3385
2021-03-06,San Francisco,075,870044,34541,34560,1109,35669,435
2021-03-06,San Joaquin,077,732212,67649,66162,2857,69019,1138
2021-03-06,San Luis Obispo,079,281455,19931,19592,575,20167,245
2021-03-06,San Mateo,081,765935,39950,39384,413,39797,329
2021-03-06,Santa Barbara,083,443738,32653,32176,1065,33241,424
2021-03-06,Santa Clara,085,1922200,111740,111570,606,112176,1749
2021-03-06,Santa Cruz,087,273765,15547,14701,790,15491,188
2021-03-06,Shasta,089,179085,11043,11076,1272,12348,158
2021-03-06,Sierra,091,2930,51,48,12,60,0
2021-03-06,Siskiyou,093,43540,1535,1432,244,1676,5
2021-03-06,Solano,095,438530,30134,30000,373,30373,169
2021-03-06,Sonoma,097,501317,28429,28484,225,28709,284
2021-03-06,Stanislaus,099,539301,51319,50691,5435,56126,711
2021-03-06,Sutter,101,95872,8915,8887,81,8968,100
2021-03-06,Tehama,103,63373,4645,4610,498,5108,33
2021-03-06,Trinity,105,12862,468,302,80,382,3
2021-03-06,Tulare,107,460477,48657,47515,8264,55779,789
2021-03-06,Tuolumne,109,53932,3857,3920,34,3954,56
2021-03-06,Ventura,111,848112,78664,78439,2814,81253,848
2021-03-06,Yolo,113,214977,13004,12951,223,13174,189
2021-03-06,Yuba,115,75493,5585,5504,89,5593,42
2021-03-05,Alameda,001,1643700,81855,81215,1751,82966,1141
2021-03-05,Alpine,003,1148,82,78,0,78,0
2021-03-05,Amador,005,37829,3498,3484,32,3516,42
2021-03-05,Butte,007,227075,11445,11050,1609,12659,185
2021-03-05,Calaveras,009,45235,1936,1902,12,1914,48
2021-03-05,Colusa,011,21464,1881,1874,273,2147,11
2021-03-05,Contra Costa,013,1133247,63999,62886,1096,63982,711
2021-03-05,Del Norte,015,27424,1047,995,5,1000,5
2021-03-05,El Dorado,017,186661,9240,9150,595,9745,97
2021-03-05,Fresno,019,978130,97490,96184,7889,104073,1432
2021-03-05,Glenn,021,27897,2278,2241,502,2743,15
2021-03-05,Humboldt,023,135768,3274,3234,22,3256,31
2021-03-05,Imperial,025,180216,27337,26970,2542,29512,651
2021-03-05,Inyo,027,18085,1333,1309,9,1318,35
2021-03-05,Kern,029,883053,94131,92601,9968,102569,1076
2021-03-05,Kings,031,150075,22445,22063,996,23059,224
2021-03-05,Lake,033,64148,3231,3185,6,3191,42
2021-03-05,Lassen,035,31185,5134,5117,98,5215,1
2021-03-05,Los Angeles,037,10098052,1176466,1160688,39704,1200392,21745
2021-03-05,Madera,039,155013,15825,15624,855,16479,211
2021-03-05,Marin,041,260295,13380,13275,171,13446,215
2021-03-05,Mariposa,043,17540,378,375,5,380,4
2021-03-05,Mendocino,045,87422,3675,3577,72,3649,42
2021-03-05,Merced,047,269075,28811,28734,950,29684,399
2021-03-05,Modoc,049,8938,348,337,118,455,3
2021-03-05,Mono,051,14174,1190,1197,16,1213,3
2021-03-05,Monterey,053,433212,42151,41802,1715,43517,325
2021-03-05,Napa,055,140530,9145,9109,34,9143,75
2021-03-05,Nevada,057,99092,4103,4033,163,4196,66
2021-03-05,Orange,059,3164182,248372,246489,10333,256822,4108
2021-03-05,Placer,061,380077,20851,19973,1141,21114,239
2021-03-05,Plumas,063,18699,647,635,10,645,4
2021-03-05,Riverside,065,2383286,286914,280075,13521,293596,3781
2021-03-05,Sacramento,067,1510023,95618,94182,1283,95465,1430
2021-03-05,San Benito,069,59416,5775,5790,92,5882,61
2021-03-05,San Bernardino,071,2135413,287094,282640,8602,291242,3774
2021-03-05,San Diego,073,3302833,266061,262357,13099,275456,3371
2021-03-05,San Francisco,075,870044,34501,34526,1105,35631,430
2021-03-05,San Joaquin,077,732212,67569,66041,2848,68889,1133
2021-03-05,San Luis Obispo,079,281455,19910,19557,573,20130,244
2021-03-05,San Mateo,081,765935,39918,39305,413,39718,326
2021-03-05,Santa Barbara,083,443738,32616,32139,1060,33199,424
2021-03-05,Santa Clara,085,1922200,111645,111384,606,111990,1745
2021-03-05,Santa Cruz,087,273765,15536,14694,790,15484,188
2021-03-05,Shasta,089,179085,11031,11062,1266,12328,148
2021-03-05,Sierra,091,2930,51,48,12,60,0
2021-03-05,Siskiyou,093,43540,1530,1429,243,1672,5
2021-03-05,Solano,095,438530,30117,29951,371,30322,168
2021-03-05,Sonoma,097,501317,28403,28417,225,28642,279
2021-03-05,Stanislaus,099,539301,51268,50606,5425,56031,721
2021-03-05,Sutter,101,95872,8908,8876,81,8957,100
2021-03-05,Tehama,103,63373,4636,4606,498,5104,33
2021-03-05,Trinity,105,12862,468,302,80,382,3
2021-03-05,Tulare,107,460477,48628,47469,8245,55714,789
2021-03-05,Tuolumne,109,53932,3855,3917,34,3951,56
2021-03-05,Ventura,111,848112,78597,78368,2813,81181,839
2021-03-05,Yolo,113,214977,12992,12920,222,13142,188
2021-03-05,Yuba,115,75493,5573,5496,89,5585,42
2021-03-04,Alameda,001,1643700,81744,81115,1751,82866,1136
2021-03-04,Alpine,003,1148,82,78,0,78,0
2021-03-04,Amador,005,37829,3497,3480,32,3512,42
2021-03-04,Butte,007,227075,11438,11033,1608,12641,185
2021-03-04,Calaveras,009,45235,1935,1896,12,1908,48
2021-03-04,Colusa,011,21464,1879,1873,268,2141,11
2021-03-04,Contra Costa,013,1133247,63899,62789,1094,63883,708
2021-03-04,Del Norte,015,27424,1039,989,5,994,5
2021-03-04,El Dorado,017,186661,9225,9133,595,9728,97
2021-03-04,Fresno,019,978130,97326,96023,7869,103892,1422
2021-03-04,Glenn,021,27897,2271,2236,501,2737,15
2021-03-04,Humboldt,023,135768,3260,3212,22,3234,31
2021-03-04,Imperial,025,180216,27324,26946,2539,29485,646
2021-03-04,Inyo,027,18085,1330,1300,9,1309,35
2021-03-04,Kern,029,883053,94042,92525,9949,102474,1070
2021-03-04,Kings,031,150075,22419,22025,993,23018,224
2021-03-04,Lake,033,64148,3223,3181,6,3187,42
2021-03-04,Lassen,035,31185,5134,5116,98,5214,1
2021-03-04,Los Angeles,037,10098052,1175856,1159405,39655,1199060,21610
2021-03-04,Madera,039,155013,15790,15596,852,16448,208
2021-03-04,Marin,041,260295,13364,13240,168,13408,215
2021-03-04,Mariposa,043,17540,378,376,5,381,4
2021-03-04,Mendocino,045,87422,3672,3569,72,3641,42
2021-03-04,Merced,047,269075,28760,28671,948,29619,396
2021-03-04,Modoc,049,8938,347,336,118,454,3
2021-03-04,Mono,051,14174,1190,1197,16,1213,3
2021-03-04,Monterey,053,433212,42131,41771,1713,43484,325
2021-03-04,Napa,055,140530,9137,9094,34,9128,74
2021-03-04,Nevada,057,99092,4093,4020,163,4183,66
2021-03-04,Orange,059,3164182,248215,246354,10316,256670,4096
2021-03-04,Placer,061,380077,20819,19900,1135,21035,239
2021-03-04,Plumas,063,18699,647,634,10,644,4
2021-03-04,Riverside,065,2383286,286784,279871,13508,293379,3766
2021-03-04,Sacramento,067,1510023,95483,93982,1280,95262,1426
2021-03-04,San Benito,069,59416,5775,5781,92,5873,61
2021-03-04,San Bernardino,071,2135413,286964,282407,8598,291005,3757
2021-03-04,San Diego,073,3302833,265801,261858,13055,274913,3359
2021-03-04,San Francisco,075,870044,34466,34480,1102,35582,426
2021-03-04,San Joaquin,077,732212,67475,65931,2838,68769,1129
2021-03-04,San Luis Obispo,079,281455,19873,19520,571,20091,243
2021-03-04,San Mateo,081,765935,39874,39225,412,39637,322
2021-03-04,Santa Barbara,083,443738,32579,32090,1059,33149,423
2021-03-04,Santa Clara,085,1922200,111511,111194,604,111798,1723
2021-03-04,Santa Cruz,087,273765,15517,14669,790,15459,186
2021-03-04,Shasta,089,179085,11028,11050,1257,12307,150
2021-03-04,Sierra,091,2930,51,48,12,60,0
2021-03-04,Siskiyou,093,43540,1523,1427,243,1670,5
2021-03-04,Solano,095,438530,30090,29905,370,30275,168
2021-03-04,Sonoma,097,501317,28348,28379,224,28603,279
2021-03-04,Stanislaus,099,539301,51181,50521,5417,55938,731
2021-03-04,Sutter,101,95872,8896,8849,81,8930,100
2021-03-04,Tehama,103,63373,4629,4604,498,5102,33
2021-03-04,Trinity,105,12862,468,302,80,382,3
2021-03-04,Tulare,107,460477,48583,47398,8220,55618,784
2021-03-04,Tuolumne,109,53932,3849,3916,34,3950,56
2021-03-04,Ventura,111,848112,78507,78184,2810,80994,831
2021-03-04,Yolo,113,214977,12972,12895,222,13117,189
2021-03-04,Yuba,115,75493,5561,5483,89,5572,41
2021-03-03,Alameda,001,1643700,81622,80972,1750,82722,1127
2021-03-03,Alpine,003,1148,82,77,0,77,0
2021-03-03,Amador,005,37829,3495,3478,31,3509,42
2021-03-03,Butte,007,227075,11430,11014,1607,12621,184
2021-03-03,Calaveras,009,45235,1934,1893,12,1905,48
2021-03-03,Colusa,011,21464,1878,1873,268,2141,11
2021-03-03,Contra Costa,013,1133247,63800,62668,1091,63759,708
2021-03-03,Del Norte,015,27424,1036,988,5,993,5
2021-03-03,El Dorado,017,186661,9215,9121,595,9716,97
2021-03-03,Fresno,019,978130,97182,95893,7851,103744,1415
2021-03-03,Glenn,021,27897,2271,2233,501,2734,15
2021-03-03,Humboldt,023,135768,3249,3196,22,3218,30
2021-03-03,Imperial,025,180216,27308,26939,2535,29474,640
2021-03-03,Inyo,027,18085,1322,1294,9,1303,35
2021-03-03,Kern,029,883053,93966,92434,9932,102366,1063
2021-03-03,Kings,031,150075,22403,22009,992,23001,223
2021-03-03,Lake,033,64148,3216,3175,6,3181,40
2021-03-03,Lassen,035,31185,5134,5115,98,5213,1
2021-03-03,Los Angeles,037,10098052,1175216,1157911,39614,1197525,21500
2021-03-03,Madera,039,155013,15771,15553,846,16399,203
2021-03-03,Marin,041,260295,13350,13216,168,13384,214
2021-03-03,Mariposa,043,17540,377,376,5,381,4
2021-03-03,Mendocino,045,87422,3664,3564,72,3636,42
2021-03-03,Merced,047,269075,28708,28625,948,29573,393
2021-03-03,Modoc,049,8938,347,333,117,450,3
2021-03-03,Mono,051,14174,1190,1191,16,1207,3
2021-03-03,Monterey,053,433212,42099,41731,1710,43441,325
2021-03-03,Napa,055,140530,9129,9090,34,9124,72
2021-03-03,Nevada,057,99092,4083,4009,163,4172,66
2021-03-03,Orange,059,3164182,248070,246120,10301,256421,4072
2021-03-03,Placer,061,380077,20793,19851,1132,20983,239
2021-03-03,Plumas,063,18699,646,631,10,641,4
2021-03-03,Riverside,065,2383286,286651,279626,13502,293128,3735
2021-03-03,Sacramento,067,1510023,95322,93819,1272,95091,1419
2021-03-03,San Benito,069,59416,5774,5774,92,5866,61
2021-03-03,San Bernardino,071,2135413,286822,282138,8591,290729,3664
2021-03-03,San Diego,073,3302833,265537,261350,13024,274374,3342
2021-03-03,San Francisco,075,870044,34434,34443,1099,35542,426
2021-03-03,San Joaquin,077,732212,67363,65855,2831,68686,1115
2021-03-03,San Luis Obispo,079,281455,19847,19479,568,20047,241
2021-03-03,San Mateo,081,765935,39828,39189,411,39600,319
2021-03-03,Santa Barbara,083,443738,32541,32027,1059,33086,421
2021-03-03,Santa Clara,085,1922200,111357,110991,602,111593,1720
2021-03-03,Santa Cruz,087,273765,15506,14645,790,15435,185
2021-03-03,Shasta,089,179085,11018,11023,1250,12273,150
2021-03-03,Sierra,091,2930,51,48,12,60,0
2021-03-03,Siskiyou,093,43540,1521,1424,243,1667,5
2021-03-03,Solano,095,438530,30054,29866,369,30235,167
2021-03-03,Sonoma,097,501317,28309,28307,223,28530,279
2021-03-03,Stanislaus,099,539301,51103,50438,5410,55848,730
2021-03-03,Sutter,101,95872,8888,8840,81,8921,99
2021-03-03,Tehama,103,63373,4627,4601,498,5099,32
2021-03-03,Trinity,105,12862,468,302,80,382,3
2021-03-03,Tulare,107,460477,48532,47348,8189,55537,778
2021-03-03,Tuolumne,109,53932,3847,3914,33,3947,56
2021-03-03,Ventura,111,848112,78423,78057,2805,80862,822
2021-03-03,Yolo,113,214977,12959,12890,222,13112,189
2021-03-03,Yuba,115,75493,5548,5479,89,5568,41
2021-03-02,Alameda,001,1643700,81501,80904,1748,82652,1116
2021-03-02,Alpine,003,1148,82,77,0,77,0
2021-03-02,Amador,005,37829,3493,3474,31,3505,42
2021-03-02,Butte,007,227075,11420,11007,1604,12611,182
2021-03-02,Calaveras,009,45235,1926,1890,12,1902,48
2021-03-02,Colusa,011,21464,1878,1872,267,2139,11
2021-03-02,Contra Costa,013,1133247,63689,62557,1087,63644,694
2021-03-02,Del Norte,015,27424,1029,983,5,988,5
2021-03-02,El Dorado,017,186661,9207,9116,595,9711,98
2021-03-02,Fresno,019,978130,97036,95785,7825,103610,1410
2021-03-02,Glenn,021,27897,2265,2232,500,2732,15
2021-03-02,Humboldt,023,135768,3230,3184,22,3206,30
2021-03-02,Imperial,025,180216,27298,26926,2533,29459,637
2021-03-02,Inyo,027,18085,1318,1292,9,1301,35
2021-03-02,Kern,029,883053,93860,92313,9905,102218,1046
2021-03-02,Kings,031,150075,22351,21999,989,22988,217
2021-03-02,Lake,033,64148,3210,3169,6,3175,40
2021-03-02,Lassen,035,31185,5129,5115,97,5212,1
2021-03-02,Los Angeles,037,10098052,1174581,1156826,39568,1196394,21395
2021-03-02,Madera,039,155013,15751,15523,843,16366,194
2021-03-02,Marin,041,260295,13327,13186,167,13353,214
2021-03-02,Mariposa,043,17540,377,376,5,381,4
2021-03-02,Mendocino,045,87422,3661,3562,71,3633,41
2021-03-02,Merced,047,269075,28651,28598,948,29546,389
2021-03-02,Modoc,049,8938,347,332,117,449,3
2021-03-02,Mono,051,14174,1189,1191,16,1207,3
2021-03-02,Monterey,053,433212,42072,41716,1709,43425,325
2021-03-02,Napa,055,140530,9117,9080,34,9114,71
2021-03-02,Nevada,057,99092,4074,3983,162,4145,66
2021-03-02,Orange,059,3164182,247924,246004,10283,256287,4037
2021-03-02,Placer,061,380077,20740,19828,1129,20957,239
2021-03-02,Plumas,063,18699,643,628,10,638,4
2021-03-02,Riverside,065,2383286,286478,279486,13494,292980,3721
2021-03-02,Sacramento,067,1510023,95155,93690,1271,94961,1411
2021-03-02,San Benito,069,59416,5767,5770,92,5862,60
2021-03-02,San Bernardino,071,2135413,286688,281919,8585,290504,3604
2021-03-02,San Diego,073,3302833,265293,260998,13002,274000,3317
2021-03-02,San Francisco,075,870044,34394,34387,1095,35482,424
2021-03-02,San Joaquin,077,732212,67255,65769,2813,68582,1111
2021-03-02,San Luis Obispo,079,281455,19815,19452,568,20020,241
2021-03-02,San Mateo,081,765935,39776,39148,410,39558,317
2021-03-02,Santa Barbara,083,443738,32492,31964,1055,33019,416
2021-03-02,Santa Clara,085,1922200,111178,110832,601,111433,1706
2021-03-02,Santa Cruz,087,273765,15492,14611,788,15399,185
2021-03-02,Shasta,089,179085,11004,11012,1239,12251,149
2021-03-02,Sierra,091,2930,51,48,12,60,0
2021-03-02,Siskiyou,093,43540,1517,1412,241,1653,5
2021-03-02,Solano,095,438530,30021,29827,367,30194,167
2021-03-02,Sonoma,097,501317,28254,28261,223,28484,279
2021-03-02,Stanislaus,099,539301,51016,50359,5398,55757,724
2021-03-02,Sutter,101,95872,8879,8832,81,8913,99
2021-03-02,Tehama,103,63373,4623,4597,497,5094,32
2021-03-02,Trinity,105,12862,468,301,80,381,3
2021-03-02,Tulare,107,460477,48469,47326,8169,55495,783
2021-03-02,Tuolumne,109,53932,3843,3908,33,3941,53
2021-03-02,Ventura,111,848112,78330,77952,2801,80753,780
2021-03-02,Yolo,113,214977,12943,12867,222,13089,189
2021-03-02,Yuba,115,75493,5540,5475,89,5564,41
2021-03-01,Alameda,001,1643700,81374,80805,1746,82551,1105
2021-03-01,Alpine,003,1148,80,77,0,77,0
2021-03-01,Amador,005,37829,3490,3469,31,3500,42
2021-03-01,Butte,007,227075,11405,10981,1599,12580,180
2021-03-01,Calaveras,009,45235,1921,1885,12,1897,46
2021-03-01,Colusa,011,21464,1877,1871,267,2138,11
2021-03-01,Contra Costa,013,1133247,63579,62458,1086,63544,694
2021-03-01,Del Norte,015,27424,1024,982,5,987,5
2021-03-01,El Dorado,017,186661,9183,9085,595,9680,98
2021-03-01,Fresno,019,978130,96898,95677,7803,103480,1405
2021-03-01,Glenn,021,27897,2260,2232,499,2731,15
2021-03-01,Humboldt,023,135768,3211,3179,22,3201,30
2021-03-01,Imperial,025,180216,27288,26913,2525,29438,636
2021-03-01,Inyo,027,18085,1315,1285,9,1294,35
2021-03-01,Kern,029,883053,93771,92219,9879,102098,1041
2021-03-01,Kings,031,150075,22334,21988,983,22971,217
2021-03-01,Lake,033,64148,3205,3164,6,3170,40
2021-03-01,Lassen,035,31185,5127,5111,97,5208,1
2021-03-01,Los Angeles,037,10098052,1173923,1155984,39526,1195510,21293
2021-03-01,Madera,039,155013,15722,15505,832,16337,194
2021-03-01,Marin,041,260295,13299,13161,166,13327,214
2021-03-01,Mariposa,043,17540,377,375,5,380,4
2021-03-01,Mendocino,045,87422,3654,3561,71,3632,41
2021-03-01,Merced,047,269075,28606,28575,944,29519,385
2021-03-01,Modoc,049,8938,344,331,116,447,3
2021-03-01,Mono,051,14174,1188,1192,16,1208,3
2021-03-01,Monterey,053,433212,42047,41697,1707,43404,324
2021-03-01,Napa,055,140530,9108,9056,34,9090,70
2021-03-01,Nevada,057,99092,4055,3979,162,4141,66
2021-03-01,Orange,059,3164182,247729,245852,10268,256120,3976
2021-03-01,Placer,061,380077,20701,19803,1126,20929,239
2021-03-01,Plumas,063,18699,643,628,10,638,4
2021-03-01,Riverside,065,2383286,286261,279323,13487,292810,3680
2021-03-01,Sacramento,067,1510023,95010,93546,1269,94815,1401
2021-03-01,San Benito,069,59416,5762,5772,92,5864,57
2021-03-01,San Bernardino,071,2135413,286545,281685,8581,290266,3603
2021-03-01,San Diego,073,3302833,264974,260622,12969,273591,3303
2021-03-01,San Francisco,075,870044,34350,34318,1087,35405,424
2021-03-01,San Joaquin,077,732212,67146,65699,2802,68501,1097
2021-03-01,San Luis Obispo,079,281455,19793,19429,566,19995,239
2021-03-01,San Mateo,081,765935,39724,39096,409,39505,314
2021-03-01,Santa Barbara,083,443738,32449,31909,1054,32963,413
2021-03-01,Santa Clara,085,1922200,111019,110684,598,111282,1704
2021-03-01,Santa Cruz,087,273765,15473,14575,787,15362,185
2021-03-01,Shasta,089,179085,10992,10990,1236,12226,149
2021-03-01,Sierra,091,2930,51,48,12,60,0
2021-03-01,Siskiyou,093,43540,1513,1408,239,1647,5
2021-03-01,Solano,095,438530,29978,29779,366,30145,166
2021-03-01,Sonoma,097,501317,28206,28222,221,28443,278
2021-03-01,Stanislaus,099,539301,50940,50293,5392,55685,722
2021-03-01,Sutter,101,95872,8868,8825,81,8906,99
2021-03-01,Tehama,103,63373,4617,4595,497,5092,32
2021-03-01,Trinity,105,12862,468,298,79,377,3
2021-03-01,Tulare,107,460477,48431,47275,8136,55411,781
2021-03-01,Tuolumne,109,53932,3840,3907,33,3940,53
2021-03-01,Ventura,111,848112,78249,77849,2799,80648,775
2021-03-01,Yolo,113,214977,12926,12854,220,13074,188
2021-03-01,Yuba,115,75493,5528,5466,89,5555,41
2021-02-28,Alameda,001,1643700,81253,80727,1744,82471,1105
2021-02-28,Alpine,003,1148,80,77,0,77,0
2021-02-28,Amador,005,37829,3485,3466,30,3496,42
2021-02-28,Butte,007,227075,11390,10970,1599,12569,180
2021-02-28,Calaveras,009,45235,1917,1881,12,1893,46
2021-02-28,Colusa,011,21464,1877,1871,266,2137,11
2021-02-28,Contra Costa,013,1133247,63452,62386,1081,63467,694
2021-02-28,Del Norte,015,27424,1022,981,5,986,5
2021-02-28,El Dorado,017,186661,9172,9082,595,9677,98
2021-02-28,Fresno,019,978130,96716,95548,7769,103317,1405
2021-02-28,Glenn,021,27897,2258,2230,497,2727,15
2021-02-28,Humboldt,023,135768,3188,3179,22,3201,30
2021-02-28,Imperial,025,180216,27262,26909,2521,29430,636
2021-02-28,Inyo,027,18085,1310,1282,9,1291,35
2021-02-28,Kern,029,883053,93656,92169,9858,102027,1012
2021-02-28,Kings,031,150075,22313,21967,982,22949,217
2021-02-28,Lake,033,64148,3200,3164,6,3170,40
2021-02-28,Lassen,035,31185,5126,5106,97,5203,1
2021-02-28,Los Angeles,037,10098052,1173136,1155141,39464,1194605,21261
2021-02-28,Madera,039,155013,15680,15496,829,16325,199
2021-02-28,Marin,041,260295,13276,13152,164,13316,214
2021-02-28,Mariposa,043,17540,377,374,5,379,4
2021-02-28,Mendocino,045,87422,3648,3558,71,3629,41
2021-02-28,Merced,047,269075,28543,28546,943,29489,384
2021-02-28,Modoc,049,8938,344,331,116,447,3
2021-02-28,Mono,051,14174,1185,1192,16,1208,3
2021-02-28,Monterey,053,433212,42015,41683,1706,43389,323
2021-02-28,Napa,055,140530,9089,9053,34,9087,70
2021-02-28,Nevada,057,99092,4042,3972,162,4134,66
2021-02-28,Orange,059,3164182,247531,245706,10261,255967,3970
2021-02-28,Placer,061,380077,20655,19775,1124,20899,239
2021-02-28,Plumas,063,18699,643,628,10,638,4
2021-02-28,Riverside,065,2383286,286028,279214,13476,292690,3661
2021-02-28,Sacramento,067,1510023,94826,93463,1264,94727,1398
2021-02-28,San Benito,069,59416,5751,5772,92,5864,57
2021-02-28,San Bernardino,071,2135413,286404,281620,8569,290189,3595
2021-02-28,San Diego,073,3302833,264677,260353,12935,273288,3303
2021-02-28,San Francisco,075,870044,34308,34291,1081,35372,417
2021-02-28,San Joaquin,077,732212,67039,65662,2793,68455,1097
2021-02-28,San Luis Obispo,079,281455,19757,19422,564,19986,237
2021-02-28,San Mateo,081,765935,39671,39059,408,39467,314
2021-02-28,Santa Barbara,083,443738,32396,31877,1054,32931,413
2021-02-28,Santa Clara,085,1922200,110820,110556,595,111151,1704
2021-02-28,Santa Cruz,087,273765,15444,14571,784,15355,185
2021-02-28,Shasta,089,179085,10971,10990,1232,12222,149
2021-02-28,Sierra,091,2930,51,48,12,60,0
2021-02-28,Siskiyou,093,43540,1505,1408,239,1647,5
2021-02-28,Solano,095,438530,29923,29758,360,30118,166
2021-02-28,Sonoma,097,501317,28143,28193,220,28413,279
2021-02-28,Stanislaus,099,539301,50850,50228,5379,55607,728
2021-02-28,Sutter,101,95872,8853,8825,81,8906,99
2021-02-28,Tehama,103,63373,4611,4590,497,5087,32
2021-02-28,Trinity,105,12862,468,298,79,377,3
2021-02-28,Tulare,107,460477,48369,47258,8105,55363,780
2021-02-28,Tuolumne,109,53932,3835,3905,33,3938,53
2021-02-28,Ventura,111,848112,78137,77749,2796,80545,775
2021-02-28,Yolo,113,214977,12904,12851,220,13071,188
2021-02-28,Yuba,115,75493,5518,5461,89,5550,41
2021-02-27,Alameda,001,1643700,81181,80565,1742,82307,1108
2021-02-27,Alpine,003,1148,80,77,0,77,0
2021-02-27,Amador,005,37829,3483,3463,30,3493,42
2021-02-27,Butte,007,227075,11378,10962,1599,12561,180
2021-02-27,Calaveras,009,45235,1912,1875,12,1887,46
2021-02-27,Colusa,011,21464,1876,1869,266,2135,11
2021-02-27,Contra Costa,013,1133247,63382,62248,1078,63326,693
2021-02-27,Del Norte,015,27424,1020,978,5,983,5
2021-02-27,El Dorado,017,186661,9168,9072,595,9667,98
2021-02-27,Fresno,019,978130,96639,95393,7758,103151,1400
2021-02-27,Glenn,021,27897,2257,2225,496,2721,15
2021-02-27,Humboldt,023,135768,3182,3167,22,3189,30
2021-02-27,Imperial,025,180216,27254,26903,2519,29422,633
2021-02-27,Inyo,027,18085,1307,1275,9,1284,35
2021-02-27,Kern,029,883053,93595,92053,9843,101896,996
2021-02-27,Kings,031,150075,22303,21955,979,22934,216
2021-02-27,Lake,033,64148,3197,3156,6,3162,40
2021-02-27,Lassen,035,31185,5126,5106,97,5203,1
2021-02-27,Los Angeles,037,10098052,1172639,1154275,39437,1193712,21158
2021-02-27,Madera,039,155013,15663,15467,828,16295,199
2021-02-27,Marin,041,260295,13252,13134,164,13298,214
2021-02-27,Mariposa,043,17540,377,374,5,379,4
2021-02-27,Mendocino,045,87422,3645,3555,71,3626,41
2021-02-27,Merced,047,269075,28501,28501,935,29436,384
2021-02-27,Modoc,049,8938,344,331,115,446,3
2021-02-27,Mono,051,14174,1183,1191,16,1207,3
2021-02-27,Monterey,053,433212,42006,41665,1705,43370,322
2021-02-27,Napa,055,140530,9078,9038,34,9072,71
2021-02-27,Nevada,057,99092,4036,3960,162,4122,66
2021-02-27,Orange,059,3164182,247404,245542,10250,255792,3960
2021-02-27,Placer,061,380077,20619,19726,1121,20847,239
2021-02-27,Plumas,063,18699,643,628,10,638,4
2021-02-27,Riverside,065,2383286,285918,279048,13466,292514,3663
2021-02-27,Sacramento,067,1510023,94743,93281,1254,94535,1396
2021-02-27,San Benito,069,59416,5750,5767,91,5858,57
2021-02-27,San Bernardino,071,2135413,286325,281471,8562,290033,3527
2021-02-27,San Diego,073,3302833,264487,260091,12897,272988,3284
2021-02-27,San Francisco,075,870044,34274,34260,1078,35338,413
2021-02-27,San Joaquin,077,732212,66993,65578,2791,68369,1100
2021-02-27,San Luis Obispo,079,281455,19736,19411,563,19974,237
2021-02-27,San Mateo,081,765935,39630,38998,407,39405,313
2021-02-27,Santa Barbara,083,443738,32362,31805,1053,32858,411
2021-02-27,Santa Clara,085,1922200,110672,110361,593,110954,1703
2021-02-27,Santa Cruz,087,273765,15435,14552,783,15335,185
2021-02-27,Shasta,089,179085,10965,10985,1228,12213,149
2021-02-27,Sierra,091,2930,51,48,12,60,0
2021-02-27,Siskiyou,093,43540,1503,1407,238,1645,5
2021-02-27,Solano,095,438530,29895,29718,359,30077,165
2021-02-27,Sonoma,097,501317,28099,28141,214,28355,281
2021-02-27,Stanislaus,099,539301,50795,50147,5369,55516,733
2021-02-27,Sutter,101,95872,8848,8820,81,8901,99
2021-02-27,Tehama,103,63373,4607,4584,496,5080,32
2021-02-27,Trinity,105,12862,468,298,79,377,3
2021-02-27,Tulare,107,460477,48332,47209,8079,55288,770
2021-02-27,Tuolumne,109,53932,3832,3899,33,3932,53
2021-02-27,Ventura,111,848112,78064,77623,2793,80416,771
2021-02-27,Yolo,113,214977,12892,12834,220,13054,188
2021-02-27,Yuba,115,75493,5515,5450,89,5539,39
2021-02-26,Alameda,001,1643700,81086,80387,1737,82124,1106
2021-02-26,Alpine,003,1148,80,77,0,77,0
2021-02-26,Amador,005,37829,3477,3457,30,3487,42
2021-02-26,Butte,007,227075,11368,10941,1599,12540,180
2021-02-26,Calaveras,009,45235,1910,1873,12,1885,46
2021-02-26,Colusa,011,21464,1876,1865,266,2131,11
2021-02-26,Contra Costa,013,1133247,63299,62114,1078,63192,685
2021-02-26,Del Norte,015,27424,1016,968,5,973,5
2021-02-26,El Dorado,017,186661,9163,9038,593,9631,98
2021-02-26,Fresno,019,978130,96536,95202,7750,102952,1391
2021-02-26,Glenn,021,27897,2254,2220,496,2716,15
2021-02-26,Humboldt,023,135768,3176,3152,22,3174,30
2021-02-26,Imperial,025,180216,27247,26888,2517,29405,631
2021-02-26,Inyo,027,18085,1305,1271,9,1280,34
2021-02-26,Kern,029,883053,93516,91884,9827,101711,997
2021-02-26,Kings,031,150075,22287,21917,976,22893,216
2021-02-26,Lake,033,64148,3192,3153,6,3159,40
2021-02-26,Lassen,035,31185,5126,5102,97,5199,1
2021-02-26,Los Angeles,037,10098052,1172064,1153131,39373,1192504,21070
2021-02-26,Madera,039,155013,15647,15436,826,16262,199
2021-02-26,Marin,041,260295,13239,13091,164,13255,214
2021-02-26,Mariposa,043,17540,377,375,5,380,4
2021-02-26,Mendocino,045,87422,3640,3549,71,3620,41
2021-02-26,Merced,047,269075,28467,28455,934,29389,382
2021-02-26,Modoc,049,8938,343,330,115,445,3
2021-02-26,Mono,051,14174,1181,1191,16,1207,3
2021-02-26,Monterey,053,433212,41980,41607,1704,43311,322
2021-02-26,Napa,055,140530,9072,9014,34,9048,70
2021-02-26,Nevada,057,99092,4025,3952,162,4114,66
2021-02-26,Orange,059,3164182,247265,245278,10240,255518,3918
2021-02-26,Placer,061,380077,20593,19712,1115,20827,239
2021-02-26,Plumas,063,18699,643,628,10,638,4
2021-02-26,Riverside,065,2383286,285774,278772,13460,292232,3653
2021-02-26,Sacramento,067,1510023,94620,93180,1251,94431,1390
2021-02-26,San Benito,069,59416,5749,5759,91,5850,57
2021-02-26,San Bernardino,071,2135413,286225,281132,8560,289692,3461
2021-02-26,San Diego,073,3302833,264260,259641,12876,272517,3271
2021-02-26,San Francisco,075,870044,34244,34213,1074,35287,413
2021-02-26,San Joaquin,077,732212,66912,65492,2785,68277,1070
2021-02-26,San Luis Obispo,079,281455,19720,19359,561,19920,234
2021-02-26,San Mateo,081,765935,39584,38922,407,39329,313
2021-02-26,Santa Barbara,083,443738,32318,31724,1052,32776,410
2021-02-26,Santa Clara,085,1922200,110540,110168,591,110759,1700
2021-02-26,Santa Cruz,087,273765,15423,14528,782,15310,185
2021-02-26,Shasta,089,179085,10958,10972,1219,12191,149
2021-02-26,Sierra,091,2930,51,47,12,59,0
2021-02-26,Siskiyou,093,43540,1503,1401,237,1638,5
2021-02-26,Solano,095,438530,29861,29651,358,30009,165
2021-02-26,Sonoma,097,501317,28070,28063,213,28276,280
2021-02-26,Stanislaus,099,539301,50739,50054,5361,55415,737
2021-02-26,Sutter,101,95872,8839,8806,81,8887,99
2021-02-26,Tehama,103,63373,4605,4581,496,5077,32
2021-02-26,Trinity,105,12862,467,298,79,377,3
2021-02-26,Tulare,107,460477,48297,47135,8048,55183,770
2021-02-26,Tuolumne,109,53932,3831,3896,33,3929,53
2021-02-26,Ventura,111,848112,77964,77534,2789,80323,765
2021-02-26,Yolo,113,214977,12885,12816,220,13036,188
2021-02-26,Yuba,115,75493,5510,5438,89,5527,39
2021-02-25,Alameda,001,1643700,80964,80181,1736,81917,1093
2021-02-25,Alpine,003,1148,80,77,0,77,0
2021-02-25,Amador,005,37829,3474,3448,30,3478,41
2021-02-25,Butte,007,227075,11347,10922,1594,12516,178
2021-02-25,Calaveras,009,45235,1902,1868,12,1880,46
2021-02-25,Colusa,011,21464,1873,1863,265,2128,11
2021-02-25,Contra Costa,013,1133247,63197,61910,1078,62988,686
2021-02-25,Del Norte,015,27424,1006,966,5,971,5
2021-02-25,El Dorado,017,186661,9147,9012,593,9605,98
2021-02-25,Fresno,019,978130,96392,95015,7727,102742,1377
2021-02-25,Glenn,021,27897,2251,2219,495,2714,15
2021-02-25,Humboldt,023,135768,3169,3129,22,3151,30
2021-02-25,Imperial,025,180216,27240,26855,2513,29368,628
2021-02-25,Inyo,027,18085,1299,1264,9,1273,33
2021-02-25,Kern,029,883053,93400,91735,9802,101537,992
2021-02-25,Kings,031,150075,22278,21900,973,22873,216
2021-02-25,Lake,033,64148,3183,3141,6,3147,40
2021-02-25,Lassen,035,31185,5125,5097,96,5193,1
2021-02-25,Los Angeles,037,10098052,1171321,1151846,39315,1191161,20931
2021-02-25,Madera,039,155013,15612,15414,822,16236,194
2021-02-25,Marin,041,260295,13216,13067,164,13231,214
2021-02-25,Mariposa,043,17540,377,375,5,380,4
2021-02-25,Mendocino,045,87422,3635,3542,71,3613,41
2021-02-25,Merced,047,269075,28418,28383,932,29315,382
2021-02-25,Modoc,049,8938,343,329,115,444,3
2021-02-25,Mono,051,14174,1180,1190,16,1206,3
2021-02-25,Monterey,053,433212,41955,41564,1699,43263,321
2021-02-25,Napa,055,140530,9046,8998,34,9032,70
2021-02-25,Nevada,057,99092,4008,3940,161,4101,66
2021-02-25,Orange,059,3164182,247092,245000,10230,255230,3882
2021-02-25,Placer,061,380077,20554,19661,1113,20774,239
2021-02-25,Plumas,063,18699,643,626,10,636,4
2021-02-25,Riverside,065,2383286,285586,278544,13439,291983,3646
2021-02-25,Sacramento,067,1510023,94462,92961,1239,94200,1386
2021-02-25,San Benito,069,59416,5744,5752,91,5843,58
2021-02-25,San Bernardino,071,2135413,286090,280946,8552,289498,3409
2021-02-25,San Diego,073,3302833,263966,258979,12846,271825,3260
2021-02-25,San Francisco,075,870044,34201,34138,1071,35209,408
2021-02-25,San Joaquin,077,732212,66828,65389,2773,68162,1047
2021-02-25,San Luis Obispo,079,281455,19699,19335,559,19894,234
2021-02-25,San Mateo,081,765935,39537,38872,407,39279,300
2021-02-25,Santa Barbara,083,443738,32241,31631,1051,32682,408
2021-02-25,Santa Clara,085,1922200,110375,109923,590,110513,1677
2021-02-25,Santa Cruz,087,273765,15404,14492,781,15273,185
2021-02-25,Shasta,089,179085,10946,10947,1214,12161,148
2021-02-25,Sierra,091,2930,51,47,12,59,0
2021-02-25,Siskiyou,093,43540,1498,1390,234,1624,4
2021-02-25,Solano,095,438530,29829,29616,358,29974,161
2021-02-25,Sonoma,097,501317,28016,28004,210,28214,278
2021-02-25,Stanislaus,099,539301,50648,49964,5351,55315,738
2021-02-25,Sutter,101,95872,8825,8789,80,8869,99
2021-02-25,Tehama,103,63373,4602,4578,494,5072,32
2021-02-25,Trinity,105,12862,467,297,79,376,3
2021-02-25,Tulare,107,460477,48247,47052,8022,55074,765
2021-02-25,Tuolumne,109,53932,3828,3894,33,3927,53
2021-02-25,Ventura,111,848112,77856,77395,2783,80178,751
2021-02-25,Yolo,113,214977,12868,12787,220,13007,188
2021-02-25,Yuba,115,75493,5503,5429,89,5518,39
2021-02-24,Alameda,001,1643700,80843,80070,1732,81802,1082
2021-02-24,Alpine,003,1148,79,77,0,77,0
2021-02-24,Amador,005,37829,3469,3444,30,3474,41
2021-02-24,Butte,007,227075,11334,10915,1590,12505,178
2021-02-24,Calaveras,009,45235,1898,1864,12,1876,31
2021-02-24,Colusa,011,21464,1871,1863,265,2128,11
2021-02-24,Contra Costa,013,1133247,63089,61776,1078,62854,663
2021-02-24,Del Norte,015,27424,1005,960,4,964,5
2021-02-24,El Dorado,017,186661,9135,8993,593,9586,98
2021-02-24,Fresno,019,978130,96245,94794,7711,102505,1369
2021-02-24,Glenn,021,27897,2250,2210,495,2705,14
2021-02-24,Humboldt,023,135768,3157,3123,22,3145,29
2021-02-24,Imperial,025,180216,27227,26843,2508,29351,596
2021-02-24,Inyo,027,18085,1294,1253,9,1262,32
2021-02-24,Kern,029,883053,93267,91525,9786,101311,992
2021-02-24,Kings,031,150075,22253,21871,971,22842,216
2021-02-24,Lake,033,64148,3176,3134,6,3140,40
2021-02-24,Lassen,035,31185,5121,5095,95,5190,1
2021-02-24,Los Angeles,037,10098052,1170559,1150322,39271,1189593,20817
2021-02-24,Madera,039,155013,15585,15390,822,16212,194
2021-02-24,Marin,041,260295,13193,13044,163,13207,214
2021-02-24,Mariposa,043,17540,377,374,5,379,4
2021-02-24,Mendocino,045,87422,3628,3540,71,3611,41
2021-02-24,Merced,047,269075,28380,28295,927,29222,383
2021-02-24,Modoc,049,8938,342,329,115,444,3
2021-02-24,Mono,051,14174,1178,1189,16,1205,3
2021-02-24,Monterey,053,433212,41930,41495,1697,43192,320
2021-02-24,Napa,055,140530,9029,8976,33,9009,70
2021-02-24,Nevada,057,99092,3998,3927,161,4088,66
2021-02-24,Orange,059,3164182,246875,244743,10217,254960,3835
2021-02-24,Placer,061,380077,20515,19648,1107,20755,239
2021-02-24,Plumas,063,18699,641,626,10,636,4
2021-02-24,Riverside,065,2383286,285358,278293,13430,291723,3603
2021-02-24,Sacramento,067,1510023,94308,92742,1234,93976,1375
2021-02-24,San Benito,069,59416,5743,5743,91,5834,57
2021-02-24,San Bernardino,071,2135413,285938,280583,8548,289131,3360
2021-02-24,San Diego,073,3302833,263671,258460,12830,271290,3230
2021-02-24,San Francisco,075,870044,34155,34061,1068,35129,406
2021-02-24,San Joaquin,077,732212,66718,65274,2771,68045,1019
2021-02-24,San Luis Obispo,079,281455,19676,19309,557,19866,233
2021-02-24,San Mateo,081,765935,39500,38763,407,39170,300
2021-02-24,Santa Barbara,083,443738,32189,31563,1048,32611,405
2021-02-24,Santa Clara,085,1922200,110227,109671,589,110260,1674
2021-02-24,Santa Cruz,087,273765,15383,14458,781,15239,185
2021-02-24,Shasta,089,179085,10932,10922,1211,12133,148
2021-02-24,Sierra,091,2930,51,47,12,59,0
2021-02-24,Siskiyou,093,43540,1491,1385,230,1615,4
2021-02-24,Solano,095,438530,29789,29577,356,29933,158
2021-02-24,Sonoma,097,501317,27952,27954,206,28160,278
2021-02-24,Stanislaus,099,539301,50577,49851,5343,55194,732
2021-02-24,Sutter,101,95872,8815,8778,80,8858,99
2021-02-24,Tehama,103,63373,4600,4566,494,5060,31
2021-02-24,Trinity,105,12862,467,294,78,372,3
2021-02-24,Tulare,107,460477,48191,46976,7994,54970,759
2021-02-24,Tuolumne,109,53932,3825,3887,33,3920,53
2021-02-24,Ventura,111,848112,77748,77238,2782,80020,718
2021-02-24,Yolo,113,214977,12855,12760,216,12976,188
2021-02-24,Yuba,115,75493,5492,5425,87,5512,39
2021-02-23,Alameda,001,1643700,80705,79948,1730,81678,1070
2021-02-23,Alpine,003,1148,78,77,0,77,0
2021-02-23,Amador,005,37829,3467,3440,30,3470,41
2021-02-23,Butte,007,227075,11318,10887,1587,12474,176
2021-02-23,Calaveras,009,45235,1897,1863,12,1875,21
2021-02-23,Colusa,011,21464,1868,1862,265,2127,11
2021-02-23,Contra Costa,013,1133247,62955,61613,1075,62688,661
2021-02-23,Del Norte,015,27424,1003,953,4,957,3
2021-02-23,El Dorado,017,186661,9122,8969,593,9562,96
2021-02-23,Fresno,019,978130,96084,94741,7697,102438,1356
2021-02-23,Glenn,021,27897,2248,2209,495,2704,14
2021-02-23,Humboldt,023,135768,3140,3108,22,3130,29
2021-02-23,Imperial,025,180216,27207,26816,2503,29319,591
2021-02-23,Inyo,027,18085,1290,1250,9,1259,32
2021-02-23,Kern,029,883053,93128,91390,9758,101148,982
2021-02-23,Kings,031,150075,22238,21839,967,22806,216
2021-02-23,Lake,033,64148,3168,3121,6,3127,40
2021-02-23,Lassen,035,31185,5118,5092,95,5187,1
2021-02-23,Los Angeles,037,10098052,1169689,1148965,39217,1188182,19887
2021-02-23,Madera,039,155013,15571,15352,816,16168,193
2021-02-23,Marin,041,260295,13173,13015,162,13177,214
2021-02-23,Mariposa,043,17540,377,374,5,379,4
2021-02-23,Mendocino,045,87422,3626,3540,70,3610,41
2021-02-23,Merced,047,269075,28300,28209,920,29129,381
2021-02-23,Modoc,049,8938,341,328,114,442,3
2021-02-23,Mono,051,14174,1178,1189,16,1205,3
2021-02-23,Monterey,053,433212,41890,41439,1692,43131,317
2021-02-23,Napa,055,140530,9017,8967,33,9000,70
2021-02-23,Nevada,057,99092,3990,3912,161,4073,66
2021-02-23,Orange,059,3164182,246677,244566,10198,254764,3843
2021-02-23,Placer,061,380077,20490,19608,1103,20711,238
2021-02-23,Plumas,063,18699,640,626,10,636,4
2021-02-23,Riverside,065,2383286,285121,278075,13415,291490,3599
2021-02-23,Sacramento,067,1510023,94151,92632,1228,93860,1370
2021-02-23,San Benito,069,59416,5737,5731,90,5821,57
2021-02-23,San Bernardino,071,2135413,285748,280279,8543,288822,3283
2021-02-23,San Diego,073,3302833,263294,257802,12800,270602,3218
2021-02-23,San Francisco,075,870044,34107,33994,1067,35061,405
2021-02-23,San Joaquin,077,732212,66618,65141,2764,67905,1004
2021-02-23,San Luis Obispo,079,281455,19647,19233,556,19789,230
2021-02-23,San Mateo,081,765935,39439,38662,407,39069,299
2021-02-23,Santa Barbara,083,443738,32134,31483,1046,32529,402
2021-02-23,Santa Clara,085,1922200,110030,109449,586,110035,1661
2021-02-23,Santa Cruz,087,273765,15354,14435,779,15214,178
2021-02-23,Shasta,089,179085,10920,10903,1207,12110,146
2021-02-23,Sierra,091,2930,51,47,12,59,0
2021-02-23,Siskiyou,093,43540,1486,1380,228,1608,4
2021-02-23,Solano,095,438530,29749,29545,353,29898,154
2021-02-23,Sonoma,097,501317,27909,27882,203,28085,278
2021-02-23,Stanislaus,099,539301,50499,49749,5327,55076,722
2021-02-23,Sutter,101,95872,8802,8766,80,8846,98
2021-02-23,Tehama,103,63373,4594,4556,493,5049,30
2021-02-23,Trinity,105,12862,467,292,77,369,3
2021-02-23,Tulare,107,460477,48113,46937,7960,54897,757
2021-02-23,Tuolumne,109,53932,3821,3864,33,3897,53
2021-02-23,Ventura,111,848112,77632,77093,2773,79866,689
2021-02-23,Yolo,113,214977,12826,12729,216,12945,188
2021-02-23,Yuba,115,75493,5479,5417,86,5503,38
2021-02-22,Alameda,001,1643700,80554,79796,1726,81522,1062
2021-02-22,Alpine,003,1148,78,77,0,77,0
2021-02-22,Amador,005,37829,3462,3438,30,3468,39
2021-02-22,Butte,007,227075,11305,10855,1582,12437,176
2021-02-22,Calaveras,009,45235,1895,1862,12,1874,21
2021-02-22,Colusa,011,21464,1868,1860,265,2125,11
2021-02-22,Contra Costa,013,1133247,62826,61478,1074,62552,661
2021-02-22,Del Norte,015,27424,1002,948,4,952,3
2021-02-22,El Dorado,017,186661,9105,8940,593,9533,96
2021-02-22,Fresno,019,978130,95922,94584,7680,102264,1351
2021-02-22,Glenn,021,27897,2243,2207,493,2700,14
2021-02-22,Humboldt,023,135768,3128,3095,22,3117,29
2021-02-22,Imperial,025,180216,27185,26778,2496,29274,590
2021-02-22,Inyo,027,18085,1285,1248,9,1257,32
2021-02-22,Kern,029,883053,93011,91201,9736,100937,982
2021-02-22,Kings,031,150075,22215,21801,964,22765,214
2021-02-22,Lake,033,64148,3162,3107,6,3113,40
2021-02-22,Lassen,035,31185,5118,5088,94,5182,1
2021-02-22,Los Angeles,037,10098052,1168817,1147541,39160,1186701,19730
2021-02-22,Madera,039,155013,15546,15325,812,16137,193
2021-02-22,Marin,041,260295,13148,12991,159,13150,213
2021-02-22,Mariposa,043,17540,376,374,5,379,4
2021-02-22,Mendocino,045,87422,3620,3535,70,3605,41
2021-02-22,Merced,047,269075,28237,28166,917,29083,379
2021-02-22,Modoc,049,8938,341,329,114,443,3
2021-02-22,Mono,051,14174,1174,1189,16,1205,3
2021-02-22,Monterey,053,433212,41845,41397,1686,43083,311
2021-02-22,Napa,055,140530,8990,8950,33,8983,69
2021-02-22,Nevada,057,99092,3981,3900,159,4059,66
2021-02-22,Orange,059,3164182,246441,244118,10180,254298,3843
2021-02-22,Placer,061,380077,20453,19587,1095,20682,238
2021-02-22,Plumas,063,18699,640,625,10,635,4
2021-02-22,Riverside,065,2383286,284858,277730,13407,291137,3567
2021-02-22,Sacramento,067,1510023,93984,92476,1218,93694,1359
2021-02-22,San Benito,069,59416,5735,5723,90,5813,57
2021-02-22,San Bernardino,071,2135413,285569,279984,8530,288514,3259
2021-02-22,San Diego,073,3302833,262884,257348,12767,270115,3189
2021-02-22,San Francisco,075,870044,34047,33947,1062,35009,405
2021-02-22,San Joaquin,077,732212,66522,65060,2751,67811,1001
2021-02-22,San Luis Obispo,079,281455,19610,19198,554,19752,229
2021-02-22,San Mateo,081,765935,39382,38542,404,38946,282
2021-02-22,Santa Barbara,083,443738,32068,31421,1043,32464,399
2021-02-22,Santa Clara,085,1922200,109821,109213,575,109788,1655
2021-02-22,Santa Cruz,087,273765,15328,14417,779,15196,176
2021-02-22,Shasta,089,179085,10905,10872,1202,12074,145
2021-02-22,Sierra,091,2930,51,47,12,59,0
2021-02-22,Siskiyou,093,43540,1480,1373,227,1600,4
2021-02-22,Solano,095,438530,29710,29508,352,29860,150
2021-02-22,Sonoma,097,501317,27864,27845,202,28047,278
2021-02-22,Stanislaus,099,539301,50398,49630,5309,54939,722
2021-02-22,Sutter,101,95872,8794,8698,80,8778,98
2021-02-22,Tehama,103,63373,4590,4550,492,5042,30
2021-02-22,Trinity,105,12862,467,287,76,363,3
2021-02-22,Tulare,107,460477,48051,46879,7928,54807,751
2021-02-22,Tuolumne,109,53932,3817,3856,33,3889,53
2021-02-22,Ventura,111,848112,77504,76947,2768,79715,677
2021-02-22,Yolo,113,214977,12799,12689,216,12905,183
2021-02-22,Yuba,115,75493,5476,5404,85,5489,38
2021-02-21,Alameda,001,1643700,80362,79649,1721,81370,1061
2021-02-21,Alpine,003,1148,78,77,0,77,0
2021-02-21,Amador,005,37829,3454,3435,30,3465,39
2021-02-21,Butte,007,227075,11287,10855,1580,12435,176
2021-02-21,Calaveras,009,45235,1894,1860,12,1872,21
2021-02-21,Colusa,011,21464,1867,1860,261,2121,11
2021-02-21,Contra Costa,013,1133247,62670,61364,1071,62435,661
2021-02-21,Del Norte,015,27424,996,942,4,946,3
2021-02-21,El Dorado,017,186661,9087,8927,592,9519,96
2021-02-21,Fresno,019,978130,95780,94374,7663,102037,1349
2021-02-21,Glenn,021,27897,2241,2201,491,2692,14
2021-02-21,Humboldt,023,135768,3116,3096,22,3118,29
2021-02-21,Imperial,025,180216,27171,26779,2494,29273,590
2021-02-21,Inyo,027,18085,1279,1232,9,1241,32
2021-02-21,Kern,029,883053,92886,91141,9698,100839,980
2021-02-21,Kings,031,150075,22179,21784,962,22746,213
2021-02-21,Lake,033,64148,3154,3100,6,3106,40
2021-02-21,Lassen,035,31185,5110,5077,94,5171,1
2021-02-21,Los Angeles,037,10098052,1167781,1146756,39112,1185868,19711
2021-02-21,Madera,039,155013,15513,15298,809,16107,192
2021-02-21,Marin,041,260295,13119,12968,159,13127,212
2021-02-21,Mariposa,043,17540,376,373,5,378,4
2021-02-21,Mendocino,045,87422,3615,3535,70,3605,41
2021-02-21,Merced,047,269075,28163,28106,901,29007,379
2021-02-21,Modoc,049,8938,338,329,114,443,3
2021-02-21,Mono,051,14174,1174,1189,16,1205,3
2021-02-21,Monterey,053,433212,41789,41373,1679,43052,309
2021-02-21,Napa,055,140530,8976,8929,33,8962,69
2021-02-21,Nevada,057,99092,3968,3895,159,4054,66
2021-02-21,Orange,059,3164182,246144,243985,10163,254148,3801
2021-02-21,Placer,061,380077,20417,19553,1091,20644,238
2021-02-21,Plumas,063,18699,640,625,10,635,4
2021-02-21,Riverside,065,2383286,284624,277555,13394,290949,3564
2021-02-21,Sacramento,067,1510023,93774,92288,1205,93493,1354
2021-02-21,San Benito,069,59416,5725,5716,87,5803,57
2021-02-21,San Bernardino,071,2135413,285344,279870,8516,288386,3247
2021-02-21,San Diego,073,3302833,262450,257027,12721,269748,3190
2021-02-21,San Francisco,075,870044,33983,33891,1058,34949,405
2021-02-21,San Joaquin,077,732212,66382,64997,2739,67736,1001
2021-02-21,San Luis Obispo,079,281455,19577,19178,552,19730,229
2021-02-21,San Mateo,081,765935,39320,38448,400,38848,282
2021-02-21,Santa Barbara,083,443738,32006,31374,1040,32414,399
2021-02-21,Santa Clara,085,1922200,109595,108992,566,109558,1654
2021-02-21,Santa Cruz,087,273765,15305,14401,778,15179,176
2021-02-21,Shasta,089,179085,10891,10867,1197,12064,145
2021-02-21,Sierra,091,2930,51,47,12,59,0
2021-02-21,Siskiyou,093,43540,1474,1371,227,1598,4
2021-02-21,Solano,095,438530,29655,29471,351,29822,150
2021-02-21,Sonoma,097,501317,27800,27793,195,27988,278
2021-02-21,Stanislaus,099,539301,50285,49527,5295,54822,726
2021-02-21,Sutter,101,95872,8777,8687,79,8766,97
2021-02-21,Tehama,103,63373,4581,4547,492,5039,30
2021-02-21,Trinity,105,12862,465,286,76,362,3
2021-02-21,Tulare,107,460477,47983,46830,7893,54723,749
2021-02-21,Tuolumne,109,53932,3803,3828,33,3861,53
2021-02-21,Ventura,111,848112,77355,76862,2754,79616,677
2021-02-21,Yolo,113,214977,12768,12670,216,12886,183
2021-02-21,Yuba,115,75493,5468,5396,84,5480,38
2021-02-20,Alameda,001,1643700,80271,79496,1716,81212,1055
2021-02-20,Alpine,003,1148,78,77,0,77,0
2021-02-20,Amador,005,37829,3452,3432,30,3462,39
2021-02-20,Butte,007,227075,11279,10838,1579,12417,176
2021-02-20,Calaveras,009,45235,1893,1858,12,1870,21
2021-02-20,Colusa,011,21464,1866,1858,261,2119,11
2021-02-20,Contra Costa,013,1133247,62586,61205,1069,62274,663
2021-02-20,Del Norte,015,27424,992,937,4,941,3
2021-02-20,El Dorado,017,186661,9077,8911,592,9503,96
2021-02-20,Fresno,019,978130,95696,94234,7643,101877,1341
2021-02-20,Glenn,021,27897,2237,2199,490,2689,14
2021-02-20,Humboldt,023,135768,3108,3073,22,3095,29
2021-02-20,Imperial,025,180216,27161,26771,2494,29265,590
2021-02-20,Inyo,027,18085,1275,1226,9,1235,32
2021-02-20,Kern,029,883053,92815,91025,9666,100691,968
2021-02-20,Kings,031,150075,22161,21773,961,22734,212
2021-02-20,Lake,033,64148,3147,3089,6,3095,40
2021-02-20,Lassen,035,31185,5108,5067,94,5161,1
2021-02-20,Los Angeles,037,10098052,1167215,1145594,39068,1184662,19630
2021-02-20,Madera,039,155013,15493,15274,808,16082,191
2021-02-20,Marin,041,260295,13098,12945,157,13102,211
2021-02-20,Mariposa,043,17540,376,372,5,377,4
2021-02-20,Mendocino,045,87422,3613,3533,70,3603,40
2021-02-20,Merced,047,269075,28120,28066,898,28964,379
2021-02-20,Modoc,049,8938,338,328,114,442,3
2021-02-20,Mono,051,14174,1173,1187,16,1203,3
2021-02-20,Monterey,053,433212,41767,41313,1677,42990,309
2021-02-20,Napa,055,140530,8967,8910,33,8943,69
2021-02-20,Nevada,057,99092,3958,3887,158,4045,66
2021-02-20,Orange,059,3164182,245974,243761,10150,253911,3755
2021-02-20,Placer,061,380077,20376,19509,1087,20596,236
2021-02-20,Plumas,063,18699,640,626,10,636,4
2021-02-20,Riverside,065,2383286,284470,277267,13385,290652,3559
2021-02-20,Sacramento,067,1510023,93651,92057,1203,93260,1352
2021-02-20,San Benito,069,59416,5714,5709,87,5796,57
2021-02-20,San Bernardino,071,2135413,285242,279608,8511,288119,3203
2021-02-20,San Diego,073,3302833,262208,256510,12692,269202,3188
2021-02-20,San Francisco,075,870044,33941,33820,1049,34869,399
2021-02-20,San Joaquin,077,732212,66312,64916,2734,67650,1001
2021-02-20,San Luis Obispo,079,281455,19553,19138,551,19689,229
2021-02-20,San Mateo,081,765935,39276,38371,399,38770,282
2021-02-20,Santa Barbara,083,443738,31972,31289,1039,32328,396
2021-02-20,Santa Clara,085,1922200,109417,108728,563,109291,1649
2021-02-20,Santa Cruz,087,273765,15294,14378,776,15154,176
2021-02-20,Shasta,089,179085,10877,10850,1192,12042,146
2021-02-20,Sierra,091,2930,51,47,12,59,0
2021-02-20,Siskiyou,093,43540,1471,1366,227,1593,4
2021-02-20,Solano,095,438530,29641,29440,349,29789,150
2021-02-20,Sonoma,097,501317,27771,27703,193,27896,278
2021-02-20,Stanislaus,099,539301,50234,49445,5281,54726,733
2021-02-20,Sutter,101,95872,8771,8681,79,8760,97
2021-02-20,Tehama,103,63373,4577,4545,492,5037,30
2021-02-20,Trinity,105,12862,464,285,75,360,3
2021-02-20,Tulare,107,460477,47947,46769,7871,54640,739
2021-02-20,Tuolumne,109,53932,3798,3823,33,3856,53
2021-02-20,Ventura,111,848112,77260,76757,2751,79508,671
2021-02-20,Yolo,113,214977,12754,12639,215,12854,183
2021-02-20,Yuba,115,75493,5465,5386,84,5470,38
2021-02-19,Alameda,001,1643700,80170,79318,1712,81030,1047
2021-02-19,Alpine,003,1148,78,77,0,77,0
2021-02-19,Amador,005,37829,3448,3427,30,3457,39
2021-02-19,Butte,007,227075,11265,10823,1572,12395,176
2021-02-19,Calaveras,009,45235,1892,1856,12,1868,21
2021-02-19,Colusa,011,21464,1866,1858,261,2119,11
2021-02-19,Contra Costa,013,1133247,62474,61017,1066,62083,651
2021-02-19,Del Norte,015,27424,987,932,4,936,2
2021-02-19,El Dorado,017,186661,9068,8882,591,9473,96
2021-02-19,Fresno,019,978130,95565,93973,7627,101600,1330
2021-02-19,Glenn,021,27897,2232,2199,489,2688,14
2021-02-19,Humboldt,023,135768,3096,3037,22,3059,29
2021-02-19,Imperial,025,180216,27155,26751,2491,29242,589
2021-02-19,Inyo,027,18085,1270,1212,9,1221,32
2021-02-19,Kern,029,883053,92746,90807,9625,100432,963
2021-02-19,Kings,031,150075,22147,21724,959,22683,211
2021-02-19,Lake,033,64148,3141,3078,6,3084,40
2021-02-19,Lassen,035,31185,5107,5057,94,5151,1
2021-02-19,Los Angeles,037,10098052,1166467,1143828,39027,1182855,19498
2021-02-19,Madera,039,155013,15476,15222,806,16028,188
2021-02-19,Marin,041,260295,13080,12919,156,13075,210
2021-02-19,Mariposa,043,17540,376,371,5,376,4
2021-02-19,Mendocino,045,87422,3611,3526,70,3596,39
2021-02-19,Merced,047,269075,28090,27985,895,28880,376
2021-02-19,Modoc,049,8938,338,328,114,442,3
2021-02-19,Mono,051,14174,1173,1186,16,1202,3
2021-02-19,Monterey,053,433212,41740,41209,1673,42882,309
2021-02-19,Napa,055,140530,8954,8899,33,8932,69
2021-02-19,Nevada,057,99092,3952,3863,158,4021,66
2021-02-19,Orange,059,3164182,245798,243397,10137,253534,3715
2021-02-19,Placer,061,380077,20354,19457,1087,20544,236
2021-02-19,Plumas,063,18699,638,624,10,634,4
2021-02-19,Riverside,065,2383286,284301,276941,13368,290309,3541
2021-02-19,Sacramento,067,1510023,93530,91815,1199,93014,1351
2021-02-19,San Benito,069,59416,5709,5699,87,5786,57
2021-02-19,San Bernardino,071,2135413,285106,279209,8506,287715,3117
2021-02-19,San Diego,073,3302833,261917,255799,12669,268468,3169
2021-02-19,San Francisco,075,870044,33893,33746,1043,34789,387
2021-02-19,San Joaquin,077,732212,66236,64774,2725,67499,988
2021-02-19,San Luis Obispo,079,281455,19522,19061,549,19610,230
2021-02-19,San Mateo,081,765935,39218,38256,397,38653,282
2021-02-19,Santa Barbara,083,443738,31908,31204,1038,32242,392
2021-02-19,Santa Clara,085,1922200,109205,108400,561,108961,1634
2021-02-19,Santa Cruz,087,273765,15279,14354,776,15130,176
2021-02-19,Shasta,089,179085,10866,10833,1189,12022,140
2021-02-19,Sierra,091,2930,51,47,12,59,0
2021-02-19,Siskiyou,093,43540,1467,1363,225,1588,4
2021-02-19,Solano,095,438530,29616,29383,348,29731,150
2021-02-19,Sonoma,097,501317,27724,27595,191,27786,280
2021-02-19,Stanislaus,099,539301,50173,49282,5265,54547,739
2021-02-19,Sutter,101,95872,8761,8665,79,8744,96
2021-02-19,Tehama,103,63373,4575,4535,492,5027,30
2021-02-19,Trinity,105,12862,462,282,73,355,3
2021-02-19,Tulare,107,460477,47902,46662,7846,54508,736
2021-02-19,Tuolumne,109,53932,3791,3817,33,3850,52
2021-02-19,Ventura,111,848112,77181,76582,2748,79330,667
2021-02-19,Yolo,113,214977,12738,12606,215,12821,183
2021-02-19,Yuba,115,75493,5455,5376,84,5460,38
2021-02-18,Alameda,001,1643700,80036,79111,1704,80815,1012
2021-02-18,Alpine,003,1148,78,77,0,77,0
2021-02-18,Amador,005,37829,3444,3417,29,3446,38
2021-02-18,Butte,007,227075,11247,10791,1570,12361,175
2021-02-18,Calaveras,009,45235,1887,1873,12,1885,21
2021-02-18,Colusa,011,21464,1864,1856,259,2115,11
2021-02-18,Contra Costa,013,1133247,62359,60868,1064,61932,640
2021-02-18,Del Norte,015,27424,982,929,4,933,2
2021-02-18,El Dorado,017,186661,9053,8850,590,9440,94
2021-02-18,Fresno,019,978130,95395,93734,7602,101336,1323
2021-02-18,Glenn,021,27897,2226,2195,489,2684,14
2021-02-18,Humboldt,023,135768,3084,3023,22,3045,29
2021-02-18,Imperial,025,180216,27129,26731,2484,29215,591
2021-02-18,Inyo,027,18085,1266,1213,8,1221,32
2021-02-18,Kern,029,883053,92592,90655,9595,100250,961
2021-02-18,Kings,031,150075,22123,21648,958,22606,211
2021-02-18,Lake,033,64148,3136,3066,6,3072,40
2021-02-18,Lassen,035,31185,5098,5052,94,5146,1
2021-02-18,Los Angeles,037,10098052,1165509,1141930,38962,1180892,19358
2021-02-18,Madera,039,155013,15454,15175,801,15976,188
2021-02-18,Marin,041,260295,13067,12895,155,13050,209
2021-02-18,Mariposa,043,17540,375,369,5,374,4
2021-02-18,Mendocino,045,87422,3608,3519,69,3588,39
2021-02-18,Merced,047,269075,28041,27870,889,28759,372
2021-02-18,Modoc,049,8938,336,327,113,440,3
2021-02-18,Mono,051,14174,1173,1182,16,1198,3
2021-02-18,Monterey,053,433212,41682,41091,1664,42755,307
2021-02-18,Napa,055,140530,8937,8877,33,8910,68
2021-02-18,Nevada,057,99092,3943,3836,157,3993,66
2021-02-18,Orange,059,3164182,245575,243098,10120,253218,3673
2021-02-18,Placer,061,380077,20327,19429,1086,20515,232
2021-02-18,Plumas,063,18699,638,624,10,634,4
2021-02-18,Riverside,065,2383286,284013,276595,13347,289942,3510
2021-02-18,Sacramento,067,1510023,93368,91476,1193,92669,1334
2021-02-18,San Benito,069,59416,5706,5697,86,5783,58
2021-02-18,San Bernardino,071,2135413,284896,278887,8492,287379,3066
2021-02-18,San Diego,073,3302833,261563,254987,12646,267633,3135
2021-02-18,San Francisco,075,870044,33835,33650,1040,34690,386
2021-02-18,San Joaquin,077,732212,66153,64634,2715,67349,982
2021-02-18,San Luis Obispo,079,281455,19480,18987,546,19533,230
2021-02-18,San Mateo,081,765935,39156,38185,393,38578,282
2021-02-18,Santa Barbara,083,443738,31830,31054,1031,32085,387
2021-02-18,Santa Clara,085,1922200,108980,108210,558,108768,1605
2021-02-18,Santa Cruz,087,273765,15253,14314,776,15090,176
2021-02-18,Shasta,089,179085,10848,10811,1186,11997,139
2021-02-18,Sierra,091,2930,50,47,12,59,0
2021-02-18,Siskiyou,093,43540,1462,1359,224,1583,4
2021-02-18,Solano,095,438530,29590,29349,347,29696,150
2021-02-18,Sonoma,097,501317,27656,27512,190,27702,281
2021-02-18,Stanislaus,099,539301,50072,49150,5248,54398,738
2021-02-18,Sutter,101,95872,8753,8654,79,8733,96
2021-02-18,Tehama,103,63373,4572,4528,492,5020,30
2021-02-18,Trinity,105,12862,461,282,73,355,3
2021-02-18,Tulare,107,460477,47839,46591,7806,54397,728
2021-02-18,Tuolumne,109,53932,3754,3811,33,3844,52
2021-02-18,Ventura,111,848112,77049,76442,2740,79182,659
2021-02-18,Yolo,113,214977,12712,12549,212,12761,183
2021-02-18,Yuba,115,75493,5438,5358,84,5442,38
2021-02-17,Alameda,001,1643700,79875,78895,1702,80597,1002
2021-02-17,Alpine,003,1148,78,77,0,77,0
2021-02-17,Amador,005,37829,3440,3415,29,3444,38
2021-02-17,Butte,007,227075,11229,10770,1566,12336,174
2021-02-17,Calaveras,009,45235,1887,1876,12,1888,21
2021-02-17,Colusa,011,21464,1861,1854,259,2113,10
2021-02-17,Contra Costa,013,1133247,62221,60723,1061,61784,635
2021-02-17,Del Norte,015,27424,975,920,4,924,2
2021-02-17,El Dorado,017,186661,9042,8847,590,9437,94
2021-02-17,Fresno,019,978130,95256,93555,7575,101130,1307
2021-02-17,Glenn,021,27897,2225,2189,488,2677,14
2021-02-17,Humboldt,023,135768,3069,3006,22,3028,29
2021-02-17,Imperial,025,180216,27115,26726,2480,29206,580
2021-02-17,Inyo,027,18085,1258,1197,8,1205,32
2021-02-17,Kern,029,883053,92474,90454,9550,100004,962
2021-02-17,Kings,031,150075,22085,21617,954,22571,211
2021-02-17,Lake,033,64148,3126,3057,2,3059,38
2021-02-17,Lassen,035,31185,5093,5052,93,5145,1
2021-02-17,Los Angeles,037,10098052,1164457,1139786,38898,1178684,19213
2021-02-17,Madera,039,155013,15429,15135,792,15927,177
2021-02-17,Marin,041,260295,13042,12881,155,13036,207
2021-02-17,Mariposa,043,17540,375,368,4,372,4
2021-02-17,Mendocino,045,87422,3606,3494,68,3562,39
2021-02-17,Merced,047,269075,27986,27824,880,28704,372
2021-02-17,Modoc,049,8938,336,327,113,440,3
2021-02-17,Mono,051,14174,1173,1180,16,1196,3
2021-02-17,Monterey,053,433212,41627,41014,1652,42666,304
2021-02-17,Napa,055,140530,8923,8865,33,8898,68
2021-02-17,Nevada,057,99092,3924,3822,154,3976,52
2021-02-17,Orange,059,3164182,245312,242716,10087,252803,3626
2021-02-17,Placer,061,380077,20294,19405,1082,20487,230
2021-02-17,Plumas,063,18699,637,623,10,633,4
2021-02-17,Riverside,065,2383286,283725,276289,13326,289615,3491
2021-02-17,Sacramento,067,1510023,93209,91309,1186,92495,1326
2021-02-17,San Benito,069,59416,5700,5661,86,5747,57
2021-02-17,San Bernardino,071,2135413,284692,278461,8473,286934,3020
2021-02-17,San Diego,073,3302833,261185,254177,12625,266802,3099
2021-02-17,San Francisco,075,870044,33759,33558,1035,34593,379
2021-02-17,San Joaquin,077,732212,66047,64556,2709,67265,979
2021-02-17,San Luis Obispo,079,281455,19435,18964,546,19510,230
2021-02-17,San Mateo,081,765935,39090,38124,392,38516,282
2021-02-17,Santa Barbara,083,443738,31762,30927,1030,31957,384
2021-02-17,Santa Clara,085,1922200,108748,107949,556,108505,1592
2021-02-17,Santa Cruz,087,273765,15220,14268,773,15041,174
2021-02-17,Shasta,089,179085,10828,10770,1185,11955,139
2021-02-17,Sierra,091,2930,50,47,12,59,0
2021-02-17,Siskiyou,093,43540,1456,1352,221,1573,4
2021-02-17,Solano,095,438530,29533,29288,347,29635,149
2021-02-17,Sonoma,097,501317,27584,27408,185,27593,281
2021-02-17,Stanislaus,099,539301,49961,49050,5232,54282,730
2021-02-17,Sutter,101,95872,8743,8681,79,8760,95
2021-02-17,Tehama,103,63373,4569,4511,492,5003,30
2021-02-17,Trinity,105,12862,461,277,71,348,3
2021-02-17,Tulare,107,460477,47774,46495,7780,54275,726
2021-02-17,Tuolumne,109,53932,3745,3806,33,3839,49
2021-02-17,Ventura,111,848112,76927,76234,2734,78968,646
2021-02-17,Yolo,113,214977,12693,12506,210,12716,182
2021-02-17,Yuba,115,75493,5429,5345,84,5429,38
2021-02-16,Alameda,001,1643700,79705,78756,1699,80455,997
2021-02-16,Alpine,003,1148,78,76,0,76,0
2021-02-16,Amador,005,37829,3433,3413,29,3442,39
2021-02-16,Butte,007,227075,11203,10748,1563,12311,164
2021-02-16,Calaveras,009,45235,1885,1872,12,1884,21
2021-02-16,Colusa,011,21464,1858,1852,257,2109,10
2021-02-16,Contra Costa,013,1133247,62070,60564,1056,61620,631
2021-02-16,Del Norte,015,27424,967,913,4,917,2
2021-02-16,El Dorado,017,186661,9032,8836,589,9425,94
2021-02-16,Fresno,019,978130,95091,93363,7545,100908,1293
2021-02-16,Glenn,021,27897,2221,2189,484,2673,14
2021-02-16,Humboldt,023,135768,3046,2994,21,3015,29
2021-02-16,Imperial,025,180216,27102,26711,2476,29187,580
2021-02-16,Inyo,027,18085,1250,1191,8,1199,32
2021-02-16,Kern,029,883053,92342,90267,9520,99787,959
2021-02-16,Kings,031,150075,22039,21583,950,22533,206
2021-02-16,Lake,033,64148,3119,3041,2,3043,38
2021-02-16,Lassen,035,31185,5081,5047,93,5140,1
2021-02-16,Los Angeles,037,10098052,1163203,1138262,38837,1177099,19044
2021-02-16,Madera,039,155013,15391,15120,787,15907,172
2021-02-16,Marin,041,260295,13014,12832,155,12987,205
2021-02-16,Mariposa,043,17540,375,367,4,371,4
2021-02-16,Mendocino,045,87422,3602,3489,68,3557,39
2021-02-16,Merced,047,269075,27905,27724,874,28598,368
2021-02-16,Modoc,049,8938,336,326,113,439,3
2021-02-16,Mono,051,14174,1173,1180,16,1196,3
2021-02-16,Monterey,053,433212,41551,40962,1643,42605,303
2021-02-16,Napa,055,140530,8910,8854,33,8887,66
2021-02-16,Nevada,057,99092,3911,3774,153,3927,47
2021-02-16,Orange,059,3164182,244990,242382,10071,252453,3612
2021-02-16,Placer,061,380077,20261,19367,1079,20446,230
2021-02-16,Plumas,063,18699,637,619,10,629,4
2021-02-16,Riverside,065,2383286,283421,275954,13303,289257,3471
2021-02-16,Sacramento,067,1510023,92955,91246,1180,92426,1305
2021-02-16,San Benito,069,59416,5692,5659,85,5744,56
2021-02-16,San Bernardino,071,2135413,284470,277947,8462,286409,2978
2021-02-16,San Diego,073,3302833,260720,253638,12586,266224,3042
2021-02-16,San Francisco,075,870044,33688,33491,1030,34521,373
2021-02-16,San Joaquin,077,732212,65917,64448,2706,67154,979
2021-02-16,San Luis Obispo,079,281455,19390,18925,543,19468,229
2021-02-16,San Mateo,081,765935,39031,38041,390,38431,277
2021-02-16,Santa Barbara,083,443738,31688,30865,1027,31892,378
2021-02-16,Santa Clara,085,1922200,108496,107754,553,108307,1591
2021-02-16,Santa Cruz,087,273765,15200,14256,772,15028,174
2021-02-16,Shasta,089,179085,10813,10736,1183,11919,139
2021-02-16,Sierra,091,2930,50,47,12,59,0
2021-02-16,Siskiyou,093,43540,1452,1351,221,1572,4
2021-02-16,Solano,095,438530,29495,29246,346,29592,148
2021-02-16,Sonoma,097,501317,27525,27380,179,27559,279
2021-02-16,Stanislaus,099,539301,49837,48927,5218,54145,716
2021-02-16,Sutter,101,95872,8720,8671,79,8750,95
2021-02-16,Tehama,103,63373,4560,4501,490,4991,30
2021-02-16,Trinity,105,12862,457,275,71,346,3
2021-02-16,Tulare,107,460477,47710,46444,7736,54180,716
2021-02-16,Tuolumne,109,53932,3743,3796,33,3829,49
2021-02-16,Ventura,111,848112,76785,76043,2730,78773,631
2021-02-16,Yolo,113,214977,12664,12457,210,12667,175
2021-02-16,Yuba,115,75493,5422,5332,83,5415,38
2021-02-15,Alameda,001,1643700,79508,78647,1688,80335,996
2021-02-15,Alpine,003,1148,78,76,0,76,0
2021-02-15,Amador,005,37829,3429,3409,29,3438,39
2021-02-15,Butte,007,227075,11185,10723,1559,12282,155
2021-02-15,Calaveras,009,45235,1881,1871,12,1883,21
2021-02-15,Colusa,011,21464,1858,1849,253,2102,10
2021-02-15,Contra Costa,013,1133247,61898,60444,1050,61494,631
2021-02-15,Del Norte,015,27424,963,913,4,917,2
2021-02-15,El Dorado,017,186661,9015,8816,589,9405,94
2021-02-15,Fresno,019,978130,94892,93231,7506,100737,1288
2021-02-15,Glenn,021,27897,2219,2185,483,2668,14
2021-02-15,Humboldt,023,135768,3039,2997,21,3018,29
2021-02-15,Imperial,025,180216,27082,26700,2473,29173,580
2021-02-15,Inyo,027,18085,1231,1184,8,1192,32
2021-02-15,Kern,029,883053,92198,90181,9488,99669,959
2021-02-15,Kings,031,150075,21994,21574,946,22520,205
2021-02-15,Lake,033,64148,3105,3030,1,3031,38
2021-02-15,Lassen,035,31185,5079,5047,92,5139,1
2021-02-15,Los Angeles,037,10098052,1161813,1137164,38774,1175938,18925
2021-02-15,Madera,039,155013,15360,15108,785,15893,106
2021-02-15,Marin,041,260295,12993,12810,152,12962,203
2021-02-15,Mariposa,043,17540,373,367,4,371,4
2021-02-15,Mendocino,045,87422,3590,3481,68,3549,39
2021-02-15,Merced,047,269075,27831,27656,866,28522,368
2021-02-15,Modoc,049,8938,336,326,113,439,3
2021-02-15,Mono,051,14174,1170,1178,16,1194,3
2021-02-15,Monterey,053,433212,41487,40911,1630,42541,302
2021-02-15,Napa,055,140530,8896,8837,33,8870,57
2021-02-15,Nevada,057,99092,3894,3767,152,3919,47
2021-02-15,Orange,059,3164182,244670,242176,10043,252219,3586
2021-02-15,Placer,061,380077,20235,19361,1078,20439,230
2021-02-15,Plumas,063,18699,637,620,10,630,4
2021-02-15,Riverside,065,2383286,283067,275771,13284,289055,3468
2021-02-15,Sacramento,067,1510023,92628,91091,1175,92266,1304
2021-02-15,San Benito,069,59416,5686,5649,85,5734,56
2021-02-15,San Bernardino,071,2135413,284219,277869,8454,286323,2945
2021-02-15,San Diego,073,3302833,260205,252940,12555,265495,3037
2021-02-15,San Francisco,075,870044,33615,33454,1024,34478,373
2021-02-15,San Joaquin,077,732212,65753,64382,2699,67081,979
2021-02-15,San Luis Obispo,079,281455,19337,18891,541,19432,227
2021-02-15,San Mateo,081,765935,38952,37969,387,38356,277
2021-02-15,Santa Barbara,083,443738,31585,30810,1024,31834,378
2021-02-15,Santa Clara,085,1922200,108266,107630,551,108181,1588
2021-02-15,Santa Cruz,087,273765,15168,14239,769,15008,175
2021-02-15,Shasta,089,179085,10793,10730,1178,11908,139
2021-02-15,Sierra,091,2930,50,47,12,59,0
2021-02-15,Siskiyou,093,43540,1444,1345,220,1565,4
2021-02-15,Solano,095,438530,29440,29225,346,29571,148
2021-02-15,Sonoma,097,501317,27441,27359,175,27534,276
2021-02-15,Stanislaus,099,539301,49711,48808,5205,54013,716
2021-02-15,Sutter,101,95872,8705,8652,79,8731,95
2021-02-15,Tehama,103,63373,4551,4492,489,4981,30
2021-02-15,Trinity,105,12862,456,274,71,345,3
2021-02-15,Tulare,107,460477,47639,46344,7697,54041,715
2021-02-15,Tuolumne,109,53932,3733,3794,33,3827,49
2021-02-15,Ventura,111,848112,76630,75889,2727,78616,629
2021-02-15,Yolo,113,214977,12629,12412,204,12616,175
2021-02-15,Yuba,115,75493,5405,5320,82,5402,38
2021-02-14,Alameda,001,1643700,79356,78442,1687,80129,995
2021-02-14,Alpine,003,1148,78,76,0,76,0
2021-02-14,Amador,005,37829,3424,3398,29,3427,39
2021-02-14,Butte,007,227075,11161,10717,1556,12273,155
2021-02-14,Calaveras,009,45235,1877,1866,12,1878,21
2021-02-14,Colusa,011,21464,1854,1845,250,2095,10
2021-02-14,Contra Costa,013,1133247,61748,60272,1047,61319,631
2021-02-14,Del Norte,015,27424,959,911,4,915,2
2021-02-14,El Dorado,017,186661,8984,8790,588,9378,94
2021-02-14,Fresno,019,978130,94721,93065,7483,100548,1287
2021-02-14,Glenn,021,27897,2216,2184,483,2667,14
2021-02-14,Humboldt,023,135768,3026,2992,21,3013,29
2021-02-14,Imperial,025,180216,27075,26696,2472,29168,580
2021-02-14,Inyo,027,18085,1225,1177,8,1185,32
2021-02-14,Kern,029,883053,92038,90038,9435,99473,959
2021-02-14,Kings,031,150075,21968,21538,944,22482,205
2021-02-14,Lake,033,64148,3094,3030,1,3031,38
2021-02-14,Lassen,035,31185,5075,5037,92,5129,1
2021-02-14,Los Angeles,037,10098052,1160471,1135450,38688,1174138,18898
2021-02-14,Madera,039,155013,15328,15089,781,15870,106
2021-02-14,Marin,041,260295,12969,12784,152,12936,201
2021-02-14,Mariposa,043,17540,373,365,4,369,4
2021-02-14,Mendocino,045,87422,3584,3475,68,3543,39
2021-02-14,Merced,047,269075,27749,27601,861,28462,368
2021-02-14,Modoc,049,8938,336,326,113,439,3
2021-02-14,Mono,051,14174,1169,1180,16,1196,3
2021-02-14,Monterey,053,433212,41436,40842,1625,42467,302
2021-02-14,Napa,055,140530,8876,8826,33,8859,57
2021-02-14,Nevada,057,99092,3878,3761,152,3913,47
2021-02-14,Orange,059,3164182,244356,241859,10024,251883,3564
2021-02-14,Placer,061,380077,20196,19313,1073,20386,230
2021-02-14,Plumas,063,18699,636,620,10,630,4
2021-02-14,Riverside,065,2383286,282735,275518,13265,288783,3471
2021-02-14,Sacramento,067,1510023,92421,90856,1171,92027,1304
2021-02-14,San Benito,069,59416,5677,5641,84,5725,56
2021-02-14,San Bernardino,071,2135413,283912,277664,8434,286098,2929
2021-02-14,San Diego,073,3302833,259713,252247,12507,264754,3037
2021-02-14,San Francisco,075,870044,33541,33374,1016,34390,372
2021-02-14,San Joaquin,077,732212,65655,64243,2685,66928,979
2021-02-14,San Luis Obispo,079,281455,19299,18868,538,19406,225
2021-02-14,San Mateo,081,765935,38868,37859,387,38246,277
2021-02-14,Santa Barbara,083,443738,31493,30744,1020,31764,377
2021-02-14,Santa Clara,085,1922200,108067,107412,547,107959,1582
2021-02-14,Santa Cruz,087,273765,15140,14225,764,14989,175
2021-02-14,Shasta,089,179085,10761,10720,1173,11893,139
2021-02-14,Sierra,091,2930,50,47,12,59,0
2021-02-14,Siskiyou,093,43540,1440,1340,220,1560,4
2021-02-14,Solano,095,438530,29398,29150,343,29493,148
2021-02-14,Sonoma,097,501317,27366,27266,173,27439,276
2021-02-14,Stanislaus,099,539301,49601,48672,5190,53862,716
2021-02-14,Sutter,101,95872,8682,8642,79,8721,95
2021-02-14,Tehama,103,63373,4545,4490,485,4975,30
2021-02-14,Trinity,105,12862,456,272,71,343,3
2021-02-14,Tulare,107,460477,47554,46263,7648,53911,715
2021-02-14,Tuolumne,109,53932,3732,3764,33,3797,49
2021-02-14,Ventura,111,848112,76461,75742,2716,78458,629
2021-02-14,Yolo,113,214977,12600,12399,203,12602,175
2021-02-14,Yuba,115,75493,5395,5314,82,5396,38
2021-02-13,Alameda,001,1643700,79234,78246,1684,79930,995
2021-02-13,Alpine,003,1148,78,76,0,76,0
2021-02-13,Amador,005,37829,3421,3387,29,3416,38
2021-02-13,Butte,007,227075,11145,10699,1554,12253,155
2021-02-13,Calaveras,009,45235,1874,1863,12,1875,21
2021-02-13,Colusa,011,21464,1854,1837,250,2087,10
2021-02-13,Contra Costa,013,1133247,61627,60100,1047,61147,629
2021-02-13,Del Norte,015,27424,957,908,4,912,2
2021-02-13,El Dorado,017,186661,8972,8758,587,9345,93
2021-02-13,Fresno,019,978130,94607,92807,7461,100268,1287
2021-02-13,Glenn,021,27897,2215,2182,481,2663,14
2021-02-13,Humboldt,023,135768,3013,2974,20,2994,29
2021-02-13,Imperial,025,180216,27068,26680,2470,29150,580
2021-02-13,Inyo,027,18085,1221,1168,8,1176,32
2021-02-13,Kern,029,883053,91949,89915,9409,99324,957
2021-02-13,Kings,031,150075,21953,21513,942,22455,205
2021-02-13,Lake,033,64148,3085,3025,1,3026,37
2021-02-13,Lassen,035,31185,5072,5028,92,5120,1
2021-02-13,Los Angeles,037,10098052,1159612,1133752,38641,1172393,18822
2021-02-13,Madera,039,155013,15319,15053,777,15830,106
2021-02-13,Marin,041,260295,12945,12757,152,12909,201
2021-02-13,Mariposa,043,17540,373,365,4,369,4
2021-02-13,Mendocino,045,87422,3574,3466,68,3534,38
2021-02-13,Merced,047,269075,27705,27541,858,28399,368
2021-02-13,Modoc,049,8938,336,325,113,438,3
2021-02-13,Mono,051,14174,1169,1176,16,1192,3
2021-02-13,Monterey,053,433212,41404,40731,1624,42355,301
2021-02-13,Napa,055,140530,8867,8809,33,8842,57
2021-02-13,Nevada,057,99092,3869,3742,151,3893,47
2021-02-13,Orange,059,3164182,244150,241545,10005,251550,3520
2021-02-13,Placer,061,380077,20176,19214,1073,20287,230
2021-02-13,Plumas,063,18699,636,616,10,626,4
2021-02-13,Riverside,065,2383286,282507,275276,13256,288532,3462
2021-02-13,Sacramento,067,1510023,92254,90401,1168,91569,1302
2021-02-13,San Benito,069,59416,5660,5633,84,5717,56
2021-02-13,San Bernardino,071,2135413,283760,277405,8422,285827,2899
2021-02-13,San Diego,073,3302833,259381,251679,12495,264174,3009
2021-02-13,San Francisco,075,870044,33491,33291,1006,34297,364
2021-02-13,San Joaquin,077,732212,65586,64105,2675,66780,977
2021-02-13,San Luis Obispo,079,281455,19271,18803,532,19335,225
2021-02-13,San Mateo,081,765935,38815,37745,387,38132,277
2021-02-13,Santa Barbara,083,443738,31441,30594,1018,31612,374
2021-02-13,Santa Clara,085,1922200,107878,107125,543,107668,1570
2021-02-13,Santa Cruz,087,273765,15113,14198,763,14961,173
2021-02-13,Shasta,089,179085,10748,10713,1168,11881,139
2021-02-13,Sierra,091,2930,50,47,12,59,0
2021-02-13,Siskiyou,093,43540,1437,1336,220,1556,4
2021-02-13,Solano,095,438530,29362,29084,343,29427,148
2021-02-13,Sonoma,097,501317,27318,27157,171,27328,276
2021-02-13,Stanislaus,099,539301,49529,48568,5184,53752,697
2021-02-13,Sutter,101,95872,8670,8626,79,8705,94
2021-02-13,Tehama,103,63373,4534,4484,484,4968,30
2021-02-13,Trinity,105,12862,455,272,70,342,3
2021-02-13,Tulare,107,460477,47503,46162,7617,53779,709
2021-02-13,Tuolumne,109,53932,3731,3752,33,3785,49
2021-02-13,Ventura,111,848112,76321,75481,2710,78191,618
2021-02-13,Yolo,113,214977,12587,12374,202,12576,175
2021-02-13,Yuba,115,75493,5387,5289,82,5371,38
2021-02-12,Alameda,001,1643700,79087,77958,1678,79636,974
2021-02-12,Alpine,003,1148,78,76,0,76,0
2021-02-12,Amador,005,37829,3417,3381,29,3410,38
2021-02-12,Butte,007,227075,11132,10655,1547,12202,155
2021-02-12,Calaveras,009,45235,1871,1860,12,1872,21
2021-02-12,Colusa,011,21464,1854,1836,250,2086,10
2021-02-12,Contra Costa,013,1133247,61475,59878,1043,60921,620
2021-02-12,Del Norte,015,27424,947,901,4,905,2
2021-02-12,El Dorado,017,186661,8956,8725,584,9309,92
2021-02-12,Fresno,019,978130,94453,92520,7441,99961,1273
2021-02-12,Glenn,021,27897,2212,2175,481,2656,14
2021-02-12,Humboldt,023,135768,3005,2961,20,2981,29
2021-02-12,Imperial,025,180216,27060,26646,2467,29113,585
2021-02-12,Inyo,027,18085,1215,1156,8,1164,32
2021-02-12,Kern,029,883053,91835,89532,9375,98907,949
2021-02-12,Kings,031,150075,21921,21462,937,22399,202
2021-02-12,Lake,033,64148,3080,3012,1,3013,36
2021-02-12,Lassen,035,31185,5070,5015,92,5107,1
2021-02-12,Los Angeles,037,10098052,1158406,1131185,38572,1169757,18637
2021-02-12,Madera,039,155013,15292,15022,774,15796,106
2021-02-12,Marin,041,260295,12919,12720,152,12872,200
2021-02-12,Mariposa,043,17540,372,365,4,369,4
2021-02-12,Mendocino,045,87422,3572,3447,68,3515,38
2021-02-12,Merced,047,269075,27654,27453,855,28308,367
2021-02-12,Modoc,049,8938,336,324,113,437,3
2021-02-12,Mono,051,14174,1168,1172,16,1188,3
2021-02-12,Monterey,053,433212,41356,40633,1615,42248,297
2021-02-12,Napa,055,140530,8855,8785,33,8818,55
2021-02-12,Nevada,057,99092,3864,3728,151,3879,47
2021-02-12,Orange,059,3164182,243911,241075,9990,251065,3505
2021-02-12,Placer,061,380077,20134,19174,1068,20242,230
2021-02-12,Plumas,063,18699,635,614,10,624,4
2021-02-12,Riverside,065,2383286,282229,274792,13239,288031,3438
2021-02-12,Sacramento,067,1510023,92052,90252,1167,91419,1295
2021-02-12,San Benito,069,59416,5644,5622,83,5705,56
2021-02-12,San Bernardino,071,2135413,283570,276890,8411,285301,2827
2021-02-12,San Diego,073,3302833,258996,250788,12469,263257,2979
2021-02-12,San Francisco,075,870044,33431,33179,1002,34181,359
2021-02-12,San Joaquin,077,732212,65491,63966,2667,66633,975
2021-02-12,San Luis Obispo,079,281455,19230,18687,531,19218,224
2021-02-12,San Mateo,081,765935,38743,37560,387,37947,254
2021-02-12,Santa Barbara,083,443738,31370,30454,1013,31467,372
2021-02-12,Santa Clara,085,1922200,107706,106759,540,107299,1543
2021-02-12,Santa Cruz,087,273765,15093,14147,763,14910,170
2021-02-12,Shasta,089,179085,10730,10693,1158,11851,142
2021-02-12,Sierra,091,2930,49,45,12,57,0
2021-02-12,Siskiyou,093,43540,1433,1324,217,1541,4
2021-02-12,Solano,095,438530,29330,28996,340,29336,147
2021-02-12,Sonoma,097,501317,27263,27064,167,27231,275
2021-02-12,Stanislaus,099,539301,49442,48418,5162,53580,697
2021-02-12,Sutter,101,95872,8657,8609,79,8688,93
2021-02-12,Tehama,103,63373,4527,4470,483,4953,27
2021-02-12,Trinity,105,12862,455,269,70,339,3
2021-02-12,Tulare,107,460477,47425,46016,7590,53606,710
2021-02-12,Tuolumne,109,53932,3728,3736,32,3768,49
2021-02-12,Ventura,111,848112,76151,75210,2703,77913,605
2021-02-12,Yolo,113,214977,12566,12340,202,12542,175
2021-02-12,Yuba,115,75493,5379,5274,82,5356,38
2021-02-11,Alameda,001,1643700,78860,77564,1673,79237,960
2021-02-11,Alpine,003,1148,77,76,0,76,0
2021-02-11,Amador,005,37829,3413,3368,29,3397,35
2021-02-11,Butte,007,227075,11109,10624,1546,12170,155
2021-02-11,Calaveras,009,45235,1868,1856,12,1868,21
2021-02-11,Colusa,011,21464,1849,1823,248,2071,10
2021-02-11,Contra Costa,013,1133247,61308,59633,1039,60672,605
2021-02-11,Del Norte,015,27424,942,894,4,898,2
2021-02-11,El Dorado,017,186661,8935,8698,584,9282,92
2021-02-11,Fresno,019,978130,94300,92168,7416,99584,1255
2021-02-11,Glenn,021,27897,2207,2166,480,2646,14
2021-02-11,Humboldt,023,135768,2992,2954,19,2973,29
2021-02-11,Imperial,025,180216,27036,26545,2465,29010,578
2021-02-11,Inyo,027,18085,1206,1144,8,1152,32
2021-02-11,Kern,029,883053,91644,89224,9332,98556,941
2021-02-11,Kings,031,150075,21891,21373,934,22307,202
2021-02-11,Lake,033,64148,3070,3002,1,3003,36
2021-02-11,Lassen,035,31185,5059,5004,89,5093,1
2021-02-11,Los Angeles,037,10098052,1156775,1128437,38503,1166940,18500
2021-02-11,Madera,039,155013,15271,14984,772,15756,106
2021-02-11,Marin,041,260295,12882,12682,152,12834,200
2021-02-11,Mariposa,043,17540,372,361,4,365,4
2021-02-11,Mendocino,045,87422,3565,3420,68,3488,38
2021-02-11,Merced,047,269075,27588,27325,851,28176,363
2021-02-11,Modoc,049,8938,335,317,113,430,3
2021-02-11,Mono,051,14174,1164,1173,16,1189,3
2021-02-11,Monterey,053,433212,41250,40469,1609,42078,295
2021-02-11,Napa,055,140530,8834,8777,33,8810,55
2021-02-11,Nevada,057,99092,3848,3720,151,3871,47
2021-02-11,Orange,059,3164182,243545,240590,9967,250557,3476
2021-02-11,Placer,061,380077,20094,19118,1067,20185,224
2021-02-11,Plumas,063,18699,634,592,10,602,4
2021-02-11,Riverside,065,2383286,281863,274313,13224,287537,3394
2021-02-11,Sacramento,067,1510023,91809,89988,1161,91149,1286
2021-02-11,San Benito,069,59416,5635,5609,83,5692,56
2021-02-11,San Bernardino,071,2135413,283271,276349,8397,284746,2774
2021-02-11,San Diego,073,3302833,258443,249971,12435,262406,2955
2021-02-11,San Francisco,075,870044,33347,33076,993,34069,356
2021-02-11,San Joaquin,077,732212,65322,63719,2657,66376,971
2021-02-11,San Luis Obispo,079,281455,19165,18615,527,19142,219
2021-02-11,San Mateo,081,765935,38652,37439,385,37824,253
2021-02-11,Santa Barbara,083,443738,31273,30375,1008,31383,370
2021-02-11,Santa Clara,085,1922200,107446,106392,534,106926,1507
2021-02-11,Santa Cruz,087,273765,15070,14088,758,14846,165
2021-02-11,Shasta,089,179085,10706,10672,1154,11826,140
2021-02-11,Sierra,091,2930,49,45,12,57,0
2021-02-11,Siskiyou,093,43540,1418,1320,217,1537,4
2021-02-11,Solano,095,438530,29277,28885,340,29225,138
2021-02-11,Sonoma,097,501317,27178,26971,164,27135,272
2021-02-11,Stanislaus,099,539301,49297,48205,5150,53355,697
2021-02-11,Sutter,101,95872,8643,8590,78,8668,93
2021-02-11,Tehama,103,63373,4521,4463,483,4946,26
2021-02-11,Trinity,105,12862,455,269,70,339,3
2021-02-11,Tulare,107,460477,47330,45897,7549,53446,706
2021-02-11,Tuolumne,109,53932,3691,3716,32,3748,48
2021-02-11,Ventura,111,848112,75949,74959,2694,77653,590
2021-02-11,Yolo,113,214977,12542,12303,200,12503,173
2021-02-11,Yuba,115,75493,5365,5261,81,5342,38
2021-02-10,Alameda,001,1643700,78656,77344,1672,79016,944
2021-02-10,Alpine,003,1148,77,76,0,76,0
2021-02-10,Amador,005,37829,3401,3348,29,3377,35
2021-02-10,Butte,007,227075,11081,10594,1545,12139,155
2021-02-10,Calaveras,009,45235,1866,1850,12,1862,21
2021-02-10,Colusa,011,21464,1842,1815,246,2061,10
2021-02-10,Contra Costa,013,1133247,61134,59488,1037,60525,590
2021-02-10,Del Norte,015,27424,936,888,4,892,2
2021-02-10,El Dorado,017,186661,8904,8682,580,9262,87
2021-02-10,Fresno,019,978130,94125,91876,7390,99266,1247
2021-02-10,Glenn,021,27897,2203,2160,478,2638,14
2021-02-10,Humboldt,023,135768,2984,2924,19,2943,29
2021-02-10,Imperial,025,180216,26998,26522,2462,28984,578
2021-02-10,Inyo,027,18085,1194,1138,8,1146,30
2021-02-10,Kern,029,883053,91438,88933,9278,98211,926
2021-02-10,Kings,031,150075,21848,21294,932,22226,197
2021-02-10,Lake,033,64148,3057,2975,1,2976,36
2021-02-10,Lassen,035,31185,5055,4993,89,5082,1
2021-02-10,Los Angeles,037,10098052,1155029,1125437,38373,1163810,18338
2021-02-10,Madera,039,155013,15232,14925,770,15695,105
2021-02-10,Marin,041,260295,12845,12651,152,12803,199
2021-02-10,Mariposa,043,17540,370,360,4,364,4
2021-02-10,Mendocino,045,87422,3550,3395,68,3463,38
2021-02-10,Merced,047,269075,27505,27246,840,28086,359
2021-02-10,Modoc,049,8938,334,315,111,426,3
2021-02-10,Mono,051,14174,1159,1170,16,1186,3
2021-02-10,Monterey,053,433212,41173,40366,1594,41960,288
2021-02-10,Napa,055,140530,8815,8769,33,8802,55
2021-02-10,Nevada,057,99092,3833,3693,149,3842,47
2021-02-10,Orange,059,3164182,243128,239974,9936,249910,3439
2021-02-10,Placer,061,380077,20055,19062,1062,20124,220
2021-02-10,Plumas,063,18699,631,589,10,599,2
2021-02-10,Riverside,065,2383286,281436,273721,13214,286935,3374
2021-02-10,Sacramento,067,1510023,91558,89653,1157,90810,1275
2021-02-10,San Benito,069,59416,5621,5591,83,5674,55
2021-02-10,San Bernardino,071,2135413,282915,275616,8381,283997,2696
2021-02-10,San Diego,073,3302833,257861,248858,12397,261255,2904
2021-02-10,San Francisco,075,870044,33264,32955,990,33945,351
2021-02-10,San Joaquin,077,732212,65180,63484,2643,66127,954
2021-02-10,San Luis Obispo,079,281455,19086,18549,525,19074,216
2021-02-10,San Mateo,081,765935,38562,37323,385,37708,245
2021-02-10,Santa Barbara,083,443738,31182,30216,1003,31219,359
2021-02-10,Santa Clara,085,1922200,107206,106048,531,106579,1489
2021-02-10,Santa Cruz,087,273765,15034,14007,756,14763,165
2021-02-10,Shasta,089,179085,10683,10645,1151,11796,142
2021-02-10,Sierra,091,2930,49,45,12,57,0
2021-02-10,Siskiyou,093,43540,1413,1314,216,1530,4
2021-02-10,Solano,095,438530,29202,28835,338,29173,137
2021-02-10,Sonoma,097,501317,27083,26881,162,27043,271
2021-02-10,Stanislaus,099,539301,49180,48016,5134,53150,696
2021-02-10,Sutter,101,95872,8626,8571,78,8649,93
2021-02-10,Tehama,103,63373,4513,4445,483,4928,23
2021-02-10,Trinity,105,12862,452,268,70,338,3
2021-02-10,Tulare,107,460477,47213,45782,7510,53292,696
2021-02-10,Tuolumne,109,53932,3683,3691,32,3723,48
2021-02-10,Ventura,111,848112,75721,74651,2677,77328,580
2021-02-10,Yolo,113,214977,12518,12276,199,12475,174
2021-02-10,Yuba,115,75493,5347,5241,81,5322,38
2021-02-09,Alameda,001,1643700,78392,77018,1669,78687,936
2021-02-09,Alpine,003,1148,77,76,0,76,0
2021-02-09,Amador,005,37829,3393,3347,29,3376,35
2021-02-09,Butte,007,227075,11055,10563,1542,12105,153
2021-02-09,Calaveras,009,45235,1862,1847,12,1859,21
2021-02-09,Colusa,011,21464,1833,1812,241,2053,10
2021-02-09,Contra Costa,013,1133247,60944,59307,1031,60338,583
2021-02-09,Del Norte,015,27424,930,886,4,890,2
2021-02-09,El Dorado,017,186661,8877,8663,579,9242,87
2021-02-09,Fresno,019,978130,93883,91730,7362,99092,1211
2021-02-09,Glenn,021,27897,2199,2156,478,2634,14
2021-02-09,Humboldt,023,135768,2976,2904,19,2923,29
2021-02-09,Imperial,025,180216,26967,26509,2459,28968,568
2021-02-09,Inyo,027,18085,1186,1137,8,1145,30
2021-02-09,Kern,029,883053,91186,88684,9232,97916,920
2021-02-09,Kings,031,150075,21806,21275,930,22205,196
2021-02-09,Lake,033,64148,3046,2955,1,2956,36
2021-02-09,Lassen,035,31185,5048,4983,89,5072,1
2021-02-09,Los Angeles,037,10098052,1153058,1122745,38288,1161033,18198
2021-02-09,Madera,039,155013,15212,14912,767,15679,105
2021-02-09,Marin,041,260295,12812,12623,151,12774,197
2021-02-09,Mariposa,043,17540,368,355,4,359,4
2021-02-09,Mendocino,045,87422,3532,3369,68,3437,38
2021-02-09,Merced,047,269075,27407,27166,835,28001,354
2021-02-09,Modoc,049,8938,333,316,111,427,3
2021-02-09,Mono,051,14174,1158,1167,16,1183,3
2021-02-09,Monterey,053,433212,41065,40279,1581,41860,285
2021-02-09,Napa,055,140530,8802,8749,33,8782,55
2021-02-09,Nevada,057,99092,3817,3687,149,3836,44
2021-02-09,Orange,059,3164182,242716,239169,9905,249074,3406
2021-02-09,Placer,061,380077,19990,19008,1055,20063,220
2021-02-09,Plumas,063,18699,631,584,10,594,2
2021-02-09,Riverside,065,2383286,280942,273465,13197,286662,3334
2021-02-09,Sacramento,067,1510023,91247,89378,1156,90534,1265
2021-02-09,San Benito,069,59416,5609,5566,82,5648,54
2021-02-09,San Bernardino,071,2135413,282541,274998,8368,283366,2613
2021-02-09,San Diego,073,3302833,257203,248048,12354,260402,2853
2021-02-09,San Francisco,075,870044,33185,32782,980,33762,349
2021-02-09,San Joaquin,077,732212,65006,63341,2638,65979,937
2021-02-09,San Luis Obispo,079,281455,19027,18489,524,19013,216
2021-02-09,San Mateo,081,765935,38431,37227,384,37611,235
2021-02-09,Santa Barbara,083,443738,31070,30118,997,31115,351
2021-02-09,Santa Clara,085,1922200,106900,105762,528,106290,1463
2021-02-09,Santa Cruz,087,273765,14984,13958,751,14709,162
2021-02-09,Shasta,089,179085,10655,10595,1149,11744,139
2021-02-09,Sierra,091,2930,49,44,12,56,0
2021-02-09,Siskiyou,093,43540,1405,1306,214,1520,4
2021-02-09,Solano,095,438530,29123,28769,335,29104,131
2021-02-09,Sonoma,097,501317,26993,26826,160,26986,267
2021-02-09,Stanislaus,099,539301,49020,47906,5118,53024,679
2021-02-09,Sutter,101,95872,8610,8541,78,8619,92
2021-02-09,Tehama,103,63373,4506,4416,482,4898,22
2021-02-09,Trinity,105,12862,452,266,70,336,3
2021-02-09,Tulare,107,460477,47079,45704,7456,53160,686
2021-02-09,Tuolumne,109,53932,3664,3673,32,3705,48
2021-02-09,Ventura,111,848112,75469,74333,2669,77002,567
2021-02-09,Yolo,113,214977,12476,12220,199,12419,174
2021-02-09,Yuba,115,75493,5338,5235,81,5316,35
2021-02-08,Alameda,001,1643700,78128,76735,1664,78399,924
2021-02-08,Alpine,003,1148,77,73,0,73,0
2021-02-08,Amador,005,37829,3386,3344,28,3372,33
2021-02-08,Butte,007,227075,11033,10524,1538,12062,152
2021-02-08,Calaveras,009,45235,1861,1840,12,1852,21
2021-02-08,Colusa,011,21464,1825,1802,237,2039,10
2021-02-08,Contra Costa,013,1133247,60733,59039,1029,60068,567
2021-02-08,Del Norte,015,27424,927,885,4,889,2
2021-02-08,El Dorado,017,186661,8846,8627,577,9204,86
2021-02-08,Fresno,019,978130,93670,91430,7336,98766,1207
2021-02-08,Glenn,021,27897,2195,2148,476,2624,14
2021-02-08,Humboldt,023,135768,2968,2902,19,2921,29
2021-02-08,Imperial,025,180216,26945,26526,2457,28983,567
2021-02-08,Inyo,027,18085,1173,1126,8,1134,30
2021-02-08,Kern,029,883053,90969,88380,9172,97552,920
2021-02-08,Kings,031,150075,21744,21232,927,22159,195
2021-02-08,Lake,033,64148,3027,2949,1,2950,36
2021-02-08,Lassen,035,31185,5035,4976,89,5065,1
2021-02-08,Los Angeles,037,10098052,1150962,1120179,38166,1158345,17977
2021-02-08,Madera,039,155013,15176,14887,760,15647,93
2021-02-08,Marin,041,260295,12782,12591,151,12742,194
2021-02-08,Mariposa,043,17540,368,355,4,359,4
2021-02-08,Mendocino,045,87422,3518,3355,68,3423,38
2021-02-08,Merced,047,269075,27323,27082,830,27912,346
2021-02-08,Modoc,049,8938,331,318,111,429,3
2021-02-08,Mono,051,14174,1158,1165,16,1181,3
2021-02-08,Monterey,053,433212,40945,40186,1562,41748,283
2021-02-08,Napa,055,140530,8787,8719,33,8752,55
2021-02-08,Nevada,057,99092,3805,3671,149,3820,44
2021-02-08,Orange,059,3164182,242249,238715,9882,248597,3361
2021-02-08,Placer,061,380077,19948,18944,1049,19993,211
2021-02-08,Plumas,063,18699,630,584,10,594,2
2021-02-08,Riverside,065,2383286,280373,272904,13171,286075,3301
2021-02-08,Sacramento,067,1510023,90961,89267,1153,90420,1247
2021-02-08,San Benito,069,59416,5604,5553,81,5634,52
2021-02-08,San Bernardino,071,2135413,282138,274661,8362,283023,2587
2021-02-08,San Diego,073,3302833,256461,247259,12313,259572,2821
2021-02-08,San Francisco,075,870044,33091,32679,972,33651,348
2021-02-08,San Joaquin,077,732212,64844,63148,2628,65776,929
2021-02-08,San Luis Obispo,079,281455,18970,18421,519,18940,214
2021-02-08,San Mateo,081,765935,38322,37084,384,37468,232
2021-02-08,Santa Barbara,083,443738,30955,29978,990,30968,340
2021-02-08,Santa Clara,085,1922200,106576,105413,520,105933,1456
2021-02-08,Santa Cruz,087,273765,14945,13921,745,14666,161
2021-02-08,Shasta,089,179085,10628,10574,1143,11717,137
2021-02-08,Sierra,091,2930,49,44,12,56,0
2021-02-08,Siskiyou,093,43540,1402,1303,214,1517,4
2021-02-08,Solano,095,438530,29057,28644,333,28977,130
2021-02-08,Sonoma,097,501317,26902,26760,159,26919,259
2021-02-08,Stanislaus,099,539301,48865,47704,5090,52794,679
2021-02-08,Sutter,101,95872,8591,8526,78,8604,92
2021-02-08,Tehama,103,63373,4495,4403,479,4882,22
2021-02-08,Trinity,105,12862,450,266,70,336,3
2021-02-08,Tulare,107,460477,46971,45617,7416,53033,673
2021-02-08,Tuolumne,109,53932,3656,3647,32,3679,48
2021-02-08,Ventura,111,848112,75212,74068,2663,76731,565
2021-02-08,Yolo,113,214977,12444,12169,198,12367,162
2021-02-08,Yuba,115,75493,5322,5215,81,5296,35
2021-02-07,Alameda,001,1643700,77826,76500,1656,78156,924
2021-02-07,Alpine,003,1148,74,72,0,72,0
2021-02-07,Amador,005,37829,3365,3343,28,3371,33
2021-02-07,Butte,007,227075,11000,10513,1530,12043,152
2021-02-07,Calaveras,009,45235,1857,1837,12,1849,21
2021-02-07,Colusa,011,21464,1814,1795,235,2030,10
2021-02-07,Contra Costa,013,1133247,60488,58836,1024,59860,566
2021-02-07,Del Norte,015,27424,923,881,4,885,2
2021-02-07,El Dorado,017,186661,8817,8596,575,9171,86
2021-02-07,Fresno,019,978130,93440,91184,7297,98481,1207
2021-02-07,Glenn,021,27897,2191,2141,471,2612,14
2021-02-07,Humboldt,023,135768,2947,2895,19,2914,28
2021-02-07,Imperial,025,180216,26918,26518,2452,28970,567
2021-02-07,Inyo,027,18085,1162,1124,8,1132,27
2021-02-07,Kern,029,883053,90722,88146,9114,97260,920
2021-02-07,Kings,031,150075,21683,21180,924,22104,192
2021-02-07,Lake,033,64148,3012,2940,1,2941,36
2021-02-07,Lassen,035,31185,5024,4973,89,5062,1
2021-02-07,Los Angeles,037,10098052,1148205,1117551,38036,1155587,17889
2021-02-07,Madera,039,155013,15142,14850,756,15606,93
2021-02-07,Marin,041,260295,12749,12571,149,12720,194
2021-02-07,Mariposa,043,17540,367,355,4,359,4
2021-02-07,Mendocino,045,87422,3501,3348,68,3416,38
2021-02-07,Merced,047,269075,27211,26977,818,27795,346
2021-02-07,Modoc,049,8938,331,317,107,424,3
2021-02-07,Mono,051,14174,1155,1165,16,1181,3
2021-02-07,Monterey,053,433212,40809,40113,1543,41656,283
2021-02-07,Napa,055,140530,8764,8701,33,8734,55
2021-02-07,Nevada,057,99092,3794,3643,149,3792,44
2021-02-07,Orange,059,3164182,241649,238155,9849,248004,3336
2021-02-07,Placer,061,380077,19901,18903,1036,19939,211
2021-02-07,Plumas,063,18699,630,584,10,594,2
2021-02-07,Riverside,065,2383286,279845,272301,13150,285451,3267
2021-02-07,Sacramento,067,1510023,90629,88919,1146,90065,1246
2021-02-07,San Benito,069,59416,5585,5548,80,5628,52
2021-02-07,San Bernardino,071,2135413,281544,274316,8337,282653,2587
2021-02-07,San Diego,073,3302833,255675,246561,12249,258810,2821
2021-02-07,San Francisco,075,870044,32971,32609,960,33569,348
2021-02-07,San Joaquin,077,732212,64570,63051,2613,65664,929
2021-02-07,San Luis Obispo,079,281455,18898,18349,512,18861,214
2021-02-07,San Mateo,081,765935,38188,36984,382,37366,232
2021-02-07,Santa Barbara,083,443738,30815,29815,979,30794,340
2021-02-07,Santa Clara,085,1922200,106236,105118,510,105628,1450
2021-02-07,Santa Cruz,087,273765,14891,13887,740,14627,161
2021-02-07,Shasta,089,179085,10608,10570,1135,11705,137
2021-02-07,Sierra,091,2930,49,43,12,55,0
2021-02-07,Siskiyou,093,43540,1395,1295,212,1507,4
2021-02-07,Solano,095,438530,28946,28567,332,28899,130
2021-02-07,Sonoma,097,501317,26795,26684,155,26839,257
2021-02-07,Stanislaus,099,539301,48675,47551,5058,52609,679
2021-02-07,Sutter,101,95872,8563,8515,78,8593,92
2021-02-07,Tehama,103,63373,4479,4396,478,4874,22
2021-02-07,Trinity,105,12862,447,264,68,332,3
2021-02-07,Tulare,107,460477,46849,45520,7338,52858,671
2021-02-07,Tuolumne,109,53932,3632,3619,31,3650,48
2021-02-07,Ventura,111,848112,74901,73759,2651,76410,561
2021-02-07,Yolo,113,214977,12399,12135,198,12333,162
2021-02-07,Yuba,115,75493,5307,5198,79,5277,35
2021-02-06,Alameda,001,1643700,77672,76170,1645,77815,922
2021-02-06,Alpine,003,1148,74,72,0,72,0
2021-02-06,Amador,005,37829,3359,3306,28,3334,33
2021-02-06,Butte,007,227075,10983,10480,1526,12006,150
2021-02-06,Calaveras,009,45235,1855,1832,12,1844,21
2021-02-06,Colusa,011,21464,1812,1791,234,2025,10
2021-02-06,Contra Costa,013,1133247,60341,58567,1018,59585,566
2021-02-06,Del Norte,015,27424,919,879,4,883,2
2021-02-06,El Dorado,017,186661,8810,8575,571,9146,86
2021-02-06,Fresno,019,978130,93327,90944,7276,98220,1207
2021-02-06,Glenn,021,27897,2189,2136,470,2606,14
2021-02-06,Humboldt,023,135768,2936,2880,19,2899,28
2021-02-06,Imperial,025,180216,26906,26514,2451,28965,567
2021-02-06,Inyo,027,18085,1159,1113,8,1121,27
2021-02-06,Kern,029,883053,90568,87919,9068,96987,912
2021-02-06,Kings,031,150075,21653,21156,924,22080,190
2021-02-06,Lake,033,64148,3007,2920,1,2921,34
2021-02-06,Lassen,035,31185,5020,4964,88,5052,1
2021-02-06,Los Angeles,037,10098052,1146850,1114718,37938,1152656,17793
2021-02-06,Madera,039,155013,15121,14807,754,15561,93
2021-02-06,Marin,041,260295,12729,12531,149,12680,194
2021-02-06,Mariposa,043,17540,366,355,3,358,4
2021-02-06,Mendocino,045,87422,3483,3316,67,3383,38
2021-02-06,Merced,047,269075,27125,26881,810,27691,346
2021-02-06,Modoc,049,8938,331,313,107,420,3
2021-02-06,Mono,051,14174,1154,1159,16,1175,3
2021-02-06,Monterey,053,433212,40751,39995,1535,41530,282
2021-02-06,Napa,055,140530,8751,8639,33,8672,55
2021-02-06,Nevada,057,99092,3782,3624,149,3773,43
2021-02-06,Orange,059,3164182,241285,237391,9815,247206,3293
2021-02-06,Placer,061,380077,19864,18836,1033,19869,211
2021-02-06,Plumas,063,18699,630,584,10,594,2
2021-02-06,Riverside,065,2383286,279476,271741,13131,284872,3243
2021-02-06,Sacramento,067,1510023,90412,88532,1136,89668,1237
2021-02-06,San Benito,069,59416,5567,5516,80,5596,52
2021-02-06,San Bernardino,071,2135413,281234,273718,8314,282032,2564
2021-02-06,San Diego,073,3302833,255179,245331,12214,257545,2812
2021-02-06,San Francisco,075,870044,32897,32437,950,33387,346
2021-02-06,San Joaquin,077,732212,64491,62840,2602,65442,906
2021-02-06,San Luis Obispo,079,281455,18856,18284,508,18792,214
2021-02-06,San Mateo,081,765935,38120,36824,379,37203,232
2021-02-06,Santa Barbara,083,443738,30739,29645,977,30622,337
2021-02-06,Santa Clara,085,1922200,106014,104639,505,105144,1439
2021-02-06,Santa Cruz,087,273765,14860,13845,736,14581,161
2021-02-06,Shasta,089,179085,10597,10561,1133,11694,137
2021-02-06,Sierra,091,2930,49,43,12,55,0
2021-02-06,Siskiyou,093,43540,1392,1289,211,1500,4
2021-02-06,Solano,095,438530,28910,28446,331,28777,129
2021-02-06,Sonoma,097,501317,26758,26564,153,26717,257
2021-02-06,Stanislaus,099,539301,48579,47325,5042,52367,679
2021-02-06,Sutter,101,95872,8555,8485,78,8563,92
2021-02-06,Tehama,103,63373,4470,4380,477,4857,22
2021-02-06,Trinity,105,12862,447,263,68,331,3
2021-02-06,Tulare,107,460477,46781,45349,7291,52640,664
2021-02-06,Tuolumne,109,53932,3625,3612,31,3643,48
2021-02-06,Ventura,111,848112,74721,73431,2645,76076,552
2021-02-06,Yolo,113,214977,12376,12061,198,12259,161
2021-02-06,Yuba,115,75493,5297,5177,78,5255,35
2021-02-05,Alameda,001,1643700,77444,75716,1643,77359,916
2021-02-05,Alpine,003,1148,74,72,0,72,0
2021-02-05,Amador,005,37829,3354,3299,27,3326,33
2021-02-05,Butte,007,227075,10964,10421,1519,11940,150
2021-02-05,Calaveras,009,45235,1851,1818,12,1830,21
2021-02-05,Colusa,011,21464,1808,1785,234,2019,10
2021-02-05,Contra Costa,013,1133247,60180,58195,1016,59211,560
2021-02-05,Del Norte,015,27424,918,874,4,878,2
2021-02-05,El Dorado,017,186661,8790,8527,569,9096,86
2021-02-05,Fresno,019,978130,93125,90513,7255,97768,1194
2021-02-05,Glenn,021,27897,2186,2122,464,2586,14
2021-02-05,Humboldt,023,135768,2926,2857,19,2876,28
2021-02-05,Imperial,025,180216,26887,26474,2450,28924,557
2021-02-05,Inyo,027,18085,1155,1104,8,1112,27
2021-02-05,Kern,029,883053,90399,87470,9001,96471,906
2021-02-05,Kings,031,150075,21615,21021,921,21942,190
2021-02-05,Lake,033,64148,2995,2906,1,2907,33
2021-02-05,Lassen,035,31185,5016,4936,88,5024,1
2021-02-05,Los Angeles,037,10098052,1144753,1110384,37803,1148187,17608
2021-02-05,Madera,039,155013,15087,14752,749,15501,95
2021-02-05,Marin,041,260295,12694,12479,149,12628,193
2021-02-05,Mariposa,043,17540,366,352,3,355,4
2021-02-05,Mendocino,045,87422,3469,3272,67,3339,38
2021-02-05,Merced,047,269075,27065,26760,809,27569,345
2021-02-05,Modoc,049,8938,331,312,107,419,3
2021-02-05,Mono,051,14174,1153,1157,16,1173,3
2021-02-05,Monterey,053,433212,40684,39840,1524,41364,281
2021-02-05,Napa,055,140530,8737,8598,33,8631,55
2021-02-05,Nevada,057,99092,3779,3607,149,3756,43
2021-02-05,Orange,059,3164182,240858,236335,9788,246123,3260
2021-02-05,Placer,061,380077,19828,18756,1031,19787,211
2021-02-05,Plumas,063,18699,628,578,10,588,2
2021-02-05,Riverside,065,2383286,279062,270666,13112,283778,3235
2021-02-05,Sacramento,067,1510023,90232,87992,1129,89121,1231
2021-02-05,San Benito,069,59416,5556,5502,80,5582,51
2021-02-05,San Bernardino,071,2135413,280890,272938,8296,281234,2495
2021-02-05,San Diego,073,3302833,254603,244066,12179,256245,2777
2021-02-05,San Francisco,075,870044,32807,32229,939,33168,337
2021-02-05,San Joaquin,077,732212,64342,62565,2594,65159,902
2021-02-05,San Luis Obispo,079,281455,18795,18152,504,18656,213
2021-02-05,San Mateo,081,765935,38036,36582,378,36960,227
2021-02-05,Santa Barbara,083,443738,30642,29455,964,30419,334
2021-02-05,Santa Clara,085,1922200,105766,104112,503,104615,1421
2021-02-05,Santa Cruz,087,273765,14839,13776,734,14510,161
2021-02-05,Shasta,089,179085,10581,10507,1126,11633,136
2021-02-05,Sierra,091,2930,49,42,12,54,0
2021-02-05,Siskiyou,093,43540,1385,1276,209,1485,4
2021-02-05,Solano,095,438530,28860,28283,331,28614,127
2021-02-05,Sonoma,097,501317,26689,26423,150,26573,252
2021-02-05,Stanislaus,099,539301,48434,47024,5024,52048,678
2021-02-05,Sutter,101,95872,8535,8443,78,8521,92
2021-02-05,Tehama,103,63373,4461,4355,476,4831,22
2021-02-05,Trinity,105,12862,446,260,68,328,3
2021-02-05,Tulare,107,460477,46705,45138,7241,52379,663
2021-02-05,Tuolumne,109,53932,3599,3595,31,3626,45
2021-02-05,Ventura,111,848112,74476,72953,2633,75586,546
2021-02-05,Yolo,113,214977,12357,12025,193,12218,162
2021-02-05,Yuba,115,75493,5280,5145,78,5223,35
2021-02-04,Alameda,001,1643700,77159,75422,1637,77059,899
2021-02-04,Alpine,003,1148,73,72,0,72,0
2021-02-04,Amador,005,37829,3351,3288,27,3315,33
2021-02-04,Butte,007,227075,10931,10386,1511,11897,147
2021-02-04,Calaveras,009,45235,1849,1808,12,1820,21
2021-02-04,Colusa,011,21464,1804,1777,232,2009,10
2021-02-04,Contra Costa,013,1133247,59992,57991,1012,59003,550
2021-02-04,Del Norte,015,27424,912,870,4,874,2
2021-02-04,El Dorado,017,186661,8764,8490,566,9056,86
2021-02-04,Fresno,019,978130,92910,90126,7228,97354,1114
2021-02-04,Glenn,021,27897,2181,2102,463,2565,14
2021-02-04,Humboldt,023,135768,2916,2827,19,2846,28
2021-02-04,Imperial,025,180216,26841,26411,2448,28859,556
2021-02-04,Inyo,027,18085,1143,1084,8,1092,27
2021-02-04,Kern,029,883053,90125,87156,8923,96079,898
2021-02-04,Kings,031,150075,21564,20918,914,21832,187
2021-02-04,Lake,033,64148,2983,2882,1,2883,34
2021-02-04,Lassen,035,31185,5013,4927,88,5015,1
2021-02-04,Los Angeles,037,10098052,1141953,1106323,37676,1143999,17396
2021-02-04,Madera,039,155013,15057,14706,746,15452,95
2021-02-04,Marin,041,260295,12658,12431,149,12580,192
2021-02-04,Mariposa,043,17540,366,348,3,351,4
2021-02-04,Mendocino,045,87422,3451,3240,65,3305,38
2021-02-04,Merced,047,269075,26971,26629,806,27435,345
2021-02-04,Modoc,049,8938,331,309,107,416,3
2021-02-04,Mono,051,14174,1151,1153,16,1169,3
2021-02-04,Monterey,053,433212,40573,39619,1507,41126,279
2021-02-04,Napa,055,140530,8708,8573,33,8606,55
2021-02-04,Nevada,057,99092,3759,3590,148,3738,37
2021-02-04,Orange,059,3164182,240214,235677,9746,245423,3238
2021-02-04,Placer,061,380077,19768,18711,1022,19733,210
2021-02-04,Plumas,063,18699,625,562,10,572,2
2021-02-04,Riverside,065,2383286,278298,269851,13073,282924,3230
2021-02-04,Sacramento,067,1510023,89932,87658,1119,88777,1222
2021-02-04,San Benito,069,59416,5542,5488,79,5567,51
2021-02-04,San Bernardino,071,2135413,280341,272223,8276,280499,2409
2021-02-04,San Diego,073,3302833,253815,242613,12113,254726,2738
2021-02-04,San Francisco,075,870044,32693,32116,930,33046,326
2021-02-04,San Joaquin,077,732212,64117,62374,2586,64960,883
2021-02-04,San Luis Obispo,079,281455,18728,18058,502,18560,211
2021-02-04,San Mateo,081,765935,37915,36437,375,36812,226
2021-02-04,Santa Barbara,083,443738,30507,29344,947,30291,322
2021-02-04,Santa Clara,085,1922200,105423,103781,500,104281,1404
2021-02-04,Santa Cruz,087,273765,14806,13713,726,14439,156
2021-02-04,Shasta,089,179085,10555,10466,1121,11587,131
2021-02-04,Sierra,091,2930,49,42,12,54,0
2021-02-04,Siskiyou,093,43540,1376,1273,209,1482,4
2021-02-04,Solano,095,438530,28757,28192,330,28522,120
2021-02-04,Sonoma,097,501317,26607,26276,146,26422,249
2021-02-04,Stanislaus,099,539301,48272,46822,5005,51827,678
2021-02-04,Sutter,101,95872,8515,8401,78,8479,92
2021-02-04,Tehama,103,63373,4444,4327,475,4802,21
2021-02-04,Trinity,105,12862,445,260,67,327,3
2021-02-04,Tulare,107,460477,46578,44983,7179,52162,656
2021-02-04,Tuolumne,109,53932,3559,3585,31,3616,45
2021-02-04,Ventura,111,848112,74144,72595,2620,75215,537
2021-02-04,Yolo,113,214977,12323,11982,192,12174,161
2021-02-04,Yuba,115,75493,5254,5135,78,5213,34
2021-02-03,Alameda,001,1643700,76834,74968,1633,76601,880
2021-02-03,Alpine,003,1148,73,72,0,72,0
2021-02-03,Amador,005,37829,3347,3281,27,3308,33
2021-02-03,Butte,007,227075,10900,10355,1504,11859,144
2021-02-03,Calaveras,009,45235,1834,1799,11,1810,21
2021-02-03,Colusa,011,21464,1799,1773,231,2004,10
2021-02-03,Contra Costa,013,1133247,59752,57762,1000,58762,537
2021-02-03,Del Norte,015,27424,907,869,4,873,2
2021-02-03,El Dorado,017,186661,8744,8428,565,8993,86
2021-02-03,Fresno,019,978130,92689,89748,7189,96937,1015
2021-02-03,Glenn,021,27897,2171,2098,462,2560,14
2021-02-03,Humboldt,023,135768,2906,2800,19,2819,27
2021-02-03,Imperial,025,180216,26805,26363,2442,28805,547
2021-02-03,Inyo,027,18085,1133,1071,8,1079,27
2021-02-03,Kern,029,883053,89882,86771,8882,95653,877
2021-02-03,Kings,031,150075,21503,20831,912,21743,172
2021-02-03,Lake,033,64148,2965,2869,1,2870,33
2021-02-03,Lassen,035,31185,5001,4910,88,4998,1
2021-02-03,Los Angeles,037,10098052,1138872,1101890,37549,1139439,17163
2021-02-03,Madera,039,155013,15018,14605,744,15349,94
2021-02-03,Marin,041,260295,12623,12406,149,12555,190
2021-02-03,Mariposa,043,17540,365,347,3,350,4
2021-02-03,Mendocino,045,87422,3425,3236,64,3300,38
2021-02-03,Merced,047,269075,26856,26520,801,27321,343
2021-02-03,Modoc,049,8938,330,308,107,415,3
2021-02-03,Mono,051,14174,1144,1146,16,1162,3
2021-02-03,Monterey,053,433212,40446,39500,1490,40990,279
2021-02-03,Napa,055,140530,8673,8534,33,8567,54
2021-02-03,Nevada,057,99092,3745,3572,148,3720,35
2021-02-03,Orange,059,3164182,239471,234738,9714,244452,3189
2021-02-03,Placer,061,380077,19713,18646,1020,19666,210
2021-02-03,Plumas,063,18699,625,559,10,569,2
2021-02-03,Riverside,065,2383286,277557,269019,13042,282061,3195
2021-02-03,Sacramento,067,1510023,89609,87415,1115,88530,1212
2021-02-03,San Benito,069,59416,5524,5463,76,5539,51
2021-02-03,San Bernardino,071,2135413,279854,271477,8253,279730,2308
2021-02-03,San Diego,073,3302833,252914,241015,12066,253081,2683
2021-02-03,San Francisco,075,870044,32563,31983,925,32908,325
2021-02-03,San Joaquin,077,732212,63889,61976,2576,64552,880
2021-02-03,San Luis Obispo,079,281455,18650,17922,499,18421,206
2021-02-03,San Mateo,081,765935,37777,36227,371,36598,225
2021-02-03,Santa Barbara,083,443738,30358,29121,937,30058,315
2021-02-03,Santa Clara,085,1922200,105107,103278,498,103776,1364
2021-02-03,Santa Cruz,087,273765,14751,13611,720,14331,154
2021-02-03,Shasta,089,179085,10512,10422,1116,11538,130
2021-02-03,Sierra,091,2930,49,42,12,54,0
2021-02-03,Siskiyou,093,43540,1365,1268,208,1476,4
2021-02-03,Solano,095,438530,28635,28057,330,28387,119
2021-02-03,Sonoma,097,501317,26523,26155,145,26300,248
2021-02-03,Stanislaus,099,539301,48095,46598,4986,51584,662
2021-02-03,Sutter,101,95872,8490,8379,78,8457,90
2021-02-03,Tehama,103,63373,4426,4309,472,4781,21
2021-02-03,Trinity,105,12862,445,260,66,326,3
2021-02-03,Tulare,107,460477,46407,44838,7123,51961,640
2021-02-03,Tuolumne,109,53932,3548,3568,31,3599,45
2021-02-03,Ventura,111,848112,73807,72124,2610,74734,526
2021-02-03,Yolo,113,214977,12299,11933,191,12124,161
2021-02-03,Yuba,115,75493,5236,5124,78,5202,34
2021-02-02,Alameda,001,1643700,76489,74642,1621,76263,869
2021-02-02,Alpine,003,1148,73,72,0,72,0
2021-02-02,Amador,005,37829,3316,3275,27,3302,33
2021-02-02,Butte,007,227075,10874,10307,1495,11802,141
2021-02-02,Calaveras,009,45235,1825,1786,11,1797,21
2021-02-02,Colusa,011,21464,1791,1769,226,1995,9
2021-02-02,Contra Costa,013,1133247,59472,57551,996,58547,536
2021-02-02,Del Norte,015,27424,901,868,4,872,2
2021-02-02,El Dorado,017,186661,8704,8405,565,8970,84
2021-02-02,Fresno,019,978130,92388,89542,7153,96695,1009
2021-02-02,Glenn,021,27897,2159,2090,459,2549,14
2021-02-02,Humboldt,023,135768,2894,2784,19,2803,25
2021-02-02,Imperial,025,180216,26752,26317,2436,28753,535
2021-02-02,Inyo,027,18085,1130,1074,8,1082,27
2021-02-02,Kern,029,883053,89579,86485,8806,95291,867
2021-02-02,Kings,031,150075,21425,20785,904,21689,172
2021-02-02,Lake,033,64148,2945,2857,1,2858,33
2021-02-02,Lassen,035,31185,4994,4908,88,4996,1
2021-02-02,Los Angeles,037,10098052,1135490,1097573,37384,1134957,16913
2021-02-02,Madera,039,155013,14967,14595,739,15334,94
2021-02-02,Marin,041,260295,12594,12367,149,12516,189
2021-02-02,Mariposa,043,17540,362,345,3,348,4
2021-02-02,Mendocino,045,87422,3392,3210,64,3274,38
2021-02-02,Merced,047,269075,26759,26427,794,27221,340
2021-02-02,Modoc,049,8938,325,306,107,413,3
2021-02-02,Mono,051,14174,1142,1147,16,1163,3
2021-02-02,Monterey,053,433212,40311,39371,1476,40847,278
2021-02-02,Napa,055,140530,8644,8505,33,8538,53
2021-02-02,Nevada,057,99092,3730,3548,148,3696,20
2021-02-02,Orange,059,3164182,238669,233783,9679,243462,3152
2021-02-02,Placer,061,380077,19655,18615,1016,19631,205
2021-02-02,Plumas,063,18699,625,560,10,570,2
2021-02-02,Riverside,065,2383286,276698,267901,13008,280909,3169
2021-02-02,Sacramento,067,1510023,89319,87107,1104,88211,1202
2021-02-02,San Benito,069,59416,5510,5444,75,5519,50
2021-02-02,San Bernardino,071,2135413,279174,270486,8223,278709,2244
2021-02-02,San Diego,073,3302833,251875,240047,11979,252026,2629
2021-02-02,San Francisco,075,870044,32409,31788,915,32703,324
2021-02-02,San Joaquin,077,732212,63668,61708,2562,64270,878
2021-02-02,San Luis Obispo,079,281455,18556,17811,497,18308,201
2021-02-02,San Mateo,081,765935,37613,36004,365,36369,225
2021-02-02,Santa Barbara,083,443738,30187,28951,930,29881,304
2021-02-02,Santa Clara,085,1922200,104641,102872,493,103365,1349
2021-02-02,Santa Cruz,087,273765,14692,13572,716,14288,150
2021-02-02,Shasta,089,179085,10486,10371,1106,11477,128
2021-02-02,Sierra,091,2930,49,42,12,54,0
2021-02-02,Siskiyou,093,43540,1358,1252,205,1457,4
2021-02-02,Solano,095,438530,28539,27963,326,28289,118
2021-02-02,Sonoma,097,501317,26407,26054,145,26199,247
2021-02-02,Stanislaus,099,539301,47875,46306,4954,51260,641
2021-02-02,Sutter,101,95872,8467,8340,78,8418,89
2021-02-02,Tehama,103,63373,4412,4289,471,4760,21
2021-02-02,Trinity,105,12862,445,260,66,326,3
2021-02-02,Tulare,107,460477,46251,44720,7057,51777,625
2021-02-02,Tuolumne,109,53932,3536,3548,31,3579,39
2021-02-02,Ventura,111,848112,73389,71557,2600,74157,514
2021-02-02,Yolo,113,214977,12254,11886,184,12070,158
2021-02-02,Yuba,115,75493,5218,5111,77,5188,34
2021-02-01,Alameda,001,1643700,76131,74374,1616,75990,858
2021-02-01,Alpine,003,1148,73,72,0,72,0
2021-02-01,Amador,005,37829,3305,3234,27,3261,32
2021-02-01,Butte,007,227075,10830,10263,1491,11754,141
2021-02-01,Calaveras,009,45235,1818,1785,11,1796,21
2021-02-01,Colusa,011,21464,1786,1763,217,1980,9
2021-02-01,Contra Costa,013,1133247,59228,57324,995,58319,531
2021-02-01,Del Norte,015,27424,897,865,4,869,2
2021-02-01,El Dorado,017,186661,8665,8337,565,8902,83
2021-02-01,Fresno,019,978130,92056,89272,7118,96390,994
2021-02-01,Glenn,021,27897,2143,2086,451,2537,14
2021-02-01,Humboldt,023,135768,2873,2773,18,2791,25
2021-02-01,Imperial,025,180216,26708,26224,2434,28658,530
2021-02-01,Inyo,027,18085,1120,1072,8,1080,27
2021-02-01,Kern,029,883053,89182,86170,8737,94907,862
2021-02-01,Kings,031,150075,21334,20746,896,21642,172
2021-02-01,Lake,033,64148,2929,2843,1,2844,33
2021-02-01,Lassen,035,31185,4974,4907,88,4995,1
2021-02-01,Los Angeles,037,10098052,1131668,1094341,37214,1131555,16695
2021-02-01,Madera,039,155013,14932,14572,736,15308,94
2021-02-01,Marin,041,260295,12555,12341,148,12489,188
2021-02-01,Mariposa,043,17540,360,344,3,347,4
2021-02-01,Mendocino,045,87422,3359,3192,64,3256,37
2021-02-01,Merced,047,269075,26635,26282,785,27067,337
2021-02-01,Modoc,049,8938,319,303,103,406,1
2021-02-01,Mono,051,14174,1139,1145,16,1161,3
2021-02-01,Monterey,053,433212,40127,39196,1454,40650,278
2021-02-01,Napa,055,140530,8612,8449,33,8482,52
2021-02-01,Nevada,057,99092,3713,3535,147,3682,20
2021-02-01,Orange,059,3164182,237756,233155,9633,242788,3100
2021-02-01,Placer,061,380077,19589,18574,1009,19583,204
2021-02-01,Plumas,063,18699,623,554,10,564,2
2021-02-01,Riverside,065,2383286,275761,267025,12971,279996,3092
2021-02-01,Sacramento,067,1510023,88918,86856,1093,87949,1193
2021-02-01,San Benito,069,59416,5492,5432,75,5507,48
2021-02-01,San Bernardino,071,2135413,278479,270012,8183,278195,2172
2021-02-01,San Diego,073,3302833,250651,239121,11903,251024,2619
2021-02-01,San Francisco,075,870044,32275,31703,903,32606,324
2021-02-01,San Joaquin,077,732212,63462,61542,2551,64093,877
2021-02-01,San Luis Obispo,079,281455,18436,17690,490,18180,199
2021-02-01,San Mateo,081,765935,37464,35843,365,36208,220
2021-02-01,Santa Barbara,083,443738,30018,28837,922,29759,297
2021-02-01,Santa Clara,085,1922200,104224,102462,492,102954,1343
2021-02-01,Santa Cruz,087,273765,14639,13524,714,14238,149
2021-02-01,Shasta,089,179085,10461,10329,1100,11429,112
2021-02-01,Sierra,091,2930,49,42,12,54,0
2021-02-01,Siskiyou,093,43540,1351,1238,202,1440,4
2021-02-01,Solano,095,438530,28434,27844,325,28169,117
2021-02-01,Sonoma,097,501317,26319,26011,144,26155,243
2021-02-01,Stanislaus,099,539301,47618,46112,4926,51038,642
2021-02-01,Sutter,101,95872,8428,8313,78,8391,89
2021-02-01,Tehama,103,63373,4386,4263,471,4734,21
2021-02-01,Trinity,105,12862,443,260,66,326,3
2021-02-01,Tulare,107,460477,46106,44569,6976,51545,618
2021-02-01,Tuolumne,109,53932,3528,3534,31,3565,39
2021-02-01,Ventura,111,848112,72984,71104,2583,73687,502
2021-02-01,Yolo,113,214977,12207,11824,176,12000,151
2021-02-01,Yuba,115,75493,5204,5084,76,5160,33
2021-01-31,Alameda,001,1643700,75703,73979,1608,75587,857
2021-01-31,Alpine,003,1148,73,72,0,72,0
2021-01-31,Amador,005,37829,3295,3212,25,3237,32
2021-01-31,Butte,007,227075,10785,10215,1481,11696,140
2021-01-31,Calaveras,009,45235,1798,1778,11,1789,21
2021-01-31,Colusa,011,21464,1780,1754,212,1966,9
2021-01-31,Contra Costa,013,1133247,58896,57079,995,58074,531
2021-01-31,Del Norte,015,27424,895,865,4,869,2
2021-01-31,El Dorado,017,186661,8629,8317,563,8880,83
2021-01-31,Fresno,019,978130,91744,88852,7064,95916,994
2021-01-31,Glenn,021,27897,2132,2083,450,2533,14
2021-01-31,Humboldt,023,135768,2857,2767,18,2785,25
2021-01-31,Imperial,025,180216,26636,26206,2425,28631,530
2021-01-31,Inyo,027,18085,1107,1072,8,1080,27
2021-01-31,Kern,029,883053,88686,85872,8651,94523,861
2021-01-31,Kings,031,150075,21249,20709,884,21593,172
2021-01-31,Lake,033,64148,2908,2826,1,2827,33
2021-01-31,Lassen,035,31185,4958,4900,88,4988,1
2021-01-31,Los Angeles,037,10098052,1127043,1090304,37009,1127313,16609
2021-01-31,Madera,039,155013,14878,14496,728,15224,94
2021-01-31,Marin,041,260295,12508,12297,144,12441,185
2021-01-31,Mariposa,043,17540,358,344,3,347,4
2021-01-31,Mendocino,045,87422,3336,3181,63,3244,37
2021-01-31,Merced,047,269075,26491,26222,780,27002,337
2021-01-31,Modoc,049,8938,316,304,101,405,1
2021-01-31,Mono,051,14174,1136,1146,16,1162,3
2021-01-31,Monterey,053,433212,39948,39035,1427,40462,278
2021-01-31,Napa,055,140530,8570,8404,33,8437,52
2021-01-31,Nevada,057,99092,3691,3518,145,3663,20
2021-01-31,Orange,059,3164182,236739,232347,9592,241939,3053
2021-01-31,Placer,061,380077,19512,18506,998,19504,204
2021-01-31,Plumas,063,18699,622,554,10,564,2
2021-01-31,Riverside,065,2383286,274744,266145,12924,279069,3074
2021-01-31,Sacramento,067,1510023,88475,86560,1079,87639,1186
2021-01-31,San Benito,069,59416,5470,5425,73,5498,48
2021-01-31,San Bernardino,071,2135413,277449,269533,8152,277685,2156
2021-01-31,San Diego,073,3302833,249338,238039,11789,249828,2619
2021-01-31,San Francisco,075,870044,32084,31563,892,32455,323
2021-01-31,San Joaquin,077,732212,63061,61379,2542,63921,877
2021-01-31,San Luis Obispo,079,281455,18302,17615,485,18100,199
2021-01-31,San Mateo,081,765935,37274,35659,362,36021,219
2021-01-31,Santa Barbara,083,443738,29774,28570,913,29483,297
2021-01-31,Santa Clara,085,1922200,103674,101986,483,102469,1330
2021-01-31,Santa Cruz,087,273765,14544,13469,700,14169,149
2021-01-31,Shasta,089,179085,10416,10313,1091,11404,112
2021-01-31,Sierra,091,2930,48,43,12,55,0
2021-01-31,Siskiyou,093,43540,1341,1238,202,1440,4
2021-01-31,Solano,095,438530,28304,27678,325,28003,118
2021-01-31,Sonoma,097,501317,26216,25925,143,26068,243
2021-01-31,Stanislaus,099,539301,47334,45971,4894,50865,642
2021-01-31,Sutter,101,95872,8383,8289,78,8367,89
2021-01-31,Tehama,103,63373,4364,4256,470,4726,21
2021-01-31,Trinity,105,12862,441,260,66,326,3
2021-01-31,Tulare,107,460477,45938,44440,6895,51335,618
2021-01-31,Tuolumne,109,53932,3490,3519,31,3550,39
2021-01-31,Ventura,111,848112,72389,70635,2570,73205,502
2021-01-31,Yolo,113,214977,12146,11771,170,11941,151
2021-01-31,Yuba,115,75493,5184,5071,76,5147,33
2021-01-30,Alameda,001,1643700,75498,73622,1603,75225,850
2021-01-30,Alpine,003,1148,73,72,0,72,0
2021-01-30,Amador,005,37829,3291,3181,25,3206,32
2021-01-30,Butte,007,227075,10751,10177,1472,11649,139
2021-01-30,Calaveras,009,45235,1785,1763,11,1774,21
2021-01-30,Colusa,011,21464,1778,1748,212,1960,9
2021-01-30,Contra Costa,013,1133247,58713,56763,991,57754,531
2021-01-30,Del Norte,015,27424,894,865,4,869,2
2021-01-30,El Dorado,017,186661,8609,8299,562,8861,83
2021-01-30,Fresno,019,978130,91564,88476,7044,95520,964
2021-01-30,Glenn,021,27897,2129,2074,448,2522,14
2021-01-30,Humboldt,023,135768,2846,2742,18,2760,24
2021-01-30,Imperial,025,180216,26612,26160,2423,28583,530
2021-01-30,Inyo,027,18085,1103,1068,8,1076,27
2021-01-30,Kern,029,883053,88485,85572,8585,94157,848
2021-01-30,Kings,031,150075,21178,20605,879,21484,169
2021-01-30,Lake,033,64148,2902,2809,1,2810,33
2021-01-30,Lassen,035,31185,4954,4890,88,4978,1
2021-01-30,Los Angeles,037,10098052,1124644,1084763,36865,1121628,16484
2021-01-30,Madera,039,155013,14836,14443,723,15166,94
2021-01-30,Marin,041,260295,12480,12225,143,12368,185
2021-01-30,Mariposa,043,17540,356,344,3,347,4
2021-01-30,Mendocino,045,87422,3322,3153,62,3215,36
2021-01-30,Merced,047,269075,26417,26078,778,26856,335
2021-01-30,Modoc,049,8938,316,303,101,404,1
2021-01-30,Mono,051,14174,1136,1143,16,1159,3
2021-01-30,Monterey,053,433212,39888,38847,1424,40271,277
2021-01-30,Napa,055,140530,8554,8342,33,8375,52
2021-01-30,Nevada,057,99092,3672,3499,145,3644,20
2021-01-30,Orange,059,3164182,236194,231358,9555,240913,3013
2021-01-30,Placer,061,380077,19459,18430,992,19422,205
2021-01-30,Plumas,063,18699,620,554,10,564,2
2021-01-30,Riverside,065,2383286,274146,265137,12893,278030,3061
2021-01-30,Sacramento,067,1510023,88283,86388,1074,87462,1184
2021-01-30,San Benito,069,59416,5452,5401,72,5473,48
2021-01-30,San Bernardino,071,2135413,277024,268660,8133,276793,2122
2021-01-30,San Diego,073,3302833,248573,236765,11744,248509,2603
2021-01-30,San Francisco,075,870044,31983,31427,889,32316,316
2021-01-30,San Joaquin,077,732212,62929,61120,2533,63653,864
2021-01-30,San Luis Obispo,079,281455,18222,17522,483,18005,198
2021-01-30,San Mateo,081,765935,37135,35451,361,35812,219
2021-01-30,Santa Barbara,083,443738,29632,28342,911,29253,296
2021-01-30,Santa Clara,085,1922200,103327,101471,480,101951,1307
2021-01-30,Santa Cruz,087,273765,14504,13383,699,14082,149
2021-01-30,Shasta,089,179085,10397,10283,1088,11371,112
2021-01-30,Sierra,091,2930,48,43,12,55,0
2021-01-30,Siskiyou,093,43540,1338,1236,201,1437,4
2021-01-30,Solano,095,438530,28221,27511,323,27834,118
2021-01-30,Sonoma,097,501317,26168,25810,140,25950,243
2021-01-30,Stanislaus,099,539301,47204,45697,4867,50564,642
2021-01-30,Sutter,101,95872,8367,8226,78,8304,87
2021-01-30,Tehama,103,63373,4351,4229,469,4698,21
2021-01-30,Trinity,105,12862,441,259,66,325,3
2021-01-30,Tulare,107,460477,45802,44203,6858,51061,615
2021-01-30,Tuolumne,109,53932,3486,3508,31,3539,36
2021-01-30,Ventura,111,848112,72076,69931,2556,72487,493
2021-01-30,Yolo,113,214977,12132,11698,169,11867,151
2021-01-30,Yuba,115,75493,5174,5042,75,5117,33
2021-01-29,Alameda,001,1643700,75229,73210,1596,74806,841
2021-01-29,Alpine,003,1148,73,72,0,72,0
2021-01-29,Amador,005,37829,3279,3134,24,3158,32
2021-01-29,Butte,007,227075,10719,10122,1462,11584,138
2021-01-29,Calaveras,009,45235,1774,1757,11,1768,21
2021-01-29,Colusa,011,21464,1774,1734,211,1945,8
2021-01-29,Contra Costa,013,1133247,58542,56318,989,57307,529
2021-01-29,Del Norte,015,27424,893,865,4,869,2
2021-01-29,El Dorado,017,186661,8592,8231,561,8792,83
2021-01-29,Fresno,019,978130,91349,87936,7006,94942,962
2021-01-29,Glenn,021,27897,2124,2061,447,2508,14
2021-01-29,Humboldt,023,135768,2833,2707,18,2725,24
2021-01-29,Imperial,025,180216,26597,26045,2420,28465,521
2021-01-29,Inyo,027,18085,1091,1048,8,1056,27
2021-01-29,Kern,029,883053,88258,85044,8533,93577,836
2021-01-29,Kings,031,150075,21139,20466,874,21340,169
2021-01-29,Lake,033,64148,2893,2792,1,2793,32
2021-01-29,Lassen,035,31185,4951,4874,88,4962,1
2021-01-29,Los Angeles,037,10098052,1121155,1078329,36711,1115040,16190
2021-01-29,Madera,039,155013,14785,14377,723,15100,94
2021-01-29,Marin,041,260295,12435,12145,142,12287,185
2021-01-29,Mariposa,043,17540,355,342,3,345,4
2021-01-29,Mendocino,045,87422,3313,3131,61,3192,36
2021-01-29,Merced,047,269075,26343,25865,773,26638,334
2021-01-29,Modoc,049,8938,315,297,101,398,1
2021-01-29,Mono,051,14174,1134,1139,16,1155,3
2021-01-29,Monterey,053,433212,39773,38539,1416,39955,277
2021-01-29,Napa,055,140530,8523,8276,33,8309,52
2021-01-29,Nevada,057,99092,3663,3487,144,3631,20
2021-01-29,Orange,059,3164182,235517,229917,9517,239434,2967
2021-01-29,Placer,061,380077,19406,18367,988,19355,203
2021-01-29,Plumas,063,18699,619,548,10,558,2
2021-01-29,Riverside,065,2383286,273344,263504,12860,276364,3008
2021-01-29,Sacramento,067,1510023,88028,86320,1070,87390,1169
2021-01-29,San Benito,069,59416,5444,5386,72,5458,48
2021-01-29,San Bernardino,071,2135413,276510,267490,8093,275583,2095
2021-01-29,San Diego,073,3302833,247631,234637,11666,246303,2571
2021-01-29,San Francisco,075,870044,31844,31294,881,32175,307
2021-01-29,San Joaquin,077,732212,62784,60899,2518,63417,858
2021-01-29,San Luis Obispo,079,281455,18162,17440,478,17918,193
2021-01-29,San Mateo,081,765935,37001,35223,358,35581,218
2021-01-29,Santa Barbara,083,443738,29498,28105,905,29010,291
2021-01-29,Santa Clara,085,1922200,102964,101010,478,101488,1273
2021-01-29,Santa Cruz,087,273765,14451,13311,696,14007,148
2021-01-29,Shasta,089,179085,10380,10220,1084,11304,112
2021-01-29,Sierra,091,2930,48,43,12,55,0
2021-01-29,Siskiyou,093,43540,1337,1227,201,1428,4
2021-01-29,Solano,095,438530,28138,27352,321,27673,116
2021-01-29,Sonoma,097,501317,26112,25710,139,25849,243
2021-01-29,Stanislaus,099,539301,47061,45466,4845,50311,642
2021-01-29,Sutter,101,95872,8348,8181,78,8259,87
2021-01-29,Tehama,103,63373,4339,4191,467,4658,20
2021-01-29,Trinity,105,12862,441,260,66,326,3
2021-01-29,Tulare,107,460477,45695,43925,6819,50744,606
2021-01-29,Tuolumne,109,53932,3476,3483,31,3514,36
2021-01-29,Ventura,111,848112,71652,69511,2542,72053,484
2021-01-29,Yolo,113,214977,12094,11612,168,11780,151
2021-01-29,Yuba,115,75493,5158,5018,75,5093,32
2021-01-28,Alameda,001,1643700,74803,72758,1588,74346,833
2021-01-28,Alpine,003,1148,73,72,0,72,0
2021-01-28,Amador,005,37829,3242,3124,24,3148,31
2021-01-28,Butte,007,227075,10678,10037,1451,11488,138
2021-01-28,Calaveras,009,45235,1761,1747,10,1757,21
2021-01-28,Colusa,011,21464,1767,1731,207,1938,8
2021-01-28,Contra Costa,013,1133247,58299,55999,979,56978,525
2021-01-28,Del Norte,015,27424,892,862,4,866,2
2021-01-28,El Dorado,017,186661,8578,8198,556,8754,79
2021-01-28,Fresno,019,978130,91061,87401,6957,94358,949
2021-01-28,Glenn,021,27897,2119,2043,440,2483,14
2021-01-28,Humboldt,023,135768,2816,2686,18,2704,24
2021-01-28,Imperial,025,180216,26553,25984,2413,28397,517
2021-01-28,Inyo,027,18085,1086,1039,8,1047,27
2021-01-28,Kern,029,883053,87929,84708,8449,93157,817
2021-01-28,Kings,031,150075,21079,20328,870,21198,167
2021-01-28,Lake,033,64148,2878,2772,1,2773,32
2021-01-28,Lassen,035,31185,4945,4865,88,4953,1
2021-01-28,Los Angeles,037,10098052,1117246,1072412,36522,1108934,15967
2021-01-28,Madera,039,155013,14729,14301,719,15020,94
2021-01-28,Marin,041,260295,12382,12079,141,12220,183
2021-01-28,Mariposa,043,17540,355,334,3,337,4
2021-01-28,Mendocino,045,87422,3296,3110,61,3171,36
2021-01-28,Merced,047,269075,26221,25620,761,26381,328
2021-01-28,Modoc,049,8938,314,297,101,398,0
2021-01-28,Mono,051,14174,1132,1131,16,1147,3
2021-01-28,Monterey,053,433212,39580,38312,1397,39709,274
2021-01-28,Napa,055,140530,8476,8233,33,8266,50
2021-01-28,Nevada,057,99092,3648,3452,143,3595,19
2021-01-28,Orange,059,3164182,234537,228636,9487,238123,2860
2021-01-28,Placer,061,380077,19345,18246,985,19231,198
2021-01-28,Plumas,063,18699,618,547,10,557,2
2021-01-28,Riverside,065,2383286,272563,262342,12812,275154,2981
2021-01-28,Sacramento,067,1510023,87666,85698,1059,86757,1149
2021-01-28,San Benito,069,59416,5426,5344,71,5415,47
2021-01-28,San Bernardino,071,2135413,275808,266456,8072,274528,2057
2021-01-28,San Diego,073,3302833,246479,232967,11577,244544,2534
2021-01-28,San Francisco,075,870044,31707,31193,865,32058,290
2021-01-28,San Joaquin,077,732212,62517,60627,2503,63130,854
2021-01-28,San Luis Obispo,079,281455,18062,17279,476,17755,189
2021-01-28,San Mateo,081,765935,36832,34931,342,35273,218
2021-01-28,Santa Barbara,083,443738,29274,27674,892,28566,284
2021-01-28,Santa Clara,085,1922200,102497,100470,476,100946,1219
2021-01-28,Santa Cruz,087,273765,14362,13188,690,13878,145
2021-01-28,Shasta,089,179085,10346,10176,1076,11252,110
2021-01-28,Sierra,091,2930,48,43,12,55,0
2021-01-28,Siskiyou,093,43540,1330,1218,199,1417,4
2021-01-28,Solano,095,438530,27977,27163,320,27483,114
2021-01-28,Sonoma,097,501317,26021,25564,139,25703,236
2021-01-28,Stanislaus,099,539301,46852,45162,4825,49987,640
2021-01-28,Sutter,101,95872,8301,8136,78,8214,85
2021-01-28,Tehama,103,63373,4316,4163,464,4627,20
2021-01-28,Trinity,105,12862,439,260,66,326,3
2021-01-28,Tulare,107,460477,45538,43742,6741,50483,595
2021-01-28,Tuolumne,109,53932,3462,3472,31,3503,32
2021-01-28,Ventura,111,848112,71139,68896,2525,71421,475
2021-01-28,Yolo,113,214977,12052,11500,163,11663,151
2021-01-28,Yuba,115,75493,5142,4994,74,5068,32
2021-01-27,Alameda,001,1643700,74379,72188,1580,73768,815
2021-01-27,Alpine,003,1148,73,72,0,72,0
2021-01-27,Amador,005,37829,3226,3116,24,3140,31
2021-01-27,Butte,007,227075,10639,9988,1438,11426,138
2021-01-27,Calaveras,009,45235,1752,1737,10,1747,21
2021-01-27,Colusa,011,21464,1761,1724,205,1929,8
2021-01-27,Contra Costa,013,1133247,58000,55578,976,56554,507
2021-01-27,Del Norte,015,27424,891,859,4,863,2
2021-01-27,El Dorado,017,186661,8552,8141,555,8696,76
2021-01-27,Fresno,019,978130,90770,86886,6915,93801,938
2021-01-27,Glenn,021,27897,2115,2042,439,2481,14
2021-01-27,Humboldt,023,135768,2794,2630,18,2648,24
2021-01-27,Imperial,025,180216,26499,25861,2398,28259,504
2021-01-27,Inyo,027,18085,1082,1023,8,1031,27
2021-01-27,Kern,029,883053,87618,84244,8379,92623,809
2021-01-27,Kings,031,150075,20973,20211,862,21073,167
2021-01-27,Lake,033,64148,2858,2750,1,2751,32
2021-01-27,Lassen,035,31185,4939,4851,88,4939,1
2021-01-27,Los Angeles,037,10098052,1112440,1066569,36310,1102879,15757
2021-01-27,Madera,039,155013,14688,14194,714,14908,86
2021-01-27,Marin,041,260295,12345,12028,140,12168,180
2021-01-27,Mariposa,043,17540,355,333,3,336,4
2021-01-27,Mendocino,045,87422,3276,3095,61,3156,36
2021-01-27,Merced,047,269075,26062,25439,750,26189,315
2021-01-27,Modoc,049,8938,314,297,98,395,0
2021-01-27,Mono,051,14174,1130,1131,16,1147,3
2021-01-27,Monterey,053,433212,39372,38139,1378,39517,268
2021-01-27,Napa,055,140530,8403,8187,33,8220,46
2021-01-27,Nevada,057,99092,3626,3431,143,3574,18
2021-01-27,Orange,059,3164182,233417,227110,9433,236543,2832
2021-01-27,Placer,061,380077,19273,18106,974,19080,198
2021-01-27,Plumas,063,18699,618,544,10,554,2
2021-01-27,Riverside,065,2383286,271366,260796,12760,273556,2931
2021-01-27,Sacramento,067,1510023,87306,85428,1048,86476,1142
2021-01-27,San Benito,069,59416,5411,5284,71,5355,47
2021-01-27,San Bernardino,071,2135413,274960,265153,8041,273194,2019
2021-01-27,San Diego,073,3302833,245150,231478,11472,242950,2465
2021-01-27,San Francisco,075,870044,31563,31082,858,31940,287
2021-01-27,San Joaquin,077,732212,62247,60131,2480,62611,853
2021-01-27,San Luis Obispo,079,281455,17955,17119,472,17591,188
2021-01-27,San Mateo,081,765935,36677,34619,339,34958,216
2021-01-27,Santa Barbara,083,443738,29097,27435,886,28321,282
2021-01-27,Santa Clara,085,1922200,102093,99732,472,100204,1184
2021-01-27,Santa Cruz,087,273765,14292,13111,687,13798,143
2021-01-27,Shasta,089,179085,10312,10106,1070,11176,105
2021-01-27,Sierra,091,2930,48,44,12,56,0
2021-01-27,Siskiyou,093,43540,1325,1214,196,1410,4
2021-01-27,Solano,095,438530,27799,26982,313,27295,112
2021-01-27,Sonoma,097,501317,25922,25361,135,25496,237
2021-01-27,Stanislaus,099,539301,46669,44874,4799,49673,624
2021-01-27,Sutter,101,95872,8257,8093,77,8170,83
2021-01-27,Tehama,103,63373,4296,4133,460,4593,20
2021-01-27,Trinity,105,12862,439,260,66,326,3
2021-01-27,Tulare,107,460477,45351,43462,6670,50132,583
2021-01-27,Tuolumne,109,53932,3452,3464,31,3495,32
2021-01-27,Ventura,111,848112,70666,68291,2500,70791,468
2021-01-27,Yolo,113,214977,12005,11427,159,11586,151
2021-01-27,Yuba,115,75493,5126,4968,74,5042,32
2021-01-26,Alameda,001,1643700,74005,71851,1563,73414,789
2021-01-26,Alpine,003,1148,73,72,0,72,0
2021-01-26,Amador,005,37829,3215,3113,24,3137,31
2021-01-26,Butte,007,227075,10597,9943,1432,11375,136
2021-01-26,Calaveras,009,45235,1742,1723,10,1733,21
2021-01-26,Colusa,011,21464,1754,1719,202,1921,8
2021-01-26,Contra Costa,013,1133247,57721,55337,968,56305,491
2021-01-26,Del Norte,015,27424,890,856,4,860,2
2021-01-26,El Dorado,017,186661,8526,8115,552,8667,71
2021-01-26,Fresno,019,978130,90412,86673,6871,93544,923
2021-01-26,Glenn,021,27897,2105,2034,434,2468,13
2021-01-26,Humboldt,023,135768,2773,2612,17,2629,24
2021-01-26,Imperial,025,180216,26426,25812,2385,28197,498
2021-01-26,Inyo,027,18085,1075,1018,8,1026,27
2021-01-26,Kern,029,883053,87195,83868,8302,92170,790
2021-01-26,Kings,031,150075,20915,20156,857,21013,159
2021-01-26,Lake,033,64148,2849,2748,1,2749,32
2021-01-26,Lassen,035,31185,4933,4844,88,4932,1
2021-01-26,Los Angeles,037,10098052,1107157,1060492,36104,1096596,15458
2021-01-26,Madera,039,155013,14631,14130,708,14838,86
2021-01-26,Marin,041,260295,12300,11993,138,12131,179
2021-01-26,Mariposa,043,17540,353,332,3,335,3
2021-01-26,Mendocino,045,87422,3250,3076,60,3136,36
2021-01-26,Merced,047,269075,25922,25359,742,26101,309
2021-01-26,Modoc,049,8938,307,291,97,388,0
2021-01-26,Mono,051,14174,1128,1120,16,1136,3
2021-01-26,Monterey,053,433212,39178,37963,1358,39321,255
2021-01-26,Napa,055,140530,8346,8145,33,8178,43
2021-01-26,Nevada,057,99092,3619,3410,142,3552,18
2021-01-26,Orange,059,3164182,232295,225987,9388,235375,2760
2021-01-26,Placer,061,380077,19197,18016,972,18988,193
2021-01-26,Plumas,063,18699,616,536,10,546,2
2021-01-26,Riverside,065,2383286,269999,259399,12696,272095,2898
2021-01-26,Sacramento,067,1510023,86948,85062,1041,86103,1127
2021-01-26,San Benito,069,59416,5397,5251,70,5321,45
2021-01-26,San Bernardino,071,2135413,273958,263736,7997,271733,1970
2021-01-26,San Diego,073,3302833,243655,230063,11370,241433,2421
2021-01-26,San Francisco,075,870044,31431,30874,839,31713,286
2021-01-26,San Joaquin,077,732212,61993,59889,2464,62353,847
2021-01-26,San Luis Obispo,079,281455,17874,17016,469,17485,186
2021-01-26,San Mateo,081,765935,36483,34441,328,34769,213
2021-01-26,Santa Barbara,083,443738,28923,27321,874,28195,273
2021-01-26,Santa Clara,085,1922200,101613,99215,469,99684,1171
2021-01-26,Santa Cruz,087,273765,14226,13045,681,13726,134
2021-01-26,Shasta,089,179085,10277,10036,1062,11098,103
2021-01-26,Sierra,091,2930,48,43,12,55,0
2021-01-26,Siskiyou,093,43540,1310,1208,194,1402,4
2021-01-26,Solano,095,438530,27643,26858,307,27165,110
2021-01-26,Sonoma,097,501317,25804,25273,133,25406,236
2021-01-26,Stanislaus,099,539301,46487,44703,4757,49460,599
2021-01-26,Sutter,101,95872,8214,8067,77,8144,83
2021-01-26,Tehama,103,63373,4263,4115,460,4575,20
2021-01-26,Trinity,105,12862,439,260,66,326,3
2021-01-26,Tulare,107,460477,45148,43394,6600,49994,579
2021-01-26,Tuolumne,109,53932,3442,3451,31,3482,30
2021-01-26,Ventura,111,848112,70133,67526,2474,70000,448
2021-01-26,Yolo,113,214977,11960,11361,156,11517,148
2021-01-26,Yuba,115,75493,5101,4944,72,5016,31
2021-01-25,Alameda,001,1643700,73575,71255,1553,72808,780
2021-01-25,Alpine,003,1148,73,72,0,72,0
2021-01-25,Amador,005,37829,3175,3074,24,3098,30
2021-01-25,Butte,007,227075,10530,9865,1424,11289,133
2021-01-25,Calaveras,009,45235,1727,1713,10,1723,21
2021-01-25,Colusa,011,21464,1742,1709,198,1907,8
2021-01-25,Contra Costa,013,1133247,57364,54989,961,55950,488
2021-01-25,Del Norte,015,27424,889,855,4,859,2
2021-01-25,El Dorado,017,186661,8501,8060,552,8612,66
2021-01-25,Fresno,019,978130,90041,86336,6839,93175,913
2021-01-25,Glenn,021,27897,2096,2028,434,2462,13
2021-01-25,Humboldt,023,135768,2739,2587,17,2604,24
2021-01-25,Imperial,025,180216,26377,25745,2377,28122,491
2021-01-25,Inyo,027,18085,1069,1015,8,1023,27
2021-01-25,Kern,029,883053,86808,83401,8216,91617,787
2021-01-25,Kings,031,150075,20795,20067,853,20920,159
2021-01-25,Lake,033,64148,2830,2729,1,2730,32
2021-01-25,Lassen,035,31185,4906,4835,88,4923,1
2021-01-25,Los Angeles,037,10098052,1101202,1055181,35875,1091056,15163
2021-01-25,Madera,039,155013,14577,14068,703,14771,86
2021-01-25,Marin,041,260295,12248,11923,134,12057,177
2021-01-25,Mariposa,043,17540,350,331,3,334,3
2021-01-25,Mendocino,045,87422,3239,3054,60,3114,35
2021-01-25,Merced,047,269075,25783,25181,733,25914,305
2021-01-25,Modoc,049,8938,306,288,93,381,0
2021-01-25,Mono,051,14174,1125,1114,15,1129,3
2021-01-25,Monterey,053,433212,38925,37726,1339,39065,255
2021-01-25,Napa,055,140530,8312,8057,32,8089,43
2021-01-25,Nevada,057,99092,3605,3365,142,3507,18
2021-01-25,Orange,059,3164182,231085,225105,9346,234451,2696
2021-01-25,Placer,061,380077,19110,17936,957,18893,193
2021-01-25,Plumas,063,18699,613,533,10,543,2
2021-01-25,Riverside,065,2383286,268259,258082,12640,270722,2789
2021-01-25,Sacramento,067,1510023,86507,84653,1033,85686,1118
2021-01-25,San Benito,069,59416,5361,5238,69,5307,43
2021-01-25,San Bernardino,071,2135413,273013,263174,7961,271135,1947
2021-01-25,San Diego,073,3302833,242041,228630,11298,239928,2375
2021-01-25,San Francisco,075,870044,31281,30734,816,31550,288
2021-01-25,San Joaquin,077,732212,61699,59291,2439,61730,838
2021-01-25,San Luis Obispo,079,281455,17740,16868,464,17332,179
2021-01-25,San Mateo,081,765935,36249,34187,322,34509,213
2021-01-25,Santa Barbara,083,443738,28688,27065,864,27929,269
2021-01-25,Santa Clara,085,1922200,101043,98647,461,99108,1143
2021-01-25,Santa Cruz,087,273765,14139,12973,676,13649,133
2021-01-25,Shasta,089,179085,10236,9991,1051,11042,103
2021-01-25,Sierra,091,2930,48,42,12,54,0
2021-01-25,Siskiyou,093,43540,1302,1205,191,1396,4
2021-01-25,Solano,095,438530,27475,26648,306,26954,109
2021-01-25,Sonoma,097,501317,25697,25160,131,25291,233
2021-01-25,Stanislaus,099,539301,46241,44293,4714,49007,599
2021-01-25,Sutter,101,95872,8171,8023,77,8100,83
2021-01-25,Tehama,103,63373,4236,4082,456,4538,20
2021-01-25,Trinity,105,12862,439,262,66,328,3
2021-01-25,Tulare,107,460477,44932,43124,6495,49619,578
2021-01-25,Tuolumne,109,53932,3433,3422,31,3453,29
2021-01-25,Ventura,111,848112,69499,66910,2457,69367,439
2021-01-25,Yolo,113,214977,11874,11276,155,11431,140
2021-01-25,Yuba,115,75493,5079,4900,70,4970,31
2021-01-24,Alameda,001,1643700,73068,70823,1542,72365,780
2021-01-24,Alpine,003,1148,73,72,0,72,0
2021-01-24,Amador,005,37829,3142,3054,24,3078,30
2021-01-24,Butte,007,227075,10446,9820,1407,11227,133
2021-01-24,Calaveras,009,45235,1714,1704,10,1714,21
2021-01-24,Colusa,011,21464,1731,1689,192,1881,8
2021-01-24,Contra Costa,013,1133247,56976,54694,948,55642,488
2021-01-24,Del Norte,015,27424,885,855,4,859,2
2021-01-24,El Dorado,017,186661,8466,8003,548,8551,66
2021-01-24,Fresno,019,978130,89604,85808,6800,92608,911
2021-01-24,Glenn,021,27897,2088,2026,433,2459,13
2021-01-24,Humboldt,023,135768,2700,2562,17,2579,24
2021-01-24,Imperial,025,180216,26282,25707,2353,28060,488
2021-01-24,Inyo,027,18085,1053,1007,8,1015,27
2021-01-24,Kern,029,883053,86371,83125,8108,91233,785
2021-01-24,Kings,031,150075,20667,19988,837,20825,159
2021-01-24,Lake,033,64148,2812,2724,0,2724,32
2021-01-24,Lassen,035,31185,4895,4828,85,4913,1
2021-01-24,Los Angeles,037,10098052,1094798,1048757,35562,1084319,15119
2021-01-24,Madera,039,155013,14487,14000,697,14697,86
2021-01-24,Marin,041,260295,12181,11872,132,12004,177
2021-01-24,Mariposa,043,17540,346,322,3,325,3
2021-01-24,Mendocino,045,87422,3218,3037,59,3096,33
2021-01-24,Merced,047,269075,25572,25047,723,25770,305
2021-01-24,Modoc,049,8938,306,285,93,378,0
2021-01-24,Mono,051,14174,1118,1113,15,1128,3
2021-01-24,Monterey,053,433212,38653,37527,1305,38832,254
2021-01-24,Napa,055,140530,8270,8005,32,8037,43
2021-01-24,Nevada,057,99092,3563,3349,140,3489,18
2021-01-24,Orange,059,3164182,229656,223853,9276,233129,2632
2021-01-24,Placer,061,380077,18995,17839,937,18776,193
2021-01-24,Plumas,063,18699,610,532,10,542,2
2021-01-24,Riverside,065,2383286,266618,256767,12564,269331,2761
2021-01-24,Sacramento,067,1510023,85954,84110,1025,85135,1112
2021-01-24,San Benito,069,59416,5319,5223,66,5289,43
2021-01-24,San Bernardino,071,2135413,271685,262370,7907,270277,1935
2021-01-24,San Diego,073,3302833,240347,227193,11167,238360,2375
2021-01-24,San Francisco,075,870044,31093,30559,794,31353,275
2021-01-24,San Joaquin,077,732212,61271,59021,2423,61444,838
2021-01-24,San Luis Obispo,079,281455,17616,16758,462,17220,179
2021-01-24,San Mateo,081,765935,36004,33956,317,34273,213
2021-01-24,Santa Barbara,083,443738,28372,26735,854,27589,269
2021-01-24,Santa Clara,085,1922200,100395,98103,456,98559,1109
2021-01-24,Santa Cruz,087,273765,14053,12905,668,13573,133
2021-01-24,Shasta,089,179085,10165,9978,1042,11020,103
2021-01-24,Sierra,091,2930,47,42,12,54,0
2021-01-24,Siskiyou,093,43540,1295,1195,191,1386,4
2021-01-24,Solano,095,438530,27286,26515,302,26817,109
2021-01-24,Sonoma,097,501317,25534,25045,130,25175,233
2021-01-24,Stanislaus,099,539301,45932,44031,4651,48682,599
2021-01-24,Sutter,101,95872,8107,7980,77,8057,83
2021-01-24,Tehama,103,63373,4196,4062,451,4513,20
2021-01-24,Trinity,105,12862,439,262,66,328,3
2021-01-24,Tulare,107,460477,44713,43006,6402,49408,577
2021-01-24,Tuolumne,109,53932,3423,3416,31,3447,29
2021-01-24,Ventura,111,848112,68788,66347,2433,68780,439
2021-01-24,Yolo,113,214977,11790,11210,151,11361,140
2021-01-24,Yuba,115,75493,5039,4875,69,4944,31
2021-01-23,Alameda,001,1643700,72819,70080,1535,71615,780
2021-01-23,Alpine,003,1148,73,72,0,72,0
2021-01-23,Amador,005,37829,3139,3049,24,3073,30
2021-01-23,Butte,007,227075,10417,9757,1404,11161,133
2021-01-23,Calaveras,009,45235,1711,1695,10,1705,21
2021-01-23,Colusa,011,21464,1727,1672,191,1863,8
2021-01-23,Contra Costa,013,1133247,56763,54162,941,55103,487
2021-01-23,Del Norte,015,27424,884,855,4,859,2
2021-01-23,El Dorado,017,186661,8450,7984,546,8530,66
2021-01-23,Fresno,019,978130,89419,85274,6771,92045,910
2021-01-23,Glenn,021,27897,2085,2015,429,2444,13
2021-01-23,Humboldt,023,135768,2681,2493,16,2509,23
2021-01-23,Imperial,025,180216,26248,25581,2343,27924,487
2021-01-23,Inyo,027,18085,1044,987,8,995,27
2021-01-23,Kern,029,883053,86127,82602,8040,90642,783
2021-01-23,Kings,031,150075,20623,19904,835,20739,159
2021-01-23,Lake,033,64148,2804,2673,0,2673,32
2021-01-23,Lassen,035,31185,4894,4816,82,4898,1
2021-01-23,Los Angeles,037,10098052,1091571,1040961,35399,1076360,15034
2021-01-23,Madera,039,155013,14451,13858,694,14552,86
2021-01-23,Marin,041,260295,12125,11796,130,11926,177
2021-01-23,Mariposa,043,17540,346,323,3,326,3
2021-01-23,Mendocino,045,87422,3204,2991,59,3050,32
2021-01-23,Merced,047,269075,25480,24787,708,25495,303
2021-01-23,Modoc,049,8938,306,285,93,378,0
2021-01-23,Mono,051,14174,1116,1111,15,1126,3
2021-01-23,Monterey,053,433212,38570,37165,1300,38465,253
2021-01-23,Napa,055,140530,8245,7893,32,7925,43
2021-01-23,Nevada,057,99092,3552,3332,139,3471,18
2021-01-23,Orange,059,3164182,228888,221722,9236,230958,2618
2021-01-23,Placer,061,380077,18944,17617,932,18549,193
2021-01-23,Plumas,063,18699,609,528,10,538,2
2021-01-23,Riverside,065,2383286,265716,253636,12512,266148,2733
2021-01-23,Sacramento,067,1510023,85725,83408,1022,84430,1108
2021-01-23,San Benito,069,59416,5295,5166,65,5231,43
2021-01-23,San Bernardino,071,2135413,271137,260381,7875,268256,1922
2021-01-23,San Diego,073,3302833,239286,225556,11095,236651,2344
2021-01-23,San Francisco,075,870044,30989,30308,765,31073,268
2021-01-23,San Joaquin,077,732212,61145,58164,2413,60577,836
2021-01-23,San Luis Obispo,079,281455,17552,16652,459,17111,176
2021-01-23,San Mateo,081,765935,35828,33696,306,34002,213
2021-01-23,Santa Barbara,083,443738,28188,26234,845,27079,264
2021-01-23,Santa Clara,085,1922200,100039,97189,455,97644,1086
2021-01-23,Santa Cruz,087,273765,13995,12771,665,13436,127
2021-01-23,Shasta,089,179085,10135,9951,1041,10992,103
2021-01-23,Sierra,091,2930,47,41,12,53,0
2021-01-23,Siskiyou,093,43540,1285,1190,190,1380,4
2021-01-23,Solano,095,438530,27193,26261,300,26561,107
2021-01-23,Sonoma,097,501317,25454,24790,130,24920,232
2021-01-23,Stanislaus,099,539301,45765,43723,4621,48344,599
2021-01-23,Sutter,101,95872,8089,7943,76,8019,80
2021-01-23,Tehama,103,63373,4177,4006,450,4456,20
2021-01-23,Trinity,105,12862,439,262,66,328,3
2021-01-23,Tulare,107,460477,44560,42661,6342,49003,575
2021-01-23,Tuolumne,109,53932,3416,3407,31,3438,29
2021-01-23,Ventura,111,848112,68338,65581,2410,67991,438
2021-01-23,Yolo,113,214977,11748,11087,147,11234,141
2021-01-23,Yuba,115,75493,5027,4831,68,4899,30
2021-01-22,Alameda,001,1643700,72499,69693,1529,71222,751
2021-01-22,Alpine,003,1148,73,71,0,71,0
2021-01-22,Amador,005,37829,3134,3042,24,3066,30
2021-01-22,Butte,007,227075,10371,9711,1391,11102,133
2021-01-22,Calaveras,009,45235,1702,1672,10,1682,21
2021-01-22,Colusa,011,21464,1725,1668,191,1859,7
2021-01-22,Contra Costa,013,1133247,56528,53887,935,54822,485
2021-01-22,Del Norte,015,27424,883,852,4,856,2
2021-01-22,El Dorado,017,186661,8416,7877,543,8420,64
2021-01-22,Fresno,019,978130,89078,84744,6743,91487,892
2021-01-22,Glenn,021,27897,2080,1985,423,2408,13
2021-01-22,Humboldt,023,135768,2657,2452,16,2468,23
2021-01-22,Imperial,025,180216,26213,25562,2328,27890,474
2021-01-22,Inyo,027,18085,1033,961,8,969,26
2021-01-22,Kern,029,883053,85830,82101,7964,90065,771
2021-01-22,Kings,031,150075,20547,19760,831,20591,159
2021-01-22,Lake,033,64148,2792,2681,0,2681,32
2021-01-22,Lassen,035,31185,4885,4765,81,4846,1
2021-01-22,Los Angeles,037,10098052,1087109,1031177,35207,1066384,14777
2021-01-22,Madera,039,155013,14391,13781,693,14474,86
2021-01-22,Marin,041,260295,12088,11769,128,11897,177
2021-01-22,Mariposa,043,17540,346,323,3,326,3
2021-01-22,Mendocino,045,87422,3179,2994,58,3052,32
2021-01-22,Merced,047,269075,25357,24616,700,25316,290
2021-01-22,Modoc,049,8938,306,285,93,378,0
2021-01-22,Mono,051,14174,1116,1108,15,1123,3
2021-01-22,Monterey,053,433212,38418,36909,1295,38204,253
2021-01-22,Napa,055,140530,8199,7828,32,7860,40
2021-01-22,Nevada,057,99092,3527,3296,138,3434,18
2021-01-22,Orange,059,3164182,227933,220384,9189,229573,2542
2021-01-22,Placer,061,380077,18887,17636,917,18553,193
2021-01-22,Plumas,063,18699,607,522,10,532,2
2021-01-22,Riverside,065,2383286,264570,252440,12444,264884,2710
2021-01-22,Sacramento,067,1510023,85395,82861,1014,83875,1094
2021-01-22,San Benito,069,59416,5269,5143,65,5208,43
2021-01-22,San Bernardino,071,2135413,270314,259121,7842,266963,1849
2021-01-22,San Diego,073,3302833,238046,222576,11030,233606,2301
2021-01-22,San Francisco,075,870044,30876,30027,748,30775,266
2021-01-22,San Joaquin,077,732212,60964,58485,2400,60885,812
2021-01-22,San Luis Obispo,079,281455,17463,16336,456,16792,172
2021-01-22,San Mateo,081,765935,35606,33401,303,33704,211
2021-01-22,Santa Barbara,083,443738,27987,25989,834,26823,256
2021-01-22,Santa Clara,085,1922200,99601,96435,452,96887,1062
2021-01-22,Santa Cruz,087,273765,13937,12687,661,13348,123
2021-01-22,Shasta,089,179085,10116,9866,1039,10905,103
2021-01-22,Sierra,091,2930,47,40,12,52,0
2021-01-22,Siskiyou,093,43540,1281,1182,188,1370,4
2021-01-22,Solano,095,438530,27103,26048,298,26346,107
2021-01-22,Sonoma,097,501317,25369,24659,130,24789,232
2021-01-22,Stanislaus,099,539301,45599,43489,4594,48083,599
2021-01-22,Sutter,101,95872,8064,7878,76,7954,80
2021-01-22,Tehama,103,63373,4160,3993,448,4441,19
2021-01-22,Trinity,105,12862,438,263,66,329,3
2021-01-22,Tulare,107,460477,44380,42307,6272,48579,573
2021-01-22,Tuolumne,109,53932,3388,3379,31,3410,29
2021-01-22,Ventura,111,848112,67832,64404,2392,66796,426
2021-01-22,Yolo,113,214977,11714,11014,140,11154,141
2021-01-22,Yuba,115,75493,5003,4789,66,4855,29
2021-01-21,Alameda,001,1643700,72064,69314,1512,70826,739
2021-01-21,Alpine,003,1148,73,71,0,71,0
2021-01-21,Amador,005,37829,3112,3038,24,3062,29
2021-01-21,Butte,007,227075,10306,9643,1385,11028,130
2021-01-21,Calaveras,009,45235,1693,1647,10,1657,21
2021-01-21,Colusa,011,21464,1718,1662,188,1850,7
2021-01-21,Contra Costa,013,1133247,56114,53595,921,54516,478
2021-01-21,Del Norte,015,27424,881,850,3,853,2
2021-01-21,El Dorado,017,186661,8367,7823,540,8363,58
2021-01-21,Fresno,019,978130,88673,84137,6703,90840,889
2021-01-21,Glenn,021,27897,2072,1964,418,2382,13
2021-01-21,Humboldt,023,135768,2634,2423,16,2439,23
2021-01-21,Imperial,025,180216,26122,25509,2314,27823,463
2021-01-21,Inyo,027,18085,1024,946,8,954,26
2021-01-21,Kern,029,883053,85417,81328,7848,89176,769
2021-01-21,Kings,031,150075,20476,19633,813,20446,158
2021-01-21,Lake,033,64148,2776,2669,0,2669,32
2021-01-21,Lassen,035,31185,4878,4763,81,4844,1
2021-01-21,Los Angeles,037,10098052,1080449,1023055,34885,1057940,14537
2021-01-21,Madera,039,155013,14323,13664,685,14349,86
2021-01-21,Marin,041,260295,12032,11732,126,11858,173
2021-01-21,Mariposa,043,17540,342,322,3,325,3
2021-01-21,Mendocino,045,87422,3156,2967,56,3023,32
2021-01-21,Merced,047,269075,25202,24426,693,25119,245
2021-01-21,Modoc,049,8938,303,284,92,376,0
2021-01-21,Mono,051,14174,1111,1104,15,1119,3
2021-01-21,Monterey,053,433212,38137,36149,1285,37434,253
2021-01-21,Napa,055,140530,8135,7774,32,7806,40
2021-01-21,Nevada,057,99092,3498,3274,137,3411,18
2021-01-21,Orange,059,3164182,226555,218867,9134,228001,2540
2021-01-21,Placer,061,380077,18808,17553,913,18466,190
2021-01-21,Plumas,063,18699,603,518,10,528,2
2021-01-21,Riverside,065,2383286,262847,251007,12364,263371,2676
2021-01-21,Sacramento,067,1510023,84916,82303,993,83296,1084
2021-01-21,San Benito,069,59416,5238,5100,60,5160,43
2021-01-21,San Bernardino,071,2135413,268970,257754,7777,265531,1832
2021-01-21,San Diego,073,3302833,236271,219729,10923,230652,2222
2021-01-21,San Francisco,075,870044,30699,29801,714,30515,266
2021-01-21,San Joaquin,077,732212,60655,58270,2380,60650,806
2021-01-21,San Luis Obispo,079,281455,17377,16153,448,16601,169
2021-01-21,San Mateo,081,765935,35360,33156,290,33446,210
2021-01-21,Santa Barbara,083,443738,27699,25654,821,26475,253
2021-01-21,Santa Clara,085,1922200,98975,96028,445,96473,1062
2021-01-21,Santa Cruz,087,273765,13852,12548,651,13199,119
2021-01-21,Shasta,089,179085,10073,9795,1024,10819,98
2021-01-21,Sierra,091,2930,47,40,12,52,0
2021-01-21,Siskiyou,093,43540,1278,1178,185,1363,4
2021-01-21,Solano,095,438530,26923,25885,294,26179,106
2021-01-21,Sonoma,097,501317,25231,24440,128,24568,230
2021-01-21,Stanislaus,099,539301,45301,43223,4550,47773,599
2021-01-21,Sutter,101,95872,8030,7822,76,7898,80
2021-01-21,Tehama,103,63373,4122,3938,448,4386,19
2021-01-21,Trinity,105,12862,438,261,66,327,3
2021-01-21,Tulare,107,460477,44169,42082,6196,48278,569
2021-01-21,Tuolumne,109,53932,3378,3365,30,3395,29
2021-01-21,Ventura,111,848112,67138,63995,2371,66366,420
2021-01-21,Yolo,113,214977,11624,10940,132,11072,141
2021-01-21,Yuba,115,75493,4971,4757,65,4822,29
2021-01-20,Alameda,001,1643700,71580,68785,1498,70283,702
2021-01-20,Alpine,003,1148,73,71,0,71,0
2021-01-20,Amador,005,37829,3081,3036,24,3060,29
2021-01-20,Butte,007,227075,10250,9582,1374,10956,130
2021-01-20,Calaveras,009,45235,1671,1637,9,1646,21
2021-01-20,Colusa,011,21464,1701,1630,183,1813,7
2021-01-20,Contra Costa,013,1133247,55658,53108,914,54022,461
2021-01-20,Del Norte,015,27424,880,848,3,851,2
2021-01-20,El Dorado,017,186661,8317,7785,537,8322,53
2021-01-20,Fresno,019,978130,88253,83591,6650,90241,872
2021-01-20,Glenn,021,27897,2053,1955,416,2371,13
2021-01-20,Humboldt,023,135768,2591,2390,16,2406,22
2021-01-20,Imperial,025,180216,26050,25380,2279,27659,461
2021-01-20,Inyo,027,18085,1014,901,8,909,26
2021-01-20,Kern,029,883053,84968,80701,7740,88441,754
2021-01-20,Kings,031,150075,20386,19522,805,20327,146
2021-01-20,Lake,033,64148,2755,2646,0,2646,31
2021-01-20,Lassen,035,31185,4870,4758,79,4837,1
2021-01-20,Los Angeles,037,10098052,1072953,1015608,34597,1050205,14299
2021-01-20,Madera,039,155013,14259,13585,680,14265,86
2021-01-20,Marin,041,260295,11978,11684,124,11808,171
2021-01-20,Mariposa,043,17540,340,322,3,325,3
2021-01-20,Mendocino,045,87422,3141,2957,56,3013,32
2021-01-20,Merced,047,269075,25029,24220,671,24891,243
2021-01-20,Modoc,049,8938,302,282,92,374,0
2021-01-20,Mono,051,14174,1104,1105,14,1119,3
2021-01-20,Monterey,053,433212,37825,35960,1265,37225,249
2021-01-20,Napa,055,140530,8066,7731,31,7762,40
2021-01-20,Nevada,057,99092,3466,3238,137,3375,18
2021-01-20,Orange,059,3164182,225019,216893,9073,225966,2500
2021-01-20,Placer,061,380077,18715,17455,895,18350,186
2021-01-20,Plumas,063,18699,601,512,10,522,2
2021-01-20,Riverside,065,2383286,260801,248686,12277,260963,2615
2021-01-20,Sacramento,067,1510023,84356,81687,983,82670,1072
2021-01-20,San Benito,069,59416,5207,5036,59,5095,35
2021-01-20,San Bernardino,071,2135413,267613,255921,7730,263651,1801
2021-01-20,San Diego,073,3302833,234416,218553,10819,229372,2174
2021-01-20,San Francisco,075,870044,30511,29665,694,30359,262
2021-01-20,San Joaquin,077,732212,60250,58025,2371,60396,783
2021-01-20,San Luis Obispo,079,281455,17196,15936,439,16375,164
2021-01-20,San Mateo,081,765935,35133,32929,289,33218,210
2021-01-20,Santa Barbara,083,443738,27382,25312,809,26121,248
2021-01-20,Santa Clara,085,1922200,98292,94995,443,95438,1040
2021-01-20,Santa Cruz,087,273765,13745,12460,638,13098,107
2021-01-20,Shasta,089,179085,10021,9697,1014,10711,98
2021-01-20,Sierra,091,2930,47,40,12,52,0
2021-01-20,Siskiyou,093,43540,1271,1163,184,1347,4
2021-01-20,Solano,095,438530,26730,25659,290,25949,106
2021-01-20,Sonoma,097,501317,25094,24262,126,24388,223
2021-01-20,Stanislaus,099,539301,45020,42955,4512,47467,585
2021-01-20,Sutter,101,95872,7979,7772,74,7846,80
2021-01-20,Tehama,103,63373,4096,3892,446,4338,19
2021-01-20,Trinity,105,12862,438,260,66,326,3
2021-01-20,Tulare,107,460477,43911,41799,6103,47902,559
2021-01-20,Tuolumne,109,53932,3364,3355,29,3384,29
2021-01-20,Ventura,111,848112,66178,63413,2342,65755,395
2021-01-20,Yolo,113,214977,11556,10852,129,10981,141
2021-01-20,Yuba,115,75493,4944,4729,65,4794,29
2021-01-19,Alameda,001,1643700,70926,68434,1488,69922,680
2021-01-19,Alpine,003,1148,73,71,0,71,0
2021-01-19,Amador,005,37829,3072,3024,24,3048,28
2021-01-19,Butte,007,227075,10186,9528,1360,10888,129
2021-01-19,Calaveras,009,45235,1656,1621,8,1629,21
2021-01-19,Colusa,011,21464,1679,1617,175,1792,7
2021-01-19,Contra Costa,013,1133247,55161,52730,903,53633,448
2021-01-19,Del Norte,015,27424,878,843,3,846,2
2021-01-19,El Dorado,017,186661,8257,7743,529,8272,47
2021-01-19,Fresno,019,978130,87730,83200,6598,89798,857
2021-01-19,Glenn,021,27897,2041,1948,411,2359,13
2021-01-19,Humboldt,023,135768,2567,2359,13,2372,22
2021-01-19,Imperial,025,180216,25969,25333,2263,27596,452
2021-01-19,Inyo,027,18085,1007,891,8,899,26
2021-01-19,Kern,029,883053,84379,80272,7632,87904,742
2021-01-19,Kings,031,150075,20247,19375,794,20169,143
2021-01-19,Lake,033,64148,2740,2625,0,2625,31
2021-01-19,Lassen,035,31185,4863,4753,79,4832,1
2021-01-19,Los Angeles,037,10098052,1064278,1010375,34326,1044701,14014
2021-01-19,Madera,039,155013,14143,13528,673,14201,86
2021-01-19,Marin,041,260295,11921,11654,120,11774,169
2021-01-19,Mariposa,043,17540,340,322,3,325,3
2021-01-19,Mendocino,045,87422,3124,2930,56,2986,32
2021-01-19,Merced,047,269075,24817,24108,662,24770,242
2021-01-19,Modoc,049,8938,301,281,92,373,0
2021-01-19,Mono,051,14174,1103,1106,14,1120,3
2021-01-19,Monterey,053,433212,37522,35840,1244,37084,248
2021-01-19,Napa,055,140530,8007,7672,31,7703,38
2021-01-19,Nevada,057,99092,3448,3216,135,3351,18
2021-01-19,Orange,059,3164182,223280,215244,9004,224248,2468
2021-01-19,Placer,061,380077,18617,17348,885,18233,182
2021-01-19,Plumas,063,18699,594,509,10,519,2
2021-01-19,Riverside,065,2383286,258714,246248,12198,258446,2585
2021-01-19,Sacramento,067,1510023,83819,81183,963,82146,1053
2021-01-19,San Benito,069,59416,5161,4988,58,5046,35
2021-01-19,San Bernardino,071,2135413,265874,253651,7672,261323,1777
2021-01-19,San Diego,073,3302833,231993,216833,10721,227554,2109
2021-01-19,San Francisco,075,870044,30292,29502,663,30165,261
2021-01-19,San Joaquin,077,732212,59866,57655,2358,60013,782
2021-01-19,San Luis Obispo,079,281455,16932,15855,436,16291,161
2021-01-19,San Mateo,081,765935,34848,32730,278,33008,208
2021-01-19,Santa Barbara,083,443738,26998,24991,793,25784,236
2021-01-19,Santa Clara,085,1922200,97517,94483,441,94924,1010
2021-01-19,Santa Cruz,087,273765,13628,12410,630,13040,106
2021-01-19,Shasta,089,179085,9985,9614,1004,10618,93
2021-01-19,Sierra,091,2930,47,40,10,50,0
2021-01-19,Siskiyou,093,43540,1263,1149,183,1332,4
2021-01-19,Solano,095,438530,26483,25520,289,25809,106
2021-01-19,Sonoma,097,501317,24914,24133,124,24257,223
2021-01-19,Stanislaus,099,539301,44672,42723,4467,47190,561
2021-01-19,Sutter,101,95872,7929,7709,68,7777,80
2021-01-19,Tehama,103,63373,4063,3876,444,4320,19
2021-01-19,Trinity,105,12862,437,260,66,326,3
2021-01-19,Tulare,107,460477,43633,41559,6007,47566,549
2021-01-19,Tuolumne,109,53932,3337,3328,29,3357,29
2021-01-19,Ventura,111,848112,65499,62656,2315,64971,383
2021-01-19,Yolo,113,214977,11469,10789,128,10917,134
2021-01-19,Yuba,115,75493,4911,4695,64,4759,29
2021-01-18,Alameda,001,1643700,70284,67938,1470,69408,680
2021-01-18,Alpine,003,1148,73,71,0,71,0
2021-01-18,Amador,005,37829,3058,3016,24,3040,28
2021-01-18,Butte,007,227075,10101,9474,1348,10822,129
2021-01-18,Calaveras,009,45235,1635,1617,7,1624,21
2021-01-18,Colusa,011,21464,1662,1608,170,1778,7
2021-01-18,Contra Costa,013,1133247,54645,52323,895,53218,448
2021-01-18,Del Norte,015,27424,877,840,3,843,2
2021-01-18,El Dorado,017,186661,8188,7707,527,8234,47
2021-01-18,Fresno,019,978130,87118,82485,6531,89016,857
2021-01-18,Glenn,021,27897,2024,1935,407,2342,13
2021-01-18,Humboldt,023,135768,2529,2343,13,2356,22
2021-01-18,Imperial,025,180216,25900,25317,2238,27555,452
2021-01-18,Inyo,027,18085,995,872,8,880,26
2021-01-18,Kern,029,883053,83741,79930,7541,87471,740
2021-01-18,Kings,031,150075,20077,19267,782,20049,141
2021-01-18,Lake,033,64148,2723,2591,0,2591,30
2021-01-18,Lassen,035,31185,4827,4749,78,4827,1
2021-01-18,Los Angeles,037,10098052,1054782,1002614,34033,1036647,13828
2021-01-18,Madera,039,155013,14030,13443,665,14108,85
2021-01-18,Marin,041,260295,11874,11607,118,11725,165
2021-01-18,Mariposa,043,17540,337,320,2,322,3
2021-01-18,Mendocino,045,87422,3101,2919,56,2975,31
2021-01-18,Merced,047,269075,24572,23927,646,24573,242
2021-01-18,Modoc,049,8938,298,281,89,370,0
2021-01-18,Mono,051,14174,1100,1101,14,1115,3
2021-01-18,Monterey,053,433212,37079,35549,1230,36779,247
2021-01-18,Napa,055,140530,7933,7601,31,7632,38
2021-01-18,Nevada,057,99092,3410,3199,134,3333,17
2021-01-18,Orange,059,3164182,221377,213866,8948,222814,2405
2021-01-18,Placer,061,380077,18501,17263,876,18139,182
2021-01-18,Plumas,063,18699,590,506,10,516,2
2021-01-18,Riverside,065,2383286,256398,244151,12104,256255,2568
2021-01-18,Sacramento,067,1510023,83149,80546,947,81493,1046
2021-01-18,San Benito,069,59416,5111,4963,56,5019,35
2021-01-18,San Bernardino,071,2135413,264108,252808,7613,260421,1775
2021-01-18,San Diego,073,3302833,229345,214335,10592,224927,2103
2021-01-18,San Francisco,075,870044,30086,29321,639,29960,259
2021-01-18,San Joaquin,077,732212,59348,57405,2336,59741,782
2021-01-18,San Luis Obispo,079,281455,16745,15742,426,16168,158
2021-01-18,San Mateo,081,765935,34534,32515,259,32774,208
2021-01-18,Santa Barbara,083,443738,26619,24638,779,25417,235
2021-01-18,Santa Clara,085,1922200,96625,93688,437,94125,992
2021-01-18,Santa Cruz,087,273765,13495,12298,617,12915,106
2021-01-18,Shasta,089,179085,9946,9600,994,10594,92
2021-01-18,Sierra,091,2930,46,40,10,50,0
2021-01-18,Siskiyou,093,43540,1251,1144,182,1326,4
2021-01-18,Solano,095,438530,26206,25344,284,25628,105
2021-01-18,Sonoma,097,501317,24646,24068,123,24191,223
2021-01-18,Stanislaus,099,539301,44316,42413,4409,46822,562
2021-01-18,Sutter,101,95872,7872,7680,66,7746,78
2021-01-18,Tehama,103,63373,4019,3854,437,4291,19
2021-01-18,Trinity,105,12862,437,260,66,326,3
2021-01-18,Tulare,107,460477,43344,41196,5895,47091,549
2021-01-18,Tuolumne,109,53932,3314,3318,28,3346,28
2021-01-18,Ventura,111,848112,65069,61859,2292,64151,379
2021-01-18,Yolo,113,214977,11341,10620,125,10745,134
2021-01-18,Yuba,115,75493,4883,4671,62,4733,29
2021-01-17,Alameda,001,1643700,69709,67375,1452,68827,676
2021-01-17,Alpine,003,1148,73,71,0,71,0
2021-01-17,Amador,005,37829,3051,3001,24,3025,28
2021-01-17,Butte,007,227075,10026,9411,1325,10736,129
2021-01-17,Calaveras,009,45235,1622,1608,7,1615,21
2021-01-17,Colusa,011,21464,1648,1588,165,1753,7
2021-01-17,Contra Costa,013,1133247,54155,51932,885,52817,447
2021-01-17,Del Norte,015,27424,877,838,3,841,2
2021-01-17,El Dorado,017,186661,8132,7659,515,8174,47
2021-01-17,Fresno,019,978130,86565,82039,6455,88494,857
2021-01-17,Glenn,021,27897,2014,1924,401,2325,9
2021-01-17,Humboldt,023,135768,2492,2322,11,2333,22
2021-01-17,Imperial,025,180216,25830,25253,2194,27447,451
2021-01-17,Inyo,027,18085,989,864,8,872,26
2021-01-17,Kern,029,883053,83193,79489,7454,86943,738
2021-01-17,Kings,031,150075,19941,19201,768,19969,131
2021-01-17,Lake,033,64148,2707,2572,0,2572,30
2021-01-17,Lassen,035,31185,4819,4740,77,4817,1
2021-01-17,Los Angeles,037,10098052,1048134,993028,33631,1026659,13741
2021-01-17,Madera,039,155013,13938,13328,660,13988,85
2021-01-17,Marin,041,260295,11821,11552,116,11668,164
2021-01-17,Mariposa,043,17540,337,319,2,321,3
2021-01-17,Mendocino,045,87422,3073,2912,55,2967,31
2021-01-17,Merced,047,269075,24360,23800,628,24428,242
2021-01-17,Modoc,049,8938,297,279,89,368,0
2021-01-17,Mono,051,14174,1093,1091,13,1104,3
2021-01-17,Monterey,053,433212,36836,35340,1204,36544,244
2021-01-17,Napa,055,140530,7877,7521,31,7552,38
2021-01-17,Nevada,057,99092,3385,3176,132,3308,17
2021-01-17,Orange,059,3164182,219371,212389,8873,221262,2359
2021-01-17,Placer,061,380077,18396,17194,861,18055,181
2021-01-17,Plumas,063,18699,589,505,9,514,2
2021-01-17,Riverside,065,2383286,254287,242206,11986,254192,2534
2021-01-17,Sacramento,067,1510023,82548,80154,935,81089,1045
2021-01-17,San Benito,069,59416,5073,4941,56,4997,35
2021-01-17,San Bernardino,071,2135413,261988,251487,7525,259012,1775
2021-01-17,San Diego,073,3302833,227151,211785,10485,222270,2103
2021-01-17,San Francisco,075,870044,29900,29139,601,29740,255
2021-01-17,San Joaquin,077,732212,58990,57094,2321,59415,780
2021-01-17,San Luis Obispo,079,281455,16623,15658,417,16075,157
2021-01-17,San Mateo,081,765935,34281,32186,236,32422,208
2021-01-17,Santa Barbara,083,443738,26159,24401,766,25167,235
2021-01-17,Santa Clara,085,1922200,95878,92752,434,93186,976
2021-01-17,Santa Cruz,087,273765,13383,12196,614,12810,106
2021-01-17,Shasta,089,179085,9888,9588,986,10574,92
2021-01-17,Sierra,091,2930,46,38,9,47,0
2021-01-17,Siskiyou,093,43540,1244,1136,179,1315,4
2021-01-17,Solano,095,438530,25977,25216,282,25498,105
2021-01-17,Sonoma,097,501317,24472,23871,123,23994,223
2021-01-17,Stanislaus,099,539301,43995,42221,4343,46564,562
2021-01-17,Sutter,101,95872,7809,7604,65,7669,77
2021-01-17,Tehama,103,63373,3988,3837,433,4270,18
2021-01-17,Trinity,105,12862,437,261,66,327,3
2021-01-17,Tulare,107,460477,43052,41016,5779,46795,549
2021-01-17,Tuolumne,109,53932,3297,3287,28,3315,27
2021-01-17,Ventura,111,848112,64221,61257,2244,63501,376
2021-01-17,Yolo,113,214977,11242,10519,123,10642,134
2021-01-17,Yuba,115,75493,4833,4640,59,4699,28
2021-01-16,Alameda,001,1643700,69384,66583,1439,68022,673
2021-01-16,Alpine,003,1148,73,71,0,71,0
2021-01-16,Amador,005,37829,3048,2986,24,3010,28
2021-01-16,Butte,007,227075,9993,9359,1305,10664,129
2021-01-16,Calaveras,009,45235,1609,1596,7,1603,21
2021-01-16,Colusa,011,21464,1636,1578,165,1743,7
2021-01-16,Contra Costa,013,1133247,53891,51363,878,52241,443
2021-01-16,Del Norte,015,27424,872,833,3,836,2
2021-01-16,El Dorado,017,186661,8110,7575,514,8089,47
2021-01-16,Fresno,019,978130,86291,81294,6398,87692,846
2021-01-16,Glenn,021,27897,2010,1894,398,2292,9
2021-01-16,Humboldt,023,135768,2472,2294,9,2303,22
2021-01-16,Imperial,025,180216,25795,25140,2187,27327,451
2021-01-16,Inyo,027,18085,985,845,8,853,25
2021-01-16,Kern,029,883053,82826,78865,7400,86265,733
2021-01-16,Kings,031,150075,19885,19072,765,19837,131
2021-01-16,Lake,033,64148,2696,2504,0,2504,30
2021-01-16,Lassen,035,31185,4807,4719,77,4796,1
2021-01-16,Los Angeles,037,10098052,1044054,982684,33390,1016074,13654
2021-01-16,Madera,039,155013,13871,13193,656,13849,85
2021-01-16,Marin,041,260295,11778,11482,116,11598,164
2021-01-16,Mariposa,043,17540,336,317,2,319,3
2021-01-16,Mendocino,045,87422,3059,2890,52,2942,31
2021-01-16,Merced,047,269075,24272,23478,614,24092,242
2021-01-16,Modoc,049,8938,297,278,89,367,0
2021-01-16,Mono,051,14174,1091,1079,13,1092,3
2021-01-16,Monterey,053,433212,36725,34972,1186,36158,243
2021-01-16,Napa,055,140530,7838,7356,31,7387,39
2021-01-16,Nevada,057,99092,3352,3144,132,3276,17
2021-01-16,Orange,059,3164182,218334,210111,8816,218927,2312
2021-01-16,Placer,061,380077,18332,16995,859,17854,177
2021-01-16,Plumas,063,18699,587,502,9,511,2
2021-01-16,Riverside,065,2383286,252932,239412,11870,251282,2506
2021-01-16,Sacramento,067,1510023,82172,79122,918,80040,1033
2021-01-16,San Benito,069,59416,5041,4875,56,4931,35
2021-01-16,San Bernardino,071,2135413,261201,249401,7458,256859,1755
2021-01-16,San Diego,073,3302833,225853,209895,10388,220283,2065
2021-01-16,San Francisco,075,870044,29772,28853,570,29423,244
2021-01-16,San Joaquin,077,732212,58743,56642,2290,58932,776
2021-01-16,San Luis Obispo,079,281455,16522,15466,415,15881,152
2021-01-16,San Mateo,081,765935,34117,31805,230,32035,208
2021-01-16,Santa Barbara,083,443738,25959,24088,762,24850,229
2021-01-16,Santa Clara,085,1922200,95409,91584,427,92011,954
2021-01-16,Santa Cruz,087,273765,13324,12026,612,12638,106
2021-01-16,Shasta,089,179085,9855,9547,982,10529,92
2021-01-16,Sierra,091,2930,45,38,9,47,0
2021-01-16,Siskiyou,093,43540,1239,1124,179,1303,4
2021-01-16,Solano,095,438530,25868,24732,277,25009,103
2021-01-16,Sonoma,097,501317,24381,23607,122,23729,223
2021-01-16,Stanislaus,099,539301,43808,41809,4293,46102,562
2021-01-16,Sutter,101,95872,7777,7560,65,7625,76
2021-01-16,Tehama,103,63373,3974,3783,433,4216,18
2021-01-16,Trinity,105,12862,437,261,66,327,3
2021-01-16,Tulare,107,460477,42872,40655,5706,46361,542
2021-01-16,Tuolumne,109,53932,3289,3269,28,3297,27
2021-01-16,Ventura,111,848112,63669,60368,2214,62582,369
2021-01-16,Yolo,113,214977,11193,10406,122,10528,134
2021-01-16,Yuba,115,75493,4802,4602,59,4661,27
2021-01-15,Alameda,001,1643700,68946,65416,1428,66844,672
2021-01-15,Alpine,003,1148,73,71,0,71,0
2021-01-15,Amador,005,37829,3041,2953,24,2977,28
2021-01-15,Butte,007,227075,9952,9233,1290,10523,129
2021-01-15,Calaveras,009,45235,1602,1538,7,1545,21
2021-01-15,Colusa,011,21464,1625,1541,160,1701,7
2021-01-15,Contra Costa,013,1133247,53561,50408,871,51279,428
2021-01-15,Del Norte,015,27424,868,828,2,830,2
2021-01-15,El Dorado,017,186661,8061,7439,505,7944,47
2021-01-15,Fresno,019,978130,85754,79950,6362,86312,832
2021-01-15,Glenn,021,27897,2006,1824,395,2219,9
2021-01-15,Humboldt,023,135768,2445,2218,8,2226,22
2021-01-15,Imperial,025,180216,25761,24944,2181,27125,446
2021-01-15,Inyo,027,18085,967,814,8,822,25
2021-01-15,Kern,029,883053,82411,77873,7335,85208,719
2021-01-15,Kings,031,150075,19776,18661,759,19420,131
2021-01-15,Lake,033,64148,2670,2434,0,2434,28
2021-01-15,Lassen,035,31185,4796,4693,75,4768,1
2021-01-15,Los Angeles,037,10098052,1037010,968979,33099,1002078,13404
2021-01-15,Madera,039,155013,13786,12883,653,13536,85
2021-01-15,Marin,041,260295,11727,11310,116,11426,160
2021-01-15,Mariposa,043,17540,334,307,2,309,3
2021-01-15,Mendocino,045,87422,3048,2835,52,2887,31
2021-01-15,Merced,047,269075,24159,23060,610,23670,239
2021-01-15,Modoc,049,8938,297,278,87,365,0
2021-01-15,Mono,051,14174,1088,1057,13,1070,3
2021-01-15,Monterey,053,433212,36509,34460,1126,35586,243
2021-01-15,Napa,055,140530,7776,7231,31,7262,38
2021-01-15,Nevada,057,99092,3339,3099,129,3228,17
2021-01-15,Orange,059,3164182,216976,207129,8764,215893,2254
2021-01-15,Placer,061,380077,18228,16712,850,17562,173
2021-01-15,Plumas,063,18699,584,499,9,508,2
2021-01-15,Riverside,065,2383286,251067,235235,11791,247026,2458
2021-01-15,Sacramento,067,1510023,81751,80279,910,81189,1023
2021-01-15,San Benito,069,59416,5002,4766,54,4820,35
2021-01-15,San Bernardino,071,2135413,260033,246182,7400,253582,1726
2021-01-15,San Diego,073,3302833,224104,206868,10323,217191,2037
2021-01-15,San Francisco,075,870044,29598,28574,550,29124,242
2021-01-15,San Joaquin,077,732212,58509,55885,2276,58161,748
2021-01-15,San Luis Obispo,079,281455,16389,15129,410,15539,148
2021-01-15,San Mateo,081,765935,33872,31291,226,31517,208
2021-01-15,Santa Barbara,083,443738,25675,23487,758,24245,226
2021-01-15,Santa Clara,085,1922200,94757,90103,422,90525,942
2021-01-15,Santa Cruz,087,273765,13215,11776,598,12374,105
2021-01-15,Shasta,089,179085,9816,9459,975,10434,91
2021-01-15,Sierra,091,2930,44,36,7,43,0
2021-01-15,Siskiyou,093,43540,1235,1119,178,1297,4
2021-01-15,Solano,095,438530,25718,24222,274,24496,103
2021-01-15,Sonoma,097,501317,24250,23204,121,23325,222
2021-01-15,Stanislaus,099,539301,43558,41178,4254,45432,562
2021-01-15,Sutter,101,95872,7730,7484,64,7548,75
2021-01-15,Tehama,103,63373,3952,3714,432,4146,17
2021-01-15,Trinity,105,12862,437,262,66,328,3
2021-01-15,Tulare,107,460477,42627,39951,5622,45573,535
2021-01-15,Tuolumne,109,53932,3273,3231,28,3259,27
2021-01-15,Ventura,111,848112,62925,59061,2181,61242,353
2021-01-15,Yolo,113,214977,11137,10240,121,10361,134
2021-01-15,Yuba,115,75493,4781,4549,59,4608,27
2021-01-14,Alameda,001,1643700,68293,64364,1413,65777,686
2021-01-14,Alpine,003,1148,73,71,0,71,0
2021-01-14,Amador,005,37829,3035,2940,24,2964,28
2021-01-14,Butte,007,227075,9866,9127,1268,10395,129
2021-01-14,Calaveras,009,45235,1585,1513,7,1520,21
2021-01-14,Colusa,011,21464,1610,1535,157,1692,7
2021-01-14,Contra Costa,013,1133247,53006,49545,857,50402,415
2021-01-14,Del Norte,015,27424,862,821,2,823,2
2021-01-14,El Dorado,017,186661,7987,7321,497,7818,45
2021-01-14,Fresno,019,978130,85121,79033,6282,85315,814
2021-01-14,Glenn,021,27897,1994,1798,390,2188,9
2021-01-14,Humboldt,023,135768,2402,2169,8,2177,22
2021-01-14,Imperial,025,180216,25652,24882,2146,27028,447
2021-01-14,Inyo,027,18085,960,790,8,798,25
2021-01-14,Kern,029,883053,81739,77070,7234,84304,705
2021-01-14,Kings,031,150075,19646,18405,755,19160,108
2021-01-14,Lake,033,64148,2627,2378,0,2378,27
2021-01-14,Lassen,035,31185,4786,4673,73,4746,1
2021-01-14,Los Angeles,037,10098052,1026995,954652,32718,987370,13147
2021-01-14,Madera,039,155013,13672,12742,642,13384,85
2021-01-14,Marin,041,260295,11653,11155,115,11270,159
2021-01-14,Mariposa,043,17540,331,302,2,304,3
2021-01-14,Mendocino,045,87422,3034,2801,50,2851,31
2021-01-14,Merced,047,269075,23932,22780,600,23380,239
2021-01-14,Modoc,049,8938,297,273,87,360,0
2021-01-14,Mono,051,14174,1080,1020,13,1033,3
2021-01-14,Monterey,053,433212,36088,34105,1104,35209,242
2021-01-14,Napa,055,140530,7691,7117,31,7148,38
2021-01-14,Nevada,057,99092,3312,3075,127,3202,17
2021-01-14,Orange,059,3164182,215046,204442,8678,213120,2162
2021-01-14,Placer,061,380077,18066,16488,843,17331,169
2021-01-14,Plumas,063,18699,576,496,9,505,2
2021-01-14,Riverside,065,2383286,248418,231684,11691,243375,2357
2021-01-14,Sacramento,067,1510023,81112,79137,886,80023,1007
2021-01-14,San Benito,069,59416,4966,4678,53,4731,35
2021-01-14,San Bernardino,071,2135413,258067,243379,7330,250709,1750
2021-01-14,San Diego,073,3302833,221710,204173,10203,214376,2005
2021-01-14,San Francisco,075,870044,29353,28200,502,28702,238
2021-01-14,San Joaquin,077,732212,57993,55058,2262,57320,739
2021-01-14,San Luis Obispo,079,281455,16227,14851,401,15252,146
2021-01-14,San Mateo,081,765935,33503,30694,217,30911,208
2021-01-14,Santa Barbara,083,443738,25255,23126,740,23866,219
2021-01-14,Santa Clara,085,1922200,93823,88505,415,88920,910
2021-01-14,Santa Cruz,087,273765,13068,11583,582,12165,109
2021-01-14,Shasta,089,179085,9767,9334,959,10293,90
2021-01-14,Sierra,091,2930,44,35,6,41,0
2021-01-14,Siskiyou,093,43540,1223,1108,175,1283,3
2021-01-14,Solano,095,438530,25459,23782,270,24052,103
2021-01-14,Sonoma,097,501317,24010,22910,121,23031,202
2021-01-14,Stanislaus,099,539301,43232,40597,4211,44808,574
2021-01-14,Sutter,101,95872,7671,7416,61,7477,74
2021-01-14,Tehama,103,63373,3924,3664,428,4092,17
2021-01-14,Trinity,105,12862,437,261,65,326,3
2021-01-14,Tulare,107,460477,42243,39565,5513,45078,533
2021-01-14,Tuolumne,109,53932,3252,3215,28,3243,28
2021-01-14,Ventura,111,848112,62053,57941,2144,60085,347
2021-01-14,Yolo,113,214977,11028,10097,115,10212,135
2021-01-14,Yuba,115,75493,4749,4496,59,4555,27
2021-01-13,Alameda,001,1643700,67535,63568,1396,64964,690
2021-01-13,Alpine,003,1148,73,71,0,71,0
2021-01-13,Amador,005,37829,3021,2914,24,2938,26
2021-01-13,Butte,007,227075,9784,9013,1253,10266,126
2021-01-13,Calaveras,009,45235,1563,1493,7,1500,21
2021-01-13,Colusa,011,21464,1598,1524,152,1676,7
2021-01-13,Contra Costa,013,1133247,52425,48877,845,49722,403
2021-01-13,Del Norte,015,27424,858,820,2,822,2
2021-01-13,El Dorado,017,186661,7894,7247,489,7736,43
2021-01-13,Fresno,019,978130,84401,78278,6240,84518,804
2021-01-13,Glenn,021,27897,1978,1792,381,2173,9
2021-01-13,Humboldt,023,135768,2369,2114,8,2122,22
2021-01-13,Imperial,025,180216,25528,24717,2113,26830,463
2021-01-13,Inyo,027,18085,948,785,8,793,25
2021-01-13,Kern,029,883053,81078,76049,7144,83193,704
2021-01-13,Kings,031,150075,19479,18121,733,18854,108
2021-01-13,Lake,033,64148,2583,2305,0,2305,27
2021-01-13,Lassen,035,31185,4779,4663,72,4735,1
2021-01-13,Los Angeles,037,10098052,1016208,937985,32307,970292,12873
2021-01-13,Madera,039,155013,13546,12570,637,13207,85
2021-01-13,Marin,041,260295,11597,11039,115,11154,161
2021-01-13,Mariposa,043,17540,329,304,2,306,3
2021-01-13,Mendocino,045,87422,3014,2790,50,2840,31
2021-01-13,Merced,047,269075,23693,22497,586,23083,241
2021-01-13,Modoc,049,8938,296,274,84,358,0
2021-01-13,Mono,051,14174,1076,1017,13,1030,3
2021-01-13,Monterey,053,433212,35664,33748,1080,34828,241
2021-01-13,Napa,055,140530,7577,7028,31,7059,36
2021-01-13,Nevada,057,99092,3288,3037,124,3161,17
2021-01-13,Orange,059,3164182,212959,201158,8609,209767,2172
2021-01-13,Placer,061,380077,17939,16272,829,17101,172
2021-01-13,Plumas,063,18699,574,490,9,499,2
2021-01-13,Riverside,065,2383286,245270,228192,11573,239765,2278
2021-01-13,Sacramento,067,1510023,80452,78268,879,79147,996
2021-01-13,San Benito,069,59416,4909,4583,52,4635,35
2021-01-13,San Bernardino,071,2135413,255695,240191,7258,247449,1759
2021-01-13,San Diego,073,3302833,219096,201578,10100,211678,1952
2021-01-13,San Francisco,075,870044,29114,27863,480,28343,238
2021-01-13,San Joaquin,077,732212,57370,54373,2232,56605,738
2021-01-13,San Luis Obispo,079,281455,16072,14625,390,15015,140
2021-01-13,San Mateo,081,765935,33163,30195,215,30410,207
2021-01-13,Santa Barbara,083,443738,24813,22714,724,23438,216
2021-01-13,Santa Clara,085,1922200,92846,87187,412,87599,911
2021-01-13,Santa Cruz,087,273765,12895,11423,568,11991,110
2021-01-13,Shasta,089,179085,9703,9180,945,10125,93
2021-01-13,Sierra,091,2930,44,33,6,39,0
2021-01-13,Siskiyou,093,43540,1217,1102,171,1273,3
2021-01-13,Solano,095,438530,25174,23503,268,23771,105
2021-01-13,Sonoma,097,501317,23760,22610,120,22730,206
2021-01-13,Stanislaus,099,539301,42840,40167,4158,44325,574
2021-01-13,Sutter,101,95872,7625,7350,60,7410,73
2021-01-13,Tehama,103,63373,3874,3589,423,4012,17
2021-01-13,Trinity,105,12862,437,260,65,325,3
2021-01-13,Tulare,107,460477,41835,39129,5409,44538,522
2021-01-13,Tuolumne,109,53932,3238,3196,28,3224,28
2021-01-13,Ventura,111,848112,61041,56453,2104,58557,338
2021-01-13,Yolo,113,214977,10927,9933,111,10044,135
2021-01-13,Yuba,115,75493,4707,4448,56,4504,27
2021-01-12,Alameda,001,1643700,66712,62642,1376,64018,677
2021-01-12,Alpine,003,1148,73,71,0,71,0
2021-01-12,Amador,005,37829,3004,2897,24,2921,26
2021-01-12,Butte,007,227075,9695,8883,1236,10119,124
2021-01-12,Calaveras,009,45235,1526,1475,7,1482,21
2021-01-12,Colusa,011,21464,1586,1510,148,1658,7
2021-01-12,Contra Costa,013,1133247,51783,48242,831,49073,399
2021-01-12,Del Norte,015,27424,853,816,2,818,2
2021-01-12,El Dorado,017,186661,7811,7156,478,7634,41
2021-01-12,Fresno,019,978130,83529,77651,6171,83822,796
2021-01-12,Glenn,021,27897,1953,1781,377,2158,9
2021-01-12,Humboldt,023,135768,2315,2077,7,2084,22
2021-01-12,Imperial,025,180216,25438,24566,2072,26638,457
2021-01-12,Inyo,027,18085,931,773,8,781,25
2021-01-12,Kern,029,883053,80371,75320,7048,82368,689
2021-01-12,Kings,031,150075,19267,18072,723,18795,108
2021-01-12,Lake,033,64148,2536,2260,0,2260,27
2021-01-12,Lassen,035,31185,4757,4659,70,4729,1
2021-01-12,Los Angeles,037,10098052,1004556,926295,31894,958189,12610
2021-01-12,Madera,039,155013,13406,12485,628,13113,85
2021-01-12,Marin,041,260295,11488,10960,115,11075,157
2021-01-12,Mariposa,043,17540,326,302,2,304,3
2021-01-12,Mendocino,045,87422,2994,2762,46,2808,31
2021-01-12,Merced,047,269075,23442,22172,564,22736,239
2021-01-12,Modoc,049,8938,294,274,84,358,0
2021-01-12,Mono,051,14174,1066,1008,13,1021,3
2021-01-12,Monterey,053,433212,35173,33381,1063,34444,240
2021-01-12,Napa,055,140530,7494,6936,31,6967,36
2021-01-12,Nevada,057,99092,3260,3014,122,3136,17
2021-01-12,Orange,059,3164182,210668,198260,8522,206782,2142
2021-01-12,Placer,061,380077,17769,16087,823,16910,163
2021-01-12,Plumas,063,18699,568,483,9,492,2
2021-01-12,Riverside,065,2383286,242136,225580,11434,237014,2266
2021-01-12,Sacramento,067,1510023,79723,77201,871,78072,985
2021-01-12,San Benito,069,59416,4841,4515,52,4567,35
2021-01-12,San Bernardino,071,2135413,253132,237008,7189,244197,1739
2021-01-12,San Diego,073,3302833,216181,198317,9984,208301,1898
2021-01-12,San Francisco,075,870044,28838,27531,447,27978,238
2021-01-12,San Joaquin,077,732212,56730,53630,2205,55835,725
2021-01-12,San Luis Obispo,079,281455,15826,14367,381,14748,132
2021-01-12,San Mateo,081,765935,32772,29747,203,29950,206
2021-01-12,Santa Barbara,083,443738,24390,22182,704,22886,209
2021-01-12,Santa Clara,085,1922200,91771,86075,404,86479,904
2021-01-12,Santa Cruz,087,273765,12680,11267,552,11819,110
2021-01-12,Shasta,089,179085,9630,9086,932,10018,84
2021-01-12,Sierra,091,2930,43,33,6,39,0
2021-01-12,Siskiyou,093,43540,1207,1091,164,1255,3
2021-01-12,Solano,095,438530,24871,23160,263,23423,102
2021-01-12,Sonoma,097,501317,23455,22403,120,22523,205
2021-01-12,Stanislaus,099,539301,42400,39615,4123,43738,571
2021-01-12,Sutter,101,95872,7562,7276,59,7335,73
2021-01-12,Tehama,103,63373,3836,3567,418,3985,17
2021-01-12,Trinity,105,12862,437,258,65,323,3
2021-01-12,Tulare,107,460477,41377,38797,5293,44090,509
2021-01-12,Tuolumne,109,53932,3205,3178,28,3206,28
2021-01-12,Ventura,111,848112,60069,55342,2071,57413,324
2021-01-12,Yolo,113,214977,10791,9857,101,9958,133
2021-01-12,Yuba,115,75493,4665,4389,56,4445,27
2021-01-11,Alameda,001,1643700,65853,61949,1359,63308,652
2021-01-11,Alpine,003,1148,73,70,0,70,0
2021-01-11,Amador,005,37829,2990,2867,24,2891,24
2021-01-11,Butte,007,227075,9581,8757,1218,9975,119
2021-01-11,Calaveras,009,45235,1507,1460,7,1467,21
2021-01-11,Colusa,011,21464,1568,1494,144,1638,7
2021-01-11,Contra Costa,013,1133247,51103,47728,822,48550,398
2021-01-11,Del Norte,015,27424,849,810,2,812,2
2021-01-11,El Dorado,017,186661,7717,6987,470,7457,36
2021-01-11,Fresno,019,978130,82649,76581,6094,82675,775
2021-01-11,Glenn,021,27897,1926,1763,371,2134,9
2021-01-11,Humboldt,023,135768,2276,2069,7,2076,22
2021-01-11,Imperial,025,180216,25323,24418,2036,26454,453
2021-01-11,Inyo,027,18085,913,763,8,771,25
2021-01-11,Kern,029,883053,79511,74489,6948,81437,682
2021-01-11,Kings,031,150075,19004,17909,715,18624,108
2021-01-11,Lake,033,64148,2484,2205,0,2205,26
2021-01-11,Lassen,035,31185,4734,4647,69,4716,1
2021-01-11,Los Angeles,037,10098052,991340,914434,31422,945856,12304
2021-01-11,Madera,039,155013,13272,12366,617,12983,85
2021-01-11,Marin,041,260295,11391,10814,112,10926,156
2021-01-11,Mariposa,043,17540,319,296,2,298,3
2021-01-11,Mendocino,045,87422,2966,2728,46,2774,31
2021-01-11,Merced,047,269075,23119,21884,549,22433,238
2021-01-11,Modoc,049,8938,293,271,83,354,0
2021-01-11,Mono,051,14174,1060,1006,13,1019,3
2021-01-11,Monterey,053,433212,34634,32858,1000,33858,239
2021-01-11,Napa,055,140530,7392,6822,31,6853,36
2021-01-11,Nevada,057,99092,3232,2980,122,3102,17
2021-01-11,Orange,059,3164182,208086,196340,8421,204761,2113
2021-01-11,Placer,061,380077,17589,15919,813,16732,163
2021-01-11,Plumas,063,18699,564,477,9,486,2
2021-01-11,Riverside,065,2383286,238623,222907,11287,234194,2222
2021-01-11,Sacramento,067,1510023,78792,76009,855,76864,974
2021-01-11,San Benito,069,59416,4767,4482,45,4527,34
2021-01-11,San Bernardino,071,2135413,250332,235543,7090,242633,1739
2021-01-11,San Diego,073,3302833,212912,194793,9824,204617,1857
2021-01-11,San Francisco,075,870044,28562,27264,426,27690,238
2021-01-11,San Joaquin,077,732212,56118,53002,2175,55177,725
2021-01-11,San Luis Obispo,079,281455,15455,14213,373,14586,126
2021-01-11,San Mateo,081,765935,32327,29355,191,29546,206
2021-01-11,Santa Barbara,083,443738,23940,21740,692,22432,200
2021-01-11,Santa Clara,085,1922200,90566,84851,395,85246,877
2021-01-11,Santa Cruz,087,273765,12500,11093,528,11621,106
2021-01-11,Shasta,089,179085,9532,8977,919,9896,81
2021-01-11,Sierra,091,2930,41,33,6,39,0
2021-01-11,Siskiyou,093,43540,1198,1087,162,1249,3
2021-01-11,Solano,095,438530,24551,22893,258,23151,101
2021-01-11,Sonoma,097,501317,23209,22191,120,22311,205
2021-01-11,Stanislaus,099,539301,41909,39149,4073,43222,571
2021-01-11,Sutter,101,95872,7503,7204,58,7262,71
2021-01-11,Tehama,103,63373,3773,3524,396,3920,17
2021-01-11,Trinity,105,12862,437,256,65,321,2
2021-01-11,Tulare,107,460477,40962,38380,5214,43594,497
2021-01-11,Tuolumne,109,53932,3194,3165,28,3193,27
2021-01-11,Ventura,111,848112,58933,54202,2048,56250,320
2021-01-11,Yolo,113,214977,10583,9699,99,9798,129
2021-01-11,Yuba,115,75493,4627,4349,49,4398,27
2021-01-10,Alameda,001,1643700,64855,61111,1331,62442,650
2021-01-10,Alpine,003,1148,73,70,0,70,0
2021-01-10,Amador,005,37829,2966,2861,24,2885,24
2021-01-10,Butte,007,227075,9460,8665,1194,9859,119
2021-01-10,Calaveras,009,45235,1483,1449,7,1456,21
2021-01-10,Colusa,011,21464,1544,1478,143,1621,7
2021-01-10,Contra Costa,013,1133247,50319,47109,804,47913,398
2021-01-10,Del Norte,015,27424,846,809,2,811,2
2021-01-10,El Dorado,017,186661,7630,6904,452,7356,36
2021-01-10,Fresno,019,978130,81838,75621,5971,81592,775
2021-01-10,Glenn,021,27897,1907,1746,363,2109,9
2021-01-10,Humboldt,023,135768,2215,2049,7,2056,22
2021-01-10,Imperial,025,180216,25162,24233,1985,26218,453
2021-01-10,Inyo,027,18085,885,748,8,756,25
2021-01-10,Kern,029,883053,78679,73712,6815,80527,679
2021-01-10,Kings,031,150075,18785,17812,708,18520,108
2021-01-10,Lake,033,64148,2431,2174,0,2174,26
2021-01-10,Lassen,035,31185,4712,4642,69,4711,1
2021-01-10,Los Angeles,037,10098052,976737,901783,30795,932578,12170
2021-01-10,Madera,039,155013,13083,12179,602,12781,85
2021-01-10,Marin,041,260295,11270,10737,111,10848,155
2021-01-10,Mariposa,043,17540,319,291,2,293,3
2021-01-10,Mendocino,045,87422,2935,2706,42,2748,31
2021-01-10,Merced,047,269075,22845,21691,537,22228,238
2021-01-10,Modoc,049,8938,293,271,81,352,0
2021-01-10,Mono,051,14174,1042,965,13,978,3
2021-01-10,Monterey,053,433212,34194,32571,967,33538,237
2021-01-10,Napa,055,140530,7288,6687,29,6716,36
2021-01-10,Nevada,057,99092,3213,2959,118,3077,17
2021-01-10,Orange,059,3164182,205321,193766,8297,202063,2104
2021-01-10,Placer,061,380077,17402,15779,793,16572,163
2021-01-10,Plumas,063,18699,554,477,9,486,2
2021-01-10,Riverside,065,2383286,235252,219486,11099,230585,2216
2021-01-10,Sacramento,067,1510023,77831,75394,827,76221,965
2021-01-10,San Benito,069,59416,4668,4434,44,4478,34
2021-01-10,San Bernardino,071,2135413,246799,232171,6986,239157,1736
2021-01-10,San Diego,073,3302833,209245,191886,9657,201543,1857
2021-01-10,San Francisco,075,870044,28178,27054,395,27449,238
2021-01-10,San Joaquin,077,732212,55260,52535,2141,54676,725
2021-01-10,San Luis Obispo,079,281455,15126,13968,361,14329,122
2021-01-10,San Mateo,081,765935,31835,28972,177,29149,206
2021-01-10,Santa Barbara,083,443738,23382,21290,677,21967,200
2021-01-10,Santa Clara,085,1922200,89392,83779,386,84165,858
2021-01-10,Santa Cruz,087,273765,12287,10951,507,11458,106
2021-01-10,Shasta,089,179085,9420,8936,904,9840,81
2021-01-10,Sierra,091,2930,40,32,6,38,0
2021-01-10,Siskiyou,093,43540,1192,1075,159,1234,3
2021-01-10,Solano,095,438530,24148,22621,255,22876,101
2021-01-10,Sonoma,097,501317,22933,21925,119,22044,204
2021-01-10,Stanislaus,099,539301,41336,38809,3995,42804,571
2021-01-10,Sutter,101,95872,7442,7133,55,7188,71
2021-01-10,Tehama,103,63373,3700,3504,383,3887,17
2021-01-10,Trinity,105,12862,437,253,63,316,2
2021-01-10,Tulare,107,460477,40546,38012,5092,43104,497
2021-01-10,Tuolumne,109,53932,3160,3143,27,3170,27
2021-01-10,Ventura,111,848112,57663,53095,2004,55099,319
2021-01-10,Yolo,113,214977,10430,9610,98,9708,129
2021-01-10,Yuba,115,75493,4575,4300,46,4346,27
2021-01-09,Alameda,001,1643700,64331,60125,1315,61440,649
2021-01-09,Alpine,003,1148,73,70,0,70,0
2021-01-09,Amador,005,37829,2959,2809,24,2833,24
2021-01-09,Butte,007,227075,9381,8552,1170,9722,118
2021-01-09,Calaveras,009,45235,1474,1425,7,1432,21
2021-01-09,Colusa,011,21464,1538,1468,142,1610,7
2021-01-09,Contra Costa,013,1133247,49967,46406,789,47195,393
2021-01-09,Del Norte,015,27424,844,802,2,804,2
2021-01-09,El Dorado,017,186661,7598,6800,449,7249,36
2021-01-09,Fresno,019,978130,81429,74816,5931,80747,773
2021-01-09,Glenn,021,27897,1891,1707,360,2067,9
2021-01-09,Humboldt,023,135768,2197,2026,7,2033,22
2021-01-09,Imperial,025,180216,25094,24028,1971,25999,448
2021-01-09,Inyo,027,18085,875,734,8,742,25
2021-01-09,Kern,029,883053,78211,73015,6738,79753,677
2021-01-09,Kings,031,150075,18690,17679,704,18383,108
2021-01-09,Lake,033,64148,2396,2144,0,2144,26
2021-01-09,Lassen,035,31185,4700,4613,68,4681,1
2021-01-09,Los Angeles,037,10098052,971167,887949,30353,918302,12011
2021-01-09,Madera,039,155013,12992,12063,597,12660,85
2021-01-09,Marin,041,260295,11209,10634,110,10744,154
2021-01-09,Mariposa,043,17540,316,287,2,289,3
2021-01-09,Mendocino,045,87422,2917,2664,42,2706,31
2021-01-09,Merced,047,269075,22703,21357,528,21885,237
2021-01-09,Modoc,049,8938,293,271,80,351,0
2021-01-09,Mono,051,14174,1037,964,13,977,3
2021-01-09,Monterey,053,433212,34043,31948,957,32905,235
2021-01-09,Napa,055,140530,7218,6594,26,6620,36
2021-01-09,Nevada,057,99092,3191,2932,115,3047,17
2021-01-09,Orange,059,3164182,203813,191004,8204,199208,2034
2021-01-09,Placer,061,380077,17294,15609,791,16400,162
2021-01-09,Plumas,063,18699,552,477,9,486,2
2021-01-09,Riverside,065,2383286,233497,216076,10962,227038,2201
2021-01-09,Sacramento,067,1510023,77297,74482,822,75304,953
2021-01-09,San Benito,069,59416,4617,4335,44,4379,34
2021-01-09,San Bernardino,071,2135413,245613,228857,6917,235774,1714
2021-01-09,San Diego,073,3302833,207552,188598,9537,198135,1824
2021-01-09,San Francisco,075,870044,28004,26708,352,27060,235
2021-01-09,San Joaquin,077,732212,54911,51927,2121,54048,724
2021-01-09,San Luis Obispo,079,281455,15002,13647,350,13997,121
2021-01-09,San Mateo,081,765935,31536,28512,170,28682,205
2021-01-09,Santa Barbara,083,443738,23169,20971,672,21643,197
2021-01-09,Santa Clara,085,1922200,88552,82269,374,82643,808
2021-01-09,Santa Cruz,087,273765,12191,10717,501,11218,107
2021-01-09,Shasta,089,179085,9387,8893,900,9793,81
2021-01-09,Sierra,091,2930,38,32,6,38,0
2021-01-09,Siskiyou,093,43540,1188,1062,155,1217,3
2021-01-09,Solano,095,438530,23990,22226,254,22480,101
2021-01-09,Sonoma,097,501317,22811,21393,119,21512,202
2021-01-09,Stanislaus,099,539301,41045,38403,3958,42361,567
2021-01-09,Sutter,101,95872,7406,7072,54,7126,69
2021-01-09,Tehama,103,63373,3668,3451,372,3823,15
2021-01-09,Trinity,105,12862,437,252,63,315,2
2021-01-09,Tulare,107,460477,40292,37684,5026,42710,496
2021-01-09,Tuolumne,109,53932,3152,3117,26,3143,26
2021-01-09,Ventura,111,848112,56834,51988,1978,53966,306
2021-01-09,Yolo,113,214977,10358,9524,95,9619,129
2021-01-09,Yuba,115,75493,4545,4265,46,4311,27
2021-01-08,Alameda,001,1643700,63777,59172,1305,60477,646
2021-01-08,Alpine,003,1148,73,70,0,70,0
2021-01-08,Amador,005,37829,2952,2792,24,2816,24
2021-01-08,Butte,007,227075,9321,8430,1157,9587,115
2021-01-08,Calaveras,009,45235,1460,1385,7,1392,21
2021-01-08,Colusa,011,21464,1525,1448,141,1589,7
2021-01-08,Contra Costa,013,1133247,49441,45667,785,46452,381
2021-01-08,Del Norte,015,27424,842,795,2,797,2
2021-01-08,El Dorado,017,186661,7528,6690,437,7127,36
2021-01-08,Fresno,019,978130,80614,73689,5870,79559,771
2021-01-08,Glenn,021,27897,1876,1680,355,2035,9
2021-01-08,Humboldt,023,135768,2173,1988,7,1995,22
2021-01-08,Imperial,025,180216,25028,23751,1956,25707,446
2021-01-08,Inyo,027,18085,861,682,8,690,24
2021-01-08,Kern,029,883053,77648,71978,6664,78642,674
2021-01-08,Kings,031,150075,18562,17441,699,18140,108
2021-01-08,Lake,033,64148,2371,2098,0,2098,26
2021-01-08,Lassen,035,31185,4692,4598,66,4664,1
2021-01-08,Los Angeles,037,10098052,960371,871188,29922,901110,11796
2021-01-08,Madera,039,155013,12841,11846,588,12434,85
2021-01-08,Marin,041,260295,11116,10531,109,10640,153
2021-01-08,Mariposa,043,17540,315,273,2,275,3
2021-01-08,Mendocino,045,87422,2898,2634,39,2673,31
2021-01-08,Merced,047,269075,22508,20862,523,21385,236
2021-01-08,Modoc,049,8938,293,266,80,346,0
2021-01-08,Mono,051,14174,1027,951,13,964,3
2021-01-08,Monterey,053,433212,33790,31543,946,32489,224
2021-01-08,Napa,055,140530,7148,6544,26,6570,32
2021-01-08,Nevada,057,99092,3169,2888,115,3003,17
2021-01-08,Orange,059,3164182,201821,186608,8117,194725,1991
2021-01-08,Placer,061,380077,17163,15401,784,16185,161
2021-01-08,Plumas,063,18699,546,465,9,474,2
2021-01-08,Riverside,065,2383286,231097,212122,10831,222953,2184
2021-01-08,Sacramento,067,1510023,76724,73245,816,74061,939
2021-01-08,San Benito,069,59416,4580,4225,43,4268,33
2021-01-08,San Bernardino,071,2135413,243733,224267,6847,231114,1703
2021-01-08,San Diego,073,3302833,205016,185060,9443,194503,1771
2021-01-08,San Francisco,075,870044,27756,26378,329,26707,207
2021-01-08,San Joaquin,077,732212,54575,50990,2092,53082,710
2021-01-08,San Luis Obispo,079,281455,14869,13286,338,13624,119
2021-01-08,San Mateo,081,765935,31186,28072,167,28239,204
2021-01-08,Santa Barbara,083,443738,22883,20461,667,21128,189
2021-01-08,Santa Clara,085,1922200,87547,80561,371,80932,789
2021-01-08,Santa Cruz,087,273765,12050,10486,493,10979,106
2021-01-08,Shasta,089,179085,9337,8772,885,9657,81
2021-01-08,Sierra,091,2930,38,31,6,37,0
2021-01-08,Siskiyou,093,43540,1185,1027,154,1181,3
2021-01-08,Solano,095,438530,23819,21832,251,22083,100
2021-01-08,Sonoma,097,501317,22669,21178,119,21297,201
2021-01-08,Stanislaus,099,539301,40747,37858,3923,41781,566
2021-01-08,Sutter,101,95872,7356,6982,54,7036,68
2021-01-08,Tehama,103,63373,3645,3406,368,3774,15
2021-01-08,Trinity,105,12862,437,247,63,310,2
2021-01-08,Tulare,107,460477,40020,36946,4925,41871,491
2021-01-08,Tuolumne,109,53932,3144,3099,26,3125,19
2021-01-08,Ventura,111,848112,55968,50553,1954,52507,294
2021-01-08,Yolo,113,214977,10270,9391,91,9482,129
2021-01-08,Yuba,115,75493,4503,4195,45,4240,26
2021-01-07,Alameda,001,1643700,62923,57921,1278,59199,632
2021-01-07,Alpine,003,1148,71,70,0,70,0
2021-01-07,Amador,005,37829,2939,2740,23,2763,24
2021-01-07,Butte,007,227075,9224,8278,1138,9416,112
2021-01-07,Calaveras,009,45235,1443,1342,6,1348,21
2021-01-07,Colusa,011,21464,1513,1420,134,1554,7
2021-01-07,Contra Costa,013,1133247,48665,44756,769,45525,376
2021-01-07,Del Norte,015,27424,840,791,2,793,2
2021-01-07,El Dorado,017,186661,7427,6545,425,6970,36
2021-01-07,Fresno,019,978130,79657,72557,5771,78328,765
2021-01-07,Glenn,021,27897,1858,1639,345,1984,9
2021-01-07,Humboldt,023,135768,2146,1954,7,1961,22
2021-01-07,Imperial,025,180216,24838,23608,1903,25511,431
2021-01-07,Inyo,027,18085,848,656,8,664,20
2021-01-07,Kern,029,883053,76786,70953,6513,77466,660
2021-01-07,Kings,031,150075,18434,17238,690,17928,108
2021-01-07,Lake,033,64148,2317,2054,0,2054,26
2021-01-07,Lassen,035,31185,4687,4581,64,4645,1
2021-01-07,Los Angeles,037,10098052,945468,853187,29379,882566,11480
2021-01-07,Madera,039,155013,12684,11644,577,12221,76
2021-01-07,Marin,041,260295,11027,10364,107,10471,153
2021-01-07,Mariposa,043,17540,313,264,2,266,3
2021-01-07,Mendocino,045,87422,2843,2585,34,2619,30
2021-01-07,Merced,047,269075,22187,20510,507,21017,234
2021-01-07,Modoc,049,8938,293,265,80,345,0
2021-01-07,Mono,051,14174,1016,905,13,918,3
2021-01-07,Monterey,053,433212,33285,30903,921,31824,222
2021-01-07,Napa,055,140530,7038,6408,26,6434,32
2021-01-07,Nevada,057,99092,3135,2847,110,2957,17
2021-01-07,Orange,059,3164182,198978,181922,8019,189941,1974
2021-01-07,Placer,061,380077,16984,15155,755,15910,144
2021-01-07,Plumas,063,18699,544,454,9,463,2
2021-01-07,Riverside,065,2383286,227635,208177,10675,218852,2156
2021-01-07,Sacramento,067,1510023,75817,72342,795,73137,919
2021-01-07,San Benito,069,59416,4519,4112,39,4151,33
2021-01-07,San Bernardino,071,2135413,240274,219691,6765,226456,1666
2021-01-07,San Diego,073,3302833,201710,180510,9264,189774,1738
2021-01-07,San Francisco,075,870044,27427,25885,314,26199,202
2021-01-07,San Joaquin,077,732212,53893,50156,2062,52218,689
2021-01-07,San Luis Obispo,079,281455,14630,12810,325,13135,118
2021-01-07,San Mateo,081,765935,30677,27494,163,27657,201
2021-01-07,Santa Barbara,083,443738,22456,19931,656,20587,187
2021-01-07,Santa Clara,085,1922200,86374,78808,368,79176,775
2021-01-07,Santa Cruz,087,273765,11841,10228,486,10714,104
2021-01-07,Shasta,089,179085,9249,8612,877,9489,81
2021-01-07,Sierra,091,2930,38,31,6,37,0
2021-01-07,Siskiyou,093,43540,1180,1010,152,1162,3
2021-01-07,Solano,095,438530,23427,21384,247,21631,100
2021-01-07,Sonoma,097,501317,22408,20857,118,20975,200
2021-01-07,Stanislaus,099,539301,40330,37296,3872,41168,553
2021-01-07,Sutter,101,95872,7297,6890,53,6943,65
2021-01-07,Tehama,103,63373,3621,3330,360,3690,15
2021-01-07,Trinity,105,12862,437,247,63,310,2
2021-01-07,Tulare,107,460477,39619,36397,4791,41188,482
2021-01-07,Tuolumne,109,53932,3124,3068,25,3093,14
2021-01-07,Ventura,111,848112,54807,49083,1926,51009,288
2021-01-07,Yolo,113,214977,10130,9207,89,9296,128
2021-01-07,Yuba,115,75493,4461,4128,45,4173,25
2021-01-06,Alameda,001,1643700,62069,57081,1248,58329,616
2021-01-06,Alpine,003,1148,71,70,0,70,0
2021-01-06,Amador,005,37829,2918,2717,22,2739,24
2021-01-06,Butte,007,227075,9109,8147,1122,9269,110
2021-01-06,Calaveras,009,45235,1420,1321,6,1327,21
2021-01-06,Colusa,011,21464,1492,1385,129,1514,7
2021-01-06,Contra Costa,013,1133247,47872,44054,753,44807,358
2021-01-06,Del Norte,015,27424,834,780,2,782,2
2021-01-06,El Dorado,017,186661,7315,6397,412,6809,35
2021-01-06,Fresno,019,978130,78814,71404,5669,77073,752
2021-01-06,Glenn,021,27897,1832,1622,340,1962,9
2021-01-06,Humboldt,023,135768,2120,1912,7,1919,22
2021-01-06,Imperial,025,180216,24593,23400,1861,25261,431
2021-01-06,Inyo,027,18085,832,630,8,638,20
2021-01-06,Kern,029,883053,75842,69893,6382,76275,646
2021-01-06,Kings,031,150075,18236,17019,670,17689,108
2021-01-06,Lake,033,64148,2280,2033,0,2033,26
2021-01-06,Lassen,035,31185,4675,4560,60,4620,1
2021-01-06,Los Angeles,037,10098052,929525,835052,28679,863731,11285
2021-01-06,Madera,039,155013,12548,11407,571,11978,67
2021-01-06,Marin,041,260295,10899,10282,106,10388,153
2021-01-06,Mariposa,043,17540,310,259,2,261,3
2021-01-06,Mendocino,045,87422,2813,2561,34,2595,30
2021-01-06,Merced,047,269075,21850,20258,491,20749,232
2021-01-06,Modoc,049,8938,293,263,80,343,0
2021-01-06,Mono,051,14174,985,905,13,918,3
2021-01-06,Monterey,053,433212,32685,30387,889,31276,222
2021-01-06,Napa,055,140530,6908,6342,26,6368,32
2021-01-06,Nevada,057,99092,3115,2805,109,2914,15
2021-01-06,Orange,059,3164182,195526,177686,7877,185563,1935
2021-01-06,Placer,061,380077,16796,14940,737,15677,134
2021-01-06,Plumas,063,18699,536,445,9,454,2
2021-01-06,Riverside,065,2383286,223607,203714,10489,214203,2121
2021-01-06,Sacramento,067,1510023,74792,71572,778,72350,909
2021-01-06,San Benito,069,59416,4443,4031,38,4069,32
2021-01-06,San Bernardino,071,2135413,236558,215286,6657,221943,1634
2021-01-06,San Diego,073,3302833,198212,176660,9093,185753,1691
2021-01-06,San Francisco,075,870044,27057,25424,306,25730,199
2021-01-06,San Joaquin,077,732212,53136,49286,2021,51307,673
2021-01-06,San Luis Obispo,079,281455,14237,12305,318,12623,115
2021-01-06,San Mateo,081,765935,30252,27050,160,27210,200
2021-01-06,Santa Barbara,083,443738,21967,19453,647,20100,177
2021-01-06,Santa Clara,085,1922200,85004,77485,361,77846,746
2021-01-06,Santa Cruz,087,273765,11622,9954,468,10422,97
2021-01-06,Shasta,089,179085,9178,8482,870,9352,78
2021-01-06,Sierra,091,2930,37,31,6,37,0
2021-01-06,Siskiyou,093,43540,1168,998,148,1146,3
2021-01-06,Solano,095,438530,23044,21102,244,21346,99
2021-01-06,Sonoma,097,501317,22101,20558,118,20676,196
2021-01-06,Stanislaus,099,539301,39763,36751,3813,40564,553
2021-01-06,Sutter,101,95872,7216,6839,52,6891,59
2021-01-06,Tehama,103,63373,3593,3306,354,3660,15
2021-01-06,Trinity,105,12862,437,246,63,309,2
2021-01-06,Tulare,107,460477,39066,35882,4694,40576,465
2021-01-06,Tuolumne,109,53932,3104,3008,25,3033,14
2021-01-06,Ventura,111,848112,53564,47428,1902,49330,280
2021-01-06,Yolo,113,214977,9967,9083,86,9169,127
2021-01-06,Yuba,115,75493,4412,4097,45,4142,25
2021-01-05,Alameda,001,1643700,60953,56432,1213,57645,602
2021-01-05,Alpine,003,1148,71,70,0,70,0
2021-01-05,Amador,005,37829,2878,2695,22,2717,24
2021-01-05,Butte,007,227075,8968,8008,1096,9104,107
2021-01-05,Calaveras,009,45235,1374,1292,6,1298,21
2021-01-05,Colusa,011,21464,1467,1376,123,1499,7
2021-01-05,Contra Costa,013,1133247,46997,43442,741,44183,353
2021-01-05,Del Norte,015,27424,827,770,2,772,2
2021-01-05,El Dorado,017,186661,7197,6270,391,6661,32
2021-01-05,Fresno,019,978130,77592,70971,5575,76546,741
2021-01-05,Glenn,021,27897,1809,1608,324,1932,9
2021-01-05,Humboldt,023,135768,2084,1884,7,1891,22
2021-01-05,Imperial,025,180216,24420,23165,1817,24982,421
2021-01-05,Inyo,027,18085,818,627,8,635,20
2021-01-05,Kern,029,883053,74764,68257,6243,74500,624
2021-01-05,Kings,031,150075,18037,16860,647,17507,108
2021-01-05,Lake,033,64148,2233,2015,0,2015,25
2021-01-05,Lassen,035,31185,4660,4554,56,4610,1
2021-01-05,Los Angeles,037,10098052,910797,823783,28004,851787,11028
2021-01-05,Madera,039,155013,12372,11359,558,11917,67
2021-01-05,Marin,041,260295,10746,10214,105,10319,151
2021-01-05,Mariposa,043,17540,304,257,2,259,3
2021-01-05,Mendocino,045,87422,2777,2501,34,2535,30
2021-01-05,Merced,047,269075,21499,20051,479,20530,230
2021-01-05,Modoc,049,8938,293,254,80,334,0
2021-01-05,Mono,051,14174,979,896,13,909,3
2021-01-05,Monterey,053,433212,32136,30045,856,30901,213
2021-01-05,Napa,055,140530,6821,6264,26,6290,29
2021-01-05,Nevada,057,99092,3087,2781,107,2888,15
2021-01-05,Orange,059,3164182,191890,174869,7682,182551,1918
2021-01-05,Placer,061,380077,16573,14723,714,15437,133
2021-01-05,Plumas,063,18699,529,428,9,437,2
2021-01-05,Riverside,065,2383286,219480,200439,10314,210753,2069
2021-01-05,Sacramento,067,1510023,73863,70677,752,71429,888
2021-01-05,San Benito,069,59416,4341,3961,36,3997,28
2021-01-05,San Bernardino,071,2135413,232614,212522,6542,219064,1615
2021-01-05,San Diego,073,3302833,194073,172845,8878,181723,1654
2021-01-05,San Francisco,075,870044,26690,24989,288,25277,196
2021-01-05,San Joaquin,077,732212,52263,48969,1973,50942,663
2021-01-05,San Luis Obispo,079,281455,13838,12027,308,12335,106
2021-01-05,San Mateo,081,765935,29768,26486,158,26644,198
2021-01-05,Santa Barbara,083,443738,21521,19063,638,19701,172
2021-01-05,Santa Clara,085,1922200,83473,76355,348,76703,729
2021-01-05,Santa Cruz,087,273765,11349,9753,444,10197,93
2021-01-05,Shasta,089,179085,9071,8345,852,9197,73
2021-01-05,Sierra,091,2930,37,31,6,37,0
2021-01-05,Siskiyou,093,43540,1156,985,146,1131,3
2021-01-05,Solano,095,438530,22636,20860,239,21099,97
2021-01-05,Sonoma,097,501317,21741,20247,117,20364,194
2021-01-05,Stanislaus,099,539301,39217,36363,3762,40125,553
2021-01-05,Sutter,101,95872,7119,6769,51,6820,59
2021-01-05,Tehama,103,63373,3537,3255,349,3604,9
2021-01-05,Trinity,105,12862,437,246,63,309,2
2021-01-05,Tulare,107,460477,38452,35585,4549,40134,455
2021-01-05,Tuolumne,109,53932,3080,2996,20,3016,13
2021-01-05,Ventura,111,848112,52318,46456,1880,48336,264
2021-01-05,Yolo,113,214977,9793,8980,85,9065,127
2021-01-05,Yuba,115,75493,4353,4053,44,4097,21
2021-01-04,Alameda,001,1643700,59725,55899,1179,57078,583
2021-01-04,Alpine,003,1148,71,68,0,68,0
2021-01-04,Amador,005,37829,2838,2596,22,2618,24
2021-01-04,Butte,007,227075,8809,7893,1076,8969,105
2021-01-04,Calaveras,009,45235,1333,1276,5,1281,21
2021-01-04,Colusa,011,21464,1442,1368,109,1477,7
2021-01-04,Contra Costa,013,1133247,46136,43019,715,43734,353
2021-01-04,Del Norte,015,27424,817,770,2,772,2
2021-01-04,El Dorado,017,186661,7063,6152,375,6527,27
2021-01-04,Fresno,019,978130,76324,69871,5477,75348,726
2021-01-04,Glenn,021,27897,1776,1590,319,1909,9
2021-01-04,Humboldt,023,135768,2048,1845,7,1852,22
2021-01-04,Imperial,025,180216,24268,23035,1764,24799,420
2021-01-04,Inyo,027,18085,791,623,8,631,20
2021-01-04,Kern,029,883053,73680,67418,6046,73464,623
2021-01-04,Kings,031,150075,17760,16801,622,17423,108
2021-01-04,Lake,033,64148,2194,1984,0,1984,25
2021-01-04,Lassen,035,31185,4638,4550,55,4605,1
2021-01-04,Los Angeles,037,10098052,890687,813022,27126,840148,10790
2021-01-04,Madera,039,155013,12152,11204,536,11740,67
2021-01-04,Marin,041,260295,10609,10115,102,10217,151
2021-01-04,Mariposa,043,17540,298,253,2,255,3
2021-01-04,Mendocino,045,87422,2737,2460,30,2490,28
2021-01-04,Merced,047,269075,21084,19804,460,20264,230
2021-01-04,Modoc,049,8938,277,250,78,328,0
2021-01-04,Mono,051,14174,968,895,13,908,3
2021-01-04,Monterey,053,433212,31516,29659,834,30493,212
2021-01-04,Napa,055,140530,6680,6187,26,6213,29
2021-01-04,Nevada,057,99092,3049,2765,104,2869,15
2021-01-04,Orange,059,3164182,188002,172458,7555,180013,1918
2021-01-04,Placer,061,380077,16314,14622,701,15323,133
2021-01-04,Plumas,063,18699,519,419,9,428,1
2021-01-04,Riverside,065,2383286,214929,196809,10123,206932,2066
2021-01-04,Sacramento,067,1510023,72810,70164,742,70906,870
2021-01-04,San Benito,069,59416,4228,3914,36,3950,28
2021-01-04,San Bernardino,071,2135413,228359,210868,6391,217259,1615
2021-01-04,San Diego,073,3302833,189499,171031,8682,179713,1598
2021-01-04,San Francisco,075,870044,26302,24753,282,25035,191
2021-01-04,San Joaquin,077,732212,51364,48644,1930,50574,661
2021-01-04,San Luis Obispo,079,281455,13352,11945,300,12245,96
2021-01-04,San Mateo,081,765935,29203,26150,153,26303,198
2021-01-04,Santa Barbara,083,443738,20998,18735,607,19342,165
2021-01-04,Santa Clara,085,1922200,81720,75297,340,75637,727
2021-01-04,Santa Cruz,087,273765,11061,9680,427,10107,85
2021-01-04,Shasta,089,179085,8966,8224,835,9059,72
2021-01-04,Sierra,091,2930,36,30,6,36,0
2021-01-04,Siskiyou,093,43540,1139,980,143,1123,3
2021-01-04,Solano,095,438530,22137,20588,232,20820,97
2021-01-04,Sonoma,097,501317,21403,20210,116,20326,194
2021-01-04,Stanislaus,099,539301,38654,36141,3705,39846,553
2021-01-04,Sutter,101,95872,7023,6712,50,6762,56
2021-01-04,Tehama,103,63373,3464,3190,344,3534,9
2021-01-04,Trinity,105,12862,434,245,63,308,2
2021-01-04,Tulare,107,460477,37892,35060,4446,39506,455
2021-01-04,Tuolumne,109,53932,3055,2987,20,3007,13
2021-01-04,Ventura,111,848112,50816,45014,1860,46874,255
2021-01-04,Yolo,113,214977,9599,8834,79,8913,121
2021-01-04,Yuba,115,75493,4295,4023,44,4067,21
2021-01-03,Alameda,001,1643700,58467,55082,1149,56231,580
2021-01-03,Alpine,003,1148,69,68,0,68,0
2021-01-03,Amador,005,37829,2774,2565,22,2587,24
2021-01-03,Butte,007,227075,8616,7837,1032,8869,105
2021-01-03,Calaveras,009,45235,1296,1249,3,1252,21
2021-01-03,Colusa,011,21464,1413,1337,103,1440,7
2021-01-03,Contra Costa,013,1133247,45246,42432,690,43122,352
2021-01-03,Del Norte,015,27424,805,768,2,770,2
2021-01-03,El Dorado,017,186661,6935,6034,358,6392,27
2021-01-03,Fresno,019,978130,75174,69326,5358,74684,719
2021-01-03,Glenn,021,27897,1750,1581,313,1894,9
2021-01-03,Humboldt,023,135768,2011,1833,7,1840,21
2021-01-03,Imperial,025,180216,24020,22951,1686,24637,419
2021-01-03,Inyo,027,18085,774,615,8,623,20
2021-01-03,Kern,029,883053,72420,66895,5868,72763,609
2021-01-03,Kings,031,150075,17484,16593,592,17185,108
2021-01-03,Lake,033,64148,2141,1976,0,1976,24
2021-01-03,Lassen,035,31185,4605,4531,54,4585,1
2021-01-03,Los Angeles,037,10098052,868659,792168,26053,818221,10633
2021-01-03,Madera,039,155013,11929,11152,513,11665,67
2021-01-03,Marin,041,260295,10458,10034,97,10131,150
2021-01-03,Mariposa,043,17540,291,248,2,250,3
2021-01-03,Mendocino,045,87422,2697,2445,29,2474,24
2021-01-03,Merced,047,269075,20616,19600,433,20033,230
2021-01-03,Modoc,049,8938,273,245,77,322,0
2021-01-03,Mono,051,14174,943,893,13,906,3
2021-01-03,Monterey,053,433212,30923,29357,799,30156,191
2021-01-03,Napa,055,140530,6579,6094,26,6120,29
2021-01-03,Nevada,057,99092,2988,2742,101,2843,15
2021-01-03,Orange,059,3164182,183813,169881,7361,177242,1919
2021-01-03,Placer,061,380077,16065,14319,677,14996,133
2021-01-03,Plumas,063,18699,506,416,9,425,1
2021-01-03,Riverside,065,2383286,210052,195048,9877,204925,2005
2021-01-03,Sacramento,067,1510023,71603,68558,721,69279,859
2021-01-03,San Benito,069,59416,4131,3882,35,3917,28
2021-01-03,San Bernardino,071,2135413,223041,208294,6218,214512,1592
2021-01-03,San Diego,073,3302833,184239,168018,8453,176471,1592
2021-01-03,San Francisco,075,870044,25805,24588,264,24852,193
2021-01-03,San Joaquin,077,732212,50244,47899,1873,49772,661
2021-01-03,San Luis Obispo,079,281455,12882,11636,291,11927,95
2021-01-03,San Mateo,081,765935,28608,25770,146,25916,196
2021-01-03,Santa Barbara,083,443738,20265,18267,590,18857,164
2021-01-03,Santa Clara,085,1922200,80133,74534,334,74868,720
2021-01-03,Santa Cruz,087,273765,10757,9528,411,9939,84
2021-01-03,Shasta,089,179085,8840,8192,795,8987,72
2021-01-03,Sierra,091,2930,36,30,6,36,0
2021-01-03,Siskiyou,093,43540,1106,976,134,1110,3
2021-01-03,Solano,095,438530,21608,20105,226,20331,97
2021-01-03,Sonoma,097,501317,21015,19982,112,20094,193
2021-01-03,Stanislaus,099,539301,37947,35762,3620,39382,553
2021-01-03,Sutter,101,95872,6926,6664,49,6713,53
2021-01-03,Tehama,103,63373,3407,3176,337,3513,9
2021-01-03,Trinity,105,12862,429,243,61,304,2
2021-01-03,Tulare,107,460477,37330,34747,4298,39045,455
2021-01-03,Tuolumne,109,53932,2995,2978,17,2995,13
2021-01-03,Ventura,111,848112,48992,43748,1842,45590,254
2021-01-03,Yolo,113,214977,9443,8674,75,8749,121
2021-01-03,Yuba,115,75493,4241,3966,43,4009,20
2021-01-02,Alameda,001,1643700,57836,54518,1120,55638,581
2021-01-02,Alpine,003,1148,69,68,0,68,0
2021-01-02,Amador,005,37829,2755,2540,22,2562,24
2021-01-02,Butte,007,227075,8510,7750,1011,8761,105
2021-01-02,Calaveras,009,45235,1276,1230,3,1233,21
2021-01-02,Colusa,011,21464,1403,1332,102,1434,7
2021-01-02,Contra Costa,013,1133247,44713,41993,679,42672,352
2021-01-02,Del Norte,015,27424,803,764,2,766,2
2021-01-02,El Dorado,017,186661,6880,5959,354,6313,27
2021-01-02,Fresno,019,978130,74630,68740,5244,73984,717
2021-01-02,Glenn,021,27897,1733,1546,312,1858,9
2021-01-02,Humboldt,023,135768,1984,1815,7,1822,21
2021-01-02,Imperial,025,180216,23933,22867,1650,24517,420
2021-01-02,Inyo,027,18085,761,609,8,617,20
2021-01-02,Kern,029,883053,71700,66457,5756,72213,610
2021-01-02,Kings,031,150075,17390,16515,588,17103,108
2021-01-02,Lake,033,64148,2105,1925,0,1925,24
2021-01-02,Lassen,035,31185,4594,4457,53,4510,1
2021-01-02,Los Angeles,037,10098052,860296,791892,25352,817244,10633
2021-01-02,Madera,039,155013,11818,11039,502,11541,67
2021-01-02,Marin,041,260295,10412,9924,94,10018,151
2021-01-02,Mariposa,043,17540,284,243,2,245,3
2021-01-02,Mendocino,045,87422,2654,2428,28,2456,24
2021-01-02,Merced,047,269075,20474,19395,416,19811,230
2021-01-02,Modoc,049,8938,272,245,77,322,0
2021-01-02,Mono,051,14174,932,884,13,897,3
2021-01-02,Monterey,053,433212,30710,28991,787,29778,191
2021-01-02,Napa,055,140530,6520,5994,26,6020,29
2021-01-02,Nevada,057,99092,2959,2706,97,2803,15
2021-01-02,Orange,059,3164182,181605,168457,7212,175669,1918
2021-01-02,Placer,061,380077,15892,14182,668,14850,133
2021-01-02,Plumas,063,18699,503,413,9,422,1
2021-01-02,Riverside,065,2383286,207410,192069,9651,201720,2008
2021-01-02,Sacramento,067,1510023,70968,67810,704,68514,858
2021-01-02,San Benito,069,59416,4048,3829,35,3864,28
2021-01-02,San Bernardino,071,2135413,221387,206939,6093,213032,1597
2021-01-02,San Diego,073,3302833,181640,164498,8256,172754,1592
2021-01-02,San Francisco,075,870044,25544,24414,257,24671,194
2021-01-02,San Joaquin,077,732212,49864,47310,1844,49154,662
2021-01-02,San Luis Obispo,079,281455,12746,11467,285,11752,95
2021-01-02,San Mateo,081,765935,28272,25483,138,25621,196
2021-01-02,Santa Barbara,083,443738,19976,18135,587,18722,164
2021-01-02,Santa Clara,085,1922200,78949,73662,327,73989,720
2021-01-02,Santa Cruz,087,273765,10602,9340,402,9742,85
2021-01-02,Shasta,089,179085,8774,8154,784,8938,72
2021-01-02,Sierra,091,2930,36,28,6,34,0
2021-01-02,Siskiyou,093,43540,1095,949,132,1081,3
2021-01-02,Solano,095,438530,21408,19805,216,20021,97
2021-01-02,Sonoma,097,501317,20846,19761,112,19873,194
2021-01-02,Stanislaus,099,539301,37614,35431,3555,38986,553
2021-01-02,Sutter,101,95872,6874,6621,49,6670,53
2021-01-02,Tehama,103,63373,3380,3146,333,3479,9
2021-01-02,Trinity,105,12862,426,243,61,304,2
2021-01-02,Tulare,107,460477,37010,34479,4223,38702,455
2021-01-02,Tuolumne,109,53932,2981,2942,15,2957,13
2021-01-02,Ventura,111,848112,47837,43397,1807,45204,254
2021-01-02,Yolo,113,214977,9345,8571,73,8644,122
2021-01-02,Yuba,115,75493,4202,3930,42,3972,21
2021-01-01,Alameda,001,1643700,57170,53518,1104,54622,579
2021-01-01,Alpine,003,1148,69,68,0,68,0
2021-01-01,Amador,005,37829,2729,2513,20,2533,24
2021-01-01,Butte,007,227075,8408,7589,989,8578,105
2021-01-01,Calaveras,009,45235,1261,1186,3,1189,21
2021-01-01,Colusa,011,21464,1394,1314,100,1414,7
2021-01-01,Contra Costa,013,1133247,44232,41412,660,42072,351
2021-01-01,Del Norte,015,27424,796,758,2,760,2
2021-01-01,El Dorado,017,186661,6788,5832,346,6178,27
2021-01-01,Fresno,019,978130,73557,67484,5158,72642,717
2021-01-01,Glenn,021,27897,1716,1520,303,1823,9
2021-01-01,Humboldt,023,135768,1945,1783,7,1790,21
2021-01-01,Imperial,025,180216,23843,22715,1599,24314,418
2021-01-01,Inyo,027,18085,737,606,8,614,20
2021-01-01,Kern,029,883053,70873,65571,5648,71219,609
2021-01-01,Kings,031,150075,17207,16358,581,16939,108
2021-01-01,Lake,033,64148,2072,1888,0,1888,24
2021-01-01,Lassen,035,31185,4588,4377,53,4430,1
2021-01-01,Los Angeles,037,10098052,846100,775578,24657,800235,10515
2021-01-01,Madera,039,155013,11658,10752,493,11245,66
2021-01-01,Marin,041,260295,10305,9821,93,9914,148
2021-01-01,Mariposa,043,17540,276,236,2,238,3
2021-01-01,Mendocino,045,87422,2600,2400,28,2428,24
2021-01-01,Merced,047,269075,20290,19118,400,19518,229
2021-01-01,Modoc,049,8938,272,241,77,318,0
2021-01-01,Mono,051,14174,914,884,12,896,3
2021-01-01,Monterey,053,433212,30470,28465,778,29243,191
2021-01-01,Napa,055,140530,6434,5899,26,5925,28
2021-01-01,Nevada,057,99092,2935,2663,97,2760,15
2021-01-01,Orange,059,3164182,178807,165440,7068,172508,1893
2021-01-01,Placer,061,380077,15702,13987,652,14639,133
2021-01-01,Plumas,063,18699,498,412,9,421,1
2021-01-01,Riverside,065,2383286,204222,188674,9393,198067,1990
2021-01-01,Sacramento,067,1510023,70370,66956,687,67643,848
2021-01-01,San Benito,069,59416,4010,3773,35,3808,28
2021-01-01,San Bernardino,071,2135413,218544,203651,5961,209612,1590
2021-01-01,San Diego,073,3302833,178567,160071,8077,168148,1592
2021-01-01,San Francisco,075,870044,25268,24145,246,24391,187
2021-01-01,San Joaquin,077,732212,49572,46640,1798,48438,657
2021-01-01,San Luis Obispo,079,281455,12518,11160,277,11437,94
2021-01-01,San Mateo,081,765935,27824,25041,134,25175,194
2021-01-01,Santa Barbara,083,443738,19656,17759,577,18336,164
2021-01-01,Santa Clara,085,1922200,77663,71904,322,72226,680
2021-01-01,Santa Cruz,087,273765,10422,9146,392,9538,84
2021-01-01,Shasta,089,179085,8693,8102,767,8869,72
2021-01-01,Sierra,091,2930,36,26,6,32,0
2021-01-01,Siskiyou,093,43540,1081,944,127,1071,3
2021-01-01,Solano,095,438530,21193,19393,214,19607,97
2021-01-01,Sonoma,097,501317,20650,19513,112,19625,189
2021-01-01,Stanislaus,099,539301,37326,34978,3491,38469,553
2021-01-01,Sutter,101,95872,6817,6553,48,6601,52
2021-01-01,Tehama,103,63373,3322,3079,326,3405,9
2021-01-01,Trinity,105,12862,426,243,61,304,2
2021-01-01,Tulare,107,460477,36600,33994,4128,38122,454
2021-01-01,Tuolumne,109,53932,2965,2909,15,2924,13
2021-01-01,Ventura,111,848112,46344,42026,1780,43806,253
2021-01-01,Yolo,113,214977,9234,8461,70,8531,120
2021-01-01,Yuba,115,75493,4148,3845,41,3886,19
2020-12-31,Alameda,001,1643700,56616,52475,1072,53547,579
2020-12-31,Alpine,003,1148,69,66,0,66,0
2020-12-31,Amador,005,37829,2715,2493,20,2513,24
2020-12-31,Butte,007,227075,8333,7405,972,8377,105
2020-12-31,Calaveras,009,45235,1250,1161,3,1164,21
2020-12-31,Colusa,011,21464,1386,1301,97,1398,7
2020-12-31,Contra Costa,013,1133247,43843,40512,645,41157,336
2020-12-31,Del Norte,015,27424,795,748,2,750,2
2020-12-31,El Dorado,017,186661,6736,5662,337,5999,26
2020-12-31,Fresno,019,978130,73123,66442,5095,71537,711
2020-12-31,Glenn,021,27897,1689,1484,295,1779,9
2020-12-31,Humboldt,023,135768,1928,1713,7,1720,21
2020-12-31,Imperial,025,180216,23772,22494,1583,24077,417
2020-12-31,Inyo,027,18085,729,591,8,599,20
2020-12-31,Kern,029,883053,70401,64904,5556,70460,609
2020-12-31,Kings,031,150075,17132,16077,573,16650,108
2020-12-31,Lake,033,64148,2057,1848,0,1848,23
2020-12-31,Lassen,035,31185,4582,4340,52,4392,1
2020-12-31,Los Angeles,037,10098052,840768,755844,24193,780037,10320
2020-12-31,Madera,039,155013,11585,10609,485,11094,64
2020-12-31,Marin,041,260295,10262,9731,92,9823,148
2020-12-31,Mariposa,043,17540,274,217,2,219,3
2020-12-31,Mendocino,045,87422,2585,2367,24,2391,24
2020-12-31,Merced,047,269075,20200,18808,390,19198,226
2020-12-31,Modoc,049,8938,272,238,77,315,0
2020-12-31,Mono,051,14174,906,868,12,880,3
2020-12-31,Monterey,053,433212,30241,27720,766,28486,188
2020-12-31,Napa,055,140530,6371,5801,26,5827,28
2020-12-31,Nevada,057,99092,2912,2619,95,2714,15
2020-12-31,Orange,059,3164182,176920,161586,6935,168521,1866
2020-12-31,Placer,061,380077,15546,13708,649,14357,126
2020-12-31,Plumas,063,18699,493,401,8,409,1
2020-12-31,Riverside,065,2383286,202549,184193,9260,193453,1958
2020-12-31,Sacramento,067,1510023,69840,65817,677,66494,830
2020-12-31,San Benito,069,59416,3986,3673,35,3708,28
2020-12-31,San Bernardino,071,2135413,216910,199115,5891,205006,1586
2020-12-31,San Diego,073,3302833,176804,155593,7978,163571,1534
2020-12-31,San Francisco,075,870044,25038,23740,239,23979,183
2020-12-31,San Joaquin,077,732212,49253,45764,1759,47523,646
2020-12-31,San Luis Obispo,079,281455,12404,10846,277,11123,89
2020-12-31,San Mateo,081,765935,27494,24570,128,24698,192
2020-12-31,Santa Barbara,083,443738,19412,17434,570,18004,161
2020-12-31,Santa Clara,085,1922200,76857,70032,317,70349,665
2020-12-31,Santa Cruz,087,273765,10304,8909,380,9289,84
2020-12-31,Shasta,089,179085,8627,7996,757,8753,69
2020-12-31,Sierra,091,2930,36,26,6,32,0
2020-12-31,Siskiyou,093,43540,1065,940,124,1064,3
2020-12-31,Solano,095,438530,20962,18942,213,19155,97
2020-12-31,Sonoma,097,501317,20529,19129,111,19240,188
2020-12-31,Stanislaus,099,539301,37018,34398,3443,37841,552
2020-12-31,Sutter,101,95872,6786,6432,48,6480,51
2020-12-31,Tehama,103,63373,3287,3036,325,3361,9
2020-12-31,Trinity,105,12862,425,241,61,302,2
2020-12-31,Tulare,107,460477,36427,33412,4065,37477,446
2020-12-31,Tuolumne,109,53932,2956,2902,15,2917,12
2020-12-31,Ventura,111,848112,45833,40854,1763,42617,251
2020-12-31,Yolo,113,214977,9146,8295,69,8364,117
2020-12-31,Yuba,115,75493,4107,3799,40,3839,18
2020-12-30,Alameda,001,1643700,55850,50158,1021,51179,573
2020-12-30,Alpine,003,1148,69,66,0,66,0
2020-12-30,Amador,005,37829,2695,2418,19,2437,24
2020-12-30,Butte,007,227075,8171,7140,952,8092,103
2020-12-30,Calaveras,009,45235,1225,1135,3,1138,21
2020-12-30,Colusa,011,21464,1370,1289,91,1380,7
2020-12-30,Contra Costa,013,1133247,43259,39601,633,40234,337
2020-12-30,Del Norte,015,27424,790,726,2,728,2
2020-12-30,El Dorado,017,186661,6635,5595,327,5922,27
2020-12-30,Fresno,019,978130,72276,65566,4941,70507,711
2020-12-30,Glenn,021,27897,1658,1471,282,1753,9
2020-12-30,Humboldt,023,135768,1894,1654,7,1661,22
2020-12-30,Imperial,025,180216,23603,22098,1506,23604,412
2020-12-30,Inyo,027,18085,722,572,8,580,20
2020-12-30,Kern,029,883053,69673,63292,5412,68704,604
2020-12-30,Kings,031,150075,17013,15862,565,16427,108
2020-12-30,Lake,033,64148,2034,1731,0,1731,23
2020-12-30,Lassen,035,31185,4573,4300,52,4352,1
2020-12-30,Los Angeles,037,10098052,829866,741907,23500,765407,10046
2020-12-30,Madera,039,155013,11475,10249,474,10723,65
2020-12-30,Marin,041,260295,10172,9569,85,9654,148
2020-12-30,Mariposa,043,17540,270,214,2,216,3
2020-12-30,Mendocino,045,87422,2567,2291,21,2312,24
2020-12-30,Merced,047,269075,19909,18519,380,18899,225
2020-12-30,Modoc,049,8938,269,234,77,311,0
2020-12-30,Mono,051,14174,903,868,12,880,3
2020-12-30,Monterey,053,433212,29611,26977,744,27721,186
2020-12-30,Napa,055,140530,6265,5754,26,5780,28
2020-12-30,Nevada,057,99092,2877,2595,93,2688,15
2020-12-30,Orange,059,3164182,174263,153951,6745,160696,1863
2020-12-30,Placer,061,380077,15315,13540,637,14177,127
2020-12-30,Plumas,063,18699,488,397,8,405,1
2020-12-30,Riverside,065,2383286,199600,176402,9075,185477,1919
2020-12-30,Sacramento,067,1510023,68967,64119,660,64779,847
2020-12-30,San Benito,069,59416,3905,3464,31,3495,29
2020-12-30,San Bernardino,071,2135413,214342,192648,5805,198453,1591
2020-12-30,San Diego,073,3302833,173171,152510,7803,160313,1472
2020-12-30,San Francisco,075,870044,24745,23099,234,23333,182
2020-12-30,San Joaquin,077,732212,48560,44465,1717,46182,634
2020-12-30,San Luis Obispo,079,281455,12136,10542,269,10811,89
2020-12-30,San Mateo,081,765935,27066,24150,124,24274,190
2020-12-30,Santa Barbara,083,443738,19010,16895,548,17443,161
2020-12-30,Santa Clara,085,1922200,75604,67218,313,67531,661
2020-12-30,Santa Cruz,087,273765,10108,8787,371,9158,86
2020-12-30,Shasta,089,179085,8513,7818,743,8561,69
2020-12-30,Sierra,091,2930,36,25,6,31,0
2020-12-30,Siskiyou,093,43540,1058,913,115,1028,3
2020-12-30,Solano,095,438530,20570,18300,210,18510,96
2020-12-30,Sonoma,097,501317,20272,18947,111,19058,191
2020-12-30,Stanislaus,099,539301,36553,33730,3368,37098,526
2020-12-30,Sutter,101,95872,6725,6328,46,6374,51
2020-12-30,Tehama,103,63373,3243,2969,321,3290,9
2020-12-30,Trinity,105,12862,424,231,60,291,2
2020-12-30,Tulare,107,460477,35877,32413,4000,36413,430
2020-12-30,Tuolumne,109,53932,2946,2772,13,2785,12
2020-12-30,Ventura,111,848112,44545,39039,1739,40778,251
2020-12-30,Yolo,113,214977,9038,8067,67,8134,117
2020-12-30,Yuba,115,75493,4036,3612,40,3652,18
2020-12-29,Alameda,001,1643700,54790,50946,986,51932,552
2020-12-29,Alpine,003,1148,69,65,0,65,0
2020-12-29,Amador,005,37829,2643,2388,18,2406,23
2020-12-29,Butte,007,227075,7998,7178,928,8106,98
2020-12-29,Calaveras,009,45235,1180,1111,2,1113,21
2020-12-29,Colusa,011,21464,1349,1272,86,1358,7
2020-12-29,Contra Costa,013,1133247,42460,39225,602,39827,325
2020-12-29,Del Norte,015,27424,783,724,2,726,2
2020-12-29,El Dorado,017,186661,6506,5551,314,5865,22
2020-12-29,Fresno,019,978130,70900,65149,4786,69935,688
2020-12-29,Glenn,021,27897,1624,1454,275,1729,9
2020-12-29,Humboldt,023,135768,1847,1616,7,1623,19
2020-12-29,Imperial,025,180216,23390,22105,1421,23526,407
2020-12-29,Inyo,027,18085,705,571,8,579,19
2020-12-29,Kern,029,883053,68507,63096,5240,68336,589
2020-12-29,Kings,031,150075,16844,15777,553,16330,108
2020-12-29,Lake,033,64148,2003,1805,0,1805,22
2020-12-29,Lassen,035,31185,4558,4288,52,4340,1
2020-12-29,Los Angeles,037,10098052,809682,731907,22633,754540,9786
2020-12-29,Madera,039,155013,11161,10251,459,10710,64
2020-12-29,Marin,041,260295,10020,9595,82,9677,146
2020-12-29,Mariposa,043,17540,262,212,2,214,3
2020-12-29,Mendocino,045,87422,2524,2249,20,2269,24
2020-12-29,Merced,047,269075,19559,18464,364,18828,221
2020-12-29,Modoc,049,8938,266,232,77,309,0
2020-12-29,Mono,051,14174,894,868,12,880,3
2020-12-29,Monterey,053,433212,28961,26894,717,27611,185
2020-12-29,Napa,055,140530,6147,5663,26,5689,28
2020-12-29,Nevada,057,99092,2829,2550,92,2642,15
2020-12-29,Orange,059,3164182,170468,154411,6577,160988,1839
2020-12-29,Placer,061,380077,15101,13392,615,14007,126
2020-12-29,Plumas,063,18699,479,395,8,403,1
2020-12-29,Riverside,065,2383286,194997,177624,8821,186445,1904
2020-12-29,Sacramento,067,1510023,67916,65078,646,65724,820
2020-12-29,San Benito,069,59416,3786,3474,30,3504,25
2020-12-29,San Bernardino,071,2135413,209517,190476,5668,196144,1557
2020-12-29,San Diego,073,3302833,168948,150062,7572,157634,1435
2020-12-29,San Francisco,075,870044,24406,22996,226,23222,178
2020-12-29,San Joaquin,077,732212,47638,44699,1662,46361,622
2020-12-29,San Luis Obispo,079,281455,11840,10387,261,10648,80
2020-12-29,San Mateo,081,765935,26523,23773,112,23885,189
2020-12-29,Santa Barbara,083,443738,18541,16797,522,17319,155
2020-12-29,Santa Clara,085,1922200,74054,67581,310,67891,621
2020-12-29,Santa Cruz,087,273765,9839,8492,362,8854,84
2020-12-29,Shasta,089,179085,8409,7782,728,8510,65
2020-12-29,Sierra,091,2930,34,24,5,29,0
2020-12-29,Siskiyou,093,43540,1043,926,113,1039,3
2020-12-29,Solano,095,438530,20188,18412,205,18617,96
2020-12-29,Sonoma,097,501317,19938,18790,109,18899,187
2020-12-29,Stanislaus,099,539301,36078,33775,3299,37074,508
2020-12-29,Sutter,101,95872,6658,6302,46,6348,50
2020-12-29,Tehama,103,63373,3175,2962,307,3269,9
2020-12-29,Trinity,105,12862,423,241,60,301,2
2020-12-29,Tulare,107,460477,35217,32545,3868,36413,419
2020-12-29,Tuolumne,109,53932,2905,2797,13,2810,12
2020-12-29,Ventura,111,848112,43290,38669,1713,40382,235
2020-12-29,Yolo,113,214977,8909,8124,65,8189,111
2020-12-29,Yuba,115,75493,3954,3723,40,3763,18
2020-12-28,Alameda,001,1643700,53762,50405,966,51371,551
2020-12-28,Alpine,003,1148,68,65,0,65,0
2020-12-28,Amador,005,37829,2573,2255,18,2273,23
2020-12-28,Butte,007,227075,7831,7053,897,7950,86
2020-12-28,Calaveras,009,45235,1157,1102,2,1104,21
2020-12-28,Colusa,011,21464,1324,1255,72,1327,7
2020-12-28,Contra Costa,013,1133247,41521,38872,575,39447,324
2020-12-28,Del Norte,015,27424,773,718,2,720,2
2020-12-28,El Dorado,017,186661,6350,5441,302,5743,18
2020-12-28,Fresno,019,978130,69629,64274,4635,68909,679
2020-12-28,Glenn,021,27897,1590,1435,263,1698,9
2020-12-28,Humboldt,023,135768,1812,1579,7,1586,19
2020-12-28,Imperial,025,180216,23129,22003,1348,23351,405
2020-12-28,Inyo,027,18085,698,569,8,577,19
2020-12-28,Kern,029,883053,67439,62392,5036,67428,579
2020-12-28,Kings,031,150075,16627,15733,536,16269,108
2020-12-28,Lake,033,64148,1962,1785,0,1785,22
2020-12-28,Lassen,035,31185,4451,4284,51,4335,1
2020-12-28,Los Angeles,037,10098052,787338,720699,21819,742518,9544
2020-12-28,Madera,039,155013,10987,10123,436,10559,64
2020-12-28,Marin,041,260295,9912,9546,76,9622,145
2020-12-28,Mariposa,043,17540,238,211,2,213,3
2020-12-28,Mendocino,045,87422,2489,2214,20,2234,23
2020-12-28,Merced,047,269075,19238,18245,345,18590,213
2020-12-28,Modoc,049,8938,261,220,76,296,0
2020-12-28,Mono,051,14174,890,848,12,860,3
2020-12-28,Monterey,053,433212,28111,26529,706,27235,182
2020-12-28,Napa,055,140530,6038,5576,26,5602,26
2020-12-28,Nevada,057,99092,2781,2532,88,2620,15
2020-12-28,Orange,059,3164182,166364,152089,6399,158488,1839
2020-12-28,Placer,061,380077,14762,13234,588,13822,126
2020-12-28,Plumas,063,18699,475,391,8,399,0
2020-12-28,Riverside,065,2383286,190097,174029,8531,182560,1855
2020-12-28,Sacramento,067,1510023,66680,64322,622,64944,813
2020-12-28,San Benito,069,59416,3717,3429,29,3458,24
2020-12-28,San Bernardino,071,2135413,204424,188919,5551,194470,1552
2020-12-28,San Diego,073,3302833,164204,147528,7390,154918,1404
2020-12-28,San Francisco,075,870044,24046,22726,221,22947,178
2020-12-28,San Joaquin,077,732212,46705,44172,1630,45802,618
2020-12-28,San Luis Obispo,079,281455,11488,10260,257,10517,76
2020-12-28,San Mateo,081,765935,26048,23467,108,23575,189
2020-12-28,Santa Barbara,083,443738,18073,16579,510,17089,155
2020-12-28,Santa Clara,085,1922200,72567,66418,303,66721,619
2020-12-28,Santa Cruz,087,273765,9571,8310,352,8662,81
2020-12-28,Shasta,089,179085,8292,7688,715,8403,65
2020-12-28,Sierra,091,2930,32,24,4,28,0
2020-12-28,Siskiyou,093,43540,1027,915,108,1023,3
2020-12-28,Solano,095,438530,19616,18171,199,18370,96
2020-12-28,Sonoma,097,501317,19591,18667,107,18774,185
2020-12-28,Stanislaus,099,539301,35528,33473,3236,36709,507
2020-12-28,Sutter,101,95872,6578,6253,46,6299,49
2020-12-28,Tehama,103,63373,3123,2934,300,3234,9
2020-12-28,Trinity,105,12862,421,240,60,300,2
2020-12-28,Tulare,107,460477,34532,32010,3761,35771,404
2020-12-28,Tuolumne,109,53932,2888,2777,13,2790,12
2020-12-28,Ventura,111,848112,41621,37151,1666,38817,230
2020-12-28,Yolo,113,214977,8754,8031,64,8095,111
2020-12-28,Yuba,115,75493,3893,3679,39,3718,18
2020-12-27,Alameda,001,1643700,52526,49764,939,50703,551
2020-12-27,Alpine,003,1148,66,65,0,65,0
2020-12-27,Amador,005,37829,2452,2218,18,2236,23
2020-12-27,Butte,007,227075,7676,7016,858,7874,86
2020-12-27,Calaveras,009,45235,1110,1097,2,1099,21
2020-12-27,Colusa,011,21464,1299,1253,69,1322,7
2020-12-27,Contra Costa,013,1133247,40586,38428,546,38974,324
2020-12-27,Del Norte,015,27424,750,712,2,714,2
2020-12-27,El Dorado,017,186661,6136,5388,279,5667,18
2020-12-27,Fresno,019,978130,68381,63811,4429,68240,679
2020-12-27,Glenn,021,27897,1562,1434,249,1683,9
2020-12-27,Humboldt,023,135768,1768,1575,7,1582,17
2020-12-27,Imperial,025,180216,22831,21934,1235,23169,405
2020-12-27,Inyo,027,18085,676,565,7,572,18
2020-12-27,Kern,029,883053,66158,61914,4863,66777,568
2020-12-27,Kings,031,150075,16391,15593,502,16095,108
2020-12-27,Lake,033,64148,1906,1769,0,1769,22
2020-12-27,Lassen,035,31185,4374,4230,44,4274,1
2020-12-27,Los Angeles,037,10098052,765843,707260,20926,728186,9476
2020-12-27,Madera,039,155013,10729,10005,426,10431,64
2020-12-27,Marin,041,260295,9789,9477,71,9548,144
2020-12-27,Mariposa,043,17540,231,208,2,210,3
2020-12-27,Mendocino,045,87422,2442,2209,20,2229,23
2020-12-27,Merced,047,269075,18870,18075,329,18404,213
2020-12-27,Modoc,049,8938,252,221,72,293,0
2020-12-27,Mono,051,14174,877,849,12,861,3
2020-12-27,Monterey,053,433212,27552,26322,689,27011,181
2020-12-27,Napa,055,140530,5904,5496,26,5522,26
2020-12-27,Nevada,057,99092,2745,2519,88,2607,15
2020-12-27,Orange,059,3164182,161967,149276,6211,155487,1839
2020-12-27,Placer,061,380077,14466,13017,556,13573,126
2020-12-27,Plumas,063,18699,469,390,8,398,0
2020-12-27,Riverside,065,2383286,185181,171995,8225,180220,1836
2020-12-27,Sacramento,067,1510023,65472,63416,600,64016,811
2020-12-27,San Benito,069,59416,3631,3394,29,3423,24
2020-12-27,San Bernardino,071,2135413,199347,186776,5414,192190,1551
2020-12-27,San Diego,073,3302833,159797,145777,7203,152980,1402
2020-12-27,San Francisco,075,870044,23699,22514,212,22726,178
2020-12-27,San Joaquin,077,732212,45667,43529,1580,45109,618
2020-12-27,San Luis Obispo,079,281455,11080,10154,252,10406,76
2020-12-27,San Mateo,081,765935,25483,23136,104,23240,187
2020-12-27,Santa Barbara,083,443738,17545,16364,483,16847,155
2020-12-27,Santa Clara,085,1922200,70946,65288,298,65586,619
2020-12-27,Santa Cruz,087,273765,9305,8234,343,8577,81
2020-12-27,Shasta,089,179085,8165,7671,693,8364,65
2020-12-27,Sierra,091,2930,32,24,3,27,0
2020-12-27,Siskiyou,093,43540,1017,914,103,1017,3
2020-12-27,Solano,095,438530,19121,17840,193,18033,96
2020-12-27,Sonoma,097,501317,19299,18487,106,18593,185
2020-12-27,Stanislaus,099,539301,34908,33076,3140,36216,506
2020-12-27,Sutter,101,95872,6497,6218,44,6262,48
2020-12-27,Tehama,103,63373,3054,2922,284,3206,9
2020-12-27,Trinity,105,12862,414,240,58,298,2
2020-12-27,Tulare,107,460477,33936,31864,3642,35506,400
2020-12-27,Tuolumne,109,53932,2783,2750,11,2761,12
2020-12-27,Ventura,111,848112,40558,36661,1613,38274,230
2020-12-27,Yolo,113,214977,8563,7919,60,7979,111
2020-12-27,Yuba,115,75493,3829,3665,37,3702,18
2020-12-26,Alameda,001,1643700,51915,49084,926,50010,551
2020-12-26,Alpine,003,1148,66,65,0,65,0
2020-12-26,Amador,005,37829,2438,2189,18,2207,23
2020-12-26,Butte,007,227075,7581,6968,834,7802,86
2020-12-26,Calaveras,009,45235,1104,1084,2,1086,21
2020-12-26,Colusa,011,21464,1289,1240,69,1309,7
2020-12-26,Contra Costa,013,1133247,40122,38008,532,38540,324
2020-12-26,Del Norte,015,27424,744,709,2,711,2
2020-12-26,El Dorado,017,186661,6081,5279,275,5554,18
2020-12-26,Fresno,019,978130,67911,63080,4365,67445,679
2020-12-26,Glenn,021,27897,1541,1413,243,1656,9
2020-12-26,Humboldt,023,135768,1730,1545,7,1552,17
2020-12-26,Imperial,025,180216,22739,21734,1183,22917,405
2020-12-26,Inyo,027,18085,663,554,7,561,18
2020-12-26,Kern,029,883053,65486,61174,4714,65888,564
2020-12-26,Kings,031,150075,16273,15517,498,16015,108
2020-12-26,Lake,033,64148,1864,1710,0,1710,22
2020-12-26,Lassen,035,31185,4353,3981,44,4025,1
2020-12-26,Los Angeles,037,10098052,757290,694149,20418,714567,9424
2020-12-26,Madera,039,155013,10652,9908,414,10322,64
2020-12-26,Marin,041,260295,9754,9413,70,9483,143
2020-12-26,Mariposa,043,17540,230,206,2,208,3
2020-12-26,Mendocino,045,87422,2396,2194,20,2214,23
2020-12-26,Merced,047,269075,18711,17890,324,18214,213
2020-12-26,Modoc,049,8938,249,222,72,294,0
2020-12-26,Mono,051,14174,871,850,12,862,3
2020-12-26,Monterey,053,433212,27415,26010,680,26690,182
2020-12-26,Napa,055,140530,5846,5427,26,5453,26
2020-12-26,Nevada,057,99092,2717,2480,88,2568,15
2020-12-26,Orange,059,3164182,159762,147304,6118,153422,1838
2020-12-26,Placer,061,380077,14296,12816,541,13357,122
2020-12-26,Plumas,063,18699,466,381,8,389,0
2020-12-26,Riverside,065,2383286,182696,169360,8064,177424,1834
2020-12-26,Sacramento,067,1510023,64849,62435,590,63025,807
2020-12-26,San Benito,069,59416,3558,3330,29,3359,24
2020-12-26,San Bernardino,071,2135413,197680,185111,5332,190443,1551
2020-12-26,San Diego,073,3302833,157272,142644,7056,149700,1402
2020-12-26,San Francisco,075,870044,23463,22319,212,22531,177
2020-12-26,San Joaquin,077,732212,45282,42887,1531,44418,618
2020-12-26,San Luis Obispo,079,281455,10993,9945,247,10192,76
2020-12-26,San Mateo,081,765935,25144,22908,99,23007,187
2020-12-26,Santa Barbara,083,443738,17306,16159,477,16636,155
2020-12-26,Santa Clara,085,1922200,69876,64185,296,64481,618
2020-12-26,Santa Cruz,087,273765,9179,8113,334,8447,81
2020-12-26,Shasta,089,179085,8106,7641,680,8321,65
2020-12-26,Sierra,091,2930,32,24,3,27,0
2020-12-26,Siskiyou,093,43540,1010,909,99,1008,2
2020-12-26,Solano,095,438530,18876,17528,193,17721,96
2020-12-26,Sonoma,097,501317,19096,18261,104,18365,184
2020-12-26,Stanislaus,099,539301,34610,32678,3088,35766,505
2020-12-26,Sutter,101,95872,6438,6121,44,6165,48
2020-12-26,Tehama,103,63373,3025,2884,279,3163,9
2020-12-26,Trinity,105,12862,412,237,57,294,2
2020-12-26,Tulare,107,460477,33634,31665,3587,35252,398
2020-12-26,Tuolumne,109,53932,2772,2703,11,2714,12
2020-12-26,Ventura,111,848112,39593,36064,1582,37646,230
2020-12-26,Yolo,113,214977,8461,7785,58,7843,111
2020-12-26,Yuba,115,75493,3801,3599,37,3636,18
2020-12-25,Alameda,001,1643700,51345,48365,911,49276,542
2020-12-25,Alpine,003,1148,66,64,0,64,0
2020-12-25,Amador,005,37829,2395,2172,18,2190,23
2020-12-25,Butte,007,227075,7482,6873,815,7688,85
2020-12-25,Calaveras,009,45235,1101,1062,2,1064,21
2020-12-25,Colusa,011,21464,1277,1219,68,1287,7
2020-12-25,Contra Costa,013,1133247,39650,37480,506,37986,324
2020-12-25,Del Norte,015,27424,741,692,2,694,2
2020-12-25,El Dorado,017,186661,6016,5170,262,5432,16
2020-12-25,Fresno,019,978130,67047,62251,4283,66534,679
2020-12-25,Glenn,021,27897,1525,1390,236,1626,9
2020-12-25,Humboldt,023,135768,1690,1532,7,1539,16
2020-12-25,Imperial,025,180216,22644,21646,1172,22818,405
2020-12-25,Inyo,027,18085,654,546,7,553,18
2020-12-25,Kern,029,883053,64757,60417,4567,64984,562
2020-12-25,Kings,031,150075,16162,15460,494,15954,108
2020-12-25,Lake,033,64148,1844,1669,0,1669,20
2020-12-25,Lassen,035,31185,4338,3926,44,3970,1
2020-12-25,Los Angeles,037,10098052,743645,665600,19739,685339,9292
2020-12-25,Madera,039,155013,10484,9770,407,10177,64
2020-12-25,Marin,041,260295,9705,9375,67,9442,143
2020-12-25,Mariposa,043,17540,224,203,2,205,3
2020-12-25,Mendocino,045,87422,2353,2176,20,2196,23
2020-12-25,Merced,047,269075,18550,17726,316,18042,213
2020-12-25,Modoc,049,8938,248,221,72,293,0
2020-12-25,Mono,051,14174,869,843,12,855,3
2020-12-25,Monterey,053,433212,27139,25788,671,26459,182
2020-12-25,Napa,055,140530,5769,5351,26,5377,26
2020-12-25,Nevada,057,99092,2691,2458,86,2544,15
2020-12-25,Orange,059,3164182,157083,144542,5926,150468,1814
2020-12-25,Placer,061,380077,14110,12660,519,13179,122
2020-12-25,Plumas,063,18699,459,381,8,389,0
2020-12-25,Riverside,065,2383286,179410,166690,7748,174438,1825
2020-12-25,Sacramento,067,1510023,64155,61630,564,62194,796
2020-12-25,San Benito,069,59416,3518,3281,27,3308,24
2020-12-25,San Bernardino,071,2135413,195049,181812,5216,187028,1546
2020-12-25,San Diego,073,3302833,154792,139958,6878,146836,1402
2020-12-25,San Francisco,075,870044,23187,22130,207,22337,175
2020-12-25,San Joaquin,077,732212,44975,42089,1476,43565,614
2020-12-25,San Luis Obispo,079,281455,10810,9749,240,9989,76
2020-12-25,San Mateo,081,765935,24822,22568,97,22665,187
2020-12-25,Santa Barbara,083,443738,17082,15936,470,16406,155
2020-12-25,Santa Clara,085,1922200,68761,63173,287,63460,612
2020-12-25,Santa Cruz,087,273765,9035,8018,312,8330,81
2020-12-25,Shasta,089,179085,8032,7612,657,8269,65
2020-12-25,Sierra,091,2930,32,24,3,27,0
2020-12-25,Siskiyou,093,43540,1004,905,96,1001,2
2020-12-25,Solano,095,438530,18704,17280,191,17471,96
2020-12-25,Sonoma,097,501317,18921,18035,102,18137,184
2020-12-25,Stanislaus,099,539301,34308,32290,3037,35327,498
2020-12-25,Sutter,101,95872,6379,6051,43,6094,47
2020-12-25,Tehama,103,63373,2976,2839,266,3105,9
2020-12-25,Trinity,105,12862,408,236,57,293,2
2020-12-25,Tulare,107,460477,33244,31323,3522,34845,398
2020-12-25,Tuolumne,109,53932,2753,2674,11,2685,12
2020-12-25,Ventura,111,848112,38437,35514,1534,37048,230
2020-12-25,Yolo,113,214977,8365,7700,56,7756,111
2020-12-25,Yuba,115,75493,3765,3549,36,3585,17
2020-12-24,Alameda,001,1643700,50996,47527,892,48419,541
2020-12-24,Alpine,003,1148,66,64,0,64,0
2020-12-24,Amador,005,37829,2383,2145,18,2163,23
2020-12-24,Butte,007,227075,7443,6716,800,7516,84
2020-12-24,Calaveras,009,45235,1098,1032,2,1034,21
2020-12-24,Colusa,011,21464,1272,1188,67,1255,7
2020-12-24,Contra Costa,013,1133247,39406,36623,495,37118,311
2020-12-24,Del Norte,015,27424,741,678,2,680,2
2020-12-24,El Dorado,017,186661,5990,5042,254,5296,16
2020-12-24,Fresno,019,978130,66824,61435,4269,65704,663
2020-12-24,Glenn,021,27897,1514,1363,228,1591,9
2020-12-24,Humboldt,023,135768,1667,1516,7,1523,16
2020-12-24,Imperial,025,180216,22594,21545,1163,22708,402
2020-12-24,Inyo,027,18085,652,532,7,539,17
2020-12-24,Kern,029,883053,64470,59601,4554,64155,556
2020-12-24,Kings,031,150075,16122,15211,493,15704,108
2020-12-24,Lake,033,64148,1829,1629,0,1629,20
2020-12-24,Lassen,035,31185,4325,3894,44,3938,1
2020-12-24,Los Angeles,037,10098052,739475,664840,19481,684321,9288
2020-12-24,Madera,039,155013,10444,9547,400,9947,63
2020-12-24,Marin,041,260295,9671,9287,67,9354,143
2020-12-24,Mariposa,043,17540,220,197,2,199,3
2020-12-24,Mendocino,045,87422,2342,2150,20,2170,23
2020-12-24,Merced,047,269075,18479,17485,312,17797,212
2020-12-24,Modoc,049,8938,248,220,71,291,0
2020-12-24,Mono,051,14174,867,817,12,829,3
2020-12-24,Monterey,053,433212,27027,25131,664,25795,180
2020-12-24,Napa,055,140530,5714,5265,26,5291,26
2020-12-24,Nevada,057,99092,2667,2429,86,2515,15
2020-12-24,Orange,059,3164182,155602,141205,5875,147080,1775
2020-12-24,Placer,061,380077,14021,12457,512,12969,121
2020-12-24,Plumas,063,18699,456,376,8,384,0
2020-12-24,Riverside,065,2383286,178476,162435,7708,170143,1816
2020-12-24,Sacramento,067,1510023,63880,60596,562,61158,788
2020-12-24,San Benito,069,59416,3487,3183,27,3210,24
2020-12-24,San Bernardino,071,2135413,194009,176866,5182,182048,1533
2020-12-24,San Diego,073,3302833,153708,136952,6846,143798,1382
2020-12-24,San Francisco,075,870044,23019,21830,204,22034,175
2020-12-24,San Joaquin,077,732212,44811,41324,1458,42782,611
2020-12-24,San Luis Obispo,079,281455,10741,9504,238,9742,77
2020-12-24,San Mateo,081,765935,24626,22093,97,22190,186
2020-12-24,Santa Barbara,083,443738,16977,15644,462,16106,153
2020-12-24,Santa Clara,085,1922200,68155,61742,280,62022,591
2020-12-24,Santa Cruz,087,273765,8964,7856,300,8156,82
2020-12-24,Shasta,089,179085,7991,7540,640,8180,65
2020-12-24,Sierra,091,2930,29,23,1,24,0
2020-12-24,Siskiyou,093,43540,999,900,90,990,2
2020-12-24,Solano,095,438530,18563,16872,186,17058,96
2020-12-24,Sonoma,097,501317,18821,17710,102,17812,183
2020-12-24,Stanislaus,099,539301,34104,31848,3011,34859,498
2020-12-24,Sutter,101,95872,6338,5960,42,6002,47
2020-12-24,Tehama,103,63373,2958,2779,264,3043,9
2020-12-24,Trinity,105,12862,407,235,57,292,2
2020-12-24,Tulare,107,460477,33125,30827,3496,34323,390
2020-12-24,Tuolumne,109,53932,2745,2653,11,2664,12
2020-12-24,Ventura,111,848112,38157,34400,1527,35927,224
2020-12-24,Yolo,113,214977,8323,7566,56,7622,113
2020-12-24,Yuba,115,75493,3740,3483,36,3519,16
2020-12-23,Alameda,001,1643700,50421,46753,866,47619,537
2020-12-23,Alpine,003,1148,66,64,0,64,0
2020-12-23,Amador,005,37829,2314,2108,17,2125,23
2020-12-23,Butte,007,227075,7354,6588,774,7362,84
2020-12-23,Calaveras,009,45235,1090,1002,1,1003,21
2020-12-23,Colusa,011,21464,1261,1167,67,1234,7
2020-12-23,Contra Costa,013,1133247,39007,36190,482,36672,311
2020-12-23,Del Norte,015,27424,734,670,2,672,2
2020-12-23,El Dorado,017,186661,5915,4967,246,5213,14
2020-12-23,Fresno,019,978130,66215,60488,4204,64692,654
2020-12-23,Glenn,021,27897,1500,1349,224,1573,9
2020-12-23,Humboldt,023,135768,1642,1458,7,1465,16
2020-12-23,Imperial,025,180216,22499,21323,1134,22457,399
2020-12-23,Inyo,027,18085,640,517,7,524,17
2020-12-23,Kern,029,883053,63953,58656,4460,63116,549
2020-12-23,Kings,031,150075,16044,14923,490,15413,105
2020-12-23,Lake,033,64148,1815,1595,0,1595,20
2020-12-23,Lassen,035,31185,4315,3865,41,3906,1
2020-12-23,Los Angeles,037,10098052,730417,651958,18948,670906,9146
2020-12-23,Madera,039,155013,10285,9371,386,9757,63
2020-12-23,Marin,041,260295,9613,9199,64,9263,142
2020-12-23,Mariposa,043,17540,218,194,2,196,3
2020-12-23,Mendocino,045,87422,2330,2121,20,2141,23
2020-12-23,Merced,047,269075,18323,17250,304,17554,203
2020-12-23,Modoc,049,8938,244,197,70,267,0
2020-12-23,Mono,051,14174,864,814,12,826,3
2020-12-23,Monterey,053,433212,26727,24856,657,25513,176
2020-12-23,Napa,055,140530,5646,5172,26,5198,25
2020-12-23,Nevada,057,99092,2622,2406,85,2491,15
2020-12-23,Orange,059,3164182,153151,138050,5708,143758,1771
2020-12-23,Placer,061,380077,13811,12213,504,12717,111
2020-12-23,Plumas,063,18699,449,369,8,377,0
2020-12-23,Riverside,065,2383286,176204,158110,7550,165660,1790
2020-12-23,Sacramento,067,1510023,63230,59661,548,60209,779
2020-12-23,San Benito,069,59416,3433,3073,25,3098,24
2020-12-23,San Bernardino,071,2135413,191966,172888,5113,178001,1509
2020-12-23,San Diego,073,3302833,151282,134695,6709,141404,1350
2020-12-23,San Francisco,075,870044,22797,21498,201,21699,174
2020-12-23,San Joaquin,077,732212,44286,35664,1416,37080,602
2020-12-23,San Luis Obispo,079,281455,10599,9267,233,9500,74
2020-12-23,San Mateo,081,765935,24324,21780,95,21875,186
2020-12-23,Santa Barbara,083,443738,16769,15399,436,15835,152
2020-12-23,Santa Clara,085,1922200,67244,60455,275,60730,579
2020-12-23,Santa Cruz,087,273765,8804,7637,282,7919,75
2020-12-23,Shasta,089,179085,7919,7487,634,8121,66
2020-12-23,Sierra,091,2930,27,23,1,24,0
2020-12-23,Siskiyou,093,43540,978,891,89,980,2
2020-12-23,Solano,095,438530,18355,16626,182,16808,95
2020-12-23,Sonoma,097,501317,18617,17397,102,17499,182
2020-12-23,Stanislaus,099,539301,33751,31492,2958,34450,499
2020-12-23,Sutter,101,95872,6272,5871,42,5913,46
2020-12-23,Tehama,103,63373,2940,2737,257,2994,9
2020-12-23,Trinity,105,12862,407,234,56,290,2
2020-12-23,Tulare,107,460477,32833,30315,3457,33772,385
2020-12-23,Tuolumne,109,53932,2706,2540,11,2551,12
2020-12-23,Ventura,111,848112,37760,33377,1498,34875,216
2020-12-23,Yolo,113,214977,8245,7508,55,7563,112
2020-12-23,Yuba,115,75493,3687,3438,36,3474,14
2020-12-22,Alameda,001,1643700,49537,45751,836,46587,534
2020-12-22,Alpine,003,1148,66,64,0,64,0
2020-12-22,Amador,005,37829,2303,1839,17,1856,23
2020-12-22,Butte,007,227075,7226,6467,759,7226,85
2020-12-22,Calaveras,009,45235,1063,988,0,988,21
2020-12-22,Colusa,011,21464,1238,1150,63,1213,7
2020-12-22,Contra Costa,013,1133247,38380,35681,470,36151,301
2020-12-22,Del Norte,015,27424,727,666,2,668,2
2020-12-22,El Dorado,017,186661,5792,4885,234,5119,12
2020-12-22,Fresno,019,978130,65181,59640,4098,63738,640
2020-12-22,Glenn,021,27897,1477,1337,213,1550,9
2020-12-22,Humboldt,023,135768,1609,1440,7,1447,16
2020-12-22,Imperial,025,180216,22310,21128,1090,22218,398
2020-12-22,Inyo,027,18085,620,506,7,513,17
2020-12-22,Kern,029,883053,63001,57816,4323,62139,547
2020-12-22,Kings,031,150075,15902,14855,484,15339,102
2020-12-22,Lake,033,64148,1791,1569,0,1569,20
2020-12-22,Lassen,035,31185,4173,3848,39,3887,1
2020-12-22,Los Angeles,037,10098052,713166,635931,18261,654192,9013
2020-12-22,Madera,039,155013,10167,9187,370,9557,63
2020-12-22,Marin,041,260295,9549,9115,63,9178,142
2020-12-22,Mariposa,043,17540,215,194,2,196,3
2020-12-22,Mendocino,045,87422,2297,2092,20,2112,23
2020-12-22,Merced,047,269075,18077,17012,299,17311,201
2020-12-22,Modoc,049,8938,236,182,69,251,0
2020-12-22,Mono,051,14174,858,786,12,798,3
2020-12-22,Monterey,053,433212,26057,24152,636,24788,176
2020-12-22,Napa,055,140530,5557,5059,26,5085,23
2020-12-22,Nevada,057,99092,2594,2367,84,2451,14
2020-12-22,Orange,059,3164182,149809,134850,5536,140386,1774
2020-12-22,Placer,061,380077,13567,11943,484,12427,105
2020-12-22,Plumas,063,18699,443,360,8,368,0
2020-12-22,Riverside,065,2383286,172392,155059,7281,162340,1777
2020-12-22,Sacramento,067,1510023,62302,57966,529,58495,772
2020-12-22,San Benito,069,59416,3355,2998,25,3023,24
2020-12-22,San Bernardino,071,2135413,187384,169266,4965,174231,1500
2020-12-22,San Diego,073,3302833,147923,132097,6547,138644,1311
2020-12-22,San Francisco,075,870044,22527,21232,197,21429,174
2020-12-22,San Joaquin,077,732212,43527,39423,1367,40790,592
2020-12-22,San Luis Obispo,079,281455,10254,9174,228,9402,69
2020-12-22,San Mateo,081,765935,23998,21382,79,21461,186
2020-12-22,Santa Barbara,083,443738,16504,15189,426,15615,150
2020-12-22,Santa Clara,085,1922200,66077,59192,267,59459,569
2020-12-22,Santa Cruz,087,273765,8625,7471,256,7727,72
2020-12-22,Shasta,089,179085,7840,7371,617,7988,64
2020-12-22,Sierra,091,2930,27,23,0,23,0
2020-12-22,Siskiyou,093,43540,972,880,88,968,2
2020-12-22,Solano,095,438530,17952,16229,179,16408,95
2020-12-22,Sonoma,097,501317,18297,17216,102,17318,180
2020-12-22,Stanislaus,099,539301,33367,30914,2886,33800,499
2020-12-22,Sutter,101,95872,6213,5791,41,5832,46
2020-12-22,Tehama,103,63373,2890,2688,252,2940,9
2020-12-22,Trinity,105,12862,406,231,56,287,2
2020-12-22,Tulare,107,460477,32368,30025,3390,33415,377
2020-12-22,Tuolumne,109,53932,2655,2526,11,2537,12
2020-12-22,Ventura,111,848112,36995,32488,1455,33943,213
2020-12-22,Yolo,113,214977,8132,7388,54,7442,113
2020-12-22,Yuba,115,75493,3636,3379,36,3415,14
2020-12-21,Alameda,001,1643700,48636,44756,809,45565,518
2020-12-21,Alpine,003,1148,65,64,0,64,0
2020-12-21,Amador,005,37829,2226,1815,17,1832,23
2020-12-21,Butte,007,227075,7071,6335,735,7070,81
2020-12-21,Calaveras,009,45235,1033,963,0,963,21
2020-12-21,Colusa,011,21464,1211,1135,58,1193,7
2020-12-21,Contra Costa,013,1133247,37628,35207,433,35640,300
2020-12-21,Del Norte,015,27424,712,660,2,662,2
2020-12-21,El Dorado,017,186661,5645,4805,221,5026,10
2020-12-21,Fresno,019,978130,64029,58568,3955,62523,634
2020-12-21,Glenn,021,27897,1445,1323,205,1528,9
2020-12-21,Humboldt,023,135768,1586,1419,7,1426,16
2020-12-21,Imperial,025,180216,22040,20994,1047,22041,395
2020-12-21,Inyo,027,18085,599,482,7,489,17
2020-12-21,Kern,029,883053,62111,56836,4186,61022,541
2020-12-21,Kings,031,150075,15652,14760,469,15229,100
2020-12-21,Lake,033,64148,1737,1538,0,1538,20
2020-12-21,Lassen,035,31185,4013,3798,37,3835,1
2020-12-21,Los Angeles,037,10098052,694085,624129,17582,641711,8918
2020-12-21,Madera,039,155013,9973,9069,350,9419,63
2020-12-21,Marin,041,260295,9480,9035,63,9098,142
2020-12-21,Mariposa,043,17540,210,186,2,188,3
2020-12-21,Mendocino,045,87422,2266,2066,20,2086,23
2020-12-21,Merced,047,269075,17827,16710,283,16993,198
2020-12-21,Modoc,049,8938,222,181,68,249,0
2020-12-21,Mono,051,14174,846,781,12,793,3
2020-12-21,Monterey,053,433212,25525,23673,622,24295,174
2020-12-21,Napa,055,140530,5470,4952,26,4978,23
2020-12-21,Nevada,057,99092,2561,2337,84,2421,13
2020-12-21,Orange,059,3164182,146397,130444,5382,135826,1772
2020-12-21,Placer,061,380077,13335,11715,465,12180,105
2020-12-21,Plumas,063,18699,439,353,8,361,0
2020-12-21,Riverside,065,2383286,168166,151713,6956,158669,1743
2020-12-21,Sacramento,067,1510023,61281,57064,512,57576,759
2020-12-21,San Benito,069,59416,3287,2921,25,2946,22
2020-12-21,San Bernardino,071,2135413,182594,165086,4800,169886,1476
2020-12-21,San Diego,073,3302833,144472,129716,6383,136099,1284
2020-12-21,San Francisco,075,870044,22241,21086,195,21281,174
2020-12-21,San Joaquin,077,732212,42731,38811,1316,40127,586
2020-12-21,San Luis Obispo,079,281455,10065,9006,223,9229,64
2020-12-21,San Mateo,081,765935,23593,21035,76,21111,185
2020-12-21,Santa Barbara,083,443738,16230,14988,421,15409,149
2020-12-21,Santa Clara,085,1922200,64884,57699,255,57954,570
2020-12-21,Santa Cruz,087,273765,8413,7315,243,7558,69
2020-12-21,Shasta,089,179085,7775,7299,607,7906,64
2020-12-21,Sierra,091,2930,24,23,0,23,0
2020-12-21,Siskiyou,093,43540,964,878,87,965,2
2020-12-21,Solano,095,438530,17482,15878,174,16052,95
2020-12-21,Sonoma,097,501317,18024,17075,98,17173,176
2020-12-21,Stanislaus,099,539301,32909,30437,2811,33248,499
2020-12-21,Sutter,101,95872,6118,5708,41,5749,46
2020-12-21,Tehama,103,63373,2825,2656,243,2899,9
2020-12-21,Trinity,105,12862,404,226,54,280,2
2020-12-21,Tulare,107,460477,31869,29482,3301,32783,373
2020-12-21,Tuolumne,109,53932,2630,2423,9,2432,12
2020-12-21,Ventura,111,848112,35915,31759,1418,33177,212
2020-12-21,Yolo,113,214977,7987,7266,50,7316,109
2020-12-21,Yuba,115,75493,3577,3329,36,3365,14
2020-12-20,Alameda,001,1643700,47757,44004,786,44790,516
2020-12-20,Alpine,003,1148,65,64,0,64,0
2020-12-20,Amador,005,37829,2168,1771,17,1788,23
2020-12-20,Butte,007,227075,6926,6228,699,6927,81
2020-12-20,Calaveras,009,45235,1009,926,0,926,21
2020-12-20,Colusa,011,21464,1183,1121,52,1173,7
2020-12-20,Contra Costa,013,1133247,37042,34798,416,35214,301
2020-12-20,Del Norte,015,27424,690,652,2,654,2
2020-12-20,El Dorado,017,186661,5520,4697,212,4909,10
2020-12-20,Fresno,019,978130,63038,57616,3818,61434,634
2020-12-20,Glenn,021,27897,1436,1295,198,1493,9
2020-12-20,Humboldt,023,135768,1549,1386,6,1392,15
2020-12-20,Imperial,025,180216,21799,20882,941,21823,395
2020-12-20,Inyo,027,18085,584,476,7,483,17
2020-12-20,Kern,029,883053,61013,55983,4031,60014,540
2020-12-20,Kings,031,150075,15432,14629,452,15081,100
2020-12-20,Lake,033,64148,1691,1463,0,1463,20
2020-12-20,Lassen,035,31185,3959,3669,35,3704,1
2020-12-20,Los Angeles,037,10098052,676003,612975,16840,629815,8862
2020-12-20,Madera,039,155013,9763,8871,341,9212,63
2020-12-20,Marin,041,260295,9382,8948,60,9008,142
2020-12-20,Mariposa,043,17540,209,179,2,181,3
2020-12-20,Mendocino,045,87422,2241,2033,20,2053,23
2020-12-20,Merced,047,269075,17511,16435,276,16711,198
2020-12-20,Modoc,049,8938,222,181,66,247,0
2020-12-20,Mono,051,14174,828,774,12,786,3
2020-12-20,Monterey,053,433212,25042,23250,581,23831,173
2020-12-20,Napa,055,140530,5349,4865,24,4889,23
2020-12-20,Nevada,057,99092,2515,2289,78,2367,13
2020-12-20,Orange,059,3164182,142893,128780,5233,134013,1763
2020-12-20,Placer,061,380077,13110,11496,446,11942,105
2020-12-20,Plumas,063,18699,431,347,8,355,0
2020-12-20,Riverside,065,2383286,163961,148714,6664,155378,1742
2020-12-20,Sacramento,067,1510023,60280,56017,492,56509,755
2020-12-20,San Benito,069,59416,3215,2885,24,2909,21
2020-12-20,San Bernardino,071,2135413,177607,162810,4642,167452,1458
2020-12-20,San Diego,073,3302833,140754,126465,6213,132678,1280
2020-12-20,San Francisco,075,870044,21926,20937,192,21129,174
2020-12-20,San Joaquin,077,732212,41889,38268,1255,39523,587
2020-12-20,San Luis Obispo,079,281455,9773,8881,217,9098,63
2020-12-20,San Mateo,081,765935,23159,20764,72,20836,185
2020-12-20,Santa Barbara,083,443738,15908,14817,401,15218,148
2020-12-20,Santa Clara,085,1922200,63474,56860,249,57109,566
2020-12-20,Santa Cruz,087,273765,8205,7178,230,7408,69
2020-12-20,Shasta,089,179085,7661,7256,593,7849,64
2020-12-20,Sierra,091,2930,24,22,0,22,0
2020-12-20,Siskiyou,093,43540,954,870,86,956,2
2020-12-20,Solano,095,438530,17104,15533,163,15696,95
2020-12-20,Sonoma,097,501317,17748,16802,97,16899,175
2020-12-20,Stanislaus,099,539301,32382,29995,2709,32704,498
2020-12-20,Sutter,101,95872,6031,5601,41,5642,43
2020-12-20,Tehama,103,63373,2775,2602,224,2826,9
2020-12-20,Trinity,105,12862,396,221,53,274,2
2020-12-20,Tulare,107,460477,31352,29078,3205,32283,373
2020-12-20,Tuolumne,109,53932,2520,2152,8,2160,12
2020-12-20,Ventura,111,848112,35213,31335,1385,32720,210
2020-12-20,Yolo,113,214977,7835,7121,47,7168,109
2020-12-20,Yuba,115,75493,3530,3254,34,3288,12
2020-12-19,Alameda,001,1643700,47310,43109,779,43888,516
2020-12-19,Alpine,003,1148,65,64,0,64,0
2020-12-19,Amador,005,37829,2144,1754,17,1771,23
2020-12-19,Butte,007,227075,6826,6118,676,6794,81
2020-12-19,Calaveras,009,45235,992,900,0,900,21
2020-12-19,Colusa,011,21464,1175,1096,50,1146,7
2020-12-19,Contra Costa,013,1133247,36728,34321,402,34723,301
2020-12-19,Del Norte,015,27424,688,641,1,642,2
2020-12-19,El Dorado,017,186661,5453,4588,204,4792,10
2020-12-19,Fresno,019,978130,62713,55428,3750,59178,634
2020-12-19,Glenn,021,27897,1401,1286,197,1483,9
2020-12-19,Humboldt,023,135768,1532,1357,6,1363,15
2020-12-19,Imperial,025,180216,21710,20711,895,21606,395
2020-12-19,Inyo,027,18085,577,475,7,482,17
2020-12-19,Kern,029,883053,60528,55118,3924,59042,540
2020-12-19,Kings,031,150075,15353,14474,450,14924,100
2020-12-19,Lake,033,64148,1656,1438,0,1438,20
2020-12-19,Lassen,035,31185,3931,3595,35,3630,1
2020-12-19,Los Angeles,037,10098052,668902,599888,16304,616192,8804
2020-12-19,Madera,039,155013,9671,8717,329,9046,63
2020-12-19,Marin,041,260295,9342,8864,60,8924,142
2020-12-19,Mariposa,043,17540,207,177,2,179,3
2020-12-19,Mendocino,045,87422,2216,2008,20,2028,23
2020-12-19,Merced,047,269075,17372,16230,268,16498,198
2020-12-19,Modoc,049,8938,219,181,66,247,0
2020-12-19,Mono,051,14174,821,766,12,778,3
2020-12-19,Monterey,053,433212,24927,22799,575,23374,172
2020-12-19,Napa,055,140530,5287,4772,24,4796,23
2020-12-19,Nevada,057,99092,2493,2260,78,2338,13
2020-12-19,Orange,059,3164182,140972,125574,5082,130656,1733
2020-12-19,Placer,061,380077,12955,11246,440,11686,105
2020-12-19,Plumas,063,18699,428,343,8,351,0
2020-12-19,Riverside,065,2383286,161974,146703,6428,153131,1737
2020-12-19,Sacramento,067,1510023,59748,55169,478,55647,746
2020-12-19,San Benito,069,59416,3169,2820,23,2843,21
2020-12-19,San Bernardino,071,2135413,176038,159883,4535,164418,1433
2020-12-19,San Diego,073,3302833,138987,122972,6074,129046,1280
2020-12-19,San Francisco,075,870044,21775,20643,192,20835,174
2020-12-19,San Joaquin,077,732212,41487,37340,1205,38545,586
2020-12-19,San Luis Obispo,079,281455,9702,8788,214,9002,63
2020-12-19,San Mateo,081,765935,22949,20393,65,20458,182
2020-12-19,Santa Barbara,083,443738,15752,14667,395,15062,148
2020-12-19,Santa Clara,085,1922200,62663,55540,245,55785,558
2020-12-19,Santa Cruz,087,273765,8101,7054,225,7279,68
2020-12-19,Shasta,089,179085,7609,7221,581,7802,63
2020-12-19,Sierra,091,2930,24,23,0,23,0
2020-12-19,Siskiyou,093,43540,950,853,85,938,2
2020-12-19,Solano,095,438530,16938,15204,159,15363,95
2020-12-19,Sonoma,097,501317,17639,16553,97,16650,175
2020-12-19,Stanislaus,099,539301,32063,29555,2636,32191,498
2020-12-19,Sutter,101,95872,5974,5506,41,5547,41
2020-12-19,Tehama,103,63373,2725,2574,222,2796,9
2020-12-19,Trinity,105,12862,395,219,53,272,2
2020-12-19,Tulare,107,460477,31130,28734,3139,31873,375
2020-12-19,Tuolumne,109,53932,2507,2107,8,2115,12
2020-12-19,Ventura,111,848112,34932,30843,1355,32198,209
2020-12-19,Yolo,113,214977,7766,7025,46,7071,109
2020-12-19,Yuba,115,75493,3498,3168,34,3202,11
2020-12-18,Alameda,001,1643700,46774,42196,763,42959,515
2020-12-18,Alpine,003,1148,65,64,0,64,0
2020-12-18,Amador,005,37829,2127,1727,15,1742,20
2020-12-18,Butte,007,227075,6741,5891,650,6541,81
2020-12-18,Calaveras,009,45235,982,870,0,870,21
2020-12-18,Colusa,011,21464,1166,1068,50,1118,7
2020-12-18,Contra Costa,013,1133247,36444,33610,390,34000,300
2020-12-18,Del Norte,015,27424,683,627,0,627,2
2020-12-18,El Dorado,017,186661,5391,4494,195,4689,10
2020-12-18,Fresno,019,978130,61886,52643,3686,56329,613
2020-12-18,Glenn,021,27897,1384,1264,192,1456,9
2020-12-18,Humboldt,023,135768,1517,1331,6,1337,15
2020-12-18,Imperial,025,180216,21632,20430,848,21278,393
2020-12-18,Inyo,027,18085,557,454,7,461,17
2020-12-18,Kern,029,883053,59868,54220,3839,58059,533
2020-12-18,Kings,031,150075,15227,14284,444,14728,98
2020-12-18,Lake,033,64148,1645,1397,0,1397,20
2020-12-18,Lassen,035,31185,3923,3486,35,3521,1
2020-12-18,Los Angeles,037,10098052,656762,586413,15802,602215,8744
2020-12-18,Madera,039,155013,9569,8609,324,8933,63
2020-12-18,Marin,041,260295,9258,8799,60,8859,142
2020-12-18,Mariposa,043,17540,204,176,2,178,3
2020-12-18,Mendocino,045,87422,2198,1977,20,1997,24
2020-12-18,Merced,047,269075,17291,15956,265,16221,195
2020-12-18,Modoc,049,8938,219,179,66,245,0
2020-12-18,Mono,051,14174,813,731,12,743,3
2020-12-18,Monterey,053,433212,24633,22336,569,22905,165
2020-12-18,Napa,055,140530,5238,4688,24,4712,23
2020-12-18,Nevada,057,99092,2476,2220,77,2297,13
2020-12-18,Orange,059,3164182,138536,121681,4933,126614,1725
2020-12-18,Placer,061,380077,12784,10995,431,11426,104
2020-12-18,Plumas,063,18699,422,336,8,344,0
2020-12-18,Riverside,065,2383286,159134,142375,6159,148534,1733
2020-12-18,Sacramento,067,1510023,59122,53980,462,54442,736
2020-12-18,San Benito,069,59416,3120,2744,23,2767,21
2020-12-18,San Bernardino,071,2135413,173739,154272,4401,158673,1430
2020-12-18,San Diego,073,3302833,136809,120463,5935,126398,1253
2020-12-18,San Francisco,075,870044,21608,20315,186,20501,173
2020-12-18,San Joaquin,077,732212,41128,36484,1174,37658,559
2020-12-18,San Luis Obispo,079,281455,9604,8598,209,8807,62
2020-12-18,San Mateo,081,765935,22636,19971,61,20032,182
2020-12-18,Santa Barbara,083,443738,15611,14361,382,14743,148
2020-12-18,Santa Clara,085,1922200,61790,53992,236,54228,539
2020-12-18,Santa Cruz,087,273765,7985,6838,217,7055,68
2020-12-18,Shasta,089,179085,7571,7114,570,7684,62
2020-12-18,Sierra,091,2930,24,23,0,23,0
2020-12-18,Siskiyou,093,43540,948,840,85,925,2
2020-12-18,Solano,095,438530,16785,14667,155,14822,95
2020-12-18,Sonoma,097,501317,17520,16261,97,16358,173
2020-12-18,Stanislaus,099,539301,31789,28967,2600,31567,490
2020-12-18,Sutter,101,95872,5890,5399,41,5440,39
2020-12-18,Tehama,103,63373,2710,2523,212,2735,9
2020-12-18,Trinity,105,12862,394,215,53,268,2
2020-12-18,Tulare,107,460477,30853,28322,3060,31382,370
2020-12-18,Tuolumne,109,53932,2496,2067,8,2075,12
2020-12-18,Ventura,111,848112,34428,29907,1312,31219,209
2020-12-18,Yolo,113,214977,7698,6901,45,6946,109
2020-12-18,Yuba,115,75493,3440,3097,34,3131,11
2020-12-17,Alameda,001,1643700,45965,41548,730,42278,508
2020-12-17,Alpine,003,1148,65,64,0,64,0
2020-12-17,Amador,005,37829,2079,1703,13,1716,19
2020-12-17,Butte,007,227075,6615,5746,632,6378,78
2020-12-17,Calaveras,009,45235,959,848,0,848,21
2020-12-17,Colusa,011,21464,1155,1053,48,1101,7
2020-12-17,Contra Costa,013,1133247,35920,33006,356,33362,293
2020-12-17,Del Norte,015,27424,678,583,0,583,1
2020-12-17,El Dorado,017,186661,5246,4327,183,4510,9
2020-12-17,Fresno,019,978130,61023,49918,3560,53478,597
2020-12-17,Glenn,021,27897,1360,1244,185,1429,9
2020-12-17,Humboldt,023,135768,1484,1322,6,1328,14
2020-12-17,Imperial,025,180216,21467,20208,779,20987,391
2020-12-17,Inyo,027,18085,539,450,6,456,16
2020-12-17,Kern,029,883053,58911,53683,3706,57389,526
2020-12-17,Kings,031,150075,15124,14057,429,14486,98
2020-12-17,Lake,033,64148,1620,1374,0,1374,20
2020-12-17,Lassen,035,31185,3887,3417,35,3452,1
2020-12-17,Los Angeles,037,10098052,641107,571093,15249,586342,8657
2020-12-17,Madera,039,155013,9452,8465,320,8785,62
2020-12-17,Marin,041,260295,9194,8721,58,8779,142
2020-12-17,Mariposa,043,17540,200,172,2,174,3
2020-12-17,Mendocino,045,87422,2164,1942,20,1962,23
2020-12-17,Merced,047,269075,17027,15648,257,15905,192
2020-12-17,Modoc,049,8938,216,179,66,245,0
2020-12-17,Mono,051,14174,800,718,12,730,3
2020-12-17,Monterey,053,433212,24114,21951,554,22505,163
2020-12-17,Napa,055,140530,5126,4612,24,4636,23
2020-12-17,Nevada,057,99092,2435,2173,74,2247,13
2020-12-17,Orange,059,3164182,135155,118367,4797,123164,1725
2020-12-17,Placer,061,380077,12510,10756,417,11173,99
2020-12-17,Plumas,063,18699,413,324,8,332,0
2020-12-17,Riverside,065,2383286,155250,139325,5944,145269,1696
2020-12-17,Sacramento,067,1510023,58216,53189,440,53629,721
2020-12-17,San Benito,069,59416,3051,2645,22,2667,20
2020-12-17,San Bernardino,071,2135413,169799,149838,4284,154122,1425
2020-12-17,San Diego,073,3302833,134008,116852,5779,122631,1239
2020-12-17,San Francisco,075,870044,21321,19939,181,20120,170
2020-12-17,San Joaquin,077,732212,40402,35894,1138,37032,554
2020-12-17,San Luis Obispo,079,281455,9484,8365,207,8572,59
2020-12-17,San Mateo,081,765935,22266,19647,61,19708,181
2020-12-17,Santa Barbara,083,443738,15378,14207,375,14582,147
2020-12-17,Santa Clara,085,1922200,60622,52559,230,52789,527
2020-12-17,Santa Cruz,087,273765,7830,6687,204,6891,64
2020-12-17,Shasta,089,179085,7494,7000,551,7551,62
2020-12-17,Sierra,091,2930,23,23,0,23,0
2020-12-17,Siskiyou,093,43540,941,827,84,911,2
2020-12-17,Solano,095,438530,16479,14361,153,14514,96
2020-12-17,Sonoma,097,501317,17248,15993,96,16089,171
2020-12-17,Stanislaus,099,539301,31364,28582,2541,31123,489
2020-12-17,Sutter,101,95872,5791,5309,40,5349,39
2020-12-17,Tehama,103,63373,2662,2480,206,2686,9
2020-12-17,Trinity,105,12862,389,213,53,266,2
2020-12-17,Tulare,107,460477,30459,27852,2982,30834,358
2020-12-17,Tuolumne,109,53932,2205,1992,8,2000,11
2020-12-17,Ventura,111,848112,33818,29404,1275,30679,208
2020-12-17,Yolo,113,214977,7573,6800,44,6844,105
2020-12-17,Yuba,115,75493,3381,3035,32,3067,12
2020-12-16,Alameda,001,1643700,45112,40751,705,41456,497
2020-12-16,Alpine,003,1148,65,64,0,64,0
2020-12-16,Amador,005,37829,2032,1693,12,1705,19
2020-12-16,Butte,007,227075,6426,5659,604,6263,76
2020-12-16,Calaveras,009,45235,924,821,0,821,21
2020-12-16,Colusa,011,21464,1142,1038,43,1081,7
2020-12-16,Contra Costa,013,1133247,35363,32429,336,32765,293
2020-12-16,Del Norte,015,27424,676,575,0,575,1
2020-12-16,El Dorado,017,186661,5125,4237,174,4411,9
2020-12-16,Fresno,019,978130,60065,49173,3464,52637,584
2020-12-16,Glenn,021,27897,1342,1236,174,1410,9
2020-12-16,Humboldt,023,135768,1452,1308,5,1313,12
2020-12-16,Imperial,025,180216,21283,19980,713,20693,388
2020-12-16,Inyo,027,18085,526,444,6,450,16
2020-12-16,Kern,029,883053,58034,52896,3574,56470,522
2020-12-16,Kings,031,150075,14944,13734,412,14146,99
2020-12-16,Lake,033,64148,1580,1363,0,1363,20
2020-12-16,Lassen,035,31185,3854,3396,34,3430,1
2020-12-16,Los Angeles,037,10098052,624584,557907,14561,572468,8561
2020-12-16,Madera,039,155013,9327,8278,312,8590,62
2020-12-16,Marin,041,260295,9123,8641,58,8699,142
2020-12-16,Mariposa,043,17540,197,175,2,177,3
2020-12-16,Mendocino,045,87422,2129,1929,20,1949,23
2020-12-16,Merced,047,269075,16741,15443,253,15696,190
2020-12-16,Modoc,049,8938,213,178,66,244,0
2020-12-16,Mono,051,14174,781,702,12,714,3
2020-12-16,Monterey,053,433212,23555,21107,543,21650,163
2020-12-16,Napa,055,140530,5029,4544,24,4568,23
2020-12-16,Nevada,057,99092,2399,2149,72,2221,13
2020-12-16,Orange,059,3164182,131677,115260,4630,119890,1712
2020-12-16,Placer,061,380077,12273,10554,396,10950,96
2020-12-16,Plumas,063,18699,404,319,8,327,0
2020-12-16,Riverside,065,2383286,151126,135751,5695,141446,1664
2020-12-16,Sacramento,067,1510023,57243,52166,415,52581,715
2020-12-16,San Benito,069,59416,2960,2582,22,2604,20
2020-12-16,San Bernardino,071,2135413,165193,143565,4149,147714,1403
2020-12-16,San Diego,073,3302833,130904,114248,5625,119873,1217
2020-12-16,San Francisco,075,870044,21062,19624,181,19805,170
2020-12-16,San Joaquin,077,732212,39575,35010,1098,36108,547
2020-12-16,San Luis Obispo,079,281455,9289,8252,198,8450,58
2020-12-16,San Mateo,081,765935,21940,19292,57,19349,179
2020-12-16,Santa Barbara,083,443738,15127,13966,363,14329,144
2020-12-16,Santa Clara,085,1922200,59379,51502,227,51729,523
2020-12-16,Santa Cruz,087,273765,7646,6536,193,6729,63
2020-12-16,Shasta,089,179085,7421,6914,529,7443,62
2020-12-16,Sierra,091,2930,23,23,0,23,0
2020-12-16,Siskiyou,093,43540,933,818,84,902,2
2020-12-16,Solano,095,438530,16012,14157,149,14306,96
2020-12-16,Sonoma,097,501317,16992,15768,96,15864,170
2020-12-16,Stanislaus,099,539301,30862,28279,2468,30747,489
2020-12-16,Sutter,101,95872,5711,5223,40,5263,39
2020-12-16,Tehama,103,63373,2629,2441,180,2621,9
2020-12-16,Trinity,105,12862,383,212,53,265,2
2020-12-16,Tulare,107,460477,30036,27500,2882,30382,352
2020-12-16,Tuolumne,109,53932,2162,1941,8,1949,11
2020-12-16,Ventura,111,848112,33044,28566,1232,29798,203
2020-12-16,Yolo,113,214977,7445,6649,43,6692,103
2020-12-16,Yuba,115,75493,3295,2980,31,3011,11
2020-12-15,Alameda,001,1643700,44256,40026,683,40709,492
2020-12-15,Alpine,003,1148,65,64,0,64,0
2020-12-15,Amador,005,37829,1919,1669,10,1679,19
2020-12-15,Butte,007,227075,6288,5565,575,6140,75
2020-12-15,Calaveras,009,45235,892,799,0,799,21
2020-12-15,Colusa,011,21464,1129,1026,42,1068,7
2020-12-15,Contra Costa,013,1133247,34705,31423,322,31745,281
2020-12-15,Del Norte,015,27424,665,564,0,564,1
2020-12-15,El Dorado,017,186661,5017,4113,160,4273,9
2020-12-15,Fresno,019,978130,58692,47316,3330,50646,574
2020-12-15,Glenn,021,27897,1329,1207,158,1365,9
2020-12-15,Humboldt,023,135768,1432,1276,5,1281,12
2020-12-15,Imperial,025,180216,21062,19756,633,20389,380
2020-12-15,Inyo,027,18085,513,394,6,400,16
2020-12-15,Kern,029,883053,57022,52002,3471,55473,511
2020-12-15,Kings,031,150075,14780,13652,393,14045,97
2020-12-15,Lake,033,64148,1555,1341,0,1341,21
2020-12-15,Lassen,035,31185,3682,3378,33,3411,1
2020-12-15,Los Angeles,037,10098052,608210,536258,13917,550175,8429
2020-12-15,Madera,039,155013,9173,8118,305,8423,60
2020-12-15,Marin,041,260295,9015,8528,56,8584,141
2020-12-15,Mariposa,043,17540,193,171,2,173,3
2020-12-15,Mendocino,045,87422,2102,1883,20,1903,24
2020-12-15,Merced,047,269075,16443,15120,249,15369,190
2020-12-15,Modoc,049,8938,211,179,66,245,0
2020-12-15,Mono,051,14174,765,702,12,714,3
2020-12-15,Monterey,053,433212,22957,19905,482,20387,161
2020-12-15,Napa,055,140530,4926,4440,24,4464,23
2020-12-15,Nevada,057,99092,2366,2117,70,2187,11
2020-12-15,Orange,059,3164182,128021,112893,4477,117370,1689
2020-12-15,Placer,061,380077,12039,10301,374,10675,95
2020-12-15,Plumas,063,18699,399,313,8,321,0
2020-12-15,Riverside,065,2383286,147068,131822,5416,137238,1624
2020-12-15,Sacramento,067,1510023,56226,51076,402,51478,703
2020-12-15,San Benito,069,59416,2881,2520,21,2541,19
2020-12-15,San Bernardino,071,2135413,160735,137548,3998,141546,1351
2020-12-15,San Diego,073,3302833,127338,111441,5462,116903,1194
2020-12-15,San Francisco,075,870044,20752,19283,178,19461,171
2020-12-15,San Joaquin,077,732212,38651,33849,1061,34910,537
2020-12-15,San Luis Obispo,079,281455,9180,8074,195,8269,55
2020-12-15,San Mateo,081,765935,21530,18907,55,18962,178
2020-12-15,Santa Barbara,083,443738,14900,13782,355,14137,144
2020-12-15,Santa Clara,085,1922200,57944,50311,224,50535,505
2020-12-15,Santa Cruz,087,273765,7461,6361,179,6540,59
2020-12-15,Shasta,089,179085,7362,6794,504,7298,54
2020-12-15,Sierra,091,2930,23,23,0,23,0
2020-12-15,Siskiyou,093,43540,924,812,83,895,2
2020-12-15,Solano,095,438530,15662,13796,149,13945,95
2020-12-15,Sonoma,097,501317,16771,15406,96,15502,167
2020-12-15,Stanislaus,099,539301,30349,27823,2387,30210,485
2020-12-15,Sutter,101,95872,5613,5080,39,5119,36
2020-12-15,Tehama,103,63373,2591,2392,175,2567,9
2020-12-15,Trinity,105,12862,375,213,51,264,1
2020-12-15,Tulare,107,460477,29547,27026,2792,29818,342
2020-12-15,Tuolumne,109,53932,2132,1874,8,1882,8
2020-12-15,Ventura,111,848112,32422,27936,1185,29121,201
2020-12-15,Yolo,113,214977,7322,6531,41,6572,104
2020-12-15,Yuba,115,75493,3201,2891,30,2921,11
2020-12-14,Alameda,001,1643700,43358,39252,664,39916,487
2020-12-14,Alpine,003,1148,65,63,0,63,0
2020-12-14,Amador,005,37829,1847,1609,10,1619,19
2020-12-14,Butte,007,227075,6120,5202,558,5760,75
2020-12-14,Calaveras,009,45235,854,718,0,718,21
2020-12-14,Colusa,011,21464,1105,949,41,990,7
2020-12-14,Contra Costa,013,1133247,34006,30594,308,30902,281
2020-12-14,Del Norte,015,27424,659,560,0,560,1
2020-12-14,El Dorado,017,186661,4861,4018,144,4162,9
2020-12-14,Fresno,019,978130,57668,44726,3150,47876,560
2020-12-14,Glenn,021,27897,1303,1186,150,1336,9
2020-12-14,Humboldt,023,135768,1419,1256,5,1261,9
2020-12-14,Imperial,025,180216,20824,19608,554,20162,379
2020-12-14,Inyo,027,18085,499,382,6,388,16
2020-12-14,Kern,029,883053,55985,50538,3350,53888,510
2020-12-14,Kings,031,150075,14595,13491,366,13857,97
2020-12-14,Lake,033,64148,1506,1301,0,1301,21
2020-12-14,Lassen,035,31185,3584,2905,30,2935,1
2020-12-14,Los Angeles,037,10098052,590586,524668,13272,537940,8340
2020-12-14,Madera,039,155013,8906,8011,296,8307,60
2020-12-14,Marin,041,260295,8932,8475,55,8530,141
2020-12-14,Mariposa,043,17540,192,171,2,173,3
2020-12-14,Mendocino,045,87422,2081,1845,20,1865,24
2020-12-14,Merced,047,269075,16035,14572,235,14807,189
2020-12-14,Modoc,049,8938,205,180,64,244,0
2020-12-14,Mono,051,14174,757,685,12,697,3
2020-12-14,Monterey,053,433212,22435,19154,476,19630,155
2020-12-14,Napa,055,140530,4833,4289,24,4313,22
2020-12-14,Nevada,057,99092,2327,2070,67,2137,11
2020-12-14,Orange,059,3164182,124131,108602,4341,112943,1688
2020-12-14,Placer,061,380077,11758,9551,363,9914,95
2020-12-14,Plumas,063,18699,387,309,8,317,0
2020-12-14,Riverside,065,2383286,142938,123715,5154,128869,1588
2020-12-14,Sacramento,067,1510023,55120,50304,377,50681,691
2020-12-14,San Benito,069,59416,2815,2467,20,2487,19
2020-12-14,San Bernardino,071,2135413,156288,129151,3870,133021,1347
2020-12-14,San Diego,073,3302833,123602,109578,5277,114855,1162
2020-12-14,San Francisco,075,870044,20375,18904,176,19080,171
2020-12-14,San Joaquin,077,732212,37807,32522,1015,33537,534
2020-12-14,San Luis Obispo,079,281455,8934,7791,191,7982,52
2020-12-14,San Mateo,081,765935,21032,18361,52,18413,178
2020-12-14,Santa Barbara,083,443738,14627,13587,347,13934,144
2020-12-14,Santa Clara,085,1922200,56380,49180,212,49392,502
2020-12-14,Santa Cruz,087,273765,7275,6049,164,6213,54
2020-12-14,Shasta,089,179085,7273,6665,485,7150,54
2020-12-14,Sierra,091,2930,23,21,0,21,0
2020-12-14,Siskiyou,093,43540,901,764,77,841,2
2020-12-14,Solano,095,438530,15300,13352,148,13500,93
2020-12-14,Sonoma,097,501317,16464,14807,95,14902,167
2020-12-14,Stanislaus,099,539301,29815,27311,2338,29649,485
2020-12-14,Sutter,101,95872,5509,5001,32,5033,35
2020-12-14,Tehama,103,63373,2548,2344,172,2516,9
2020-12-14,Trinity,105,12862,371,205,49,254,1
2020-12-14,Tulare,107,460477,29074,25735,2701,28436,341
2020-12-14,Tuolumne,109,53932,2079,1647,8,1655,8
2020-12-14,Ventura,111,848112,31499,27436,1126,28562,202
2020-12-14,Yolo,113,214977,7163,6389,40,6429,95
2020-12-14,Yuba,115,75493,3139,2851,30,2881,11
2020-12-13,Alameda,001,1643700,42161,38064,638,38702,486
2020-12-13,Alpine,003,1148,65,63,0,63,0
2020-12-13,Amador,005,37829,1791,1457,9,1466,19
2020-12-13,Butte,007,227075,5972,5103,517,5620,75
2020-12-13,Calaveras,009,45235,818,710,0,710,21
2020-12-13,Colusa,011,21464,1089,945,37,982,7
2020-12-13,Contra Costa,013,1133247,33278,29667,302,29969,281
2020-12-13,Del Norte,015,27424,606,542,0,542,1
2020-12-13,El Dorado,017,186661,4760,3770,133,3903,9
2020-12-13,Fresno,019,978130,56561,44114,2991,47105,559
2020-12-13,Glenn,021,27897,1290,1171,139,1310,9
2020-12-13,Humboldt,023,135768,1396,1238,4,1242,9
2020-12-13,Imperial,025,180216,20533,19472,431,19903,379
2020-12-13,Inyo,027,18085,478,380,6,386,16
2020-12-13,Kern,029,883053,54954,49051,3196,52247,510
2020-12-13,Kings,031,150075,14315,13357,348,13705,97
2020-12-13,Lake,033,64148,1463,1271,0,1271,21
2020-12-13,Lassen,035,31185,3477,2867,25,2892,1
2020-12-13,Los Angeles,037,10098052,572977,517472,12564,530036,8294
2020-12-13,Madera,039,155013,8724,7909,282,8191,60
2020-12-13,Marin,041,260295,8812,8409,55,8464,141
2020-12-13,Mariposa,043,17540,188,167,2,169,3
2020-12-13,Mendocino,045,87422,2047,1793,20,1813,24
2020-12-13,Merced,047,269075,15684,14384,232,14616,189
2020-12-13,Modoc,049,8938,192,179,58,237,0
2020-12-13,Mono,051,14174,741,675,12,687,3
2020-12-13,Monterey,053,433212,22013,18913,462,19375,153
2020-12-13,Napa,055,140530,4727,4194,24,4218,22
2020-12-13,Nevada,057,99092,2279,2030,65,2095,11
2020-12-13,Orange,059,3164182,120199,104768,4167,108935,1688
2020-12-13,Placer,061,380077,11443,9405,345,9750,95
2020-12-13,Plumas,063,18699,381,291,8,299,0
2020-12-13,Riverside,065,2383286,138808,119691,4891,124582,1581
2020-12-13,Sacramento,067,1510023,53851,49480,348,49828,682
2020-12-13,San Benito,069,59416,2745,2408,19,2427,19
2020-12-13,San Bernardino,071,2135413,151388,126718,3707,130425,1333
2020-12-13,San Diego,073,3302833,120002,107372,5108,112480,1162
2020-12-13,San Francisco,075,870044,20030,18686,167,18853,167
2020-12-13,San Joaquin,077,732212,37003,32170,975,33145,534
2020-12-13,San Luis Obispo,079,281455,8744,7625,183,7808,52
2020-12-13,San Mateo,081,765935,20541,18090,46,18136,177
2020-12-13,Santa Barbara,083,443738,14357,13249,332,13581,144
2020-12-13,Santa Clara,085,1922200,54954,47920,203,48123,499
2020-12-13,Santa Cruz,087,273765,7026,5986,153,6139,54
2020-12-13,Shasta,089,179085,7199,6647,459,7106,54
2020-12-13,Sierra,091,2930,23,21,0,21,0
2020-12-13,Siskiyou,093,43540,889,762,72,834,2
2020-12-13,Solano,095,438530,14862,13276,145,13421,93
2020-12-13,Sonoma,097,501317,16150,14495,94,14589,167
2020-12-13,Stanislaus,099,539301,29250,26569,2276,28845,485
2020-12-13,Sutter,101,95872,5382,4798,28,4826,34
2020-12-13,Tehama,103,63373,2503,2325,157,2482,9
2020-12-13,Trinity,105,12862,365,204,49,253,1
2020-12-13,Tulare,107,460477,28584,25496,2614,28110,340
2020-12-13,Tuolumne,109,53932,2017,1611,8,1619,8
2020-12-13,Ventura,111,848112,30496,26588,1063,27651,202
2020-12-13,Yolo,113,214977,6981,6265,34,6299,95
2020-12-13,Yuba,115,75493,3074,2754,27,2781,11
2020-12-12,Alameda,001,1643700,41717,37027,618,37645,486
2020-12-12,Alpine,003,1148,65,63,0,63,0
2020-12-12,Amador,005,37829,1763,1236,8,1244,19
2020-12-12,Butte,007,227075,5899,4972,505,5477,73
2020-12-12,Calaveras,009,45235,808,708,0,708,21
2020-12-12,Colusa,011,21464,1069,945,35,980,7
2020-12-12,Contra Costa,013,1133247,32934,29506,293,29799,281
2020-12-12,Del Norte,015,27424,598,529,0,529,1
2020-12-12,El Dorado,017,186661,4685,3706,116,3822,9
2020-12-12,Fresno,019,978130,56210,43756,2931,46687,559
2020-12-12,Glenn,021,27897,1282,1143,135,1278,8
2020-12-12,Humboldt,023,135768,1377,1208,4,1212,9
2020-12-12,Imperial,025,180216,20448,18947,373,19320,379
2020-12-12,Inyo,027,18085,474,380,6,386,16
2020-12-12,Kern,029,883053,54434,48194,3108,51302,507
2020-12-12,Kings,031,150075,14226,13205,344,13549,96
2020-12-12,Lake,033,64148,1447,1232,0,1232,21
2020-12-12,Lassen,035,31185,3454,2866,22,2888,1
2020-12-12,Los Angeles,037,10098052,566177,504317,12056,516373,8269
2020-12-12,Madera,039,155013,8597,7765,279,8044,59
2020-12-12,Marin,041,260295,8758,8363,54,8417,141
2020-12-12,Mariposa,043,17540,187,164,2,166,3
2020-12-12,Mendocino,045,87422,2011,1771,20,1791,24
2020-12-12,Merced,047,269075,15593,14181,228,14409,188
2020-12-12,Modoc,049,8938,191,169,55,224,0
2020-12-12,Mono,051,14174,734,640,12,652,3
2020-12-12,Monterey,053,433212,21902,18596,433,19029,151
2020-12-12,Napa,055,140530,4682,4113,24,4137,22
2020-12-12,Nevada,057,99092,2261,1981,63,2044,10
2020-12-12,Orange,059,3164182,118315,100468,4019,104487,1674
2020-12-12,Placer,061,380077,11278,9390,340,9730,95
2020-12-12,Plumas,063,18699,375,291,8,299,0
2020-12-12,Riverside,065,2383286,136751,118335,4686,123021,1579
2020-12-12,Sacramento,067,1510023,53267,48319,335,48654,673
2020-12-12,San Benito,069,59416,2689,2355,19,2374,19
2020-12-12,San Bernardino,071,2135413,149758,125741,3605,129346,1321
2020-12-12,San Diego,073,3302833,118381,104958,5011,109969,1151
2020-12-12,San Francisco,075,870044,19840,18413,163,18576,167
2020-12-12,San Joaquin,077,732212,36676,32200,944,33144,534
2020-12-12,San Luis Obispo,079,281455,8645,7462,177,7639,50
2020-12-12,San Mateo,081,765935,20320,17574,45,17619,177
2020-12-12,Santa Barbara,083,443738,14205,13174,324,13498,144
2020-12-12,Santa Clara,085,1922200,54004,45892,200,46092,498
2020-12-12,Santa Cruz,087,273765,6928,5905,144,6049,54
2020-12-12,Shasta,089,179085,7165,6551,441,6992,54
2020-12-12,Sierra,091,2930,23,21,0,21,0
2020-12-12,Siskiyou,093,43540,887,762,69,831,2
2020-12-12,Solano,095,438530,14664,12748,138,12886,93
2020-12-12,Sonoma,097,501317,16029,14466,94,14560,166
2020-12-12,Stanislaus,099,539301,28949,26246,2224,28470,483
2020-12-12,Sutter,101,95872,5320,4717,28,4745,32
2020-12-12,Tehama,103,63373,2485,2252,151,2403,9
2020-12-12,Trinity,105,12862,363,204,47,251,1
2020-12-12,Tulare,107,460477,28325,25333,2556,27889,341
2020-12-12,Tuolumne,109,53932,1974,1536,8,1544,8
2020-12-12,Ventura,111,848112,30052,25955,1030,26985,202
2020-12-12,Yolo,113,214977,6899,6116,32,6148,95
2020-12-12,Yuba,115,75493,3047,2692,26,2718,10
2020-12-11,Alameda,001,1643700,41150,36281,606,36887,482
2020-12-11,Alpine,003,1148,65,63,0,63,0
2020-12-11,Amador,005,37829,1747,1213,8,1221,19
2020-12-11,Butte,007,227075,5826,4941,487,5428,73
2020-12-11,Calaveras,009,45235,792,697,0,697,21
2020-12-11,Colusa,011,21464,1059,923,33,956,7
2020-12-11,Contra Costa,013,1133247,32511,29036,289,29325,282
2020-12-11,Del Norte,015,27424,592,505,0,505,1
2020-12-11,El Dorado,017,186661,4604,3669,101,3770,9
2020-12-11,Fresno,019,978130,55198,43071,2865,45936,550
2020-12-11,Glenn,021,27897,1266,1135,130,1265,8
2020-12-11,Humboldt,023,135768,1359,1190,4,1194,9
2020-12-11,Imperial,025,180216,20358,18599,329,18928,377
2020-12-11,Inyo,027,18085,462,372,6,378,16
2020-12-11,Kern,029,883053,53756,47664,3046,50710,502
2020-12-11,Kings,031,150075,14082,13118,340,13458,94
2020-12-11,Lake,033,64148,1434,1205,0,1205,21
2020-12-11,Lassen,035,31185,3442,2790,21,2811,1
2020-12-11,Los Angeles,037,10098052,554373,493592,11644,505236,8198
2020-12-11,Madera,039,155013,8506,7648,269,7917,59
2020-12-11,Marin,041,260295,8664,8317,53,8370,141
2020-12-11,Mariposa,043,17540,186,164,2,166,3
2020-12-11,Mendocino,045,87422,1987,1769,20,1789,24
2020-12-11,Merced,047,269075,15473,14038,220,14258,186
2020-12-11,Modoc,049,8938,191,168,54,222,0
2020-12-11,Mono,051,14174,724,631,12,643,3
2020-12-11,Monterey,053,433212,21601,18421,428,18849,150
2020-12-11,Napa,055,140530,4627,4054,24,4078,22
2020-12-11,Nevada,057,99092,2244,1959,60,2019,10
2020-12-11,Orange,059,3164182,116007,98357,3917,102274,1656
2020-12-11,Placer,061,380077,11116,8904,324,9228,93
2020-12-11,Plumas,063,18699,367,286,8,294,0
2020-12-11,Riverside,065,2383286,133683,115329,4466,119795,1573
2020-12-11,Sacramento,067,1510023,52605,47468,327,47795,669
2020-12-11,San Benito,069,59416,2638,2319,19,2338,19
2020-12-11,San Bernardino,071,2135413,147068,123092,3489,126581,1313
2020-12-11,San Diego,073,3302833,116421,102468,4928,107396,1137
2020-12-11,San Francisco,075,870044,19610,18246,162,18408,165
2020-12-11,San Joaquin,077,732212,36330,32044,916,32960,534
2020-12-11,San Luis Obispo,079,281455,8484,7415,175,7590,49
2020-12-11,San Mateo,081,765935,20049,17240,34,17274,177
2020-12-11,Santa Barbara,083,443738,14062,12997,316,13313,144
2020-12-11,Santa Clara,085,1922200,53000,45101,191,45292,494
2020-12-11,Santa Cruz,087,273765,6815,5764,135,5899,50
2020-12-11,Shasta,089,179085,7120,6459,434,6893,54
2020-12-11,Sierra,091,2930,23,19,0,19,0
2020-12-11,Siskiyou,093,43540,880,753,66,819,2
2020-12-11,Solano,095,438530,14478,12554,134,12688,92
2020-12-11,Sonoma,097,501317,15862,14298,92,14390,166
2020-12-11,Stanislaus,099,539301,28681,25928,2181,28109,464
2020-12-11,Sutter,101,95872,5257,4600,27,4627,30
2020-12-11,Tehama,103,63373,2454,2232,147,2379,9
2020-12-11,Trinity,105,12862,360,204,47,251,1
2020-12-11,Tulare,107,460477,27965,24953,2509,27462,338
2020-12-11,Tuolumne,109,53932,1960,1510,8,1518,8
2020-12-11,Ventura,111,848112,29446,24999,1008,26007,202
2020-12-11,Yolo,113,214977,6793,6006,31,6037,95
2020-12-11,Yuba,115,75493,2987,2649,25,2674,10
2020-12-10,Alameda,001,1643700,40380,35686,584,36270,477
2020-12-10,Alpine,003,1148,65,63,0,63,0
2020-12-10,Amador,005,37829,1690,1191,8,1199,18
2020-12-10,Butte,007,227075,5710,4863,460,5323,72
2020-12-10,Calaveras,009,45235,774,684,0,684,21
2020-12-10,Colusa,011,21464,1036,909,28,937,7
2020-12-10,Contra Costa,013,1133247,31830,28413,283,28696,276
2020-12-10,Del Norte,015,27424,582,501,0,501,1
2020-12-10,El Dorado,017,186661,4486,3557,96,3653,9
2020-12-10,Fresno,019,978130,54219,42461,2722,45183,540
2020-12-10,Glenn,021,27897,1246,1126,121,1247,8
2020-12-10,Humboldt,023,135768,1339,1140,4,1144,9
2020-12-10,Imperial,025,180216,20142,18333,252,18585,370
2020-12-10,Inyo,027,18085,441,365,6,371,15
2020-12-10,Kern,029,883053,52772,47176,2880,50056,499
2020-12-10,Kings,031,150075,13924,12993,334,13327,92
2020-12-10,Lake,033,64148,1393,1167,0,1167,21
2020-12-10,Lassen,035,31185,3420,2764,17,2781,0
2020-12-10,Los Angeles,037,10098052,540407,480354,11106,491460,8149
2020-12-10,Madera,039,155013,8400,7445,254,7699,59
2020-12-10,Marin,041,260295,8611,8245,52,8297,140
2020-12-10,Mariposa,043,17540,185,160,2,162,3
2020-12-10,Mendocino,045,87422,1961,1748,17,1765,24
2020-12-10,Merced,047,269075,15227,13756,217,13973,186
2020-12-10,Modoc,049,8938,186,165,52,217,0
2020-12-10,Mono,051,14174,719,601,12,613,3
2020-12-10,Monterey,053,433212,21120,18266,418,18684,145
2020-12-10,Napa,055,140530,4541,3974,23,3997,22
2020-12-10,Nevada,057,99092,2208,1919,60,1979,10
2020-12-10,Orange,059,3164182,112911,95297,3755,99052,1651
2020-12-10,Placer,061,380077,10863,8906,306,9212,90
2020-12-10,Plumas,063,18699,356,281,8,289,0
2020-12-10,Riverside,065,2383286,129997,112794,4197,116991,1552
2020-12-10,Sacramento,067,1510023,51706,46471,306,46777,664
2020-12-10,San Benito,069,59416,2578,2268,18,2286,19
2020-12-10,San Bernardino,071,2135413,142834,120186,3315,123501,1306
2020-12-10,San Diego,073,3302833,113896,99601,4779,104380,1114
2020-12-10,San Francisco,075,870044,19298,17945,154,18099,164
2020-12-10,San Joaquin,077,732212,35695,31228,886,32114,534
2020-12-10,San Luis Obispo,079,281455,8321,7245,164,7409,49
2020-12-10,San Mateo,081,765935,19604,16701,24,16725,177
2020-12-10,Santa Barbara,083,443738,13883,12788,307,13095,143
2020-12-10,Santa Clara,085,1922200,51862,43939,176,44115,491
2020-12-10,Santa Cruz,087,273765,6648,5645,122,5767,48
2020-12-10,Shasta,089,179085,7052,6312,409,6721,53
2020-12-10,Sierra,091,2930,23,18,0,18,0
2020-12-10,Siskiyou,093,43540,870,712,65,777,2
2020-12-10,Solano,095,438530,14111,12017,128,12145,90
2020-12-10,Sonoma,097,501317,15607,14282,90,14372,167
2020-12-10,Stanislaus,099,539301,28218,25582,2112,27694,464
2020-12-10,Sutter,101,95872,5127,4528,25,4553,27
2020-12-10,Tehama,103,63373,2410,2190,137,2327,9
2020-12-10,Trinity,105,12862,356,202,45,247,1
2020-12-10,Tulare,107,460477,27509,24506,2443,26949,337
2020-12-10,Tuolumne,109,53932,1718,1451,8,1459,8
2020-12-10,Ventura,111,848112,28595,24075,964,25039,202
2020-12-10,Yolo,113,214977,6673,5896,30,5926,95
2020-12-10,Yuba,115,75493,2923,2604,24,2628,10
2020-12-09,Alameda,001,1643700,39538,35047,562,35609,470
2020-12-09,Alpine,003,1148,65,58,0,58,0
2020-12-09,Amador,005,37829,1647,1121,8,1129,19
2020-12-09,Butte,007,227075,5567,4733,440,5173,70
2020-12-09,Calaveras,009,45235,747,670,0,670,21
2020-12-09,Colusa,011,21464,1021,896,27,923,7
2020-12-09,Contra Costa,013,1133247,31124,28308,272,28580,273
2020-12-09,Del Norte,015,27424,569,481,0,481,2
2020-12-09,El Dorado,017,186661,4351,3449,88,3537,8
2020-12-09,Fresno,019,978130,53217,41954,2568,44522,533
2020-12-09,Glenn,021,27897,1232,1107,115,1222,8
2020-12-09,Humboldt,023,135768,1307,1086,4,1090,10
2020-12-09,Imperial,025,180216,19888,17757,215,17972,368
2020-12-09,Inyo,027,18085,428,356,6,362,15
2020-12-09,Kern,029,883053,51613,46379,2738,49117,494
2020-12-09,Kings,031,150075,13779,12716,326,13042,92
2020-12-09,Lake,033,64148,1366,1158,0,1158,20
2020-12-09,Lassen,035,31185,3351,2331,15,2346,0
2020-12-09,Los Angeles,037,10098052,526929,467971,10554,478525,8075
2020-12-09,Madera,039,155013,8287,7216,251,7467,59
2020-12-09,Marin,041,260295,8549,8182,51,8233,138
2020-12-09,Mariposa,043,17540,183,154,2,156,3
2020-12-09,Mendocino,045,87422,1935,1703,16,1719,24
2020-12-09,Merced,047,269075,14986,13588,210,13798,183
2020-12-09,Modoc,049,8938,181,146,43,189,0
2020-12-09,Mono,051,14174,707,601,12,613,3
2020-12-09,Monterey,053,433212,20719,17891,410,18301,143
2020-12-09,Napa,055,140530,4455,3858,22,3880,21
2020-12-09,Nevada,057,99092,2155,1864,60,1924,10
2020-12-09,Orange,059,3164182,109821,93763,3582,97345,1629
2020-12-09,Placer,061,380077,10601,8588,292,8880,85
2020-12-09,Plumas,063,18699,348,271,8,279,0
2020-12-09,Riverside,065,2383286,126299,110376,3990,114366,1543
2020-12-09,Sacramento,067,1510023,50643,45284,279,45563,659
2020-12-09,San Benito,069,59416,2505,2217,16,2233,19
2020-12-09,San Bernardino,071,2135413,138554,114516,3122,117638,1305
2020-12-09,San Diego,073,3302833,110916,97551,4640,102191,1103
2020-12-09,San Francisco,075,870044,18997,17628,153,17781,163
2020-12-09,San Joaquin,077,732212,34877,30539,861,31400,531
2020-12-09,San Luis Obispo,079,281455,8102,7105,156,7261,47
2020-12-09,San Mateo,081,765935,19154,16422,23,16445,175
2020-12-09,Santa Barbara,083,443738,13683,12630,297,12927,142
2020-12-09,Santa Clara,085,1922200,50714,42912,160,43072,489
2020-12-09,Santa Cruz,087,273765,6489,5527,107,5634,47
2020-12-09,Shasta,089,179085,6987,6105,395,6500,52
2020-12-09,Sierra,091,2930,23,18,0,18,0
2020-12-09,Siskiyou,093,43540,859,713,64,777,2
2020-12-09,Solano,095,438530,13763,11862,120,11982,90
2020-12-09,Sonoma,097,501317,15351,13994,87,14081,164
2020-12-09,Stanislaus,099,539301,27720,25157,2051,27208,463
2020-12-09,Sutter,101,95872,5009,4418,21,4439,24
2020-12-09,Tehama,103,63373,2374,2102,133,2235,9
2020-12-09,Trinity,105,12862,348,199,42,241,0
2020-12-09,Tulare,107,460477,26913,24124,2365,26489,334
2020-12-09,Tuolumne,109,53932,1685,1319,8,1327,8
2020-12-09,Ventura,111,848112,27732,23830,922,24752,201
2020-12-09,Yolo,113,214977,6549,5760,28,5788,95
2020-12-09,Yuba,115,75493,2855,2513,23,2536,10
2020-12-08,Alameda,001,1643700,38640,34373,546,34919,469
2020-12-08,Alpine,003,1148,64,53,0,53,0
2020-12-08,Amador,005,37829,1361,1043,8,1051,17
2020-12-08,Butte,007,227075,5408,4651,399,5050,70
2020-12-08,Calaveras,009,45235,723,657,0,657,21
2020-12-08,Colusa,011,21464,1005,875,26,901,6
2020-12-08,Contra Costa,013,1133247,30421,27926,255,28181,270
2020-12-08,Del Norte,015,27424,553,465,0,465,2
2020-12-08,El Dorado,017,186661,4227,3296,75,3371,8
2020-12-08,Fresno,019,978130,51954,41574,2412,43986,529
2020-12-08,Glenn,021,27897,1212,1094,107,1201,8
2020-12-08,Humboldt,023,135768,1281,1059,4,1063,10
2020-12-08,Imperial,025,180216,19371,17568,207,17775,363
2020-12-08,Inyo,027,18085,405,333,6,339,15
2020-12-08,Kern,029,883053,50319,45116,2581,47697,487
2020-12-08,Kings,031,150075,13625,12623,317,12940,90
2020-12-08,Lake,033,64148,1324,1127,0,1127,20
2020-12-08,Lassen,035,31185,3195,2165,15,2180,0
2020-12-08,Los Angeles,037,10098052,514240,459738,10070,469808,8004
2020-12-08,Madera,039,155013,8156,7082,238,7320,59
2020-12-08,Marin,041,260295,8469,8099,50,8149,137
2020-12-08,Mariposa,043,17540,179,150,2,152,2
2020-12-08,Mendocino,045,87422,1893,1666,16,1682,23
2020-12-08,Merced,047,269075,14674,13380,209,13589,181
2020-12-08,Modoc,049,8938,173,138,40,178,0
2020-12-08,Mono,051,14174,693,597,12,609,3
2020-12-08,Monterey,053,433212,20145,17752,403,18155,134
2020-12-08,Napa,055,140530,4368,3778,21,3799,22
2020-12-08,Nevada,057,99092,2101,1809,57,1866,11
2020-12-08,Orange,059,3164182,106600,91406,3417,94823,1629
2020-12-08,Placer,061,380077,10333,8224,287,8511,82
2020-12-08,Plumas,063,18699,338,258,8,266,0
2020-12-08,Riverside,065,2383286,122936,107620,3810,111430,1514
2020-12-08,Sacramento,067,1510023,49578,44635,264,44899,649
2020-12-08,San Benito,069,59416,2452,2180,16,2196,18
2020-12-08,San Bernardino,071,2135413,134203,110676,2996,113672,1301
2020-12-08,San Diego,073,3302833,107545,95447,4483,99930,1088
2020-12-08,San Francisco,075,870044,18687,17384,151,17535,162
2020-12-08,San Joaquin,077,732212,33982,30225,828,31053,530
2020-12-08,San Luis Obispo,079,281455,7973,6903,145,7048,45
2020-12-08,San Mateo,081,765935,18754,16305,23,16328,175
2020-12-08,Santa Barbara,083,443738,13499,12516,288,12804,141
2020-12-08,Santa Clara,085,1922200,49409,41309,151,41460,484
2020-12-08,Santa Cruz,087,273765,6311,5374,105,5479,45
2020-12-08,Shasta,089,179085,6878,5946,387,6333,50
2020-12-08,Sierra,091,2930,22,18,0,18,0
2020-12-08,Siskiyou,093,43540,845,704,62,766,2
2020-12-08,Solano,095,438530,13361,11669,118,11787,89
2020-12-08,Sonoma,097,501317,15092,13601,86,13687,164
2020-12-08,Stanislaus,099,539301,27230,24793,1986,26779,461
2020-12-08,Sutter,101,95872,4914,4342,20,4362,24
2020-12-08,Tehama,103,63373,2294,2057,125,2182,9
2020-12-08,Trinity,105,12862,339,198,41,239,0
2020-12-08,Tulare,107,460477,26308,23607,2304,25911,330
2020-12-08,Tuolumne,109,53932,1661,1264,8,1272,7
2020-12-08,Ventura,111,848112,27069,23665,879,24544,195
2020-12-08,Yolo,113,214977,6418,5560,28,5588,90
2020-12-08,Yuba,115,75493,2778,2477,23,2500,10
2020-12-07,Alameda,001,1643700,37774,33887,511,34398,466
2020-12-07,Alpine,003,1148,63,53,0,53,0
2020-12-07,Amador,005,37829,1286,993,7,1000,17
2020-12-07,Butte,007,227075,5273,4604,377,4981,67
2020-12-07,Calaveras,009,45235,691,606,0,606,21
2020-12-07,Colusa,011,21464,980,825,24,849,6
2020-12-07,Contra Costa,013,1133247,29807,27307,242,27549,270
2020-12-07,Del Norte,015,27424,541,424,0,424,2
2020-12-07,El Dorado,017,186661,4048,3275,68,3343,8
2020-12-07,Fresno,019,978130,50479,41098,2289,43387,526
2020-12-07,Glenn,021,27897,1193,1085,101,1186,8
2020-12-07,Humboldt,023,135768,1246,1023,4,1027,9
2020-12-07,Imperial,025,180216,18949,17234,195,17429,364
2020-12-07,Inyo,027,18085,390,333,6,339,15
2020-12-07,Kern,029,883053,49294,44409,2445,46854,486
2020-12-07,Kings,031,150075,13482,12412,307,12719,90
2020-12-07,Lake,033,64148,1297,1090,0,1090,20
2020-12-07,Lassen,035,31185,3098,2167,15,2182,0
2020-12-07,Los Angeles,037,10098052,500578,451052,9628,460680,7937
2020-12-07,Madera,039,155013,7891,6935,233,7168,59
2020-12-07,Marin,041,260295,8411,8049,49,8098,136
2020-12-07,Mariposa,043,17540,176,146,2,148,2
2020-12-07,Mendocino,045,87422,1857,1638,14,1652,23
2020-12-07,Merced,047,269075,14315,13250,199,13449,179
2020-12-07,Modoc,049,8938,166,128,37,165,0
2020-12-07,Mono,051,14174,680,590,12,602,3
2020-12-07,Monterey,053,433212,19664,17746,391,18137,132
2020-12-07,Napa,055,140530,4277,3684,21,3705,21
2020-12-07,Nevada,057,99092,2052,1777,56,1833,11
2020-12-07,Orange,059,3164182,103339,89793,3298,93091,1628
2020-12-07,Placer,061,380077,10006,7911,273,8184,82
2020-12-07,Plumas,063,18699,326,256,5,261,0
2020-12-07,Riverside,065,2383286,119737,102363,3627,105990,1491
2020-12-07,Sacramento,067,1510023,48483,43419,247,43666,638
2020-12-07,San Benito,069,59416,2401,2165,15,2180,18
2020-12-07,San Bernardino,071,2135413,130253,108161,2877,111038,1295
2020-12-07,San Diego,073,3302833,104756,94171,4302,98473,1062
2020-12-07,San Francisco,075,870044,18396,17220,144,17364,161
2020-12-07,San Joaquin,077,732212,33107,28188,801,28989,530
2020-12-07,San Luis Obispo,079,281455,7791,6782,138,6920,45
2020-12-07,San Mateo,081,765935,18313,16029,22,16051,175
2020-12-07,Santa Barbara,083,443738,13258,12362,278,12640,141
2020-12-07,Santa Clara,085,1922200,48022,40621,142,40763,484
2020-12-07,Santa Cruz,087,273765,6146,5152,99,5251,41
2020-12-07,Shasta,089,179085,6755,5742,372,6114,50
2020-12-07,Sierra,091,2930,20,18,0,18,0
2020-12-07,Siskiyou,093,43540,818,652,62,714,2
2020-12-07,Solano,095,438530,13021,11354,114,11468,89
2020-12-07,Sonoma,097,501317,14808,13376,86,13462,164
2020-12-07,Stanislaus,099,539301,26672,24479,1934,26413,454
2020-12-07,Sutter,101,95872,4773,4106,20,4126,24
2020-12-07,Tehama,103,63373,2240,2030,120,2150,9
2020-12-07,Trinity,105,12862,335,194,41,235,0
2020-12-07,Tulare,107,460477,25773,22760,2247,25007,328
2020-12-07,Tuolumne,109,53932,1576,1256,7,1263,7
2020-12-07,Ventura,111,848112,26482,23354,843,24197,191
2020-12-07,Yolo,113,214977,6254,5537,27,5564,90
2020-12-07,Yuba,115,75493,2710,2428,21,2449,10
2020-12-06,Alameda,001,1643700,36785,33477,491,33968,465
2020-12-06,Alpine,003,1148,59,53,0,53,0
2020-12-06,Amador,005,37829,1223,952,6,958,17
2020-12-06,Butte,007,227075,5120,4527,344,4871,67
2020-12-06,Calaveras,009,45235,672,606,0,606,21
2020-12-06,Colusa,011,21464,963,824,21,845,6
2020-12-06,Contra Costa,013,1133247,29201,26566,235,26801,270
2020-12-06,Del Norte,015,27424,486,414,0,414,2
2020-12-06,El Dorado,017,186661,3911,3086,63,3149,8
2020-12-06,Fresno,019,978130,49523,40869,2173,43042,526
2020-12-06,Glenn,021,27897,1183,1067,97,1164,8
2020-12-06,Humboldt,023,135768,1221,1004,4,1008,9
2020-12-06,Imperial,025,180216,18638,16922,186,17108,364
2020-12-06,Inyo,027,18085,377,333,6,339,15
2020-12-06,Kern,029,883053,48305,43899,2275,46174,486
2020-12-06,Kings,031,150075,13210,12056,290,12346,90
2020-12-06,Lake,033,64148,1259,1075,0,1075,20
2020-12-06,Lassen,035,31185,2993,2168,13,2181,0
2020-12-06,Los Angeles,037,10098052,486992,443230,9181,452411,7910
2020-12-06,Madera,039,155013,7719,6826,224,7050,59
2020-12-06,Marin,041,260295,8330,8013,47,8060,136
2020-12-06,Mariposa,043,17540,175,144,2,146,2
2020-12-06,Mendocino,045,87422,1817,1614,14,1628,23
2020-12-06,Merced,047,269075,13980,12928,190,13118,179
2020-12-06,Modoc,049,8938,153,125,29,154,0
2020-12-06,Mono,051,14174,658,586,10,596,3
2020-12-06,Monterey,053,433212,19045,17426,381,17807,130
2020-12-06,Napa,055,140530,4165,3644,21,3665,21
2020-12-06,Nevada,057,99092,1993,1710,53,1763,10
2020-12-06,Orange,059,3164182,100272,87737,3168,90905,1627
2020-12-06,Placer,061,380077,9725,7837,252,8089,82
2020-12-06,Plumas,063,18699,313,254,4,258,0
2020-12-06,Riverside,065,2383286,116643,100088,3403,103491,1482
2020-12-06,Sacramento,067,1510023,47243,42808,231,43039,638
2020-12-06,San Benito,069,59416,2364,2135,15,2150,18
2020-12-06,San Bernardino,071,2135413,126105,106927,2720,109647,1286
2020-12-06,San Diego,073,3302833,101724,92173,4148,96321,1062
2020-12-06,San Francisco,075,870044,18074,17107,137,17244,161
2020-12-06,San Joaquin,077,732212,32273,28188,772,28960,530
2020-12-06,San Luis Obispo,079,281455,7625,6723,133,6856,45
2020-12-06,San Mateo,081,765935,17808,15855,19,15874,175
2020-12-06,Santa Barbara,083,443738,13026,12252,269,12521,141
2020-12-06,Santa Clara,085,1922200,46646,39112,136,39248,482
2020-12-06,Santa Cruz,087,273765,5972,5069,93,5162,40
2020-12-06,Shasta,089,179085,6614,5743,351,6094,49
2020-12-06,Sierra,091,2930,20,17,0,17,0
2020-12-06,Siskiyou,093,43540,800,652,60,712,2
2020-12-06,Solano,095,438530,12734,11354,104,11458,88
2020-12-06,Sonoma,097,501317,14519,13238,85,13323,164
2020-12-06,Stanislaus,099,539301,26119,24036,1870,25906,454
2020-12-06,Sutter,101,95872,4657,4009,19,4028,21
2020-12-06,Tehama,103,63373,2181,1982,111,2093,9
2020-12-06,Trinity,105,12862,328,181,39,220,0
2020-12-06,Tulare,107,460477,25247,22756,2178,24934,327
2020-12-06,Tuolumne,109,53932,1480,1210,7,1217,7
2020-12-06,Ventura,111,848112,25940,23035,816,23851,191
2020-12-06,Yolo,113,214977,6093,5465,22,5487,90
2020-12-06,Yuba,115,75493,2666,2340,20,2360,10
2020-12-05,Alameda,001,1643700,36426,32781,480,33261,465
2020-12-05,Alpine,003,1148,58,53,0,53,0
2020-12-05,Amador,005,37829,1199,847,6,853,17
2020-12-05,Butte,007,227075,5052,4455,325,4780,66
2020-12-05,Calaveras,009,45235,660,606,0,606,21
2020-12-05,Colusa,011,21464,945,825,18,843,6
2020-12-05,Contra Costa,013,1133247,28909,26217,228,26445,270
2020-12-05,Del Norte,015,27424,480,408,0,408,2
2020-12-05,El Dorado,017,186661,3846,3061,58,3119,8
2020-12-05,Fresno,019,978130,49204,40568,2118,42686,525
2020-12-05,Glenn,021,27897,1170,1056,91,1147,8
2020-12-05,Humboldt,023,135768,1188,979,4,983,9
2020-12-05,Imperial,025,180216,18472,16544,184,16728,362
2020-12-05,Inyo,027,18085,372,332,6,338,15
2020-12-05,Kern,029,883053,47841,43332,2190,45522,484
2020-12-05,Kings,031,150075,13129,11898,287,12185,90
2020-12-05,Lake,033,64148,1233,1069,0,1069,20
2020-12-05,Lassen,035,31185,2802,2168,11,2179,0
2020-12-05,Los Angeles,037,10098052,481193,433120,8862,441982,7888
2020-12-05,Madera,039,155013,7626,6619,217,6836,59
2020-12-05,Marin,041,260295,8303,7961,47,8008,136
2020-12-05,Mariposa,043,17540,170,143,2,145,2
2020-12-05,Mendocino,045,87422,1778,1585,14,1599,23
2020-12-05,Merced,047,269075,13873,12747,179,12926,180
2020-12-05,Modoc,049,8938,153,118,28,146,0
2020-12-05,Mono,051,14174,653,554,10,564,3
2020-12-05,Monterey,053,433212,18899,17077,377,17454,127
2020-12-05,Napa,055,140530,4094,3565,21,3586,21
2020-12-05,Nevada,057,99092,1978,1642,51,1693,10
2020-12-05,Orange,059,3164182,98814,85735,3072,88807,1612
2020-12-05,Placer,061,380077,9605,7811,243,8054,78
2020-12-05,Plumas,063,18699,306,246,1,247,0
2020-12-05,Riverside,065,2383286,115031,98612,3225,101837,1477
2020-12-05,Sacramento,067,1510023,46575,41878,216,42094,625
2020-12-05,San Benito,069,59416,2320,2073,15,2088,18
2020-12-05,San Bernardino,071,2135413,124581,105382,2591,107973,1283
2020-12-05,San Diego,073,3302833,100372,90470,4067,94537,1055
2020-12-05,San Francisco,075,870044,17890,16786,133,16919,161
2020-12-05,San Joaquin,077,732212,32009,28105,739,28844,523
2020-12-05,San Luis Obispo,079,281455,7558,6623,130,6753,44
2020-12-05,San Mateo,081,765935,17550,15512,19,15531,175
2020-12-05,Santa Barbara,083,443738,12926,12107,263,12370,141
2020-12-05,Santa Clara,085,1922200,45905,38339,131,38470,474
2020-12-05,Santa Cruz,087,273765,5898,4997,91,5088,40
2020-12-05,Shasta,089,179085,6553,5653,340,5993,49
2020-12-05,Sierra,091,2930,20,17,0,17,0
2020-12-05,Siskiyou,093,43540,792,649,59,708,2
2020-12-05,Solano,095,438530,12565,11351,102,11453,87
2020-12-05,Sonoma,097,501317,14423,13137,85,13222,164
2020-12-05,Stanislaus,099,539301,25806,23662,1835,25497,454
2020-12-05,Sutter,101,95872,4592,3937,19,3956,20
2020-12-05,Tehama,103,63373,2165,1926,109,2035,9
2020-12-05,Trinity,105,12862,327,177,39,216,0
2020-12-05,Tulare,107,460477,25031,22660,2120,24780,324
2020-12-05,Tuolumne,109,53932,1423,1180,7,1187,7
2020-12-05,Ventura,111,848112,25569,22710,802,23512,191
2020-12-05,Yolo,113,214977,6016,5351,21,5372,90
2020-12-05,Yuba,115,75493,2629,2275,20,2295,10
2020-12-04,Alameda,001,1643700,35879,31871,467,32338,465
2020-12-04,Alpine,003,1148,58,53,0,53,0
2020-12-04,Amador,005,37829,1185,766,3,769,16
2020-12-04,Butte,007,227075,4980,4336,305,4641,65
2020-12-04,Calaveras,009,45235,655,585,0,585,21
2020-12-04,Colusa,011,21464,931,790,17,807,6
2020-12-04,Contra Costa,013,1133247,28564,25705,216,25921,264
2020-12-04,Del Norte,015,27424,469,401,0,401,2
2020-12-04,El Dorado,017,186661,3758,2933,55,2988,7
2020-12-04,Fresno,019,978130,48495,40108,2050,42158,522
2020-12-04,Glenn,021,27897,1164,1017,83,1100,8
2020-12-04,Humboldt,023,135768,1170,960,4,964,9
2020-12-04,Imperial,025,180216,18230,16484,184,16668,362
2020-12-04,Inyo,027,18085,364,324,6,330,15
2020-12-04,Kern,029,883053,47290,42497,2087,44584,485
2020-12-04,Kings,031,150075,13036,11767,281,12048,88
2020-12-04,Lake,033,64148,1205,1018,0,1018,20
2020-12-04,Lassen,035,31185,2795,2167,10,2177,0
2020-12-04,Los Angeles,037,10098052,472576,424164,8563,432727,7845
2020-12-04,Madera,039,155013,7535,6479,214,6693,58
2020-12-04,Marin,041,260295,8252,7896,44,7940,136
2020-12-04,Mariposa,043,17540,170,136,2,138,2
2020-12-04,Mendocino,045,87422,1759,1563,13,1576,23
2020-12-04,Merced,047,269075,13758,12474,171,12645,177
2020-12-04,Modoc,049,8938,153,115,28,143,0
2020-12-04,Mono,051,14174,648,549,10,559,3
2020-12-04,Monterey,053,433212,18689,16737,368,17105,127
2020-12-04,Napa,055,140530,4040,3432,21,3453,19
2020-12-04,Nevada,057,99092,1953,1560,48,1608,10
2020-12-04,Orange,059,3164182,96893,83738,3007,86745,1597
2020-12-04,Placer,061,380077,9480,7461,229,7690,76
2020-12-04,Plumas,063,18699,299,232,0,232,0
2020-12-04,Riverside,065,2383286,112832,95255,3068,98323,1475
2020-12-04,Sacramento,067,1510023,45810,41061,199,41260,618
2020-12-04,San Benito,069,59416,2287,2006,15,2021,17
2020-12-04,San Bernardino,071,2135413,122308,102418,2483,104901,1290
2020-12-04,San Diego,073,3302833,98888,88183,3980,92163,1047
2020-12-04,San Francisco,075,870044,17699,16499,133,16632,161
2020-12-04,San Joaquin,077,732212,31571,27806,702,28508,522
2020-12-04,San Luis Obispo,079,281455,7473,6473,127,6600,42
2020-12-04,San Mateo,081,765935,17262,15112,18,15130,173
2020-12-04,Santa Barbara,083,443738,12820,11947,256,12203,141
2020-12-04,Santa Clara,085,1922200,44983,37465,125,37590,468
2020-12-04,Santa Cruz,087,273765,5811,4985,89,5074,32
2020-12-04,Shasta,089,179085,6465,5439,330,5769,49
2020-12-04,Sierra,091,2930,19,17,0,17,0
2020-12-04,Siskiyou,093,43540,785,639,56,695,2
2020-12-04,Solano,095,438530,12419,11037,99,11136,87
2020-12-04,Sonoma,097,501317,14275,12962,84,13046,164
2020-12-04,Stanislaus,099,539301,25536,23206,1790,24996,448
2020-12-04,Sutter,101,95872,4520,3791,14,3805,20
2020-12-04,Tehama,103,63373,2125,1876,104,1980,9
2020-12-04,Trinity,105,12862,325,172,39,211,0
2020-12-04,Tulare,107,460477,24748,22273,2048,24321,322
2020-12-04,Tuolumne,109,53932,1392,1134,7,1141,7
2020-12-04,Ventura,111,848112,25192,22024,785,22809,189
2020-12-04,Yolo,113,214977,5942,5294,20,5314,87
2020-12-04,Yuba,115,75493,2586,2225,19,2244,10
2020-12-03,Alameda,001,1643700,35113,31184,448,31632,465
2020-12-03,Alpine,003,1148,57,53,0,53,0
2020-12-03,Amador,005,37829,1134,653,3,656,16
2020-12-03,Butte,007,227075,4884,4305,286,4591,65
2020-12-03,Calaveras,009,45235,636,572,0,572,21
2020-12-03,Colusa,011,21464,918,774,17,791,6
2020-12-03,Contra Costa,013,1133247,28064,25464,209,25673,265
2020-12-03,Del Norte,015,27424,465,388,0,388,2
2020-12-03,El Dorado,017,186661,3632,2740,53,2793,6
2020-12-03,Fresno,019,978130,47742,39680,1978,41658,516
2020-12-03,Glenn,021,27897,1146,997,75,1072,8
2020-12-03,Humboldt,023,135768,1140,923,4,927,9
2020-12-03,Imperial,025,180216,18024,16436,172,16608,359
2020-12-03,Inyo,027,18085,361,321,6,327,15
2020-12-03,Kern,029,883053,46444,42062,1986,44048,483
2020-12-03,Kings,031,150075,12936,11658,269,11927,87
2020-12-03,Lake,033,64148,1190,991,0,991,20
2020-12-03,Lassen,035,31185,2755,2128,9,2137,0
2020-12-03,Los Angeles,037,10098052,462481,415805,8200,424005,7787
2020-12-03,Madera,039,155013,7412,6398,209,6607,58
2020-12-03,Marin,041,260295,8192,7861,40,7901,136
2020-12-03,Mariposa,043,17540,166,132,2,134,2
2020-12-03,Mendocino,045,87422,1742,1547,10,1557,23
2020-12-03,Merced,047,269075,13513,12310,163,12473,177
2020-12-03,Modoc,049,8938,151,114,28,142,0
2020-12-03,Mono,051,14174,626,527,10,537,3
2020-12-03,Monterey,053,433212,18227,16218,357,16575,125
2020-12-03,Napa,055,140530,3926,3360,21,3381,19
2020-12-03,Nevada,057,99092,1875,1472,47,1519,10
2020-12-03,Orange,059,3164182,94360,82187,2937,85124,1591
2020-12-03,Placer,061,380077,9278,7270,213,7483,73
2020-12-03,Plumas,063,18699,284,223,0,223,0
2020-12-03,Riverside,065,2383286,110068,92489,2906,95395,1461
2020-12-03,Sacramento,067,1510023,44751,40280,185,40465,614
2020-12-03,San Benito,069,59416,2241,1967,15,1982,16
2020-12-03,San Bernardino,071,2135413,118981,100787,2399,103186,1283
2020-12-03,San Diego,073,3302833,97073,86144,3862,90006,1040
2020-12-03,San Francisco,075,870044,17477,16236,132,16368,161
2020-12-03,San Joaquin,077,732212,30848,27239,657,27896,522
2020-12-03,San Luis Obispo,079,281455,7305,6388,126,6514,42
2020-12-03,San Mateo,081,765935,16909,14909,18,14927,173
2020-12-03,Santa Barbara,083,443738,12691,11829,250,12079,141
2020-12-03,Santa Clara,085,1922200,43787,36621,119,36740,465
2020-12-03,Santa Cruz,087,273765,5668,4850,85,4935,28
2020-12-03,Shasta,089,179085,6356,5330,323,5653,48
2020-12-03,Sierra,091,2930,19,17,0,17,0
2020-12-03,Siskiyou,093,43540,770,629,53,682,2
2020-12-03,Solano,095,438530,12205,10857,96,10953,87
2020-12-03,Sonoma,097,501317,14032,12772,83,12855,164
2020-12-03,Stanislaus,099,539301,25127,22821,1742,24563,447
2020-12-03,Sutter,101,95872,4436,3727,14,3741,20
2020-12-03,Tehama,103,63373,2073,1832,95,1927,9
2020-12-03,Trinity,105,12862,322,166,39,205,0
2020-12-03,Tulare,107,460477,24349,21993,1955,23948,321
2020-12-03,Tuolumne,109,53932,1350,1105,7,1112,7
2020-12-03,Ventura,111,848112,24489,21555,772,22327,187
2020-12-03,Yolo,113,214977,5804,5069,20,5089,87
2020-12-03,Yuba,115,75493,2516,2182,18,2200,10
2020-12-02,Alameda,001,1643700,34487,30697,438,31135,463
2020-12-02,Alpine,003,1148,56,52,0,52,0
2020-12-02,Amador,005,37829,1062,585,3,588,16
2020-12-02,Butte,007,227075,4761,4243,276,4519,65
2020-12-02,Calaveras,009,45235,620,553,0,553,21
2020-12-02,Colusa,011,21464,902,756,16,772,6
2020-12-02,Contra Costa,013,1133247,27605,25147,197,25344,264
2020-12-02,Del Norte,015,27424,451,384,0,384,2
2020-12-02,El Dorado,017,186661,3530,2638,49,2687,5
2020-12-02,Fresno,019,978130,46986,39324,1877,41201,507
2020-12-02,Glenn,021,27897,1129,995,67,1062,7
2020-12-02,Humboldt,023,135768,1114,899,4,903,9
2020-12-02,Imperial,025,180216,17602,16360,164,16524,356
2020-12-02,Inyo,027,18085,354,314,6,320,15
2020-12-02,Kern,029,883053,45547,41660,1889,43549,479
2020-12-02,Kings,031,150075,12583,11531,255,11786,86
2020-12-02,Lake,033,64148,1159,971,0,971,20
2020-12-02,Lassen,035,31185,2696,2115,9,2124,0
2020-12-02,Los Angeles,037,10098052,452434,408289,7861,416150,7739
2020-12-02,Madera,039,155013,7288,6370,203,6573,57
2020-12-02,Marin,041,260295,8145,7819,38,7857,136
2020-12-02,Mariposa,043,17540,163,131,2,133,2
2020-12-02,Mendocino,045,87422,1709,1524,10,1534,23
2020-12-02,Merced,047,269075,13270,12168,155,12323,173
2020-12-02,Modoc,049,8938,148,113,28,141,0
2020-12-02,Mono,051,14174,617,520,10,530,3
2020-12-02,Monterey,053,433212,17747,16064,318,16382,121
2020-12-02,Napa,055,140530,3823,3298,20,3318,19
2020-12-02,Nevada,057,99092,1813,1430,46,1476,9
2020-12-02,Orange,059,3164182,92163,81046,2857,83903,1569
2020-12-02,Placer,061,380077,9046,6941,199,7140,73
2020-12-02,Plumas,063,18699,271,218,0,218,0
2020-12-02,Riverside,065,2383286,107348,90089,2725,92814,1451
2020-12-02,Sacramento,067,1510023,43711,39334,174,39508,597
2020-12-02,San Benito,069,59416,2176,1921,15,1936,16
2020-12-02,San Bernardino,071,2135413,115409,98567,2291,100858,1240
2020-12-02,San Diego,073,3302833,95157,84640,3747,88387,1035
2020-12-02,San Francisco,075,870044,17241,16058,130,16188,157
2020-12-02,San Joaquin,077,732212,30227,26740,633,27373,519
2020-12-02,San Luis Obispo,079,281455,7206,6324,124,6448,42
2020-12-02,San Mateo,081,765935,16546,14757,17,14774,170
2020-12-02,Santa Barbara,083,443738,12540,11705,238,11943,140
2020-12-02,Santa Clara,085,1922200,42672,35878,119,35997,458
2020-12-02,Santa Cruz,087,273765,5536,4766,82,4848,27
2020-12-02,Shasta,089,179085,6233,5188,306,5494,47
2020-12-02,Sierra,091,2930,19,17,0,17,0
2020-12-02,Siskiyou,093,43540,754,624,51,675,1
2020-12-02,Solano,095,438530,11959,10701,92,10793,87
2020-12-02,Sonoma,097,501317,13793,12635,82,12717,163
2020-12-02,Stanislaus,099,539301,24626,22615,1687,24302,448
2020-12-02,Sutter,101,95872,4276,3604,14,3618,18
2020-12-02,Tehama,103,63373,2030,1800,80,1880,9
2020-12-02,Trinity,105,12862,312,165,38,203,0
2020-12-02,Tulare,107,460477,23969,21789,1876,23665,321
2020-12-02,Tuolumne,109,53932,1309,1076,7,1083,7
2020-12-02,Ventura,111,848112,24078,21208,754,21962,186
2020-12-02,Yolo,113,214977,5695,5053,19,5072,87
2020-12-02,Yuba,115,75493,2439,2119,17,2136,10
2020-12-01,Alameda,001,1643700,33797,30252,428,30680,460
2020-12-01,Alpine,003,1148,56,41,0,41,0
2020-12-01,Amador,005,37829,915,575,2,577,16
2020-12-01,Butte,007,227075,4655,4177,262,4439,65
2020-12-01,Calaveras,009,45235,602,544,0,544,21
2020-12-01,Colusa,011,21464,885,747,16,763,6
2020-12-01,Contra Costa,013,1133247,27033,24788,189,24977,264
2020-12-01,Del Norte,015,27424,423,357,0,357,2
2020-12-01,El Dorado,017,186661,3385,2542,44,2586,4
2020-12-01,Fresno,019,978130,46084,39004,1799,40803,505
2020-12-01,Glenn,021,27897,1108,989,62,1051,7
2020-12-01,Humboldt,023,135768,1084,886,4,890,9
2020-12-01,Imperial,025,180216,17286,16278,161,16439,356
2020-12-01,Inyo,027,18085,347,304,6,310,15
2020-12-01,Kern,029,883053,44744,41345,1758,43103,478
2020-12-01,Kings,031,150075,12268,11415,241,11656,86
2020-12-01,Lake,033,64148,1141,969,0,969,19
2020-12-01,Lassen,035,31185,2530,2047,8,2055,0
2020-12-01,Los Angeles,037,10098052,442068,403266,7535,410801,7704
2020-12-01,Madera,039,155013,7171,6270,193,6463,57
2020-12-01,Marin,041,260295,8075,7787,37,7824,136
2020-12-01,Mariposa,043,17540,158,128,2,130,2
2020-12-01,Mendocino,045,87422,1675,1497,10,1507,23
2020-12-01,Merced,047,269075,13027,12032,146,12178,172
2020-12-01,Modoc,049,8938,143,113,24,137,0
2020-12-01,Mono,051,14174,604,520,10,530,3
2020-12-01,Monterey,053,433212,17240,15835,307,16142,121
2020-12-01,Napa,055,140530,3739,3124,19,3143,19
2020-12-01,Nevada,057,99092,1751,1411,45,1456,9
2020-12-01,Orange,059,3164182,90064,79468,2769,82237,1567
2020-12-01,Placer,061,380077,8722,6794,192,6986,72
2020-12-01,Plumas,063,18699,259,201,0,201,0
2020-12-01,Riverside,065,2383286,104539,88530,2563,91093,1448
2020-12-01,Sacramento,067,1510023,42663,38966,170,39136,589
2020-12-01,San Benito,069,59416,2121,1888,15,1903,15
2020-12-01,San Bernardino,071,2135413,111935,95854,2167,98021,1220
2020-12-01,San Diego,073,3302833,92900,83423,3637,87060,1019
2020-12-01,San Francisco,075,870044,16958,15797,126,15923,157
2020-12-01,San Joaquin,077,732212,29427,26432,611,27043,514
2020-12-01,San Luis Obispo,079,281455,7064,6264,119,6383,40
2020-12-01,San Mateo,081,765935,16221,14495,17,14512,170
2020-12-01,Santa Barbara,083,443738,12401,11611,228,11839,140
2020-12-01,Santa Clara,085,1922200,41415,35397,113,35510,452
2020-12-01,Santa Cruz,087,273765,5378,4638,74,4712,27
2020-12-01,Shasta,089,179085,6108,5077,286,5363,47
2020-12-01,Sierra,091,2930,19,17,0,17,0
2020-12-01,Siskiyou,093,43540,740,608,47,655,1
2020-12-01,Solano,095,438530,11699,10604,87,10691,87
2020-12-01,Sonoma,097,501317,13588,12491,79,12570,163
2020-12-01,Stanislaus,099,539301,24169,22351,1630,23981,447
2020-12-01,Sutter,101,95872,4134,3538,14,3552,17
2020-12-01,Tehama,103,63373,1965,1773,70,1843,9
2020-12-01,Trinity,105,12862,298,165,32,197,0
2020-12-01,Tulare,107,460477,23514,21645,1807,23452,319
2020-12-01,Tuolumne,109,53932,1273,1052,5,1057,7
2020-12-01,Ventura,111,848112,23465,20604,732,21336,186
2020-12-01,Yolo,113,214977,5555,4928,19,4947,86
2020-12-01,Yuba,115,75493,2373,2088,16,2104,10
2020-11-30,Alameda,001,1643700,32979,29972,411,30383,457
2020-11-30,Alpine,003,1148,54,41,0,41,0
2020-11-30,Amador,005,37829,874,559,2,561,16
2020-11-30,Butte,007,227075,4537,4148,246,4394,65
2020-11-30,Calaveras,009,45235,580,478,0,478,21
2020-11-30,Colusa,011,21464,858,737,12,749,6
2020-11-30,Contra Costa,013,1133247,26450,24365,185,24550,264
2020-11-30,Del Norte,015,27424,400,339,0,339,2
2020-11-30,El Dorado,017,186661,3211,2488,39,2527,4
2020-11-30,Fresno,019,978130,44973,38712,1685,40397,500
2020-11-30,Glenn,021,27897,1085,954,57,1011,5
2020-11-30,Humboldt,023,135768,1037,870,4,874,9
2020-11-30,Imperial,025,180216,17032,16212,140,16352,356
2020-11-30,Inyo,027,18085,342,304,5,309,15
2020-11-30,Kern,029,883053,43981,40941,1622,42563,473
2020-11-30,Kings,031,150075,12120,11346,226,11572,85
2020-11-30,Lake,033,64148,1109,939,0,939,18
2020-11-30,Lassen,035,31185,2437,1793,8,1801,0
2020-11-30,Los Angeles,037,10098052,431403,396202,7201,403403,7658
2020-11-30,Madera,039,155013,7005,6210,179,6389,57
2020-11-30,Marin,041,260295,8032,7764,36,7800,136
2020-11-30,Mariposa,043,17540,151,123,2,125,2
2020-11-30,Mendocino,045,87422,1647,1482,10,1492,23
2020-11-30,Merced,047,269075,12752,11913,135,12048,172
2020-11-30,Modoc,049,8938,133,113,24,137,0
2020-11-30,Mono,051,14174,582,519,10,529,3
2020-11-30,Monterey,053,433212,16809,15837,299,16136,119
2020-11-30,Napa,055,140530,3639,3091,19,3110,18
2020-11-30,Nevada,057,99092,1665,1347,42,1389,9
2020-11-30,Orange,059,3164182,87953,78711,2673,81384,1568
2020-11-30,Placer,061,380077,8427,6575,179,6754,72
2020-11-30,Plumas,063,18699,248,192,0,192,0
2020-11-30,Riverside,065,2383286,101545,87722,2416,90138,1446
2020-11-30,Sacramento,067,1510023,41583,37834,161,37995,586
2020-11-30,San Benito,069,59416,2074,1875,14,1889,15
2020-11-30,San Bernardino,071,2135413,108203,92704,2055,94759,1220
2020-11-30,San Diego,073,3302833,90537,82045,3510,85555,997
2020-11-30,San Francisco,075,870044,16658,15638,123,15761,157
2020-11-30,San Joaquin,077,732212,28721,25742,585,26327,509
2020-11-30,San Luis Obispo,079,281455,6930,6224,117,6341,36
2020-11-30,San Mateo,081,765935,15861,14276,17,14293,170
2020-11-30,Santa Barbara,083,443738,12223,11572,220,11792,140
2020-11-30,Santa Clara,085,1922200,40207,35019,112,35131,451
2020-11-30,Santa Cruz,087,273765,5240,4558,70,4628,26
2020-11-30,Shasta,089,179085,5963,4933,257,5190,44
2020-11-30,Sierra,091,2930,19,16,0,16,0
2020-11-30,Siskiyou,093,43540,731,605,43,648,1
2020-11-30,Solano,095,438530,11437,10392,82,10474,87
2020-11-30,Sonoma,097,501317,13343,12232,75,12307,163
2020-11-30,Stanislaus,099,539301,23707,22110,1586,23696,446
2020-11-30,Sutter,101,95872,3977,3430,13,3443,16
2020-11-30,Tehama,103,63373,1918,1724,64,1788,9
2020-11-30,Trinity,105,12862,292,162,32,194,0
2020-11-30,Tulare,107,460477,23127,20833,1712,22545,319
2020-11-30,Tuolumne,109,53932,1229,1027,5,1032,7
2020-11-30,Ventura,111,848112,22709,20308,716,21024,180
2020-11-30,Yolo,113,214977,5443,4894,19,4913,81
2020-11-30,Yuba,115,75493,2312,2028,14,2042,10
2020-11-29,Alameda,001,1643700,32194,29918,389,30307,457
2020-11-29,Alpine,003,1148,51,41,0,41,0
2020-11-29,Amador,005,37829,723,548,2,550,16
2020-11-29,Butte,007,227075,4435,4008,229,4237,65
2020-11-29,Calaveras,009,45235,548,478,0,478,21
2020-11-29,Colusa,011,21464,829,723,8,731,6
2020-11-29,Contra Costa,013,1133247,25948,24165,179,24344,264
2020-11-29,Del Norte,015,27424,394,339,0,339,2
2020-11-29,El Dorado,017,186661,3080,2447,38,2485,4
2020-11-29,Fresno,019,978130,44021,38568,1613,40181,500
2020-11-29,Glenn,021,27897,1062,951,55,1006,4
2020-11-29,Humboldt,023,135768,1008,856,4,860,9
2020-11-29,Imperial,025,180216,16803,16138,112,16250,356
2020-11-29,Inyo,027,18085,327,289,5,294,15
2020-11-29,Kern,029,883053,43218,40596,1474,42070,473
2020-11-29,Kings,031,150075,11969,11247,208,11455,85
2020-11-29,Lake,033,64148,1085,927,0,927,18
2020-11-29,Lassen,035,31185,2334,1793,8,1801,0
2020-11-29,Los Angeles,037,10098052,420999,391162,6902,398064,7642
2020-11-29,Madera,039,155013,6862,6184,173,6357,57
2020-11-29,Marin,041,260295,7966,7739,33,7772,135
2020-11-29,Mariposa,043,17540,147,123,2,125,2
2020-11-29,Mendocino,045,87422,1613,1473,10,1483,23
2020-11-29,Merced,047,269075,12513,11773,126,11899,172
2020-11-29,Modoc,049,8938,129,105,22,127,0
2020-11-29,Mono,051,14174,559,515,9,524,3
2020-11-29,Monterey,053,433212,16497,15621,292,15913,119
2020-11-29,Napa,055,140530,3534,3090,18,3108,18
2020-11-29,Nevada,057,99092,1584,1311,40,1351,9
2020-11-29,Orange,059,3164182,85934,78057,2626,80683,1567
2020-11-29,Placer,061,380077,8130,6535,167,6702,72
2020-11-29,Plumas,063,18699,243,191,0,191,0
2020-11-29,Riverside,065,2383286,99152,87383,2263,89646,1442
2020-11-29,Sacramento,067,1510023,40504,37415,152,37567,585
2020-11-29,San Benito,069,59416,2030,1860,14,1874,15
2020-11-29,San Bernardino,071,2135413,104848,92052,1939,93991,1223
2020-11-29,San Diego,073,3302833,88126,81086,3357,84443,997
2020-11-29,San Francisco,075,870044,16377,15571,116,15687,153
2020-11-29,San Joaquin,077,732212,27979,25740,579,26319,509
2020-11-29,San Luis Obispo,079,281455,6807,6145,117,6262,36
2020-11-29,San Mateo,081,765935,15528,14177,17,14194,169
2020-11-29,Santa Barbara,083,443738,12068,11520,216,11736,140
2020-11-29,Santa Clara,085,1922200,39002,34234,106,34340,451
2020-11-29,Santa Cruz,087,273765,5081,4490,68,4558,26
2020-11-29,Shasta,089,179085,5791,4935,229,5164,43
2020-11-29,Sierra,091,2930,19,16,0,16,0
2020-11-29,Siskiyou,093,43540,708,590,41,631,1
2020-11-29,Solano,095,438530,11205,10393,78,10471,87
2020-11-29,Sonoma,097,501317,13091,12052,71,12123,163
2020-11-29,Stanislaus,099,539301,23211,21701,1552,23253,446
2020-11-29,Sutter,101,95872,3862,3297,13,3310,16
2020-11-29,Tehama,103,63373,1868,1710,48,1758,9
2020-11-29,Trinity,105,12862,289,159,30,189,0
2020-11-29,Tulare,107,460477,22758,20793,1636,22429,319
2020-11-29,Tuolumne,109,53932,1192,988,5,993,7
2020-11-29,Ventura,111,848112,22024,19952,703,20655,179
2020-11-29,Yolo,113,214977,5305,4830,18,4848,80
2020-11-29,Yuba,115,75493,2256,1959,14,1973,10
2020-11-28,Alameda,001,1643700,31884,29368,384,29752,456
2020-11-28,Alpine,003,1148,51,41,0,41,0
2020-11-28,Amador,005,37829,646,536,2,538,16
2020-11-28,Butte,007,227075,4377,3894,225,4119,65
2020-11-28,Calaveras,009,45235,544,478,0,478,21
2020-11-28,Colusa,011,21464,820,711,6,717,6
2020-11-28,Contra Costa,013,1133247,25615,23798,175,23973,264
2020-11-28,Del Norte,015,27424,384,328,0,328,2
2020-11-28,El Dorado,017,186661,3012,2415,32,2447,4
2020-11-28,Fresno,019,978130,43673,38288,1574,39862,500
2020-11-28,Glenn,021,27897,1051,925,51,976,4
2020-11-28,Humboldt,023,135768,973,844,4,848,9
2020-11-28,Imperial,025,180216,16738,16019,110,16129,356
2020-11-28,Inyo,027,18085,319,289,5,294,15
2020-11-28,Kern,029,883053,42855,40255,1386,41641,473
2020-11-28,Kings,031,150075,11904,11070,201,11271,85
2020-11-28,Lake,033,64148,1070,920,0,920,18
2020-11-28,Lassen,035,31185,2267,1714,8,1722,0
2020-11-28,Los Angeles,037,10098052,416083,386194,6744,392938,7625
2020-11-28,Madera,039,155013,6760,6119,166,6285,57
2020-11-28,Marin,041,260295,7936,7696,29,7725,135
2020-11-28,Mariposa,043,17540,144,120,2,122,2
2020-11-28,Mendocino,045,87422,1582,1458,10,1468,22
2020-11-28,Merced,047,269075,12415,11688,120,11808,172
2020-11-28,Modoc,049,8938,126,103,22,125,0
2020-11-28,Mono,051,14174,553,505,9,514,3
2020-11-28,Monterey,053,433212,16331,15328,288,15616,118
2020-11-28,Napa,055,140530,3482,3033,18,3051,18
2020-11-28,Nevada,057,99092,1556,1272,38,1310,9
2020-11-28,Orange,059,3164182,84837,76882,2579,79461,1568
2020-11-28,Placer,061,380077,7968,6497,164,6661,70
2020-11-28,Plumas,063,18699,236,188,0,188,0
2020-11-28,Riverside,065,2383286,97742,86854,2161,89015,1440
2020-11-28,Sacramento,067,1510023,39926,36905,148,37053,580
2020-11-28,San Benito,069,59416,1983,1835,14,1849,15
2020-11-28,San Bernardino,071,2135413,103449,91183,1841,93024,1224
2020-11-28,San Diego,073,3302833,86872,80020,3273,83293,997
2020-11-28,San Francisco,075,870044,16201,15450,108,15558,153
2020-11-28,San Joaquin,077,732212,27780,25742,564,26306,509
2020-11-28,San Luis Obispo,079,281455,6737,6106,113,6219,36
2020-11-28,San Mateo,081,765935,15337,14040,17,14057,169
2020-11-28,Santa Barbara,083,443738,11966,11481,211,11692,140
2020-11-28,Santa Clara,085,1922200,38258,33701,104,33805,449
2020-11-28,Santa Cruz,087,273765,5004,4426,68,4494,26
2020-11-28,Shasta,089,179085,5714,4882,222,5104,43
2020-11-28,Sierra,091,2930,19,16,0,16,0
2020-11-28,Siskiyou,093,43540,698,558,38,596,1
2020-11-28,Solano,095,438530,11086,10252,76,10328,87
2020-11-28,Sonoma,097,501317,12987,12008,62,12070,162
2020-11-28,Stanislaus,099,539301,22972,21574,1517,23091,446
2020-11-28,Sutter,101,95872,3778,3244,13,3257,15
2020-11-28,Tehama,103,63373,1851,1678,44,1722,9
2020-11-28,Trinity,105,12862,286,157,28,185,0
2020-11-28,Tulare,107,460477,22562,20701,1594,22295,319
2020-11-28,Tuolumne,109,53932,1170,976,5,981,7
2020-11-28,Ventura,111,848112,21726,19510,693,20203,179
2020-11-28,Yolo,113,214977,5231,4739,16,4755,80
2020-11-28,Yuba,115,75493,2203,1912,14,1926,10
2020-11-27,Alameda,001,1643700,31445,29064,373,29437,450
2020-11-27,Alpine,003,1148,51,41,0,41,0
2020-11-27,Amador,005,37829,599,498,1,499,16
2020-11-27,Butte,007,227075,4336,3894,219,4113,65
2020-11-27,Calaveras,009,45235,535,478,0,478,21
2020-11-27,Colusa,011,21464,803,694,4,698,6
2020-11-27,Contra Costa,013,1133247,25355,23463,169,23632,264
2020-11-27,Del Norte,015,27424,378,307,0,307,2
2020-11-27,El Dorado,017,186661,2941,2238,29,2267,4
2020-11-27,Fresno,019,978130,43267,37994,1516,39510,500
2020-11-27,Glenn,021,27897,1038,891,46,937,4
2020-11-27,Humboldt,023,135768,954,795,3,798,9
2020-11-27,Imperial,025,180216,16670,15960,101,16061,356
2020-11-27,Inyo,027,18085,313,289,5,294,15
2020-11-27,Kern,029,883053,42431,39707,1316,41023,473
2020-11-27,Kings,031,150075,11818,10667,183,10850,85
2020-11-27,Lake,033,64148,1034,909,0,909,18
2020-11-27,Lassen,035,31185,2255,1714,8,1722,0
2020-11-27,Los Angeles,037,10098052,409577,382740,6588,389328,7606
2020-11-27,Madera,039,155013,6688,6050,160,6210,57
2020-11-27,Marin,041,260295,7893,7660,29,7689,135
2020-11-27,Mariposa,043,17540,142,118,2,120,2
2020-11-27,Mendocino,045,87422,1568,1387,9,1396,22
2020-11-27,Merced,047,269075,12309,11550,113,11663,172
2020-11-27,Modoc,049,8938,125,100,22,122,0
2020-11-27,Mono,051,14174,549,498,9,507,3
2020-11-27,Monterey,053,433212,16163,14753,288,15041,113
2020-11-27,Napa,055,140530,3442,2988,18,3006,18
2020-11-27,Nevada,057,99092,1526,1184,36,1220,9
2020-11-27,Orange,059,3164182,83548,75151,2540,77691,1568
2020-11-27,Placer,061,380077,7807,6283,154,6437,68
2020-11-27,Plumas,063,18699,233,188,0,188,0
2020-11-27,Riverside,065,2383286,96131,85769,2008,87777,1440
2020-11-27,Sacramento,067,1510023,39304,36579,144,36723,579
2020-11-27,San Benito,069,59416,1949,1805,13,1818,15
2020-11-27,San Bernardino,071,2135413,101939,90254,1760,92014,1224
2020-11-27,San Diego,073,3302833,85678,78161,3184,81345,996
2020-11-27,San Francisco,075,870044,16045,15377,106,15483,153
2020-11-27,San Joaquin,077,732212,27559,25741,544,26285,509
2020-11-27,San Luis Obispo,079,281455,6654,6039,110,6149,36
2020-11-27,San Mateo,081,765935,15134,13872,16,13888,169
2020-11-27,Santa Barbara,083,443738,11873,11340,208,11548,140
2020-11-27,Santa Clara,085,1922200,37582,32935,97,33032,449
2020-11-27,Santa Cruz,087,273765,4933,4358,66,4424,26
2020-11-27,Shasta,089,179085,5637,4710,209,4919,43
2020-11-27,Sierra,091,2930,18,16,0,16,0
2020-11-27,Siskiyou,093,43540,683,554,35,589,1
2020-11-27,Solano,095,438530,10967,10044,73,10117,87
2020-11-27,Sonoma,097,501317,12854,11924,60,11984,162
2020-11-27,Stanislaus,099,539301,22744,21185,1487,22672,446
2020-11-27,Sutter,101,95872,3712,3101,13,3114,15
2020-11-27,Tehama,103,63373,1822,1649,40,1689,9
2020-11-27,Trinity,105,12862,282,151,28,179,0
2020-11-27,Tulare,107,460477,22374,20634,1537,22171,319
2020-11-27,Tuolumne,109,53932,1138,881,5,886,7
2020-11-27,Ventura,111,848112,21402,19379,671,20050,179
2020-11-27,Yolo,113,214977,5182,4737,16,4753,79
2020-11-27,Yuba,115,75493,2174,1864,13,1877,10
2020-11-26,Alameda,001,1643700,31034,28797,354,29151,447
2020-11-26,Alpine,003,1148,51,41,0,41,0
2020-11-26,Amador,005,37829,591,488,1,489,16
2020-11-26,Butte,007,227075,4273,3894,213,4107,65
2020-11-26,Calaveras,009,45235,507,478,0,478,21
2020-11-26,Colusa,011,21464,789,694,4,698,6
2020-11-26,Contra Costa,013,1133247,25021,23468,163,23631,264
2020-11-26,Del Norte,015,27424,367,307,0,307,2
2020-11-26,El Dorado,017,186661,2860,2217,27,2244,4
2020-11-26,Fresno,019,978130,42861,37724,1471,39195,500
2020-11-26,Glenn,021,27897,1022,892,44,936,4
2020-11-26,Humboldt,023,135768,931,795,2,797,9
2020-11-26,Imperial,025,180216,16561,15722,97,15819,355
2020-11-26,Inyo,027,18085,312,289,5,294,15
2020-11-26,Kern,029,883053,41981,39123,1254,40377,471
2020-11-26,Kings,031,150075,11763,10475,171,10646,85
2020-11-26,Lake,033,64148,1021,890,0,890,18
2020-11-26,Lassen,035,31185,2240,1714,8,1722,0
2020-11-26,Los Angeles,037,10098052,404423,378340,6352,384692,7581
2020-11-26,Madera,039,155013,6613,6003,154,6157,57
2020-11-26,Marin,041,260295,7856,7610,29,7639,135
2020-11-26,Mariposa,043,17540,137,116,2,118,2
2020-11-26,Mendocino,045,87422,1554,1387,7,1394,22
2020-11-26,Merced,047,269075,12161,11440,111,11551,172
2020-11-26,Modoc,049,8938,123,100,22,122,0
2020-11-26,Mono,051,14174,541,485,9,494,2
2020-11-26,Monterey,053,433212,15927,14750,280,15030,113
2020-11-26,Napa,055,140530,3378,2988,18,3006,18
2020-11-26,Nevada,057,99092,1480,1184,36,1220,9
2020-11-26,Orange,059,3164182,82160,74264,2478,76742,1563
2020-11-26,Placer,061,380077,7645,6278,145,6423,68
2020-11-26,Plumas,063,18699,225,188,0,188,0
2020-11-26,Riverside,065,2383286,94527,85774,1884,87658,1440
2020-11-26,Sacramento,067,1510023,38662,35854,136,35990,580
2020-11-26,San Benito,069,59416,1922,1769,13,1782,15
2020-11-26,San Bernardino,071,2135413,100291,89727,1668,91395,1223
2020-11-26,San Diego,073,3302833,84068,76359,3080,79439,996
2020-11-26,San Francisco,075,870044,15908,15156,103,15259,153
2020-11-26,San Joaquin,077,732212,27303,25738,532,26270,509
2020-11-26,San Luis Obispo,079,281455,6561,5964,107,6071,36
2020-11-26,San Mateo,081,765935,14945,13715,15,13730,169
2020-11-26,Santa Barbara,083,443738,11792,11277,207,11484,139
2020-11-26,Santa Clara,085,1922200,36940,32411,89,32500,446
2020-11-26,Santa Cruz,087,273765,4802,4269,60,4329,26
2020-11-26,Shasta,089,179085,5554,4712,198,4910,43
2020-11-26,Sierra,091,2930,18,15,0,15,0
2020-11-26,Siskiyou,093,43540,673,526,34,560,1
2020-11-26,Solano,095,438530,10824,9941,71,10012,87
2020-11-26,Sonoma,097,501317,12706,11922,58,11980,162
2020-11-26,Stanislaus,099,539301,22511,21186,1446,22632,445
2020-11-26,Sutter,101,95872,3618,3101,12,3113,15
2020-11-26,Tehama,103,63373,1780,1612,37,1649,9
2020-11-26,Trinity,105,12862,278,139,28,167,0
2020-11-26,Tulare,107,460477,22135,20649,1473,22122,319
2020-11-26,Tuolumne,109,53932,1110,871,5,876,7
2020-11-26,Ventura,111,848112,20906,19058,657,19715,179
2020-11-26,Yolo,113,214977,5095,4566,16,4582,76
2020-11-26,Yuba,115,75493,2114,1865,11,1876,10
2020-11-25,Alameda,001,1643700,30819,28378,346,28724,447
2020-11-25,Alpine,003,1148,51,41,0,41,0
2020-11-25,Amador,005,37829,581,484,1,485,16
2020-11-25,Butte,007,227075,4242,3848,210,4058,64
2020-11-25,Calaveras,009,45235,504,475,0,475,21
2020-11-25,Colusa,011,21464,772,693,4,697,6
2020-11-25,Contra Costa,013,1133247,24866,23307,162,23469,263
2020-11-25,Del Norte,015,27424,366,304,0,304,2
2020-11-25,El Dorado,017,186661,2824,2154,27,2181,4
2020-11-25,Fresno,019,978130,42628,37349,1449,38798,494
2020-11-25,Glenn,021,27897,1005,891,42,933,4
2020-11-25,Humboldt,023,135768,923,777,2,779,9
2020-11-25,Imperial,025,180216,16491,15640,95,15735,355
2020-11-25,Inyo,027,18085,310,289,5,294,15
2020-11-25,Kern,029,883053,41825,38878,1235,40113,467
2020-11-25,Kings,031,150075,11728,10417,167,10584,85
2020-11-25,Lake,033,64148,1004,878,0,878,18
2020-11-25,Lassen,035,31185,2197,1701,8,1709,0
2020-11-25,Los Angeles,037,10098052,401393,373919,6249,380168,7545
2020-11-25,Madera,039,155013,6591,5989,151,6140,57
2020-11-25,Marin,041,260295,7829,7601,28,7629,135
2020-11-25,Mariposa,043,17540,136,114,2,116,2
2020-11-25,Mendocino,045,87422,1535,1373,7,1380,22
2020-11-25,Merced,047,269075,12103,11346,111,11457,172
2020-11-25,Modoc,049,8938,123,96,22,118,0
2020-11-25,Mono,051,14174,536,487,9,496,2
2020-11-25,Monterey,053,433212,15810,14695,278,14973,113
2020-11-25,Napa,055,140530,3345,2945,18,2963,17
2020-11-25,Nevada,057,99092,1462,1170,34,1204,9
2020-11-25,Orange,059,3164182,81405,73014,2458,75472,1551
2020-11-25,Placer,061,380077,7569,6221,144,6365,68
2020-11-25,Plumas,063,18699,220,183,0,183,0
2020-11-25,Riverside,065,2383286,93983,85077,1866,86943,1438
2020-11-25,Sacramento,067,1510023,38326,35687,133,35820,574
2020-11-25,San Benito,069,59416,1899,1764,13,1777,15
2020-11-25,San Bernardino,071,2135413,99451,88469,1640,90109,1225
2020-11-25,San Diego,073,3302833,83411,75307,3044,78351,988
2020-11-25,San Francisco,075,870044,15803,15053,101,15154,153
2020-11-25,San Joaquin,077,732212,27176,25556,520,26076,515
2020-11-25,San Luis Obispo,079,281455,6518,5913,106,6019,34
2020-11-25,San Mateo,081,765935,14830,13614,15,13629,170
2020-11-25,Santa Barbara,083,443738,11742,11183,207,11390,138
2020-11-25,Santa Clara,085,1922200,36494,32032,88,32120,442
2020-11-25,Santa Cruz,087,273765,4750,4202,59,4261,25
2020-11-25,Shasta,089,179085,5508,4588,191,4779,43
2020-11-25,Sierra,091,2930,18,15,0,15,0
2020-11-25,Siskiyou,093,43540,666,499,34,533,1
2020-11-25,Solano,095,438530,10719,9832,70,9902,87
2020-11-25,Sonoma,097,501317,12643,11775,57,11832,162
2020-11-25,Stanislaus,099,539301,22380,21022,1419,22441,445
2020-11-25,Sutter,101,95872,3574,3064,12,3076,14
2020-11-25,Tehama,103,63373,1768,1587,32,1619,9
2020-11-25,Trinity,105,12862,276,135,28,163,0
2020-11-25,Tulare,107,460477,22045,20528,1442,21970,318
2020-11-25,Tuolumne,109,53932,1093,842,5,847,7
2020-11-25,Ventura,111,848112,20811,18914,651,19565,179
2020-11-25,Yolo,113,214977,5059,4527,16,4543,76
2020-11-25,Yuba,115,75493,2088,1840,11,1851,10
2020-11-24,Alameda,001,1643700,30340,28030,335,28365,444
2020-11-24,Alpine,003,1148,51,41,0,41,0
2020-11-24,Amador,005,37829,556,470,1,471,16
2020-11-24,Butte,007,227075,4157,3798,202,4000,63
2020-11-24,Calaveras,009,45235,497,466,0,466,21
2020-11-24,Colusa,011,21464,754,682,4,686,6
2020-11-24,Contra Costa,013,1133247,24513,23072,156,23228,259
2020-11-24,Del Norte,015,27424,357,298,0,298,2
2020-11-24,El Dorado,017,186661,2719,2005,26,2031,4
2020-11-24,Fresno,019,978130,42225,37021,1373,38394,493
2020-11-24,Glenn,021,27897,987,883,38,921,4
2020-11-24,Humboldt,023,135768,904,774,2,776,9
2020-11-24,Imperial,025,180216,16388,15600,90,15690,355
2020-11-24,Inyo,027,18085,309,282,5,287,15
2020-11-24,Kern,029,883053,41351,38551,1157,39708,465
2020-11-24,Kings,031,150075,11461,10338,154,10492,85
2020-11-24,Lake,033,64148,988,872,0,872,18
2020-11-24,Lassen,035,31185,2174,1657,8,1665,0
2020-11-24,Los Angeles,037,10098052,395083,370008,6012,376020,7501
2020-11-24,Madera,039,155013,6506,5881,145,6026,57
2020-11-24,Marin,041,260295,7782,7591,28,7619,135
2020-11-24,Mariposa,043,17540,126,114,1,115,2
2020-11-24,Mendocino,045,87422,1513,1346,6,1352,22
2020-11-24,Merced,047,269075,11914,11268,105,11373,171
2020-11-24,Modoc,049,8938,119,91,22,113,0
2020-11-24,Mono,051,14174,532,483,9,492,2
2020-11-24,Monterey,053,433212,15549,14354,266,14620,113
2020-11-24,Napa,055,140530,3279,2904,18,2922,17
2020-11-24,Nevada,057,99092,1398,1156,32,1188,9
2020-11-24,Orange,059,3164182,79962,71975,2378,74353,1547
2020-11-24,Placer,061,380077,7388,6147,137,6284,67
2020-11-24,Plumas,063,18699,217,180,0,180,0
2020-11-24,Riverside,065,2383286,92224,83685,1737,85422,1420
2020-11-24,Sacramento,067,1510023,37646,35097,126,35223,568
2020-11-24,San Benito,069,59416,1867,1740,12,1752,15
2020-11-24,San Bernardino,071,2135413,97114,86645,1539,88184,1226
2020-11-24,San Diego,073,3302833,82001,74363,2973,77336,984
2020-11-24,San Francisco,075,870044,15608,14874,97,14971,153
2020-11-24,San Joaquin,077,732212,26860,25318,492,25810,517
2020-11-24,San Luis Obispo,079,281455,6455,5805,105,5910,34
2020-11-24,San Mateo,081,765935,14621,13558,14,13572,170
2020-11-24,Santa Barbara,083,443738,11636,11154,205,11359,138
2020-11-24,Santa Clara,085,1922200,35703,31564,84,31648,438
2020-11-24,Santa Cruz,087,273765,4637,4132,58,4190,25
2020-11-24,Shasta,089,179085,5408,4410,172,4582,43
2020-11-24,Sierra,091,2930,18,15,0,15,0
2020-11-24,Siskiyou,093,43540,648,473,31,504,1
2020-11-24,Solano,095,438530,10548,9716,69,9785,86
2020-11-24,Sonoma,097,501317,12463,11644,54,11698,162
2020-11-24,Stanislaus,099,539301,22138,20830,1376,22206,438
2020-11-24,Sutter,101,95872,3468,2974,12,2986,14
2020-11-24,Tehama,103,63373,1718,1565,27,1592,9
2020-11-24,Trinity,105,12862,269,129,27,156,0
2020-11-24,Tulare,107,460477,21796,20319,1378,21697,315
2020-11-24,Tuolumne,109,53932,1064,832,5,837,7
2020-11-24,Ventura,111,848112,20429,18637,641,19278,179
2020-11-24,Yolo,113,214977,4975,4420,16,4436,76
2020-11-24,Yuba,115,75493,2037,1804,9,1813,10
2020-11-23,Alameda,001,1643700,29924,27718,323,28041,444
2020-11-23,Alpine,003,1148,49,41,0,41,0
2020-11-23,Amador,005,37829,515,457,1,458,16
2020-11-23,Butte,007,227075,4093,3765,196,3961,61
2020-11-23,Calaveras,009,45235,480,434,0,434,21
2020-11-23,Colusa,011,21464,740,662,4,666,6
2020-11-23,Contra Costa,013,1133247,24241,22674,151,22825,260
2020-11-23,Del Norte,015,27424,335,296,0,296,2
2020-11-23,El Dorado,017,186661,2599,2005,25,2030,4
2020-11-23,Fresno,019,978130,41776,36688,1310,37998,488
2020-11-23,Glenn,021,27897,961,853,38,891,4
2020-11-23,Humboldt,023,135768,891,746,2,748,9
2020-11-23,Imperial,025,180216,16218,15104,85,15189,355
2020-11-23,Inyo,027,18085,301,279,5,284,15
2020-11-23,Kern,029,883053,40838,38245,1094,39339,463
2020-11-23,Kings,031,150075,11041,10204,147,10351,85
2020-11-23,Lake,033,64148,965,840,0,840,18
2020-11-23,Lassen,035,31185,2094,1271,7,1278,0
2020-11-23,Los Angeles,037,10098052,388986,366374,5762,372136,7447
2020-11-23,Madera,039,155013,6380,5787,141,5928,56
2020-11-23,Marin,041,260295,7740,7543,28,7571,135
2020-11-23,Mariposa,043,17540,125,97,1,98,2
2020-11-23,Mendocino,045,87422,1483,1330,6,1336,22
2020-11-23,Merced,047,269075,11726,11148,102,11250,169
2020-11-23,Modoc,049,8938,105,91,21,112,0
2020-11-23,Mono,051,14174,519,480,9,489,2
2020-11-23,Monterey,053,433212,15270,14265,260,14525,112
2020-11-23,Napa,055,140530,3213,2811,17,2828,17
2020-11-23,Nevada,057,99092,1309,1087,32,1119,9
2020-11-23,Orange,059,3164182,78559,71074,2332,73406,1546
2020-11-23,Placer,061,380077,7186,5999,136,6135,66
2020-11-23,Plumas,063,18699,213,172,0,172,0
2020-11-23,Riverside,065,2383286,90445,82175,1672,83847,1415
2020-11-23,Sacramento,067,1510023,37076,34141,119,34260,556
2020-11-23,San Benito,069,59416,1839,1729,11,1740,15
2020-11-23,San Bernardino,071,2135413,95006,84387,1476,85863,1224
2020-11-23,San Diego,073,3302833,80539,72817,2885,75702,968
2020-11-23,San Francisco,075,870044,15450,14646,95,14741,153
2020-11-23,San Joaquin,077,732212,26511,24622,488,25110,517
2020-11-23,San Luis Obispo,079,281455,6373,5772,103,5875,34
2020-11-23,San Mateo,081,765935,14429,13364,14,13378,170
2020-11-23,Santa Barbara,083,443738,11529,10944,201,11145,137
2020-11-23,Santa Clara,085,1922200,35053,31064,81,31145,435
2020-11-23,Santa Cruz,087,273765,4527,4003,54,4057,25
2020-11-23,Shasta,089,179085,5290,4100,160,4260,43
2020-11-23,Sierra,091,2930,17,15,0,15,0
2020-11-23,Siskiyou,093,43540,621,460,30,490,0
2020-11-23,Solano,095,438530,10391,9394,66,9460,86
2020-11-23,Sonoma,097,501317,12290,11507,50,11557,160
2020-11-23,Stanislaus,099,539301,21845,20487,1343,21830,436
2020-11-23,Sutter,101,95872,3331,2840,11,2851,14
2020-11-23,Tehama,103,63373,1670,1526,24,1550,9
2020-11-23,Trinity,105,12862,260,120,25,145,0
2020-11-23,Tulare,107,460477,21502,19818,1312,21130,315
2020-11-23,Tuolumne,109,53932,1024,774,5,779,7
2020-11-23,Ventura,111,848112,20054,18480,628,19108,179
2020-11-23,Yolo,113,214977,4895,4265,15,4280,75
2020-11-23,Yuba,115,75493,1970,1702,9,1711,10
2020-11-22,Alameda,001,1643700,29487,27472,312,27784,444
2020-11-22,Alpine,003,1148,46,41,0,41,0
2020-11-22,Amador,005,37829,503,450,1,451,16
2020-11-22,Butte,007,227075,4042,3712,189,3901,61
2020-11-22,Calaveras,009,45235,468,434,0,434,21
2020-11-22,Colusa,011,21464,722,642,3,645,6
2020-11-22,Contra Costa,013,1133247,23936,22407,146,22553,260
2020-11-22,Del Norte,015,27424,311,271,0,271,2
2020-11-22,El Dorado,017,186661,2489,1917,22,1939,4
2020-11-22,Fresno,019,978130,41294,36315,1255,37570,488
2020-11-22,Glenn,021,27897,939,832,34,866,4
2020-11-22,Humboldt,023,135768,875,729,2,731,9
2020-11-22,Imperial,025,180216,16013,15109,40,15149,355
2020-11-22,Inyo,027,18085,295,279,5,284,15
2020-11-22,Kern,029,883053,40259,37904,1060,38964,463
2020-11-22,Kings,031,150075,10940,10035,138,10173,85
2020-11-22,Lake,033,64148,943,834,0,834,18
2020-11-22,Lassen,035,31185,1929,1211,6,1217,0
2020-11-22,Los Angeles,037,10098052,382707,360341,5513,365854,7438
2020-11-22,Madera,039,155013,6300,5745,130,5875,56
2020-11-22,Marin,041,260295,7705,7506,27,7533,135
2020-11-22,Mariposa,043,17540,124,95,1,96,2
2020-11-22,Mendocino,045,87422,1459,1285,5,1290,22
2020-11-22,Merced,047,269075,11577,10939,102,11041,169
2020-11-22,Modoc,049,8938,104,87,19,106,0
2020-11-22,Mono,051,14174,504,481,9,490,2
2020-11-22,Monterey,053,433212,15028,13887,254,14141,111
2020-11-22,Napa,055,140530,3132,2778,17,2795,17
2020-11-22,Nevada,057,99092,1251,1052,32,1084,9
2020-11-22,Orange,059,3164182,77146,69913,2293,72206,1546
2020-11-22,Placer,061,380077,6959,5880,126,6006,66
2020-11-22,Plumas,063,18699,200,172,0,172,0
2020-11-22,Riverside,065,2383286,88850,81565,1611,83176,1409
2020-11-22,Sacramento,067,1510023,36344,33421,106,33527,555
2020-11-22,San Benito,069,59416,1810,1704,11,1715,15
2020-11-22,San Bernardino,071,2135413,92663,83505,1406,84911,1224
2020-11-22,San Diego,073,3302833,78802,71649,2810,74459,968
2020-11-22,San Francisco,075,870044,15279,14515,94,14609,153
2020-11-22,San Joaquin,077,732212,26212,24619,476,25095,517
2020-11-22,San Luis Obispo,079,281455,6265,5664,102,5766,34
2020-11-22,San Mateo,081,765935,14224,13228,14,13242,170
2020-11-22,Santa Barbara,083,443738,11394,10946,196,11142,137
2020-11-22,Santa Clara,085,1922200,34375,30633,79,30712,434
2020-11-22,Santa Cruz,087,273765,4445,3896,47,3943,25
2020-11-22,Shasta,089,179085,5134,4100,142,4242,43
2020-11-22,Sierra,091,2930,17,13,0,13,0
2020-11-22,Siskiyou,093,43540,589,411,30,441,0
2020-11-22,Solano,095,438530,10220,9363,62,9425,86
2020-11-22,Sonoma,097,501317,12132,11415,48,11463,159
2020-11-22,Stanislaus,099,539301,21518,20223,1313,21536,436
2020-11-22,Sutter,101,95872,3214,2677,11,2688,13
2020-11-22,Tehama,103,63373,1637,1457,19,1476,9
2020-11-22,Trinity,105,12862,254,114,25,139,0
2020-11-22,Tulare,107,460477,21250,19818,1242,21060,314
2020-11-22,Tuolumne,109,53932,998,689,5,694,7
2020-11-22,Ventura,111,848112,19693,18105,614,18719,179
2020-11-22,Yolo,113,214977,4795,4206,15,4221,75
2020-11-22,Yuba,115,75493,1917,1672,9,1681,10
2020-11-21,Alameda,001,1643700,29300,27424,310,27734,444
2020-11-21,Alpine,003,1148,46,41,0,41,0
2020-11-21,Amador,005,37829,489,450,1,451,16
2020-11-21,Butte,007,227075,3994,3664,186,3850,61
2020-11-21,Calaveras,009,45235,462,434,0,434,21
2020-11-21,Colusa,011,21464,713,642,3,645,6
2020-11-21,Contra Costa,013,1133247,23783,22338,144,22482,260
2020-11-21,Del Norte,015,27424,306,271,0,271,2
2020-11-21,El Dorado,017,186661,2440,1900,21,1921,4
2020-11-21,Fresno,019,978130,41038,35973,1221,37194,482
2020-11-21,Glenn,021,27897,934,829,32,861,4
2020-11-21,Humboldt,023,135768,865,728,2,730,9
2020-11-21,Imperial,025,180216,15936,15053,40,15093,355
2020-11-21,Inyo,027,18085,293,283,5,288,15
2020-11-21,Kern,029,883053,40003,37403,1025,38428,463
2020-11-21,Kings,031,150075,10892,10019,134,10153,85
2020-11-21,Lake,033,64148,930,832,0,832,18
2020-11-21,Lassen,035,31185,1862,1211,6,1217,0
2020-11-21,Los Angeles,037,10098052,379527,357754,5367,363121,7428
2020-11-21,Madera,039,155013,6263,5706,130,5836,56
2020-11-21,Marin,041,260295,7682,7488,26,7514,134
2020-11-21,Mariposa,043,17540,124,92,1,93,2
2020-11-21,Mendocino,045,87422,1428,1282,5,1287,22
2020-11-21,Merced,047,269075,11516,10849,101,10950,169
2020-11-21,Modoc,049,8938,100,87,18,105,0
2020-11-21,Mono,051,14174,499,469,9,478,2
2020-11-21,Monterey,053,433212,14930,13886,249,14135,110
2020-11-21,Napa,055,140530,3098,2757,17,2774,17
2020-11-21,Nevada,057,99092,1239,1018,31,1049,9
2020-11-21,Orange,059,3164182,76343,69021,2263,71284,1543
2020-11-21,Placer,061,380077,6846,5778,123,5901,65
2020-11-21,Plumas,063,18699,195,172,0,172,0
2020-11-21,Riverside,065,2383286,88073,80676,1565,82241,1407
2020-11-21,Sacramento,067,1510023,35948,33133,98,33231,548
2020-11-21,San Benito,069,59416,1791,1691,11,1702,15
2020-11-21,San Bernardino,071,2135413,91787,83206,1330,84536,1222
2020-11-21,San Diego,073,3302833,78023,70711,2755,73466,966
2020-11-21,San Francisco,075,870044,15176,14445,93,14538,153
2020-11-21,San Joaquin,077,732212,26079,24620,461,25081,517
2020-11-21,San Luis Obispo,079,281455,6212,5618,99,5717,34
2020-11-21,San Mateo,081,765935,14122,13138,14,13152,170
2020-11-21,Santa Barbara,083,443738,11343,10922,193,11115,137
2020-11-21,Santa Clara,085,1922200,33991,30377,76,30453,433
2020-11-21,Santa Cruz,087,273765,4388,3898,47,3945,25
2020-11-21,Shasta,089,179085,5060,4095,139,4234,42
2020-11-21,Sierra,091,2930,17,13,0,13,0
2020-11-21,Siskiyou,093,43540,573,403,30,433,0
2020-11-21,Solano,095,438530,10130,9290,59,9349,86
2020-11-21,Sonoma,097,501317,12057,11394,46,11440,158
2020-11-21,Stanislaus,099,539301,21375,20111,1288,21399,435
2020-11-21,Sutter,101,95872,3154,2615,10,2625,13
2020-11-21,Tehama,103,63373,1617,1435,18,1453,9
2020-11-21,Trinity,105,12862,251,110,24,134,0
2020-11-21,Tulare,107,460477,21124,19752,1208,20960,313
2020-11-21,Tuolumne,109,53932,979,690,5,695,7
2020-11-21,Ventura,111,848112,19529,18040,604,18644,177
2020-11-21,Yolo,113,214977,4721,4147,14,4161,75
2020-11-21,Yuba,115,75493,1885,1643,9,1652,10
2020-11-20,Alameda,001,1643700,29086,27221,303,27524,444
2020-11-20,Alpine,003,1148,46,20,0,20,0
2020-11-20,Amador,005,37829,485,446,1,447,16
2020-11-20,Butte,007,227075,3962,3618,182,3800,60
2020-11-20,Calaveras,009,45235,450,424,0,424,21
2020-11-20,Colusa,011,21464,705,631,2,633,6
2020-11-20,Contra Costa,013,1133247,23597,22116,140,22256,260
2020-11-20,Del Norte,015,27424,302,264,0,264,2
2020-11-20,El Dorado,017,186661,2344,1868,19,1887,4
2020-11-20,Fresno,019,978130,40744,35635,1191,36826,480
2020-11-20,Glenn,021,27897,922,826,30,856,4
2020-11-20,Humboldt,023,135768,856,714,1,715,9
2020-11-20,Imperial,025,180216,15874,14864,36,14900,353
2020-11-20,Inyo,027,18085,291,262,5,267,15
2020-11-20,Kern,029,883053,39709,37143,999,38142,462
2020-11-20,Kings,031,150075,10844,9903,133,10036,85
2020-11-20,Lake,033,64148,921,820,0,820,18
2020-11-20,Lassen,035,31185,1777,1212,5,1217,0
2020-11-20,Los Angeles,037,10098052,375643,353554,5204,358758,7398
2020-11-20,Madera,039,155013,6170,5635,129,5764,54
2020-11-20,Marin,041,260295,7658,7467,25,7492,134
2020-11-20,Mariposa,043,17540,116,89,1,90,2
2020-11-20,Mendocino,045,87422,1408,1269,5,1274,22
2020-11-20,Merced,047,269075,11430,10729,101,10830,167
2020-11-20,Modoc,049,8938,100,83,18,101,0
2020-11-20,Mono,051,14174,497,469,9,478,2
2020-11-20,Monterey,053,433212,14805,13738,240,13978,110
2020-11-20,Napa,055,140530,3068,2718,17,2735,17
2020-11-20,Nevada,057,99092,1221,990,30,1020,9
2020-11-20,Orange,059,3164182,75506,68212,2225,70437,1532
2020-11-20,Placer,061,380077,6711,5687,108,5795,66
2020-11-20,Plumas,063,18699,193,163,0,163,0
2020-11-20,Riverside,065,2383286,87062,79613,1502,81115,1405
2020-11-20,Sacramento,067,1510023,35572,32832,91,32923,549
2020-11-20,San Benito,069,59416,1779,1668,11,1679,15
2020-11-20,San Bernardino,071,2135413,90421,81203,1249,82452,1220
2020-11-20,San Diego,073,3302833,77025,69233,2673,71906,960
2020-11-20,San Francisco,075,870044,15072,14327,92,14419,153
2020-11-20,San Joaquin,077,732212,25926,24460,448,24908,515
2020-11-20,San Luis Obispo,079,281455,6156,5524,96,5620,34
2020-11-20,San Mateo,081,765935,13989,12980,13,12993,169
2020-11-20,Santa Barbara,083,443738,11287,10825,187,11012,136
2020-11-20,Santa Clara,085,1922200,33569,30002,71,30073,431
2020-11-20,Santa Cruz,087,273765,4322,3815,47,3862,25
2020-11-20,Shasta,089,179085,4987,3861,134,3995,42
2020-11-20,Sierra,091,2930,17,12,0,12,0
2020-11-20,Siskiyou,093,43540,560,387,29,416,0
2020-11-20,Solano,095,438530,10038,9216,57,9273,85
2020-11-20,Sonoma,097,501317,11973,11316,45,11361,158
2020-11-20,Stanislaus,099,539301,21220,19889,1262,21151,433
2020-11-20,Sutter,101,95872,3104,2580,10,2590,13
2020-11-20,Tehama,103,63373,1602,1410,15,1425,9
2020-11-20,Trinity,105,12862,250,102,24,126,0
2020-11-20,Tulare,107,460477,20991,19568,1169,20737,311
2020-11-20,Tuolumne,109,53932,940,662,5,667,7
2020-11-20,Ventura,111,848112,19361,17741,576,18317,175
2020-11-20,Yolo,113,214977,4643,4081,13,4094,74
2020-11-20,Yuba,115,75493,1857,1611,9,1620,10
2020-11-19,Alameda,001,1643700,28740,26971,295,27266,441
2020-11-19,Alpine,003,1148,43,20,0,20,0
2020-11-19,Amador,005,37829,481,436,1,437,16
2020-11-19,Butte,007,227075,3913,3576,175,3751,60
2020-11-19,Calaveras,009,45235,440,417,0,417,21
2020-11-19,Colusa,011,21464,687,621,2,623,6
2020-11-19,Contra Costa,013,1133247,23325,21886,137,22023,259
2020-11-19,Del Norte,015,27424,294,251,0,251,2
2020-11-19,El Dorado,017,186661,2270,1825,18,1843,4
2020-11-19,Fresno,019,978130,40294,35278,1134,36412,478
2020-11-19,Glenn,021,27897,900,806,29,835,4
2020-11-19,Humboldt,023,135768,836,693,1,694,9
2020-11-19,Imperial,025,180216,15665,14507,36,14543,349
2020-11-19,Inyo,027,18085,289,262,5,267,15
2020-11-19,Kern,029,883053,39288,36779,957,37736,459
2020-11-19,Kings,031,150075,10696,9763,125,9888,85
2020-11-19,Lake,033,64148,907,809,0,809,18
2020-11-19,Lassen,035,31185,1660,1201,3,1204,0
2020-11-19,Los Angeles,037,10098052,370621,349493,5034,354527,7365
2020-11-19,Madera,039,155013,6098,5540,121,5661,54
2020-11-19,Marin,041,260295,7627,7451,25,7476,134
2020-11-19,Mariposa,043,17540,109,88,0,88,2
2020-11-19,Mendocino,045,87422,1387,1237,5,1242,23
2020-11-19,Merced,047,269075,11289,10634,95,10729,167
2020-11-19,Modoc,049,8938,97,82,18,100,0
2020-11-19,Mono,051,14174,489,468,9,477,2
2020-11-19,Monterey,053,433212,14590,13369,228,13597,108
2020-11-19,Napa,055,140530,3014,2641,17,2658,17
2020-11-19,Nevada,057,99092,1180,945,29,974,9
2020-11-19,Orange,059,3164182,74243,66998,2180,69178,1530
2020-11-19,Placer,061,380077,6520,5612,107,5719,65
2020-11-19,Plumas,063,18699,188,158,0,158,0
2020-11-19,Riverside,065,2383286,85577,78535,1431,79966,1402
2020-11-19,Sacramento,067,1510023,35058,32367,89,32456,546
2020-11-19,San Benito,069,59416,1756,1643,11,1654,15
2020-11-19,San Bernardino,071,2135413,88525,79244,1169,80413,1215
2020-11-19,San Diego,073,3302833,75775,68142,2569,70711,952
2020-11-19,San Francisco,075,870044,14915,14178,86,14264,153
2020-11-19,San Joaquin,077,732212,25606,24270,437,24707,516
2020-11-19,San Luis Obispo,079,281455,6079,5410,92,5502,34
2020-11-19,San Mateo,081,765935,13851,12714,13,12727,169
2020-11-19,Santa Barbara,083,443738,11207,10741,184,10925,136
2020-11-19,Santa Clara,085,1922200,33011,29630,70,29700,424
2020-11-19,Santa Cruz,087,273765,4232,3679,45,3724,25
2020-11-19,Shasta,089,179085,4849,3685,124,3809,42
2020-11-19,Sierra,091,2930,17,11,0,11,0
2020-11-19,Siskiyou,093,43540,535,360,28,388,0
2020-11-19,Solano,095,438530,9901,9093,53,9146,84
2020-11-19,Sonoma,097,501317,11803,11205,43,11248,156
2020-11-19,Stanislaus,099,539301,20980,19736,1220,20956,433
2020-11-19,Sutter,101,95872,3005,2509,10,2519,13
2020-11-19,Tehama,103,63373,1569,1373,12,1385,9
2020-11-19,Trinity,105,12862,244,97,24,121,0
2020-11-19,Tulare,107,460477,20769,19384,1104,20488,304
2020-11-19,Tuolumne,109,53932,907,602,5,607,7
2020-11-19,Ventura,111,848112,19008,17300,563,17863,174
2020-11-19,Yolo,113,214977,4548,3973,13,3986,72
2020-11-19,Yuba,115,75493,1817,1568,9,1577,10
2020-11-18,Alameda,001,1643700,28477,26610,290,26900,440
2020-11-18,Alpine,003,1148,42,16,0,16,0
2020-11-18,Amador,005,37829,476,430,1,431,16
2020-11-18,Butte,007,227075,3860,3537,162,3699,59
2020-11-18,Calaveras,009,45235,436,409,0,409,21
2020-11-18,Colusa,011,21464,674,611,2,613,6
2020-11-18,Contra Costa,013,1133247,23058,21685,133,21818,258
2020-11-18,Del Norte,015,27424,281,240,0,240,2
2020-11-18,El Dorado,017,186661,2182,1799,17,1816,4
2020-11-18,Fresno,019,978130,39854,34997,1083,36080,474
2020-11-18,Glenn,021,27897,883,803,27,830,4
2020-11-18,Humboldt,023,135768,822,690,1,691,9
2020-11-18,Imperial,025,180216,15443,14428,36,14464,348
2020-11-18,Inyo,027,18085,287,262,5,267,15
2020-11-18,Kern,029,883053,38899,36537,907,37444,456
2020-11-18,Kings,031,150075,10548,9696,122,9818,85
2020-11-18,Lake,033,64148,894,802,0,802,18
2020-11-18,Lassen,035,31185,1560,1124,3,1127,0
2020-11-18,Los Angeles,037,10098052,365755,344675,4849,349524,7338
2020-11-18,Madera,039,155013,6011,5519,109,5628,54
2020-11-18,Marin,041,260295,7603,7435,25,7460,134
2020-11-18,Mariposa,043,17540,106,88,0,88,2
2020-11-18,Mendocino,045,87422,1367,1237,5,1242,23
2020-11-18,Merced,047,269075,11173,10536,94,10630,166
2020-11-18,Modoc,049,8938,94,77,18,95,0
2020-11-18,Mono,051,14174,484,468,9,477,2
2020-11-18,Monterey,053,433212,14395,13340,214,13554,108
2020-11-18,Napa,055,140530,2968,2607,17,2624,17
2020-11-18,Nevada,057,99092,1140,933,27,960,9
2020-11-18,Orange,059,3164182,73145,66381,2155,68536,1521
2020-11-18,Placer,061,380077,6342,5543,102,5645,64
2020-11-18,Plumas,063,18699,183,143,0,143,0
2020-11-18,Riverside,065,2383286,84112,77739,1328,79067,1387
2020-11-18,Sacramento,067,1510023,34433,31816,81,31897,541
2020-11-18,San Benito,069,59416,1731,1632,10,1642,15
2020-11-18,San Bernardino,071,2135413,86767,77400,1089,78489,1206
2020-11-18,San Diego,073,3302833,74481,67243,2509,69752,945
2020-11-18,San Francisco,075,870044,14771,14057,84,14141,153
2020-11-18,San Joaquin,077,732212,25340,24146,422,24568,517
2020-11-18,San Luis Obispo,079,281455,6003,5322,91,5413,34
2020-11-18,San Mateo,081,765935,13698,12631,12,12643,169
2020-11-18,Santa Barbara,083,443738,11128,10684,177,10861,136
2020-11-18,Santa Clara,085,1922200,32546,29285,65,29350,421
2020-11-18,Santa Cruz,087,273765,4140,3618,43,3661,25
2020-11-18,Shasta,089,179085,4715,3547,120,3667,42
2020-11-18,Sierra,091,2930,17,11,0,11,0
2020-11-18,Siskiyou,093,43540,503,351,27,378,0
2020-11-18,Solano,095,438530,9769,8994,51,9045,84
2020-11-18,Sonoma,097,501317,11696,11129,40,11169,155
2020-11-18,Stanislaus,099,539301,20737,19609,1195,20804,431
2020-11-18,Sutter,101,95872,2887,2442,10,2452,13
2020-11-18,Tehama,103,63373,1531,1338,12,1350,8
2020-11-18,Trinity,105,12862,230,95,23,118,0
2020-11-18,Tulare,107,460477,20559,19286,1053,20339,306
2020-11-18,Tuolumne,109,53932,872,590,5,595,7
2020-11-18,Ventura,111,848112,18683,17169,548,17717,173
2020-11-18,Yolo,113,214977,4474,3929,13,3942,71
2020-11-18,Yuba,115,75493,1763,1540,9,1549,10
2020-11-17,Alameda,001,1643700,28150,26425,280,26705,439
2020-11-17,Alpine,003,1148,40,12,0,12,0
2020-11-17,Amador,005,37829,465,423,1,424,16
2020-11-17,Butte,007,227075,3818,3500,152,3652,59
2020-11-17,Calaveras,009,45235,421,405,0,405,21
2020-11-17,Colusa,011,21464,663,606,1,607,6
2020-11-17,Contra Costa,013,1133247,22785,21557,128,21685,256
2020-11-17,Del Norte,015,27424,275,233,0,233,2
2020-11-17,El Dorado,017,186661,2123,1758,17,1775,4
2020-11-17,Fresno,019,978130,39256,34765,1024,35789,472
2020-11-17,Glenn,021,27897,872,795,26,821,4
2020-11-17,Humboldt,023,135768,800,685,1,686,9
2020-11-17,Imperial,025,180216,15207,14204,34,14238,346
2020-11-17,Inyo,027,18085,286,263,5,268,15
2020-11-17,Kern,029,883053,38449,36164,854,37018,455
2020-11-17,Kings,031,150075,10475,9653,115,9768,85
2020-11-17,Lake,033,64148,874,792,0,792,18
2020-11-17,Lassen,035,31185,1481,1124,3,1127,0
2020-11-17,Los Angeles,037,10098052,360811,340933,4685,345618,7302
2020-11-17,Madera,039,155013,5922,5485,102,5587,54
2020-11-17,Marin,041,260295,7571,7404,24,7428,134
2020-11-17,Mariposa,043,17540,103,87,0,87,2
2020-11-17,Mendocino,045,87422,1346,1216,5,1221,23
2020-11-17,Merced,047,269075,11029,10457,87,10544,162
2020-11-17,Modoc,049,8938,88,71,17,88,0
2020-11-17,Mono,051,14174,479,459,9,468,2
2020-11-17,Monterey,053,433212,14166,13220,204,13424,108
2020-11-17,Napa,055,140530,2914,2568,17,2585,17
2020-11-17,Nevada,057,99092,1099,918,26,944,9
2020-11-17,Orange,059,3164182,71995,65757,2127,67884,1519
2020-11-17,Placer,061,380077,6180,5435,96,5531,63
2020-11-17,Plumas,063,18699,175,142,0,142,0
2020-11-17,Riverside,065,2383286,82725,77079,1237,78316,1379
2020-11-17,Sacramento,067,1510023,33834,31341,77,31418,538
2020-11-17,San Benito,069,59416,1715,1611,4,1615,15
2020-11-17,San Bernardino,071,2135413,84953,76134,999,77133,1188
2020-11-17,San Diego,073,3302833,73228,66321,2453,68774,933
2020-11-17,San Francisco,075,870044,14605,13952,83,14035,153
2020-11-17,San Joaquin,077,732212,25068,23997,402,24399,516
2020-11-17,San Luis Obispo,079,281455,5907,5235,91,5326,34
2020-11-17,San Mateo,081,765935,13536,12491,11,12502,169
2020-11-17,Santa Barbara,083,443738,11043,10597,172,10769,136
2020-11-17,Santa Clara,085,1922200,31999,29013,64,29077,419
2020-11-17,Santa Cruz,087,273765,4055,3548,40,3588,25
2020-11-17,Shasta,089,179085,4557,3457,108,3565,40
2020-11-17,Sierra,091,2930,15,11,0,11,0
2020-11-17,Siskiyou,093,43540,455,333,26,359,0
2020-11-17,Solano,095,438530,9624,8905,50,8955,84
2020-11-17,Sonoma,097,501317,11562,11084,39,11123,155
2020-11-17,Stanislaus,099,539301,20513,19466,1167,20633,425
2020-11-17,Sutter,101,95872,2804,2370,9,2379,12
2020-11-17,Tehama,103,63373,1480,1290,12,1302,7
2020-11-17,Trinity,105,12862,213,83,23,106,0
2020-11-17,Tulare,107,460477,20328,19176,991,20167,305
2020-11-17,Tuolumne,109,53932,834,568,5,573,7
2020-11-17,Ventura,111,848112,18411,16797,530,17327,173
2020-11-17,Yolo,113,214977,4297,3887,12,3899,70
2020-11-17,Yuba,115,75493,1715,1519,9,1528,10
2020-11-16,Alameda,001,1643700,27803,26063,275,26338,436
2020-11-16,Alpine,003,1148,37,12,0,12,0
2020-11-16,Amador,005,37829,457,414,1,415,16
2020-11-16,Butte,007,227075,3779,3490,144,3634,58
2020-11-16,Calaveras,009,45235,413,402,0,402,21
2020-11-16,Colusa,011,21464,654,601,1,602,6
2020-11-16,Contra Costa,013,1133247,22518,21386,123,21509,256
2020-11-16,Del Norte,015,27424,268,225,0,225,2
2020-11-16,El Dorado,017,186661,2063,1694,15,1709,4
2020-11-16,Fresno,019,978130,38766,34593,970,35563,471
2020-11-16,Glenn,021,27897,860,786,25,811,4
2020-11-16,Humboldt,023,135768,784,660,1,661,9
2020-11-16,Imperial,025,180216,14959,14111,34,14145,346
2020-11-16,Inyo,027,18085,283,263,5,268,15
2020-11-16,Kern,029,883053,38055,36049,811,36860,455
2020-11-16,Kings,031,150075,10208,9569,111,9680,85
2020-11-16,Lake,033,64148,862,784,0,784,18
2020-11-16,Lassen,035,31185,1300,1124,3,1127,0
2020-11-16,Los Angeles,037,10098052,356065,338778,4511,343289,7277
2020-11-16,Madera,039,155013,5835,5433,96,5529,54
2020-11-16,Marin,041,260295,7542,7359,24,7383,134
2020-11-16,Mariposa,043,17540,100,86,0,86,2
2020-11-16,Mendocino,045,87422,1321,1209,5,1214,23
2020-11-16,Merced,047,269075,10891,10399,84,10483,162
2020-11-16,Modoc,049,8938,86,71,17,88,0
2020-11-16,Mono,051,14174,477,453,9,462,2
2020-11-16,Monterey,053,433212,13920,13089,194,13283,107
2020-11-16,Napa,055,140530,2838,2536,17,2553,17
2020-11-16,Nevada,057,99092,1056,889,24,913,9
2020-11-16,Orange,059,3164182,70898,65396,2113,67509,1519
2020-11-16,Placer,061,380077,6060,5387,87,5474,63
2020-11-16,Plumas,063,18699,168,127,0,127,0
2020-11-16,Riverside,065,2383286,81350,76449,1172,77621,1379
2020-11-16,Sacramento,067,1510023,33196,30954,70,31024,534
2020-11-16,San Benito,069,59416,1697,1603,3,1606,15
2020-11-16,San Bernardino,071,2135413,83124,74401,930,75331,1186
2020-11-16,San Diego,073,3302833,71917,65603,2381,67984,926
2020-11-16,San Francisco,075,870044,14446,13847,80,13927,153
2020-11-16,San Joaquin,077,732212,24780,23515,393,23908,513
2020-11-16,San Luis Obispo,079,281455,5804,5161,86,5247,34
2020-11-16,San Mateo,081,765935,13376,12398,11,12409,169
2020-11-16,Santa Barbara,083,443738,10978,10565,168,10733,135
2020-11-16,Santa Clara,085,1922200,31433,28673,63,28736,419
2020-11-16,Santa Cruz,087,273765,3982,3520,40,3560,25
2020-11-16,Shasta,089,179085,4409,3284,103,3387,37
2020-11-16,Sierra,091,2930,15,11,0,11,0
2020-11-16,Siskiyou,093,43540,428,294,26,320,0
2020-11-16,Solano,095,438530,9425,8827,50,8877,84
2020-11-16,Sonoma,097,501317,11471,10961,38,10999,155
2020-11-16,Stanislaus,099,539301,20277,19333,1140,20473,425
2020-11-16,Sutter,101,95872,2698,2322,9,2331,12
2020-11-16,Tehama,103,63373,1435,1261,8,1269,7
2020-11-16,Trinity,105,12862,201,67,23,90,0
2020-11-16,Tulare,107,460477,20149,18891,937,19828,305
2020-11-16,Tuolumne,109,53932,798,543,5,548,7
2020-11-16,Ventura,111,848112,18073,16691,522,17213,172
2020-11-16,Yolo,113,214977,4201,3858,12,3870,70
2020-11-16,Yuba,115,75493,1679,1500,8,1508,10
2020-11-15,Alameda,001,1643700,27485,25879,269,26148,436
2020-11-15,Alpine,003,1148,35,12,0,12,0
2020-11-15,Amador,005,37829,445,409,1,410,16
2020-11-15,Butte,007,227075,3725,3452,135,3587,58
2020-11-15,Calaveras,009,45235,399,386,0,386,21
2020-11-15,Colusa,011,21464,645,601,1,602,6
2020-11-15,Contra Costa,013,1133247,22219,21179,122,21301,256
2020-11-15,Del Norte,015,27424,253,224,0,224,2
2020-11-15,El Dorado,017,186661,2001,1683,14,1697,4
2020-11-15,Fresno,019,978130,38252,34297,932,35229,471
2020-11-15,Glenn,021,27897,848,783,24,807,4
2020-11-15,Humboldt,023,135768,755,653,1,654,9
2020-11-15,Imperial,025,180216,14722,13940,34,13974,346
2020-11-15,Inyo,027,18085,273,263,5,268,15
2020-11-15,Kern,029,883053,37650,35911,776,36687,455
2020-11-15,Kings,031,150075,10015,9533,107,9640,85
2020-11-15,Lake,033,64148,853,777,0,777,17
2020-11-15,Lassen,035,31185,1253,1124,3,1127,0
2020-11-15,Los Angeles,037,10098052,351023,336035,4339,340374,7271
2020-11-15,Madera,039,155013,5738,5391,90,5481,54
2020-11-15,Marin,041,260295,7516,7347,24,7371,133
2020-11-15,Mariposa,043,17540,97,86,0,86,2
2020-11-15,Mendocino,045,87422,1302,1197,5,1202,22
2020-11-15,Merced,047,269075,10758,10350,84,10434,162
2020-11-15,Modoc,049,8938,85,68,17,85,0
2020-11-15,Mono,051,14174,475,453,9,462,2
2020-11-15,Monterey,053,433212,13723,12999,181,13180,107
2020-11-15,Napa,055,140530,2779,2509,15,2524,17
2020-11-15,Nevada,057,99092,1001,859,24,883,9
2020-11-15,Orange,059,3164182,69858,65008,2097,67105,1519
2020-11-15,Placer,061,380077,5905,5330,79,5409,63
2020-11-15,Plumas,063,18699,162,127,0,127,0
2020-11-15,Riverside,065,2383286,80026,75531,1113,76644,1374
2020-11-15,Sacramento,067,1510023,32570,30601,65,30666,534
2020-11-15,San Benito,069,59416,1672,1589,2,1591,15
2020-11-15,San Bernardino,071,2135413,80971,73769,855,74624,1185
2020-11-15,San Diego,073,3302833,70416,64770,2324,67094,926
2020-11-15,San Francisco,075,870044,14270,13757,79,13836,153
2020-11-15,San Joaquin,077,732212,24570,23516,377,23893,513
2020-11-15,San Luis Obispo,079,281455,5681,5120,84,5204,34
2020-11-15,San Mateo,081,765935,13199,12348,11,12359,169
2020-11-15,Santa Barbara,083,443738,10883,10516,166,10682,135
2020-11-15,Santa Clara,085,1922200,30979,28289,62,28351,418
2020-11-15,Santa Cruz,087,273765,3844,3439,39,3478,25
2020-11-15,Shasta,089,179085,4236,3290,94,3384,37
2020-11-15,Sierra,091,2930,15,11,0,11,0
2020-11-15,Siskiyou,093,43540,409,294,26,320,0
2020-11-15,Solano,095,438530,9264,8713,47,8760,84
2020-11-15,Sonoma,097,501317,11351,10833,37,10870,154
2020-11-15,Stanislaus,099,539301,20005,19228,1115,20343,425
2020-11-15,Sutter,101,95872,2608,2230,9,2239,12
2020-11-15,Tehama,103,63373,1384,1222,7,1229,7
2020-11-15,Trinity,105,12862,191,67,21,88,0
2020-11-15,Tulare,107,460477,19932,18891,884,19775,305
2020-11-15,Tuolumne,109,53932,756,486,5,491,7
2020-11-15,Ventura,111,848112,17799,16564,514,17078,172
2020-11-15,Yolo,113,214977,4098,3819,11,3830,67
2020-11-15,Yuba,115,75493,1638,1470,7,1477,10
2020-11-14,Alameda,001,1643700,27218,25714,267,25981,435
2020-11-14,Alpine,003,1148,35,12,0,12,0
2020-11-14,Amador,005,37829,436,404,0,404,16
2020-11-14,Butte,007,227075,3689,3434,121,3555,58
2020-11-14,Calaveras,009,45235,398,386,0,386,21
2020-11-14,Colusa,011,21464,633,601,1,602,6
2020-11-14,Contra Costa,013,1133247,22080,20975,115,21090,256
2020-11-14,Del Norte,015,27424,247,219,0,219,2
2020-11-14,El Dorado,017,186661,1957,1648,14,1662,4
2020-11-14,Fresno,019,978130,38002,33969,895,34864,471
2020-11-14,Glenn,021,27897,839,772,21,793,3
2020-11-14,Humboldt,023,135768,740,643,1,644,9
2020-11-14,Imperial,025,180216,14629,13932,33,13965,346
2020-11-14,Inyo,027,18085,272,263,5,268,15
2020-11-14,Kern,029,883053,37441,35626,757,36383,454
2020-11-14,Kings,031,150075,9980,9490,104,9594,85
2020-11-14,Lake,033,64148,844,773,0,773,17
2020-11-14,Lassen,035,31185,1239,833,3,836,0
2020-11-14,Los Angeles,037,10098052,348315,333021,4230,337251,7269
2020-11-14,Madera,039,155013,5708,5371,88,5459,54
2020-11-14,Marin,041,260295,7500,7325,24,7349,133
2020-11-14,Mariposa,043,17540,96,86,0,86,2
2020-11-14,Mendocino,045,87422,1286,1181,5,1186,22
2020-11-14,Merced,047,269075,10702,10286,82,10368,161
2020-11-14,Modoc,049,8938,84,64,16,80,0
2020-11-14,Mono,051,14174,475,453,9,462,2
2020-11-14,Monterey,053,433212,13627,12854,171,13025,105
2020-11-14,Napa,055,140530,2745,2473,15,2488,17
2020-11-14,Nevada,057,99092,985,835,24,859,9
2020-11-14,Orange,059,3164182,69237,64340,2086,66426,1517
2020-11-14,Placer,061,380077,5829,5215,73,5288,63
2020-11-14,Plumas,063,18699,157,128,0,128,0
2020-11-14,Riverside,065,2383286,79285,74910,1074,75984,1373
2020-11-14,Sacramento,067,1510023,32244,30298,65,30363,532
2020-11-14,San Benito,069,59416,1657,1573,2,1575,15
2020-11-14,San Bernardino,071,2135413,80037,72868,823,73691,1184
2020-11-14,San Diego,073,3302833,69651,63715,2272,65987,926
2020-11-14,San Francisco,075,870044,14182,13661,78,13739,153
2020-11-14,San Joaquin,077,732212,24479,23516,369,23885,511
2020-11-14,San Luis Obispo,079,281455,5617,5073,79,5152,34
2020-11-14,San Mateo,081,765935,13091,12293,11,12304,169
2020-11-14,Santa Barbara,083,443738,10829,10482,164,10646,135
2020-11-14,Santa Clara,085,1922200,30694,27962,60,28022,416
2020-11-14,Santa Cruz,087,273765,3789,3402,39,3441,25
2020-11-14,Shasta,089,179085,4155,3195,92,3287,37
2020-11-14,Sierra,091,2930,15,11,0,11,0
2020-11-14,Siskiyou,093,43540,396,292,26,318,0
2020-11-14,Solano,095,438530,9184,8655,46,8701,84
2020-11-14,Sonoma,097,501317,11298,10769,37,10806,154
2020-11-14,Stanislaus,099,539301,19862,19068,1093,20161,424
2020-11-14,Sutter,101,95872,2563,2182,9,2191,12
2020-11-14,Tehama,103,63373,1363,1206,6,1212,7
2020-11-14,Trinity,105,12862,186,67,21,88,0
2020-11-14,Tulare,107,460477,19837,18853,856,19709,305
2020-11-14,Tuolumne,109,53932,728,448,5,453,7
2020-11-14,Ventura,111,848112,17653,16297,503,16800,172
2020-11-14,Yolo,113,214977,4055,3765,9,3774,65
2020-11-14,Yuba,115,75493,1609,1453,7,1460,10
2020-11-13,Alameda,001,1643700,27002,25515,262,25777,434
2020-11-13,Alpine,003,1148,35,12,0,12,0
2020-11-13,Amador,005,37829,433,397,0,397,16
2020-11-13,Butte,007,227075,3665,3402,112,3514,58
2020-11-13,Calaveras,009,45235,394,378,0,378,21
2020-11-13,Colusa,011,21464,625,598,1,599,6
2020-11-13,Contra Costa,013,1133247,21907,20799,115,20914,256
2020-11-13,Del Norte,015,27424,244,208,0,208,2
2020-11-13,El Dorado,017,186661,1912,1611,13,1624,4
2020-11-13,Fresno,019,978130,37755,33693,881,34574,470
2020-11-13,Glenn,021,27897,825,755,17,772,3
2020-11-13,Humboldt,023,135768,725,638,1,639,9
2020-11-13,Imperial,025,180216,14559,13790,32,13822,341
2020-11-13,Inyo,027,18085,271,262,5,267,15
2020-11-13,Kern,029,883053,37239,35431,740,36171,453
2020-11-13,Kings,031,150075,9921,9428,103,9531,85
2020-11-13,Lake,033,64148,838,770,0,770,17
2020-11-13,Lassen,035,31185,1230,832,3,835,0
2020-11-13,Los Angeles,037,10098052,345189,329364,4123,333487,7248
2020-11-13,Madera,039,155013,5668,5340,87,5427,54
2020-11-13,Marin,041,260295,7487,7307,23,7330,133
2020-11-13,Mariposa,043,17540,94,86,0,86,2
2020-11-13,Mendocino,045,87422,1274,1173,5,1178,22
2020-11-13,Merced,047,269075,10646,10185,79,10264,159
2020-11-13,Modoc,049,8938,84,63,14,77,0
2020-11-13,Mono,051,14174,475,448,8,456,2
2020-11-13,Monterey,053,433212,13431,12681,159,12840,104
2020-11-13,Napa,055,140530,2706,2440,15,2455,17
2020-11-13,Nevada,057,99092,966,798,24,822,9
2020-11-13,Orange,059,3164182,68638,63804,2066,65870,1514
2020-11-13,Placer,061,380077,5724,5122,67,5189,63
2020-11-13,Plumas,063,18699,151,125,0,125,0
2020-11-13,Riverside,065,2383286,78546,74138,1045,75183,1372
2020-11-13,Sacramento,067,1510023,31926,29787,60,29847,524
2020-11-13,San Benito,069,59416,1645,1553,1,1554,15
2020-11-13,San Bernardino,071,2135413,78989,71895,802,72697,1184
2020-11-13,San Diego,073,3302833,68804,62978,2234,65212,921
2020-11-13,San Francisco,075,870044,14089,13516,76,13592,146
2020-11-13,San Joaquin,077,732212,24384,23314,363,23677,510
2020-11-13,San Luis Obispo,079,281455,5550,4960,76,5036,34
2020-11-13,San Mateo,081,765935,12997,12182,11,12193,169
2020-11-13,Santa Barbara,083,443738,10777,10405,162,10567,134
2020-11-13,Santa Clara,085,1922200,30367,27609,58,27667,415
2020-11-13,Santa Cruz,087,273765,3716,3343,39,3382,25
2020-11-13,Shasta,089,179085,4071,2983,88,3071,37
2020-11-13,Sierra,091,2930,15,11,0,11,0
2020-11-13,Siskiyou,093,43540,391,280,25,305,0
2020-11-13,Solano,095,438530,9093,8525,46,8571,84
2020-11-13,Sonoma,097,501317,11237,10685,35,10720,151
2020-11-13,Stanislaus,099,539301,19737,18936,1065,20001,422
2020-11-13,Sutter,101,95872,2517,2121,8,2129,12
2020-11-13,Tehama,103,63373,1335,1167,6,1173,7
2020-11-13,Trinity,105,12862,184,64,21,85,0
2020-11-13,Tulare,107,460477,19713,18714,815,19529,305
2020-11-13,Tuolumne,109,53932,695,427,5,432,7
2020-11-13,Ventura,111,848112,17507,16172,489,16661,171
2020-11-13,Yolo,113,214977,4004,3716,9,3725,65
2020-11-13,Yuba,115,75493,1582,1435,7,1442,10
2020-11-12,Alameda,001,1643700,26735,25345,262,25607,432
2020-11-12,Alpine,003,1148,34,12,0,12,0
2020-11-12,Amador,005,37829,432,392,0,392,16
2020-11-12,Butte,007,227075,3616,3347,109,3456,58
2020-11-12,Calaveras,009,45235,389,373,0,373,21
2020-11-12,Colusa,011,21464,620,591,1,592,6
2020-11-12,Contra Costa,013,1133247,21700,20619,113,20732,255
2020-11-12,Del Norte,015,27424,237,203,0,203,2
2020-11-12,El Dorado,017,186661,1866,1573,9,1582,4
2020-11-12,Fresno,019,978130,37406,33459,839,34298,468
2020-11-12,Glenn,021,27897,806,727,17,744,3
2020-11-12,Humboldt,023,135768,712,625,1,626,9
2020-11-12,Imperial,025,180216,14394,13619,32,13651,341
2020-11-12,Inyo,027,18085,270,255,5,260,15
2020-11-12,Kern,029,883053,36975,35207,725,35932,451
2020-11-12,Kings,031,150075,9854,9335,102,9437,85
2020-11-12,Lake,033,64148,829,764,0,764,17
2020-11-12,Lassen,035,31185,1161,832,2,834,0
2020-11-12,Los Angeles,037,10098052,341448,327001,4022,331023,7223
2020-11-12,Madera,039,155013,5633,5273,82,5355,54
2020-11-12,Marin,041,260295,7458,7268,23,7291,133
2020-11-12,Mariposa,043,17540,92,84,0,84,2
2020-11-12,Mendocino,045,87422,1255,1142,5,1147,22
2020-11-12,Merced,047,269075,10532,10107,76,10183,158
2020-11-12,Modoc,049,8938,84,63,14,77,0
2020-11-12,Mono,051,14174,474,442,8,450,2
2020-11-12,Monterey,053,433212,13310,12489,145,12634,100
2020-11-12,Napa,055,140530,2644,2398,15,2413,16
2020-11-12,Nevada,057,99092,943,780,23,803,9
2020-11-12,Orange,059,3164182,67893,63232,2047,65279,1514
2020-11-12,Placer,061,380077,5614,5044,58,5102,62
2020-11-12,Plumas,063,18699,147,121,0,121,0
2020-11-12,Riverside,065,2383286,77614,73381,1002,74383,1362
2020-11-12,Sacramento,067,1510023,31435,29459,53,29512,520
2020-11-12,San Benito,069,59416,1625,1525,1,1526,15
2020-11-12,San Bernardino,071,2135413,77623,70758,763,71521,1183
2020-11-12,San Diego,073,3302833,67824,62336,2183,64519,918
2020-11-12,San Francisco,075,870044,13990,13289,75,13364,146
2020-11-12,San Joaquin,077,732212,24191,23002,342,23344,509
2020-11-12,San Luis Obispo,079,281455,5486,4898,75,4973,33
2020-11-12,San Mateo,081,765935,12873,12086,10,12096,169
2020-11-12,Santa Barbara,083,443738,10715,10325,157,10482,134
2020-11-12,Santa Clara,085,1922200,29991,27261,57,27318,414
2020-11-12,Santa Cruz,087,273765,3633,3317,37,3354,25
2020-11-12,Shasta,089,179085,3934,2825,77,2902,37
2020-11-12,Sierra,091,2930,15,11,0,11,0
2020-11-12,Siskiyou,093,43540,374,275,20,295,0
2020-11-12,Solano,095,438530,8993,8417,45,8462,85
2020-11-12,Sonoma,097,501317,11135,10602,34,10636,151
2020-11-12,Stanislaus,099,539301,19568,18787,1036,19823,422
2020-11-12,Sutter,101,95872,2434,2075,7,2082,12
2020-11-12,Tehama,103,63373,1308,1117,6,1123,7
2020-11-12,Trinity,105,12862,176,62,20,82,0
2020-11-12,Tulare,107,460477,19601,18545,777,19322,305
2020-11-12,Tuolumne,109,53932,656,353,5,358,7
2020-11-12,Ventura,111,848112,17257,16013,483,16496,158
2020-11-12,Yolo,113,214977,3960,3646,9,3655,63
2020-11-12,Yuba,115,75493,1547,1410,7,1417,10
2020-11-11,Alameda,001,1643700,26492,25140,260,25400,429
2020-11-11,Alpine,003,1148,29,12,0,12,0
2020-11-11,Amador,005,37829,425,389,0,389,16
2020-11-11,Butte,007,227075,3590,3348,96,3444,58
2020-11-11,Calaveras,009,45235,379,373,0,373,21
2020-11-11,Colusa,011,21464,614,591,1,592,6
2020-11-11,Contra Costa,013,1133247,21482,20452,111,20563,255
2020-11-11,Del Norte,015,27424,230,203,0,203,2
2020-11-11,El Dorado,017,186661,1820,1564,8,1572,4
2020-11-11,Fresno,019,978130,37087,33287,804,34091,468
2020-11-11,Glenn,021,27897,790,722,16,738,3
2020-11-11,Humboldt,023,135768,698,623,1,624,9
2020-11-11,Imperial,025,180216,14224,13623,30,13653,340
2020-11-11,Inyo,027,18085,268,255,5,260,15
2020-11-11,Kern,029,883053,36700,35014,708,35722,449
2020-11-11,Kings,031,150075,9748,9263,99,9362,85
2020-11-11,Lake,033,64148,819,763,0,763,17
2020-11-11,Lassen,035,31185,1136,831,2,833,0
2020-11-11,Los Angeles,037,10098052,338083,324567,3938,328505,7220
2020-11-11,Madera,039,155013,5598,5248,80,5328,54
2020-11-11,Marin,041,260295,7435,7268,23,7291,133
2020-11-11,Mariposa,043,17540,92,84,0,84,2
2020-11-11,Mendocino,045,87422,1243,1142,5,1147,22
2020-11-11,Merced,047,269075,10461,10074,74,10148,157
2020-11-11,Modoc,049,8938,80,62,13,75,0
2020-11-11,Mono,051,14174,472,443,8,451,2
2020-11-11,Monterey,053,433212,13166,12417,141,12558,100
2020-11-11,Napa,055,140530,2595,2365,12,2377,15
2020-11-11,Nevada,057,99092,901,741,23,764,9
2020-11-11,Orange,059,3164182,67255,62929,2024,64953,1506
2020-11-11,Placer,061,380077,5530,4981,50,5031,60
2020-11-11,Plumas,063,18699,145,111,0,111,0
2020-11-11,Riverside,065,2383286,76710,72953,956,73909,1361
2020-11-11,Sacramento,067,1510023,30978,28968,51,29019,520
2020-11-11,San Benito,069,59416,1611,1512,1,1513,15
2020-11-11,San Bernardino,071,2135413,76336,70374,736,71110,1182
2020-11-11,San Diego,073,3302833,66889,61746,2122,63868,918
2020-11-11,San Francisco,075,870044,13882,13287,74,13361,146
2020-11-11,San Joaquin,077,732212,24031,23001,336,23337,509
2020-11-11,San Luis Obispo,079,281455,5410,4832,72,4904,33
2020-11-11,San Mateo,081,765935,12758,12008,10,12018,169
2020-11-11,Santa Barbara,083,443738,10649,10278,157,10435,134
2020-11-11,Santa Clara,085,1922200,29638,27075,56,27131,413
2020-11-11,Santa Cruz,087,273765,3565,3247,37,3284,25
2020-11-11,Shasta,089,179085,3810,2766,67,2833,36
2020-11-11,Sierra,091,2930,13,11,0,11,0
2020-11-11,Siskiyou,093,43540,343,261,17,278,0
2020-11-11,Solano,095,438530,8875,8353,43,8396,85
2020-11-11,Sonoma,097,501317,11061,10498,34,10532,150
2020-11-11,Stanislaus,099,539301,19431,18671,1006,19677,422
2020-11-11,Sutter,101,95872,2386,2049,6,2055,12
2020-11-11,Tehama,103,63373,1266,1105,5,1110,7
2020-11-11,Trinity,105,12862,165,62,20,82,0
2020-11-11,Tulare,107,460477,19470,18500,746,19246,305
2020-11-11,Tuolumne,109,53932,600,354,4,358,7
2020-11-11,Ventura,111,848112,17042,15801,470,16271,158
2020-11-11,Yolo,113,214977,3909,3606,9,3615,63
2020-11-11,Yuba,115,75493,1532,1400,7,1407,10
2020-11-10,Alameda,001,1643700,26262,25008,257,25265,424
2020-11-10,Alpine,003,1148,29,9,0,9,0
2020-11-10,Amador,005,37829,419,384,0,384,16
2020-11-10,Butte,007,227075,3554,3327,92,3419,58
2020-11-10,Calaveras,009,45235,374,367,0,367,21
2020-11-10,Colusa,011,21464,606,590,1,591,6
2020-11-10,Contra Costa,013,1133247,21275,20326,109,20435,255
2020-11-10,Del Norte,015,27424,224,196,0,196,2
2020-11-10,El Dorado,017,186661,1759,1551,8,1559,4
2020-11-10,Fresno,019,978130,36817,33024,766,33790,465
2020-11-10,Glenn,021,27897,782,719,12,731,3
2020-11-10,Humboldt,023,135768,681,610,1,611,9
2020-11-10,Imperial,025,180216,14095,13570,30,13600,338
2020-11-10,Inyo,027,18085,267,252,5,257,14
2020-11-10,Kern,029,883053,36423,34858,689,35547,448
2020-11-10,Kings,031,150075,9701,9236,92,9328,85
2020-11-10,Lake,033,64148,809,762,0,762,16
2020-11-10,Lassen,035,31185,1121,830,2,832,0
2020-11-10,Los Angeles,037,10098052,334831,322569,3824,326393,7205
2020-11-10,Madera,039,155013,5556,5229,74,5303,54
2020-11-10,Marin,041,260295,7416,7259,23,7282,133
2020-11-10,Mariposa,043,17540,90,84,0,84,2
2020-11-10,Mendocino,045,87422,1235,1137,5,1142,22
2020-11-10,Merced,047,269075,10399,9992,68,10060,157
2020-11-10,Modoc,049,8938,78,61,13,74,0
2020-11-10,Mono,051,14174,470,443,8,451,2
2020-11-10,Monterey,053,433212,13031,12335,133,12468,100
2020-11-10,Napa,055,140530,2557,2341,10,2351,15
2020-11-10,Nevada,057,99092,885,734,23,757,9
2020-11-10,Orange,059,3164182,66704,62597,2014,64611,1504
2020-11-10,Placer,061,380077,5450,4902,49,4951,60
2020-11-10,Plumas,063,18699,141,108,0,108,0
2020-11-10,Riverside,065,2383286,76068,72316,929,73245,1359
2020-11-10,Sacramento,067,1510023,30571,28677,48,28725,519
2020-11-10,San Benito,069,59416,1596,1508,1,1509,15
2020-11-10,San Bernardino,071,2135413,75166,69666,703,70369,1182
2020-11-10,San Diego,073,3302833,65998,61085,2085,63170,915
2020-11-10,San Francisco,075,870044,13765,13210,74,13284,146
2020-11-10,San Joaquin,077,732212,23866,22865,329,23194,508
2020-11-10,San Luis Obispo,079,281455,5347,4780,69,4849,33
2020-11-10,San Mateo,081,765935,12657,11939,10,11949,169
2020-11-10,Santa Barbara,083,443738,10582,10252,153,10405,134
2020-11-10,Santa Clara,085,1922200,29294,26917,55,26972,409
2020-11-10,Santa Cruz,087,273765,3501,3221,37,3258,25
2020-11-10,Shasta,089,179085,3667,2686,59,2745,36
2020-11-10,Sierra,091,2930,12,10,0,10,0
2020-11-10,Siskiyou,093,43540,326,263,16,279,0
2020-11-10,Solano,095,438530,8777,8299,43,8342,85
2020-11-10,Sonoma,097,501317,10974,10414,34,10448,150
2020-11-10,Stanislaus,099,539301,19297,18592,982,19574,420
2020-11-10,Sutter,101,95872,2291,2035,5,2040,12
2020-11-10,Tehama,103,63373,1240,1099,4,1103,7
2020-11-10,Trinity,105,12862,156,62,18,80,0
2020-11-10,Tulare,107,460477,19355,18430,722,19152,305
2020-11-10,Tuolumne,109,53932,552,353,4,357,7
2020-11-10,Ventura,111,848112,16859,15625,468,16093,158
2020-11-10,Yolo,113,214977,3848,3573,9,3582,63
2020-11-10,Yuba,115,75493,1509,1392,7,1399,10
2020-11-09,Alameda,001,1643700,26013,24899,253,25152,424
2020-11-09,Alpine,003,1148,27,6,0,6,0
2020-11-09,Amador,005,37829,410,380,0,380,16
2020-11-09,Butte,007,227075,3509,3301,83,3384,57
2020-11-09,Calaveras,009,45235,370,360,0,360,21
2020-11-09,Colusa,011,21464,600,583,1,584,6
2020-11-09,Contra Costa,013,1133247,21102,20193,107,20300,255
2020-11-09,Del Norte,015,27424,218,195,0,195,2
2020-11-09,El Dorado,017,186661,1718,1515,8,1523,4
2020-11-09,Fresno,019,978130,36506,32755,726,33481,465
2020-11-09,Glenn,021,27897,776,714,9,723,3
2020-11-09,Humboldt,023,135768,668,607,1,608,9
2020-11-09,Imperial,025,180216,13978,13508,29,13537,338
2020-11-09,Inyo,027,18085,267,252,5,257,14
2020-11-09,Kern,029,883053,36192,34764,653,35417,448
2020-11-09,Kings,031,150075,9631,9141,90,9231,84
2020-11-09,Lake,033,64148,800,755,0,755,16
2020-11-09,Lassen,035,31185,1025,799,2,801,0
2020-11-09,Los Angeles,037,10098052,331735,320370,3748,324118,7180
2020-11-09,Madera,039,155013,5510,5209,71,5280,54
2020-11-09,Marin,041,260295,7390,7237,22,7259,131
2020-11-09,Mariposa,043,17540,90,84,0,84,2
2020-11-09,Mendocino,045,87422,1223,1132,5,1137,22
2020-11-09,Merced,047,269075,10296,9922,65,9987,157
2020-11-09,Modoc,049,8938,74,54,12,66,0
2020-11-09,Mono,051,14174,467,352,8,360,2
2020-11-09,Monterey,053,433212,12884,12148,124,12272,98
2020-11-09,Napa,055,140530,2514,2309,10,2319,15
2020-11-09,Nevada,057,99092,848,729,22,751,9
2020-11-09,Orange,059,3164182,66063,62335,2002,64337,1501
2020-11-09,Placer,061,380077,5365,4843,37,4880,60
2020-11-09,Plumas,063,18699,134,102,0,102,0
2020-11-09,Riverside,065,2383286,75284,72059,895,72954,1346
2020-11-09,Sacramento,067,1510023,30100,28200,48,28248,516
2020-11-09,San Benito,069,59416,1587,1506,1,1507,15
2020-11-09,San Bernardino,071,2135413,74112,69015,661,69676,1182
2020-11-09,San Diego,073,3302833,65143,60572,2045,62617,908
2020-11-09,San Francisco,075,870044,13645,12984,71,13055,146
2020-11-09,San Joaquin,077,732212,23701,22512,324,22836,505
2020-11-09,San Luis Obispo,079,281455,5260,4746,67,4813,32
2020-11-09,San Mateo,081,765935,12550,11857,10,11867,169
2020-11-09,Santa Barbara,083,443738,10525,10214,147,10361,134
2020-11-09,Santa Clara,085,1922200,28899,26693,55,26748,409
2020-11-09,Santa Cruz,087,273765,3443,3194,37,3231,25
2020-11-09,Shasta,089,179085,3513,2581,50,2631,36
2020-11-09,Sierra,091,2930,10,10,0,10,0
2020-11-09,Siskiyou,093,43540,315,257,14,271,0
2020-11-09,Solano,095,438530,8661,8254,42,8296,85
2020-11-09,Sonoma,097,501317,10866,10310,34,10344,150
2020-11-09,Stanislaus,099,539301,19144,18482,965,19447,418
2020-11-09,Sutter,101,95872,2224,2010,4,2014,12
2020-11-09,Tehama,103,63373,1204,1071,3,1074,7
2020-11-09,Trinity,105,12862,149,46,18,64,0
2020-11-09,Tulare,107,460477,19235,18272,690,18962,304
2020-11-09,Tuolumne,109,53932,498,346,4,350,7
2020-11-09,Ventura,111,848112,16657,15568,465,16033,156
2020-11-09,Yolo,113,214977,3788,3522,9,3531,62
2020-11-09,Yuba,115,75493,1476,1380,7,1387,10
2020-11-08,Alameda,001,1643700,25783,24731,253,24984,424
2020-11-08,Alpine,003,1148,24,6,0,6,0
2020-11-08,Amador,005,37829,403,376,0,376,16
2020-11-08,Butte,007,227075,3471,3285,76,3361,57
2020-11-08,Calaveras,009,45235,368,360,0,360,21
2020-11-08,Colusa,011,21464,597,583,1,584,6
2020-11-08,Contra Costa,013,1133247,20932,20031,105,20136,254
2020-11-08,Del Norte,015,27424,210,195,0,195,2
2020-11-08,El Dorado,017,186661,1680,1502,8,1510,4
2020-11-08,Fresno,019,978130,36170,32619,688,33307,465
2020-11-08,Glenn,021,27897,770,707,8,715,3
2020-11-08,Humboldt,023,135768,652,605,1,606,9
2020-11-08,Imperial,025,180216,13862,13428,29,13457,338
2020-11-08,Inyo,027,18085,263,252,5,257,14
2020-11-08,Kern,029,883053,35973,34644,636,35280,448
2020-11-08,Kings,031,150075,9498,9026,87,9113,84
2020-11-08,Lake,033,64148,792,754,0,754,16
2020-11-08,Lassen,035,31185,877,799,2,801,0
2020-11-08,Los Angeles,037,10098052,328609,318960,3680,322640,7176
2020-11-08,Madera,039,155013,5441,5196,68,5264,54
2020-11-08,Marin,041,260295,7370,7227,22,7249,131
2020-11-08,Mariposa,043,17540,90,83,0,83,2
2020-11-08,Mendocino,045,87422,1214,1129,5,1134,22
2020-11-08,Merced,047,269075,10221,9885,63,9948,157
2020-11-08,Modoc,049,8938,70,54,12,66,0
2020-11-08,Mono,051,14174,461,352,8,360,2
2020-11-08,Monterey,053,433212,12739,12122,113,12235,98
2020-11-08,Napa,055,140530,2474,2274,10,2284,15
2020-11-08,Nevada,057,99092,832,715,22,737,9
2020-11-08,Orange,059,3164182,65474,62034,1988,64022,1501
2020-11-08,Placer,061,380077,5262,4800,32,4832,60
2020-11-08,Plumas,063,18699,129,102,0,102,0
2020-11-08,Riverside,065,2383286,74629,71442,853,72295,1345
2020-11-08,Sacramento,067,1510023,29540,28059,45,28104,515
2020-11-08,San Benito,069,59416,1572,1496,1,1497,15
2020-11-08,San Bernardino,071,2135413,72859,68412,622,69034,1182
2020-11-08,San Diego,073,3302833,64298,60199,2001,62200,908
2020-11-08,San Francisco,075,870044,13514,12985,66,13051,146
2020-11-08,San Joaquin,077,732212,23507,22514,320,22834,505
2020-11-08,San Luis Obispo,079,281455,5194,4698,62,4760,32
2020-11-08,San Mateo,081,765935,12431,11783,10,11793,169
2020-11-08,Santa Barbara,083,443738,10455,10180,145,10325,134
2020-11-08,Santa Clara,085,1922200,28525,26442,54,26496,410
2020-11-08,Santa Cruz,087,273765,3386,3134,37,3171,25
2020-11-08,Shasta,089,179085,3377,2582,44,2626,36
2020-11-08,Sierra,091,2930,10,7,0,7,0
2020-11-08,Siskiyou,093,43540,303,246,13,259,0
2020-11-08,Solano,095,438530,8540,8132,41,8173,85
2020-11-08,Sonoma,097,501317,10759,10229,34,10263,149
2020-11-08,Stanislaus,099,539301,18969,18413,944,19357,418
2020-11-08,Sutter,101,95872,2166,1980,4,1984,12
2020-11-08,Tehama,103,63373,1180,1054,3,1057,7
2020-11-08,Trinity,105,12862,146,46,17,63,0
2020-11-08,Tulare,107,460477,19092,18272,660,18932,304
2020-11-08,Tuolumne,109,53932,471,341,4,345,7
2020-11-08,Ventura,111,848112,16462,15504,457,15961,156
2020-11-08,Yolo,113,214977,3727,3492,9,3501,61
2020-11-08,Yuba,115,75493,1455,1369,7,1376,10
2020-11-07,Alameda,001,1643700,25673,24578,251,24829,424
2020-11-07,Alpine,003,1148,24,6,0,6,0
2020-11-07,Amador,005,37829,400,375,0,375,16
2020-11-07,Butte,007,227075,3459,3277,71,3348,57
2020-11-07,Calaveras,009,45235,366,360,0,360,21
2020-11-07,Colusa,011,21464,597,583,1,584,6
2020-11-07,Contra Costa,013,1133247,20831,19943,104,20047,254
2020-11-07,Del Norte,015,27424,206,194,0,194,2
2020-11-07,El Dorado,017,186661,1655,1495,7,1502,4
2020-11-07,Fresno,019,978130,36016,32497,665,33162,465
2020-11-07,Glenn,021,27897,762,707,8,715,3
2020-11-07,Humboldt,023,135768,641,590,1,591,9
2020-11-07,Imperial,025,180216,13804,13388,28,13416,338
2020-11-07,Inyo,027,18085,261,252,5,257,14
2020-11-07,Kern,029,883053,35818,34513,626,35139,448
2020-11-07,Kings,031,150075,9465,9005,81,9086,84
2020-11-07,Lake,033,64148,788,751,0,751,16
2020-11-07,Lassen,035,31185,861,799,2,801,0
2020-11-07,Los Angeles,037,10098052,327101,316756,3612,320368,7174
2020-11-07,Madera,039,155013,5419,5177,66,5243,54
2020-11-07,Marin,041,260295,7359,7215,22,7237,131
2020-11-07,Mariposa,043,17540,90,81,0,81,2
2020-11-07,Mendocino,045,87422,1203,1118,5,1123,22
2020-11-07,Merced,047,269075,10189,9855,59,9914,157
2020-11-07,Modoc,049,8938,70,51,12,63,0
2020-11-07,Mono,051,14174,458,352,8,360,2
2020-11-07,Monterey,053,433212,12670,12030,109,12139,98
2020-11-07,Napa,055,140530,2444,2260,9,2269,15
2020-11-07,Nevada,057,99092,815,710,22,732,9
2020-11-07,Orange,059,3164182,65187,62038,1982,64020,1505
2020-11-07,Placer,061,380077,5199,4745,32,4777,60
2020-11-07,Plumas,063,18699,127,94,0,94,0
2020-11-07,Riverside,065,2383286,74234,71153,825,71978,1345
2020-11-07,Sacramento,067,1510023,29289,27773,45,27818,515
2020-11-07,San Benito,069,59416,1560,1489,1,1490,15
2020-11-07,San Bernardino,071,2135413,72344,67935,611,68546,1182
2020-11-07,San Diego,073,3302833,63786,59682,1969,61651,909
2020-11-07,San Francisco,075,870044,13453,12980,65,13045,146
2020-11-07,San Joaquin,077,732212,23398,22517,314,22831,505
2020-11-07,San Luis Obispo,079,281455,5145,4668,59,4727,32
2020-11-07,San Mateo,081,765935,12368,11711,10,11721,169
2020-11-07,Santa Barbara,083,443738,10413,10157,143,10300,134
2020-11-07,Santa Clara,085,1922200,28320,26244,53,26297,410
2020-11-07,Santa Cruz,087,273765,3348,3130,37,3167,25
2020-11-07,Shasta,089,179085,3310,2547,42,2589,36
2020-11-07,Sierra,091,2930,10,7,0,7,0
2020-11-07,Siskiyou,093,43540,299,241,13,254,0
2020-11-07,Solano,095,438530,8488,8066,41,8107,85
2020-11-07,Sonoma,097,501317,10713,10200,34,10234,149
2020-11-07,Stanislaus,099,539301,18860,18386,927,19313,418
2020-11-07,Sutter,101,95872,2126,1973,4,1977,12
2020-11-07,Tehama,103,63373,1156,1043,3,1046,7
2020-11-07,Trinity,105,12862,146,42,16,58,0
2020-11-07,Tulare,107,460477,19036,18229,643,18872,304
2020-11-07,Tuolumne,109,53932,460,327,4,331,7
2020-11-07,Ventura,111,848112,16402,15364,452,15816,156
2020-11-07,Yolo,113,214977,3696,3486,9,3495,61
2020-11-07,Yuba,115,75493,1440,1349,7,1356,10
2020-11-06,Alameda,001,1643700,25541,24389,249,24638,420
2020-11-06,Alpine,003,1148,24,6,0,6,0
2020-11-06,Amador,005,37829,398,369,0,369,16
2020-11-06,Butte,007,227075,3434,3254,63,3317,57
2020-11-06,Calaveras,009,45235,365,359,0,359,21
2020-11-06,Colusa,011,21464,595,580,1,581,6
2020-11-06,Contra Costa,013,1133247,20682,19744,104,19848,252
2020-11-06,Del Norte,015,27424,203,194,0,194,2
2020-11-06,El Dorado,017,186661,1629,1475,7,1482,4
2020-11-06,Fresno,019,978130,35828,32278,649,32927,460
2020-11-06,Glenn,021,27897,756,707,7,714,3
2020-11-06,Humboldt,023,135768,638,587,1,588,9
2020-11-06,Imperial,025,180216,13751,13230,28,13258,338
2020-11-06,Inyo,027,18085,259,246,5,251,14
2020-11-06,Kern,029,883053,35653,34360,608,34968,443
2020-11-06,Kings,031,150075,9441,8883,79,8962,83
2020-11-06,Lake,033,64148,787,741,0,741,16
2020-11-06,Lassen,035,31185,853,794,2,796,0
2020-11-06,Los Angeles,037,10098052,325128,314356,3559,317915,7160
2020-11-06,Madera,039,155013,5403,5136,65,5201,54
2020-11-06,Marin,041,260295,7338,7184,22,7206,131
2020-11-06,Mariposa,043,17540,89,79,0,79,2
2020-11-06,Mendocino,045,87422,1198,1113,5,1118,22
2020-11-06,Merced,047,269075,10149,9778,56,9834,157
2020-11-06,Modoc,049,8938,70,48,12,60,0
2020-11-06,Mono,051,14174,452,308,8,316,1
2020-11-06,Monterey,053,433212,12553,11914,108,12022,96
2020-11-06,Napa,055,140530,2419,2189,9,2198,15
2020-11-06,Nevada,057,99092,802,692,21,713,9
2020-11-06,Orange,059,3164182,64884,61049,1972,63021,1494
2020-11-06,Placer,061,380077,5126,4680,32,4712,60
2020-11-06,Plumas,063,18699,122,90,0,90,0
2020-11-06,Riverside,065,2383286,73784,70409,784,71193,1341
2020-11-06,Sacramento,067,1510023,28997,27489,43,27532,514
2020-11-06,San Benito,069,59416,1551,1479,1,1480,15
2020-11-06,San Bernardino,071,2135413,71747,66740,590,67330,1179
2020-11-06,San Diego,073,3302833,63262,59143,1937,61080,907
2020-11-06,San Francisco,075,870044,13383,12825,64,12889,146
2020-11-06,San Joaquin,077,732212,23313,22424,304,22728,502
2020-11-06,San Luis Obispo,079,281455,5080,4531,53,4584,32
2020-11-06,San Mateo,081,765935,12293,11587,10,11597,168
2020-11-06,Santa Barbara,083,443738,10377,10118,138,10256,133
2020-11-06,Santa Clara,085,1922200,28078,25831,53,25884,402
2020-11-06,Santa Cruz,087,273765,3311,3063,37,3100,25
2020-11-06,Shasta,089,179085,3237,2475,41,2516,35
2020-11-06,Sierra,091,2930,9,7,0,7,0
2020-11-06,Siskiyou,093,43540,286,237,12,249,0
2020-11-06,Solano,095,438530,8423,7959,41,8000,85
2020-11-06,Sonoma,097,501317,10663,10142,34,10176,149
2020-11-06,Stanislaus,099,539301,18773,18250,918,19168,417
2020-11-06,Sutter,101,95872,2099,1937,2,1939,12
2020-11-06,Tehama,103,63373,1135,1024,3,1027,6
2020-11-06,Trinity,105,12862,143,41,16,57,0
2020-11-06,Tulare,107,460477,18972,18136,618,18754,300
2020-11-06,Tuolumne,109,53932,439,316,4,320,5
2020-11-06,Ventura,111,848112,16316,15222,449,15671,154
2020-11-06,Yolo,113,214977,3667,3420,9,3429,62
2020-11-06,Yuba,115,75493,1427,1335,7,1342,10
2020-11-05,Alameda,001,1643700,25363,24270,249,24519,420
2020-11-05,Alpine,003,1148,24,6,0,6,0
2020-11-05,Amador,005,37829,395,363,0,363,16
2020-11-05,Butte,007,227075,3411,3239,57,3296,57
2020-11-05,Calaveras,009,45235,358,333,0,333,19
2020-11-05,Colusa,011,21464,591,574,1,575,6
2020-11-05,Contra Costa,013,1133247,20500,19656,102,19758,252
2020-11-05,Del Norte,015,27424,201,192,0,192,2
2020-11-05,El Dorado,017,186661,1605,1466,7,1473,4
2020-11-05,Fresno,019,978130,35585,32056,624,32680,460
2020-11-05,Glenn,021,27897,736,702,7,709,3
2020-11-05,Humboldt,023,135768,627,581,1,582,9
2020-11-05,Imperial,025,180216,13659,13178,27,13205,337
2020-11-05,Inyo,027,18085,259,247,5,252,14
2020-11-05,Kern,029,883053,35451,34232,594,34826,443
2020-11-05,Kings,031,150075,9286,8846,76,8922,83
2020-11-05,Lake,033,64148,783,739,0,739,16
2020-11-05,Lassen,035,31185,822,782,2,784,0
2020-11-05,Los Angeles,037,10098052,322772,312381,3506,315887,7146
2020-11-05,Madera,039,155013,5364,5129,62,5191,54
2020-11-05,Marin,041,260295,7316,7171,22,7193,131
2020-11-05,Mariposa,043,17540,88,79,0,79,2
2020-11-05,Mendocino,045,87422,1186,1112,5,1117,22
2020-11-05,Merced,047,269075,10090,9753,51,9804,155
2020-11-05,Modoc,049,8938,69,47,11,58,0
2020-11-05,Mono,051,14174,450,307,8,315,1
2020-11-05,Monterey,053,433212,12445,11784,104,11888,96
2020-11-05,Napa,055,140530,2392,2158,9,2167,15
2020-11-05,Nevada,057,99092,780,687,20,707,9
2020-11-05,Orange,059,3164182,64437,60740,1962,62702,1484
2020-11-05,Placer,061,380077,5057,4627,27,4654,60
2020-11-05,Plumas,063,18699,114,90,0,90,0
2020-11-05,Riverside,065,2383286,73073,70094,726,70820,1338
2020-11-05,Sacramento,067,1510023,28616,27232,42,27274,512
2020-11-05,San Benito,069,59416,1536,1477,1,1478,15
2020-11-05,San Bernardino,071,2135413,70918,66407,577,66984,1174
2020-11-05,San Diego,073,3302833,62636,58659,1911,60570,904
2020-11-05,San Francisco,075,870044,13271,12726,63,12789,146
2020-11-05,San Joaquin,077,732212,23149,22318,300,22618,502
2020-11-05,San Luis Obispo,079,281455,5013,4459,51,4510,32
2020-11-05,San Mateo,081,765935,12199,11535,10,11545,168
2020-11-05,Santa Barbara,083,443738,10333,10080,135,10215,133
2020-11-05,Santa Clara,085,1922200,27811,25651,53,25704,402
2020-11-05,Santa Cruz,087,273765,3273,3023,37,3060,25
2020-11-05,Shasta,089,179085,3147,2401,40,2441,34
2020-11-05,Sierra,091,2930,9,6,0,6,0
2020-11-05,Siskiyou,093,43540,275,228,12,240,0
2020-11-05,Solano,095,438530,8340,7842,41,7883,85
2020-11-05,Sonoma,097,501317,10551,10064,33,10097,145
2020-11-05,Stanislaus,099,539301,18659,18194,905,19099,417
2020-11-05,Sutter,101,95872,2067,1925,2,1927,12
2020-11-05,Tehama,103,63373,1113,1015,2,1017,6
2020-11-05,Trinity,105,12862,127,41,15,56,0
2020-11-05,Tulare,107,460477,18884,18049,592,18641,301
2020-11-05,Tuolumne,109,53932,410,312,4,316,5
2020-11-05,Ventura,111,848112,16150,15113,438,15551,155
2020-11-05,Yolo,113,214977,3617,3391,9,3400,61
2020-11-05,Yuba,115,75493,1409,1322,7,1329,10
2020-11-04,Alameda,001,1643700,25186,24172,247,24419,418
2020-11-04,Alpine,003,1148,20,5,0,5,0
2020-11-04,Amador,005,37829,392,362,0,362,16
2020-11-04,Butte,007,227075,3385,3218,54,3272,57
2020-11-04,Calaveras,009,45235,355,290,0,290,19
2020-11-04,Colusa,011,21464,589,571,1,572,6
2020-11-04,Contra Costa,013,1133247,20333,19472,99,19571,251
2020-11-04,Del Norte,015,27424,197,188,0,188,2
2020-11-04,El Dorado,017,186661,1590,1448,4,1452,4
2020-11-04,Fresno,019,978130,35352,31952,596,32548,457
2020-11-04,Glenn,021,27897,732,701,6,707,3
2020-11-04,Humboldt,023,135768,618,571,1,572,9
2020-11-04,Imperial,025,180216,13561,13087,27,13114,335
2020-11-04,Inyo,027,18085,258,247,5,252,14
2020-11-04,Kern,029,883053,35296,34027,583,34610,439
2020-11-04,Kings,031,150075,9252,8817,74,8891,83
2020-11-04,Lake,033,64148,776,735,0,735,16
2020-11-04,Lassen,035,31185,817,781,2,783,0
2020-11-04,Los Angeles,037,10098052,320462,310456,3426,313882,7124
2020-11-04,Madera,039,155013,5344,5083,58,5141,54
2020-11-04,Marin,041,260295,7304,7157,22,7179,131
2020-11-04,Mariposa,043,17540,88,79,0,79,2
2020-11-04,Mendocino,045,87422,1168,1089,5,1094,22
2020-11-04,Merced,047,269075,10040,9717,49,9766,153
2020-11-04,Modoc,049,8938,59,47,11,58,0
2020-11-04,Mono,051,14174,447,237,7,244,1
2020-11-04,Monterey,053,433212,12241,11743,98,11841,96
2020-11-04,Napa,055,140530,2338,2133,9,2142,15
2020-11-04,Nevada,057,99092,761,675,20,695,9
2020-11-04,Orange,059,3164182,64003,60463,1939,62402,1483
2020-11-04,Placer,061,380077,4978,4526,24,4550,60
2020-11-04,Plumas,063,18699,112,88,0,88,0
2020-11-04,Riverside,065,2383286,72456,69562,667,70229,1335
2020-11-04,Sacramento,067,1510023,28265,27005,41,27046,510
2020-11-04,San Benito,069,59416,1521,1464,1,1465,15
2020-11-04,San Bernardino,071,2135413,70119,65891,554,66445,1169
2020-11-04,San Diego,073,3302833,61990,58126,1885,60011,904
2020-11-04,San Francisco,075,870044,13187,12649,60,12709,146
2020-11-04,San Joaquin,077,732212,23012,22197,287,22484,500
2020-11-04,San Luis Obispo,079,281455,4946,4389,49,4438,32
2020-11-04,San Mateo,081,765935,12104,11456,10,11466,168
2020-11-04,Santa Barbara,083,443738,10295,10026,134,10160,132
2020-11-04,Santa Clara,085,1922200,27548,25487,53,25540,393
2020-11-04,Santa Cruz,087,273765,3236,2997,37,3034,25
2020-11-04,Shasta,089,179085,3016,2321,35,2356,34
2020-11-04,Sierra,091,2930,9,6,0,6,0
2020-11-04,Siskiyou,093,43540,266,222,12,234,0
2020-11-04,Solano,095,438530,8241,7733,41,7774,85
2020-11-04,Sonoma,097,501317,10457,9965,33,9998,142
2020-11-04,Stanislaus,099,539301,18542,18114,890,19004,416
2020-11-04,Sutter,101,95872,2033,1916,2,1918,12
2020-11-04,Tehama,103,63373,1088,997,2,999,6
2020-11-04,Trinity,105,12862,123,37,15,52,0
2020-11-04,Tulare,107,460477,18775,17952,564,18516,298
2020-11-04,Tuolumne,109,53932,388,310,4,314,5
2020-11-04,Ventura,111,848112,16009,14936,435,15371,155
2020-11-04,Yolo,113,214977,3576,3361,9,3370,62
2020-11-04,Yuba,115,75493,1388,1312,7,1319,10
2020-11-03,Alameda,001,1643700,25002,24055,245,24300,418
2020-11-03,Alpine,003,1148,19,4,0,4,0
2020-11-03,Amador,005,37829,387,361,0,361,16
2020-11-03,Butte,007,227075,3361,3211,49,3260,57
2020-11-03,Calaveras,009,45235,351,287,0,287,19
2020-11-03,Colusa,011,21464,584,572,1,573,6
2020-11-03,Contra Costa,013,1133247,20178,19416,99,19515,250
2020-11-03,Del Norte,015,27424,196,187,0,187,2
2020-11-03,El Dorado,017,186661,1568,1445,3,1448,4
2020-11-03,Fresno,019,978130,35082,31856,573,32429,457
2020-11-03,Glenn,021,27897,726,698,6,704,3
2020-11-03,Humboldt,023,135768,612,570,1,571,8
2020-11-03,Imperial,025,180216,13472,13044,26,13070,335
2020-11-03,Inyo,027,18085,257,244,5,249,14
2020-11-03,Kern,029,883053,35105,33957,572,34529,439
2020-11-03,Kings,031,150075,9089,8783,69,8852,83
2020-11-03,Lake,033,64148,766,732,0,732,16
2020-11-03,Lassen,035,31185,808,782,2,784,0
2020-11-03,Los Angeles,037,10098052,318006,308812,3358,312170,7104
2020-11-03,Madera,039,155013,5307,5058,57,5115,54
2020-11-03,Marin,041,260295,7284,7147,21,7168,131
2020-11-03,Mariposa,043,17540,87,79,0,79,2
2020-11-03,Mendocino,045,87422,1153,1084,5,1089,22
2020-11-03,Merced,047,269075,9987,9713,48,9761,153
2020-11-03,Modoc,049,8938,57,47,9,56,0
2020-11-03,Mono,051,14174,443,210,7,217,1
2020-11-03,Monterey,053,433212,12172,11703,91,11794,94
2020-11-03,Napa,055,140530,2302,2130,9,2139,15
2020-11-03,Nevada,057,99092,741,670,19,689,9
2020-11-03,Orange,059,3164182,63573,60283,1928,62211,1477
2020-11-03,Placer,061,380077,4904,4514,24,4538,60
2020-11-03,Plumas,063,18699,109,86,0,86,0
2020-11-03,Riverside,065,2383286,71837,69300,642,69942,1325
2020-11-03,Sacramento,067,1510023,27885,26841,40,26881,510
2020-11-03,San Benito,069,59416,1511,1463,1,1464,15
2020-11-03,San Bernardino,071,2135413,69307,65320,546,65866,1159
2020-11-03,San Diego,073,3302833,61314,57722,1841,59563,901
2020-11-03,San Francisco,075,870044,13064,12585,60,12645,146
2020-11-03,San Joaquin,077,732212,22877,22109,281,22390,500
2020-11-03,San Luis Obispo,079,281455,4862,4371,47,4418,32
2020-11-03,San Mateo,081,765935,12009,11406,10,11416,162
2020-11-03,Santa Barbara,083,443738,10241,10008,129,10137,132
2020-11-03,Santa Clara,085,1922200,27276,25386,52,25438,393
2020-11-03,Santa Cruz,087,273765,3186,2980,36,3016,25
2020-11-03,Shasta,089,179085,2922,2288,28,2316,33
2020-11-03,Sierra,091,2930,7,6,0,6,0
2020-11-03,Siskiyou,093,43540,262,219,11,230,0
2020-11-03,Solano,095,438530,8158,7691,41,7732,85
2020-11-03,Sonoma,097,501317,10355,9906,33,9939,142
2020-11-03,Stanislaus,099,539301,18421,18080,879,18959,416
2020-11-03,Sutter,101,95872,2000,1914,2,1916,12
2020-11-03,Tehama,103,63373,1067,988,2,990,6
2020-11-03,Trinity,105,12862,116,36,14,50,0
2020-11-03,Tulare,107,460477,18669,17890,539,18429,297
2020-11-03,Tuolumne,109,53932,365,302,4,306,5
2020-11-03,Ventura,111,848112,15882,14816,428,15244,155
2020-11-03,Yolo,113,214977,3525,3343,9,3352,61
2020-11-03,Yuba,115,75493,1375,1295,7,1302,10
2020-11-02,Alameda,001,1643700,24806,23991,242,24233,419
2020-11-02,Alpine,003,1148,16,4,0,4,0
2020-11-02,Amador,005,37829,379,357,0,357,16
2020-11-02,Butte,007,227075,3341,3198,46,3244,57
2020-11-02,Calaveras,009,45235,351,282,0,282,18
2020-11-02,Colusa,011,21464,579,571,1,572,6
2020-11-02,Contra Costa,013,1133247,20024,19339,98,19437,250
2020-11-02,Del Norte,015,27424,193,175,0,175,2
2020-11-02,El Dorado,017,186661,1544,1405,3,1408,4
2020-11-02,Fresno,019,978130,34813,31738,556,32294,451
2020-11-02,Glenn,021,27897,720,692,5,697,3
2020-11-02,Humboldt,023,135768,603,569,1,570,8
2020-11-02,Imperial,025,180216,13392,13004,25,13029,334
2020-11-02,Inyo,027,18085,254,243,5,248,14
2020-11-02,Kern,029,883053,34947,33834,562,34396,437
2020-11-02,Kings,031,150075,9059,8654,66,8720,82
2020-11-02,Lake,033,64148,760,728,0,728,17
2020-11-02,Lassen,035,31185,800,782,2,784,0
2020-11-02,Los Angeles,037,10098052,315663,307620,3280,310900,7079
2020-11-02,Madera,039,155013,5276,5033,56,5089,54
2020-11-02,Marin,041,260295,7266,7132,20,7152,125
2020-11-02,Mariposa,043,17540,87,79,0,79,2
2020-11-02,Mendocino,045,87422,1139,1076,5,1081,21
2020-11-02,Merced,047,269075,9925,9664,42,9706,152
2020-11-02,Modoc,049,8938,54,45,5,50,0
2020-11-02,Mono,051,14174,441,211,7,218,1
2020-11-02,Monterey,053,433212,12065,11602,88,11690,93
2020-11-02,Napa,055,140530,2260,2081,9,2090,15
2020-11-02,Nevada,057,99092,725,656,19,675,9
2020-11-02,Orange,059,3164182,63168,59996,1912,61908,1474
2020-11-02,Placer,061,380077,4836,4461,22,4483,60
2020-11-02,Plumas,063,18699,101,86,0,86,0
2020-11-02,Riverside,065,2383286,71206,68833,601,69434,1321
2020-11-02,Sacramento,067,1510023,27543,26676,38,26714,508
2020-11-02,San Benito,069,59416,1499,1459,1,1460,15
2020-11-02,San Bernardino,071,2135413,68452,64629,535,65164,1157
2020-11-02,San Diego,073,3302833,60591,57429,1796,59225,891
2020-11-02,San Francisco,075,870044,12967,12436,59,12495,145
2020-11-02,San Joaquin,077,732212,22737,21919,273,22192,500
2020-11-02,San Luis Obispo,079,281455,4762,4303,44,4347,31
2020-11-02,San Mateo,081,765935,11900,11328,10,11338,161
2020-11-02,Santa Barbara,083,443738,10200,9985,124,10109,130
2020-11-02,Santa Clara,085,1922200,26986,25222,52,25274,387
2020-11-02,Santa Cruz,087,273765,3144,2943,36,2979,25
2020-11-02,Shasta,089,179085,2819,2174,24,2198,33
2020-11-02,Sierra,091,2930,7,6,0,6,0
2020-11-02,Siskiyou,093,43540,252,216,11,227,0
2020-11-02,Solano,095,438530,8040,7665,41,7706,84
2020-11-02,Sonoma,097,501317,10273,9796,32,9828,140
2020-11-02,Stanislaus,099,539301,18325,18005,870,18875,412
2020-11-02,Sutter,101,95872,1976,1895,2,1897,12
2020-11-02,Tehama,103,63373,1044,971,2,973,6
2020-11-02,Trinity,105,12862,110,30,14,44,0
2020-11-02,Tulare,107,460477,18576,17774,518,18292,299
2020-11-02,Tuolumne,109,53932,344,302,4,306,5
2020-11-02,Ventura,111,848112,15741,14767,414,15181,156
2020-11-02,Yolo,113,214977,3476,3318,9,3327,61
2020-11-02,Yuba,115,75493,1362,1280,7,1287,10
2020-11-01,Alameda,001,1643700,24643,23892,240,24132,419
2020-11-01,Alpine,003,1148,10,4,0,4,0
2020-11-01,Amador,005,37829,376,352,0,352,16
2020-11-01,Butte,007,227075,3317,3185,45,3230,57
2020-11-01,Calaveras,009,45235,350,282,0,282,18
2020-11-01,Colusa,011,21464,577,567,1,568,6
2020-11-01,Contra Costa,013,1133247,19850,19246,97,19343,250
2020-11-01,Del Norte,015,27424,189,175,0,175,2
2020-11-01,El Dorado,017,186661,1528,1394,3,1397,4
2020-11-01,Fresno,019,978130,34556,31613,536,32149,451
2020-11-01,Glenn,021,27897,711,688,3,691,3
2020-11-01,Humboldt,023,135768,595,568,1,569,8
2020-11-01,Imperial,025,180216,13301,12969,23,12992,334
2020-11-01,Inyo,027,18085,252,241,5,246,14
2020-11-01,Kern,029,883053,34766,33760,467,34227,437
2020-11-01,Kings,031,150075,9021,8641,65,8706,82
2020-11-01,Lake,033,64148,754,727,0,727,17
2020-11-01,Lassen,035,31185,800,782,2,784,0
2020-11-01,Los Angeles,037,10098052,313097,306217,3187,309404,7077
2020-11-01,Madera,039,155013,5228,5019,54,5073,54
2020-11-01,Marin,041,260295,7249,7124,20,7144,125
2020-11-01,Mariposa,043,17540,83,79,0,79,2
2020-11-01,Mendocino,045,87422,1126,1074,5,1079,21
2020-11-01,Merced,047,269075,9864,9626,42,9668,152
2020-11-01,Modoc,049,8938,53,45,5,50,0
2020-11-01,Mono,051,14174,412,211,6,217,1
2020-11-01,Monterey,053,433212,11957,11587,85,11672,93
2020-11-01,Napa,055,140530,2226,2067,9,2076,15
2020-11-01,Nevada,057,99092,709,646,18,664,9
2020-11-01,Orange,059,3164182,62766,59733,1885,61618,1475
2020-11-01,Placer,061,380077,4770,4422,21,4443,58
2020-11-01,Plumas,063,18699,96,86,0,86,0
2020-11-01,Riverside,065,2383286,70576,68493,565,69058,1319
2020-11-01,Sacramento,067,1510023,27222,26442,38,26480,508
2020-11-01,San Benito,069,59416,1484,1451,1,1452,15
2020-11-01,San Bernardino,071,2135413,67609,64339,514,64853,1157
2020-11-01,San Diego,073,3302833,59903,57122,1756,58878,891
2020-11-01,San Francisco,075,870044,12844,12436,54,12490,145
2020-11-01,San Joaquin,077,732212,22609,21919,267,22186,500
2020-11-01,San Luis Obispo,079,281455,4682,4303,43,4346,31
2020-11-01,San Mateo,081,765935,11819,11280,10,11290,160
2020-11-01,Santa Barbara,083,443738,10149,9969,108,10077,130
2020-11-01,Santa Clara,085,1922200,26706,25090,52,25142,386
2020-11-01,Santa Cruz,087,273765,3091,2921,36,2957,25
2020-11-01,Shasta,089,179085,2684,2172,23,2195,33
2020-11-01,Sierra,091,2930,7,6,0,6,0
2020-11-01,Siskiyou,093,43540,247,205,11,216,0
2020-11-01,Solano,095,438530,7950,7591,41,7632,84
2020-11-01,Sonoma,097,501317,10181,9688,32,9720,140
2020-11-01,Stanislaus,099,539301,18224,17961,850,18811,412
2020-11-01,Sutter,101,95872,1950,1888,1,1889,12
2020-11-01,Tehama,103,63373,1027,965,2,967,5
2020-11-01,Trinity,105,12862,108,30,13,43,0
2020-11-01,Tulare,107,460477,18464,17774,487,18261,299
2020-11-01,Tuolumne,109,53932,322,295,4,299,5
2020-11-01,Ventura,111,848112,15592,14686,383,15069,156
2020-11-01,Yolo,113,214977,3428,3303,9,3312,60
2020-11-01,Yuba,115,75493,1345,1273,7,1280,10
2020-10-31,Alameda,001,1643700,24527,23780,236,24016,416
2020-10-31,Alpine,003,1148,10,4,0,4,0
2020-10-31,Amador,005,37829,372,347,0,347,16
2020-10-31,Butte,007,227075,3304,3172,43,3215,57
2020-10-31,Calaveras,009,45235,350,280,0,280,18
2020-10-31,Colusa,011,21464,575,555,1,556,6
2020-10-31,Contra Costa,013,1133247,19744,19161,97,19258,249
2020-10-31,Del Norte,015,27424,188,175,0,175,2
2020-10-31,El Dorado,017,186661,1519,1390,3,1393,4
2020-10-31,Fresno,019,978130,34419,31558,533,32091,451
2020-10-31,Glenn,021,27897,709,678,3,681,3
2020-10-31,Humboldt,023,135768,592,561,1,562,8
2020-10-31,Imperial,025,180216,13259,12912,23,12935,334
2020-10-31,Inyo,027,18085,251,241,5,246,14
2020-10-31,Kern,029,883053,34663,33666,457,34123,437
2020-10-31,Kings,031,150075,9000,8612,64,8676,82
2020-10-31,Lake,033,64148,750,724,0,724,16
2020-10-31,Lassen,035,31185,795,782,2,784,0
2020-10-31,Los Angeles,037,10098052,311724,304704,3143,307847,7073
2020-10-31,Madera,039,155013,5210,5013,51,5064,54
2020-10-31,Marin,041,260295,7233,7112,20,7132,125
2020-10-31,Mariposa,043,17540,83,79,0,79,2
2020-10-31,Mendocino,045,87422,1118,1066,5,1071,21
2020-10-31,Merced,047,269075,9831,9597,41,9638,151
2020-10-31,Modoc,049,8938,52,34,4,38,0
2020-10-31,Mono,051,14174,263,194,5,199,1
2020-10-31,Monterey,053,433212,11889,11539,81,11620,93
2020-10-31,Napa,055,140530,2207,2040,9,2049,15
2020-10-31,Nevada,057,99092,691,644,18,662,9
2020-10-31,Orange,059,3164182,62508,59488,1867,61355,1473
2020-10-31,Placer,061,380077,4720,4374,20,4394,58
2020-10-31,Plumas,063,18699,95,85,0,85,0
2020-10-31,Riverside,065,2383286,70219,68178,542,68720,1319
2020-10-31,Sacramento,067,1510023,27023,26316,36,26352,507
2020-10-31,San Benito,069,59416,1477,1448,1,1449,15
2020-10-31,San Bernardino,071,2135413,67184,64016,504,64520,1157
2020-10-31,San Diego,073,3302833,59450,56769,1728,58497,891
2020-10-31,San Francisco,075,870044,12770,12438,53,12491,145
2020-10-31,San Joaquin,077,732212,22534,21918,258,22176,500
2020-10-31,San Luis Obispo,079,281455,4613,4285,40,4325,31
2020-10-31,San Mateo,081,765935,11767,11253,10,11263,160
2020-10-31,Santa Barbara,083,443738,10120,9957,100,10057,130
2020-10-31,Santa Clara,085,1922200,26537,24957,52,25009,379
2020-10-31,Santa Cruz,087,273765,3056,2895,35,2930,25
2020-10-31,Shasta,089,179085,2630,2122,22,2144,33
2020-10-31,Sierra,091,2930,7,6,0,6,0
2020-10-31,Siskiyou,093,43540,245,200,11,211,0
2020-10-31,Solano,095,438530,7886,7545,41,7586,84
2020-10-31,Sonoma,097,501317,10128,9648,32,9680,140
2020-10-31,Stanislaus,099,539301,18161,17920,834,18754,412
2020-10-31,Sutter,101,95872,1941,1876,1,1877,12
2020-10-31,Tehama,103,63373,1017,953,2,955,5
2020-10-31,Trinity,105,12862,105,30,13,43,0
2020-10-31,Tulare,107,460477,18415,17758,479,18237,299
2020-10-31,Tuolumne,109,53932,315,290,4,294,5
2020-10-31,Ventura,111,848112,15508,14635,365,15000,155
2020-10-31,Yolo,113,214977,3393,3290,9,3299,60
2020-10-31,Yuba,115,75493,1329,1260,6,1266,10
2020-10-30,Alameda,001,1643700,24447,23676,234,23910,401
2020-10-30,Alpine,003,1148,10,4,0,4,0
2020-10-30,Amador,005,37829,372,344,0,344,16
2020-10-30,Butte,007,227075,3299,3160,43,3203,57
2020-10-30,Calaveras,009,45235,349,279,0,279,18
2020-10-30,Colusa,011,21464,573,554,1,555,6
2020-10-30,Contra Costa,013,1133247,19672,19074,97,19171,249
2020-10-30,Del Norte,015,27424,187,175,0,175,2
2020-10-30,El Dorado,017,186661,1506,1386,3,1389,4
2020-10-30,Fresno,019,978130,34297,31409,524,31933,446
2020-10-30,Glenn,021,27897,703,674,2,676,3
2020-10-30,Humboldt,023,135768,591,561,1,562,7
2020-10-30,Imperial,025,180216,13218,12853,23,12876,334
2020-10-30,Inyo,027,18085,250,241,5,246,14
2020-10-30,Kern,029,883053,34570,33583,456,34039,437
2020-10-30,Kings,031,150075,8990,8564,62,8626,82
2020-10-30,Lake,033,64148,750,720,0,720,16
2020-10-30,Lassen,035,31185,789,777,2,779,0
2020-10-30,Los Angeles,037,10098052,310288,303425,3108,306533,7060
2020-10-30,Madera,039,155013,5198,4991,49,5040,54
2020-10-30,Marin,041,260295,7213,7097,20,7117,125
2020-10-30,Mariposa,043,17540,83,78,0,78,2
2020-10-30,Mendocino,045,87422,1116,1062,5,1067,21
2020-10-30,Merced,047,269075,9799,9539,41,9580,150
2020-10-30,Modoc,049,8938,51,34,3,37,0
2020-10-30,Mono,051,14174,262,193,5,198,1
2020-10-30,Monterey,053,433212,11826,11491,76,11567,92
2020-10-30,Napa,055,140530,2189,2028,9,2037,15
2020-10-30,Nevada,057,99092,685,634,18,652,9
2020-10-30,Orange,059,3164182,62266,59334,1855,61189,1469
2020-10-30,Placer,061,380077,4673,4335,20,4355,58
2020-10-30,Plumas,063,18699,92,80,0,80,0
2020-10-30,Riverside,065,2383286,69879,67752,522,68274,1317
2020-10-30,Sacramento,067,1510023,26875,26147,36,26183,505
2020-10-30,San Benito,069,59416,1471,1440,1,1441,15
2020-10-30,San Bernardino,071,2135413,66768,63512,501,64013,1156
2020-10-30,San Diego,073,3302833,59045,56387,1706,58093,888
2020-10-30,San Francisco,075,870044,12715,12384,53,12437,145
2020-10-30,San Joaquin,077,732212,22467,21849,252,22101,500
2020-10-30,San Luis Obispo,079,281455,4570,4256,40,4296,31
2020-10-30,San Mateo,081,765935,11708,11207,10,11217,159
2020-10-30,Santa Barbara,083,443738,10097,9937,100,10037,128
2020-10-30,Santa Clara,085,1922200,26388,24811,52,24863,378
2020-10-30,Santa Cruz,087,273765,3038,2874,35,2909,25
2020-10-30,Shasta,089,179085,2586,2048,21,2069,32
2020-10-30,Sierra,091,2930,7,6,0,6,0
2020-10-30,Siskiyou,093,43540,245,192,11,203,0
2020-10-30,Solano,095,438530,7825,7497,41,7538,84
2020-10-30,Sonoma,097,501317,10053,9602,32,9634,140
2020-10-30,Stanislaus,099,539301,18113,17861,818,18679,410
2020-10-30,Sutter,101,95872,1928,1860,1,1861,12
2020-10-30,Tehama,103,63373,1013,932,2,934,5
2020-10-30,Trinity,105,12862,105,29,13,42,0
2020-10-30,Tulare,107,460477,18370,17682,464,18146,299
2020-10-30,Tuolumne,109,53932,308,286,4,290,4
2020-10-30,Ventura,111,848112,15435,14578,353,14931,154
2020-10-30,Yolo,113,214977,3376,3263,9,3272,60
2020-10-30,Yuba,115,75493,1321,1256,6,1262,10
2020-10-29,Alameda,001,1643700,24283,23530,233,23763,401
2020-10-29,Alpine,003,1148,7,4,0,4,0
2020-10-29,Amador,005,37829,368,338,0,338,16
2020-10-29,Butte,007,227075,3281,3143,42,3185,57
2020-10-29,Calaveras,009,45235,347,278,0,278,13
2020-10-29,Colusa,011,21464,569,552,1,553,6
2020-10-29,Contra Costa,013,1133247,19573,18933,96,19029,249
2020-10-29,Del Norte,015,27424,185,174,0,174,2
2020-10-29,El Dorado,017,186661,1484,1370,3,1373,4
2020-10-29,Fresno,019,978130,34140,31321,517,31838,445
2020-10-29,Glenn,021,27897,701,673,2,675,3
2020-10-29,Humboldt,023,135768,586,559,1,560,7
2020-10-29,Imperial,025,180216,13174,12769,23,12792,334
2020-10-29,Inyo,027,18085,248,238,5,243,14
2020-10-29,Kern,029,883053,34469,33460,452,33912,437
2020-10-29,Kings,031,150075,8836,8502,61,8563,82
2020-10-29,Lake,033,64148,747,702,0,702,16
2020-10-29,Lassen,035,31185,788,772,2,774,0
2020-10-29,Los Angeles,037,10098052,308659,302246,3061,305307,7046
2020-10-29,Madera,039,155013,5168,4970,47,5017,53
2020-10-29,Marin,041,260295,7199,7083,20,7103,125
2020-10-29,Mariposa,043,17540,81,78,0,78,2
2020-10-29,Mendocino,045,87422,1110,1058,5,1063,21
2020-10-29,Merced,047,269075,9746,9496,41,9537,150
2020-10-29,Modoc,049,8938,49,31,3,34,0
2020-10-29,Mono,051,14174,255,176,5,181,1
2020-10-29,Monterey,053,433212,11745,11425,74,11499,92
2020-10-29,Napa,055,140530,2165,2009,9,2018,15
2020-10-29,Nevada,057,99092,678,632,18,650,9
2020-10-29,Orange,059,3164182,61998,59046,1835,60881,1464
2020-10-29,Placer,061,380077,4628,4270,18,4288,58
2020-10-29,Plumas,063,18699,90,69,0,69,0
2020-10-29,Riverside,065,2383286,69502,67268,492,67760,1304
2020-10-29,Sacramento,067,1510023,26663,25978,35,26013,507
2020-10-29,San Benito,069,59416,1466,1431,1,1432,15
2020-10-29,San Bernardino,071,2135413,66200,62968,491,63459,1150
2020-10-29,San Diego,073,3302833,58579,55916,1677,57593,885
2020-10-29,San Francisco,075,870044,12636,12312,53,12365,145
2020-10-29,San Joaquin,077,732212,22383,21736,240,21976,498
2020-10-29,San Luis Obispo,079,281455,4540,4223,39,4262,31
2020-10-29,San Mateo,081,765935,11662,11145,10,11155,157
2020-10-29,Santa Barbara,083,443738,10064,9902,98,10000,128
2020-10-29,Santa Clara,085,1922200,26236,24614,52,24666,377
2020-10-29,Santa Cruz,087,273765,3013,2850,35,2885,24
2020-10-29,Shasta,089,179085,2523,2008,21,2029,32
2020-10-29,Sierra,091,2930,6,6,0,6,0
2020-10-29,Siskiyou,093,43540,229,185,11,196,0
2020-10-29,Solano,095,438530,7763,7453,41,7494,78
2020-10-29,Sonoma,097,501317,9989,9533,32,9565,140
2020-10-29,Stanislaus,099,539301,18060,17790,797,18587,410
2020-10-29,Sutter,101,95872,1920,1852,1,1853,12
2020-10-29,Tehama,103,63373,995,925,2,927,5
2020-10-29,Trinity,105,12862,100,28,12,40,0
2020-10-29,Tulare,107,460477,18292,17627,445,18072,299
2020-10-29,Tuolumne,109,53932,303,279,4,283,4
2020-10-29,Ventura,111,848112,15344,14486,349,14835,154
2020-10-29,Yolo,113,214977,3347,3246,9,3255,60
2020-10-29,Yuba,115,75493,1310,1248,6,1254,10
2020-10-28,Alameda,001,1643700,24183,23468,232,23700,400
2020-10-28,Alpine,003,1148,6,4,0,4,0
2020-10-28,Amador,005,37829,365,337,0,337,16
2020-10-28,Butte,007,227075,3265,3134,39,3173,56
2020-10-28,Calaveras,009,45235,346,278,0,278,13
2020-10-28,Colusa,011,21464,566,551,1,552,6
2020-10-28,Contra Costa,013,1133247,19486,18828,95,18923,246
2020-10-28,Del Norte,015,27424,182,173,0,173,2
2020-10-28,El Dorado,017,186661,1472,1363,3,1366,4
2020-10-28,Fresno,019,978130,34018,31195,511,31706,444
2020-10-28,Glenn,021,27897,697,673,2,675,3
2020-10-28,Humboldt,023,135768,582,559,1,560,7
2020-10-28,Imperial,025,180216,13125,12730,23,12753,333
2020-10-28,Inyo,027,18085,248,238,5,243,14
2020-10-28,Kern,029,883053,34367,33424,433,33857,436
2020-10-28,Kings,031,150075,8814,8486,60,8546,82
2020-10-28,Lake,033,64148,744,700,0,700,15
2020-10-28,Lassen,035,31185,784,771,2,773,0
2020-10-28,Los Angeles,037,10098052,307200,300726,3019,303745,7031
2020-10-28,Madera,039,155013,5151,4954,46,5000,53
2020-10-28,Marin,041,260295,7188,7079,20,7099,126
2020-10-28,Mariposa,043,17540,81,78,0,78,2
2020-10-28,Mendocino,045,87422,1109,1037,5,1042,20
2020-10-28,Merced,047,269075,9720,9480,40,9520,150
2020-10-28,Modoc,049,8938,48,31,2,33,0
2020-10-28,Mono,051,14174,237,176,5,181,1
2020-10-28,Monterey,053,433212,11687,11330,72,11402,89
2020-10-28,Napa,055,140530,2139,1998,8,2006,15
2020-10-28,Nevada,057,99092,670,629,18,647,9
2020-10-28,Orange,059,3164182,61734,58801,1819,60620,1459
2020-10-28,Placer,061,380077,4572,4236,18,4254,57
2020-10-28,Plumas,063,18699,89,67,0,67,0
2020-10-28,Riverside,065,2383286,69104,67003,468,67471,1302
2020-10-28,Sacramento,067,1510023,26467,25838,34,25872,506
2020-10-28,San Benito,069,59416,1458,1429,1,1430,15
2020-10-28,San Bernardino,071,2135413,65740,62778,482,63260,1154
2020-10-28,San Diego,073,3302833,58196,55556,1648,57204,881
2020-10-28,San Francisco,075,870044,12578,12261,52,12313,145
2020-10-28,San Joaquin,077,732212,22299,21707,229,21936,498
2020-10-28,San Luis Obispo,079,281455,4496,4197,36,4233,31
2020-10-28,San Mateo,081,765935,11595,11101,10,11111,157
2020-10-28,Santa Barbara,083,443738,10040,9872,96,9968,127
2020-10-28,Santa Clara,085,1922200,26092,24503,52,24555,375
2020-10-28,Santa Cruz,087,273765,2982,2836,35,2871,24
2020-10-28,Shasta,089,179085,2443,1996,20,2016,31
2020-10-28,Sierra,091,2930,6,6,0,6,0
2020-10-28,Siskiyou,093,43540,226,182,10,192,0
2020-10-28,Solano,095,438530,7704,7362,41,7403,77
2020-10-28,Sonoma,097,501317,9899,9457,27,9484,140
2020-10-28,Stanislaus,099,539301,17995,17765,787,18552,409
2020-10-28,Sutter,101,95872,1911,1840,1,1841,12
2020-10-28,Tehama,103,63373,984,921,2,923,5
2020-10-28,Trinity,105,12862,93,28,11,39,0
2020-10-28,Tulare,107,460477,18235,17569,429,17998,297
2020-10-28,Tuolumne,109,53932,300,277,4,281,4
2020-10-28,Ventura,111,848112,15271,14409,340,14749,153
2020-10-28,Yolo,113,214977,3323,3230,9,3239,60
2020-10-28,Yuba,115,75493,1298,1245,6,1251,10
2020-10-27,Alameda,001,1643700,24067,23365,230,23595,400
2020-10-27,Alpine,003,1148,6,3,0,3,0
2020-10-27,Amador,005,37829,362,335,0,335,16
2020-10-27,Butte,007,227075,3248,3107,36,3143,56
2020-10-27,Calaveras,009,45235,344,277,0,277,13
2020-10-27,Colusa,011,21464,561,549,1,550,6
2020-10-27,Contra Costa,013,1133247,19381,18766,95,18861,246
2020-10-27,Del Norte,015,27424,179,173,0,173,2
2020-10-27,El Dorado,017,186661,1459,1351,3,1354,4
2020-10-27,Fresno,019,978130,33899,31096,506,31602,442
2020-10-27,Glenn,021,27897,695,667,1,668,3
2020-10-27,Humboldt,023,135768,579,559,1,560,7
2020-10-27,Imperial,025,180216,13076,12680,22,12702,333
2020-10-27,Inyo,027,18085,248,231,5,236,14
2020-10-27,Kern,029,883053,34250,33328,429,33757,436
2020-10-27,Kings,031,150075,8783,8411,60,8471,83
2020-10-27,Lake,033,64148,741,700,0,700,15
2020-10-27,Lassen,035,31185,782,764,2,766,0
2020-10-27,Los Angeles,037,10098052,305816,299438,2990,302428,7008
2020-10-27,Madera,039,155013,5121,4942,45,4987,53
2020-10-27,Marin,041,260295,7172,7070,20,7090,126
2020-10-27,Mariposa,043,17540,80,78,0,78,2
2020-10-27,Mendocino,045,87422,1103,1033,4,1037,20
2020-10-27,Merced,047,269075,9680,9449,40,9489,150
2020-10-27,Modoc,049,8938,46,31,2,33,0
2020-10-27,Mono,051,14174,223,169,5,174,1
2020-10-27,Monterey,053,433212,11631,11261,70,11331,88
2020-10-27,Napa,055,140530,2123,1979,8,1987,15
2020-10-27,Nevada,057,99092,664,622,18,640,8
2020-10-27,Orange,059,3164182,61463,58550,1803,60353,1448
2020-10-27,Placer,061,380077,4523,4197,16,4213,57
2020-10-27,Plumas,063,18699,86,63,0,63,0
2020-10-27,Riverside,065,2383286,68751,66699,423,67122,1299
2020-10-27,Sacramento,067,1510023,26280,25701,33,25734,501
2020-10-27,San Benito,069,59416,1453,1428,1,1429,15
2020-10-27,San Bernardino,071,2135413,65277,62357,469,62826,1154
2020-10-27,San Diego,073,3302833,57723,55226,1625,56851,877
2020-10-27,San Francisco,075,870044,12503,12218,51,12269,140
2020-10-27,San Joaquin,077,732212,22208,21637,220,21857,496
2020-10-27,San Luis Obispo,079,281455,4469,4148,32,4180,31
2020-10-27,San Mateo,081,765935,11546,11074,10,11084,156
2020-10-27,Santa Barbara,083,443738,10010,9874,95,9969,125
2020-10-27,Santa Clara,085,1922200,25950,24368,52,24420,367
2020-10-27,Santa Cruz,087,273765,2952,2815,34,2849,24
2020-10-27,Shasta,089,179085,2357,1962,20,1982,29
2020-10-27,Sierra,091,2930,6,6,0,6,0
2020-10-27,Siskiyou,093,43540,217,181,10,191,0
2020-10-27,Solano,095,438530,7635,7298,41,7339,77
2020-10-27,Sonoma,097,501317,9832,9389,27,9416,140
2020-10-27,Stanislaus,099,539301,17927,17720,780,18500,408
2020-10-27,Sutter,101,95872,1898,1832,1,1833,12
2020-10-27,Tehama,103,63373,970,913,2,915,5
2020-10-27,Trinity,105,12862,90,28,11,39,0
2020-10-27,Tulare,107,460477,18172,17520,406,17926,296
2020-10-27,Tuolumne,109,53932,296,275,4,279,4
2020-10-27,Ventura,111,848112,15188,14347,333,14680,153
2020-10-27,Yolo,113,214977,3309,3216,9,3225,58
2020-10-27,Yuba,115,75493,1285,1235,6,1241,10
2020-10-26,Alameda,001,1643700,23954,23284,229,23513,398
2020-10-26,Alpine,003,1148,4,3,0,3,0
2020-10-26,Amador,005,37829,358,331,0,331,16
2020-10-26,Butte,007,227075,3237,3095,34,3129,56
2020-10-26,Calaveras,009,45235,340,274,0,274,13
2020-10-26,Colusa,011,21464,559,548,1,549,6
2020-10-26,Contra Costa,013,1133247,19285,18718,94,18812,245
2020-10-26,Del Norte,015,27424,179,171,0,171,2
2020-10-26,El Dorado,017,186661,1445,1336,3,1339,4
2020-10-26,Fresno,019,978130,33786,30969,499,31468,441
2020-10-26,Glenn,021,27897,688,660,1,661,3
2020-10-26,Humboldt,023,135768,571,554,1,555,7
2020-10-26,Imperial,025,180216,13022,12654,19,12673,333
2020-10-26,Inyo,027,18085,248,226,5,231,14
2020-10-26,Kern,029,883053,34166,33233,424,33657,432
2020-10-26,Kings,031,150075,8761,8264,58,8322,82
2020-10-26,Lake,033,64148,739,697,0,697,15
2020-10-26,Lassen,035,31185,779,764,2,766,0
2020-10-26,Los Angeles,037,10098052,304388,297961,2948,300909,6979
2020-10-26,Madera,039,155013,5100,4922,44,4966,53
2020-10-26,Marin,041,260295,7166,7064,19,7083,104
2020-10-26,Mariposa,043,17540,80,77,0,77,2
2020-10-26,Mendocino,045,87422,1095,1026,4,1030,20
2020-10-26,Merced,047,269075,9633,9375,39,9414,150
2020-10-26,Modoc,049,8938,44,28,0,28,0
2020-10-26,Mono,051,14174,217,167,5,172,1
2020-10-26,Monterey,053,433212,11581,11207,66,11273,87
2020-10-26,Napa,055,140530,2091,1966,8,1974,14
2020-10-26,Nevada,057,99092,657,618,18,636,8
2020-10-26,Orange,059,3164182,61260,58377,1784,60161,1442
2020-10-26,Placer,061,380077,4481,4161,15,4176,57
2020-10-26,Plumas,063,18699,84,63,0,63,0
2020-10-26,Riverside,065,2383286,68299,66475,397,66872,1294
2020-10-26,Sacramento,067,1510023,26099,25555,31,25586,496
2020-10-26,San Benito,069,59416,1445,1424,1,1425,15
2020-10-26,San Bernardino,071,2135413,64806,61871,466,62337,1153
2020-10-26,San Diego,073,3302833,57330,54957,1587,56544,870
2020-10-26,San Francisco,075,870044,12443,12072,51,12123,138
2020-10-26,San Joaquin,077,732212,22125,21459,214,21673,495
2020-10-26,San Luis Obispo,079,281455,4444,4133,32,4165,31
2020-10-26,San Mateo,081,765935,11502,11037,10,11047,156
2020-10-26,Santa Barbara,083,443738,9987,9827,95,9922,122
2020-10-26,Santa Clara,085,1922200,25760,24258,51,24309,365
2020-10-26,Santa Cruz,087,273765,2926,2808,34,2842,24
2020-10-26,Shasta,089,179085,2303,1889,20,1909,29
2020-10-26,Sierra,091,2930,6,6,0,6,0
2020-10-26,Siskiyou,093,43540,209,179,10,189,0
2020-10-26,Solano,095,438530,7555,7271,41,7312,62
2020-10-26,Sonoma,097,501317,9753,9315,27,9342,140
2020-10-26,Stanislaus,099,539301,17877,17666,770,18436,400
2020-10-26,Sutter,101,95872,1890,1817,1,1818,12
2020-10-26,Tehama,103,63373,950,892,2,894,5
2020-10-26,Trinity,105,12862,89,26,11,37,0
2020-10-26,Tulare,107,460477,18095,17432,383,17815,296
2020-10-26,Tuolumne,109,53932,287,271,4,275,4
2020-10-26,Ventura,111,848112,15118,14330,330,14660,154
2020-10-26,Yolo,113,214977,3290,3206,9,3215,58
2020-10-26,Yuba,115,75493,1269,1226,6,1232,10
2020-10-25,Alameda,001,1643700,23848,23192,229,23421,398
2020-10-25,Alpine,003,1148,3,3,0,3,0
2020-10-25,Amador,005,37829,347,330,0,330,16
2020-10-25,Butte,007,227075,3218,3087,34,3121,56
2020-10-25,Calaveras,009,45235,339,274,0,274,13
2020-10-25,Colusa,011,21464,555,548,1,549,6
2020-10-25,Contra Costa,013,1133247,19184,18640,94,18734,245
2020-10-25,Del Norte,015,27424,175,171,0,171,2
2020-10-25,El Dorado,017,186661,1430,1328,3,1331,4
2020-10-25,Fresno,019,978130,33652,30858,486,31344,441
2020-10-25,Glenn,021,27897,685,652,1,653,3
2020-10-25,Humboldt,023,135768,568,554,1,555,7
2020-10-25,Imperial,025,180216,12972,12572,19,12591,333
2020-10-25,Inyo,027,18085,245,226,5,231,14
2020-10-25,Kern,029,883053,34059,33185,420,33605,432
2020-10-25,Kings,031,150075,8728,8246,56,8302,82
2020-10-25,Lake,033,64148,722,695,0,695,15
2020-10-25,Lassen,035,31185,776,764,2,766,0
2020-10-25,Los Angeles,037,10098052,302826,297110,2911,300021,6973
2020-10-25,Madera,039,155013,5070,4909,39,4948,53
2020-10-25,Marin,041,260295,7156,7052,19,7071,102
2020-10-25,Mariposa,043,17540,80,77,0,77,2
2020-10-25,Mendocino,045,87422,1088,1024,4,1028,20
2020-10-25,Merced,047,269075,9568,9352,37,9389,150
2020-10-25,Modoc,049,8938,39,28,0,28,0
2020-10-25,Mono,051,14174,209,167,5,172,1
2020-10-25,Monterey,053,433212,11498,11182,61,11243,87
2020-10-25,Napa,055,140530,2061,1962,8,1970,14
2020-10-25,Nevada,057,99092,649,616,18,634,8
2020-10-25,Orange,059,3164182,60972,58185,1775,59960,1443
2020-10-25,Placer,061,380077,4429,4140,15,4155,57
2020-10-25,Plumas,063,18699,84,63,0,63,0
2020-10-25,Riverside,065,2383286,67847,66192,381,66573,1289
2020-10-25,Sacramento,067,1510023,25883,25445,28,25473,496
2020-10-25,San Benito,069,59416,1438,1423,1,1424,15
2020-10-25,San Bernardino,071,2135413,64265,61551,454,62005,1153
2020-10-25,San Diego,073,3302833,56867,54599,1555,56154,870
2020-10-25,San Francisco,075,870044,12370,12072,51,12123,137
2020-10-25,San Joaquin,077,732212,22017,21459,206,21665,495
2020-10-25,San Luis Obispo,079,281455,4402,4126,30,4156,31
2020-10-25,San Mateo,081,765935,11457,10987,10,10997,156
2020-10-25,Santa Barbara,083,443738,9967,9814,95,9909,122
2020-10-25,Santa Clara,085,1922200,25572,24087,51,24138,365
2020-10-25,Santa Cruz,087,273765,2899,2789,34,2823,24
2020-10-25,Shasta,089,179085,2239,1889,20,1909,29
2020-10-25,Sierra,091,2930,6,6,0,6,0
2020-10-25,Siskiyou,093,43540,206,176,10,186,0
2020-10-25,Solano,095,438530,7477,7197,41,7238,60
2020-10-25,Sonoma,097,501317,9660,9235,26,9261,140
2020-10-25,Stanislaus,099,539301,17820,17641,760,18401,400
2020-10-25,Sutter,101,95872,1872,1811,1,1812,12
2020-10-25,Tehama,103,63373,933,880,2,882,5
2020-10-25,Trinity,105,12862,85,26,11,37,0
2020-10-25,Tulare,107,460477,18022,17431,373,17804,296
2020-10-25,Tuolumne,109,53932,282,271,4,275,4
2020-10-25,Ventura,111,848112,15025,14300,324,14624,154
2020-10-25,Yolo,113,214977,3269,3190,9,3199,58
2020-10-25,Yuba,115,75493,1261,1219,6,1225,10
2020-10-24,Alameda,001,1643700,23777,23099,226,23325,398
2020-10-24,Alpine,003,1148,3,3,0,3,0
2020-10-24,Amador,005,37829,346,328,0,328,16
2020-10-24,Butte,007,227075,3209,3078,34,3112,56
2020-10-24,Calaveras,009,45235,337,274,0,274,13
2020-10-24,Colusa,011,21464,550,548,1,549,6
2020-10-24,Contra Costa,013,1133247,19117,18567,94,18661,244
2020-10-24,Del Norte,015,27424,174,171,0,171,2
2020-10-24,El Dorado,017,186661,1414,1317,3,1320,4
2020-10-24,Fresno,019,978130,33591,30752,481,31233,441
2020-10-24,Glenn,021,27897,682,650,1,651,3
2020-10-24,Humboldt,023,135768,566,553,1,554,7
2020-10-24,Imperial,025,180216,12945,12469,19,12488,333
2020-10-24,Inyo,027,18085,245,226,5,231,14
2020-10-24,Kern,029,883053,34001,33105,414,33519,432
2020-10-24,Kings,031,150075,8718,8228,55,8283,82
2020-10-24,Lake,033,64148,717,696,0,696,15
2020-10-24,Lassen,035,31185,775,764,2,766,0
2020-10-24,Los Angeles,037,10098052,302007,296323,2889,299212,6969
2020-10-24,Madera,039,155013,5057,4898,38,4936,53
2020-10-24,Marin,041,260295,7147,7042,19,7061,102
2020-10-24,Mariposa,043,17540,80,77,0,77,2
2020-10-24,Mendocino,045,87422,1076,1022,4,1026,20
2020-10-24,Merced,047,269075,9544,9351,37,9388,150
2020-10-24,Modoc,049,8938,38,28,0,28,0
2020-10-24,Mono,051,14174,195,167,5,172,1
2020-10-24,Monterey,053,433212,11429,11153,60,11213,87
2020-10-24,Napa,055,140530,2044,1957,8,1965,14
2020-10-24,Nevada,057,99092,645,608,18,626,8
2020-10-24,Orange,059,3164182,60817,57928,1765,59693,1441
2020-10-24,Placer,061,380077,4398,4093,15,4108,57
2020-10-24,Plumas,063,18699,78,63,0,63,0
2020-10-24,Riverside,065,2383286,67639,65902,366,66268,1288
2020-10-24,Sacramento,067,1510023,25802,25372,28,25400,496
2020-10-24,San Benito,069,59416,1433,1417,1,1418,15
2020-10-24,San Bernardino,071,2135413,64025,61351,445,61796,1153
2020-10-24,San Diego,073,3302833,56590,54330,1542,55872,868
2020-10-24,San Francisco,075,870044,12312,12073,50,12123,137
2020-10-24,San Joaquin,077,732212,21965,21458,201,21659,495
2020-10-24,San Luis Obispo,079,281455,4377,4119,29,4148,31
2020-10-24,San Mateo,081,765935,11418,10942,10,10952,155
2020-10-24,Santa Barbara,083,443738,9950,9781,95,9876,122
2020-10-24,Santa Clara,085,1922200,25485,23978,51,24029,365
2020-10-24,Santa Cruz,087,273765,2880,2775,34,2809,24
2020-10-24,Shasta,089,179085,2194,1878,20,1898,29
2020-10-24,Sierra,091,2930,6,6,0,6,0
2020-10-24,Siskiyou,093,43540,205,174,10,184,0
2020-10-24,Solano,095,438530,7424,7189,41,7230,60
2020-10-24,Sonoma,097,501317,9626,9179,26,9205,140
2020-10-24,Stanislaus,099,539301,17776,17574,744,18318,400
2020-10-24,Sutter,101,95872,1863,1804,1,1805,12
2020-10-24,Tehama,103,63373,925,872,2,874,5
2020-10-24,Trinity,105,12862,85,25,11,36,0
2020-10-24,Tulare,107,460477,17999,17406,362,17768,295
2020-10-24,Tuolumne,109,53932,279,269,4,273,4
2020-10-24,Ventura,111,848112,14972,14240,323,14563,154
2020-10-24,Yolo,113,214977,3257,3164,9,3173,57
2020-10-24,Yuba,115,75493,1258,1210,6,1216,10
2020-10-23,Alameda,001,1643700,23704,23047,224,23271,393
2020-10-23,Alpine,003,1148,3,3,0,3,0
2020-10-23,Amador,005,37829,345,324,0,324,16
2020-10-23,Butte,007,227075,3200,3059,34,3093,55
2020-10-23,Calaveras,009,45235,336,273,0,273,13
2020-10-23,Colusa,011,21464,550,547,1,548,6
2020-10-23,Contra Costa,013,1133247,19047,18483,93,18576,244
2020-10-23,Del Norte,015,27424,174,171,0,171,2
2020-10-23,El Dorado,017,186661,1405,1310,3,1313,4
2020-10-23,Fresno,019,978130,33524,30590,477,31067,441
2020-10-23,Glenn,021,27897,679,644,1,645,3
2020-10-23,Humboldt,023,135768,564,553,1,554,7
2020-10-23,Imperial,025,180216,12914,12398,18,12416,333
2020-10-23,Inyo,027,18085,244,226,5,231,14
2020-10-23,Kern,029,883053,33933,33077,409,33486,431
2020-10-23,Kings,031,150075,8709,8218,55,8273,82
2020-10-23,Lake,033,64148,715,689,0,689,15
2020-10-23,Lassen,035,31185,774,764,2,766,0
2020-10-23,Los Angeles,037,10098052,300925,294287,2861,297148,6956
2020-10-23,Madera,039,155013,5052,4888,38,4926,53
2020-10-23,Marin,041,260295,7134,7029,19,7048,102
2020-10-23,Mariposa,043,17540,80,77,0,77,2
2020-10-23,Mendocino,045,87422,1073,1019,4,1023,20
2020-10-23,Merced,047,269075,9530,9327,37,9364,149
2020-10-23,Modoc,049,8938,38,28,0,28,0
2020-10-23,Mono,051,14174,194,159,5,164,1
2020-10-23,Monterey,053,433212,11382,11099,56,11155,86
2020-10-23,Napa,055,140530,2036,1942,8,1950,14
2020-10-23,Nevada,057,99092,642,604,18,622,8
2020-10-23,Orange,059,3164182,60646,57595,1750,59345,1430
2020-10-23,Placer,061,380077,4352,4073,15,4088,57
2020-10-23,Plumas,063,18699,75,63,0,63,0
2020-10-23,Riverside,065,2383286,67400,65512,358,65870,1279
2020-10-23,Sacramento,067,1510023,25696,25224,28,25252,496
2020-10-23,San Benito,069,59416,1431,1412,1,1413,15
2020-10-23,San Bernardino,071,2135413,63738,60854,431,61285,1150
2020-10-23,San Diego,073,3302833,56284,53944,1515,55459,867
2020-10-23,San Francisco,075,870044,12281,12015,50,12065,137
2020-10-23,San Joaquin,077,732212,21909,21361,195,21556,495
2020-10-23,San Luis Obispo,079,281455,4351,4102,29,4131,31
2020-10-23,San Mateo,081,765935,11369,10872,10,10882,155
2020-10-23,Santa Barbara,083,443738,9934,9751,95,9846,121
2020-10-23,Santa Clara,085,1922200,25383,23822,51,23873,364
2020-10-23,Santa Cruz,087,273765,2866,2757,34,2791,24
2020-10-23,Shasta,089,179085,2157,1846,19,1865,29
2020-10-23,Sierra,091,2930,6,6,0,6,0
2020-10-23,Siskiyou,093,43540,201,172,10,182,0
2020-10-23,Solano,095,438530,7393,7174,41,7215,59
2020-10-23,Sonoma,097,501317,9569,9112,26,9138,139
2020-10-23,Stanislaus,099,539301,17739,17496,737,18233,395
2020-10-23,Sutter,101,95872,1856,1797,1,1798,12
2020-10-23,Tehama,103,63373,916,862,2,864,5
2020-10-23,Trinity,105,12862,85,26,11,37,0
2020-10-23,Tulare,107,460477,17954,17334,350,17684,295
2020-10-23,Tuolumne,109,53932,277,254,4,258,4
2020-10-23,Ventura,111,848112,14943,14192,323,14515,155
2020-10-23,Yolo,113,214977,3245,3140,9,3149,57
2020-10-23,Yuba,115,75493,1254,1206,6,1212,10
2020-10-22,Alameda,001,1643700,23602,22915,224,23139,393
2020-10-22,Alpine,003,1148,3,3,0,3,0
2020-10-22,Amador,005,37829,341,317,0,317,16
2020-10-22,Butte,007,227075,3190,3046,32,3078,55
2020-10-22,Calaveras,009,45235,333,273,0,273,13
2020-10-22,Colusa,011,21464,550,547,1,548,6
2020-10-22,Contra Costa,013,1133247,18975,18393,93,18486,243
2020-10-22,Del Norte,015,27424,173,168,0,168,2
2020-10-22,El Dorado,017,186661,1395,1308,3,1311,4
2020-10-22,Fresno,019,978130,33414,30471,469,30940,438
2020-10-22,Glenn,021,27897,672,643,1,644,3
2020-10-22,Humboldt,023,135768,562,548,1,549,7
2020-10-22,Imperial,025,180216,12861,12311,18,12329,333
2020-10-22,Inyo,027,18085,241,220,5,225,14
2020-10-22,Kern,029,883053,33852,32991,406,33397,431
2020-10-22,Kings,031,150075,8458,8201,55,8256,82
2020-10-22,Lake,033,64148,711,678,0,678,15
2020-10-22,Lassen,035,31185,771,764,2,766,0
2020-10-22,Los Angeles,037,10098052,299550,291599,2802,294401,6935
2020-10-22,Madera,039,155013,5031,4847,38,4885,52
2020-10-22,Marin,041,260295,7127,7014,19,7033,102
2020-10-22,Mariposa,043,17540,80,77,0,77,2
2020-10-22,Mendocino,045,87422,1068,1016,4,1020,20
2020-10-22,Merced,047,269075,9502,9323,37,9360,149
2020-10-22,Modoc,049,8938,34,26,0,26,0
2020-10-22,Mono,051,14174,189,156,5,161,1
2020-10-22,Monterey,053,433212,11323,11059,53,11112,84
2020-10-22,Napa,055,140530,2021,1928,8,1936,14
2020-10-22,Nevada,057,99092,636,600,18,618,8
2020-10-22,Orange,059,3164182,60431,57418,1733,59151,1422
2020-10-22,Placer,061,380077,4303,4036,15,4051,57
2020-10-22,Plumas,063,18699,72,62,0,62,0
2020-10-22,Riverside,065,2383286,67065,65104,338,65442,1279
2020-10-22,Sacramento,067,1510023,25556,25054,28,25082,492
2020-10-22,San Benito,069,59416,1427,1403,1,1404,15
2020-10-22,San Bernardino,071,2135413,63337,60402,416,60818,1149
2020-10-22,San Diego,073,3302833,55897,53514,1496,55010,866
2020-10-22,San Francisco,075,870044,12223,11991,48,12039,137
2020-10-22,San Joaquin,077,732212,21836,21282,189,21471,495
2020-10-22,San Luis Obispo,079,281455,4335,4081,29,4110,31
2020-10-22,San Mateo,081,765935,11313,10796,10,10806,155
2020-10-22,Santa Barbara,083,443738,9900,9710,93,9803,120
2020-10-22,Santa Clara,085,1922200,25229,23621,51,23672,363
2020-10-22,Santa Cruz,087,273765,2848,2738,33,2771,24
2020-10-22,Shasta,089,179085,2111,1799,19,1818,29
2020-10-22,Sierra,091,2930,6,6,0,6,0
2020-10-22,Siskiyou,093,43540,201,169,10,179,0
2020-10-22,Solano,095,438530,7347,7116,41,7157,59
2020-10-22,Sonoma,097,501317,9503,9052,25,9077,139
2020-10-22,Stanislaus,099,539301,17685,17440,725,18165,395
2020-10-22,Sutter,101,95872,1842,1794,1,1795,12
2020-10-22,Tehama,103,63373,905,852,2,854,5
2020-10-22,Trinity,105,12862,84,26,11,37,0
2020-10-22,Tulare,107,460477,17888,17265,337,17602,293
2020-10-22,Tuolumne,109,53932,275,252,4,256,4
2020-10-22,Ventura,111,848112,14896,14124,321,14445,154
2020-10-22,Yolo,113,214977,3233,3116,9,3125,58
2020-10-22,Yuba,115,75493,1247,1199,5,1204,10
2020-10-21,Alameda,001,1643700,23514,22853,222,23075,392
2020-10-21,Alpine,003,1148,3,3,0,3,0
2020-10-21,Amador,005,37829,336,313,0,313,16
2020-10-21,Butte,007,227075,3178,3041,32,3073,55
2020-10-21,Calaveras,009,45235,332,272,0,272,13
2020-10-21,Colusa,011,21464,550,546,1,547,6
2020-10-21,Contra Costa,013,1133247,18901,18299,93,18392,243
2020-10-21,Del Norte,015,27424,173,169,0,169,2
2020-10-21,El Dorado,017,186661,1383,1305,2,1307,4
2020-10-21,Fresno,019,978130,33318,30328,464,30792,433
2020-10-21,Glenn,021,27897,667,640,1,641,3
2020-10-21,Humboldt,023,135768,561,548,1,549,7
2020-10-21,Imperial,025,180216,12804,12210,18,12228,331
2020-10-21,Inyo,027,18085,237,220,5,225,14
2020-10-21,Kern,029,883053,33777,32956,405,33361,430
2020-10-21,Kings,031,150075,8431,8186,55,8241,80
2020-10-21,Lake,033,64148,710,676,0,676,15
2020-10-21,Lassen,035,31185,770,764,2,766,0
2020-10-21,Los Angeles,037,10098052,298210,288096,2760,290856,6923
2020-10-21,Madera,039,155013,5006,4831,38,4869,52
2020-10-21,Marin,041,260295,7118,7002,19,7021,102
2020-10-21,Mariposa,043,17540,80,77,0,77,2
2020-10-21,Mendocino,045,87422,1066,1011,4,1015,21
2020-10-21,Merced,047,269075,9478,9319,35,9354,149
2020-10-21,Modoc,049,8938,33,26,0,26,0
2020-10-21,Mono,051,14174,187,156,5,161,1
2020-10-21,Monterey,053,433212,11285,11005,52,11057,83
2020-10-21,Napa,055,140530,2006,1918,8,1926,13
2020-10-21,Nevada,057,99092,630,597,18,615,8
2020-10-21,Orange,059,3164182,60218,57189,1724,58913,1409
2020-10-21,Placer,061,380077,4266,4007,15,4022,56
2020-10-21,Plumas,063,18699,69,58,0,58,0
2020-10-21,Riverside,065,2383286,66769,64778,314,65092,1278
2020-10-21,Sacramento,067,1510023,25363,24908,28,24936,490
2020-10-21,San Benito,069,59416,1426,1401,1,1402,14
2020-10-21,San Bernardino,071,2135413,62928,59948,409,60357,1141
2020-10-21,San Diego,073,3302833,55545,53279,1468,54747,863
2020-10-21,San Francisco,075,870044,12174,11976,47,12023,137
2020-10-21,San Joaquin,077,732212,21760,21201,183,21384,495
2020-10-21,San Luis Obispo,079,281455,4320,4055,27,4082,31
2020-10-21,San Mateo,081,765935,11264,10730,10,10740,155
2020-10-21,Santa Barbara,083,443738,9882,9681,92,9773,121
2020-10-21,Santa Clara,085,1922200,25103,23537,51,23588,361
2020-10-21,Santa Cruz,087,273765,2825,2729,33,2762,24
2020-10-21,Shasta,089,179085,2075,1777,19,1796,27
2020-10-21,Sierra,091,2930,6,6,0,6,0
2020-10-21,Siskiyou,093,43540,197,169,10,179,0
2020-10-21,Solano,095,438530,7301,7088,41,7129,59
2020-10-21,Sonoma,097,501317,9423,8987,25,9012,138
2020-10-21,Stanislaus,099,539301,17635,17419,717,18136,392
2020-10-21,Sutter,101,95872,1828,1786,1,1787,12
2020-10-21,Tehama,103,63373,889,824,2,826,5
2020-10-21,Trinity,105,12862,78,25,10,35,0
2020-10-21,Tulare,107,460477,17850,17204,323,17527,292
2020-10-21,Tuolumne,109,53932,274,251,4,255,4
2020-10-21,Ventura,111,848112,14833,14050,318,14368,153
2020-10-21,Yolo,113,214977,3214,3095,9,3104,58
2020-10-21,Yuba,115,75493,1238,1194,5,1199,10
2020-10-20,Alameda,001,1643700,23411,22750,218,22968,391
2020-10-20,Alpine,003,1148,3,3,0,3,0
2020-10-20,Amador,005,37829,335,313,0,313,16
2020-10-20,Butte,007,227075,3166,3027,32,3059,56
2020-10-20,Calaveras,009,45235,331,273,0,273,13
2020-10-20,Colusa,011,21464,547,546,1,547,6
2020-10-20,Contra Costa,013,1133247,18809,18246,93,18339,241
2020-10-20,Del Norte,015,27424,172,169,0,169,2
2020-10-20,El Dorado,017,186661,1377,1295,2,1297,4
2020-10-20,Fresno,019,978130,33215,30220,458,30678,431
2020-10-20,Glenn,021,27897,662,638,1,639,3
2020-10-20,Humboldt,023,135768,557,545,1,546,7
2020-10-20,Imperial,025,180216,12735,12114,18,12132,330
2020-10-20,Inyo,027,18085,237,218,5,223,14
2020-10-20,Kern,029,883053,33702,32889,392,33281,429
2020-10-20,Kings,031,150075,8413,8178,54,8232,80
2020-10-20,Lake,033,64148,708,675,0,675,15
2020-10-20,Lassen,035,31185,769,757,2,759,0
2020-10-20,Los Angeles,037,10098052,296719,287727,2709,290436,6891
2020-10-20,Madera,039,155013,4989,4823,38,4861,52
2020-10-20,Marin,041,260295,7103,6994,19,7013,101
2020-10-20,Mariposa,043,17540,79,77,0,77,2
2020-10-20,Mendocino,045,87422,1064,1004,4,1008,21
2020-10-20,Merced,047,269075,9456,9323,35,9358,149
2020-10-20,Modoc,049,8938,32,26,0,26,0
2020-10-20,Mono,051,14174,187,156,5,161,1
2020-10-20,Monterey,053,433212,11242,10942,49,10991,81
2020-10-20,Napa,055,140530,1987,1912,8,1920,13
2020-10-20,Nevada,057,99092,620,596,18,614,8
2020-10-20,Orange,059,3164182,59954,56914,1714,58628,1397
2020-10-20,Placer,061,380077,4228,3997,15,4012,56
2020-10-20,Plumas,063,18699,66,53,0,53,0
2020-10-20,Riverside,065,2383286,66389,64452,302,64754,1275
2020-10-20,Sacramento,067,1510023,25235,24767,27,24794,485
2020-10-20,San Benito,069,59416,1423,1398,1,1399,14
2020-10-20,San Bernardino,071,2135413,62546,59571,407,59978,1109
2020-10-20,San Diego,073,3302833,55209,53004,1448,54452,857
2020-10-20,San Francisco,075,870044,12127,12013,46,12059,126
2020-10-20,San Joaquin,077,732212,21681,21173,173,21346,490
2020-10-20,San Luis Obispo,079,281455,4302,4043,26,4069,31
2020-10-20,San Mateo,081,765935,11217,10659,10,10669,155
2020-10-20,Santa Barbara,083,443738,9853,9664,90,9754,121
2020-10-20,Santa Clara,085,1922200,24966,23406,51,23457,358
2020-10-20,Santa Cruz,087,273765,2802,2710,33,2743,23
2020-10-20,Shasta,089,179085,2052,1747,19,1766,20
2020-10-20,Sierra,091,2930,6,6,0,6,0
2020-10-20,Siskiyou,093,43540,189,168,10,178,0
2020-10-20,Solano,095,438530,7252,7044,41,7085,57
2020-10-20,Sonoma,097,501317,9360,8904,23,8927,135
2020-10-20,Stanislaus,099,539301,17581,17367,713,18080,393
2020-10-20,Sutter,101,95872,1819,1783,1,1784,12
2020-10-20,Tehama,103,63373,874,813,2,815,5
2020-10-20,Trinity,105,12862,77,25,10,35,0
2020-10-20,Tulare,107,460477,17783,17156,318,17474,289
2020-10-20,Tuolumne,109,53932,272,250,4,254,4
2020-10-20,Ventura,111,848112,14769,13980,316,14296,152
2020-10-20,Yolo,113,214977,3191,3083,9,3092,56
2020-10-20,Yuba,115,75493,1228,1191,5,1196,10
2020-10-19,Alameda,001,1643700,23300,22647,217,22864,392
2020-10-19,Alpine,003,1148,3,3,0,3,0
2020-10-19,Amador,005,37829,329,313,0,313,16
2020-10-19,Butte,007,227075,3155,3026,32,3058,55
2020-10-19,Calaveras,009,45235,330,268,0,268,13
2020-10-19,Colusa,011,21464,547,544,1,545,6
2020-10-19,Contra Costa,013,1133247,18711,18173,93,18266,239
2020-10-19,Del Norte,015,27424,169,167,0,167,2
2020-10-19,El Dorado,017,186661,1356,1287,2,1289,4
2020-10-19,Fresno,019,978130,33106,30152,452,30604,431
2020-10-19,Glenn,021,27897,657,635,0,635,3
2020-10-19,Humboldt,023,135768,557,543,1,544,7
2020-10-19,Imperial,025,180216,12681,12036,17,12053,330
2020-10-19,Inyo,027,18085,236,218,5,223,14
2020-10-19,Kern,029,883053,33626,32840,389,33229,428
2020-10-19,Kings,031,150075,8395,8173,54,8227,80
2020-10-19,Lake,033,64148,705,673,0,673,15
2020-10-19,Lassen,035,31185,768,757,2,759,0
2020-10-19,Los Angeles,037,10098052,295232,287119,2671,289790,6858
2020-10-19,Madera,039,155013,4974,4787,38,4825,52
2020-10-19,Marin,041,260295,7085,6981,19,7000,100
2020-10-19,Mariposa,043,17540,79,77,0,77,2
2020-10-19,Mendocino,045,87422,1059,1001,4,1005,21
2020-10-19,Merced,047,269075,9431,9305,31,9336,148
2020-10-19,Modoc,049,8938,31,26,0,26,0
2020-10-19,Mono,051,14174,182,156,5,161,1
2020-10-19,Monterey,053,433212,11181,10907,49,10956,80
2020-10-19,Napa,055,140530,1975,1892,8,1900,12
2020-10-19,Nevada,057,99092,617,590,18,608,8
2020-10-19,Orange,059,3164182,59670,56652,1699,58351,1396
2020-10-19,Placer,061,380077,4179,3962,15,3977,49
2020-10-19,Plumas,063,18699,64,52,0,52,0
2020-10-19,Riverside,065,2383286,65958,64016,286,64302,1272
2020-10-19,Sacramento,067,1510023,25096,24542,27,24569,483
2020-10-19,San Benito,069,59416,1416,1395,1,1396,14
2020-10-19,San Bernardino,071,2135413,62095,59265,396,59661,1100
2020-10-19,San Diego,073,3302833,54823,52739,1423,54162,853
2020-10-19,San Francisco,075,870044,12083,11879,46,11925,126
2020-10-19,San Joaquin,077,732212,21606,20930,165,21095,489
2020-10-19,San Luis Obispo,079,281455,4286,4016,26,4042,31
2020-10-19,San Mateo,081,765935,11171,10568,10,10578,154
2020-10-19,Santa Barbara,083,443738,9818,9632,90,9722,121
2020-10-19,Santa Clara,085,1922200,24816,23301,51,23352,352
2020-10-19,Santa Cruz,087,273765,2785,2705,33,2738,19
2020-10-19,Shasta,089,179085,2008,1709,18,1727,20
2020-10-19,Sierra,091,2930,6,6,0,6,0
2020-10-19,Siskiyou,093,43540,182,167,10,177,0
2020-10-19,Solano,095,438530,7211,7003,41,7044,57
2020-10-19,Sonoma,097,501317,9273,8830,23,8853,135
2020-10-19,Stanislaus,099,539301,17530,17342,703,18045,390
2020-10-19,Sutter,101,95872,1814,1773,1,1774,12
2020-10-19,Tehama,103,63373,871,793,2,795,5
2020-10-19,Trinity,105,12862,75,23,10,33,0
2020-10-19,Tulare,107,460477,17733,17047,311,17358,291
2020-10-19,Tuolumne,109,53932,270,247,4,251,4
2020-10-19,Ventura,111,848112,14703,13930,313,14243,152
2020-10-19,Yolo,113,214977,3178,3069,9,3078,56
2020-10-19,Yuba,115,75493,1221,1183,5,1188,10
2020-10-18,Alameda,001,1643700,23196,22546,216,22762,392
2020-10-18,Alpine,003,1148,3,3,0,3,0
2020-10-18,Amador,005,37829,317,313,0,313,16
2020-10-18,Butte,007,227075,3142,3019,32,3051,55
2020-10-18,Calaveras,009,45235,329,267,0,267,13
2020-10-18,Colusa,011,21464,545,544,1,545,6
2020-10-18,Contra Costa,013,1133247,18612,18120,93,18213,237
2020-10-18,Del Norte,015,27424,169,167,0,167,2
2020-10-18,El Dorado,017,186661,1347,1283,2,1285,4
2020-10-18,Fresno,019,978130,32977,30051,444,30495,430
2020-10-18,Glenn,021,27897,655,634,0,634,3
2020-10-18,Humboldt,023,135768,554,540,1,541,7
2020-10-18,Imperial,025,180216,12619,11987,16,12003,330
2020-10-18,Inyo,027,18085,233,215,5,220,14
2020-10-18,Kern,029,883053,33553,32799,382,33181,428
2020-10-18,Kings,031,150075,8380,8159,54,8213,80
2020-10-18,Lake,033,64148,698,670,0,670,15
2020-10-18,Lassen,035,31185,768,757,2,759,0
2020-10-18,Los Angeles,037,10098052,293524,286187,2628,288815,6857
2020-10-18,Madera,039,155013,4949,4770,37,4807,52
2020-10-18,Marin,041,260295,7064,6969,19,6988,99
2020-10-18,Mariposa,043,17540,79,77,0,77,2
2020-10-18,Mendocino,045,87422,1057,988,4,992,21
2020-10-18,Merced,047,269075,9396,9292,31,9323,148
2020-10-18,Modoc,049,8938,30,26,0,26,0
2020-10-18,Mono,051,14174,177,155,5,160,1
2020-10-18,Monterey,053,433212,11128,10872,49,10921,80
2020-10-18,Napa,055,140530,1962,1882,8,1890,12
2020-10-18,Nevada,057,99092,611,582,18,600,8
2020-10-18,Orange,059,3164182,59373,56394,1683,58077,1396
2020-10-18,Placer,061,380077,4131,3938,15,3953,49
2020-10-18,Plumas,063,18699,62,52,0,52,0
2020-10-18,Riverside,065,2383286,65645,63765,265,64030,1270
2020-10-18,Sacramento,067,1510023,24940,24425,27,24452,482
2020-10-18,San Benito,069,59416,1409,1395,1,1396,14
2020-10-18,San Bernardino,071,2135413,61595,58893,388,59281,1098
2020-10-18,San Diego,073,3302833,54434,52359,1402,53761,853
2020-10-18,San Francisco,075,870044,12044,11878,46,11924,126
2020-10-18,San Joaquin,077,732212,21523,20931,152,21083,489
2020-10-18,San Luis Obispo,079,281455,4255,4009,24,4033,31
2020-10-18,San Mateo,081,765935,11112,10503,10,10513,154
2020-10-18,Santa Barbara,083,443738,9779,9608,89,9697,121
2020-10-18,Santa Clara,085,1922200,24643,23169,51,23220,352
2020-10-18,Santa Cruz,087,273765,2771,2692,33,2725,19
2020-10-18,Shasta,089,179085,1983,1708,18,1726,20
2020-10-18,Sierra,091,2930,6,6,0,6,0
2020-10-18,Siskiyou,093,43540,182,167,10,177,0
2020-10-18,Solano,095,438530,7164,6962,41,7003,57
2020-10-18,Sonoma,097,501317,9196,8781,22,8803,134
2020-10-18,Stanislaus,099,539301,17474,17290,694,17984,390
2020-10-18,Sutter,101,95872,1805,1764,1,1765,12
2020-10-18,Tehama,103,63373,839,774,2,776,5
2020-10-18,Trinity,105,12862,75,20,10,30,0
2020-10-18,Tulare,107,460477,17639,17048,302,17350,290
2020-10-18,Tuolumne,109,53932,265,245,4,249,4
2020-10-18,Ventura,111,848112,14623,13901,312,14213,151
2020-10-18,Yolo,113,214977,3139,3059,9,3068,55
2020-10-18,Yuba,115,75493,1210,1176,5,1181,10
2020-10-17,Alameda,001,1643700,23150,22394,214,22608,398
2020-10-17,Alpine,003,1148,3,3,0,3,0
2020-10-17,Amador,005,37829,315,309,0,309,16
2020-10-17,Butte,007,227075,3134,3012,30,3042,55
2020-10-17,Calaveras,009,45235,329,267,0,267,13
2020-10-17,Colusa,011,21464,544,544,1,545,6
2020-10-17,Contra Costa,013,1133247,18559,18005,93,18098,237
2020-10-17,Del Norte,015,27424,169,167,0,167,2
2020-10-17,El Dorado,017,186661,1343,1277,2,1279,4
2020-10-17,Fresno,019,978130,32923,29911,442,30353,430
2020-10-17,Glenn,021,27897,652,633,0,633,3
2020-10-17,Humboldt,023,135768,551,535,1,536,7
2020-10-17,Imperial,025,180216,12591,11962,16,11978,330
2020-10-17,Inyo,027,18085,228,212,5,217,14
2020-10-17,Kern,029,883053,33502,32710,379,33089,428
2020-10-17,Kings,031,150075,8374,8151,53,8204,80
2020-10-17,Lake,033,64148,695,663,0,663,15
2020-10-17,Lassen,035,31185,768,757,2,759,0
2020-10-17,Los Angeles,037,10098052,292771,285858,2601,288459,6844
2020-10-17,Madera,039,155013,4943,4759,37,4796,53
2020-10-17,Marin,041,260295,7061,6958,19,6977,99
2020-10-17,Mariposa,043,17540,78,77,0,77,2
2020-10-17,Mendocino,045,87422,1050,977,4,981,21
2020-10-17,Merced,047,269075,9382,9275,31,9306,148
2020-10-17,Modoc,049,8938,30,26,0,26,0
2020-10-17,Mono,051,14174,176,155,5,160,1
2020-10-17,Monterey,053,433212,11088,10807,48,10855,80
2020-10-17,Napa,055,140530,1953,1866,8,1874,12
2020-10-17,Nevada,057,99092,610,580,18,598,8
2020-10-17,Orange,059,3164182,59231,56197,1676,57873,1396
2020-10-17,Placer,061,380077,4104,3898,15,3913,49
2020-10-17,Plumas,063,18699,62,52,0,52,0
2020-10-17,Riverside,065,2383286,65447,63171,255,63426,1270
2020-10-17,Sacramento,067,1510023,24856,24304,27,24331,482
2020-10-17,San Benito,069,59416,1405,1389,1,1390,14
2020-10-17,San Bernardino,071,2135413,61324,58415,381,58796,1097
2020-10-17,San Diego,073,3302833,54209,51986,1391,53377,853
2020-10-17,San Francisco,075,870044,12016,11877,45,11922,126
2020-10-17,San Joaquin,077,732212,21469,20932,146,21078,489
2020-10-17,San Luis Obispo,079,281455,4240,3979,24,4003,31
2020-10-17,San Mateo,081,765935,11084,10423,10,10433,153
2020-10-17,Santa Barbara,083,443738,9760,9588,87,9675,121
2020-10-17,Santa Clara,085,1922200,24554,22997,51,23048,349
2020-10-17,Santa Cruz,087,273765,2757,2680,33,2713,19
2020-10-17,Shasta,089,179085,1957,1679,18,1697,20
2020-10-17,Sierra,091,2930,6,6,0,6,0
2020-10-17,Siskiyou,093,43540,181,167,10,177,0
2020-10-17,Solano,095,438530,7138,6929,41,6970,57
2020-10-17,Sonoma,097,501317,9153,8725,22,8747,134
2020-10-17,Stanislaus,099,539301,17434,17232,685,17917,390
2020-10-17,Sutter,101,95872,1803,1762,1,1763,12
2020-10-17,Tehama,103,63373,823,764,2,766,5
2020-10-17,Trinity,105,12862,75,20,10,30,0
2020-10-17,Tulare,107,460477,17609,16995,293,17288,290
2020-10-17,Tuolumne,109,53932,265,241,4,245,4
2020-10-17,Ventura,111,848112,14578,13845,309,14154,151
2020-10-17,Yolo,113,214977,3124,3045,8,3053,55
2020-10-17,Yuba,115,75493,1205,1164,5,1169,10
2020-10-16,Alameda,001,1643700,23096,22315,214,22529,397
2020-10-16,Alpine,003,1148,3,3,0,3,0
2020-10-16,Amador,005,37829,315,309,0,309,16
2020-10-16,Butte,007,227075,3123,3004,30,3034,54
2020-10-16,Calaveras,009,45235,329,267,0,267,13
2020-10-16,Colusa,011,21464,543,544,1,545,6
2020-10-16,Contra Costa,013,1133247,18506,17956,93,18049,237
2020-10-16,Del Norte,015,27424,169,166,0,166,2
2020-10-16,El Dorado,017,186661,1337,1273,2,1275,4
2020-10-16,Fresno,019,978130,32847,29796,441,30237,427
2020-10-16,Glenn,021,27897,647,632,0,632,3
2020-10-16,Humboldt,023,135768,551,533,1,534,7
2020-10-16,Imperial,025,180216,12551,11885,16,11901,330
2020-10-16,Inyo,027,18085,224,212,5,217,14
2020-10-16,Kern,029,883053,33459,32660,377,33037,428
2020-10-16,Kings,031,150075,8365,8146,52,8198,80
2020-10-16,Lake,033,64148,693,644,0,644,14
2020-10-16,Lassen,035,31185,768,757,2,759,0
2020-10-16,Los Angeles,037,10098052,291709,284988,2580,287568,6835
2020-10-16,Madera,039,155013,4931,4736,36,4772,53
2020-10-16,Marin,041,260295,7051,6933,19,6952,99
2020-10-16,Mariposa,043,17540,78,76,0,76,2
2020-10-16,Mendocino,045,87422,1043,974,4,978,21
2020-10-16,Merced,047,269075,9365,9246,31,9277,148
2020-10-16,Modoc,049,8938,30,26,0,26,0
2020-10-16,Mono,051,14174,174,155,5,160,1
2020-10-16,Monterey,053,433212,11053,10727,48,10775,79
2020-10-16,Napa,055,140530,1944,1855,8,1863,12
2020-10-16,Nevada,057,99092,608,579,18,597,8
2020-10-16,Orange,059,3164182,59053,56091,1670,57761,1388
2020-10-16,Placer,061,380077,4084,3864,15,3879,49
2020-10-16,Plumas,063,18699,61,52,0,52,0
2020-10-16,Riverside,065,2383286,65221,62986,254,63240,1267
2020-10-16,Sacramento,067,1510023,24762,24144,27,24171,479
2020-10-16,San Benito,069,59416,1402,1388,1,1389,14
2020-10-16,San Bernardino,071,2135413,61055,58233,381,58614,1069
2020-10-16,San Diego,073,3302833,53967,51785,1377,53162,850
2020-10-16,San Francisco,075,870044,11994,11840,44,11884,126
2020-10-16,San Joaquin,077,732212,21424,20910,145,21055,489
2020-10-16,San Luis Obispo,079,281455,4224,3952,24,3976,32
2020-10-16,San Mateo,081,765935,11058,10405,10,10415,153
2020-10-16,Santa Barbara,083,443738,9741,9549,87,9636,119
2020-10-16,Santa Clara,085,1922200,24467,22920,51,22971,345
2020-10-16,Santa Cruz,087,273765,2744,2666,33,2699,20
2020-10-16,Shasta,089,179085,1935,1660,18,1678,20
2020-10-16,Sierra,091,2930,6,6,0,6,0
2020-10-16,Siskiyou,093,43540,179,167,10,177,0
2020-10-16,Solano,095,438530,7115,6879,41,6920,55
2020-10-16,Sonoma,097,501317,9097,8652,22,8674,133
2020-10-16,Stanislaus,099,539301,17400,17201,677,17878,366
2020-10-16,Sutter,101,95872,1795,1756,1,1757,12
2020-10-16,Tehama,103,63373,822,737,2,739,3
2020-10-16,Trinity,105,12862,75,20,10,30,0
2020-10-16,Tulare,107,460477,17577,16965,285,17250,290
2020-10-16,Tuolumne,109,53932,263,237,4,241,4
2020-10-16,Ventura,111,848112,14535,13805,304,14109,152
2020-10-16,Yolo,113,214977,3115,3030,8,3038,55
2020-10-16,Yuba,115,75493,1205,1155,5,1160,10
2020-10-15,Alameda,001,1643700,23028,22267,213,22480,390
2020-10-15,Alpine,003,1148,3,3,0,3,0
2020-10-15,Amador,005,37829,315,309,0,309,16
2020-10-15,Butte,007,227075,3111,3000,29,3029,54
2020-10-15,Calaveras,009,45235,328,267,0,267,13
2020-10-15,Colusa,011,21464,542,543,1,544,6
2020-10-15,Contra Costa,013,1133247,18439,17893,92,17985,237
2020-10-15,Del Norte,015,27424,169,164,0,164,2
2020-10-15,El Dorado,017,186661,1332,1265,2,1267,4
2020-10-15,Fresno,019,978130,32750,29727,438,30165,425
2020-10-15,Glenn,021,27897,642,632,0,632,3
2020-10-15,Humboldt,023,135768,547,531,1,532,7
2020-10-15,Imperial,025,180216,12510,11820,15,11835,330
2020-10-15,Inyo,027,18085,224,210,5,215,14
2020-10-15,Kern,029,883053,33378,32593,374,32967,427
2020-10-15,Kings,031,150075,8350,8134,52,8186,80
2020-10-15,Lake,033,64148,691,642,0,642,14
2020-10-15,Lassen,035,31185,767,752,2,754,0
2020-10-15,Los Angeles,037,10098052,290424,284019,2546,286565,6807
2020-10-15,Madera,039,155013,4919,4723,35,4758,50
2020-10-15,Marin,041,260295,7043,6912,19,6931,99
2020-10-15,Mariposa,043,17540,78,76,0,76,2
2020-10-15,Mendocino,045,87422,1037,963,4,967,21
2020-10-15,Merced,047,269075,9338,9213,31,9244,147
2020-10-15,Modoc,049,8938,30,26,0,26,0
2020-10-15,Mono,051,14174,174,155,5,160,1
2020-10-15,Monterey,053,433212,10986,10677,47,10724,79
2020-10-15,Napa,055,140530,1931,1842,8,1850,12
2020-10-15,Nevada,057,99092,604,575,18,593,8
2020-10-15,Orange,059,3164182,58837,55952,1658,57610,1379
2020-10-15,Placer,061,380077,4054,3848,15,3863,48
2020-10-15,Plumas,063,18699,58,52,0,52,0
2020-10-15,Riverside,065,2383286,64889,62819,251,63070,1266
2020-10-15,Sacramento,067,1510023,24646,24068,27,24095,474
2020-10-15,San Benito,069,59416,1399,1384,1,1385,14
2020-10-15,San Bernardino,071,2135413,60716,58068,378,58446,1067
2020-10-15,San Diego,073,3302833,53683,51472,1361,52833,847
2020-10-15,San Francisco,075,870044,11966,11808,41,11849,126
2020-10-15,San Joaquin,077,732212,21351,20880,139,21019,487
2020-10-15,San Luis Obispo,079,281455,4207,3934,24,3958,32
2020-10-15,San Mateo,081,765935,11018,10340,10,10350,152
2020-10-15,Santa Barbara,083,443738,9717,9526,86,9612,117
2020-10-15,Santa Clara,085,1922200,24351,22808,51,22859,343
2020-10-15,Santa Cruz,087,273765,2730,2656,33,2689,13
2020-10-15,Shasta,089,179085,1924,1635,18,1653,20
2020-10-15,Sierra,091,2930,6,6,0,6,0
2020-10-15,Siskiyou,093,43540,175,166,10,176,0
2020-10-15,Solano,095,438530,7076,6830,41,6871,55
2020-10-15,Sonoma,097,501317,9005,8571,22,8593,133
2020-10-15,Stanislaus,099,539301,17362,17151,663,17814,366
2020-10-15,Sutter,101,95872,1792,1752,1,1753,12
2020-10-15,Tehama,103,63373,795,726,2,728,3
2020-10-15,Trinity,105,12862,75,20,10,30,0
2020-10-15,Tulare,107,460477,17517,16918,270,17188,289
2020-10-15,Tuolumne,109,53932,261,236,4,240,4
2020-10-15,Ventura,111,848112,14479,13750,299,14049,152
2020-10-15,Yolo,113,214977,3095,3014,8,3022,55
2020-10-15,Yuba,115,75493,1198,1151,5,1156,10
2020-10-14,Alameda,001,1643700,22929,22227,212,22439,398
2020-10-14,Alpine,003,1148,3,3,0,3,0
2020-10-14,Amador,005,37829,313,308,0,308,16
2020-10-14,Butte,007,227075,3103,2995,29,3024,54
2020-10-14,Calaveras,009,45235,328,266,0,266,12
2020-10-14,Colusa,011,21464,542,543,1,544,6
2020-10-14,Contra Costa,013,1133247,18382,17820,90,17910,236
2020-10-14,Del Norte,015,27424,168,163,0,163,2
2020-10-14,El Dorado,017,186661,1326,1264,2,1266,4
2020-10-14,Fresno,019,978130,32635,29650,432,30082,424
2020-10-14,Glenn,021,27897,641,629,0,629,3
2020-10-14,Humboldt,023,135768,544,531,1,532,7
2020-10-14,Imperial,025,180216,12473,11765,13,11778,330
2020-10-14,Inyo,027,18085,223,209,4,213,14
2020-10-14,Kern,029,883053,33303,32528,372,32900,425
2020-10-14,Kings,031,150075,8332,8118,52,8170,80
2020-10-14,Lake,033,64148,690,642,0,642,14
2020-10-14,Lassen,035,31185,765,752,2,754,0
2020-10-14,Los Angeles,037,10098052,289111,282918,2502,285420,6786
2020-10-14,Madera,039,155013,4904,4713,34,4747,50
2020-10-14,Marin,041,260295,7037,6907,19,6926,99
2020-10-14,Mariposa,043,17540,77,76,0,76,2
2020-10-14,Mendocino,045,87422,1031,955,4,959,21
2020-10-14,Merced,047,269075,9313,9201,29,9230,147
2020-10-14,Modoc,049,8938,30,27,0,27,0
2020-10-14,Mono,051,14174,174,155,5,160,1
2020-10-14,Monterey,053,433212,10935,10616,47,10663,78
2020-10-14,Napa,055,140530,1914,1837,8,1845,12
2020-10-14,Nevada,057,99092,602,573,18,591,7
2020-10-14,Orange,059,3164182,58623,55756,1649,57405,1348
2020-10-14,Placer,061,380077,4031,3829,15,3844,48
2020-10-14,Plumas,063,18699,54,52,0,52,0
2020-10-14,Riverside,065,2383286,64606,62607,250,62857,1261
2020-10-14,Sacramento,067,1510023,24502,24013,27,24040,472
2020-10-14,San Benito,069,59416,1397,1381,0,1381,14
2020-10-14,San Bernardino,071,2135413,60389,57774,374,58148,1063
2020-10-14,San Diego,073,3302833,53364,51329,1337,52666,844
2020-10-14,San Francisco,075,870044,11934,11783,40,11823,123
2020-10-14,San Joaquin,077,732212,21272,20845,125,20970,487
2020-10-14,San Luis Obispo,079,281455,4184,3901,23,3924,32
2020-10-14,San Mateo,081,765935,10967,10309,10,10319,132
2020-10-14,Santa Barbara,083,443738,9683,9509,86,9595,117
2020-10-14,Santa Clara,085,1922200,24202,22735,51,22786,343
2020-10-14,Santa Cruz,087,273765,2720,2618,33,2651,13
2020-10-14,Shasta,089,179085,1886,1553,18,1571,20
2020-10-14,Sierra,091,2930,6,6,0,6,0
2020-10-14,Siskiyou,093,43540,175,166,10,176,0
2020-10-14,Solano,095,438530,7020,6786,41,6827,55
2020-10-14,Sonoma,097,501317,8952,8514,22,8536,133
2020-10-14,Stanislaus,099,539301,17317,17105,660,17765,365
2020-10-14,Sutter,101,95872,1783,1747,1,1748,12
2020-10-14,Tehama,103,63373,784,721,2,723,3
2020-10-14,Trinity,105,12862,74,20,10,30,0
2020-10-14,Tulare,107,460477,17455,16863,257,17120,287
2020-10-14,Tuolumne,109,53932,260,236,4,240,4
2020-10-14,Ventura,111,848112,14426,13697,295,13992,152
2020-10-14,Yolo,113,214977,3077,3007,7,3014,55
2020-10-14,Yuba,115,75493,1190,1147,5,1152,10
2020-10-13,Alameda,001,1643700,22825,22185,210,22395,389
2020-10-13,Alpine,003,1148,3,3,0,3,0
2020-10-13,Amador,005,37829,311,306,0,306,16
2020-10-13,Butte,007,227075,3094,2992,29,3021,54
2020-10-13,Calaveras,009,45235,324,262,0,262,12
2020-10-13,Colusa,011,21464,542,541,1,542,6
2020-10-13,Contra Costa,013,1133247,18324,17783,90,17873,234
2020-10-13,Del Norte,015,27424,168,163,0,163,2
2020-10-13,El Dorado,017,186661,1317,1262,2,1264,4
2020-10-13,Fresno,019,978130,32513,29579,428,30007,424
2020-10-13,Glenn,021,27897,640,629,0,629,3
2020-10-13,Humboldt,023,135768,542,523,1,524,7
2020-10-13,Imperial,025,180216,12438,11727,12,11739,327
2020-10-13,Inyo,027,18085,220,207,4,211,14
2020-10-13,Kern,029,883053,33228,32497,370,32867,419
2020-10-13,Kings,031,150075,8323,8111,52,8163,80
2020-10-13,Lake,033,64148,687,639,0,639,12
2020-10-13,Lassen,035,31185,763,752,2,754,0
2020-10-13,Los Angeles,037,10098052,287833,281716,2459,284175,6767
2020-10-13,Madera,039,155013,4886,4700,34,4734,50
2020-10-13,Marin,041,260295,7015,6900,18,6918,97
2020-10-13,Mariposa,043,17540,77,76,0,76,2
2020-10-13,Mendocino,045,87422,1022,950,4,954,21
2020-10-13,Merced,047,269075,9296,9181,29,9210,146
2020-10-13,Modoc,049,8938,29,28,0,28,0
2020-10-13,Mono,051,14174,174,155,4,159,1
2020-10-13,Monterey,053,433212,10874,10574,46,10620,78
2020-10-13,Napa,055,140530,1905,1825,8,1833,12
2020-10-13,Nevada,057,99092,595,572,18,590,7
2020-10-13,Orange,059,3164182,58410,55515,1636,57151,1326
2020-10-13,Placer,061,380077,3993,3825,15,3840,48
2020-10-13,Plumas,063,18699,52,51,0,51,0
2020-10-13,Riverside,065,2383286,64286,62279,248,62527,1254
2020-10-13,Sacramento,067,1510023,24425,23930,27,23957,466
2020-10-13,San Benito,069,59416,1389,1380,0,1380,14
2020-10-13,San Bernardino,071,2135413,60050,57411,372,57783,1061
2020-10-13,San Diego,073,3302833,53071,51026,1320,52346,840
2020-10-13,San Francisco,075,870044,11899,11659,40,11699,122
2020-10-13,San Joaquin,077,732212,21211,20822,121,20943,481
2020-10-13,San Luis Obispo,079,281455,4168,3892,22,3914,32
2020-10-13,San Mateo,081,765935,10924,10286,10,10296,130
2020-10-13,Santa Barbara,083,443738,9652,9489,86,9575,117
2020-10-13,Santa Clara,085,1922200,24075,22678,51,22729,343
2020-10-13,Santa Cruz,087,273765,2702,2603,33,2636,13
2020-10-13,Shasta,089,179085,1862,1606,18,1624,20
2020-10-13,Sierra,091,2930,6,6,0,6,0
2020-10-13,Siskiyou,093,43540,174,163,10,173,0
2020-10-13,Solano,095,438530,6985,6761,41,6802,55
2020-10-13,Sonoma,097,501317,8869,8456,22,8478,133
2020-10-13,Stanislaus,099,539301,17272,17082,655,17737,362
2020-10-13,Sutter,101,95872,1774,1748,1,1749,12
2020-10-13,Tehama,103,63373,776,717,2,719,3
2020-10-13,Trinity,105,12862,70,19,9,28,0
2020-10-13,Tulare,107,460477,17396,16822,249,17071,286
2020-10-13,Tuolumne,109,53932,258,235,4,239,4
2020-10-13,Ventura,111,848112,14371,13645,291,13936,151
2020-10-13,Yolo,113,214977,3069,2983,6,2989,55
2020-10-13,Yuba,115,75493,1185,1143,5,1148,10
2020-10-12,Alameda,001,1643700,22745,22126,209,22335,389
2020-10-12,Alpine,003,1148,3,3,0,3,0
2020-10-12,Amador,005,37829,310,305,0,305,16
2020-10-12,Butte,007,227075,3088,2975,29,3004,54
2020-10-12,Calaveras,009,45235,324,262,0,262,12
2020-10-12,Colusa,011,21464,542,541,1,542,6
2020-10-12,Contra Costa,013,1133247,18249,17728,90,17818,233
2020-10-12,Del Norte,015,27424,168,161,0,161,2
2020-10-12,El Dorado,017,186661,1314,1254,2,1256,4
2020-10-12,Fresno,019,978130,32380,29523,424,29947,421
2020-10-12,Glenn,021,27897,639,626,0,626,3
2020-10-12,Humboldt,023,135768,539,522,1,523,7
2020-10-12,Imperial,025,180216,12399,11689,12,11701,328
2020-10-12,Inyo,027,18085,217,201,4,205,14
2020-10-12,Kern,029,883053,33135,32425,367,32792,419
2020-10-12,Kings,031,150075,8317,8106,51,8157,80
2020-10-12,Lake,033,64148,681,633,0,633,12
2020-10-12,Lassen,035,31185,763,752,2,754,0
2020-10-12,Los Angeles,037,10098052,286615,280961,2432,283393,6747
2020-10-12,Madera,039,155013,4867,4689,34,4723,50
2020-10-12,Marin,041,260295,6998,6886,18,6904,97
2020-10-12,Mariposa,043,17540,77,76,0,76,2
2020-10-12,Mendocino,045,87422,1016,947,4,951,21
2020-10-12,Merced,047,269075,9275,9141,29,9170,146
2020-10-12,Modoc,049,8938,29,27,0,27,0
2020-10-12,Mono,051,14174,174,154,4,158,1
2020-10-12,Monterey,053,433212,10808,10473,46,10519,77
2020-10-12,Napa,055,140530,1897,1819,8,1827,11
2020-10-12,Nevada,057,99092,591,570,18,588,7
2020-10-12,Orange,059,3164182,58180,55373,1626,56999,1326
2020-10-12,Placer,061,380077,3961,3808,14,3822,48
2020-10-12,Plumas,063,18699,52,51,0,51,0
2020-10-12,Riverside,065,2383286,63975,62279,244,62523,1254
2020-10-12,Sacramento,067,1510023,24319,23807,27,23834,466
2020-10-12,San Benito,069,59416,1386,1376,0,1376,13
2020-10-12,San Bernardino,071,2135413,59675,57235,371,57606,1061
2020-10-12,San Diego,073,3302833,52781,50748,1293,52041,826
2020-10-12,San Francisco,075,870044,11867,11659,40,11699,122
2020-10-12,San Joaquin,077,732212,21148,20701,115,20816,480
2020-10-12,San Luis Obispo,079,281455,4140,3874,22,3896,32
2020-10-12,San Mateo,081,765935,10876,10262,10,10272,130
2020-10-12,Santa Barbara,083,443738,9614,9462,86,9548,117
2020-10-12,Santa Clara,085,1922200,23959,22578,51,22629,343
2020-10-12,Santa Cruz,087,273765,2685,2590,33,2623,13
2020-10-12,Shasta,089,179085,1837,1515,18,1533,20
2020-10-12,Sierra,091,2930,6,6,0,6,0
2020-10-12,Siskiyou,093,43540,173,162,10,172,0
2020-10-12,Solano,095,438530,6946,6742,41,6783,55
2020-10-12,Sonoma,097,501317,8798,8377,22,8399,133
2020-10-12,Stanislaus,099,539301,17223,17051,646,17697,361
2020-10-12,Sutter,101,95872,1766,1741,1,1742,12
2020-10-12,Tehama,103,63373,760,708,2,710,3
2020-10-12,Trinity,105,12862,69,19,9,28,0
2020-10-12,Tulare,107,460477,17344,16742,242,16984,286
2020-10-12,Tuolumne,109,53932,253,234,4,238,4
2020-10-12,Ventura,111,848112,14309,13617,287,13904,151
2020-10-12,Yolo,113,214977,3054,2964,6,2970,55
2020-10-12,Yuba,115,75493,1174,1141,5,1146,10
2020-10-11,Alameda,001,1643700,22655,22057,205,22262,392
2020-10-11,Alpine,003,1148,3,3,0,3,0
2020-10-11,Amador,005,37829,308,305,0,305,16
2020-10-11,Butte,007,227075,3080,2967,28,2995,54
2020-10-11,Calaveras,009,45235,322,262,0,262,12
2020-10-11,Colusa,011,21464,540,541,1,542,6
2020-10-11,Contra Costa,013,1133247,18165,17678,90,17768,233
2020-10-11,Del Norte,015,27424,166,161,0,161,2
2020-10-11,El Dorado,017,186661,1305,1242,2,1244,4
2020-10-11,Fresno,019,978130,32242,29419,416,29835,421
2020-10-11,Glenn,021,27897,637,625,0,625,3
2020-10-11,Humboldt,023,135768,538,521,1,522,7
2020-10-11,Imperial,025,180216,12339,11614,12,11626,328
2020-10-11,Inyo,027,18085,213,201,4,205,14
2020-10-11,Kern,029,883053,33048,32399,360,32759,418
2020-10-11,Kings,031,150075,8300,8094,50,8144,80
2020-10-11,Lake,033,64148,668,631,0,631,12
2020-10-11,Lassen,035,31185,762,752,2,754,0
2020-10-11,Los Angeles,037,10098052,285175,280190,2391,282581,6745
2020-10-11,Madera,039,155013,4839,4680,33,4713,50
2020-10-11,Marin,041,260295,6989,6870,18,6888,97
2020-10-11,Mariposa,043,17540,77,76,0,76,2
2020-10-11,Mendocino,045,87422,1009,944,4,948,21
2020-10-11,Merced,047,269075,9257,9124,29,9153,146
2020-10-11,Modoc,049,8938,29,27,0,27,0
2020-10-11,Mono,051,14174,174,154,4,158,1
2020-10-11,Monterey,053,433212,10757,10445,44,10489,77
2020-10-11,Napa,055,140530,1881,1811,8,1819,11
2020-10-11,Nevada,057,99092,589,569,18,587,7
2020-10-11,Orange,059,3164182,57950,55202,1620,56822,1326
2020-10-11,Placer,061,380077,3940,3787,14,3801,48
2020-10-11,Plumas,063,18699,52,51,0,51,0
2020-10-11,Riverside,065,2383286,63686,62112,240,62352,1254
2020-10-11,Sacramento,067,1510023,24177,23778,27,23805,466
2020-10-11,San Benito,069,59416,1385,1374,0,1374,13
2020-10-11,San Bernardino,071,2135413,59221,56997,369,57366,1061
2020-10-11,San Diego,073,3302833,52431,50553,1271,51824,826
2020-10-11,San Francisco,075,870044,11824,11659,40,11699,122
2020-10-11,San Joaquin,077,732212,21073,20700,105,20805,480
2020-10-11,San Luis Obispo,079,281455,4123,3874,21,3895,32
2020-10-11,San Mateo,081,765935,10844,10240,10,10250,130
2020-10-11,Santa Barbara,083,443738,9583,9440,85,9525,117
2020-10-11,Santa Clara,085,1922200,23816,22487,50,22537,336
2020-10-11,Santa Cruz,087,273765,2671,2578,33,2611,13
2020-10-11,Shasta,089,179085,1807,1515,17,1532,20
2020-10-11,Sierra,091,2930,6,6,0,6,0
2020-10-11,Siskiyou,093,43540,172,162,10,172,0
2020-10-11,Solano,095,438530,6892,6685,41,6726,53
2020-10-11,Sonoma,097,501317,8741,8319,22,8341,133
2020-10-11,Stanislaus,099,539301,17159,17007,630,17637,360
2020-10-11,Sutter,101,95872,1763,1742,1,1743,12
2020-10-11,Tehama,103,63373,736,702,2,704,3
2020-10-11,Trinity,105,12862,69,19,9,28,0
2020-10-11,Tulare,107,460477,17280,16741,234,16975,286
2020-10-11,Tuolumne,109,53932,248,234,4,238,4
2020-10-11,Ventura,111,848112,14248,13604,282,13886,151
2020-10-11,Yolo,113,214977,3024,2952,6,2958,55
2020-10-11,Yuba,115,75493,1162,1137,5,1142,10
2020-10-10,Alameda,001,1643700,22605,21979,204,22183,398
2020-10-10,Alpine,003,1148,3,3,0,3,0
2020-10-10,Amador,005,37829,307,304,0,304,16
2020-10-10,Butte,007,227075,3075,2962,27,2989,54
2020-10-10,Calaveras,009,45235,321,262,0,262,12
2020-10-10,Colusa,011,21464,540,541,1,542,6
2020-10-10,Contra Costa,013,1133247,18129,17566,89,17655,233
2020-10-10,Del Norte,015,27424,166,161,0,161,2
2020-10-10,El Dorado,017,186661,1303,1240,2,1242,4
2020-10-10,Fresno,019,978130,32178,29286,414,29700,421
2020-10-10,Glenn,021,27897,637,623,0,623,3
2020-10-10,Humboldt,023,135768,535,518,1,519,7
2020-10-10,Imperial,025,180216,12324,11591,12,11603,327
2020-10-10,Inyo,027,18085,210,201,4,205,14
2020-10-10,Kern,029,883053,33011,32338,360,32698,418
2020-10-10,Kings,031,150075,8296,8078,50,8128,80
2020-10-10,Lake,033,64148,667,630,0,630,11
2020-10-10,Lassen,035,31185,762,752,2,754,0
2020-10-10,Los Angeles,037,10098052,284455,279213,2357,281570,6743
2020-10-10,Madera,039,155013,4826,4662,33,4695,50
2020-10-10,Marin,041,260295,6980,6852,18,6870,97
2020-10-10,Mariposa,043,17540,77,76,0,76,2
2020-10-10,Mendocino,045,87422,1002,935,4,939,21
2020-10-10,Merced,047,269075,9251,9105,28,9133,146
2020-10-10,Modoc,049,8938,29,27,0,27,0
2020-10-10,Mono,051,14174,174,154,4,158,1
2020-10-10,Monterey,053,433212,10724,10410,44,10454,75
2020-10-10,Napa,055,140530,1874,1804,8,1812,11
2020-10-10,Nevada,057,99092,586,564,18,582,6
2020-10-10,Orange,059,3164182,57829,54965,1615,56580,1324
2020-10-10,Placer,061,380077,3923,3757,14,3771,48
2020-10-10,Plumas,063,18699,52,51,0,51,0
2020-10-10,Riverside,065,2383286,63482,61845,238,62083,1254
2020-10-10,Sacramento,067,1510023,24110,23689,27,23716,466
2020-10-10,San Benito,069,59416,1383,1370,0,1370,13
2020-10-10,San Bernardino,071,2135413,59058,56683,367,57050,1061
2020-10-10,San Diego,073,3302833,52201,50145,1253,51398,825
2020-10-10,San Francisco,075,870044,11803,11663,40,11703,122
2020-10-10,San Joaquin,077,732212,21045,20700,101,20801,481
2020-10-10,San Luis Obispo,079,281455,4103,3832,21,3853,32
2020-10-10,San Mateo,081,765935,10807,10218,10,10228,130
2020-10-10,Santa Barbara,083,443738,9572,9417,85,9502,116
2020-10-10,Santa Clara,085,1922200,23725,22354,50,22404,330
2020-10-10,Santa Cruz,087,273765,2657,2572,33,2605,13
2020-10-10,Shasta,089,179085,1790,1473,17,1490,20
2020-10-10,Sierra,091,2930,6,6,0,6,0
2020-10-10,Siskiyou,093,43540,172,161,10,171,0
2020-10-10,Solano,095,438530,6866,6655,41,6696,53
2020-10-10,Sonoma,097,501317,8721,8235,22,8257,133
2020-10-10,Stanislaus,099,539301,17124,16960,622,17582,360
2020-10-10,Sutter,101,95872,1760,1735,1,1736,12
2020-10-10,Tehama,103,63373,729,693,2,695,3
2020-10-10,Trinity,105,12862,69,19,9,28,0
2020-10-10,Tulare,107,460477,17245,16709,229,16938,286
2020-10-10,Tuolumne,109,53932,248,233,4,237,4
2020-10-10,Ventura,111,848112,14223,13520,282,13802,151
2020-10-10,Yolo,113,214977,3015,2939,6,2945,55
2020-10-10,Yuba,115,75493,1160,1134,5,1139,10
2020-10-09,Alameda,001,1643700,22557,21924,204,22128,399
2020-10-09,Alpine,003,1148,3,3,0,3,0
2020-10-09,Amador,005,37829,307,303,0,303,16
2020-10-09,Butte,007,227075,3072,2956,27,2983,51
2020-10-09,Calaveras,009,45235,319,262,0,262,11
2020-10-09,Colusa,011,21464,540,541,1,542,6
2020-10-09,Contra Costa,013,1133247,18079,17487,89,17576,229
2020-10-09,Del Norte,015,27424,165,161,0,161,2
2020-10-09,El Dorado,017,186661,1299,1234,2,1236,4
2020-10-09,Fresno,019,978130,32105,29208,412,29620,417
2020-10-09,Glenn,021,27897,632,617,0,617,3
2020-10-09,Humboldt,023,135768,533,516,1,517,7
2020-10-09,Imperial,025,180216,12297,11516,12,11528,330
2020-10-09,Inyo,027,18085,207,200,4,204,14
2020-10-09,Kern,029,883053,32968,32237,358,32595,417
2020-10-09,Kings,031,150075,8289,7993,48,8041,80
2020-10-09,Lake,033,64148,657,610,0,610,11
2020-10-09,Lassen,035,31185,762,751,2,753,0
2020-10-09,Los Angeles,037,10098052,283321,278039,2332,280371,6715
2020-10-09,Madera,039,155013,4816,4646,33,4679,50
2020-10-09,Marin,041,260295,6966,6838,18,6856,96
2020-10-09,Mariposa,043,17540,77,76,0,76,2
2020-10-09,Mendocino,045,87422,992,933,4,937,20
2020-10-09,Merced,047,269075,9237,9095,28,9123,145
2020-10-09,Modoc,049,8938,29,27,0,27,0
2020-10-09,Mono,051,14174,174,154,4,158,1
2020-10-09,Monterey,053,433212,10690,10369,44,10413,75
2020-10-09,Napa,055,140530,1864,1795,8,1803,11
2020-10-09,Nevada,057,99092,581,561,18,579,6
2020-10-09,Orange,059,3164182,57657,54746,1610,56356,1305
2020-10-09,Placer,061,380077,3909,3737,14,3751,48
2020-10-09,Plumas,063,18699,52,50,0,50,0
2020-10-09,Riverside,065,2383286,63246,61529,237,61766,1252
2020-10-09,Sacramento,067,1510023,24040,23606,27,23633,457
2020-10-09,San Benito,069,59416,1378,1367,0,1367,13
2020-10-09,San Bernardino,071,2135413,58818,56434,365,56799,1057
2020-10-09,San Diego,073,3302833,51925,49825,1242,51067,821
2020-10-09,San Francisco,075,870044,11773,11620,40,11660,120
2020-10-09,San Joaquin,077,732212,21015,20648,92,20740,481
2020-10-09,San Luis Obispo,079,281455,4084,3810,21,3831,32
2020-10-09,San Mateo,081,765935,10779,10140,10,10150,130
2020-10-09,Santa Barbara,083,443738,9544,9396,85,9481,116
2020-10-09,Santa Clara,085,1922200,23623,22251,49,22300,328
2020-10-09,Santa Cruz,087,273765,2648,2555,33,2588,13
2020-10-09,Shasta,089,179085,1764,1353,16,1369,20
2020-10-09,Sierra,091,2930,6,6,0,6,0
2020-10-09,Siskiyou,093,43540,170,156,10,166,0
2020-10-09,Solano,095,438530,6827,6614,41,6655,53
2020-10-09,Sonoma,097,501317,8667,8133,22,8155,133
2020-10-09,Stanislaus,099,539301,17100,16904,613,17517,362
2020-10-09,Sutter,101,95872,1756,1732,1,1733,12
2020-10-09,Tehama,103,63373,723,682,2,684,3
2020-10-09,Trinity,105,12862,69,25,9,34,0
2020-10-09,Tulare,107,460477,17205,16644,220,16864,286
2020-10-09,Tuolumne,109,53932,245,230,4,234,4
2020-10-09,Ventura,111,848112,14187,13469,279,13748,151
2020-10-09,Yolo,113,214977,3008,2928,6,2934,55
2020-10-09,Yuba,115,75493,1159,1129,5,1134,10
2020-10-08,Alameda,001,1643700,22476,21826,203,22029,395
2020-10-08,Alpine,003,1148,3,3,0,3,0
2020-10-08,Amador,005,37829,306,302,0,302,16
2020-10-08,Butte,007,227075,3062,2935,27,2962,51
2020-10-08,Calaveras,009,45235,318,262,0,262,11
2020-10-08,Colusa,011,21464,540,539,1,540,6
2020-10-08,Contra Costa,013,1133247,18019,17418,88,17506,228
2020-10-08,Del Norte,015,27424,165,151,0,151,2
2020-10-08,El Dorado,017,186661,1298,1230,2,1232,4
2020-10-08,Fresno,019,978130,32000,29111,412,29523,416
2020-10-08,Glenn,021,27897,629,616,0,616,3
2020-10-08,Humboldt,023,135768,529,515,1,516,7
2020-10-08,Imperial,025,180216,12258,11405,12,11417,330
2020-10-08,Inyo,027,18085,204,199,4,203,14
2020-10-08,Kern,029,883053,32910,32169,353,32522,411
2020-10-08,Kings,031,150075,8283,7968,48,8016,80
2020-10-08,Lake,033,64148,652,604,0,604,11
2020-10-08,Lassen,035,31185,757,751,2,753,0
2020-10-08,Los Angeles,037,10098052,282121,276763,2292,279055,6699
2020-10-08,Madera,039,155013,4797,4637,33,4670,50
2020-10-08,Marin,041,260295,6952,6810,18,6828,96
2020-10-08,Mariposa,043,17540,77,76,0,76,2
2020-10-08,Mendocino,045,87422,987,930,4,934,20
2020-10-08,Merced,047,269075,9217,9069,28,9097,144
2020-10-08,Modoc,049,8938,29,27,0,27,0
2020-10-08,Mono,051,14174,174,153,4,157,1
2020-10-08,Monterey,053,433212,10623,10343,44,10387,75
2020-10-08,Napa,055,140530,1849,1779,8,1787,11
2020-10-08,Nevada,057,99092,578,556,18,574,6
2020-10-08,Orange,059,3164182,57464,54523,1599,56122,1293
2020-10-08,Placer,061,380077,3891,3715,14,3729,48
2020-10-08,Plumas,063,18699,52,50,0,50,0
2020-10-08,Riverside,065,2383286,62977,61105,235,61340,1244
2020-10-08,Sacramento,067,1510023,23932,23482,27,23509,454
2020-10-08,San Benito,069,59416,1373,1367,0,1367,13
2020-10-08,San Bernardino,071,2135413,58452,56152,364,56516,1048
2020-10-08,San Diego,073,3302833,51645,49468,1210,50678,819
2020-10-08,San Francisco,075,870044,11735,11608,40,11648,115
2020-10-08,San Joaquin,077,732212,20963,20576,87,20663,478
2020-10-08,San Luis Obispo,079,281455,4068,3785,21,3806,32
2020-10-08,San Mateo,081,765935,10747,10044,10,10054,130
2020-10-08,Santa Barbara,083,443738,9516,9374,85,9459,116
2020-10-08,Santa Clara,085,1922200,23521,22095,49,22144,323
2020-10-08,Santa Cruz,087,273765,2636,2535,33,2568,13
2020-10-08,Shasta,089,179085,1730,1305,16,1321,20
2020-10-08,Sierra,091,2930,6,6,0,6,0
2020-10-08,Siskiyou,093,43540,170,156,10,166,0
2020-10-08,Solano,095,438530,6803,6556,41,6597,53
2020-10-08,Sonoma,097,501317,8601,8063,22,8085,132
2020-10-08,Stanislaus,099,539301,17054,16821,605,17426,360
2020-10-08,Sutter,101,95872,1756,1725,1,1726,12
2020-10-08,Tehama,103,63373,714,676,2,678,3
2020-10-08,Trinity,105,12862,68,25,9,34,0
2020-10-08,Tulare,107,460477,17144,16573,211,16784,283
2020-10-08,Tuolumne,109,53932,244,230,4,234,4
2020-10-08,Ventura,111,848112,14139,13399,277,13676,151
2020-10-08,Yolo,113,214977,2991,2914,6,2920,55
2020-10-08,Yuba,115,75493,1154,1126,5,1131,10
2020-10-07,Alameda,001,1643700,22399,21736,203,21939,395
2020-10-07,Alpine,003,1148,3,3,0,3,0
2020-10-07,Amador,005,37829,306,302,0,302,16
2020-10-07,Butte,007,227075,3050,2927,27,2954,47
2020-10-07,Calaveras,009,45235,316,262,0,262,11
2020-10-07,Colusa,011,21464,539,539,0,539,6
2020-10-07,Contra Costa,013,1133247,17949,17346,87,17433,225
2020-10-07,Del Norte,015,27424,164,149,0,149,2
2020-10-07,El Dorado,017,186661,1290,1219,2,1221,4
2020-10-07,Fresno,019,978130,31879,29069,407,29476,413
2020-10-07,Glenn,021,27897,629,615,0,615,3
2020-10-07,Humboldt,023,135768,526,512,1,513,7
2020-10-07,Imperial,025,180216,12221,11289,11,11300,330
2020-10-07,Inyo,027,18085,204,199,4,203,14
2020-10-07,Kern,029,883053,32837,32068,352,32420,410
2020-10-07,Kings,031,150075,8268,7948,48,7996,80
2020-10-07,Lake,033,64148,651,599,0,599,11
2020-10-07,Lassen,035,31185,757,751,2,753,0
2020-10-07,Los Angeles,037,10098052,280940,275559,2258,277817,6681
2020-10-07,Madera,039,155013,4777,4618,33,4651,50
2020-10-07,Marin,041,260295,6925,6790,18,6808,95
2020-10-07,Mariposa,043,17540,77,75,0,75,2
2020-10-07,Mendocino,045,87422,981,927,4,931,19
2020-10-07,Merced,047,269075,9180,9045,27,9072,144
2020-10-07,Modoc,049,8938,29,27,0,27,0
2020-10-07,Mono,051,14174,173,153,3,156,1
2020-10-07,Monterey,053,433212,10564,10272,44,10316,75
2020-10-07,Napa,055,140530,1836,1774,8,1782,11
2020-10-07,Nevada,057,99092,574,552,18,570,6
2020-10-07,Orange,059,3164182,57246,54332,1589,55921,1277
2020-10-07,Placer,061,380077,3875,3693,14,3707,48
2020-10-07,Plumas,063,18699,52,50,0,50,0
2020-10-07,Riverside,065,2383286,62630,60857,231,61088,1241
2020-10-07,Sacramento,067,1510023,23835,23380,27,23407,452
2020-10-07,San Benito,069,59416,1370,1363,0,1363,13
2020-10-07,San Bernardino,071,2135413,58103,55738,363,56101,1043
2020-10-07,San Diego,073,3302833,51329,49177,1186,50363,813
2020-10-07,San Francisco,075,870044,11700,11551,40,11591,115
2020-10-07,San Joaquin,077,732212,20911,20527,80,20607,478
2020-10-07,San Luis Obispo,079,281455,4038,3749,21,3770,32
2020-10-07,San Mateo,081,765935,10704,9980,10,9990,130
2020-10-07,Santa Barbara,083,443738,9490,9350,84,9434,116
2020-10-07,Santa Clara,085,1922200,23393,21993,49,22042,320
2020-10-07,Santa Cruz,087,273765,2624,2518,33,2551,14
2020-10-07,Shasta,089,179085,1687,1268,16,1284,20
2020-10-07,Sierra,091,2930,6,6,0,6,0
2020-10-07,Siskiyou,093,43540,168,154,10,164,0
2020-10-07,Solano,095,438530,6768,6526,41,6567,53
2020-10-07,Sonoma,097,501317,8526,7993,21,8014,130
2020-10-07,Stanislaus,099,539301,17019,16786,599,17385,357
2020-10-07,Sutter,101,95872,1753,1723,1,1724,12
2020-10-07,Tehama,103,63373,705,666,2,668,3
2020-10-07,Trinity,105,12862,64,25,8,33,0
2020-10-07,Tulare,107,460477,17101,16483,202,16685,282
2020-10-07,Tuolumne,109,53932,244,227,4,231,3
2020-10-07,Ventura,111,848112,14089,13333,271,13604,150
2020-10-07,Yolo,113,214977,2965,2904,6,2910,55
2020-10-07,Yuba,115,75493,1148,1120,5,1125,10
2020-10-06,Alameda,001,1643700,22308,21698,201,21899,385
2020-10-06,Alpine,003,1148,3,3,0,3,0
2020-10-06,Amador,005,37829,304,301,0,301,16
2020-10-06,Butte,007,227075,3043,2925,27,2952,47
2020-10-06,Calaveras,009,45235,316,261,0,261,11
2020-10-06,Colusa,011,21464,538,538,0,538,6
2020-10-06,Contra Costa,013,1133247,17870,17295,87,17382,219
2020-10-06,Del Norte,015,27424,164,144,0,144,2
2020-10-06,El Dorado,017,186661,1286,1211,2,1213,4
2020-10-06,Fresno,019,978130,31735,29022,404,29426,412
2020-10-06,Glenn,021,27897,626,604,0,604,3
2020-10-06,Humboldt,023,135768,523,508,1,509,7
2020-10-06,Imperial,025,180216,12183,11196,11,11207,327
2020-10-06,Inyo,027,18085,202,198,4,202,14
2020-10-06,Kern,029,883053,32760,32006,350,32356,407
2020-10-06,Kings,031,150075,8252,7943,48,7991,81
2020-10-06,Lake,033,64148,645,596,0,596,11
2020-10-06,Lassen,035,31185,757,743,2,745,0
2020-10-06,Los Angeles,037,10098052,279704,274115,2208,276323,6657
2020-10-06,Madera,039,155013,4765,4608,33,4641,50
2020-10-06,Marin,041,260295,6910,6766,18,6784,91
2020-10-06,Mariposa,043,17540,77,75,0,75,2
2020-10-06,Mendocino,045,87422,974,920,4,924,19
2020-10-06,Merced,047,269075,9144,9034,26,9060,143
2020-10-06,Modoc,049,8938,29,26,0,26,0
2020-10-06,Mono,051,14174,173,153,3,156,1
2020-10-06,Monterey,053,433212,10508,10235,42,10277,72
2020-10-06,Napa,055,140530,1830,1770,8,1778,11
2020-10-06,Nevada,057,99092,571,551,18,569,6
2020-10-06,Orange,059,3164182,57031,54203,1580,55783,1273
2020-10-06,Placer,061,380077,3853,3680,14,3694,48
2020-10-06,Plumas,063,18699,52,49,0,49,0
2020-10-06,Riverside,065,2383286,62365,60593,228,60821,1238
2020-10-06,Sacramento,067,1510023,23748,23322,27,23349,442
2020-10-06,San Benito,069,59416,1369,1358,0,1358,12
2020-10-06,San Bernardino,071,2135413,57786,55416,359,55775,1040
2020-10-06,San Diego,073,3302833,50992,48823,1169,49992,806
2020-10-06,San Francisco,075,870044,11674,11513,39,11552,115
2020-10-06,San Joaquin,077,732212,20871,20481,77,20558,477
2020-10-06,San Luis Obispo,079,281455,4004,3723,21,3744,32
2020-10-06,San Mateo,081,765935,10671,9934,10,9944,129
2020-10-06,Santa Barbara,083,443738,9461,9331,83,9414,116
2020-10-06,Santa Clara,085,1922200,23298,21914,49,21963,320
2020-10-06,Santa Cruz,087,273765,2602,2510,33,2543,12
2020-10-06,Shasta,089,179085,1647,1242,16,1258,18
2020-10-06,Sierra,091,2930,6,6,0,6,0
2020-10-06,Siskiyou,093,43540,168,154,10,164,0
2020-10-06,Solano,095,438530,6722,6506,41,6547,52
2020-10-06,Sonoma,097,501317,8433,7895,21,7916,130
2020-10-06,Stanislaus,099,539301,16974,16759,593,17352,354
2020-10-06,Sutter,101,95872,1751,1722,1,1723,12
2020-10-06,Tehama,103,63373,696,660,2,662,3
2020-10-06,Trinity,105,12862,64,25,8,33,0
2020-10-06,Tulare,107,460477,17059,16456,194,16650,280
2020-10-06,Tuolumne,109,53932,243,227,4,231,2
2020-10-06,Ventura,111,848112,14022,13242,266,13508,150
2020-10-06,Yolo,113,214977,2951,2899,6,2905,56
2020-10-06,Yuba,115,75493,1147,1114,5,1119,10
2020-10-05,Alameda,001,1643700,22220,21637,198,21835,383
2020-10-05,Alpine,003,1148,3,2,0,2,0
2020-10-05,Amador,005,37829,304,299,0,299,16
2020-10-05,Butte,007,227075,3033,2910,27,2937,46
2020-10-05,Calaveras,009,45235,316,259,0,259,11
2020-10-05,Colusa,011,21464,538,537,0,537,6
2020-10-05,Contra Costa,013,1133247,17793,17250,87,17337,216
2020-10-05,Del Norte,015,27424,161,142,0,142,2
2020-10-05,El Dorado,017,186661,1282,1202,2,1204,4
2020-10-05,Fresno,019,978130,31618,29136,404,29540,408
2020-10-05,Glenn,021,27897,624,603,0,603,3
2020-10-05,Humboldt,023,135768,522,506,1,507,6
2020-10-05,Imperial,025,180216,12143,11169,11,11180,327
2020-10-05,Inyo,027,18085,202,197,4,201,14
2020-10-05,Kern,029,883053,32681,31933,346,32279,404
2020-10-05,Kings,031,150075,8155,7932,48,7980,80
2020-10-05,Lake,033,64148,641,592,0,592,10
2020-10-05,Lassen,035,31185,756,743,2,745,0
2020-10-05,Los Angeles,037,10098052,278617,273200,2166,275366,6632
2020-10-05,Madera,039,155013,4757,4598,31,4629,50
2020-10-05,Marin,041,260295,6893,6751,18,6769,91
2020-10-05,Mariposa,043,17540,77,75,0,75,2
2020-10-05,Mendocino,045,87422,966,913,4,917,19
2020-10-05,Merced,047,269075,9125,9021,25,9046,143
2020-10-05,Modoc,049,8938,29,26,0,26,0
2020-10-05,Mono,051,14174,173,152,3,155,1
2020-10-05,Monterey,053,433212,10461,10187,42,10229,72
2020-10-05,Napa,055,140530,1819,1760,8,1768,11
2020-10-05,Nevada,057,99092,568,550,17,567,6
2020-10-05,Orange,059,3164182,56815,54103,1567,55670,1271
2020-10-05,Placer,061,380077,3827,3670,14,3684,46
2020-10-05,Plumas,063,18699,51,49,0,49,0
2020-10-05,Riverside,065,2383286,62045,60454,224,60678,1232
2020-10-05,Sacramento,067,1510023,23644,23207,27,23234,438
2020-10-05,San Benito,069,59416,1366,1356,0,1356,12
2020-10-05,San Bernardino,071,2135413,57478,55100,358,55458,1031
2020-10-05,San Diego,073,3302833,50656,48662,1145,49807,803
2020-10-05,San Francisco,075,870044,11635,11476,36,11512,110
2020-10-05,San Joaquin,077,732212,20800,20319,74,20393,476
2020-10-05,San Luis Obispo,079,281455,3977,3710,21,3731,32
2020-10-05,San Mateo,081,765935,10644,9896,10,9906,128
2020-10-05,Santa Barbara,083,443738,9439,9309,83,9392,116
2020-10-05,Santa Clara,085,1922200,23181,21861,49,21910,319
2020-10-05,Santa Cruz,087,273765,2590,2492,33,2525,9
2020-10-05,Shasta,089,179085,1615,1158,16,1174,18
2020-10-05,Sierra,091,2930,6,6,0,6,0
2020-10-05,Siskiyou,093,43540,168,153,10,163,0
2020-10-05,Solano,095,438530,6683,6475,41,6516,52
2020-10-05,Sonoma,097,501317,8341,7817,21,7838,130
2020-10-05,Stanislaus,099,539301,16939,16730,586,17316,351
2020-10-05,Sutter,101,95872,1743,1719,1,1720,12
2020-10-05,Tehama,103,63373,688,642,2,644,3
2020-10-05,Trinity,105,12862,62,22,8,30,0
2020-10-05,Tulare,107,460477,17000,16343,189,16532,278
2020-10-05,Tuolumne,109,53932,240,226,4,230,2
2020-10-05,Ventura,111,848112,13953,13224,246,13470,149
2020-10-05,Yolo,113,214977,2932,2889,6,2895,56
2020-10-05,Yuba,115,75493,1134,1108,5,1113,9
2020-10-04,Alameda,001,1643700,22124,21597,198,21795,383
2020-10-04,Alpine,003,1148,3,2,0,2,0
2020-10-04,Amador,005,37829,302,297,0,297,16
2020-10-04,Butte,007,227075,3019,2903,27,2930,46
2020-10-04,Calaveras,009,45235,316,259,0,259,11
2020-10-04,Colusa,011,21464,537,537,0,537,6
2020-10-04,Contra Costa,013,1133247,17728,17192,87,17279,214
2020-10-04,Del Norte,015,27424,157,142,0,142,2
2020-10-04,El Dorado,017,186661,1278,1196,2,1198,4
2020-10-04,Fresno,019,978130,31495,29065,404,29469,408
2020-10-04,Glenn,021,27897,622,601,0,601,3
2020-10-04,Humboldt,023,135768,521,506,1,507,6
2020-10-04,Imperial,025,180216,12104,11127,11,11138,327
2020-10-04,Inyo,027,18085,199,195,4,199,14
2020-10-04,Kern,029,883053,32607,31906,343,32249,404
2020-10-04,Kings,031,150075,8140,7919,48,7967,80
2020-10-04,Lake,033,64148,627,589,0,589,10
2020-10-04,Lassen,035,31185,756,743,2,745,0
2020-10-04,Los Angeles,037,10098052,277228,272822,2118,274940,6625
2020-10-04,Madera,039,155013,4741,4587,31,4618,50
2020-10-04,Marin,041,260295,6873,6741,18,6759,91
2020-10-04,Mariposa,043,17540,77,75,0,75,2
2020-10-04,Mendocino,045,87422,953,905,4,909,18
2020-10-04,Merced,047,269075,9100,9006,25,9031,140
2020-10-04,Modoc,049,8938,29,26,0,26,0
2020-10-04,Mono,051,14174,172,152,2,154,1
2020-10-04,Monterey,053,433212,10420,10141,41,10182,72
2020-10-04,Napa,055,140530,1807,1759,8,1767,11
2020-10-04,Nevada,057,99092,564,547,16,563,6
2020-10-04,Orange,059,3164182,56579,53966,1558,55524,1270
2020-10-04,Placer,061,380077,3806,3664,14,3678,46
2020-10-04,Plumas,063,18699,51,49,0,49,0
2020-10-04,Riverside,065,2383286,61759,60251,220,60471,1226
2020-10-04,Sacramento,067,1510023,23531,23162,27,23189,438
2020-10-04,San Benito,069,59416,1366,1355,0,1355,12
2020-10-04,San Bernardino,071,2135413,57031,55100,356,55456,1031
2020-10-04,San Diego,073,3302833,50289,48438,1120,49558,803
2020-10-04,San Francisco,075,870044,11603,11474,34,11508,110
2020-10-04,San Joaquin,077,732212,20723,20320,68,20388,476
2020-10-04,San Luis Obispo,079,281455,3952,3688,21,3709,31
2020-10-04,San Mateo,081,765935,10584,9858,10,9868,128
2020-10-04,Santa Barbara,083,443738,9413,9276,81,9357,116
2020-10-04,Santa Clara,085,1922200,23044,21780,49,21829,316
2020-10-04,Santa Cruz,087,273765,2574,2483,33,2516,9
2020-10-04,Shasta,089,179085,1517,1158,15,1173,18
2020-10-04,Sierra,091,2930,6,6,0,6,0
2020-10-04,Siskiyou,093,43540,168,153,10,163,0
2020-10-04,Solano,095,438530,6632,6445,41,6486,52
2020-10-04,Sonoma,097,501317,8253,7794,21,7815,129
2020-10-04,Stanislaus,099,539301,16889,16711,577,17288,351
2020-10-04,Sutter,101,95872,1740,1711,1,1712,11
2020-10-04,Tehama,103,63373,673,637,2,639,3
2020-10-04,Trinity,105,12862,61,21,8,29,0
2020-10-04,Tulare,107,460477,16923,16343,178,16521,278
2020-10-04,Tuolumne,109,53932,238,226,4,230,2
2020-10-04,Ventura,111,848112,13871,13197,229,13426,149
2020-10-04,Yolo,113,214977,2921,2875,6,2881,56
2020-10-04,Yuba,115,75493,1130,1103,5,1108,9
2020-10-03,Alameda,001,1643700,22078,21510,197,21707,386
2020-10-03,Alpine,003,1148,3,2,0,2,0
2020-10-03,Amador,005,37829,301,296,0,296,16
2020-10-03,Butte,007,227075,3013,2894,27,2921,46
2020-10-03,Calaveras,009,45235,316,259,0,259,11
2020-10-03,Colusa,011,21464,536,537,0,537,6
2020-10-03,Contra Costa,013,1133247,17678,17087,85,17172,213
2020-10-03,Del Norte,015,27424,153,142,0,142,2
2020-10-03,El Dorado,017,186661,1271,1188,2,1190,4
2020-10-03,Fresno,019,978130,31435,28975,403,29378,408
2020-10-03,Glenn,021,27897,620,601,0,601,3
2020-10-03,Humboldt,023,135768,520,504,1,505,6
2020-10-03,Imperial,025,180216,12081,11090,11,11101,327
2020-10-03,Inyo,027,18085,199,194,4,198,14
2020-10-03,Kern,029,883053,32557,31864,340,32204,403
2020-10-03,Kings,031,150075,8136,7887,48,7935,80
2020-10-03,Lake,033,64148,617,588,0,588,10
2020-10-03,Lassen,035,31185,756,743,2,745,0
2020-10-03,Los Angeles,037,10098052,276523,271869,2089,273958,6620
2020-10-03,Madera,039,155013,4724,4565,31,4596,50
2020-10-03,Marin,041,260295,6867,6728,18,6746,91
2020-10-03,Mariposa,043,17540,77,75,0,75,2
2020-10-03,Mendocino,045,87422,951,898,4,902,18
2020-10-03,Merced,047,269075,9087,8986,25,9011,139
2020-10-03,Modoc,049,8938,29,26,0,26,0
2020-10-03,Mono,051,14174,171,152,2,154,1
2020-10-03,Monterey,053,433212,10386,10092,38,10130,72
2020-10-03,Napa,055,140530,1803,1752,8,1760,11
2020-10-03,Nevada,057,99092,563,544,16,560,6
2020-10-03,Orange,059,3164182,56462,53573,1553,55126,1268
2020-10-03,Placer,061,380077,3795,3648,14,3662,47
2020-10-03,Plumas,063,18699,51,48,0,48,0
2020-10-03,Riverside,065,2383286,61607,59991,218,60209,1226
2020-10-03,Sacramento,067,1510023,23480,23076,27,23103,437
2020-10-03,San Benito,069,59416,1366,1351,0,1351,12
2020-10-03,San Bernardino,071,2135413,56858,55004,353,55357,1031
2020-10-03,San Diego,073,3302833,50058,48202,1103,49305,798
2020-10-03,San Francisco,075,870044,11578,11475,32,11507,110
2020-10-03,San Joaquin,077,732212,20697,20322,68,20390,476
2020-10-03,San Luis Obispo,079,281455,3928,3670,21,3691,31
2020-10-03,San Mateo,081,765935,10558,9822,9,9831,128
2020-10-03,Santa Barbara,083,443738,9400,9256,81,9337,116
2020-10-03,Santa Clara,085,1922200,22964,21672,49,21721,309
2020-10-03,Santa Cruz,087,273765,2566,2476,33,2509,9
2020-10-03,Shasta,089,179085,1489,1117,14,1131,18
2020-10-03,Sierra,091,2930,6,6,0,6,0
2020-10-03,Siskiyou,093,43540,168,152,10,162,0
2020-10-03,Solano,095,438530,6606,6419,41,6460,52
2020-10-03,Sonoma,097,501317,8210,7747,21,7768,129
2020-10-03,Stanislaus,099,539301,16856,16645,573,17218,351
2020-10-03,Sutter,101,95872,1736,1705,1,1706,11
2020-10-03,Tehama,103,63373,667,630,2,632,3
2020-10-03,Trinity,105,12862,61,15,8,23,0
2020-10-03,Tulare,107,460477,16879,16322,174,16496,278
2020-10-03,Tuolumne,109,53932,237,224,4,228,2
2020-10-03,Ventura,111,848112,13832,13150,225,13375,148
2020-10-03,Yolo,113,214977,2914,2863,6,2869,56
2020-10-03,Yuba,115,75493,1122,1097,5,1102,8
2020-10-02,Alameda,001,1643700,22023,21404,196,21600,382
2020-10-02,Alpine,003,1148,3,2,0,2,0
2020-10-02,Amador,005,37829,300,296,0,296,16
2020-10-02,Butte,007,227075,3003,2879,27,2906,46
2020-10-02,Calaveras,009,45235,315,259,0,259,11
2020-10-02,Colusa,011,21464,535,537,0,537,6
2020-10-02,Contra Costa,013,1133247,17635,17002,84,17086,213
2020-10-02,Del Norte,015,27424,152,141,0,141,2
2020-10-02,El Dorado,017,186661,1264,1168,2,1170,4
2020-10-02,Fresno,019,978130,31352,28855,403,29258,403
2020-10-02,Glenn,021,27897,615,594,0,594,3
2020-10-02,Humboldt,023,135768,519,503,1,504,6
2020-10-02,Imperial,025,180216,12059,11024,11,11035,327
2020-10-02,Inyo,027,18085,197,191,4,195,14
2020-10-02,Kern,029,883053,32505,31790,338,32128,399
2020-10-02,Kings,031,150075,8127,7716,48,7764,79
2020-10-02,Lake,033,64148,611,579,0,579,10
2020-10-02,Lassen,035,31185,756,742,2,744,0
2020-10-02,Los Angeles,037,10098052,275621,270935,2062,272997,6602
2020-10-02,Madera,039,155013,4715,4537,31,4568,49
2020-10-02,Marin,041,260295,6850,6717,18,6735,91
2020-10-02,Mariposa,043,17540,77,75,0,75,2
2020-10-02,Mendocino,045,87422,946,883,4,887,18
2020-10-02,Merced,047,269075,9077,8961,25,8986,139
2020-10-02,Modoc,049,8938,29,26,0,26,0
2020-10-02,Mono,051,14174,171,150,2,152,1
2020-10-02,Monterey,053,433212,10352,9997,38,10035,71
2020-10-02,Napa,055,140530,1797,1737,8,1745,11
2020-10-02,Nevada,057,99092,560,543,16,559,6
2020-10-02,Orange,059,3164182,56331,53299,1546,54845,1262
2020-10-02,Placer,061,380077,3775,3612,14,3626,46
2020-10-02,Plumas,063,18699,51,48,0,48,0
2020-10-02,Riverside,065,2383286,61386,59673,215,59888,1223
2020-10-02,Sacramento,067,1510023,23415,22818,27,22845,436
2020-10-02,San Benito,069,59416,1362,1347,0,1347,12
2020-10-02,San Bernardino,071,2135413,56670,54613,353,54966,1028
2020-10-02,San Diego,073,3302833,49805,47793,1088,48881,794
2020-10-02,San Francisco,075,870044,11555,11398,32,11430,110
2020-10-02,San Joaquin,077,732212,20663,20235,67,20302,474
2020-10-02,San Luis Obispo,079,281455,3905,3654,21,3675,31
2020-10-02,San Mateo,081,765935,10517,9745,9,9754,128
2020-10-02,Santa Barbara,083,443738,9377,9234,81,9315,116
2020-10-02,Santa Clara,085,1922200,22878,21545,48,21593,305
2020-10-02,Santa Cruz,087,273765,2549,2463,33,2496,9
2020-10-02,Shasta,089,179085,1454,1046,14,1060,18
2020-10-02,Sierra,091,2930,6,6,0,6,0
2020-10-02,Siskiyou,093,43540,168,151,10,161,0
2020-10-02,Solano,095,438530,6576,6385,41,6426,52
2020-10-02,Sonoma,097,501317,8153,7662,21,7683,125
2020-10-02,Stanislaus,099,539301,16815,16609,564,17173,349
2020-10-02,Sutter,101,95872,1735,1693,1,1694,11
2020-10-02,Tehama,103,63373,662,619,2,621,3
2020-10-02,Trinity,105,12862,61,15,8,23,0
2020-10-02,Tulare,107,460477,16838,16245,167,16412,278
2020-10-02,Tuolumne,109,53932,235,225,4,229,2
2020-10-02,Ventura,111,848112,13793,13120,221,13341,146
2020-10-02,Yolo,113,214977,2909,2845,6,2851,55
2020-10-02,Yuba,115,75493,1120,1090,5,1095,8
2020-10-01,Alameda,001,1643700,21962,21349,192,21541,383
2020-10-01,Alpine,003,1148,3,2,0,2,0
2020-10-01,Amador,005,37829,300,294,0,294,16
2020-10-01,Butte,007,227075,2995,2865,27,2892,45
2020-10-01,Calaveras,009,45235,315,257,0,257,11
2020-10-01,Colusa,011,21464,535,536,0,536,6
2020-10-01,Contra Costa,013,1133247,17572,16898,84,16982,211
2020-10-01,Del Norte,015,27424,147,140,0,140,2
2020-10-01,El Dorado,017,186661,1260,1162,1,1163,4
2020-10-01,Fresno,019,978130,31271,28796,401,29197,397
2020-10-01,Glenn,021,27897,611,593,0,593,3
2020-10-01,Humboldt,023,135768,519,499,1,500,6
2020-10-01,Imperial,025,180216,12016,10928,11,10939,325
2020-10-01,Inyo,027,18085,197,191,4,195,14
2020-10-01,Kern,029,883053,32442,31678,333,32011,399
2020-10-01,Kings,031,150075,8116,7688,45,7733,79
2020-10-01,Lake,033,64148,605,572,0,572,11
2020-10-01,Lassen,035,31185,753,742,2,744,0
2020-10-01,Los Angeles,037,10098052,274579,271513,2028,273541,6621
2020-10-01,Madera,039,155013,4692,4508,31,4539,48
2020-10-01,Marin,041,260295,6836,6710,18,6728,92
2020-10-01,Mariposa,043,17540,77,76,0,76,2
2020-10-01,Mendocino,045,87422,941,874,4,878,19
2020-10-01,Merced,047,269075,9049,8942,25,8967,138
2020-10-01,Modoc,049,8938,29,26,0,26,0
2020-10-01,Mono,051,14174,169,150,2,152,1
2020-10-01,Monterey,053,433212,10276,9958,38,9996,71
2020-10-01,Napa,055,140530,1789,1729,8,1737,11
2020-10-01,Nevada,057,99092,559,543,16,559,6
2020-10-01,Orange,059,3164182,56166,53088,1533,54621,1257
2020-10-01,Placer,061,380077,3748,3599,14,3613,45
2020-10-01,Plumas,063,18699,51,48,0,48,0
2020-10-01,Riverside,065,2383286,61134,59293,209,59502,1223
2020-10-01,Sacramento,067,1510023,23303,22714,26,22740,433
2020-10-01,San Benito,069,59416,1360,1346,0,1346,12
2020-10-01,San Bernardino,071,2135413,56376,54350,350,54700,1021
2020-10-01,San Diego,073,3302833,49523,47487,1068,48555,792
2020-10-01,San Francisco,075,870044,11524,11284,30,11314,110
2020-10-01,San Joaquin,077,732212,20616,20204,64,20268,471
2020-10-01,San Luis Obispo,079,281455,3878,3625,21,3646,31
2020-10-01,San Mateo,081,765935,10472,9681,9,9690,128
2020-10-01,Santa Barbara,083,443738,9337,9215,81,9296,118
2020-10-01,Santa Clara,085,1922200,22777,21398,48,21446,305
2020-10-01,Santa Cruz,087,273765,2534,2418,33,2451,10
2020-10-01,Shasta,089,179085,1403,991,14,1005,18
2020-10-01,Sierra,091,2930,6,6,0,6,0
2020-10-01,Siskiyou,093,43540,165,150,10,160,0
2020-10-01,Solano,095,438530,6538,6352,41,6393,52
2020-10-01,Sonoma,097,501317,8086,7569,21,7590,125
2020-10-01,Stanislaus,099,539301,16782,16555,558,17113,346
2020-10-01,Sutter,101,95872,1730,1684,1,1685,11
2020-10-01,Tehama,103,63373,652,606,2,608,3
2020-10-01,Trinity,105,12862,61,15,8,23,0
2020-10-01,Tulare,107,460477,16763,16182,164,16346,275
2020-10-01,Tuolumne,109,53932,235,223,4,227,2
2020-10-01,Ventura,111,848112,13741,13057,207,13264,146
2020-10-01,Yolo,113,214977,2891,2833,6,2839,55
2020-10-01,Yuba,115,75493,1116,1082,5,1087,8
2020-09-30,Alameda,001,1643700,21883,21271,189,21460,380
2020-09-30,Alpine,003,1148,3,2,0,2,0
2020-09-30,Amador,005,37829,300,294,0,294,16
2020-09-30,Butte,007,227075,2987,2858,27,2885,44
2020-09-30,Calaveras,009,45235,314,258,0,258,11
2020-09-30,Colusa,011,21464,534,534,0,534,6
2020-09-30,Contra Costa,013,1133247,17504,16819,84,16903,211
2020-09-30,Del Norte,015,27424,146,140,0,140,2
2020-09-30,El Dorado,017,186661,1248,1157,1,1158,4
2020-09-30,Fresno,019,978130,31180,28706,398,29104,395
2020-09-30,Glenn,021,27897,606,592,0,592,3
2020-09-30,Humboldt,023,135768,517,497,1,498,6
2020-09-30,Imperial,025,180216,11991,10868,11,10879,287
2020-09-30,Inyo,027,18085,196,189,4,193,14
2020-09-30,Kern,029,883053,32367,31601,332,31933,398
2020-09-30,Kings,031,150075,8087,7685,45,7730,79
2020-09-30,Lake,033,64148,599,567,0,567,10
2020-09-30,Lassen,035,31185,750,742,2,744,0
2020-09-30,Los Angeles,037,10098052,273354,270260,1995,272255,6568
2020-09-30,Madera,039,155013,4683,4477,31,4508,47
2020-09-30,Marin,041,260295,6812,6700,17,6717,91
2020-09-30,Mariposa,043,17540,77,76,0,76,2
2020-09-30,Mendocino,045,87422,935,867,4,871,17
2020-09-30,Merced,047,269075,9029,8926,25,8951,136
2020-09-30,Modoc,049,8938,29,26,0,26,0
2020-09-30,Mono,051,14174,169,150,2,152,1
2020-09-30,Monterey,053,433212,10226,9898,37,9935,70
2020-09-30,Napa,055,140530,1775,1728,8,1736,11
2020-09-30,Nevada,057,99092,557,540,16,556,6
2020-09-30,Orange,059,3164182,55975,52916,1517,54433,1251
2020-09-30,Placer,061,380077,3727,3585,14,3599,43
2020-09-30,Plumas,063,18699,51,48,0,48,0
2020-09-30,Riverside,065,2383286,60779,59074,205,59279,1220
2020-09-30,Sacramento,067,1510023,23199,22613,26,22639,429
2020-09-30,San Benito,069,59416,1357,1342,0,1342,12
2020-09-30,San Bernardino,071,2135413,56096,53988,348,54336,1018
2020-09-30,San Diego,073,3302833,49219,47182,1047,48229,783
2020-09-30,San Francisco,075,870044,11494,11247,30,11277,106
2020-09-30,San Joaquin,077,732212,20533,20150,62,20212,461
2020-09-30,San Luis Obispo,079,281455,3853,3597,21,3618,31
2020-09-30,San Mateo,081,765935,10430,9634,9,9643,128
2020-09-30,Santa Barbara,083,443738,9311,9186,81,9267,115
2020-09-30,Santa Clara,085,1922200,22672,21318,48,21366,302
2020-09-30,Santa Cruz,087,273765,2521,2405,33,2438,10
2020-09-30,Shasta,089,179085,1347,976,13,989,17
2020-09-30,Sierra,091,2930,6,6,0,6,0
2020-09-30,Siskiyou,093,43540,163,150,10,160,0
2020-09-30,Solano,095,438530,6496,6315,41,6356,51
2020-09-30,Sonoma,097,501317,7997,7494,21,7515,125
2020-09-30,Stanislaus,099,539301,16735,16531,552,17083,343
2020-09-30,Sutter,101,95872,1714,1680,1,1681,10
2020-09-30,Tehama,103,63373,646,594,2,596,3
2020-09-30,Trinity,105,12862,58,15,8,23,0
2020-09-30,Tulare,107,460477,16697,16117,157,16274,274
2020-09-30,Tuolumne,109,53932,233,224,4,228,2
2020-09-30,Ventura,111,848112,13706,12968,191,13159,145
2020-09-30,Yolo,113,214977,2878,2822,6,2828,55
2020-09-30,Yuba,115,75493,1113,1075,5,1080,8
2020-09-29,Alameda,001,1643700,21806,21241,185,21426,374
2020-09-29,Alpine,003,1148,3,2,0,2,0
2020-09-29,Amador,005,37829,298,294,0,294,16
2020-09-29,Butte,007,227075,2973,2848,27,2875,44
2020-09-29,Calaveras,009,45235,312,261,0,261,11
2020-09-29,Colusa,011,21464,534,534,0,534,6
2020-09-29,Contra Costa,013,1133247,17449,16716,82,16798,209
2020-09-29,Del Norte,015,27424,142,142,0,142,2
2020-09-29,El Dorado,017,186661,1239,1151,1,1152,4
2020-09-29,Fresno,019,978130,31085,28621,397,29018,394
2020-09-29,Glenn,021,27897,602,589,0,589,3
2020-09-29,Humboldt,023,135768,515,497,1,498,6
2020-09-29,Imperial,025,180216,11957,10811,11,10822,283
2020-09-29,Inyo,027,18085,195,188,4,192,14
2020-09-29,Kern,029,883053,32312,31534,331,31865,397
2020-09-29,Kings,031,150075,8031,7681,45,7726,78
2020-09-29,Lake,033,64148,597,566,0,566,11
2020-09-29,Lassen,035,31185,750,741,2,743,0
2020-09-29,Los Angeles,037,10098052,272139,269246,1966,271212,6545
2020-09-29,Madera,039,155013,4659,4453,31,4484,47
2020-09-29,Marin,041,260295,6791,6692,17,6709,91
2020-09-29,Mariposa,043,17540,77,74,0,74,2
2020-09-29,Mendocino,045,87422,925,854,4,858,17
2020-09-29,Merced,047,269075,9016,8892,23,8915,136
2020-09-29,Modoc,049,8938,29,26,0,26,0
2020-09-29,Mono,051,14174,169,149,2,151,1
2020-09-29,Monterey,053,433212,10171,9826,35,9861,70
2020-09-29,Napa,055,140530,1772,1727,8,1735,11
2020-09-29,Nevada,057,99092,552,539,16,555,6
2020-09-29,Orange,059,3164182,55789,52755,1506,54261,1231
2020-09-29,Placer,061,380077,3705,3570,14,3584,42
2020-09-29,Plumas,063,18699,51,48,0,48,0
2020-09-29,Riverside,065,2383286,60449,58863,198,59061,1208
2020-09-29,Sacramento,067,1510023,23078,22547,26,22573,425
2020-09-29,San Benito,069,59416,1352,1341,0,1341,12
2020-09-29,San Bernardino,071,2135413,55785,53753,347,54100,1012
2020-09-29,San Diego,073,3302833,48942,46987,1024,48011,781
2020-09-29,San Francisco,075,870044,11458,11142,30,11172,104
2020-09-29,San Joaquin,077,732212,20467,20094,60,20154,454
2020-09-29,San Luis Obispo,079,281455,3831,3581,21,3602,31
2020-09-29,San Mateo,081,765935,10383,9619,9,9628,127
2020-09-29,Santa Barbara,083,443738,9291,9149,80,9229,114
2020-09-29,Santa Clara,085,1922200,22536,21233,47,21280,302
2020-09-29,Santa Cruz,087,273765,2506,2383,32,2415,10
2020-09-29,Shasta,089,179085,1286,943,13,956,17
2020-09-29,Sierra,091,2930,6,6,0,6,0
2020-09-29,Siskiyou,093,43540,157,150,10,160,0
2020-09-29,Solano,095,438530,6462,6303,41,6344,51
2020-09-29,Sonoma,097,501317,7925,7426,21,7447,125
2020-09-29,Stanislaus,099,539301,16705,16505,546,17051,341
2020-09-29,Sutter,101,95872,1708,1677,1,1678,10
2020-09-29,Tehama,103,63373,628,585,2,587,2
2020-09-29,Trinity,105,12862,56,16,8,24,0
2020-09-29,Tulare,107,460477,16633,16055,150,16205,270
2020-09-29,Tuolumne,109,53932,233,224,4,228,2
2020-09-29,Ventura,111,848112,13649,12875,188,13063,145
2020-09-29,Yolo,113,214977,2865,2818,6,2824,55
2020-09-29,Yuba,115,75493,1111,1071,5,1076,8
2020-09-28,Alameda,001,1643700,21719,21133,185,21318,370
2020-09-28,Alpine,003,1148,3,2,0,2,0
2020-09-28,Amador,005,37829,296,294,0,294,16
2020-09-28,Butte,007,227075,2958,2837,27,2864,44
2020-09-28,Calaveras,009,45235,312,257,0,257,11
2020-09-28,Colusa,011,21464,533,531,0,531,6
2020-09-28,Contra Costa,013,1133247,17384,16653,82,16735,195
2020-09-28,Del Norte,015,27424,142,138,0,138,2
2020-09-28,El Dorado,017,186661,1232,1144,1,1145,4
2020-09-28,Fresno,019,978130,31003,28517,389,28906,389
2020-09-28,Glenn,021,27897,600,585,0,585,3
2020-09-28,Humboldt,023,135768,509,495,1,496,6
2020-09-28,Imperial,025,180216,11922,10777,11,10788,283
2020-09-28,Inyo,027,18085,194,188,4,192,14
2020-09-28,Kern,029,883053,32247,31481,327,31808,395
2020-09-28,Kings,031,150075,7890,7661,43,7704,78
2020-09-28,Lake,033,64148,593,559,0,559,10
2020-09-28,Lassen,035,31185,749,737,2,739,0
2020-09-28,Los Angeles,037,10098052,271033,268404,1936,270340,6508
2020-09-28,Madera,039,155013,4638,4438,31,4469,47
2020-09-28,Marin,041,260295,6775,6676,17,6693,91
2020-09-28,Mariposa,043,17540,77,74,0,74,2
2020-09-28,Mendocino,045,87422,910,850,4,854,17
2020-09-28,Merced,047,269075,8988,8869,23,8892,136
2020-09-28,Modoc,049,8938,29,26,0,26,0
2020-09-28,Mono,051,14174,169,148,2,150,1
2020-09-28,Monterey,053,433212,10106,9780,33,9813,69
2020-09-28,Napa,055,140530,1760,1705,8,1713,11
2020-09-28,Nevada,057,99092,544,538,16,554,6
2020-09-28,Orange,059,3164182,55583,52633,1497,54130,1196
2020-09-28,Placer,061,380077,3684,3572,14,3586,42
2020-09-28,Plumas,063,18699,50,48,0,48,0
2020-09-28,Riverside,065,2383286,60151,58570,189,58759,1198
2020-09-28,Sacramento,067,1510023,22931,22392,26,22418,423
2020-09-28,San Benito,069,59416,1349,1336,0,1336,11
2020-09-28,San Bernardino,071,2135413,55436,53501,347,53848,988
2020-09-28,San Diego,073,3302833,48624,46736,1004,47740,776
2020-09-28,San Francisco,075,870044,11424,11114,30,11144,100
2020-09-28,San Joaquin,077,732212,20418,19982,59,20041,448
2020-09-28,San Luis Obispo,079,281455,3810,3567,21,3588,31
2020-09-28,San Mateo,081,765935,10332,9582,9,9591,127
2020-09-28,Santa Barbara,083,443738,9273,9121,80,9201,114
2020-09-28,Santa Clara,085,1922200,22419,21180,47,21227,271
2020-09-28,Santa Cruz,087,273765,2496,2359,32,2391,9
2020-09-28,Shasta,089,179085,1232,883,10,893,17
2020-09-28,Sierra,091,2930,6,6,0,6,0
2020-09-28,Siskiyou,093,43540,157,149,10,159,0
2020-09-28,Solano,095,438530,6426,6254,41,6295,51
2020-09-28,Sonoma,097,501317,7849,7369,21,7390,125
2020-09-28,Stanislaus,099,539301,16665,16467,539,17006,336
2020-09-28,Sutter,101,95872,1701,1676,1,1677,10
2020-09-28,Tehama,103,63373,620,579,2,581,2
2020-09-28,Trinity,105,12862,56,16,8,24,0
2020-09-28,Tulare,107,460477,16580,15918,145,16063,270
2020-09-28,Tuolumne,109,53932,233,225,4,229,2
2020-09-28,Ventura,111,848112,13571,12812,181,12993,139
2020-09-28,Yolo,113,214977,2848,2809,6,2815,55
2020-09-28,Yuba,115,75493,1108,1062,5,1067,7
2020-09-27,Alameda,001,1643700,21638,21077,181,21258,370
2020-09-27,Alpine,003,1148,3,2,0,2,0
2020-09-27,Amador,005,37829,296,291,0,291,16
2020-09-27,Butte,007,227075,2946,2833,27,2860,44
2020-09-27,Calaveras,009,45235,311,257,0,257,11
2020-09-27,Colusa,011,21464,532,531,0,531,6
2020-09-27,Contra Costa,013,1133247,17282,16596,81,16677,195
2020-09-27,Del Norte,015,27424,142,138,0,138,2
2020-09-27,El Dorado,017,186661,1217,1130,1,1131,4
2020-09-27,Fresno,019,978130,30897,28441,389,28830,389
2020-09-27,Glenn,021,27897,596,576,0,576,3
2020-09-27,Humboldt,023,135768,507,492,1,493,6
2020-09-27,Imperial,025,180216,11888,10743,11,10754,283
2020-09-27,Inyo,027,18085,192,188,4,192,14
2020-09-27,Kern,029,883053,32128,31462,324,31786,395
2020-09-27,Kings,031,150075,7870,7641,43,7684,78
2020-09-27,Lake,033,64148,589,555,0,555,10
2020-09-27,Lassen,035,31185,749,737,2,739,0
2020-09-27,Los Angeles,037,10098052,269857,267754,1915,269669,6507
2020-09-27,Madera,039,155013,4609,4416,31,4447,47
2020-09-27,Marin,041,260295,6765,6663,17,6680,91
2020-09-27,Mariposa,043,17540,77,74,0,74,2
2020-09-27,Mendocino,045,87422,904,846,4,850,17
2020-09-27,Merced,047,269075,8954,8853,23,8876,136
2020-09-27,Modoc,049,8938,29,26,0,26,0
2020-09-27,Mono,051,14174,169,148,2,150,1
2020-09-27,Monterey,053,433212,10046,9724,32,9756,69
2020-09-27,Napa,055,140530,1755,1690,8,1698,11
2020-09-27,Nevada,057,99092,543,537,16,553,6
2020-09-27,Orange,059,3164182,55308,52458,1488,53946,1195
2020-09-27,Placer,061,380077,3671,3562,14,3576,42
2020-09-27,Plumas,063,18699,50,48,0,48,0
2020-09-27,Riverside,065,2383286,59855,58509,181,58690,1191
2020-09-27,Sacramento,067,1510023,22833,22356,26,22382,422
2020-09-27,San Benito,069,59416,1349,1331,0,1331,11
2020-09-27,San Bernardino,071,2135413,55000,53127,347,53474,988
2020-09-27,San Diego,073,3302833,48280,46612,987,47599,776
2020-09-27,San Francisco,075,870044,11372,11114,30,11144,100
2020-09-27,San Joaquin,077,732212,20358,19981,59,20040,448
2020-09-27,San Luis Obispo,079,281455,3789,3562,21,3583,31
2020-09-27,San Mateo,081,765935,10264,9566,9,9575,127
2020-09-27,Santa Barbara,083,443738,9252,9090,79,9169,114
2020-09-27,Santa Clara,085,1922200,22310,21091,47,21138,271
2020-09-27,Santa Cruz,087,273765,2474,2359,32,2391,9
2020-09-27,Shasta,089,179085,1189,883,9,892,17
2020-09-27,Sierra,091,2930,6,6,0,6,0
2020-09-27,Siskiyou,093,43540,156,149,10,159,0
2020-09-27,Solano,095,438530,6391,6211,41,6252,51
2020-09-27,Sonoma,097,501317,7768,7336,21,7357,124
2020-09-27,Stanislaus,099,539301,16614,16448,533,16981,336
2020-09-27,Sutter,101,95872,1694,1672,1,1673,10
2020-09-27,Tehama,103,63373,603,573,2,575,2
2020-09-27,Trinity,105,12862,56,16,8,24,0
2020-09-27,Tulare,107,460477,16502,15918,136,16054,270
2020-09-27,Tuolumne,109,53932,232,224,4,228,2
2020-09-27,Ventura,111,848112,13482,12775,172,12947,139
2020-09-27,Yolo,113,214977,2834,2796,6,2802,55
2020-09-27,Yuba,115,75493,1098,1059,5,1064,7
2020-09-26,Alameda,001,1643700,21580,21019,180,21199,370
2020-09-26,Alpine,003,1148,3,2,0,2,0
2020-09-26,Amador,005,37829,295,291,0,291,16
2020-09-26,Butte,007,227075,2938,2827,27,2854,44
2020-09-26,Calaveras,009,45235,311,257,0,257,11
2020-09-26,Colusa,011,21464,532,529,0,529,6
2020-09-26,Contra Costa,013,1133247,17239,16508,81,16589,194
2020-09-26,Del Norte,015,27424,142,138,0,138,2
2020-09-26,El Dorado,017,186661,1212,1127,1,1128,4
2020-09-26,Fresno,019,978130,30830,28336,389,28725,389
2020-09-26,Glenn,021,27897,596,576,0,576,3
2020-09-26,Humboldt,023,135768,507,491,1,492,6
2020-09-26,Imperial,025,180216,11871,10721,11,10732,283
2020-09-26,Inyo,027,18085,191,187,4,191,14
2020-09-26,Kern,029,883053,32077,31410,324,31734,394
2020-09-26,Kings,031,150075,7858,7537,43,7580,78
2020-09-26,Lake,033,64148,586,549,0,549,10
2020-09-26,Lassen,035,31185,749,737,2,739,0
2020-09-26,Los Angeles,037,10098052,269223,266931,1900,268831,6497
2020-09-26,Madera,039,155013,4593,4410,31,4441,47
2020-09-26,Marin,041,260295,6752,6641,17,6658,91
2020-09-26,Mariposa,043,17540,76,74,0,74,2
2020-09-26,Mendocino,045,87422,899,836,4,840,17
2020-09-26,Merced,047,269075,8942,8841,22,8863,136
2020-09-26,Modoc,049,8938,29,26,0,26,0
2020-09-26,Mono,051,14174,169,148,2,150,1
2020-09-26,Monterey,053,433212,10019,9651,32,9683,68
2020-09-26,Napa,055,140530,1753,1681,8,1689,11
2020-09-26,Nevada,057,99092,543,534,16,550,6
2020-09-26,Orange,059,3164182,55168,52203,1482,53685,1194
2020-09-26,Placer,061,380077,3658,3551,14,3565,42
2020-09-26,Plumas,063,18699,49,48,0,48,0
2020-09-26,Riverside,065,2383286,59720,58076,179,58255,1190
2020-09-26,Sacramento,067,1510023,22777,22269,26,22295,421
2020-09-26,San Benito,069,59416,1347,1325,0,1325,11
2020-09-26,San Bernardino,071,2135413,54867,53122,347,53469,988
2020-09-26,San Diego,073,3302833,48075,46333,973,47306,775
2020-09-26,San Francisco,075,870044,11344,11113,30,11143,100
2020-09-26,San Joaquin,077,732212,20323,19982,57,20039,449
2020-09-26,San Luis Obispo,079,281455,3773,3546,21,3567,31
2020-09-26,San Mateo,081,765935,10230,9509,9,9518,127
2020-09-26,Santa Barbara,083,443738,9241,9061,79,9140,114
2020-09-26,Santa Clara,085,1922200,22239,20967,46,21013,270
2020-09-26,Santa Cruz,087,273765,2466,2336,32,2368,9
2020-09-26,Shasta,089,179085,1139,856,8,864,17
2020-09-26,Sierra,091,2930,6,6,0,6,0
2020-09-26,Siskiyou,093,43540,155,149,10,159,0
2020-09-26,Solano,095,438530,6372,6209,41,6250,51
2020-09-26,Sonoma,097,501317,7743,7285,20,7305,124
2020-09-26,Stanislaus,099,539301,16589,16421,524,16945,336
2020-09-26,Sutter,101,95872,1689,1662,1,1663,10
2020-09-26,Tehama,103,63373,591,560,2,562,2
2020-09-26,Trinity,105,12862,54,16,8,24,0
2020-09-26,Tulare,107,460477,16476,15881,134,16015,270
2020-09-26,Tuolumne,109,53932,232,223,4,227,2
2020-09-26,Ventura,111,848112,13447,12729,171,12900,137
2020-09-26,Yolo,113,214977,2832,2789,6,2795,55
2020-09-26,Yuba,115,75493,1094,1056,5,1061,7
2020-09-25,Alameda,001,1643700,21526,20911,180,21091,367
2020-09-25,Alpine,003,1148,3,2,0,2,0
2020-09-25,Amador,005,37829,295,289,0,289,16
2020-09-25,Butte,007,227075,2933,2819,27,2846,43
2020-09-25,Calaveras,009,45235,311,257,0,257,11
2020-09-25,Colusa,011,21464,532,528,0,528,6
2020-09-25,Contra Costa,013,1133247,17180,16401,81,16482,194
2020-09-25,Del Norte,015,27424,142,138,0,138,2
2020-09-25,El Dorado,017,186661,1208,1104,1,1105,4
2020-09-25,Fresno,019,978130,30770,28199,388,28587,385
2020-09-25,Glenn,021,27897,594,570,0,570,3
2020-09-25,Humboldt,023,135768,506,489,1,490,5
2020-09-25,Imperial,025,180216,11853,10681,11,10692,283
2020-09-25,Inyo,027,18085,189,187,4,191,14
2020-09-25,Kern,029,883053,32024,31333,322,31655,393
2020-09-25,Kings,031,150075,7853,7450,43,7493,77
2020-09-25,Lake,033,64148,585,539,0,539,9
2020-09-25,Lassen,035,31185,749,737,2,739,0
2020-09-25,Los Angeles,037,10098052,268434,265713,1886,267599,6483
2020-09-25,Madera,039,155013,4574,4369,31,4400,48
2020-09-25,Marin,041,260295,6749,6622,17,6639,90
2020-09-25,Mariposa,043,17540,76,74,0,74,2
2020-09-25,Mendocino,045,87422,884,819,3,822,17
2020-09-25,Merced,047,269075,8926,8830,22,8852,135
2020-09-25,Modoc,049,8938,29,26,0,26,0
2020-09-25,Mono,051,14174,169,149,2,151,1
2020-09-25,Monterey,053,433212,9967,9581,32,9613,68
2020-09-25,Napa,055,140530,1751,1669,8,1677,11
2020-09-25,Nevada,057,99092,541,529,16,545,6
2020-09-25,Orange,059,3164182,55041,52031,1474,53505,1184
2020-09-25,Placer,061,380077,3647,3527,14,3541,41
2020-09-25,Plumas,063,18699,49,48,0,48,0
2020-09-25,Riverside,065,2383286,59544,57783,174,57957,1183
2020-09-25,Sacramento,067,1510023,22700,22132,26,22158,418
2020-09-25,San Benito,069,59416,1346,1318,0,1318,11
2020-09-25,San Bernardino,071,2135413,54713,52814,347,53161,987
2020-09-25,San Diego,073,3302833,47873,46003,957,46960,775
2020-09-25,San Francisco,075,870044,11310,11066,29,11095,100
2020-09-25,San Joaquin,077,732212,20271,19909,57,19966,449
2020-09-25,San Luis Obispo,079,281455,3761,3512,21,3533,31
2020-09-25,San Mateo,081,765935,10194,9447,9,9456,127
2020-09-25,Santa Barbara,083,443738,9217,9026,79,9105,114
2020-09-25,Santa Clara,085,1922200,22175,20812,45,20857,265
2020-09-25,Santa Cruz,087,273765,2454,2309,31,2340,9
2020-09-25,Shasta,089,179085,1105,806,8,814,16
2020-09-25,Sierra,091,2930,6,6,0,6,0
2020-09-25,Siskiyou,093,43540,155,149,10,159,0
2020-09-25,Solano,095,438530,6356,6179,41,6220,50
2020-09-25,Sonoma,097,501317,7703,7202,20,7222,124
2020-09-25,Stanislaus,099,539301,16571,16381,522,16903,326
2020-09-25,Sutter,101,95872,1686,1655,1,1656,10
2020-09-25,Tehama,103,63373,583,546,2,548,2
2020-09-25,Trinity,105,12862,54,15,8,23,0
2020-09-25,Tulare,107,460477,16436,15815,132,15947,267
2020-09-25,Tuolumne,109,53932,232,223,4,227,2
2020-09-25,Ventura,111,848112,13404,12664,168,12832,137
2020-09-25,Yolo,113,214977,2824,2784,6,2790,55
2020-09-25,Yuba,115,75493,1089,1049,5,1054,5
2020-09-24,Alameda,001,1643700,21451,20838,177,21015,364
2020-09-24,Alpine,003,1148,3,2,0,2,0
2020-09-24,Amador,005,37829,295,288,0,288,16
2020-09-24,Butte,007,227075,2922,2803,27,2830,43
2020-09-24,Calaveras,009,45235,311,258,0,258,11
2020-09-24,Colusa,011,21464,532,523,0,523,6
2020-09-24,Contra Costa,013,1133247,17098,16252,81,16333,192
2020-09-24,Del Norte,015,27424,138,137,0,137,2
2020-09-24,El Dorado,017,186661,1199,1093,1,1094,4
2020-09-24,Fresno,019,978130,30664,28106,384,28490,375
2020-09-24,Glenn,021,27897,590,567,0,567,3
2020-09-24,Humboldt,023,135768,503,482,1,483,5
2020-09-24,Imperial,025,180216,11829,10622,11,10633,283
2020-09-24,Inyo,027,18085,189,187,4,191,13
2020-09-24,Kern,029,883053,31961,31273,320,31593,388
2020-09-24,Kings,031,150075,7837,7428,43,7471,76
2020-09-24,Lake,033,64148,576,531,0,531,9
2020-09-24,Lassen,035,31185,748,737,2,739,0
2020-09-24,Los Angeles,037,10098052,267392,264374,1868,266242,6452
2020-09-24,Madera,039,155013,4555,4344,31,4375,48
2020-09-24,Marin,041,260295,6721,6588,17,6605,85
2020-09-24,Mariposa,043,17540,76,74,0,74,2
2020-09-24,Mendocino,045,87422,880,810,3,813,17
2020-09-24,Merced,047,269075,8897,8813,21,8834,135
2020-09-24,Modoc,049,8938,29,24,0,24,0
2020-09-24,Mono,051,14174,169,149,2,151,1
2020-09-24,Monterey,053,433212,9901,9544,30,9574,67
2020-09-24,Napa,055,140530,1739,1661,8,1669,11
2020-09-24,Nevada,057,99092,540,527,16,543,6
2020-09-24,Orange,059,3164182,54833,51749,1456,53205,1164
2020-09-24,Placer,061,380077,3632,3514,14,3528,41
2020-09-24,Plumas,063,18699,49,48,0,48,0
2020-09-24,Riverside,065,2383286,59278,57491,168,57659,1172
2020-09-24,Sacramento,067,1510023,22574,21985,25,22010,417
2020-09-24,San Benito,069,59416,1344,1308,0,1308,11
2020-09-24,San Bernardino,071,2135413,54377,52455,346,52801,988
2020-09-24,San Diego,073,3302833,47604,45598,942,46540,773
2020-09-24,San Francisco,075,870044,11263,10992,29,11021,99
2020-09-24,San Joaquin,077,732212,20233,19851,55,19906,444
2020-09-24,San Luis Obispo,079,281455,3745,3480,21,3501,31
2020-09-24,San Mateo,081,765935,10146,9376,9,9385,127
2020-09-24,Santa Barbara,083,443738,9164,8988,77,9065,114
2020-09-24,Santa Clara,085,1922200,22087,20689,45,20734,262
2020-09-24,Santa Cruz,087,273765,2434,2300,29,2329,9
2020-09-24,Shasta,089,179085,1068,773,5,778,14
2020-09-24,Sierra,091,2930,6,6,0,6,0
2020-09-24,Siskiyou,093,43540,155,149,10,159,0
2020-09-24,Solano,095,438530,6323,6137,41,6178,49
2020-09-24,Sonoma,097,501317,7622,7163,20,7183,122
2020-09-24,Stanislaus,099,539301,16534,16326,517,16843,326
2020-09-24,Sutter,101,95872,1683,1646,1,1647,10
2020-09-24,Tehama,103,63373,580,540,2,542,2
2020-09-24,Trinity,105,12862,54,15,8,23,0
2020-09-24,Tulare,107,460477,16371,15754,131,15885,267
2020-09-24,Tuolumne,109,53932,232,224,4,228,2
2020-09-24,Ventura,111,848112,13322,12617,167,12784,138
2020-09-24,Yolo,113,214977,2817,2776,6,2782,55
2020-09-24,Yuba,115,75493,1084,1042,5,1047,5
2020-09-23,Alameda,001,1643700,21383,20718,175,20893,361
2020-09-23,Alpine,003,1148,3,2,0,2,0
2020-09-23,Amador,005,37829,294,288,0,288,16
2020-09-23,Butte,007,227075,2914,2790,27,2817,43
2020-09-23,Calaveras,009,45235,310,258,0,258,11
2020-09-23,Colusa,011,21464,531,521,0,521,6
2020-09-23,Contra Costa,013,1133247,17035,16167,80,16247,192
2020-09-23,Del Norte,015,27424,136,137,0,137,2
2020-09-23,El Dorado,017,186661,1185,1088,1,1089,4
2020-09-23,Fresno,019,978130,30569,28019,382,28401,371
2020-09-23,Glenn,021,27897,583,561,0,561,3
2020-09-23,Humboldt,023,135768,499,477,1,478,5
2020-09-23,Imperial,025,180216,11803,10587,11,10598,284
2020-09-23,Inyo,027,18085,188,177,4,181,13
2020-09-23,Kern,029,883053,31917,31172,318,31490,387
2020-09-23,Kings,031,150075,7815,7406,43,7449,76
2020-09-23,Lake,033,64148,571,519,0,519,9
2020-09-23,Lassen,035,31185,748,736,2,738,0
2020-09-23,Los Angeles,037,10098052,266375,263318,1839,265157,6421
2020-09-23,Madera,039,155013,4540,4311,31,4342,48
2020-09-23,Marin,041,260295,6702,6567,17,6584,85
2020-09-23,Mariposa,043,17540,76,74,0,74,2
2020-09-23,Mendocino,045,87422,879,801,2,803,17
2020-09-23,Merced,047,269075,8876,8785,19,8804,134
2020-09-23,Modoc,049,8938,29,24,0,24,0
2020-09-23,Mono,051,14174,169,149,2,151,1
2020-09-23,Monterey,053,433212,9832,9452,29,9481,67
2020-09-23,Napa,055,140530,1730,1653,8,1661,11
2020-09-23,Nevada,057,99092,539,523,16,539,6
2020-09-23,Orange,059,3164182,54606,51658,1448,53106,1155
2020-09-23,Placer,061,380077,3620,3506,14,3520,41
2020-09-23,Plumas,063,18699,49,48,0,48,0
2020-09-23,Riverside,065,2383286,58972,57257,165,57422,1165
2020-09-23,Sacramento,067,1510023,22497,21821,25,21846,415
2020-09-23,San Benito,069,59416,1338,1305,0,1305,10
2020-09-23,San Bernardino,071,2135413,54083,52132,344,52476,973
2020-09-23,San Diego,073,3302833,47328,45427,923,46350,767
2020-09-23,San Francisco,075,870044,11214,10926,29,10955,95
2020-09-23,San Joaquin,077,732212,20180,19785,55,19840,439
2020-09-23,San Luis Obispo,079,281455,3727,3447,21,3468,31
2020-09-23,San Mateo,081,765935,10106,9351,9,9360,127
2020-09-23,Santa Barbara,083,443738,9135,8952,77,9029,112
2020-09-23,Santa Clara,085,1922200,21976,20575,42,20617,260
2020-09-23,Santa Cruz,087,273765,2415,2283,29,2312,9
2020-09-23,Shasta,089,179085,1029,756,4,760,14
2020-09-23,Sierra,091,2930,6,6,0,6,0
2020-09-23,Siskiyou,093,43540,155,149,10,159,0
2020-09-23,Solano,095,438530,6298,6123,41,6164,50
2020-09-23,Sonoma,097,501317,7546,7091,20,7111,122
2020-09-23,Stanislaus,099,539301,16504,16271,514,16785,317
2020-09-23,Sutter,101,95872,1679,1646,1,1647,10
2020-09-23,Tehama,103,63373,574,533,2,535,2
2020-09-23,Trinity,105,12862,53,15,8,23,0
2020-09-23,Tulare,107,460477,16306,15664,130,15794,266
2020-09-23,Tuolumne,109,53932,232,223,4,227,2
2020-09-23,Ventura,111,848112,13266,12591,164,12755,137
2020-09-23,Yolo,113,214977,2799,2766,6,2772,55
2020-09-23,Yuba,115,75493,1082,1038,5,1043,5
2020-09-22,Alameda,001,1643700,21303,20607,173,20780,355
2020-09-22,Alpine,003,1148,2,2,0,2,0
2020-09-22,Amador,005,37829,293,287,0,287,16
2020-09-22,Butte,007,227075,2909,2776,27,2803,43
2020-09-22,Calaveras,009,45235,310,258,0,258,11
2020-09-22,Colusa,011,21464,529,518,0,518,6
2020-09-22,Contra Costa,013,1133247,16945,16090,80,16170,190
2020-09-22,Del Norte,015,27424,136,137,0,137,2
2020-09-22,El Dorado,017,186661,1166,1076,1,1077,4
2020-09-22,Fresno,019,978130,30474,27944,379,28323,369
2020-09-22,Glenn,021,27897,580,560,0,560,3
2020-09-22,Humboldt,023,135768,498,476,1,477,5
2020-09-22,Imperial,025,180216,11774,10529,10,10539,284
2020-09-22,Inyo,027,18085,188,177,4,181,13
2020-09-22,Kern,029,883053,31849,31110,311,31421,383
2020-09-22,Kings,031,150075,7758,7395,42,7437,76
2020-09-22,Lake,033,64148,563,516,0,516,9
2020-09-22,Lassen,035,31185,747,736,2,738,0
2020-09-22,Los Angeles,037,10098052,265310,262117,1813,263930,6394
2020-09-22,Madera,039,155013,4524,4303,31,4334,47
2020-09-22,Marin,041,260295,6688,6561,17,6578,84
2020-09-22,Mariposa,043,17540,76,74,0,74,2
2020-09-22,Mendocino,045,87422,859,794,1,795,18
2020-09-22,Merced,047,269075,8846,8769,19,8788,132
2020-09-22,Modoc,049,8938,29,24,0,24,0
2020-09-22,Mono,051,14174,168,149,2,151,1
2020-09-22,Monterey,053,433212,9774,9393,29,9422,67
2020-09-22,Napa,055,140530,1713,1652,8,1660,11
2020-09-22,Nevada,057,99092,539,523,16,539,6
2020-09-22,Orange,059,3164182,54356,51528,1439,52967,1132
2020-09-22,Placer,061,380077,3608,3492,14,3506,40
2020-09-22,Plumas,063,18699,49,48,0,48,0
2020-09-22,Riverside,065,2383286,58488,57066,161,57227,1162
2020-09-22,Sacramento,067,1510023,22377,21745,25,21770,410
2020-09-22,San Benito,069,59416,1333,1305,0,1305,10
2020-09-22,San Bernardino,071,2135413,53809,51899,344,52243,971
2020-09-22,San Diego,073,3302833,47021,45149,904,46053,765
2020-09-22,San Francisco,075,870044,11170,10893,28,10921,95
2020-09-22,San Joaquin,077,732212,20133,19755,54,19809,426
2020-09-22,San Luis Obispo,079,281455,3705,3420,21,3441,31
2020-09-22,San Mateo,081,765935,10068,9291,9,9300,127
2020-09-22,Santa Barbara,083,443738,9105,8927,76,9003,111
2020-09-22,Santa Clara,085,1922200,21857,20514,42,20556,253
2020-09-22,Santa Cruz,087,273765,2392,2264,29,2293,8
2020-09-22,Shasta,089,179085,994,723,4,727,14
2020-09-22,Sierra,091,2930,6,6,0,6,0
2020-09-22,Siskiyou,093,43540,155,149,10,159,0
2020-09-22,Solano,095,438530,6267,6107,41,6148,48
2020-09-22,Sonoma,097,501317,7467,7068,19,7087,117
2020-09-22,Stanislaus,099,539301,16481,16231,507,16738,316
2020-09-22,Sutter,101,95872,1673,1638,1,1639,10
2020-09-22,Tehama,103,63373,566,529,2,531,2
2020-09-22,Trinity,105,12862,53,15,8,23,0
2020-09-22,Tulare,107,460477,16239,15616,126,15742,263
2020-09-22,Tuolumne,109,53932,231,224,4,228,1
2020-09-22,Ventura,111,848112,13214,12507,160,12667,136
2020-09-22,Yolo,113,214977,2792,2763,6,2769,54
2020-09-22,Yuba,115,75493,1073,1035,5,1040,5
2020-09-21,Alameda,001,1643700,21224,20501,172,20673,343
2020-09-21,Alpine,003,1148,2,2,0,2,0
2020-09-21,Amador,005,37829,291,286,0,286,16
2020-09-21,Butte,007,227075,2895,2769,27,2796,41
2020-09-21,Calaveras,009,45235,308,256,0,256,10
2020-09-21,Colusa,011,21464,528,517,0,517,6
2020-09-21,Contra Costa,013,1133247,16858,16008,80,16088,189
2020-09-21,Del Norte,015,27424,136,132,0,132,2
2020-09-21,El Dorado,017,186661,1157,1074,1,1075,4
2020-09-21,Fresno,019,978130,30372,27843,372,28215,362
2020-09-21,Glenn,021,27897,576,556,0,556,3
2020-09-21,Humboldt,023,135768,494,473,1,474,5
2020-09-21,Imperial,025,180216,11743,10521,10,10531,284
2020-09-21,Inyo,027,18085,187,177,4,181,12
2020-09-21,Kern,029,883053,31777,31031,309,31340,379
2020-09-21,Kings,031,150075,7645,7297,41,7338,76
2020-09-21,Lake,033,64148,558,508,0,508,8
2020-09-21,Lassen,035,31185,745,735,2,737,0
2020-09-21,Los Angeles,037,10098052,264223,261418,1768,263186,6360
2020-09-21,Madera,039,155013,4513,4275,30,4305,47
2020-09-21,Marin,041,260295,6677,6538,16,6554,84
2020-09-21,Mariposa,043,17540,75,74,0,74,2
2020-09-21,Mendocino,045,87422,844,778,0,778,18
2020-09-21,Merced,047,269075,8827,8749,17,8766,128
2020-09-21,Modoc,049,8938,29,22,0,22,0
2020-09-21,Mono,051,14174,168,147,2,149,1
2020-09-21,Monterey,053,433212,9710,9331,26,9357,66
2020-09-21,Napa,055,140530,1702,1641,8,1649,11
2020-09-21,Nevada,057,99092,537,515,16,531,6
2020-09-21,Orange,059,3164182,54134,51363,1432,52795,1110
2020-09-21,Placer,061,380077,3598,3473,14,3487,40
2020-09-21,Plumas,063,18699,49,47,0,47,0
2020-09-21,Riverside,065,2383286,58216,57001,154,57155,1153
2020-09-21,Sacramento,067,1510023,22196,21568,25,21593,404
2020-09-21,San Benito,069,59416,1331,1298,0,1298,10
2020-09-21,San Bernardino,071,2135413,53523,51654,344,51998,970
2020-09-21,San Diego,073,3302833,46737,44927,883,45810,760
2020-09-21,San Francisco,075,870044,11122,10743,28,10771,95
2020-09-21,San Joaquin,077,732212,20075,19579,54,19633,423
2020-09-21,San Luis Obispo,079,281455,3679,3406,21,3427,27
2020-09-21,San Mateo,081,765935,10016,9239,9,9248,127
2020-09-21,Santa Barbara,083,443738,9077,8911,76,8987,110
2020-09-21,Santa Clara,085,1922200,21756,20432,42,20474,252
2020-09-21,Santa Cruz,087,273765,2375,2257,27,2284,8
2020-09-21,Shasta,089,179085,944,696,4,700,14
2020-09-21,Sierra,091,2930,6,6,0,6,0
2020-09-21,Siskiyou,093,43540,155,146,10,156,0
2020-09-21,Solano,095,438530,6243,6019,41,6060,46
2020-09-21,Sonoma,097,501317,7391,7017,19,7036,117
2020-09-21,Stanislaus,099,539301,16451,16186,507,16693,310
2020-09-21,Sutter,101,95872,1666,1634,1,1635,10
2020-09-21,Tehama,103,63373,547,513,2,515,2
2020-09-21,Trinity,105,12862,53,15,8,23,0
2020-09-21,Tulare,107,460477,16165,15528,117,15645,260
2020-09-21,Tuolumne,109,53932,231,221,4,225,1
2020-09-21,Ventura,111,848112,13130,12477,154,12631,133
2020-09-21,Yolo,113,214977,2786,2752,6,2758,54
2020-09-21,Yuba,115,75493,1069,1033,5,1038,1
2020-09-20,Alameda,001,1643700,21124,20425,169,20594,343
2020-09-20,Alpine,003,1148,2,2,0,2,0
2020-09-20,Amador,005,37829,290,286,0,286,16
2020-09-20,Butte,007,227075,2883,2764,27,2791,39
2020-09-20,Calaveras,009,45235,304,256,0,256,10
2020-09-20,Colusa,011,21464,526,510,0,510,6
2020-09-20,Contra Costa,013,1133247,16724,15917,79,15996,189
2020-09-20,Del Norte,015,27424,134,132,0,132,2
2020-09-20,El Dorado,017,186661,1142,1073,1,1074,4
2020-09-20,Fresno,019,978130,30258,27769,367,28136,362
2020-09-20,Glenn,021,27897,572,550,0,550,3
2020-09-20,Humboldt,023,135768,494,472,1,473,5
2020-09-20,Imperial,025,180216,11716,10496,9,10505,284
2020-09-20,Inyo,027,18085,187,177,4,181,12
2020-09-20,Kern,029,883053,31694,30992,306,31298,379
2020-09-20,Kings,031,150075,7598,7159,40,7199,76
2020-09-20,Lake,033,64148,546,492,0,492,8
2020-09-20,Lassen,035,31185,745,735,2,737,0
2020-09-20,Los Angeles,037,10098052,262993,260770,1743,262513,6347
2020-09-20,Madera,039,155013,4493,4257,30,4287,47
2020-09-20,Marin,041,260295,6651,6533,16,6549,83
2020-09-20,Mariposa,043,17540,75,74,0,74,2
2020-09-20,Mendocino,045,87422,832,765,0,765,18
2020-09-20,Merced,047,269075,8800,8745,17,8762,128
2020-09-20,Modoc,049,8938,27,22,0,22,0
2020-09-20,Mono,051,14174,167,147,2,149,1
2020-09-20,Monterey,053,433212,9632,9312,26,9338,65
2020-09-20,Napa,055,140530,1693,1626,8,1634,11
2020-09-20,Nevada,057,99092,534,511,16,527,6
2020-09-20,Orange,059,3164182,53893,51233,1422,52655,1110
2020-09-20,Placer,061,380077,3583,3452,14,3466,40
2020-09-20,Plumas,063,18699,49,47,0,47,0
2020-09-20,Riverside,065,2383286,58015,56783,148,56931,1147
2020-09-20,Sacramento,067,1510023,22009,21394,24,21418,401
2020-09-20,San Benito,069,59416,1320,1291,0,1291,9
2020-09-20,San Bernardino,071,2135413,53203,51559,342,51901,970
2020-09-20,San Diego,073,3302833,46364,44579,854,45433,760
2020-09-20,San Francisco,075,870044,11068,10743,28,10771,95
2020-09-20,San Joaquin,077,732212,20010,19578,47,19625,423
2020-09-20,San Luis Obispo,079,281455,3651,3393,21,3414,27
2020-09-20,San Mateo,081,765935,9949,9198,9,9207,127
2020-09-20,Santa Barbara,083,443738,9041,8880,75,8955,110
2020-09-20,Santa Clara,085,1922200,21635,20330,41,20371,252
2020-09-20,Santa Cruz,087,273765,2355,2199,27,2226,8
2020-09-20,Shasta,089,179085,903,696,3,699,14
2020-09-20,Sierra,091,2930,6,6,0,6,0
2020-09-20,Siskiyou,093,43540,155,146,10,156,0
2020-09-20,Solano,095,438530,6199,6020,41,6061,46
2020-09-20,Sonoma,097,501317,7287,6954,19,6973,117
2020-09-20,Stanislaus,099,539301,16420,16159,500,16659,310
2020-09-20,Sutter,101,95872,1660,1624,1,1625,10
2020-09-20,Tehama,103,63373,534,509,2,511,2
2020-09-20,Trinity,105,12862,53,15,8,23,0
2020-09-20,Tulare,107,460477,16079,15528,111,15639,260
2020-09-20,Tuolumne,109,53932,231,221,4,225,1
2020-09-20,Ventura,111,848112,13064,12406,150,12556,133
2020-09-20,Yolo,113,214977,2778,2745,6,2751,54
2020-09-20,Yuba,115,75493,1062,1029,5,1034,1
2020-09-19,Alameda,001,1643700,21073,20349,166,20515,343
2020-09-19,Alpine,003,1148,2,2,0,2,0
2020-09-19,Amador,005,37829,290,285,0,285,16
2020-09-19,Butte,007,227075,2877,2748,27,2775,38
2020-09-19,Calaveras,009,45235,304,256,0,256,10
2020-09-19,Colusa,011,21464,526,507,0,507,6
2020-09-19,Contra Costa,013,1133247,16661,15783,79,15862,186
2020-09-19,Del Norte,015,27424,133,132,0,132,2
2020-09-19,El Dorado,017,186661,1136,1068,0,1068,4
2020-09-19,Fresno,019,978130,30185,27668,367,28035,362
2020-09-19,Glenn,021,27897,569,547,0,547,3
2020-09-19,Humboldt,023,135768,493,471,1,472,5
2020-09-19,Imperial,025,180216,11701,10496,9,10505,284
2020-09-19,Inyo,027,18085,187,177,4,181,12
2020-09-19,Kern,029,883053,31640,30886,303,31189,379
2020-09-19,Kings,031,150075,7592,7130,40,7170,76
2020-09-19,Lake,033,64148,546,465,0,465,8
2020-09-19,Lassen,035,31185,745,731,2,733,0
2020-09-19,Los Angeles,037,10098052,262367,259801,1729,261530,6325
2020-09-19,Madera,039,155013,4470,4237,30,4267,47
2020-09-19,Marin,041,260295,6644,6513,15,6528,81
2020-09-19,Mariposa,043,17540,75,74,0,74,2
2020-09-19,Mendocino,045,87422,829,750,0,750,18
2020-09-19,Merced,047,269075,8789,8717,16,8733,128
2020-09-19,Modoc,049,8938,27,22,0,22,0
2020-09-19,Mono,051,14174,167,147,2,149,1
2020-09-19,Monterey,053,433212,9590,9237,26,9263,65
2020-09-19,Napa,055,140530,1685,1614,8,1622,11
2020-09-19,Nevada,057,99092,532,505,16,521,6
2020-09-19,Orange,059,3164182,53764,50999,1415,52414,1105
2020-09-19,Placer,061,380077,3574,3412,14,3426,40
2020-09-19,Plumas,063,18699,49,47,0,47,0
2020-09-19,Riverside,065,2383286,57888,56562,147,56709,1147
2020-09-19,Sacramento,067,1510023,21955,21297,24,21321,396
2020-09-19,San Benito,069,59416,1316,1276,0,1276,9
2020-09-19,San Bernardino,071,2135413,53047,51353,339,51692,971
2020-09-19,San Diego,073,3302833,46136,44295,831,45126,773
2020-09-19,San Francisco,075,870044,11035,10741,28,10769,95
2020-09-19,San Joaquin,077,732212,19973,19580,47,19627,424
2020-09-19,San Luis Obispo,079,281455,3630,3369,21,3390,27
2020-09-19,San Mateo,081,765935,9918,9158,9,9167,127
2020-09-19,Santa Barbara,083,443738,9021,8862,75,8937,106
2020-09-19,Santa Clara,085,1922200,21546,20170,41,20211,251
2020-09-19,Santa Cruz,087,273765,2341,2198,26,2224,8
2020-09-19,Shasta,089,179085,876,687,3,690,14
2020-09-19,Sierra,091,2930,6,6,0,6,0
2020-09-19,Siskiyou,093,43540,155,146,10,156,0
2020-09-19,Solano,095,438530,6183,5998,41,6039,46
2020-09-19,Sonoma,097,501317,7254,6905,19,6924,117
2020-09-19,Stanislaus,099,539301,16380,16109,493,16602,313
2020-09-19,Sutter,101,95872,1659,1602,1,1603,10
2020-09-19,Tehama,103,63373,529,498,2,500,2
2020-09-19,Trinity,105,12862,53,15,8,23,0
2020-09-19,Tulare,107,460477,16030,15485,108,15593,260
2020-09-19,Tuolumne,109,53932,231,217,4,221,1
2020-09-19,Ventura,111,848112,13032,12328,150,12478,133
2020-09-19,Yolo,113,214977,2770,2739,6,2745,54
2020-09-19,Yuba,115,75493,1055,1023,5,1028,1
2020-09-18,Alameda,001,1643700,21008,20222,160,20382,341
2020-09-18,Alpine,003,1148,2,2,0,2,0
2020-09-18,Amador,005,37829,290,285,0,285,16
2020-09-18,Butte,007,227075,2875,2738,27,2765,37
2020-09-18,Calaveras,009,45235,304,255,0,255,9
2020-09-18,Colusa,011,21464,526,504,0,504,6
2020-09-18,Contra Costa,013,1133247,16576,15667,79,15746,185
2020-09-18,Del Norte,015,27424,133,131,0,131,2
2020-09-18,El Dorado,017,186661,1123,1063,0,1063,4
2020-09-18,Fresno,019,978130,30120,27560,367,27927,359
2020-09-18,Glenn,021,27897,566,541,0,541,3
2020-09-18,Humboldt,023,135768,490,470,1,471,5
2020-09-18,Imperial,025,180216,11686,10460,9,10469,283
2020-09-18,Inyo,027,18085,187,177,4,181,12
2020-09-18,Kern,029,883053,31582,30742,300,31042,373
2020-09-18,Kings,031,150075,7582,7062,40,7102,74
2020-09-18,Lake,033,64148,540,458,0,458,8
2020-09-18,Lassen,035,31185,744,731,2,733,0
2020-09-18,Los Angeles,037,10098052,261606,258488,1711,260199,6324
2020-09-18,Madera,039,155013,4458,4211,30,4241,45
2020-09-18,Marin,041,260295,6629,6475,15,6490,81
2020-09-18,Mariposa,043,17540,75,74,0,74,2
2020-09-18,Mendocino,045,87422,821,739,0,739,18
2020-09-18,Merced,047,269075,8777,8691,15,8706,127
2020-09-18,Modoc,049,8938,27,22,0,22,0
2020-09-18,Mono,051,14174,165,147,2,149,1
2020-09-18,Monterey,053,433212,9548,9183,26,9209,64
2020-09-18,Napa,055,140530,1679,1604,8,1612,11
2020-09-18,Nevada,057,99092,529,504,16,520,6
2020-09-18,Orange,059,3164182,53617,50733,1403,52136,1107
2020-09-18,Placer,061,380077,3563,3389,14,3403,40
2020-09-18,Plumas,063,18699,49,45,0,45,0
2020-09-18,Riverside,065,2383286,57766,56248,143,56391,1143
2020-09-18,Sacramento,067,1510023,21872,21105,24,21129,391
2020-09-18,San Benito,069,59416,1308,1257,0,1257,8
2020-09-18,San Bernardino,071,2135413,52902,51106,336,51442,970
2020-09-18,San Diego,073,3302833,45886,44009,826,44835,757
2020-09-18,San Francisco,075,870044,10997,10644,27,10671,95
2020-09-18,San Joaquin,077,732212,19929,19531,46,19577,423
2020-09-18,San Luis Obispo,079,281455,3606,3328,21,3349,27
2020-09-18,San Mateo,081,765935,9878,9062,9,9071,127
2020-09-18,Santa Barbara,083,443738,9000,8824,75,8899,107
2020-09-18,Santa Clara,085,1922200,21448,20058,41,20099,252
2020-09-18,Santa Cruz,087,273765,2320,2180,25,2205,8
2020-09-18,Shasta,089,179085,841,668,3,671,14
2020-09-18,Sierra,091,2930,6,6,0,6,0
2020-09-18,Siskiyou,093,43540,154,146,10,156,0
2020-09-18,Solano,095,438530,6167,5961,41,6002,46
2020-09-18,Sonoma,097,501317,7206,6856,19,6875,114
2020-09-18,Stanislaus,099,539301,16352,16042,487,16529,277
2020-09-18,Sutter,101,95872,1652,1586,1,1587,10
2020-09-18,Tehama,103,63373,529,490,2,492,2
2020-09-18,Trinity,105,12862,53,15,7,22,0
2020-09-18,Tulare,107,460477,15997,15435,104,15539,259
2020-09-18,Tuolumne,109,53932,230,216,4,220,1
2020-09-18,Ventura,111,848112,12971,12236,146,12382,133
2020-09-18,Yolo,113,214977,2764,2732,6,2738,54
2020-09-18,Yuba,115,75493,1051,1020,5,1025,1
2020-09-17,Alameda,001,1643700,20909,20146,160,20306,339
2020-09-17,Alpine,003,1148,2,2,0,2,0
2020-09-17,Amador,005,37829,288,284,0,284,16
2020-09-17,Butte,007,227075,2857,2720,27,2747,38
2020-09-17,Calaveras,009,45235,304,254,0,254,9
2020-09-17,Colusa,011,21464,524,499,0,499,6
2020-09-17,Contra Costa,013,1133247,16486,15576,79,15655,184
2020-09-17,Del Norte,015,27424,133,131,0,131,2
2020-09-17,El Dorado,017,186661,1114,1057,0,1057,4
2020-09-17,Fresno,019,978130,30010,27487,362,27849,355
2020-09-17,Glenn,021,27897,565,541,0,541,3
2020-09-17,Humboldt,023,135768,484,466,1,467,5
2020-09-17,Imperial,025,180216,11669,10436,9,10445,281
2020-09-17,Inyo,027,18085,187,176,4,180,12
2020-09-17,Kern,029,883053,31521,30627,293,30920,372
2020-09-17,Kings,031,150075,7511,7015,40,7055,72
2020-09-17,Lake,033,64148,530,433,0,433,8
2020-09-17,Lassen,035,31185,742,731,2,733,0
2020-09-17,Los Angeles,037,10098052,260665,257246,1696,258942,6318
2020-09-17,Madera,039,155013,4424,4152,30,4182,45
2020-09-17,Marin,041,260295,6608,6457,15,6472,81
2020-09-17,Mariposa,043,17540,75,74,0,74,2
2020-09-17,Mendocino,045,87422,810,737,0,737,18
2020-09-17,Merced,047,269075,8758,8671,15,8686,119
2020-09-17,Modoc,049,8938,27,22,0,22,0
2020-09-17,Mono,051,14174,165,147,2,149,1
2020-09-17,Monterey,053,433212,9486,9113,25,9138,62
2020-09-17,Napa,055,140530,1668,1592,8,1600,11
2020-09-17,Nevada,057,99092,527,494,16,510,6
2020-09-17,Orange,059,3164182,53436,50537,1391,51928,1098
2020-09-17,Placer,061,380077,3542,3368,14,3382,40
2020-09-17,Plumas,063,18699,49,45,0,45,0
2020-09-17,Riverside,065,2383286,57540,56007,142,56149,1134
2020-09-17,Sacramento,067,1510023,21637,20895,24,20919,385
2020-09-17,San Benito,069,59416,1305,1252,0,1252,8
2020-09-17,San Bernardino,071,2135413,52700,50770,336,51106,904
2020-09-17,San Diego,073,3302833,45606,43621,814,44435,754
2020-09-17,San Francisco,075,870044,10902,10564,27,10591,95
2020-09-17,San Joaquin,077,732212,19870,19439,46,19485,416
2020-09-17,San Luis Obispo,079,281455,3576,3299,21,3320,27
2020-09-17,San Mateo,081,765935,9836,8984,9,8993,127
2020-09-17,Santa Barbara,083,443738,8976,8779,75,8854,107
2020-09-17,Santa Clara,085,1922200,21331,19825,41,19866,254
2020-09-17,Santa Cruz,087,273765,2304,2155,25,2180,7
2020-09-17,Shasta,089,179085,802,660,3,663,12
2020-09-17,Sierra,091,2930,6,6,0,6,0
2020-09-17,Siskiyou,093,43540,154,146,10,156,0
2020-09-17,Solano,095,438530,6144,5915,41,5956,44
2020-09-17,Sonoma,097,501317,7142,6754,19,6773,114
2020-09-17,Stanislaus,099,539301,16319,15984,483,16467,277
2020-09-17,Sutter,101,95872,1647,1572,1,1573,10
2020-09-17,Tehama,103,63373,515,487,2,489,2
2020-09-17,Trinity,105,12862,53,15,7,22,0
2020-09-17,Tulare,107,460477,15944,15344,102,15446,258
2020-09-17,Tuolumne,109,53932,229,214,4,218,1
2020-09-17,Ventura,111,848112,12884,12167,142,12309,130
2020-09-17,Yolo,113,214977,2755,2724,6,2730,53
2020-09-17,Yuba,115,75493,1047,1015,5,1020,1
2020-09-16,Alameda,001,1643700,20811,20009,158,20167,333
2020-09-16,Alpine,003,1148,2,2,0,2,0
2020-09-16,Amador,005,37829,288,284,0,284,16
2020-09-16,Butte,007,227075,2847,2704,26,2730,38
2020-09-16,Calaveras,009,45235,304,254,0,254,9
2020-09-16,Colusa,011,21464,522,497,0,497,6
2020-09-16,Contra Costa,013,1133247,16400,15473,79,15552,183
2020-09-16,Del Norte,015,27424,133,131,0,131,2
2020-09-16,El Dorado,017,186661,1106,1049,0,1049,4
2020-09-16,Fresno,019,978130,29903,27381,360,27741,343
2020-09-16,Glenn,021,27897,563,539,0,539,3
2020-09-16,Humboldt,023,135768,483,455,1,456,4
2020-09-16,Imperial,025,180216,11646,10401,9,10410,277
2020-09-16,Inyo,027,18085,186,176,4,180,12
2020-09-16,Kern,029,883053,31461,30570,292,30862,371
2020-09-16,Kings,031,150075,7486,7002,37,7039,71
2020-09-16,Lake,033,64148,519,417,0,417,6
2020-09-16,Lassen,035,31185,741,730,2,732,0
2020-09-16,Los Angeles,037,10098052,259686,256101,1678,257779,6299
2020-09-16,Madera,039,155013,4401,4138,30,4168,45
2020-09-16,Marin,041,260295,6580,6430,15,6445,77
2020-09-16,Mariposa,043,17540,75,74,0,74,2
2020-09-16,Mendocino,045,87422,801,727,0,727,18
2020-09-16,Merced,047,269075,8737,8646,15,8661,118
2020-09-16,Modoc,049,8938,27,22,0,22,0
2020-09-16,Mono,051,14174,165,147,2,149,1
2020-09-16,Monterey,053,433212,9432,8997,25,9022,62
2020-09-16,Napa,055,140530,1654,1587,8,1595,11
2020-09-16,Nevada,057,99092,522,495,15,510,6
2020-09-16,Orange,059,3164182,53235,50414,1382,51796,1096
2020-09-16,Placer,061,380077,3524,3351,14,3365,39
2020-09-16,Plumas,063,18699,49,45,0,45,0
2020-09-16,Riverside,065,2383286,57346,55811,134,55945,1127
2020-09-16,Sacramento,067,1510023,21542,20610,24,20634,377
2020-09-16,San Benito,069,59416,1297,1244,0,1244,8
2020-09-16,San Bernardino,071,2135413,52475,50509,335,50844,907
2020-09-16,San Diego,073,3302833,45314,43447,793,44240,748
2020-09-16,San Francisco,075,870044,10855,10502,27,10529,90
2020-09-16,San Joaquin,077,732212,19816,19377,45,19422,409
2020-09-16,San Luis Obispo,079,281455,3545,3285,21,3306,28
2020-09-16,San Mateo,081,765935,9771,8944,9,8953,127
2020-09-16,Santa Barbara,083,443738,8943,8764,75,8839,107
2020-09-16,Santa Clara,085,1922200,21212,19684,41,19725,253
2020-09-16,Santa Cruz,087,273765,2263,2089,24,2113,7
2020-09-16,Shasta,089,179085,776,635,3,638,11
2020-09-16,Sierra,091,2930,6,6,0,6,0
2020-09-16,Siskiyou,093,43540,153,145,10,155,0
2020-09-16,Solano,095,438530,6114,5899,41,5940,44
2020-09-16,Sonoma,097,501317,7081,6731,19,6750,104
2020-09-16,Stanislaus,099,539301,16271,15897,475,16372,263
2020-09-16,Sutter,101,95872,1634,1567,1,1568,10
2020-09-16,Tehama,103,63373,507,485,2,487,2
2020-09-16,Trinity,105,12862,53,15,7,22,0
2020-09-16,Tulare,107,460477,15900,15314,95,15409,258
2020-09-16,Tuolumne,109,53932,228,210,4,214,1
2020-09-16,Ventura,111,848112,12813,12073,140,12213,130
2020-09-16,Yolo,113,214977,2748,2709,6,2715,53
2020-09-16,Yuba,115,75493,1045,1000,5,1005,1
2020-09-15,Alameda,001,1643700,20704,19931,155,20086,327
2020-09-15,Alpine,003,1148,2,2,0,2,0
2020-09-15,Amador,005,37829,287,282,0,282,16
2020-09-15,Butte,007,227075,2834,2695,24,2719,38
2020-09-15,Calaveras,009,45235,304,248,0,248,5
2020-09-15,Colusa,011,21464,516,497,0,497,6
2020-09-15,Contra Costa,013,1133247,16297,15423,78,15501,180
2020-09-15,Del Norte,015,27424,133,129,0,129,2
2020-09-15,El Dorado,017,186661,1101,1046,0,1046,4
2020-09-15,Fresno,019,978130,29796,27312,355,27667,343
2020-09-15,Glenn,021,27897,562,531,0,531,3
2020-09-15,Humboldt,023,135768,481,456,1,457,4
2020-09-15,Imperial,025,180216,11621,10376,9,10385,277
2020-09-15,Inyo,027,18085,186,176,4,180,12
2020-09-15,Kern,029,883053,31348,30429,289,30718,368
2020-09-15,Kings,031,150075,7328,6977,37,7014,70
2020-09-15,Lake,033,64148,505,416,0,416,4
2020-09-15,Lassen,035,31185,737,719,2,721,0
2020-09-15,Los Angeles,037,10098052,258576,255048,1656,256704,6269
2020-09-15,Madera,039,155013,4382,4122,30,4152,45
2020-09-15,Marin,041,260295,6549,6423,15,6438,77
2020-09-15,Mariposa,043,17540,75,74,0,74,2
2020-09-15,Mendocino,045,87422,783,724,0,724,18
2020-09-15,Merced,047,269075,8707,8633,15,8648,114
2020-09-15,Modoc,049,8938,26,21,0,21,0
2020-09-15,Mono,051,14174,165,147,2,149,1
2020-09-15,Monterey,053,433212,9383,8943,25,8968,62
2020-09-15,Napa,055,140530,1640,1580,8,1588,11
2020-09-15,Nevada,057,99092,517,494,15,509,6
2020-09-15,Orange,059,3164182,53053,50294,1367,51661,1088
2020-09-15,Placer,061,380077,3500,3331,14,3345,38
2020-09-15,Plumas,063,18699,49,44,0,44,0
2020-09-15,Riverside,065,2383286,57052,55569,124,55693,1118
2020-09-15,Sacramento,067,1510023,21399,20487,24,20511,372
2020-09-15,San Benito,069,59416,1290,1237,0,1237,7
2020-09-15,San Bernardino,071,2135413,52259,50333,334,50667,904
2020-09-15,San Diego,073,3302833,44995,43183,773,43956,742
2020-09-15,San Francisco,075,870044,10797,10414,27,10441,90
2020-09-15,San Joaquin,077,732212,19764,19313,45,19358,401
2020-09-15,San Luis Obispo,079,281455,3525,3262,21,3283,28
2020-09-15,San Mateo,081,765935,9701,8895,9,8904,127
2020-09-15,Santa Barbara,083,443738,8918,8724,74,8798,104
2020-09-15,Santa Clara,085,1922200,21076,19610,41,19651,252
2020-09-15,Santa Cruz,087,273765,2237,2079,23,2102,7
2020-09-15,Shasta,089,179085,764,627,3,630,11
2020-09-15,Sierra,091,2930,6,6,0,6,0
2020-09-15,Siskiyou,093,43540,153,143,10,153,0
2020-09-15,Solano,095,438530,6080,5878,41,5919,45
2020-09-15,Sonoma,097,501317,7042,6701,19,6720,104
2020-09-15,Stanislaus,099,539301,16223,15880,473,16353,260
2020-09-15,Sutter,101,95872,1623,1556,1,1557,10
2020-09-15,Tehama,103,63373,495,484,2,486,2
2020-09-15,Trinity,105,12862,53,15,7,22,0
2020-09-15,Tulare,107,460477,15823,15203,93,15296,254
2020-09-15,Tuolumne,109,53932,228,209,4,213,1
2020-09-15,Ventura,111,848112,12760,11932,139,12071,128
2020-09-15,Yolo,113,214977,2744,2708,6,2714,53
2020-09-15,Yuba,115,75493,1039,991,4,995,1
2020-09-14,Alameda,001,1643700,20577,19851,154,20005,306
2020-09-14,Alpine,003,1148,2,2,0,2,0
2020-09-14,Amador,005,37829,285,281,0,281,16
2020-09-14,Butte,007,227075,2817,2642,24,2666,37
2020-09-14,Calaveras,009,45235,304,244,0,244,3
2020-09-14,Colusa,011,21464,515,486,0,486,6
2020-09-14,Contra Costa,013,1133247,16173,15354,77,15431,174
2020-09-14,Del Norte,015,27424,130,116,0,116,2
2020-09-14,El Dorado,017,186661,1097,1039,0,1039,3
2020-09-14,Fresno,019,978130,29711,27232,352,27584,344
2020-09-14,Glenn,021,27897,554,521,0,521,3
2020-09-14,Humboldt,023,135768,478,437,1,438,4
2020-09-14,Imperial,025,180216,11601,10340,9,10349,273
2020-09-14,Inyo,027,18085,186,176,4,180,12
2020-09-14,Kern,029,883053,31260,30344,288,30632,368
2020-09-14,Kings,031,150075,7246,6950,37,6987,70
2020-09-14,Lake,033,64148,485,407,0,407,4
2020-09-14,Lassen,035,31185,737,719,2,721,0
2020-09-14,Los Angeles,037,10098052,257549,254622,1631,256253,6226
2020-09-14,Madera,039,155013,4368,4104,30,4134,45
2020-09-14,Marin,041,260295,6528,6409,15,6424,70
2020-09-14,Mariposa,043,17540,75,74,0,74,2
2020-09-14,Mendocino,045,87422,766,710,0,710,17
2020-09-14,Merced,047,269075,8688,8593,15,8608,112
2020-09-14,Modoc,049,8938,26,21,0,21,0
2020-09-14,Mono,051,14174,165,147,2,149,1
2020-09-14,Monterey,053,433212,9312,8845,24,8869,61
2020-09-14,Napa,055,140530,1623,1576,8,1584,11
2020-09-14,Nevada,057,99092,512,489,15,504,6
2020-09-14,Orange,059,3164182,52892,50149,1351,51500,1079
2020-09-14,Placer,061,380077,3479,3302,14,3316,38
2020-09-14,Plumas,063,18699,48,42,0,42,0
2020-09-14,Riverside,065,2383286,56833,55488,119,55607,1113
2020-09-14,Sacramento,067,1510023,21204,20377,23,20400,367
2020-09-14,San Benito,069,59416,1275,1233,0,1233,7
2020-09-14,San Bernardino,071,2135413,52034,50163,333,50496,895
2020-09-14,San Diego,073,3302833,44684,42889,753,43642,734
2020-09-14,San Francisco,075,870044,10730,10255,25,10280,90
2020-09-14,San Joaquin,077,732212,19690,19111,44,19155,397
2020-09-14,San Luis Obispo,079,281455,3500,3248,21,3269,25
2020-09-14,San Mateo,081,765935,9639,8847,9,8856,127
2020-09-14,Santa Barbara,083,443738,8892,8692,74,8766,104
2020-09-14,Santa Clara,085,1922200,20887,19545,41,19586,247
2020-09-14,Santa Cruz,087,273765,2216,2016,22,2038,7
2020-09-14,Shasta,089,179085,741,584,3,587,10
2020-09-14,Sierra,091,2930,6,6,0,6,0
2020-09-14,Siskiyou,093,43540,152,143,10,153,0
2020-09-14,Solano,095,438530,6045,5834,41,5875,44
2020-09-14,Sonoma,097,501317,6979,6630,19,6649,102
2020-09-14,Stanislaus,099,539301,16178,15812,470,16282,253
2020-09-14,Sutter,101,95872,1612,1549,1,1550,10
2020-09-14,Tehama,103,63373,493,475,2,477,1
2020-09-14,Trinity,105,12862,52,14,7,21,0
2020-09-14,Tulare,107,460477,15753,15096,87,15183,254
2020-09-14,Tuolumne,109,53932,227,208,4,212,1
2020-09-14,Ventura,111,848112,12658,11903,136,12039,125
2020-09-14,Yolo,113,214977,2733,2687,6,2693,53
2020-09-14,Yuba,115,75493,1031,977,4,981,1
2020-09-13,Alameda,001,1643700,20471,19815,151,19966,306
2020-09-13,Alpine,003,1148,2,2,0,2,0
2020-09-13,Amador,005,37829,282,279,0,279,16
2020-09-13,Butte,007,227075,2795,2640,24,2664,37
2020-09-13,Calaveras,009,45235,303,246,0,246,3
2020-09-13,Colusa,011,21464,511,486,0,486,6
2020-09-13,Contra Costa,013,1133247,16065,15284,77,15361,172
2020-09-13,Del Norte,015,27424,127,116,0,116,1
2020-09-13,El Dorado,017,186661,1092,1035,0,1035,2
2020-09-13,Fresno,019,978130,29603,27196,343,27539,345
2020-09-13,Glenn,021,27897,550,517,0,517,3
2020-09-13,Humboldt,023,135768,478,434,1,435,4
2020-09-13,Imperial,025,180216,11564,10304,8,10312,273
2020-09-13,Inyo,027,18085,186,176,4,180,12
2020-09-13,Kern,029,883053,31167,30277,281,30558,368
2020-09-13,Kings,031,150075,7227,6937,37,6974,70
2020-09-13,Lake,033,64148,466,397,0,397,4
2020-09-13,Lassen,035,31185,734,719,2,721,0
2020-09-13,Los Angeles,037,10098052,256400,253950,1615,255565,6203
2020-09-13,Madera,039,155013,4311,4090,30,4120,45
2020-09-13,Marin,041,260295,6507,6395,15,6410,70
2020-09-13,Mariposa,043,17540,75,74,0,74,2
2020-09-13,Mendocino,045,87422,759,707,0,707,17
2020-09-13,Merced,047,269075,8654,8575,14,8589,112
2020-09-13,Modoc,049,8938,26,21,0,21,0
2020-09-13,Mono,051,14174,165,147,2,149,1
2020-09-13,Monterey,053,433212,9230,8826,23,8849,61
2020-09-13,Napa,055,140530,1616,1563,8,1571,11
2020-09-13,Nevada,057,99092,504,486,15,501,6
2020-09-13,Orange,059,3164182,52676,50061,1344,51405,1075
2020-09-13,Placer,061,380077,3449,3291,14,3305,38
2020-09-13,Plumas,063,18699,48,42,0,42,0
2020-09-13,Riverside,065,2383286,56626,55235,108,55343,1108
2020-09-13,Sacramento,067,1510023,20858,20279,23,20302,367
2020-09-13,San Benito,069,59416,1267,1217,0,1217,7
2020-09-13,San Bernardino,071,2135413,51748,49968,331,50299,895
2020-09-13,San Diego,073,3302833,44358,42681,719,43400,734
2020-09-13,San Francisco,075,870044,10652,10254,25,10279,90
2020-09-13,San Joaquin,077,732212,19618,19110,43,19153,396
2020-09-13,San Luis Obispo,079,281455,3463,3240,21,3261,24
2020-09-13,San Mateo,081,765935,9578,8811,9,8820,127
2020-09-13,Santa Barbara,083,443738,8855,8690,74,8764,104
2020-09-13,Santa Clara,085,1922200,20751,19456,40,19496,245
2020-09-13,Santa Cruz,087,273765,2183,2016,20,2036,7
2020-09-13,Shasta,089,179085,729,583,3,586,10
2020-09-13,Sierra,091,2930,6,6,0,6,0
2020-09-13,Siskiyou,093,43540,152,143,9,152,0
2020-09-13,Solano,095,438530,5999,5810,41,5851,43
2020-09-13,Sonoma,097,501317,6914,6592,19,6611,95
2020-09-13,Stanislaus,099,539301,16115,15759,458,16217,253
2020-09-13,Sutter,101,95872,1600,1539,1,1540,10
2020-09-13,Tehama,103,63373,489,476,2,478,1
2020-09-13,Trinity,105,12862,52,14,7,21,0
2020-09-13,Tulare,107,460477,15682,15098,86,15184,254
2020-09-13,Tuolumne,109,53932,224,208,4,212,1
2020-09-13,Ventura,111,848112,12550,11855,135,11990,123
2020-09-13,Yolo,113,214977,2721,2675,6,2681,53
2020-09-13,Yuba,115,75493,1026,967,4,971,1
2020-09-12,Alameda,001,1643700,20412,19758,151,19909,307
2020-09-12,Alpine,003,1148,2,2,0,2,0
2020-09-12,Amador,005,37829,281,278,0,278,16
2020-09-12,Butte,007,227075,2788,2629,23,2652,37
2020-09-12,Calaveras,009,45235,301,246,0,246,3
2020-09-12,Colusa,011,21464,507,486,0,486,6
2020-09-12,Contra Costa,013,1133247,15989,15135,76,15211,174
2020-09-12,Del Norte,015,27424,126,116,0,116,1
2020-09-12,El Dorado,017,186661,1085,1034,0,1034,2
2020-09-12,Fresno,019,978130,29532,27076,343,27419,345
2020-09-12,Glenn,021,27897,549,517,0,517,3
2020-09-12,Humboldt,023,135768,477,430,1,431,4
2020-09-12,Imperial,025,180216,11552,10305,8,10313,273
2020-09-12,Inyo,027,18085,186,177,4,181,12
2020-09-12,Kern,029,883053,31101,30202,281,30483,368
2020-09-12,Kings,031,150075,7217,6895,37,6932,70
2020-09-12,Lake,033,64148,460,393,0,393,4
2020-09-12,Lassen,035,31185,734,719,2,721,0
2020-09-12,Los Angeles,037,10098052,255841,253156,1594,254750,6193
2020-09-12,Madera,039,155013,4300,4058,30,4088,43
2020-09-12,Marin,041,260295,6498,6393,15,6408,69
2020-09-12,Mariposa,043,17540,75,72,0,72,2
2020-09-12,Mendocino,045,87422,756,700,0,700,17
2020-09-12,Merced,047,269075,8645,8533,14,8547,112
2020-09-12,Modoc,049,8938,25,21,0,21,0
2020-09-12,Mono,051,14174,165,147,2,149,1
2020-09-12,Monterey,053,433212,9194,8743,23,8766,61
2020-09-12,Napa,055,140530,1613,1556,8,1564,11
2020-09-12,Nevada,057,99092,503,482,15,497,6
2020-09-12,Orange,059,3164182,52561,49895,1341,51236,1078
2020-09-12,Placer,061,380077,3432,3280,14,3294,38
2020-09-12,Plumas,063,18699,48,42,0,42,0
2020-09-12,Riverside,065,2383286,56497,55058,104,55162,1108
2020-09-12,Sacramento,067,1510023,20789,20184,23,20207,367
2020-09-12,San Benito,069,59416,1264,1208,0,1208,7
2020-09-12,San Bernardino,071,2135413,51657,49945,329,50274,896
2020-09-12,San Diego,073,3302833,44163,42416,710,43126,747
2020-09-12,San Francisco,075,870044,10607,10257,25,10282,90
2020-09-12,San Joaquin,077,732212,19590,19108,43,19151,396
2020-09-12,San Luis Obispo,079,281455,3436,3220,21,3241,24
2020-09-12,San Mateo,081,765935,9533,8759,9,8768,127
2020-09-12,Santa Barbara,083,443738,8841,8642,74,8716,104
2020-09-12,Santa Clara,085,1922200,20667,19330,40,19370,237
2020-09-12,Santa Cruz,087,273765,2171,2016,20,2036,7
2020-09-12,Shasta,089,179085,717,569,3,572,10
2020-09-12,Sierra,091,2930,6,6,0,6,0
2020-09-12,Siskiyou,093,43540,152,141,9,150,0
2020-09-12,Solano,095,438530,5975,5772,41,5813,43
2020-09-12,Sonoma,097,501317,6890,6531,19,6550,95
2020-09-12,Stanislaus,099,539301,16083,15675,455,16130,253
2020-09-12,Sutter,101,95872,1594,1529,1,1530,10
2020-09-12,Tehama,103,63373,486,471,2,473,1
2020-09-12,Trinity,105,12862,52,15,7,22,0
2020-09-12,Tulare,107,460477,15636,15018,85,15103,254
2020-09-12,Tuolumne,109,53932,224,208,4,212,1
2020-09-12,Ventura,111,848112,12499,11759,133,11892,123
2020-09-12,Yolo,113,214977,2714,2646,6,2652,53
2020-09-12,Yuba,115,75493,1022,963,4,967,1
2020-09-11,Alameda,001,1643700,20357,19625,150,19775,298
2020-09-11,Alpine,003,1148,2,2,0,2,0
2020-09-11,Amador,005,37829,281,277,0,277,16
2020-09-11,Butte,007,227075,2777,2605,23,2628,37
2020-09-11,Calaveras,009,45235,300,242,0,242,1
2020-09-11,Colusa,011,21464,506,484,0,484,6
2020-09-11,Contra Costa,013,1133247,15937,15001,73,15074,173
2020-09-11,Del Norte,015,27424,126,115,0,115,1
2020-09-11,El Dorado,017,186661,1082,1024,0,1024,2
2020-09-11,Fresno,019,978130,29452,26917,342,27259,344
2020-09-11,Glenn,021,27897,544,515,0,515,3
2020-09-11,Humboldt,023,135768,475,426,1,427,4
2020-09-11,Imperial,025,180216,11534,10286,8,10294,273
2020-09-11,Inyo,027,18085,186,176,4,180,12
2020-09-11,Kern,029,883053,31033,30059,280,30339,365
2020-09-11,Kings,031,150075,7200,6770,37,6807,70
2020-09-11,Lake,033,64148,453,382,0,382,4
2020-09-11,Lassen,035,31185,734,719,2,721,0
2020-09-11,Los Angeles,037,10098052,255160,252057,1583,253640,6172
2020-09-11,Madera,039,155013,4281,4018,30,4048,43
2020-09-11,Marin,041,260295,6495,6364,15,6379,69
2020-09-11,Mariposa,043,17540,75,72,0,72,2
2020-09-11,Mendocino,045,87422,745,700,0,700,17
2020-09-11,Merced,047,269075,8624,8489,14,8503,109
2020-09-11,Modoc,049,8938,25,21,0,21,0
2020-09-11,Mono,051,14174,165,145,2,147,1
2020-09-11,Monterey,053,433212,9146,8595,23,8618,61
2020-09-11,Napa,055,140530,1602,1543,8,1551,11
2020-09-11,Nevada,057,99092,496,483,15,498,6
2020-09-11,Orange,059,3164182,52432,49755,1329,51084,1068
2020-09-11,Placer,061,380077,3417,3254,14,3268,37
2020-09-11,Plumas,063,18699,48,42,0,42,0
2020-09-11,Riverside,065,2383286,56362,54717,101,54818,1099
2020-09-11,Sacramento,067,1510023,20704,20012,23,20035,358
2020-09-11,San Benito,069,59416,1254,1202,0,1202,7
2020-09-11,San Bernardino,071,2135413,51558,49682,329,50011,871
2020-09-11,San Diego,073,3302833,43943,41971,704,42675,730
2020-09-11,San Francisco,075,870044,10559,10133,24,10157,89
2020-09-11,San Joaquin,077,732212,19542,19019,43,19062,391
2020-09-11,San Luis Obispo,079,281455,3418,3190,21,3211,24
2020-09-11,San Mateo,081,765935,9491,8611,9,8620,127
2020-09-11,Santa Barbara,083,443738,8808,8592,73,8665,103
2020-09-11,Santa Clara,085,1922200,20578,19065,40,19105,234
2020-09-11,Santa Cruz,087,273765,2154,1997,20,2017,7
2020-09-11,Shasta,089,179085,707,568,3,571,10
2020-09-11,Sierra,091,2930,6,6,0,6,0
2020-09-11,Siskiyou,093,43540,151,139,9,148,0
2020-09-11,Solano,095,438530,5958,5742,41,5783,42
2020-09-11,Sonoma,097,501317,6845,6469,19,6488,91
2020-09-11,Stanislaus,099,539301,16045,15613,452,16065,253
2020-09-11,Sutter,101,95872,1584,1505,1,1506,11
2020-09-11,Tehama,103,63373,483,466,2,468,1
2020-09-11,Trinity,105,12862,52,16,7,23,0
2020-09-11,Tulare,107,460477,15605,14932,83,15015,251
2020-09-11,Tuolumne,109,53932,224,208,4,212,1
2020-09-11,Ventura,111,848112,12445,11700,131,11831,123
2020-09-11,Yolo,113,214977,2703,2632,6,2638,53
2020-09-11,Yuba,115,75493,1014,946,4,950,1
2020-09-10,Alameda,001,1643700,20283,19509,150,19659,292
2020-09-10,Alpine,003,1148,2,2,0,2,0
2020-09-10,Amador,005,37829,280,277,0,277,16
2020-09-10,Butte,007,227075,2760,2590,23,2613,37
2020-09-10,Calaveras,009,45235,300,244,0,244,1
2020-09-10,Colusa,011,21464,504,482,0,482,6
2020-09-10,Contra Costa,013,1133247,15867,14909,73,14982,172
2020-09-10,Del Norte,015,27424,125,112,0,112,1
2020-09-10,El Dorado,017,186661,1079,1020,0,1020,2
2020-09-10,Fresno,019,978130,29330,26783,342,27125,338
2020-09-10,Glenn,021,27897,534,511,0,511,3
2020-09-10,Humboldt,023,135768,464,422,1,423,4
2020-09-10,Imperial,025,180216,11518,10251,8,10259,270
2020-09-10,Inyo,027,18085,185,176,4,180,11
2020-09-10,Kern,029,883053,30951,29988,276,30264,363
2020-09-10,Kings,031,150075,7170,6739,37,6776,70
2020-09-10,Lake,033,64148,446,377,0,377,4
2020-09-10,Lassen,035,31185,733,716,2,718,0
2020-09-10,Los Angeles,037,10098052,254181,251003,1562,252565,6132
2020-09-10,Madera,039,155013,4263,3979,30,4009,43
2020-09-10,Marin,041,260295,6483,6344,15,6359,68
2020-09-10,Mariposa,043,17540,75,72,0,72,2
2020-09-10,Mendocino,045,87422,735,697,0,697,16
2020-09-10,Merced,047,269075,8578,8461,14,8475,109
2020-09-10,Modoc,049,8938,25,21,0,21,0
2020-09-10,Mono,051,14174,165,145,2,147,1
2020-09-10,Monterey,053,433212,9076,8570,23,8593,59
2020-09-10,Napa,055,140530,1596,1536,8,1544,11
2020-09-10,Nevada,057,99092,492,478,15,493,6
2020-09-10,Orange,059,3164182,52269,49617,1323,50940,1057
2020-09-10,Placer,061,380077,3398,3233,14,3247,37
2020-09-10,Plumas,063,18699,48,42,0,42,0
2020-09-10,Riverside,065,2383286,56043,54417,98,54515,1091
2020-09-10,Sacramento,067,1510023,20582,19618,22,19640,354
2020-09-10,San Benito,069,59416,1248,1201,0,1201,5
2020-09-10,San Bernardino,071,2135413,51369,49467,327,49794,867
2020-09-10,San Diego,073,3302833,43677,41610,677,42287,725
2020-09-10,San Francisco,075,870044,10482,10082,24,10106,89
2020-09-10,San Joaquin,077,732212,19489,18854,43,18897,389
2020-09-10,San Luis Obispo,079,281455,3404,3161,20,3181,24
2020-09-10,San Mateo,081,765935,9445,8529,9,8538,125
2020-09-10,Santa Barbara,083,443738,8763,8552,73,8625,100
2020-09-10,Santa Clara,085,1922200,20464,18870,40,18910,231
2020-09-10,Santa Cruz,087,273765,2139,1986,18,2004,7
2020-09-10,Shasta,089,179085,696,566,3,569,10
2020-09-10,Sierra,091,2930,6,6,0,6,0
2020-09-10,Siskiyou,093,43540,151,137,9,146,0
2020-09-10,Solano,095,438530,5918,5696,41,5737,42
2020-09-10,Sonoma,097,501317,6796,6424,19,6443,91
2020-09-10,Stanislaus,099,539301,15991,15509,447,15956,243
2020-09-10,Sutter,101,95872,1572,1494,1,1495,11
2020-09-10,Tehama,103,63373,476,466,2,468,1
2020-09-10,Trinity,105,12862,52,15,7,22,0
2020-09-10,Tulare,107,460477,15550,14860,80,14940,250
2020-09-10,Tuolumne,109,53932,223,205,4,209,1
2020-09-10,Ventura,111,848112,12351,11600,124,11724,122
2020-09-10,Yolo,113,214977,2698,2612,6,2618,53
2020-09-10,Yuba,115,75493,1008,941,4,945,1
2020-09-09,Alameda,001,1643700,20204,19399,149,19548,289
2020-09-09,Alpine,003,1148,2,2,0,2,0
2020-09-09,Amador,005,37829,279,276,0,276,16
2020-09-09,Butte,007,227075,2743,2561,23,2584,37
2020-09-09,Calaveras,009,45235,300,242,0,242,1
2020-09-09,Colusa,011,21464,499,479,0,479,6
2020-09-09,Contra Costa,013,1133247,15781,14816,73,14889,171
2020-09-09,Del Norte,015,27424,121,109,0,109,1
2020-09-09,El Dorado,017,186661,1076,1020,0,1020,2
2020-09-09,Fresno,019,978130,29227,26724,337,27061,329
2020-09-09,Glenn,021,27897,531,508,0,508,3
2020-09-09,Humboldt,023,135768,462,420,1,421,4
2020-09-09,Imperial,025,180216,11497,10233,8,10241,268
2020-09-09,Inyo,027,18085,184,173,4,177,2
2020-09-09,Kern,029,883053,30853,29925,273,30198,355
2020-09-09,Kings,031,150075,7152,6721,37,6758,72
2020-09-09,Lake,033,64148,438,371,0,371,4
2020-09-09,Lassen,035,31185,732,714,2,716,0
2020-09-09,Los Angeles,037,10098052,253307,249876,1544,251420,6091
2020-09-09,Madera,039,155013,4237,3926,30,3956,43
2020-09-09,Marin,041,260295,6464,6321,15,6336,68
2020-09-09,Mariposa,043,17540,74,72,0,72,2
2020-09-09,Mendocino,045,87422,727,695,0,695,16
2020-09-09,Merced,047,269075,8554,8441,14,8455,107
2020-09-09,Modoc,049,8938,24,20,0,20,0
2020-09-09,Mono,051,14174,165,145,2,147,1
2020-09-09,Monterey,053,433212,9004,8527,23,8550,59
2020-09-09,Napa,055,140530,1586,1531,8,1539,11
2020-09-09,Nevada,057,99092,488,476,15,491,6
2020-09-09,Orange,059,3164182,52089,49394,1315,50709,1054
2020-09-09,Placer,061,380077,3378,3222,14,3236,36
2020-09-09,Plumas,063,18699,46,42,0,42,0
2020-09-09,Riverside,065,2383286,55813,54320,95,54415,1081
2020-09-09,Sacramento,067,1510023,20476,19474,21,19495,347
2020-09-09,San Benito,069,59416,1244,1199,0,1199,5
2020-09-09,San Bernardino,071,2135413,51171,49264,326,49590,866
2020-09-09,San Diego,073,3302833,43388,41326,665,41991,721
2020-09-09,San Francisco,075,870044,10432,9996,23,10019,86
2020-09-09,San Joaquin,077,732212,19425,18799,42,18841,388
2020-09-09,San Luis Obispo,079,281455,3386,3131,20,3151,24
2020-09-09,San Mateo,081,765935,9384,8478,9,8487,125
2020-09-09,Santa Barbara,083,443738,8720,8528,73,8601,97
2020-09-09,Santa Clara,085,1922200,20332,18759,40,18799,228
2020-09-09,Santa Cruz,087,273765,2116,1967,18,1985,7
2020-09-09,Shasta,089,179085,684,562,3,565,10
2020-09-09,Sierra,091,2930,6,6,0,6,0
2020-09-09,Siskiyou,093,43540,149,137,9,146,0
2020-09-09,Solano,095,438530,5886,5680,41,5721,36
2020-09-09,Sonoma,097,501317,6729,6397,19,6416,92
2020-09-09,Stanislaus,099,539301,15952,15469,436,15905,243
2020-09-09,Sutter,101,95872,1564,1487,1,1488,11
2020-09-09,Tehama,103,63373,473,462,2,464,1
2020-09-09,Trinity,105,12862,52,14,7,21,0
2020-09-09,Tulare,107,460477,15501,14787,75,14862,249
2020-09-09,Tuolumne,109,53932,222,204,3,207,1
2020-09-09,Ventura,111,848112,12260,11497,121,11618,121
2020-09-09,Yolo,113,214977,2687,2604,6,2610,53
2020-09-09,Yuba,115,75493,1003,936,4,940,1
2020-09-08,Alameda,001,1643700,20096,19293,149,19442,288
2020-09-08,Alpine,003,1148,2,2,0,2,0
2020-09-08,Amador,005,37829,279,276,0,276,16
2020-09-08,Butte,007,227075,2725,2453,23,2476,36
2020-09-08,Calaveras,009,45235,298,233,0,233,1
2020-09-08,Colusa,011,21464,497,475,0,475,6
2020-09-08,Contra Costa,013,1133247,15653,14740,70,14810,171
2020-09-08,Del Norte,015,27424,121,109,0,109,2
2020-09-08,El Dorado,017,186661,1073,1011,0,1011,2
2020-09-08,Fresno,019,978130,29107,26640,333,26973,329
2020-09-08,Glenn,021,27897,527,492,0,492,3
2020-09-08,Humboldt,023,135768,460,420,1,421,4
2020-09-08,Imperial,025,180216,11481,10198,8,10206,267
2020-09-08,Inyo,027,18085,184,169,4,173,2
2020-09-08,Kern,029,883053,30767,29850,271,30121,351
2020-09-08,Kings,031,150075,7114,6658,37,6695,72
2020-09-08,Lake,033,64148,428,370,0,370,4
2020-09-08,Lassen,035,31185,732,710,2,712,0
2020-09-08,Los Angeles,037,10098052,252379,249217,1516,250733,6034
2020-09-08,Madera,039,155013,4213,3904,30,3934,43
2020-09-08,Marin,041,260295,6433,6313,15,6328,68
2020-09-08,Mariposa,043,17540,74,72,0,72,2
2020-09-08,Mendocino,045,87422,720,690,0,690,16
2020-09-08,Merced,047,269075,8531,8381,14,8395,104
2020-09-08,Modoc,049,8938,24,20,0,20,0
2020-09-08,Mono,051,14174,165,145,2,147,1
2020-09-08,Monterey,053,433212,8919,8491,23,8514,59
2020-09-08,Napa,055,140530,1582,1518,8,1526,11
2020-09-08,Nevada,057,99092,488,470,15,485,6
2020-09-08,Orange,059,3164182,51948,49214,1311,50525,1044
2020-09-08,Placer,061,380077,3364,3205,14,3219,36
2020-09-08,Plumas,063,18699,46,42,0,42,0
2020-09-08,Riverside,065,2383286,55599,54168,92,54260,1069
2020-09-08,Sacramento,067,1510023,20241,19411,20,19431,347
2020-09-08,San Benito,069,59416,1237,1188,0,1188,5
2020-09-08,San Bernardino,071,2135413,50981,49034,325,49359,856
2020-09-08,San Diego,073,3302833,43072,41079,653,41732,709
2020-09-08,San Francisco,075,870044,10359,9821,23,9844,86
2020-09-08,San Joaquin,077,732212,19347,18550,42,18592,388
2020-09-08,San Luis Obispo,079,281455,3371,3120,20,3140,23
2020-09-08,San Mateo,081,765935,9308,8460,9,8469,125
2020-09-08,Santa Barbara,083,443738,8686,8488,72,8560,96
2020-09-08,Santa Clara,085,1922200,20156,18645,40,18685,228
2020-09-08,Santa Cruz,087,273765,2088,1903,18,1921,7
2020-09-08,Shasta,089,179085,676,556,3,559,10
2020-09-08,Sierra,091,2930,6,6,0,6,0
2020-09-08,Siskiyou,093,43540,147,136,9,145,0
2020-09-08,Solano,095,438530,5849,5654,41,5695,36
2020-09-08,Sonoma,097,501317,6660,6356,19,6375,92
2020-09-08,Stanislaus,099,539301,15888,15415,424,15839,238
2020-09-08,Sutter,101,95872,1548,1473,1,1474,11
2020-09-08,Tehama,103,63373,469,458,2,460,1
2020-09-08,Trinity,105,12862,51,13,7,20,0
2020-09-08,Tulare,107,460477,15421,14635,74,14709,249
2020-09-08,Tuolumne,109,53932,221,197,3,200,1
2020-09-08,Ventura,111,848112,12191,11475,118,11593,118
2020-09-08,Yolo,113,214977,2677,2580,6,2586,53
2020-09-08,Yuba,115,75493,991,923,4,927,1
2020-09-07,Alameda,001,1643700,19974,19188,143,19331,281
2020-09-07,Alpine,003,1148,2,2,0,2,0
2020-09-07,Amador,005,37829,279,276,0,276,16
2020-09-07,Butte,007,227075,2692,2450,22,2472,30
2020-09-07,Calaveras,009,45235,288,234,0,234,1
2020-09-07,Colusa,011,21464,496,475,0,475,6
2020-09-07,Contra Costa,013,1133247,15540,14637,67,14704,172
2020-09-07,Del Norte,015,27424,121,109,0,109,2
2020-09-07,El Dorado,017,186661,1062,1011,0,1011,2
2020-09-07,Fresno,019,978130,29013,26565,330,26895,329
2020-09-07,Glenn,021,27897,522,488,0,488,3
2020-09-07,Humboldt,023,135768,451,416,1,417,4
2020-09-07,Imperial,025,180216,11450,10199,8,10207,267
2020-09-07,Inyo,027,18085,184,169,4,173,2
2020-09-07,Kern,029,883053,30646,29790,266,30056,348
2020-09-07,Kings,031,150075,6989,6630,37,6667,72
2020-09-07,Lake,033,64148,405,367,0,367,2
2020-09-07,Lassen,035,31185,732,709,2,711,0
2020-09-07,Los Angeles,037,10098052,251333,248804,1494,250298,6030
2020-09-07,Madera,039,155013,4182,3889,29,3918,43
2020-09-07,Marin,041,260295,6403,6296,15,6311,67
2020-09-07,Mariposa,043,17540,74,72,0,72,2
2020-09-07,Mendocino,045,87422,712,687,0,687,16
2020-09-07,Merced,047,269075,8484,8381,14,8395,104
2020-09-07,Modoc,049,8938,23,20,0,20,0
2020-09-07,Mono,051,14174,165,145,2,147,1
2020-09-07,Monterey,053,433212,8840,8463,23,8486,57
2020-09-07,Napa,055,140530,1570,1514,8,1522,11
2020-09-07,Nevada,057,99092,486,469,15,484,6
2020-09-07,Orange,059,3164182,51775,49132,1307,50439,1042
2020-09-07,Placer,061,380077,3333,3188,13,3201,36
2020-09-07,Plumas,063,18699,45,42,0,42,0
2020-09-07,Riverside,065,2383286,55324,54178,86,54264,1069
2020-09-07,Sacramento,067,1510023,19998,19292,19,19311,345
2020-09-07,San Benito,069,59416,1231,1180,0,1180,4
2020-09-07,San Bernardino,071,2135413,50753,49043,323,49366,821
2020-09-07,San Diego,073,3302833,42672,40868,626,41494,708
2020-09-07,San Francisco,075,870044,10308,9813,22,9835,85
2020-09-07,San Joaquin,077,732212,19266,18552,40,18592,386
2020-09-07,San Luis Obispo,079,281455,3334,3116,20,3136,23
2020-09-07,San Mateo,081,765935,9226,8409,9,8418,125
2020-09-07,Santa Barbara,083,443738,8642,8479,72,8551,95
2020-09-07,Santa Clara,085,1922200,19998,18596,39,18635,226
2020-09-07,Santa Cruz,087,273765,2060,1902,18,1920,7
2020-09-07,Shasta,089,179085,666,556,3,559,10
2020-09-07,Sierra,091,2930,6,6,0,6,0
2020-09-07,Siskiyou,093,43540,146,133,9,142,0
2020-09-07,Solano,095,438530,5784,5640,41,5681,36
2020-09-07,Sonoma,097,501317,6593,6268,19,6287,85
2020-09-07,Stanislaus,099,539301,15823,15343,412,15755,236
2020-09-07,Sutter,101,95872,1531,1468,1,1469,11
2020-09-07,Tehama,103,63373,466,453,2,455,1
2020-09-07,Trinity,105,12862,51,13,7,20,0
2020-09-07,Tulare,107,460477,15315,14637,72,14709,249
2020-09-07,Tuolumne,109,53932,220,196,3,199,1
2020-09-07,Ventura,111,848112,12096,11463,115,11578,118
2020-09-07,Yolo,113,214977,2660,2565,5,2570,53
2020-09-07,Yuba,115,75493,975,923,3,926,1
2020-09-06,Alameda,001,1643700,19916,19029,141,19170,281
2020-09-06,Alpine,003,1148,2,2,0,2,0
2020-09-06,Amador,005,37829,277,275,0,275,16
2020-09-06,Butte,007,227075,2683,2446,22,2468,30
2020-09-06,Calaveras,009,45235,288,235,0,235,1
2020-09-06,Colusa,011,21464,492,475,0,475,6
2020-09-06,Contra Costa,013,1133247,15460,14565,66,14631,171
2020-09-06,Del Norte,015,27424,121,109,0,109,2
2020-09-06,El Dorado,017,186661,1060,1008,0,1008,2
2020-09-06,Fresno,019,978130,28949,26471,328,26799,329
2020-09-06,Glenn,021,27897,516,474,0,474,3
2020-09-06,Humboldt,023,135768,448,404,1,405,4
2020-09-06,Imperial,025,180216,11433,10152,8,10160,267
2020-09-06,Inyo,027,18085,184,169,4,173,2
2020-09-06,Kern,029,883053,30590,29699,262,29961,348
2020-09-06,Kings,031,150075,6969,6561,36,6597,72
2020-09-06,Lake,033,64148,402,362,0,362,2
2020-09-06,Lassen,035,31185,732,709,2,711,0
2020-09-06,Los Angeles,037,10098052,250701,248316,1480,249796,6004
2020-09-06,Madera,039,155013,4138,3867,29,3896,42
2020-09-06,Marin,041,260295,6391,6276,15,6291,67
2020-09-06,Mariposa,043,17540,74,72,0,72,2
2020-09-06,Mendocino,045,87422,711,672,0,672,16
2020-09-06,Merced,047,269075,8464,8327,14,8341,104
2020-09-06,Modoc,049,8938,23,20,0,20,0
2020-09-06,Mono,051,14174,164,145,2,147,1
2020-09-06,Monterey,053,433212,8800,8403,22,8425,56
2020-09-06,Napa,055,140530,1566,1501,6,1507,11
2020-09-06,Nevada,057,99092,486,467,14,481,6
2020-09-06,Orange,059,3164182,51662,48931,1303,50234,1042
2020-09-06,Placer,061,380077,3316,3169,13,3182,36
2020-09-06,Plumas,063,18699,44,42,0,42,0
2020-09-06,Riverside,065,2383286,55208,53970,84,54054,1069
2020-09-06,Sacramento,067,1510023,19903,19128,19,19147,340
2020-09-06,San Benito,069,59416,1229,1178,0,1178,4
2020-09-06,San Bernardino,071,2135413,50644,48923,323,49246,823
2020-09-06,San Diego,073,3302833,42424,40652,620,41272,707
2020-09-06,San Francisco,075,870044,10234,9813,22,9835,85
2020-09-06,San Joaquin,077,732212,19217,18558,40,18598,386
2020-09-06,San Luis Obispo,079,281455,3323,3101,20,3121,23
2020-09-06,San Mateo,081,765935,9173,8387,9,8396,125
2020-09-06,Santa Barbara,083,443738,8613,8434,72,8506,95
2020-09-06,Santa Clara,085,1922200,19897,18495,39,18534,207
2020-09-06,Santa Cruz,087,273765,2053,1902,18,1920,7
2020-09-06,Shasta,089,179085,660,550,3,553,10
2020-09-06,Sierra,091,2930,6,6,0,6,0
2020-09-06,Siskiyou,093,43540,146,132,9,141,0
2020-09-06,Solano,095,438530,5758,5619,41,5660,37
2020-09-06,Sonoma,097,501317,6564,6212,19,6231,85
2020-09-06,Stanislaus,099,539301,15779,15288,408,15696,236
2020-09-06,Sutter,101,95872,1518,1451,1,1452,11
2020-09-06,Tehama,103,63373,465,455,2,457,1
2020-09-06,Trinity,105,12862,50,13,7,20,0
2020-09-06,Tulare,107,460477,15272,14636,71,14707,249
2020-09-06,Tuolumne,109,53932,217,194,3,197,1
2020-09-06,Ventura,111,848112,12051,11315,115,11430,118
2020-09-06,Yolo,113,214977,2646,2556,5,2561,53
2020-09-06,Yuba,115,75493,966,913,3,916,1
2020-09-05,Alameda,001,1643700,19869,18973,139,19112,279
2020-09-05,Alpine,003,1148,2,2,0,2,0
2020-09-05,Amador,005,37829,277,274,0,274,16
2020-09-05,Butte,007,227075,2667,2406,21,2427,30
2020-09-05,Calaveras,009,45235,288,237,0,237,1
2020-09-05,Colusa,011,21464,488,472,0,472,6
2020-09-05,Contra Costa,013,1133247,15383,14456,64,14520,173
2020-09-05,Del Norte,015,27424,121,109,0,109,2
2020-09-05,El Dorado,017,186661,1060,1007,0,1007,2
2020-09-05,Fresno,019,978130,28881,26325,328,26653,331
2020-09-05,Glenn,021,27897,515,474,0,474,3
2020-09-05,Humboldt,023,135768,446,402,1,403,4
2020-09-05,Imperial,025,180216,11416,10151,8,10159,268
2020-09-05,Inyo,027,18085,184,169,4,173,2
2020-09-05,Kern,029,883053,30530,29645,258,29903,347
2020-09-05,Kings,031,150075,6960,6518,36,6554,66
2020-09-05,Lake,033,64148,399,359,0,359,2
2020-09-05,Lassen,035,31185,732,709,2,711,0
2020-09-05,Los Angeles,037,10098052,250166,247572,1468,249040,6001
2020-09-05,Madera,039,155013,4097,3851,29,3880,42
2020-09-05,Marin,041,260295,6384,6259,15,6274,66
2020-09-05,Mariposa,043,17540,74,72,0,72,2
2020-09-05,Mendocino,045,87422,710,658,0,658,16
2020-09-05,Merced,047,269075,8432,8297,12,8309,104
2020-09-05,Modoc,049,8938,23,19,0,19,0
2020-09-05,Mono,051,14174,164,145,2,147,1
2020-09-05,Monterey,053,433212,8770,8301,22,8323,56
2020-09-05,Napa,055,140530,1560,1484,6,1490,11
2020-09-05,Nevada,057,99092,483,461,14,475,6
2020-09-05,Orange,059,3164182,51560,48726,1298,50024,1039
2020-09-05,Placer,061,380077,3306,3141,13,3154,35
2020-09-05,Plumas,063,18699,44,42,0,42,0
2020-09-05,Riverside,065,2383286,55102,53780,84,53864,1066
2020-09-05,Sacramento,067,1510023,19812,18955,19,18974,339
2020-09-05,San Benito,069,59416,1227,1153,0,1153,4
2020-09-05,San Bernardino,071,2135413,50569,48800,322,49122,825
2020-09-05,San Diego,073,3302833,42231,40344,608,40952,717
2020-09-05,San Francisco,075,870044,10201,9812,21,9833,85
2020-09-05,San Joaquin,077,732212,19189,18557,40,18597,386
2020-09-05,San Luis Obispo,079,281455,3313,3083,20,3103,23
2020-09-05,San Mateo,081,765935,9128,8352,9,8361,124
2020-09-05,Santa Barbara,083,443738,8597,8404,72,8476,96
2020-09-05,Santa Clara,085,1922200,19813,18311,39,18350,207
2020-09-05,Santa Cruz,087,273765,2045,1904,18,1922,7
2020-09-05,Shasta,089,179085,659,544,3,547,10
2020-09-05,Sierra,091,2930,6,6,0,6,0
2020-09-05,Siskiyou,093,43540,145,131,9,140,0
2020-09-05,Solano,095,438530,5746,5579,41,5620,37
2020-09-05,Sonoma,097,501317,6531,6149,19,6168,85
2020-09-05,Stanislaus,099,539301,15731,15198,404,15602,236
2020-09-05,Sutter,101,95872,1511,1445,1,1446,11
2020-09-05,Tehama,103,63373,464,447,2,449,1
2020-09-05,Trinity,105,12862,50,13,7,20,0
2020-09-05,Tulare,107,460477,15215,14576,69,14645,249
2020-09-05,Tuolumne,109,53932,217,194,3,197,1
2020-09-05,Ventura,111,848112,12008,11254,115,11369,118
2020-09-05,Yolo,113,214977,2636,2534,5,2539,53
2020-09-05,Yuba,115,75493,960,902,3,905,1
2020-09-04,Alameda,001,1643700,19801,18843,137,18980,276
2020-09-04,Alpine,003,1148,2,2,0,2,0
2020-09-04,Amador,005,37829,276,274,0,274,16
2020-09-04,Butte,007,227075,2644,2325,21,2346,28
2020-09-04,Calaveras,009,45235,286,237,0,237,1
2020-09-04,Colusa,011,21464,486,467,0,467,6
2020-09-04,Contra Costa,013,1133247,15303,14355,63,14418,164
2020-09-04,Del Norte,015,27424,121,109,0,109,2
2020-09-04,El Dorado,017,186661,1056,992,0,992,2
2020-09-04,Fresno,019,978130,28776,26147,327,26474,321
2020-09-04,Glenn,021,27897,507,463,0,463,3
2020-09-04,Humboldt,023,135768,441,390,1,391,4
2020-09-04,Imperial,025,180216,11407,10136,8,10144,267
2020-09-04,Inyo,027,18085,184,169,4,173,2
2020-09-04,Kern,029,883053,30462,29526,255,29781,345
2020-09-04,Kings,031,150075,6947,6259,36,6295,66
2020-09-04,Lake,033,64148,399,347,0,347,2
2020-09-04,Lassen,035,31185,732,708,2,710,0
2020-09-04,Los Angeles,037,10098052,249600,246396,1448,247844,5977
2020-09-04,Madera,039,155013,4084,3838,29,3867,42
2020-09-04,Marin,041,260295,6372,6251,15,6266,66
2020-09-04,Mariposa,043,17540,74,72,0,72,2
2020-09-04,Mendocino,045,87422,708,646,0,646,16
2020-09-04,Merced,047,269075,8412,8214,12,8226,104
2020-09-04,Modoc,049,8938,23,15,0,15,0
2020-09-04,Mono,051,14174,164,145,2,147,1
2020-09-04,Monterey,053,433212,8725,8208,22,8230,56
2020-09-04,Napa,055,140530,1551,1475,6,1481,11
2020-09-04,Nevada,057,99092,480,455,14,469,6
2020-09-04,Orange,059,3164182,51436,48488,1291,49779,1031
2020-09-04,Placer,061,380077,3294,3101,13,3114,35
2020-09-04,Plumas,063,18699,44,42,0,42,0
2020-09-04,Riverside,065,2383286,54989,53606,79,53685,1066
2020-09-04,Sacramento,067,1510023,19724,18765,19,18784,337
2020-09-04,San Benito,069,59416,1218,1137,0,1137,4
2020-09-04,San Bernardino,071,2135413,50476,48497,320,48817,800
2020-09-04,San Diego,073,3302833,42001,39901,599,40500,701
2020-09-04,San Francisco,075,870044,10161,9694,20,9714,85
2020-09-04,San Joaquin,077,732212,19135,18438,40,18478,376
2020-09-04,San Luis Obispo,079,281455,3298,3049,19,3068,21
2020-09-04,San Mateo,081,765935,9084,8275,9,8284,122
2020-09-04,Santa Barbara,083,443738,8567,8340,72,8412,96
2020-09-04,Santa Clara,085,1922200,19705,18074,39,18113,209
2020-09-04,Santa Cruz,087,273765,2028,1896,17,1913,7
2020-09-04,Shasta,089,179085,656,536,3,539,10
2020-09-04,Sierra,091,2930,6,6,0,6,0
2020-09-04,Siskiyou,093,43540,145,129,9,138,0
2020-09-04,Solano,095,438530,5733,5552,41,5593,37
2020-09-04,Sonoma,097,501317,6466,6050,19,6069,85
2020-09-04,Stanislaus,099,539301,15697,15074,395,15469,233
2020-09-04,Sutter,101,95872,1495,1425,1,1426,11
2020-09-04,Tehama,103,63373,460,442,2,444,1
2020-09-04,Trinity,105,12862,50,13,7,20,0
2020-09-04,Tulare,107,460477,15187,14501,65,14566,247
2020-09-04,Tuolumne,109,53932,217,193,3,196,1
2020-09-04,Ventura,111,848112,11966,11171,115,11286,114
2020-09-04,Yolo,113,214977,2622,2495,5,2500,53
2020-09-04,Yuba,115,75493,955,884,3,887,1
2020-09-03,Alameda,001,1643700,19698,18687,137,18824,275
2020-09-03,Alpine,003,1148,2,2,0,2,0
2020-09-03,Amador,005,37829,276,274,0,274,16
2020-09-03,Butte,007,227075,2599,2274,21,2295,27
2020-09-03,Calaveras,009,45235,285,238,0,238,1
2020-09-03,Colusa,011,21464,484,464,0,464,6
2020-09-03,Contra Costa,013,1133247,15196,14206,60,14266,159
2020-09-03,Del Norte,015,27424,118,109,0,109,2
2020-09-03,El Dorado,017,186661,1052,983,0,983,2
2020-09-03,Fresno,019,978130,28657,25978,322,26300,313
2020-09-03,Glenn,021,27897,503,460,0,460,3
2020-09-03,Humboldt,023,135768,436,390,1,391,4
2020-09-03,Imperial,025,180216,11386,10083,8,10091,255
2020-09-03,Inyo,027,18085,182,171,4,175,3
2020-09-03,Kern,029,883053,30370,29426,241,29667,340
2020-09-03,Kings,031,150075,6867,6200,36,6236,64
2020-09-03,Lake,033,64148,390,347,0,347,2
2020-09-03,Lassen,035,31185,732,707,2,709,0
2020-09-03,Los Angeles,037,10098052,248741,245026,1427,246453,5931
2020-09-03,Madera,039,155013,4065,3780,29,3809,43
2020-09-03,Marin,041,260295,6353,6175,15,6190,66
2020-09-03,Mariposa,043,17540,74,71,0,71,2
2020-09-03,Mendocino,045,87422,699,638,0,638,16
2020-09-03,Merced,047,269075,8370,8136,12,8148,105
2020-09-03,Modoc,049,8938,23,14,0,14,0
2020-09-03,Mono,051,14174,163,144,2,146,1
2020-09-03,Monterey,053,433212,8671,8128,22,8150,56
2020-09-03,Napa,055,140530,1544,1466,6,1472,10
2020-09-03,Nevada,057,99092,477,453,14,467,6
2020-09-03,Orange,059,3164182,51249,48226,1276,49502,1009
2020-09-03,Placer,061,380077,3276,3069,13,3082,34
2020-09-03,Plumas,063,18699,44,39,0,39,0
2020-09-03,Riverside,065,2383286,54809,53341,75,53416,1052
2020-09-03,Sacramento,067,1510023,19596,18553,18,18571,328
2020-09-03,San Benito,069,59416,1207,1121,0,1121,4
2020-09-03,San Bernardino,071,2135413,50310,48165,319,48484,800
2020-09-03,San Diego,073,3302833,41687,39448,583,40031,700
2020-09-03,San Francisco,075,870044,10095,9636,18,9654,84
2020-09-03,San Joaquin,077,732212,19058,18331,40,18371,371
2020-09-03,San Luis Obispo,079,281455,3281,3023,19,3042,21
2020-09-03,San Mateo,081,765935,9010,8211,9,8220,122
2020-09-03,Santa Barbara,083,443738,8519,8277,72,8349,96
2020-09-03,Santa Clara,085,1922200,19525,17879,39,17918,208
2020-09-03,Santa Cruz,087,273765,2013,1870,17,1887,7
2020-09-03,Shasta,089,179085,651,535,3,538,10
2020-09-03,Sierra,091,2930,6,6,0,6,0
2020-09-03,Siskiyou,093,43540,145,128,9,137,0
2020-09-03,Solano,095,438530,5713,5499,40,5539,36
2020-09-03,Sonoma,097,501317,6405,5997,19,6016,62
2020-09-03,Stanislaus,099,539301,15645,14985,391,15376,217
2020-09-03,Sutter,101,95872,1485,1412,1,1413,11
2020-09-03,Tehama,103,63373,456,436,2,438,1
2020-09-03,Trinity,105,12862,48,13,7,20,0
2020-09-03,Tulare,107,460477,15121,14408,64,14472,244
2020-09-03,Tuolumne,109,53932,217,193,3,196,1
2020-09-03,Ventura,111,848112,11848,11109,112,11221,112
2020-09-03,Yolo,113,214977,2606,2475,5,2480,53
2020-09-03,Yuba,115,75493,948,867,3,870,1
2020-09-02,Alameda,001,1643700,19578,18522,134,18656,260
2020-09-02,Alpine,003,1148,2,2,0,2,0
2020-09-02,Amador,005,37829,276,245,0,245,14
2020-09-02,Butte,007,227075,2553,2241,21,2262,27
2020-09-02,Calaveras,009,45235,284,235,0,235,1
2020-09-02,Colusa,011,21464,480,460,0,460,6
2020-09-02,Contra Costa,013,1133247,15107,14097,58,14155,159
2020-09-02,Del Norte,015,27424,117,109,0,109,2
2020-09-02,El Dorado,017,186661,1048,975,0,975,2
2020-09-02,Fresno,019,978130,28509,25785,319,26104,292
2020-09-02,Glenn,021,27897,498,457,0,457,3
2020-09-02,Humboldt,023,135768,433,381,1,382,4
2020-09-02,Imperial,025,180216,11370,9832,8,9840,255
2020-09-02,Inyo,027,18085,182,171,4,175,3
2020-09-02,Kern,029,883053,30278,29288,235,29523,335
2020-09-02,Kings,031,150075,6782,6142,36,6178,64
2020-09-02,Lake,033,64148,386,342,0,342,2
2020-09-02,Lassen,035,31185,730,706,2,708,0
2020-09-02,Los Angeles,037,10098052,247810,243999,1399,245398,5887
2020-09-02,Madera,039,155013,4045,3735,29,3764,41
2020-09-02,Marin,041,260295,6338,6131,15,6146,66
2020-09-02,Mariposa,043,17540,74,71,0,71,2
2020-09-02,Mendocino,045,87422,689,636,0,636,15
2020-09-02,Merced,047,269075,8339,8097,11,8108,103
2020-09-02,Modoc,049,8938,22,11,0,11,0
2020-09-02,Mono,051,14174,163,145,2,147,1
2020-09-02,Monterey,053,433212,8607,8070,22,8092,56
2020-09-02,Napa,055,140530,1532,1454,6,1460,10
2020-09-02,Nevada,057,99092,471,452,13,465,6
2020-09-02,Orange,059,3164182,51068,47871,1266,49137,994
2020-09-02,Placer,061,380077,3251,3047,12,3059,33
2020-09-02,Plumas,063,18699,44,39,0,39,0
2020-09-02,Riverside,065,2383286,54607,52923,72,52995,1032
2020-09-02,Sacramento,067,1510023,19363,18355,17,18372,316
2020-09-02,San Benito,069,59416,1194,1107,0,1107,4
2020-09-02,San Bernardino,071,2135413,50147,47766,316,48082,794
2020-09-02,San Diego,073,3302833,41367,39123,569,39692,695
2020-09-02,San Francisco,075,870044,10026,9587,18,9605,84
2020-09-02,San Joaquin,077,732212,18977,18194,39,18233,352
2020-09-02,San Luis Obispo,079,281455,3255,3002,18,3020,21
2020-09-02,San Mateo,081,765935,8953,8148,9,8157,122
2020-09-02,Santa Barbara,083,443738,8464,8206,71,8277,94
2020-09-02,Santa Clara,085,1922200,19371,17673,39,17712,206
2020-09-02,Santa Cruz,087,273765,1990,1850,17,1867,7
2020-09-02,Shasta,089,179085,650,531,3,534,10
2020-09-02,Sierra,091,2930,6,6,0,6,0
2020-09-02,Siskiyou,093,43540,144,127,9,136,0
2020-09-02,Solano,095,438530,5685,5463,40,5503,36
2020-09-02,Sonoma,097,501317,6343,5846,19,5865,62
2020-09-02,Stanislaus,099,539301,15575,14854,384,15238,220
2020-09-02,Sutter,101,95872,1470,1401,1,1402,10
2020-09-02,Tehama,103,63373,453,429,2,431,1
2020-09-02,Trinity,105,12862,48,13,7,20,0
2020-09-02,Tulare,107,460477,15054,14298,63,14361,244
2020-09-02,Tuolumne,109,53932,217,190,3,193,1
2020-09-02,Ventura,111,848112,11761,11031,111,11142,111
2020-09-02,Yolo,113,214977,2585,2449,5,2454,54
2020-09-02,Yuba,115,75493,941,856,3,859,1
2020-09-01,Alameda,001,1643700,19439,18382,131,18513,248
2020-09-01,Alpine,003,1148,2,2,0,2,0
2020-09-01,Amador,005,37829,275,244,0,244,13
2020-09-01,Butte,007,227075,2496,2146,21,2167,26
2020-09-01,Calaveras,009,45235,276,228,0,228,1
2020-09-01,Colusa,011,21464,476,454,0,454,6
2020-09-01,Contra Costa,013,1133247,15013,13998,56,14054,158
2020-09-01,Del Norte,015,27424,116,108,0,108,2
2020-09-01,El Dorado,017,186661,1040,972,0,972,2
2020-09-01,Fresno,019,978130,28362,25542,316,25858,290
2020-09-01,Glenn,021,27897,491,449,0,449,3
2020-09-01,Humboldt,023,135768,427,378,1,379,4
2020-09-01,Imperial,025,180216,11344,9782,8,9790,250
2020-09-01,Inyo,027,18085,182,171,4,175,3
2020-09-01,Kern,029,883053,30187,29162,230,29392,332
2020-09-01,Kings,031,150075,6751,6088,36,6124,62
2020-09-01,Lake,033,64148,383,341,0,341,2
2020-09-01,Lassen,035,31185,727,706,2,708,0
2020-09-01,Los Angeles,037,10098052,246719,242633,1375,244008,5832
2020-09-01,Madera,039,155013,4016,3703,28,3731,41
2020-09-01,Marin,041,260295,6323,6102,15,6117,67
2020-09-01,Mariposa,043,17540,73,72,0,72,2
2020-09-01,Mendocino,045,87422,674,626,0,626,15
2020-09-01,Merced,047,269075,8286,8046,10,8056,103
2020-09-01,Modoc,049,8938,20,10,0,10,0
2020-09-01,Mono,051,14174,163,145,2,147,1
2020-09-01,Monterey,053,433212,8500,7926,22,7948,56
2020-09-01,Napa,055,140530,1517,1446,6,1452,10
2020-09-01,Nevada,057,99092,465,450,13,463,6
2020-09-01,Orange,059,3164182,50904,47671,1247,48918,976
2020-09-01,Placer,061,380077,3229,3013,12,3025,33
2020-09-01,Plumas,063,18699,44,39,0,39,0
2020-09-01,Riverside,065,2383286,54389,52785,71,52856,1027
2020-09-01,Sacramento,067,1510023,19179,18217,16,18233,305
2020-09-01,San Benito,069,59416,1182,1089,0,1089,4
2020-09-01,San Bernardino,071,2135413,49940,47371,315,47686,786
2020-09-01,San Diego,073,3302833,41009,38873,531,39404,688
2020-09-01,San Francisco,075,870044,9957,9492,18,9510,83
2020-09-01,San Joaquin,077,732212,18895,17915,38,17953,341
2020-09-01,San Luis Obispo,079,281455,3229,2970,18,2988,21
2020-09-01,San Mateo,081,765935,8873,8132,9,8141,122
2020-09-01,Santa Barbara,083,443738,8414,8142,70,8212,93
2020-09-01,Santa Clara,085,1922200,19192,17319,39,17358,204
2020-09-01,Santa Cruz,087,273765,1966,1752,17,1769,7
2020-09-01,Shasta,089,179085,642,527,3,530,9
2020-09-01,Sierra,091,2930,6,6,0,6,0
2020-09-01,Siskiyou,093,43540,141,128,8,136,0
2020-09-01,Solano,095,438530,5659,5438,40,5478,34
2020-09-01,Sonoma,097,501317,6253,5733,19,5752,60
2020-09-01,Stanislaus,099,539301,15499,14784,374,15158,212
2020-09-01,Sutter,101,95872,1459,1389,1,1390,10
2020-09-01,Tehama,103,63373,449,422,2,424,1
2020-09-01,Trinity,105,12862,47,13,6,19,0
2020-09-01,Tulare,107,460477,14971,14156,63,14219,241
2020-09-01,Tuolumne,109,53932,211,183,3,186,1
2020-09-01,Ventura,111,848112,11683,10899,106,11005,108
2020-09-01,Yolo,113,214977,2569,2440,5,2445,51
2020-09-01,Yuba,115,75493,932,841,3,844,1
2020-08-31,Alameda,001,1643700,19294,18148,131,18279,248
2020-08-31,Alpine,003,1148,2,2,0,2,0
2020-08-31,Amador,005,37829,275,243,0,243,13
2020-08-31,Butte,007,227075,2432,2069,21,2090,26
2020-08-31,Calaveras,009,45235,271,212,0,212,1
2020-08-31,Colusa,011,21464,475,443,0,443,6
2020-08-31,Contra Costa,013,1133247,14886,13902,53,13955,153
2020-08-31,Del Norte,015,27424,116,108,0,108,2
2020-08-31,El Dorado,017,186661,1033,965,0,965,2
2020-08-31,Fresno,019,978130,28141,25185,310,25495,290
2020-08-31,Glenn,021,27897,479,437,0,437,3
2020-08-31,Humboldt,023,135768,425,374,1,375,4
2020-08-31,Imperial,025,180216,11313,9759,8,9767,250
2020-08-31,Inyo,027,18085,181,160,4,164,3
2020-08-31,Kern,029,883053,30089,29067,229,29296,318
2020-08-31,Kings,031,150075,6483,6037,36,6073,62
2020-08-31,Lake,033,64148,367,341,0,341,2
2020-08-31,Lassen,035,31185,724,706,2,708,0
2020-08-31,Los Angeles,037,10098052,245618,241793,1347,243140,5787
2020-08-31,Madera,039,155013,3993,3662,27,3689,35
2020-08-31,Marin,041,260295,6287,6074,15,6089,67
2020-08-31,Mariposa,043,17540,73,69,0,69,2
2020-08-31,Mendocino,045,87422,662,618,0,618,15
2020-08-31,Merced,047,269075,8224,7991,10,8001,79
2020-08-31,Modoc,049,8938,18,10,0,10,0
2020-08-31,Mono,051,14174,163,145,2,147,1
2020-08-31,Monterey,053,433212,8393,7839,22,7861,56
2020-08-31,Napa,055,140530,1509,1434,6,1440,10
2020-08-31,Nevada,057,99092,463,447,13,460,6
2020-08-31,Orange,059,3164182,50704,47392,1219,48611,965
2020-08-31,Placer,061,380077,3180,2989,12,3001,33
2020-08-31,Plumas,063,18699,43,39,0,39,0
2020-08-31,Riverside,065,2383286,54167,52508,69,52577,1020
2020-08-31,Sacramento,067,1510023,18942,17999,16,18015,303
2020-08-31,San Benito,069,59416,1166,1080,0,1080,4
2020-08-31,San Bernardino,071,2135413,49728,47370,314,47684,755
2020-08-31,San Diego,073,3302833,40642,38606,498,39104,682
2020-08-31,San Francisco,075,870044,9878,9293,15,9308,83
2020-08-31,San Joaquin,077,732212,18808,17807,37,17844,338
2020-08-31,San Luis Obispo,079,281455,3206,2951,17,2968,21
2020-08-31,San Mateo,081,765935,8803,8065,9,8074,122
2020-08-31,Santa Barbara,083,443738,8368,8124,70,8194,94
2020-08-31,Santa Clara,085,1922200,19003,17211,39,17250,202
2020-08-31,Santa Cruz,087,273765,1941,1742,17,1759,7
2020-08-31,Shasta,089,179085,637,528,3,531,9
2020-08-31,Sierra,091,2930,6,6,0,6,0
2020-08-31,Siskiyou,093,43540,140,127,8,135,0
2020-08-31,Solano,095,438530,5627,5302,39,5341,34
2020-08-31,Sonoma,097,501317,6178,5650,19,5669,60
2020-08-31,Stanislaus,099,539301,15424,14685,365,15050,213
2020-08-31,Sutter,101,95872,1444,1365,1,1366,10
2020-08-31,Tehama,103,63373,446,421,2,423,1
2020-08-31,Trinity,105,12862,47,13,6,19,0
2020-08-31,Tulare,107,460477,14884,13985,61,14046,237
2020-08-31,Tuolumne,109,53932,211,178,3,181,1
2020-08-31,Ventura,111,848112,11595,10866,105,10971,108
2020-08-31,Yolo,113,214977,2551,2423,5,2428,51
2020-08-31,Yuba,115,75493,918,830,3,833,1
2020-08-30,Alameda,001,1643700,19170,18099,129,18228,248
2020-08-30,Alpine,003,1148,2,2,0,2,0
2020-08-30,Amador,005,37829,274,240,0,240,13
2020-08-30,Butte,007,227075,2351,1988,21,2009,26
2020-08-30,Calaveras,009,45235,262,211,0,211,1
2020-08-30,Colusa,011,21464,474,440,0,440,6
2020-08-30,Contra Costa,013,1133247,14748,13780,53,13833,150
2020-08-30,Del Norte,015,27424,115,108,0,108,2
2020-08-30,El Dorado,017,186661,1023,962,0,962,2
2020-08-30,Fresno,019,978130,28015,24963,309,25272,291
2020-08-30,Glenn,021,27897,472,437,0,437,3
2020-08-30,Humboldt,023,135768,414,362,1,363,4
2020-08-30,Imperial,025,180216,11295,9703,8,9711,250
2020-08-30,Inyo,027,18085,181,160,4,164,3
2020-08-30,Kern,029,883053,29996,28987,229,29216,317
2020-08-30,Kings,031,150075,6437,6000,36,6036,62
2020-08-30,Lake,033,64148,362,334,0,334,2
2020-08-30,Lassen,035,31185,722,706,2,708,0
2020-08-30,Los Angeles,037,10098052,244481,240775,1314,242089,5772
2020-08-30,Madera,039,155013,3964,3626,27,3653,33
2020-08-30,Marin,041,260295,6257,6060,15,6075,66
2020-08-30,Mariposa,043,17540,73,69,0,69,2
2020-08-30,Mendocino,045,87422,656,611,0,611,13
2020-08-30,Merced,047,269075,8149,7960,10,7970,79
2020-08-30,Modoc,049,8938,13,10,0,10,0
2020-08-30,Mono,051,14174,163,145,2,147,1
2020-08-30,Monterey,053,433212,8309,7816,22,7838,54
2020-08-30,Napa,055,140530,1497,1423,6,1429,10
2020-08-30,Nevada,057,99092,460,445,13,458,6
2020-08-30,Orange,059,3164182,50508,47283,1205,48488,965
2020-08-30,Placer,061,380077,3147,2961,12,2973,32
2020-08-30,Plumas,063,18699,42,39,0,39,0
2020-08-30,Riverside,065,2383286,53988,52227,67,52294,1017
2020-08-30,Sacramento,067,1510023,18764,17751,16,17767,300
2020-08-30,San Benito,069,59416,1156,1071,0,1071,4
2020-08-30,San Bernardino,071,2135413,49471,47201,314,47515,755
2020-08-30,San Diego,073,3302833,40244,38302,477,38779,682
2020-08-30,San Francisco,075,870044,9780,9294,12,9306,83
2020-08-30,San Joaquin,077,732212,18691,17637,36,17673,338
2020-08-30,San Luis Obispo,079,281455,3181,2934,17,2951,21
2020-08-30,San Mateo,081,765935,8726,8013,8,8021,122
2020-08-30,Santa Barbara,083,443738,8308,8088,70,8158,93
2020-08-30,Santa Clara,085,1922200,18827,17045,39,17084,202
2020-08-30,Santa Cruz,087,273765,1915,1743,17,1760,7
2020-08-30,Shasta,089,179085,634,525,3,528,9
2020-08-30,Sierra,091,2930,6,6,0,6,0
2020-08-30,Siskiyou,093,43540,138,125,8,133,0
2020-08-30,Solano,095,438530,5583,5303,39,5342,34
2020-08-30,Sonoma,097,501317,6120,5590,19,5609,60
2020-08-30,Stanislaus,099,539301,15353,14580,356,14936,209
2020-08-30,Sutter,101,95872,1422,1351,1,1352,10
2020-08-30,Tehama,103,63373,437,419,2,421,1
2020-08-30,Trinity,105,12862,47,13,6,19,0
2020-08-30,Tulare,107,460477,14789,13985,60,14045,236
2020-08-30,Tuolumne,109,53932,207,178,3,181,1
2020-08-30,Ventura,111,848112,11482,10775,100,10875,108
2020-08-30,Yolo,113,214977,2523,2391,4,2395,51
2020-08-30,Yuba,115,75493,904,832,3,835,1
2020-08-29,Alameda,001,1643700,19103,17888,129,18017,250
2020-08-29,Alpine,003,1148,2,2,0,2,0
2020-08-29,Amador,005,37829,274,239,0,239,13
2020-08-29,Butte,007,227075,2320,1948,21,1969,26
2020-08-29,Calaveras,009,45235,258,211,0,211,1
2020-08-29,Colusa,011,21464,471,440,0,440,6
2020-08-29,Contra Costa,013,1133247,14675,13663,52,13715,159
2020-08-29,Del Norte,015,27424,115,108,0,108,1
2020-08-29,El Dorado,017,186661,1020,958,0,958,2
2020-08-29,Fresno,019,978130,27960,24821,309,25130,291
2020-08-29,Glenn,021,27897,466,437,0,437,3
2020-08-29,Humboldt,023,135768,411,363,1,364,4
2020-08-29,Imperial,025,180216,11280,9698,8,9706,250
2020-08-29,Inyo,027,18085,181,160,4,164,3
2020-08-29,Kern,029,883053,29955,28947,228,29175,317
2020-08-29,Kings,031,150075,6422,5906,36,5942,62
2020-08-29,Lake,033,64148,361,329,0,329,2
2020-08-29,Lassen,035,31185,722,706,2,708,0
2020-08-29,Los Angeles,037,10098052,243851,239815,1301,241116,5762
2020-08-29,Madera,039,155013,3955,3605,26,3631,33
2020-08-29,Marin,041,260295,6245,6007,15,6022,64
2020-08-29,Mariposa,043,17540,73,69,0,69,2
2020-08-29,Mendocino,045,87422,651,596,0,596,13
2020-08-29,Merced,047,269075,8119,7867,10,7877,79
2020-08-29,Modoc,049,8938,13,9,0,9,0
2020-08-29,Mono,051,14174,163,145,2,147,1
2020-08-29,Monterey,053,433212,8264,7680,22,7702,53
2020-08-29,Napa,055,140530,1494,1413,6,1419,10
2020-08-29,Nevada,057,99092,460,442,13,455,5
2020-08-29,Orange,059,3164182,50398,47007,1195,48202,960
2020-08-29,Placer,061,380077,3130,2935,12,2947,32
2020-08-29,Plumas,063,18699,41,39,0,39,0
2020-08-29,Riverside,065,2383286,53876,51918,65,51983,1016
2020-08-29,Sacramento,067,1510023,18692,17588,16,17604,291
2020-08-29,San Benito,069,59416,1147,1045,0,1045,4
2020-08-29,San Bernardino,071,2135413,49356,46849,314,47163,755
2020-08-29,San Diego,073,3302833,39978,38049,459,38508,694
2020-08-29,San Francisco,075,870044,9752,9291,11,9302,83
2020-08-29,San Joaquin,077,732212,18647,17493,36,17529,335
2020-08-29,San Luis Obispo,079,281455,3156,2917,17,2934,21
2020-08-29,San Mateo,081,765935,8684,7928,8,7936,122
2020-08-29,Santa Barbara,083,443738,8282,8052,69,8121,93
2020-08-29,Santa Clara,085,1922200,18730,16898,38,16936,202
2020-08-29,Santa Cruz,087,273765,1903,1746,17,1763,7
2020-08-29,Shasta,089,179085,626,522,3,525,9
2020-08-29,Sierra,091,2930,6,6,0,6,0
2020-08-29,Siskiyou,093,43540,138,121,8,129,0
2020-08-29,Solano,095,438530,5562,5303,39,5342,34
2020-08-29,Sonoma,097,501317,6085,5537,19,5556,60
2020-08-29,Stanislaus,099,539301,15304,14479,346,14825,208
2020-08-29,Sutter,101,95872,1417,1333,1,1334,9
2020-08-29,Tehama,103,63373,436,417,2,419,1
2020-08-29,Trinity,105,12862,46,11,6,17,0
2020-08-29,Tulare,107,460477,14751,13890,59,13949,236
2020-08-29,Tuolumne,109,53932,207,178,3,181,1
2020-08-29,Ventura,111,848112,11440,10705,100,10805,108
2020-08-29,Yolo,113,214977,2505,2357,4,2361,51
2020-08-29,Yuba,115,75493,895,822,3,825,1
2020-08-28,Alameda,001,1643700,19020,17729,128,17857,237
2020-08-28,Alpine,003,1148,2,2,0,2,0
2020-08-28,Amador,005,37829,274,234,0,234,13
2020-08-28,Butte,007,227075,2290,1886,21,1907,25
2020-08-28,Calaveras,009,45235,256,207,0,207,1
2020-08-28,Colusa,011,21464,470,441,0,441,6
2020-08-28,Contra Costa,013,1133247,14604,13522,51,13573,158
2020-08-28,Del Norte,015,27424,115,107,0,107,1
2020-08-28,El Dorado,017,186661,1014,949,0,949,2
2020-08-28,Fresno,019,978130,27826,24612,309,24921,282
2020-08-28,Glenn,021,27897,459,429,0,429,3
2020-08-28,Humboldt,023,135768,407,362,1,363,4
2020-08-28,Imperial,025,180216,11266,9656,8,9664,241
2020-08-28,Inyo,027,18085,180,160,4,164,2
2020-08-28,Kern,029,883053,29907,28744,228,28972,306
2020-08-28,Kings,031,150075,6415,5829,35,5864,62
2020-08-28,Lake,033,64148,356,320,0,320,2
2020-08-28,Lassen,035,31185,722,704,2,706,0
2020-08-28,Los Angeles,037,10098052,243041,238544,1276,239820,5740
2020-08-28,Madera,039,155013,3936,3552,26,3578,33
2020-08-28,Marin,041,260295,6223,5991,15,6006,63
2020-08-28,Mariposa,043,17540,73,67,0,67,2
2020-08-28,Mendocino,045,87422,646,588,0,588,11
2020-08-28,Merced,047,269075,8089,7803,10,7813,77
2020-08-28,Modoc,049,8938,13,6,0,6,0
2020-08-28,Mono,051,14174,163,145,2,147,1
2020-08-28,Monterey,053,433212,8207,7591,22,7613,53
2020-08-28,Napa,055,140530,1486,1403,5,1408,10
2020-08-28,Nevada,057,99092,459,438,13,451,5
2020-08-28,Orange,059,3164182,50298,46696,1180,47876,942
2020-08-28,Placer,061,380077,3119,2891,12,2903,32
2020-08-28,Plumas,063,18699,41,39,0,39,0
2020-08-28,Riverside,065,2383286,53745,51510,61,51571,1008
2020-08-28,Sacramento,067,1510023,18595,17119,16,17135,283
2020-08-28,San Benito,069,59416,1131,1016,0,1016,3
2020-08-28,San Bernardino,071,2135413,49238,46553,310,46863,754
2020-08-28,San Diego,073,3302833,39748,37786,444,38230,676
2020-08-28,San Francisco,075,870044,9699,9135,11,9146,83
2020-08-28,San Joaquin,077,732212,18594,17114,35,17149,314
2020-08-28,San Luis Obispo,079,281455,3139,2849,17,2866,20
2020-08-28,San Mateo,081,765935,8637,7783,8,7791,121
2020-08-28,Santa Barbara,083,443738,8250,8001,69,8070,92
2020-08-28,Santa Clara,085,1922200,18599,16696,38,16734,201
2020-08-28,Santa Cruz,087,273765,1891,1747,17,1764,7
2020-08-28,Shasta,089,179085,622,516,3,519,9
2020-08-28,Sierra,091,2930,6,6,0,6,0
2020-08-28,Siskiyou,093,43540,136,119,8,127,0
2020-08-28,Solano,095,438530,5543,5219,39,5258,34
2020-08-28,Sonoma,097,501317,6050,5425,18,5443,58
2020-08-28,Stanislaus,099,539301,15262,14176,342,14518,190
2020-08-28,Sutter,101,95872,1407,1308,1,1309,9
2020-08-28,Tehama,103,63373,431,410,2,412,1
2020-08-28,Trinity,105,12862,46,11,6,17,0
2020-08-28,Tulare,107,460477,14705,13776,59,13835,236
2020-08-28,Tuolumne,109,53932,207,176,3,179,1
2020-08-28,Ventura,111,848112,11404,10606,98,10704,103
2020-08-28,Yolo,113,214977,2496,2323,4,2327,51
2020-08-28,Yuba,115,75493,886,810,3,813,1
2020-08-27,Alameda,001,1643700,18875,17584,125,17709,234
2020-08-27,Alpine,003,1148,2,2,0,2,0
2020-08-27,Amador,005,37829,273,233,0,233,13
2020-08-27,Butte,007,227075,2224,1803,20,1823,25
2020-08-27,Calaveras,009,45235,250,204,0,204,1
2020-08-27,Colusa,011,21464,468,438,0,438,6
2020-08-27,Contra Costa,013,1133247,14503,13379,50,13429,158
2020-08-27,Del Norte,015,27424,115,107,0,107,1
2020-08-27,El Dorado,017,186661,1010,942,0,942,2
2020-08-27,Fresno,019,978130,27643,24367,304,24671,272
2020-08-27,Glenn,021,27897,451,429,0,429,3
2020-08-27,Humboldt,023,135768,399,358,1,359,4
2020-08-27,Imperial,025,180216,11239,9608,8,9616,235
2020-08-27,Inyo,027,18085,180,157,3,160,2
2020-08-27,Kern,029,883053,29835,28635,219,28854,294
2020-08-27,Kings,031,150075,6393,5759,35,5794,62
2020-08-27,Lake,033,64148,354,314,0,314,2
2020-08-27,Lassen,035,31185,722,703,2,705,0
2020-08-27,Los Angeles,037,10098052,242038,237103,1260,238363,5704
2020-08-27,Madera,039,155013,3910,3465,26,3491,33
2020-08-27,Marin,041,260295,6199,5929,15,5944,62
2020-08-27,Mariposa,043,17540,73,67,0,67,2
2020-08-27,Mendocino,045,87422,637,581,0,581,10
2020-08-27,Merced,047,269075,8045,7765,10,7775,75
2020-08-27,Modoc,049,8938,11,5,0,5,0
2020-08-27,Mono,051,14174,163,145,2,147,1
2020-08-27,Monterey,053,433212,8113,7501,22,7523,52
2020-08-27,Napa,055,140530,1480,1397,5,1402,10
2020-08-27,Nevada,057,99092,456,435,13,448,5
2020-08-27,Orange,059,3164182,50141,46449,1169,47618,935
2020-08-27,Placer,061,380077,3088,2869,12,2881,32
2020-08-27,Plumas,063,18699,40,39,0,39,0
2020-08-27,Riverside,065,2383286,53536,51306,58,51364,999
2020-08-27,Sacramento,067,1510023,18397,16875,16,16891,281
2020-08-27,San Benito,069,59416,1115,987,0,987,3
2020-08-27,San Bernardino,071,2135413,49012,46345,304,46649,751
2020-08-27,San Diego,073,3302833,39477,37501,424,37925,673
2020-08-27,San Francisco,075,870044,9633,9014,11,9025,83
2020-08-27,San Joaquin,077,732212,18514,16989,35,17024,314
2020-08-27,San Luis Obispo,079,281455,3114,2808,17,2825,20
2020-08-27,San Mateo,081,765935,8528,7728,8,7736,121
2020-08-27,Santa Barbara,083,443738,8212,7934,69,8003,92
2020-08-27,Santa Clara,085,1922200,18416,16495,38,16533,199
2020-08-27,Santa Cruz,087,273765,1874,1734,17,1751,7
2020-08-27,Shasta,089,179085,616,512,3,515,9
2020-08-27,Sierra,091,2930,6,6,0,6,0
2020-08-27,Siskiyou,093,43540,136,118,8,126,0
2020-08-27,Solano,095,438530,5505,5167,39,5206,34
2020-08-27,Sonoma,097,501317,5938,5357,18,5375,58
2020-08-27,Stanislaus,099,539301,15181,14080,339,14419,186
2020-08-27,Sutter,101,95872,1387,1296,1,1297,9
2020-08-27,Tehama,103,63373,427,398,2,400,1
2020-08-27,Trinity,105,12862,46,11,6,17,0
2020-08-27,Tulare,107,460477,14613,13666,58,13724,231
2020-08-27,Tuolumne,109,53932,202,174,3,177,1
2020-08-27,Ventura,111,848112,11341,10483,94,10577,102
2020-08-27,Yolo,113,214977,2472,2293,4,2297,51
2020-08-27,Yuba,115,75493,875,807,3,810,1
2020-08-26,Alameda,001,1643700,18713,17373,125,17498,233
2020-08-26,Alpine,003,1148,2,2,0,2,0
2020-08-26,Amador,005,37829,273,229,0,229,13
2020-08-26,Butte,007,227075,2156,1765,18,1783,25
2020-08-26,Calaveras,009,45235,243,201,0,201,1
2020-08-26,Colusa,011,21464,462,433,0,433,5
2020-08-26,Contra Costa,013,1133247,14366,13248,50,13298,157
2020-08-26,Del Norte,015,27424,114,86,0,86,1
2020-08-26,El Dorado,017,186661,1008,938,0,938,2
2020-08-26,Fresno,019,978130,27495,24071,302,24373,255
2020-08-26,Glenn,021,27897,449,429,0,429,3
2020-08-26,Humboldt,023,135768,387,357,1,358,4
2020-08-26,Imperial,025,180216,11217,9453,8,9461,227
2020-08-26,Inyo,027,18085,177,157,3,160,2
2020-08-26,Kern,029,883053,29696,28507,216,28723,286
2020-08-26,Kings,031,150075,6372,5720,35,5755,62
2020-08-26,Lake,033,64148,349,308,0,308,2
2020-08-26,Lassen,035,31185,722,702,2,704,0
2020-08-26,Los Angeles,037,10098052,241025,235499,1229,236728,5665
2020-08-26,Madera,039,155013,3881,3458,26,3484,32
2020-08-26,Marin,041,260295,6182,5887,15,5902,56
2020-08-26,Mariposa,043,17540,73,68,0,68,2
2020-08-26,Mendocino,045,87422,626,581,0,581,10
2020-08-26,Merced,047,269075,8012,7720,10,7730,74
2020-08-26,Modoc,049,8938,8,5,0,5,0
2020-08-26,Mono,051,14174,163,141,2,143,1
2020-08-26,Monterey,053,433212,8020,7439,22,7461,51
2020-08-26,Napa,055,140530,1467,1382,5,1387,10
2020-08-26,Nevada,057,99092,453,432,13,445,2
2020-08-26,Orange,059,3164182,49957,46157,1154,47311,905
2020-08-26,Placer,061,380077,3066,2846,10,2856,32
2020-08-26,Plumas,063,18699,39,39,0,39,0
2020-08-26,Riverside,065,2383286,53294,51138,58,51196,987
2020-08-26,Sacramento,067,1510023,18234,16708,16,16724,271
2020-08-26,San Benito,069,59416,1100,978,0,978,3
2020-08-26,San Bernardino,071,2135413,48804,45840,300,46140,743
2020-08-26,San Diego,073,3302833,39139,37224,397,37621,668
2020-08-26,San Francisco,075,870044,9558,8938,11,8949,81
2020-08-26,San Joaquin,077,732212,18425,16845,34,16879,309
2020-08-26,San Luis Obispo,079,281455,3086,2761,17,2778,20
2020-08-26,San Mateo,081,765935,8461,7655,8,7663,121
2020-08-26,Santa Barbara,083,443738,8178,7904,69,7973,90
2020-08-26,Santa Clara,085,1922200,18240,16283,38,16321,198
2020-08-26,Santa Cruz,087,273765,1863,1726,17,1743,7
2020-08-26,Shasta,089,179085,611,511,3,514,9
2020-08-26,Sierra,091,2930,6,6,0,6,0
2020-08-26,Siskiyou,093,43540,133,109,8,117,0
2020-08-26,Solano,095,438530,5481,5131,38,5169,34
2020-08-26,Sonoma,097,501317,5865,5283,18,5301,58
2020-08-26,Stanislaus,099,539301,15104,13964,333,14297,186
2020-08-26,Sutter,101,95872,1369,1275,1,1276,9
2020-08-26,Tehama,103,63373,424,396,2,398,1
2020-08-26,Trinity,105,12862,45,10,6,16,0
2020-08-26,Tulare,107,460477,14546,13568,58,13626,232
2020-08-26,Tuolumne,109,53932,201,172,3,175,1
2020-08-26,Ventura,111,848112,11269,10412,87,10499,100
2020-08-26,Yolo,113,214977,2450,2279,4,2283,49
2020-08-26,Yuba,115,75493,860,779,3,782,1
2020-08-25,Alameda,001,1643700,18556,17278,125,17403,232
2020-08-25,Alpine,003,1148,2,2,0,2,0
2020-08-25,Amador,005,37829,273,227,0,227,13
2020-08-25,Butte,007,227075,2089,1718,18,1736,24
2020-08-25,Calaveras,009,45235,241,196,0,196,1
2020-08-25,Colusa,011,21464,455,430,0,430,5
2020-08-25,Contra Costa,013,1133247,14228,13181,49,13230,156
2020-08-25,Del Norte,015,27424,113,83,0,83,1
2020-08-25,El Dorado,017,186661,1005,928,0,928,2
2020-08-25,Fresno,019,978130,27307,23932,301,24233,250
2020-08-25,Glenn,021,27897,446,429,0,429,3
2020-08-25,Humboldt,023,135768,382,342,1,343,4
2020-08-25,Imperial,025,180216,11189,9381,8,9389,217
2020-08-25,Inyo,027,18085,175,144,3,147,1
2020-08-25,Kern,029,883053,29559,28416,216,28632,285
2020-08-25,Kings,031,150075,6215,5702,35,5737,59
2020-08-25,Lake,033,64148,344,304,0,304,2
2020-08-25,Lassen,035,31185,721,692,2,694,0
2020-08-25,Los Angeles,037,10098052,239730,233961,1179,235140,5612
2020-08-25,Madera,039,155013,3866,3446,25,3471,32
2020-08-25,Marin,041,260295,6144,5860,15,5875,56
2020-08-25,Mariposa,043,17540,73,67,0,67,2
2020-08-25,Mendocino,045,87422,618,571,0,571,10
2020-08-25,Merced,047,269075,7946,7693,9,7702,69
2020-08-25,Modoc,049,8938,8,5,0,5,0
2020-08-25,Mono,051,14174,163,129,2,131,1
2020-08-25,Monterey,053,433212,7940,7333,22,7355,51
2020-08-25,Napa,055,140530,1460,1374,5,1379,10
2020-08-25,Nevada,057,99092,449,430,13,443,2
2020-08-25,Orange,059,3164182,49763,45737,1138,46875,902
2020-08-25,Placer,061,380077,3047,2829,7,2836,31
2020-08-25,Plumas,063,18699,39,39,0,39,0
2020-08-25,Riverside,065,2383286,53062,50889,58,50947,981
2020-08-25,Sacramento,067,1510023,18081,16601,16,16617,265
2020-08-25,San Benito,069,59416,1084,973,0,973,3
2020-08-25,San Bernardino,071,2135413,48570,45544,297,45841,727
2020-08-25,San Diego,073,3302833,38860,36996,375,37371,665
2020-08-25,San Francisco,075,870044,9480,8848,11,8859,81
2020-08-25,San Joaquin,077,732212,18298,16795,34,16829,306
2020-08-25,San Luis Obispo,079,281455,3027,2731,16,2747,20
2020-08-25,San Mateo,081,765935,8401,7636,8,7644,120
2020-08-25,Santa Barbara,083,443738,8126,7854,69,7923,90
2020-08-25,Santa Clara,085,1922200,18068,16199,38,16237,194
2020-08-25,Santa Cruz,087,273765,1844,1708,17,1725,7
2020-08-25,Shasta,089,179085,607,511,3,514,9
2020-08-25,Sierra,091,2930,6,6,0,6,0
2020-08-25,Siskiyou,093,43540,132,109,8,117,0
2020-08-25,Solano,095,438530,5420,5114,38,5152,34
2020-08-25,Sonoma,097,501317,5779,5148,18,5166,56
2020-08-25,Stanislaus,099,539301,14996,13886,322,14208,182
2020-08-25,Sutter,101,95872,1352,1259,1,1260,9
2020-08-25,Tehama,103,63373,421,394,2,396,1
2020-08-25,Trinity,105,12862,44,10,6,16,0
2020-08-25,Tulare,107,460477,14443,13514,57,13571,224
2020-08-25,Tuolumne,109,53932,199,172,3,175,1
2020-08-25,Ventura,111,848112,11184,10313,82,10395,99
2020-08-25,Yolo,113,214977,2437,2254,4,2258,50
2020-08-25,Yuba,115,75493,850,775,3,778,1
2020-08-24,Alameda,001,1643700,18361,16913,124,17037,231
2020-08-24,Alpine,003,1148,2,2,0,2,0
2020-08-24,Amador,005,37829,271,227,0,227,13
2020-08-24,Butte,007,227075,2005,1649,18,1667,23
2020-08-24,Calaveras,009,45235,231,187,0,187,1
2020-08-24,Colusa,011,21464,451,425,0,425,5
2020-08-24,Contra Costa,013,1133247,14113,12906,47,12953,153
2020-08-24,Del Norte,015,27424,113,80,0,80,1
2020-08-24,El Dorado,017,186661,997,908,0,908,2
2020-08-24,Fresno,019,978130,27119,23618,294,23912,235
2020-08-24,Glenn,021,27897,444,421,0,421,2
2020-08-24,Humboldt,023,135768,378,340,1,341,4
2020-08-24,Imperial,025,180216,11156,9323,8,9331,210
2020-08-24,Inyo,027,18085,171,144,3,147,2
2020-08-24,Kern,029,883053,29461,28157,210,28367,277
2020-08-24,Kings,031,150075,6127,5652,35,5687,60
2020-08-24,Lake,033,64148,329,302,0,302,2
2020-08-24,Lassen,035,31185,721,693,2,695,0
2020-08-24,Los Angeles,037,10098052,238367,233036,1160,234196,5562
2020-08-24,Madera,039,155013,3839,3418,25,3443,32
2020-08-24,Marin,041,260295,6081,5834,15,5849,56
2020-08-24,Mariposa,043,17540,71,66,0,66,2
2020-08-24,Mendocino,045,87422,603,550,0,550,10
2020-08-24,Merced,047,269075,7868,7605,9,7614,69
2020-08-24,Modoc,049,8938,8,5,0,5,0
2020-08-24,Mono,051,14174,163,129,2,131,1
2020-08-24,Monterey,053,433212,7831,7212,21,7233,50
2020-08-24,Napa,055,140530,1447,1358,5,1363,10
2020-08-24,Nevada,057,99092,444,423,13,436,2
2020-08-24,Orange,059,3164182,49570,45536,1128,46664,887
2020-08-24,Placer,061,380077,3001,2793,7,2800,31
2020-08-24,Plumas,063,18699,39,37,0,37,0
2020-08-24,Riverside,065,2383286,52784,50496,58,50554,975
2020-08-24,Sacramento,067,1510023,17884,16318,16,16334,249
2020-08-24,San Benito,069,59416,1063,961,0,961,3
2020-08-24,San Bernardino,071,2135413,48307,45199,295,45494,720
2020-08-24,San Diego,073,3302833,38572,36729,347,37076,660
2020-08-24,San Francisco,075,870044,9397,8621,10,8631,81
2020-08-24,San Joaquin,077,732212,18157,16565,33,16598,305
2020-08-24,San Luis Obispo,079,281455,2999,2705,16,2721,20
2020-08-24,San Mateo,081,765935,8334,7502,8,7510,120
2020-08-24,Santa Barbara,083,443738,8085,7784,69,7853,90
2020-08-24,Santa Clara,085,1922200,17863,16049,38,16087,192
2020-08-24,Santa Cruz,087,273765,1824,1627,16,1643,6
2020-08-24,Shasta,089,179085,605,505,3,508,9
2020-08-24,Sierra,091,2930,6,6,0,6,0
2020-08-24,Siskiyou,093,43540,128,107,8,115,0
2020-08-24,Solano,095,438530,5371,4979,36,5015,32
2020-08-24,Sonoma,097,501317,5677,5071,18,5089,56
2020-08-24,Stanislaus,099,539301,14898,13521,308,13829,171
2020-08-24,Sutter,101,95872,1333,1219,1,1220,9
2020-08-24,Tehama,103,63373,416,388,2,390,1
2020-08-24,Trinity,105,12862,44,10,6,16,0
2020-08-24,Tulare,107,460477,14336,13360,56,13416,223
2020-08-24,Tuolumne,109,53932,198,170,3,173,1
2020-08-24,Ventura,111,848112,11104,10261,78,10339,99
2020-08-24,Yolo,113,214977,2403,2239,4,2243,47
2020-08-24,Yuba,115,75493,833,750,3,753,1
2020-08-23,Alameda,001,1643700,18138,16786,123,16909,231
2020-08-23,Alpine,003,1148,2,2,0,2,0
2020-08-23,Amador,005,37829,268,227,0,227,13
2020-08-23,Butte,007,227075,1891,1637,18,1655,23
2020-08-23,Calaveras,009,45235,221,187,0,187,1
2020-08-23,Colusa,011,21464,444,424,0,424,5
2020-08-23,Contra Costa,013,1133247,13953,12642,47,12689,153
2020-08-23,Del Norte,015,27424,113,80,0,80,1
2020-08-23,El Dorado,017,186661,984,901,0,901,2
2020-08-23,Fresno,019,978130,26914,23414,290,23704,235
2020-08-23,Glenn,021,27897,437,421,0,421,2
2020-08-23,Humboldt,023,135768,376,341,1,342,4
2020-08-23,Imperial,025,180216,11127,9243,8,9251,210
2020-08-23,Inyo,027,18085,168,144,3,147,2
2020-08-23,Kern,029,883053,29312,28028,205,28233,277
2020-08-23,Kings,031,150075,6084,5628,35,5663,60
2020-08-23,Lake,033,64148,325,299,0,299,2
2020-08-23,Lassen,035,31185,720,693,2,695,0
2020-08-23,Los Angeles,037,10098052,236772,231833,1090,232923,5549
2020-08-23,Madera,039,155013,3807,3401,24,3425,32
2020-08-23,Marin,041,260295,6042,5807,14,5821,50
2020-08-23,Mariposa,043,17540,71,66,0,66,2
2020-08-23,Mendocino,045,87422,599,550,0,550,10
2020-08-23,Merced,047,269075,7799,7574,8,7582,69
2020-08-23,Modoc,049,8938,7,5,0,5,0
2020-08-23,Mono,051,14174,163,129,2,131,1
2020-08-23,Monterey,053,433212,7741,7173,21,7194,50
2020-08-23,Napa,055,140530,1435,1348,5,1353,10
2020-08-23,Nevada,057,99092,439,421,13,434,2
2020-08-23,Orange,059,3164182,49332,45267,1117,46384,887
2020-08-23,Placer,061,380077,2962,2772,7,2779,31
2020-08-23,Plumas,063,18699,39,37,0,37,0
2020-08-23,Riverside,065,2383286,52514,50293,56,50349,955
2020-08-23,Sacramento,067,1510023,17660,16084,15,16099,243
2020-08-23,San Benito,069,59416,1050,938,0,938,3
2020-08-23,San Bernardino,071,2135413,48038,45010,285,45295,719
2020-08-23,San Diego,073,3302833,38251,36542,320,36862,660
2020-08-23,San Francisco,075,870044,9302,8564,9,8573,80
2020-08-23,San Joaquin,077,732212,18024,16069,32,16101,305
2020-08-23,San Luis Obispo,079,281455,2957,2679,16,2695,20
2020-08-23,San Mateo,081,765935,8239,7450,8,7458,120
2020-08-23,Santa Barbara,083,443738,8017,7725,69,7794,90
2020-08-23,Santa Clara,085,1922200,17668,15912,36,15948,191
2020-08-23,Santa Cruz,087,273765,1798,1627,16,1643,6
2020-08-23,Shasta,089,179085,600,501,3,504,9
2020-08-23,Sierra,091,2930,6,6,0,6,0
2020-08-23,Siskiyou,093,43540,123,107,8,115,0
2020-08-23,Solano,095,438530,5313,4977,34,5011,32
2020-08-23,Sonoma,097,501317,5589,5018,18,5036,56
2020-08-23,Stanislaus,099,539301,14763,13483,285,13768,171
2020-08-23,Sutter,101,95872,1311,1203,1,1204,9
2020-08-23,Tehama,103,63373,406,381,2,383,1
2020-08-23,Trinity,105,12862,44,10,6,16,0
2020-08-23,Tulare,107,460477,14204,13303,53,13356,223
2020-08-23,Tuolumne,109,53932,195,164,3,167,1
2020-08-23,Ventura,111,848112,11003,10126,74,10200,99
2020-08-23,Yolo,113,214977,2375,2210,4,2214,47
2020-08-23,Yuba,115,75493,812,750,3,753,1
2020-08-22,Alameda,001,1643700,18044,16648,122,16770,231
2020-08-22,Alpine,003,1148,2,2,0,2,0
2020-08-22,Amador,005,37829,267,224,0,224,13
2020-08-22,Butte,007,227075,1840,1618,18,1636,22
2020-08-22,Calaveras,009,45235,218,187,0,187,1
2020-08-22,Colusa,011,21464,440,419,0,419,5
2020-08-22,Contra Costa,013,1133247,13866,12522,47,12569,153
2020-08-22,Del Norte,015,27424,112,80,0,80,1
2020-08-22,El Dorado,017,186661,982,900,0,900,2
2020-08-22,Fresno,019,978130,26817,23197,289,23486,235
2020-08-22,Glenn,021,27897,436,421,0,421,2
2020-08-22,Humboldt,023,135768,366,334,1,335,4
2020-08-22,Imperial,025,180216,11119,9244,8,9252,210
2020-08-22,Inyo,027,18085,168,144,3,147,1
2020-08-22,Kern,029,883053,29258,27807,205,28012,277
2020-08-22,Kings,031,150075,6075,5447,35,5482,60
2020-08-22,Lake,033,64148,323,291,0,291,2
2020-08-22,Lassen,035,31185,720,693,2,695,0
2020-08-22,Los Angeles,037,10098052,236113,230858,1072,231930,5540
2020-08-22,Madera,039,155013,3788,3330,24,3354,32
2020-08-22,Marin,041,260295,6030,5789,14,5803,49
2020-08-22,Mariposa,043,17540,71,66,0,66,2
2020-08-22,Mendocino,045,87422,596,529,0,529,10
2020-08-22,Merced,047,269075,7771,7493,8,7501,69
2020-08-22,Modoc,049,8938,7,5,0,5,0
2020-08-22,Mono,051,14174,163,129,2,131,1
2020-08-22,Monterey,053,433212,7693,7081,21,7102,50
2020-08-22,Napa,055,140530,1430,1328,5,1333,11
2020-08-22,Nevada,057,99092,439,411,13,424,2
2020-08-22,Orange,059,3164182,49191,45131,1111,46242,885
2020-08-22,Placer,061,380077,2948,2734,7,2741,30
2020-08-22,Plumas,063,18699,39,37,0,37,0
2020-08-22,Riverside,065,2383286,52366,49944,55,49999,953
2020-08-22,Sacramento,067,1510023,17548,15516,15,15531,239
2020-08-22,San Benito,069,59416,1034,912,0,912,3
2020-08-22,San Bernardino,071,2135413,47909,44803,281,45084,719
2020-08-22,San Diego,073,3302833,38069,36205,309,36514,673
2020-08-22,San Francisco,075,870044,9242,8568,9,8577,80
2020-08-22,San Joaquin,077,732212,17968,16068,32,16100,305
2020-08-22,San Luis Obispo,079,281455,2931,2660,16,2676,20
2020-08-22,San Mateo,081,765935,8192,7361,8,7369,120
2020-08-22,Santa Barbara,083,443738,7991,7685,69,7754,90
2020-08-22,Santa Clara,085,1922200,17560,15590,36,15626,190
2020-08-22,Santa Cruz,087,273765,1782,1628,15,1643,6
2020-08-22,Shasta,089,179085,598,493,3,496,9
2020-08-22,Sierra,091,2930,6,6,0,6,0
2020-08-22,Siskiyou,093,43540,123,106,8,114,0
2020-08-22,Solano,095,438530,5283,4944,33,4977,32
2020-08-22,Sonoma,097,501317,5543,4891,18,4909,57
2020-08-22,Stanislaus,099,539301,14713,13380,268,13648,170
2020-08-22,Sutter,101,95872,1304,1189,1,1190,8
2020-08-22,Tehama,103,63373,405,368,2,370,1
2020-08-22,Trinity,105,12862,44,8,6,14,0
2020-08-22,Tulare,107,460477,14137,13196,53,13249,222
2020-08-22,Tuolumne,109,53932,193,162,3,165,1
2020-08-22,Ventura,111,848112,10948,9959,72,10031,99
2020-08-22,Yolo,113,214977,2359,2188,4,2192,47
2020-08-22,Yuba,115,75493,800,738,3,741,1
2020-08-21,Alameda,001,1643700,17952,16413,122,16535,232
2020-08-21,Alpine,003,1148,2,2,0,2,0
2020-08-21,Amador,005,37829,266,223,0,223,11
2020-08-21,Butte,007,227075,1801,1582,18,1600,19
2020-08-21,Calaveras,009,45235,218,182,0,182,1
2020-08-21,Colusa,011,21464,438,418,0,418,5
2020-08-21,Contra Costa,013,1133247,13777,12333,46,12379,149
2020-08-21,Del Norte,015,27424,112,78,0,78,1
2020-08-21,El Dorado,017,186661,978,885,0,885,2
2020-08-21,Fresno,019,978130,26647,22840,288,23128,232
2020-08-21,Glenn,021,27897,432,418,0,418,2
2020-08-21,Humboldt,023,135768,363,331,1,332,4
2020-08-21,Imperial,025,180216,11103,9166,8,9174,204
2020-08-21,Inyo,027,18085,168,144,3,147,1
2020-08-21,Kern,029,883053,29199,27567,203,27770,269
2020-08-21,Kings,031,150075,6053,5391,35,5426,60
2020-08-21,Lake,033,64148,321,281,0,281,2
2020-08-21,Lassen,035,31185,720,693,2,695,0
2020-08-21,Los Angeles,037,10098052,235239,229235,1052,230287,5494
2020-08-21,Madera,039,155013,3758,3271,24,3295,31
2020-08-21,Marin,041,260295,6010,5762,14,5776,49
2020-08-21,Mariposa,043,17540,71,66,0,66,2
2020-08-21,Mendocino,045,87422,586,505,0,505,10
2020-08-21,Merced,047,269075,7742,7357,8,7365,69
2020-08-21,Modoc,049,8938,7,5,0,5,0
2020-08-21,Mono,051,14174,163,128,2,130,1
2020-08-21,Monterey,053,433212,7621,6974,21,6995,49
2020-08-21,Napa,055,140530,1421,1317,5,1322,10
2020-08-21,Nevada,057,99092,438,406,13,419,2
2020-08-21,Orange,059,3164182,49050,44625,1102,45727,875
2020-08-21,Placer,061,380077,2932,2698,6,2704,30
2020-08-21,Plumas,063,18699,39,36,0,36,0
2020-08-21,Riverside,065,2383286,52171,49409,55,49464,932
2020-08-21,Sacramento,067,1510023,17425,15247,15,15262,237
2020-08-21,San Benito,069,59416,1024,891,0,891,3
2020-08-21,San Bernardino,071,2135413,47789,44249,277,44526,668
2020-08-21,San Diego,073,3302833,37865,35914,292,36206,652
2020-08-21,San Francisco,075,870044,9192,8375,9,8384,80
2020-08-21,San Joaquin,077,732212,17885,15888,30,15918,301
2020-08-21,San Luis Obispo,079,281455,2908,2640,16,2656,19
2020-08-21,San Mateo,081,765935,8134,7253,8,7261,120
2020-08-21,Santa Barbara,083,443738,7950,7645,69,7714,86
2020-08-21,Santa Clara,085,1922200,17408,15399,36,15435,190
2020-08-21,Santa Cruz,087,273765,1770,1617,15,1632,6
2020-08-21,Shasta,089,179085,598,486,3,489,9
2020-08-21,Sierra,091,2930,6,6,0,6,0
2020-08-21,Siskiyou,093,43540,123,103,6,109,0
2020-08-21,Solano,095,438530,5260,4891,32,4923,32
2020-08-21,Sonoma,097,501317,5473,4816,18,4834,57
2020-08-21,Stanislaus,099,539301,14644,13282,253,13535,161
2020-08-21,Sutter,101,95872,1291,1173,1,1174,8
2020-08-21,Tehama,103,63373,403,357,2,359,1
2020-08-21,Trinity,105,12862,44,8,6,14,0
2020-08-21,Tulare,107,460477,14065,13002,52,13054,217
2020-08-21,Tuolumne,109,53932,185,161,3,164,1
2020-08-21,Ventura,111,848112,10883,9865,70,9935,98
2020-08-21,Yolo,113,214977,2343,2164,4,2168,46
2020-08-21,Yuba,115,75493,796,717,3,720,1
2020-08-20,Alameda,001,1643700,17793,16174,122,16296,229
2020-08-20,Alpine,003,1148,2,2,0,2,0
2020-08-20,Amador,005,37829,264,222,0,222,11
2020-08-20,Butte,007,227075,1750,1549,18,1567,18
2020-08-20,Calaveras,009,45235,215,179,0,179,1
2020-08-20,Colusa,011,21464,436,415,0,415,5
2020-08-20,Contra Costa,013,1133247,13649,12108,45,12153,144
2020-08-20,Del Norte,015,27424,112,78,0,78,1
2020-08-20,El Dorado,017,186661,974,881,0,881,2
2020-08-20,Fresno,019,978130,26465,22535,283,22818,228
2020-08-20,Glenn,021,27897,427,414,0,414,2
2020-08-20,Humboldt,023,135768,358,318,1,319,4
2020-08-20,Imperial,025,180216,11084,9086,8,9094,196
2020-08-20,Inyo,027,18085,167,144,3,147,1
2020-08-20,Kern,029,883053,29031,27337,192,27529,267
2020-08-20,Kings,031,150075,6013,5347,34,5381,59
2020-08-20,Lake,033,64148,316,280,0,280,2
2020-08-20,Lassen,035,31185,719,693,2,695,0
2020-08-20,Los Angeles,037,10098052,234016,227492,1033,228525,5445
2020-08-20,Madera,039,155013,3732,3197,24,3221,31
2020-08-20,Marin,041,260295,5992,5745,14,5759,47
2020-08-20,Mariposa,043,17540,71,67,0,67,2
2020-08-20,Mendocino,045,87422,575,497,0,497,10
2020-08-20,Merced,047,269075,7667,7173,8,7181,68
2020-08-20,Modoc,049,8938,7,5,0,5,0
2020-08-20,Mono,051,14174,163,128,2,130,1
2020-08-20,Monterey,053,433212,7550,6892,21,6913,47
2020-08-20,Napa,055,140530,1413,1306,5,1311,10
2020-08-20,Nevada,057,99092,437,401,13,414,2
2020-08-20,Orange,059,3164182,48823,44299,1091,45390,849
2020-08-20,Placer,061,380077,2916,2681,6,2687,30
2020-08-20,Plumas,063,18699,39,36,0,36,0
2020-08-20,Riverside,065,2383286,51952,48953,54,49007,927
2020-08-20,Sacramento,067,1510023,17183,14992,15,15007,231
2020-08-20,San Benito,069,59416,1011,866,0,866,3
2020-08-20,San Bernardino,071,2135413,47533,43627,273,43900,665
2020-08-20,San Diego,073,3302833,37645,35610,274,35884,644
2020-08-20,San Francisco,075,870044,9106,8262,9,8271,72
2020-08-20,San Joaquin,077,732212,17792,15778,30,15808,297
2020-08-20,San Luis Obispo,079,281455,2888,2590,16,2606,19
2020-08-20,San Mateo,081,765935,8069,7188,8,7196,120
2020-08-20,Santa Barbara,083,443738,7912,7571,69,7640,81
2020-08-20,Santa Clara,085,1922200,17235,15162,36,15198,190
2020-08-20,Santa Cruz,087,273765,1757,1581,15,1596,6
2020-08-20,Shasta,089,179085,597,478,3,481,9
2020-08-20,Sierra,091,2930,6,6,0,6,0
2020-08-20,Siskiyou,093,43540,122,102,1,103,0
2020-08-20,Solano,095,438530,5216,4843,32,4875,31
2020-08-20,Sonoma,097,501317,5401,4737,18,4755,54
2020-08-20,Stanislaus,099,539301,14548,13120,244,13364,161
2020-08-20,Sutter,101,95872,1267,1158,1,1159,8
2020-08-20,Tehama,103,63373,397,350,2,352,1
2020-08-20,Trinity,105,12862,44,8,6,14,0
2020-08-20,Tulare,107,460477,13957,12907,51,12958,217
2020-08-20,Tuolumne,109,53932,181,159,3,162,1
2020-08-20,Ventura,111,848112,10770,9744,69,9813,93
2020-08-20,Yolo,113,214977,2321,2150,4,2154,47
2020-08-20,Yuba,115,75493,779,709,3,712,1
2020-08-19,Alameda,001,1643700,17634,15874,121,15995,226
2020-08-19,Alpine,003,1148,2,2,0,2,0
2020-08-19,Amador,005,37829,263,219,0,219,9
2020-08-19,Butte,007,227075,1707,1517,18,1535,16
2020-08-19,Calaveras,009,45235,212,177,0,177,1
2020-08-19,Colusa,011,21464,435,415,0,415,5
2020-08-19,Contra Costa,013,1133247,13537,11895,43,11938,142
2020-08-19,Del Norte,015,27424,112,78,0,78,1
2020-08-19,El Dorado,017,186661,968,870,0,870,2
2020-08-19,Fresno,019,978130,26276,22167,274,22441,221
2020-08-19,Glenn,021,27897,425,414,0,414,2
2020-08-19,Humboldt,023,135768,355,316,1,317,4
2020-08-19,Imperial,025,180216,11056,9041,8,9049,192
2020-08-19,Inyo,027,18085,165,140,3,143,1
2020-08-19,Kern,029,883053,28914,27142,188,27330,263
2020-08-19,Kings,031,150075,5840,5301,32,5333,59
2020-08-19,Lake,033,64148,313,277,0,277,2
2020-08-19,Lassen,035,31185,711,693,2,695,0
2020-08-19,Los Angeles,037,10098052,232742,226006,993,226999,5399
2020-08-19,Madera,039,155013,3698,3158,22,3180,30
2020-08-19,Marin,041,260295,5968,5723,13,5736,46
2020-08-19,Mariposa,043,17540,71,64,0,64,2
2020-08-19,Mendocino,045,87422,559,495,0,495,8
2020-08-19,Merced,047,269075,7540,7082,5,7087,66
2020-08-19,Modoc,049,8938,7,5,0,5,0
2020-08-19,Mono,051,14174,163,128,2,130,1
2020-08-19,Monterey,053,433212,7450,6693,21,6714,45
2020-08-19,Napa,055,140530,1408,1293,5,1298,10
2020-08-19,Nevada,057,99092,430,398,13,411,2
2020-08-19,Orange,059,3164182,48618,43938,1088,45026,829
2020-08-19,Placer,061,380077,2894,2659,6,2665,28
2020-08-19,Plumas,063,18699,39,36,0,36,0
2020-08-19,Riverside,065,2383286,51703,48741,54,48795,922
2020-08-19,Sacramento,067,1510023,17002,14764,15,14779,229
2020-08-19,San Benito,069,59416,994,853,0,853,3
2020-08-19,San Bernardino,071,2135413,47234,43224,267,43491,661
2020-08-19,San Diego,073,3302833,37396,35378,259,35637,638
2020-08-19,San Francisco,075,870044,9041,8236,9,8245,72
2020-08-19,San Joaquin,077,732212,17666,15677,29,15706,296
2020-08-19,San Luis Obispo,079,281455,2848,2553,16,2569,19
2020-08-19,San Mateo,081,765935,8000,7146,8,7154,119
2020-08-19,Santa Barbara,083,443738,7863,7499,69,7568,80
2020-08-19,Santa Clara,085,1922200,17089,14994,36,15030,189
2020-08-19,Santa Cruz,087,273765,1731,1554,15,1569,6
2020-08-19,Shasta,089,179085,593,475,3,478,9
2020-08-19,Sierra,091,2930,6,6,0,6,0
2020-08-19,Siskiyou,093,43540,121,103,1,104,0
2020-08-19,Solano,095,438530,5175,4807,32,4839,31
2020-08-19,Sonoma,097,501317,5322,4614,18,4632,54
2020-08-19,Stanislaus,099,539301,14445,13084,222,13306,160
2020-08-19,Sutter,101,95872,1233,1146,1,1147,8
2020-08-19,Tehama,103,63373,391,342,2,344,1
2020-08-19,Trinity,105,12862,43,8,6,14,0
2020-08-19,Tulare,107,460477,13859,12756,51,12807,217
2020-08-19,Tuolumne,109,53932,178,159,3,162,1
2020-08-19,Ventura,111,848112,10678,9587,67,9654,91
2020-08-19,Yolo,113,214977,2299,2126,4,2130,47
2020-08-19,Yuba,115,75493,767,701,3,704,1
2020-08-18,Alameda,001,1643700,17457,15627,119,15746,223
2020-08-18,Alpine,003,1148,2,2,0,2,0
2020-08-18,Amador,005,37829,262,215,0,215,9
2020-08-18,Butte,007,227075,1674,1491,18,1509,16
2020-08-18,Calaveras,009,45235,208,174,0,174,1
2020-08-18,Colusa,011,21464,434,415,0,415,5
2020-08-18,Contra Costa,013,1133247,13417,11689,41,11730,141
2020-08-18,Del Norte,015,27424,111,78,0,78,0
2020-08-18,El Dorado,017,186661,963,866,0,866,2
2020-08-18,Fresno,019,978130,26055,21798,268,22066,212
2020-08-18,Glenn,021,27897,425,407,0,407,2
2020-08-18,Humboldt,023,135768,353,315,1,316,4
2020-08-18,Imperial,025,180216,11022,8968,8,8976,189
2020-08-18,Inyo,027,18085,164,140,3,143,1
2020-08-18,Kern,029,883053,28761,26978,184,27162,263
2020-08-18,Kings,031,150075,5805,5269,31,5300,58
2020-08-18,Lake,033,64148,310,274,0,274,2
2020-08-18,Lassen,035,31185,711,693,2,695,0
2020-08-18,Los Angeles,037,10098052,231483,224218,956,225174,5339
2020-08-18,Madera,039,155013,3670,3125,22,3147,28
2020-08-18,Marin,041,260295,5938,5708,13,5721,47
2020-08-18,Mariposa,043,17540,71,61,0,61,2
2020-08-18,Mendocino,045,87422,550,468,0,468,8
2020-08-18,Merced,047,269075,7492,6940,5,6945,66
2020-08-18,Modoc,049,8938,7,5,0,5,0
2020-08-18,Mono,051,14174,162,129,2,131,1
2020-08-18,Monterey,053,433212,7358,6691,20,6711,44
2020-08-18,Napa,055,140530,1405,1274,5,1279,10
2020-08-18,Nevada,057,99092,423,389,13,402,2
2020-08-18,Orange,059,3164182,48393,43659,1073,44732,809
2020-08-18,Placer,061,380077,2868,2644,5,2649,28
2020-08-18,Plumas,063,18699,39,34,0,34,0
2020-08-18,Riverside,065,2383286,51372,48447,54,48501,917
2020-08-18,Sacramento,067,1510023,16772,14610,14,14624,222
2020-08-18,San Benito,069,59416,974,836,0,836,3
2020-08-18,San Bernardino,071,2135413,46952,42827,261,43088,648
2020-08-18,San Diego,073,3302833,37103,35164,227,35391,633
2020-08-18,San Francisco,075,870044,8955,8016,9,8025,72
2020-08-18,San Joaquin,077,732212,17550,15509,28,15537,290
2020-08-18,San Luis Obispo,079,281455,2823,2535,15,2550,18
2020-08-18,San Mateo,081,765935,7938,7074,8,7082,119
2020-08-18,Santa Barbara,083,443738,7821,7472,69,7541,81
2020-08-18,Santa Clara,085,1922200,16916,14786,35,14821,184
2020-08-18,Santa Cruz,087,273765,1718,1509,15,1524,6
2020-08-18,Shasta,089,179085,589,468,3,471,9
2020-08-18,Sierra,091,2930,6,6,0,6,0
2020-08-18,Siskiyou,093,43540,120,103,1,104,0
2020-08-18,Solano,095,438530,5148,4700,32,4732,31
2020-08-18,Sonoma,097,501317,5253,4506,18,4524,48
2020-08-18,Stanislaus,099,539301,14347,12935,206,13141,149
2020-08-18,Sutter,101,95872,1214,1126,1,1127,8
2020-08-18,Tehama,103,63373,381,333,2,335,1
2020-08-18,Trinity,105,12862,41,8,6,14,0
2020-08-18,Tulare,107,460477,13728,12637,48,12685,212
2020-08-18,Tuolumne,109,53932,175,159,3,162,1
2020-08-18,Ventura,111,848112,10588,9536,62,9598,89
2020-08-18,Yolo,113,214977,2277,2102,4,2106,47
2020-08-18,Yuba,115,75493,759,679,3,682,1
2020-08-17,Alameda,001,1643700,17263,15454,118,15572,221
2020-08-17,Alpine,003,1148,2,2,0,2,0
2020-08-17,Amador,005,37829,262,215,0,215,9
2020-08-17,Butte,007,227075,1629,1463,18,1481,15
2020-08-17,Calaveras,009,45235,204,167,0,167,1
2020-08-17,Colusa,011,21464,431,408,0,408,5
2020-08-17,Contra Costa,013,1133247,13280,11442,41,11483,141
2020-08-17,Del Norte,015,27424,107,77,0,77,0
2020-08-17,El Dorado,017,186661,960,846,0,846,2
2020-08-17,Fresno,019,978130,25847,21316,261,21577,211
2020-08-17,Glenn,021,27897,424,402,0,402,2
2020-08-17,Humboldt,023,135768,349,302,1,303,4
2020-08-17,Imperial,025,180216,10981,8897,8,8905,188
2020-08-17,Inyo,027,18085,156,124,3,127,1
2020-08-17,Kern,029,883053,28614,26773,173,26946,249
2020-08-17,Kings,031,150075,5767,5249,31,5280,58
2020-08-17,Lake,033,64148,305,270,0,270,2
2020-08-17,Lassen,035,31185,711,666,2,668,0
2020-08-17,Los Angeles,037,10098052,229967,223418,908,224326,5282
2020-08-17,Madera,039,155013,3627,3050,21,3071,26
2020-08-17,Marin,041,260295,5915,5683,12,5695,46
2020-08-17,Mariposa,043,17540,71,61,0,61,2
2020-08-17,Mendocino,045,87422,532,454,0,454,8
2020-08-17,Merced,047,269075,7397,6814,5,6819,66
2020-08-17,Modoc,049,8938,7,5,0,5,0
2020-08-17,Mono,051,14174,162,126,2,128,1
2020-08-17,Monterey,053,433212,7258,6553,20,6573,44
2020-08-17,Napa,055,140530,1384,1255,5,1260,10
2020-08-17,Nevada,057,99092,418,383,13,396,2
2020-08-17,Orange,059,3164182,48183,43621,1060,44681,804
2020-08-17,Placer,061,380077,2843,2609,5,2614,28
2020-08-17,Plumas,063,18699,39,33,0,33,0
2020-08-17,Riverside,065,2383286,51040,48062,52,48114,916
2020-08-17,Sacramento,067,1510023,16552,14333,14,14347,219
2020-08-17,San Benito,069,59416,959,822,0,822,2
2020-08-17,San Bernardino,071,2135413,46607,42005,253,42258,604
2020-08-17,San Diego,073,3302833,36837,34962,213,35175,626
2020-08-17,San Francisco,075,870044,8884,7600,9,7609,72
2020-08-17,San Joaquin,077,732212,17387,15323,27,15350,280
2020-08-17,San Luis Obispo,079,281455,2790,2527,15,2542,18
2020-08-17,San Mateo,081,765935,7881,6987,7,6994,118
2020-08-17,Santa Barbara,083,443738,7779,7438,69,7507,80
2020-08-17,Santa Clara,085,1922200,16695,14546,35,14581,183
2020-08-17,Santa Cruz,087,273765,1702,1453,14,1467,6
2020-08-17,Shasta,089,179085,583,467,3,470,9
2020-08-17,Sierra,091,2930,6,6,0,6,0
2020-08-17,Siskiyou,093,43540,119,103,0,103,0
2020-08-17,Solano,095,438530,5091,4479,32,4511,31
2020-08-17,Sonoma,097,501317,5165,4402,16,4418,48
2020-08-17,Stanislaus,099,539301,14222,12745,199,12944,148
2020-08-17,Sutter,101,95872,1198,1071,1,1072,8
2020-08-17,Tehama,103,63373,372,324,2,326,1
2020-08-17,Trinity,105,12862,41,8,6,14,0
2020-08-17,Tulare,107,460477,13615,12487,47,12534,210
2020-08-17,Tuolumne,109,53932,172,157,3,160,1
2020-08-17,Ventura,111,848112,10465,9490,57,9547,89
2020-08-17,Yolo,113,214977,2250,2083,4,2087,47
2020-08-17,Yuba,115,75493,744,647,3,650,1
2020-08-16,Alameda,001,1643700,16972,15338,118,15456,221
2020-08-16,Alpine,003,1148,2,2,0,2,0
2020-08-16,Amador,005,37829,259,215,0,215,9
2020-08-16,Butte,007,227075,1591,1432,18,1450,15
2020-08-16,Calaveras,009,45235,197,167,0,167,1
2020-08-16,Colusa,011,21464,429,407,0,407,5
2020-08-16,Contra Costa,013,1133247,13094,11255,41,11296,140
2020-08-16,Del Norte,015,27424,103,77,0,77,0
2020-08-16,El Dorado,017,186661,948,843,0,843,2
2020-08-16,Fresno,019,978130,25626,21010,256,21266,211
2020-08-16,Glenn,021,27897,422,400,0,400,2
2020-08-16,Humboldt,023,135768,347,301,1,302,4
2020-08-16,Imperial,025,180216,10937,8883,8,8891,188
2020-08-16,Inyo,027,18085,149,125,2,127,1
2020-08-16,Kern,029,883053,28415,26520,165,26685,249
2020-08-16,Kings,031,150075,5736,5146,31,5177,58
2020-08-16,Lake,033,64148,301,269,0,269,2
2020-08-16,Lassen,035,31185,711,666,2,668,0
2020-08-16,Los Angeles,037,10098052,228397,222236,878,223114,5263
2020-08-16,Madera,039,155013,3582,3013,21,3034,26
2020-08-16,Marin,041,260295,5889,5664,12,5676,46
2020-08-16,Mariposa,043,17540,71,61,0,61,2
2020-08-16,Mendocino,045,87422,524,451,0,451,8
2020-08-16,Merced,047,269075,7315,6744,5,6749,66
2020-08-16,Modoc,049,8938,7,5,0,5,0
2020-08-16,Mono,051,14174,162,126,2,128,1
2020-08-16,Monterey,053,433212,7160,6516,19,6535,44
2020-08-16,Napa,055,140530,1366,1241,3,1244,10
2020-08-16,Nevada,057,99092,409,379,13,392,2
2020-08-16,Orange,059,3164182,47934,43303,1049,44352,803
2020-08-16,Placer,061,380077,2814,2583,4,2587,28
2020-08-16,Plumas,063,18699,39,33,0,33,0
2020-08-16,Riverside,065,2383286,50709,47669,51,47720,910
2020-08-16,Sacramento,067,1510023,16312,14210,14,14224,219
2020-08-16,San Benito,069,59416,930,815,0,815,2
2020-08-16,San Bernardino,071,2135413,46183,41724,245,41969,603
2020-08-16,San Diego,073,3302833,36573,34680,198,34878,626
2020-08-16,San Francisco,075,870044,8797,7602,9,7611,72
2020-08-16,San Joaquin,077,732212,17184,15288,27,15315,280
2020-08-16,San Luis Obispo,079,281455,2761,2494,15,2509,17
2020-08-16,San Mateo,081,765935,7806,6942,7,6949,118
2020-08-16,Santa Barbara,083,443738,7730,7368,69,7437,79
2020-08-16,Santa Clara,085,1922200,16497,14329,35,14364,183
2020-08-16,Santa Cruz,087,273765,1675,1449,13,1462,6
2020-08-16,Shasta,089,179085,576,465,3,468,9
2020-08-16,Sierra,091,2930,6,6,0,6,0
2020-08-16,Siskiyou,093,43540,118,102,0,102,0
2020-08-16,Solano,095,438530,5031,4479,32,4511,31
2020-08-16,Sonoma,097,501317,5061,4329,16,4345,46
2020-08-16,Stanislaus,099,539301,14064,12668,189,12857,148
2020-08-16,Sutter,101,95872,1180,1071,1,1072,8
2020-08-16,Tehama,103,63373,362,318,2,320,1
2020-08-16,Trinity,105,12862,38,8,6,14,0
2020-08-16,Tulare,107,460477,13483,12334,44,12378,211
2020-08-16,Tuolumne,109,53932,172,156,3,159,1
2020-08-16,Ventura,111,848112,10356,9408,52,9460,89
2020-08-16,Yolo,113,214977,2231,2057,4,2061,47
2020-08-16,Yuba,115,75493,735,647,2,649,1
2020-08-15,Alameda,001,1643700,16895,15165,118,15283,221
2020-08-15,Alpine,003,1148,2,2,0,2,0
2020-08-15,Amador,005,37829,259,210,0,210,9
2020-08-15,Butte,007,227075,1569,1409,18,1427,15
2020-08-15,Calaveras,009,45235,195,167,0,167,1
2020-08-15,Colusa,011,21464,428,401,0,401,5
2020-08-15,Contra Costa,013,1133247,12998,11106,41,11147,138
2020-08-15,Del Norte,015,27424,103,77,0,77,0
2020-08-15,El Dorado,017,186661,943,838,0,838,2
2020-08-15,Fresno,019,978130,25510,20603,254,20857,211
2020-08-15,Glenn,021,27897,422,398,0,398,2
2020-08-15,Humboldt,023,135768,346,301,1,302,4
2020-08-15,Imperial,025,180216,10917,8794,8,8802,188
2020-08-15,Inyo,027,18085,149,123,2,125,1
2020-08-15,Kern,029,883053,28327,26338,165,26503,249
2020-08-15,Kings,031,150075,5718,5039,31,5070,56
2020-08-15,Lake,033,64148,299,268,0,268,2
2020-08-15,Lassen,035,31185,711,666,2,668,0
2020-08-15,Los Angeles,037,10098052,227647,221043,868,221911,5252
2020-08-15,Madera,039,155013,3532,2950,21,2971,26
2020-08-15,Marin,041,260295,5882,5628,12,5640,46
2020-08-15,Mariposa,043,17540,71,61,0,61,2
2020-08-15,Mendocino,045,87422,520,444,0,444,8
2020-08-15,Merced,047,269075,7281,6656,5,6661,66
2020-08-15,Modoc,049,8938,7,5,0,5,0
2020-08-15,Mono,051,14174,162,126,2,128,1
2020-08-15,Monterey,053,433212,7115,6162,19,6181,44
2020-08-15,Napa,055,140530,1356,1232,3,1235,10
2020-08-15,Nevada,057,99092,409,376,13,389,2
2020-08-15,Orange,059,3164182,47821,42811,1038,43849,801
2020-08-15,Placer,061,380077,2793,2551,4,2555,27
2020-08-15,Plumas,063,18699,39,33,0,33,0
2020-08-15,Riverside,065,2383286,50558,46720,51,46771,910
2020-08-15,Sacramento,067,1510023,16202,14018,14,14032,219
2020-08-15,San Benito,069,59416,917,805,0,805,2
2020-08-15,San Bernardino,071,2135413,46031,41231,243,41474,602
2020-08-15,San Diego,073,3302833,36407,34346,184,34530,639
2020-08-15,San Francisco,075,870044,8733,7601,9,7610,69
2020-08-15,San Joaquin,077,732212,17111,15113,27,15140,280
2020-08-15,San Luis Obispo,079,281455,2744,2461,15,2476,17
2020-08-15,San Mateo,081,765935,7769,6860,7,6867,118
2020-08-15,Santa Barbara,083,443738,7702,7338,69,7407,79
2020-08-15,Santa Clara,085,1922200,16401,14105,35,14140,183
2020-08-15,Santa Cruz,087,273765,1654,1449,13,1462,6
2020-08-15,Shasta,089,179085,573,458,3,461,9
2020-08-15,Sierra,091,2930,6,6,0,6,0
2020-08-15,Siskiyou,093,43540,117,100,0,100,0
2020-08-15,Solano,095,438530,5009,4477,32,4509,31
2020-08-15,Sonoma,097,501317,5006,4134,16,4150,45
2020-08-15,Stanislaus,099,539301,14000,12541,188,12729,149
2020-08-15,Sutter,101,95872,1169,1046,1,1047,8
2020-08-15,Tehama,103,63373,361,312,2,314,1
2020-08-15,Trinity,105,12862,36,6,6,12,0
2020-08-15,Tulare,107,460477,13445,12262,44,12306,211
2020-08-15,Tuolumne,109,53932,172,155,3,158,1
2020-08-15,Ventura,111,848112,10297,9379,50,9429,89
2020-08-15,Yolo,113,214977,2219,2031,4,2035,46
2020-08-15,Yuba,115,75493,731,623,2,625,1
2020-08-14,Alameda,001,1643700,16756,14909,118,15027,221
2020-08-14,Alpine,003,1148,2,2,0,2,0
2020-08-14,Amador,005,37829,259,209,0,209,9
2020-08-14,Butte,007,227075,1560,1384,18,1402,15
2020-08-14,Calaveras,009,45235,191,165,0,165,1
2020-08-14,Colusa,011,21464,426,399,0,399,5
2020-08-14,Contra Costa,013,1133247,12886,10893,41,10934,137
2020-08-14,Del Norte,015,27424,103,76,0,76,0
2020-08-14,El Dorado,017,186661,935,827,0,827,2
2020-08-14,Fresno,019,978130,25376,19900,254,20154,208
2020-08-14,Glenn,021,27897,420,395,0,395,2
2020-08-14,Humboldt,023,135768,340,294,1,295,4
2020-08-14,Imperial,025,180216,10893,8756,8,8764,185
2020-08-14,Inyo,027,18085,148,115,2,117,1
2020-08-14,Kern,029,883053,28223,25893,164,26057,249
2020-08-14,Kings,031,150075,5704,4953,31,4984,56
2020-08-14,Lake,033,64148,290,267,0,267,2
2020-08-14,Lassen,035,31185,711,665,2,667,0
2020-08-14,Los Angeles,037,10098052,226480,219083,851,219934,5222
2020-08-14,Madera,039,155013,3502,2876,21,2897,26
2020-08-14,Marin,041,260295,5871,5601,12,5613,46
2020-08-14,Mariposa,043,17540,70,61,0,61,2
2020-08-14,Mendocino,045,87422,511,432,0,432,8
2020-08-14,Merced,047,269075,7251,6466,5,6471,67
2020-08-14,Modoc,049,8938,7,5,0,5,0
2020-08-14,Mono,051,14174,162,126,2,128,1
2020-08-14,Monterey,053,433212,7064,6121,19,6140,41
2020-08-14,Napa,055,140530,1346,1230,3,1233,10
2020-08-14,Nevada,057,99092,405,377,13,390,2
2020-08-14,Orange,059,3164182,47671,42399,1025,43424,798
2020-08-14,Placer,061,380077,2774,2546,4,2550,26
2020-08-14,Plumas,063,18699,38,33,0,33,0
2020-08-14,Riverside,065,2383286,50329,46456,51,46507,891
2020-08-14,Sacramento,067,1510023,16052,13645,14,13659,212
2020-08-14,San Benito,069,59416,900,783,0,783,2
2020-08-14,San Bernardino,071,2135413,45844,40442,240,40682,594
2020-08-14,San Diego,073,3302833,36213,34067,177,34244,622
2020-08-14,San Francisco,075,870044,8674,7467,9,7476,69
2020-08-14,San Joaquin,077,732212,17011,14925,27,14952,276
2020-08-14,San Luis Obispo,079,281455,2729,2422,15,2437,17
2020-08-14,San Mateo,081,765935,7710,6655,7,6662,118
2020-08-14,Santa Barbara,083,443738,7652,7302,69,7371,77
2020-08-14,Santa Clara,085,1922200,16235,13785,34,13819,183
2020-08-14,Santa Cruz,087,273765,1632,1418,12,1430,6
2020-08-14,Shasta,089,179085,568,446,3,449,9
2020-08-14,Sierra,091,2930,6,5,0,5,0
2020-08-14,Siskiyou,093,43540,117,98,0,98,0
2020-08-14,Solano,095,438530,4988,4421,32,4453,31
2020-08-14,Sonoma,097,501317,4946,4087,13,4100,45
2020-08-14,Stanislaus,099,539301,13922,12379,184,12563,140
2020-08-14,Sutter,101,95872,1161,1039,1,1040,8
2020-08-14,Tehama,103,63373,357,305,2,307,1
2020-08-14,Trinity,105,12862,36,6,6,12,0
2020-08-14,Tulare,107,460477,13368,12009,44,12053,211
2020-08-14,Tuolumne,109,53932,171,155,3,158,1
2020-08-14,Ventura,111,848112,10222,9313,50,9363,89
2020-08-14,Yolo,113,214977,2205,1991,4,1995,45
2020-08-14,Yuba,115,75493,715,606,2,608,1
2020-08-13,Alameda,001,1643700,16479,14385,118,14503,218
2020-08-13,Alpine,003,1148,2,2,0,2,0
2020-08-13,Amador,005,37829,259,198,0,198,8
2020-08-13,Butte,007,227075,1535,1345,18,1363,15
2020-08-13,Calaveras,009,45235,189,162,0,162,1
2020-08-13,Colusa,011,21464,426,395,0,395,5
2020-08-13,Contra Costa,013,1133247,12732,10545,40,10585,136
2020-08-13,Del Norte,015,27424,102,74,0,74,0
2020-08-13,El Dorado,017,186661,930,803,0,803,2
2020-08-13,Fresno,019,978130,25149,19157,248,19405,201
2020-08-13,Glenn,021,27897,416,392,0,392,1
2020-08-13,Humboldt,023,135768,332,281,1,282,4
2020-08-13,Imperial,025,180216,10862,8640,8,8648,170
2020-08-13,Inyo,027,18085,144,97,2,99,1
2020-08-13,Kern,029,883053,28056,25472,161,25633,242
2020-08-13,Kings,031,150075,5669,4824,31,4855,52
2020-08-13,Lake,033,64148,285,263,0,263,2
2020-08-13,Lassen,035,31185,711,652,2,654,0
2020-08-13,Los Angeles,037,10098052,225104,216497,830,217327,5179
2020-08-13,Madera,039,155013,3458,2675,20,2695,25
2020-08-13,Marin,041,260295,5855,5503,12,5515,44
2020-08-13,Mariposa,043,17540,69,61,0,61,2
2020-08-13,Mendocino,045,87422,506,401,0,401,8
2020-08-13,Merced,047,269075,7134,5945,5,5950,63
2020-08-13,Modoc,049,8938,7,5,0,5,0
2020-08-13,Mono,051,14174,162,124,2,126,1
2020-08-13,Monterey,053,433212,6981,5925,19,5944,38
2020-08-13,Napa,055,140530,1337,1179,3,1182,10
2020-08-13,Nevada,057,99092,401,362,13,375,1
2020-08-13,Orange,059,3164182,47432,42019,1013,43032,773
2020-08-13,Placer,061,380077,2751,2460,4,2464,26
2020-08-13,Plumas,063,18699,38,32,0,32,0
2020-08-13,Riverside,065,2383286,50033,45327,51,45378,885
2020-08-13,Sacramento,067,1510023,15850,13237,14,13251,197
2020-08-13,San Benito,069,59416,871,757,0,757,2
2020-08-13,San Bernardino,071,2135413,45449,39395,234,39629,591
2020-08-13,San Diego,073,3302833,35977,33661,159,33820,627
2020-08-13,San Francisco,075,870044,8580,7277,9,7286,69
2020-08-13,San Joaquin,077,732212,16856,14537,26,14563,261
2020-08-13,San Luis Obispo,079,281455,2707,2283,15,2298,16
2020-08-13,San Mateo,081,765935,7648,6503,7,6510,117
2020-08-13,Santa Barbara,083,443738,7607,7129,68,7197,74
2020-08-13,Santa Clara,085,1922200,16012,13257,34,13291,182
2020-08-13,Santa Cruz,087,273765,1607,1383,12,1395,6
2020-08-13,Shasta,089,179085,563,428,3,431,9
2020-08-13,Sierra,091,2930,6,5,0,5,0
2020-08-13,Siskiyou,093,43540,117,95,0,95,0
2020-08-13,Solano,095,438530,4951,4305,32,4337,31
2020-08-13,Sonoma,097,501317,4872,3902,13,3915,45
2020-08-13,Stanislaus,099,539301,13792,11953,168,12121,136
2020-08-13,Sutter,101,95872,1139,992,1,993,8
2020-08-13,Tehama,103,63373,348,302,2,304,1
2020-08-13,Trinity,105,12862,35,6,6,12,0
2020-08-13,Tulare,107,460477,13224,11692,41,11733,210
2020-08-13,Tuolumne,109,53932,170,152,3,155,1
2020-08-13,Ventura,111,848112,10133,9114,50,9164,90
2020-08-13,Yolo,113,214977,2178,1938,4,1942,44
2020-08-13,Yuba,115,75493,699,568,2,570,1
2020-08-12,Alameda,001,1643700,16266,14214,118,14332,215
2020-08-12,Alpine,003,1148,2,2,0,2,0
2020-08-12,Amador,005,37829,256,197,0,197,8
2020-08-12,Butte,007,227075,1507,1317,18,1335,15
2020-08-12,Calaveras,009,45235,186,157,0,157,1
2020-08-12,Colusa,011,21464,421,394,0,394,5
2020-08-12,Contra Costa,013,1133247,12587,10304,39,10343,134
2020-08-12,Del Norte,015,27424,101,74,0,74,0
2020-08-12,El Dorado,017,186661,912,794,0,794,2
2020-08-12,Fresno,019,978130,24919,18690,242,18932,194
2020-08-12,Glenn,021,27897,413,388,0,388,1
2020-08-12,Humboldt,023,135768,325,281,1,282,4
2020-08-12,Imperial,025,180216,10839,8566,8,8574,167
2020-08-12,Inyo,027,18085,127,97,2,99,1
2020-08-12,Kern,029,883053,27864,25191,159,25350,232
2020-08-12,Kings,031,150075,5630,4736,31,4767,50
2020-08-12,Lake,033,64148,283,253,0,253,2
2020-08-12,Lassen,035,31185,710,651,2,653,0
2020-08-12,Los Angeles,037,10098052,223704,214542,814,215356,5119
2020-08-12,Madera,039,155013,3424,2681,18,2699,23
2020-08-12,Marin,041,260295,5833,5423,12,5435,44
2020-08-12,Mariposa,043,17540,69,61,0,61,2
2020-08-12,Mendocino,045,87422,487,386,0,386,9
2020-08-12,Merced,047,269075,7072,5777,5,5782,66
2020-08-12,Modoc,049,8938,7,5,0,5,0
2020-08-12,Mono,051,14174,161,124,2,126,1
2020-08-12,Monterey,053,433212,6877,5919,19,5938,38
2020-08-12,Napa,055,140530,1327,1161,3,1164,10
2020-08-12,Nevada,057,99092,396,357,13,370,1
2020-08-12,Orange,059,3164182,47181,41576,989,42565,754
2020-08-12,Placer,061,380077,2719,2417,4,2421,25
2020-08-12,Plumas,063,18699,38,31,0,31,0
2020-08-12,Riverside,065,2383286,49685,44747,51,44798,867
2020-08-12,Sacramento,067,1510023,15638,12528,14,12542,189
2020-08-12,San Benito,069,59416,858,751,0,751,2
2020-08-12,San Bernardino,071,2135413,45106,38811,225,39036,589
2020-08-12,San Diego,073,3302833,35768,33395,139,33534,608
2020-08-12,San Francisco,075,870044,8497,7194,9,7203,66
2020-08-12,San Joaquin,077,732212,16710,14154,26,14180,253
2020-08-12,San Luis Obispo,079,281455,2682,2263,15,2278,15
2020-08-12,San Mateo,081,765935,7569,6427,7,6434,117
2020-08-12,Santa Barbara,083,443738,7547,7049,66,7115,74
2020-08-12,Santa Clara,085,1922200,15836,13002,34,13036,182
2020-08-12,Santa Cruz,087,273765,1578,1382,11,1393,6
2020-08-12,Shasta,089,179085,559,417,3,420,9
2020-08-12,Sierra,091,2930,5,4,0,4,0
2020-08-12,Siskiyou,093,43540,116,90,0,90,0
2020-08-12,Solano,095,438530,4906,4258,32,4290,31
2020-08-12,Sonoma,097,501317,4798,3847,13,3860,47
2020-08-12,Stanislaus,099,539301,13653,11682,160,11842,136
2020-08-12,Sutter,101,95872,1115,987,1,988,7
2020-08-12,Tehama,103,63373,338,289,2,291,1
2020-08-12,Trinity,105,12862,34,6,6,12,0
2020-08-12,Tulare,107,460477,13096,11460,41,11501,211
2020-08-12,Tuolumne,109,53932,169,150,3,153,1
2020-08-12,Ventura,111,848112,10046,9005,50,9055,87
2020-08-12,Yolo,113,214977,2154,1921,4,1925,44
2020-08-12,Yuba,115,75493,677,549,1,550,1
2020-08-11,Alameda,001,1643700,16005,13960,115,14075,204
2020-08-11,Alpine,003,1148,2,2,0,2,0
2020-08-11,Amador,005,37829,250,187,0,187,3
2020-08-11,Butte,007,227075,1480,1296,18,1314,15
2020-08-11,Calaveras,009,45235,184,161,0,161,1
2020-08-11,Colusa,011,21464,416,390,0,390,5
2020-08-11,Contra Costa,013,1133247,12398,10012,37,10049,131
2020-08-11,Del Norte,015,27424,100,73,0,73,0
2020-08-11,El Dorado,017,186661,905,786,0,786,2
2020-08-11,Fresno,019,978130,24597,18344,239,18583,187
2020-08-11,Glenn,021,27897,411,380,0,380,1
2020-08-11,Humboldt,023,135768,320,283,1,284,4
2020-08-11,Imperial,025,180216,10784,8518,8,8526,165
2020-08-11,Inyo,027,18085,122,97,2,99,1
2020-08-11,Kern,029,883053,27529,25042,157,25199,230
2020-08-11,Kings,031,150075,5439,4696,31,4727,50
2020-08-11,Lake,033,64148,280,243,0,243,2
2020-08-11,Lassen,035,31185,704,605,2,607,0
2020-08-11,Los Angeles,037,10098052,222204,212421,789,213210,5065
2020-08-11,Madera,039,155013,3370,2673,18,2691,22
2020-08-11,Marin,041,260295,5805,5287,11,5298,44
2020-08-11,Mariposa,043,17540,68,60,0,60,2
2020-08-11,Mendocino,045,87422,477,385,0,385,9
2020-08-11,Merced,047,269075,6977,5322,4,5326,65
2020-08-11,Modoc,049,8938,7,5,0,5,0
2020-08-11,Mono,051,14174,161,124,2,126,1
2020-08-11,Monterey,053,433212,6769,5624,19,5643,36
2020-08-11,Napa,055,140530,1316,1143,2,1145,11
2020-08-11,Nevada,057,99092,393,358,13,371,1
2020-08-11,Orange,059,3164182,46961,41205,967,42172,742
2020-08-11,Placer,061,380077,2687,2393,4,2397,24
2020-08-11,Plumas,063,18699,38,31,0,31,0
2020-08-11,Riverside,065,2383286,49328,44237,51,44288,836
2020-08-11,Sacramento,067,1510023,15347,12298,14,12312,182
2020-08-11,San Benito,069,59416,846,750,0,750,2
2020-08-11,San Bernardino,071,2135413,44765,38467,218,38685,584
2020-08-11,San Diego,073,3302833,35501,33159,120,33279,602
2020-08-11,San Francisco,075,870044,8401,6988,9,6997,66
2020-08-11,San Joaquin,077,732212,16532,13997,21,14018,251
2020-08-11,San Luis Obispo,079,281455,2625,2234,15,2249,15
2020-08-11,San Mateo,081,765935,7495,6339,7,6346,117
2020-08-11,Santa Barbara,083,443738,7498,6942,66,7008,70
2020-08-11,Santa Clara,085,1922200,15614,12920,34,12954,183
2020-08-11,Santa Cruz,087,273765,1555,1352,11,1363,4
2020-08-11,Shasta,089,179085,555,416,3,419,9
2020-08-11,Sierra,091,2930,5,4,0,4,0
2020-08-11,Siskiyou,093,43540,116,90,0,90,0
2020-08-11,Solano,095,438530,4858,4206,31,4237,31
2020-08-11,Sonoma,097,501317,4704,3752,13,3765,45
2020-08-11,Stanislaus,099,539301,13549,11592,148,11740,128
2020-08-11,Sutter,101,95872,1093,964,1,965,7
2020-08-11,Tehama,103,63373,334,289,2,291,1
2020-08-11,Trinity,105,12862,34,5,6,11,0
2020-08-11,Tulare,107,460477,12971,11392,40,11432,201
2020-08-11,Tuolumne,109,53932,164,146,3,149,1
2020-08-11,Ventura,111,848112,9978,8953,49,9002,88
2020-08-11,Yolo,113,214977,2132,1912,4,1916,44
2020-08-11,Yuba,115,75493,666,540,1,541,1
2020-08-10,Alameda,001,1643700,15765,13420,114,13534,203
2020-08-10,Alpine,003,1148,2,2,0,2,0
2020-08-10,Amador,005,37829,249,172,0,172,2
2020-08-10,Butte,007,227075,1456,1174,16,1190,15
2020-08-10,Calaveras,009,45235,174,121,0,121,1
2020-08-10,Colusa,011,21464,414,387,0,387,4
2020-08-10,Contra Costa,013,1133247,12245,9454,35,9489,130
2020-08-10,Del Norte,015,27424,98,69,0,69,0
2020-08-10,El Dorado,017,186661,893,771,0,771,2
2020-08-10,Fresno,019,978130,24316,17978,238,18216,183
2020-08-10,Glenn,021,27897,408,381,0,381,1
2020-08-10,Humboldt,023,135768,314,277,1,278,4
2020-08-10,Imperial,025,180216,10740,8465,8,8473,165
2020-08-10,Inyo,027,18085,122,97,2,99,1
2020-08-10,Kern,029,883053,27303,24499,156,24655,215
2020-08-10,Kings,031,150075,5333,4588,31,4619,50
2020-08-10,Lake,033,64148,273,239,0,239,2
2020-08-10,Lassen,035,31185,704,588,2,590,0
2020-08-10,Los Angeles,037,10098052,220629,211035,771,211806,5003
2020-08-10,Madera,039,155013,3337,2365,17,2382,22
2020-08-10,Marin,041,260295,5760,5242,10,5252,44
2020-08-10,Mariposa,043,17540,68,57,0,57,2
2020-08-10,Mendocino,045,87422,453,364,0,364,1
2020-08-10,Merced,047,269075,6896,4913,4,4917,51
2020-08-10,Modoc,049,8938,7,5,0,5,0
2020-08-10,Mono,051,14174,161,123,2,125,1
2020-08-10,Monterey,053,433212,6659,5358,19,5377,34
2020-08-10,Napa,055,140530,1298,1084,2,1086,8
2020-08-10,Nevada,057,99092,385,356,13,369,1
2020-08-10,Orange,059,3164182,46691,40445,949,41394,721
2020-08-10,Placer,061,380077,2648,2298,4,2302,21
2020-08-10,Plumas,063,18699,38,27,0,27,0
2020-08-10,Riverside,065,2383286,48944,43296,50,43346,830
2020-08-10,Sacramento,067,1510023,15036,12059,14,12073,168
2020-08-10,San Benito,069,59416,833,743,0,743,2
2020-08-10,San Bernardino,071,2135413,44388,37367,209,37576,579
2020-08-10,San Diego,073,3302833,35235,32977,104,33081,594
2020-08-10,San Francisco,075,870044,8311,6816,8,6824,66
2020-08-10,San Joaquin,077,732212,16350,13308,21,13329,240
2020-08-10,San Luis Obispo,079,281455,2526,2208,14,2222,15
2020-08-10,San Mateo,081,765935,7418,6222,7,6229,117
2020-08-10,Santa Barbara,083,443738,7443,6869,66,6935,66
2020-08-10,Santa Clara,085,1922200,15354,12615,33,12648,182
2020-08-10,Santa Cruz,087,273765,1535,1239,10,1249,4
2020-08-10,Shasta,089,179085,551,384,3,387,9
2020-08-10,Sierra,091,2930,5,3,0,3,0
2020-08-10,Siskiyou,093,43540,113,88,0,88,0
2020-08-10,Solano,095,438530,4798,4101,31,4132,31
2020-08-10,Sonoma,097,501317,4535,3640,9,3649,42
2020-08-10,Stanislaus,099,539301,13367,10855,131,10986,106
2020-08-10,Sutter,101,95872,1068,865,1,866,7
2020-08-10,Tehama,103,63373,327,282,2,284,1
2020-08-10,Trinity,105,12862,31,5,6,11,0
2020-08-10,Tulare,107,460477,12798,10750,38,10788,194
2020-08-10,Tuolumne,109,53932,164,143,2,145,1
2020-08-10,Ventura,111,848112,9894,8851,48,8899,85
2020-08-10,Yolo,113,214977,2109,1840,4,1844,45
2020-08-10,Yuba,115,75493,649,527,1,528,1
2020-08-09,Alameda,001,1643700,15485,13241,112,13353,203
2020-08-09,Alpine,003,1148,2,2,0,2,0
2020-08-09,Amador,005,37829,244,153,0,153,2
2020-08-09,Butte,007,227075,1412,1155,16,1171,15
2020-08-09,Calaveras,009,45235,169,122,0,122,1
2020-08-09,Colusa,011,21464,410,371,0,371,4
2020-08-09,Contra Costa,013,1133247,12017,9214,34,9248,130
2020-08-09,Del Norte,015,27424,98,69,0,69,0
2020-08-09,El Dorado,017,186661,885,748,0,748,2
2020-08-09,Fresno,019,978130,24007,17846,234,18080,183
2020-08-09,Glenn,021,27897,406,354,0,354,1
2020-08-09,Humboldt,023,135768,308,279,1,280,4
2020-08-09,Imperial,025,180216,10697,8310,7,8317,165
2020-08-09,Inyo,027,18085,117,86,1,87,1
2020-08-09,Kern,029,883053,27047,23680,156,23836,215
2020-08-09,Kings,031,150075,5290,4446,30,4476,50
2020-08-09,Lake,033,64148,266,225,0,225,2
2020-08-09,Lassen,035,31185,698,589,2,591,0
2020-08-09,Los Angeles,037,10098052,218569,208810,749,209559,4984
2020-08-09,Madera,039,155013,3278,2322,13,2335,22
2020-08-09,Marin,041,260295,5717,5204,10,5214,44
2020-08-09,Mariposa,043,17540,66,56,0,56,2
2020-08-09,Mendocino,045,87422,443,283,0,283,1
2020-08-09,Merced,047,269075,6798,4735,3,4738,51
2020-08-09,Modoc,049,8938,7,4,0,4,0
2020-08-09,Mono,051,14174,160,113,2,115,1
2020-08-09,Monterey,053,433212,6535,5199,19,5218,34
2020-08-09,Napa,055,140530,1279,1062,2,1064,8
2020-08-09,Nevada,057,99092,377,332,13,345,1
2020-08-09,Orange,059,3164182,46392,39244,934,40178,722
2020-08-09,Placer,061,380077,2619,2211,4,2215,20
2020-08-09,Plumas,063,18699,38,27,0,27,0
2020-08-09,Riverside,065,2383286,48598,41894,50,41944,828
2020-08-09,Sacramento,067,1510023,14756,11301,14,11315,167
2020-08-09,San Benito,069,59416,814,687,0,687,2
2020-08-09,San Bernardino,071,2135413,43913,36092,209,36301,579
2020-08-09,San Diego,073,3302833,34944,32749,93,32842,594
2020-08-09,San Francisco,075,870044,8196,6820,8,6828,66
2020-08-09,San Joaquin,077,732212,16146,12933,20,12953,240
2020-08-09,San Luis Obispo,079,281455,2490,2124,14,2138,15
2020-08-09,San Mateo,081,765935,7323,6094,7,6101,117
2020-08-09,Santa Barbara,083,443738,7355,6669,66,6735,66
2020-08-09,Santa Clara,085,1922200,15084,11878,33,11911,181
2020-08-09,Santa Cruz,087,273765,1511,1246,10,1256,4
2020-08-09,Shasta,089,179085,547,361,3,364,9
2020-08-09,Sierra,091,2930,5,3,0,3,0
2020-08-09,Siskiyou,093,43540,112,74,0,74,0
2020-08-09,Solano,095,438530,4745,3954,30,3984,31
2020-08-09,Sonoma,097,501317,4399,3531,7,3538,41
2020-08-09,Stanislaus,099,539301,13159,10264,118,10382,106
2020-08-09,Sutter,101,95872,1034,857,1,858,7
2020-08-09,Tehama,103,63373,319,265,2,267,1
2020-08-09,Trinity,105,12862,31,5,6,11,0
2020-08-09,Tulare,107,460477,12606,10630,35,10665,194
2020-08-09,Tuolumne,109,53932,161,143,2,145,1
2020-08-09,Ventura,111,848112,9746,8633,47,8680,85
2020-08-09,Yolo,113,214977,2078,1765,4,1769,44
2020-08-09,Yuba,115,75493,629,442,1,443,1
2020-08-08,Alameda,001,1643700,15375,13087,112,13199,204
2020-08-08,Alpine,003,1148,2,2,0,2,0
2020-08-08,Amador,005,37829,244,139,0,139,2
2020-08-08,Butte,007,227075,1394,1140,16,1156,15
2020-08-08,Calaveras,009,45235,168,122,0,122,1
2020-08-08,Colusa,011,21464,409,368,0,368,4
2020-08-08,Contra Costa,013,1133247,11908,9104,34,9138,129
2020-08-08,Del Norte,015,27424,97,69,0,69,0
2020-08-08,El Dorado,017,186661,878,734,0,734,2
2020-08-08,Fresno,019,978130,23870,17538,232,17770,183
2020-08-08,Glenn,021,27897,406,344,0,344,1
2020-08-08,Humboldt,023,135768,305,277,1,278,4
2020-08-08,Imperial,025,180216,10682,8213,7,8220,165
2020-08-08,Inyo,027,18085,113,86,1,87,1
2020-08-08,Kern,029,883053,26933,22803,156,22959,215
2020-08-08,Kings,031,150075,5276,4367,30,4397,49
2020-08-08,Lake,033,64148,264,221,0,221,2
2020-08-08,Lassen,035,31185,698,589,2,591,0
2020-08-08,Los Angeles,037,10098052,217684,206971,738,207709,4974
2020-08-08,Madera,039,155013,3247,2275,13,2288,22
2020-08-08,Marin,041,260295,5697,5118,10,5128,44
2020-08-08,Mariposa,043,17540,65,55,0,55,2
2020-08-08,Mendocino,045,87422,441,264,0,264,1
2020-08-08,Merced,047,269075,6758,4570,3,4573,51
2020-08-08,Modoc,049,8938,7,4,0,4,0
2020-08-08,Mono,051,14174,160,113,2,115,1
2020-08-08,Monterey,053,433212,6477,5101,19,5120,33
2020-08-08,Napa,055,140530,1271,1062,2,1064,8
2020-08-08,Nevada,057,99092,375,325,13,338,1
2020-08-08,Orange,059,3164182,46262,38688,925,39613,718
2020-08-08,Placer,061,380077,2602,2153,4,2157,20
2020-08-08,Plumas,063,18699,38,27,0,27,0
2020-08-08,Riverside,065,2383286,48394,41412,50,41462,823
2020-08-08,Sacramento,067,1510023,14627,11144,14,11158,166
2020-08-08,San Benito,069,59416,806,684,0,684,2
2020-08-08,San Bernardino,071,2135413,43717,35691,208,35899,531
2020-08-08,San Diego,073,3302833,34755,32332,84,32416,593
2020-08-08,San Francisco,075,870044,8130,6820,8,6828,66
2020-08-08,San Joaquin,077,732212,16065,12559,19,12578,240
2020-08-08,San Luis Obispo,079,281455,2467,2081,14,2095,15
2020-08-08,San Mateo,081,765935,7265,6021,7,6028,117
2020-08-08,Santa Barbara,083,443738,7317,6598,66,6664,66
2020-08-08,Santa Clara,085,1922200,14932,11615,33,11648,181
2020-08-08,Santa Cruz,087,273765,1497,1247,10,1257,4
2020-08-08,Shasta,089,179085,545,343,3,346,9
2020-08-08,Sierra,091,2930,5,3,0,3,0
2020-08-08,Siskiyou,093,43540,112,73,0,73,0
2020-08-08,Solano,095,438530,4724,3889,29,3918,31
2020-08-08,Sonoma,097,501317,4368,3399,7,3406,41
2020-08-08,Stanislaus,099,539301,13084,9963,113,10076,105
2020-08-08,Sutter,101,95872,1024,830,1,831,7
2020-08-08,Tehama,103,63373,318,251,2,253,1
2020-08-08,Trinity,105,12862,31,5,6,11,0
2020-08-08,Tulare,107,460477,12530,10505,35,10540,192
2020-08-08,Tuolumne,109,53932,161,143,2,145,1
2020-08-08,Ventura,111,848112,9691,8462,46,8508,85
2020-08-08,Yolo,113,214977,2065,1725,4,1729,44
2020-08-08,Yuba,115,75493,620,430,1,431,1
2020-08-07,Alameda,001,1643700,15264,12805,112,12917,204
2020-08-07,Alpine,003,1148,2,2,0,2,0
2020-08-07,Amador,005,37829,242,125,0,125,2
2020-08-07,Butte,007,227075,1376,1092,16,1108,13
2020-08-07,Calaveras,009,45235,168,119,0,119,1
2020-08-07,Colusa,011,21464,408,358,0,358,4
2020-08-07,Contra Costa,013,1133247,11760,8810,34,8844,126
2020-08-07,Del Norte,015,27424,97,69,0,69,0
2020-08-07,El Dorado,017,186661,873,724,0,724,2
2020-08-07,Fresno,019,978130,23710,17290,232,17522,171
2020-08-07,Glenn,021,27897,405,339,0,339,1
2020-08-07,Humboldt,023,135768,301,274,1,275,4
2020-08-07,Imperial,025,180216,10657,8085,7,8092,164
2020-08-07,Inyo,027,18085,112,81,1,82,1
2020-08-07,Kern,029,883053,26807,22143,153,22296,206
2020-08-07,Kings,031,150075,5259,4315,30,4345,48
2020-08-07,Lake,033,64148,262,215,0,215,1
2020-08-07,Lassen,035,31185,697,588,2,590,0
2020-08-07,Los Angeles,037,10098052,216218,204406,726,205132,4924
2020-08-07,Madera,039,155013,3215,2245,13,2258,20
2020-08-07,Marin,041,260295,5668,5094,10,5104,43
2020-08-07,Mariposa,043,17540,65,53,0,53,2
2020-08-07,Mendocino,045,87422,427,262,0,262,1
2020-08-07,Merced,047,269075,6715,4358,3,4361,30
2020-08-07,Modoc,049,8938,7,4,0,4,0
2020-08-07,Mono,051,14174,160,112,2,114,1
2020-08-07,Monterey,053,433212,6402,5041,19,5060,33
2020-08-07,Napa,055,140530,1266,1055,2,1057,8
2020-08-07,Nevada,057,99092,372,324,13,337,1
2020-08-07,Orange,059,3164182,46050,38459,908,39367,701
2020-08-07,Placer,061,380077,2584,2078,4,2082,20
2020-08-07,Plumas,063,18699,38,25,0,25,0
2020-08-07,Riverside,065,2383286,48131,40902,49,40951,810
2020-08-07,Sacramento,067,1510023,14482,10798,14,10812,160
2020-08-07,San Benito,069,59416,800,647,0,647,2
2020-08-07,San Bernardino,071,2135413,43470,35200,207,35407,524
2020-08-07,San Diego,073,3302833,34570,31781,81,31862,586
2020-08-07,San Francisco,075,870044,8052,6765,8,6773,66
2020-08-07,San Joaquin,077,732212,15980,12392,19,12411,223
2020-08-07,San Luis Obispo,079,281455,2436,2050,14,2064,14
2020-08-07,San Mateo,081,765935,7205,5948,7,5955,117
2020-08-07,Santa Barbara,083,443738,7266,6509,66,6575,66
2020-08-07,Santa Clara,085,1922200,14733,11409,33,11442,180
2020-08-07,Santa Cruz,087,273765,1479,1234,10,1244,5
2020-08-07,Shasta,089,179085,540,342,3,345,9
2020-08-07,Sierra,091,2930,5,3,0,3,0
2020-08-07,Siskiyou,093,43540,109,73,0,73,0
2020-08-07,Solano,095,438530,4692,3844,28,3872,31
2020-08-07,Sonoma,097,501317,4304,3329,7,3336,34
2020-08-07,Stanislaus,099,539301,12962,9665,103,9768,98
2020-08-07,Sutter,101,95872,1020,807,1,808,6
2020-08-07,Tehama,103,63373,314,246,2,248,1
2020-08-07,Trinity,105,12862,30,5,6,11,0
2020-08-07,Tulare,107,460477,12453,10292,35,10327,195
2020-08-07,Tuolumne,109,53932,160,136,2,138,1
2020-08-07,Ventura,111,848112,9631,8356,44,8400,84
2020-08-07,Yolo,113,214977,2038,1689,4,1693,37
2020-08-07,Yuba,115,75493,615,413,1,414,1
2020-08-06,Alameda,001,1643700,15042,12474,111,12585,200
2020-08-06,Alpine,003,1148,2,2,0,2,0
2020-08-06,Amador,005,37829,228,125,0,125,0
2020-08-06,Butte,007,227075,1357,1060,16,1076,13
2020-08-06,Calaveras,009,45235,166,117,0,117,1
2020-08-06,Colusa,011,21464,405,358,0,358,3
2020-08-06,Contra Costa,013,1133247,11566,8583,33,8616,124
2020-08-06,Del Norte,015,27424,97,69,0,69,0
2020-08-06,El Dorado,017,186661,862,703,0,703,1
2020-08-06,Fresno,019,978130,23412,17031,225,17256,161
2020-08-06,Glenn,021,27897,400,332,0,332,1
2020-08-06,Humboldt,023,135768,296,266,1,267,4
2020-08-06,Imperial,025,180216,10614,8064,7,8071,163
2020-08-06,Inyo,027,18085,104,83,1,84,1
2020-08-06,Kern,029,883053,26571,21843,152,21995,197
2020-08-06,Kings,031,150075,5197,4264,29,4293,47
2020-08-06,Lake,033,64148,259,209,0,209,1
2020-08-06,Lassen,035,31185,695,588,2,590,0
2020-08-06,Los Angeles,037,10098052,214147,201372,710,202082,4874
2020-08-06,Madera,039,155013,3167,2240,12,2252,19
2020-08-06,Marin,041,260295,5636,5058,10,5068,43
2020-08-06,Mariposa,043,17540,64,52,0,52,2
2020-08-06,Mendocino,045,87422,413,260,0,260,1
2020-08-06,Merced,047,269075,6614,4235,3,4238,30
2020-08-06,Modoc,049,8938,7,4,0,4,0
2020-08-06,Mono,051,14174,159,111,2,113,1
2020-08-06,Monterey,053,433212,6293,5001,18,5019,33
2020-08-06,Napa,055,140530,1252,1032,2,1034,8
2020-08-06,Nevada,057,99092,367,321,13,334,1
2020-08-06,Orange,059,3164182,45758,38399,903,39302,694
2020-08-06,Placer,061,380077,2558,2045,4,2049,20
2020-08-06,Plumas,063,18699,37,25,0,25,0
2020-08-06,Riverside,065,2383286,47736,40269,49,40318,781
2020-08-06,Sacramento,067,1510023,14253,10548,14,10562,153
2020-08-06,San Benito,069,59416,792,626,0,626,2
2020-08-06,San Bernardino,071,2135413,43065,34819,205,35024,516
2020-08-06,San Diego,073,3302833,34303,31129,74,31203,583
2020-08-06,San Francisco,075,870044,7959,6737,7,6744,60
2020-08-06,San Joaquin,077,732212,15820,12269,19,12288,203
2020-08-06,San Luis Obispo,079,281455,2412,2000,13,2013,13
2020-08-06,San Mateo,081,765935,7105,5885,7,5892,117
2020-08-06,Santa Barbara,083,443738,7206,6620,66,6686,65
2020-08-06,Santa Clara,085,1922200,14504,11280,33,11313,178
2020-08-06,Santa Cruz,087,273765,1458,1215,10,1225,4
2020-08-06,Shasta,089,179085,531,343,3,346,9
2020-08-06,Sierra,091,2930,5,3,0,3,0
2020-08-06,Siskiyou,093,43540,109,73,0,73,0
2020-08-06,Solano,095,438530,4649,3784,28,3812,29
2020-08-06,Sonoma,097,501317,4240,3259,7,3266,33
2020-08-06,Stanislaus,099,539301,12812,9566,87,9653,98
2020-08-06,Sutter,101,95872,989,797,1,798,6
2020-08-06,Tehama,103,63373,311,242,2,244,1
2020-08-06,Trinity,105,12862,27,5,6,11,0
2020-08-06,Tulare,107,460477,12294,10169,35,10204,195
2020-08-06,Tuolumne,109,53932,159,136,2,138,1
2020-08-06,Ventura,111,848112,9516,8245,41,8286,80
2020-08-06,Yolo,113,214977,2014,1662,4,1666,36
2020-08-06,Yuba,115,75493,606,407,0,407,1
2020-08-05,Alameda,001,1643700,14828,12140,111,12251,193
2020-08-05,Alpine,003,1148,2,2,0,2,0
2020-08-05,Amador,005,37829,218,123,0,123,0
2020-08-05,Butte,007,227075,1323,1038,15,1053,13
2020-08-05,Calaveras,009,45235,163,116,0,116,1
2020-08-05,Colusa,011,21464,401,354,0,354,3
2020-08-05,Contra Costa,013,1133247,11397,8362,33,8395,122
2020-08-05,Del Norte,015,27424,96,69,0,69,0
2020-08-05,El Dorado,017,186661,854,692,0,692,1
2020-08-05,Fresno,019,978130,23168,16625,220,16845,159
2020-08-05,Glenn,021,27897,397,330,0,330,1
2020-08-05,Humboldt,023,135768,294,249,1,250,4
2020-08-05,Imperial,025,180216,10579,8036,7,8043,163
2020-08-05,Inyo,027,18085,102,62,1,63,1
2020-08-05,Kern,029,883053,26383,21540,147,21687,194
2020-08-05,Kings,031,150075,5152,4192,27,4219,47
2020-08-05,Lake,033,64148,252,209,0,209,1
2020-08-05,Lassen,035,31185,648,557,2,559,0
2020-08-05,Los Angeles,037,10098052,212230,198355,690,199045,4832
2020-08-05,Madera,039,155013,3125,2172,12,2184,19
2020-08-05,Marin,041,260295,5604,5036,10,5046,43
2020-08-05,Mariposa,043,17540,64,52,0,52,2
2020-08-05,Mendocino,045,87422,401,248,0,248,1
2020-08-05,Merced,047,269075,6479,4119,3,4122,30
2020-08-05,Modoc,049,8938,7,3,0,3,0
2020-08-05,Mono,051,14174,159,104,2,106,1
2020-08-05,Monterey,053,433212,6178,4936,18,4954,32
2020-08-05,Napa,055,140530,1240,1020,2,1022,8
2020-08-05,Nevada,057,99092,358,327,13,340,2
2020-08-05,Orange,059,3164182,45449,37907,895,38802,663
2020-08-05,Placer,061,380077,2517,1989,4,1993,18
2020-08-05,Plumas,063,18699,36,25,0,25,0
2020-08-05,Riverside,065,2383286,47344,39454,47,39501,761
2020-08-05,Sacramento,067,1510023,14034,10261,13,10274,151
2020-08-05,San Benito,069,59416,783,613,0,613,2
2020-08-05,San Bernardino,071,2135413,42603,34442,200,34642,504
2020-08-05,San Diego,073,3302833,34079,30866,58,30924,578
2020-08-05,San Francisco,075,870044,7866,6701,7,6708,60
2020-08-05,San Joaquin,077,732212,15657,12148,19,12167,199
2020-08-05,San Luis Obispo,079,281455,2388,1928,13,1941,13
2020-08-05,San Mateo,081,765935,7009,5695,7,5702,116
2020-08-05,Santa Barbara,083,443738,7146,6597,66,6663,63
2020-08-05,Santa Clara,085,1922200,14270,11074,33,11107,176
2020-08-05,Santa Cruz,087,273765,1438,1192,8,1200,4
2020-08-05,Shasta,089,179085,525,338,3,341,9
2020-08-05,Sierra,091,2930,5,3,0,3,0
2020-08-05,Siskiyou,093,43540,105,72,0,72,0
2020-08-05,Solano,095,438530,4598,3750,27,3777,29
2020-08-05,Sonoma,097,501317,4157,3173,7,3180,33
2020-08-05,Stanislaus,099,539301,12653,9408,82,9490,97
2020-08-05,Sutter,101,95872,978,780,1,781,6
2020-08-05,Tehama,103,63373,308,231,2,233,1
2020-08-05,Trinity,105,12862,27,5,6,11,0
2020-08-05,Tulare,107,460477,12154,9924,35,9959,192
2020-08-05,Tuolumne,109,53932,159,137,2,139,0
2020-08-05,Ventura,111,848112,9400,8162,37,8199,75
2020-08-05,Yolo,113,214977,1986,1634,4,1638,36
2020-08-05,Yuba,115,75493,589,400,0,400,1
2020-08-04,Alameda,001,1643700,14611,11983,110,12093,192
2020-08-04,Alpine,003,1148,2,2,0,2,0
2020-08-04,Amador,005,37829,203,123,0,123,0
2020-08-04,Butte,007,227075,1299,1011,15,1026,10
2020-08-04,Calaveras,009,45235,159,116,0,116,1
2020-08-04,Colusa,011,21464,396,354,0,354,3
2020-08-04,Contra Costa,013,1133247,11230,8210,33,8243,122
2020-08-04,Del Norte,015,27424,94,69,0,69,0
2020-08-04,El Dorado,017,186661,844,668,0,668,1
2020-08-04,Fresno,019,978130,22884,16272,213,16485,154
2020-08-04,Glenn,021,27897,396,325,0,325,1
2020-08-04,Humboldt,023,135768,284,241,1,242,4
2020-08-04,Imperial,025,180216,10542,7974,7,7981,163
2020-08-04,Inyo,027,18085,88,59,1,60,1
2020-08-04,Kern,029,883053,26100,21403,147,21550,190
2020-08-04,Kings,031,150075,5087,4163,27,4190,47
2020-08-04,Lake,033,64148,252,206,0,206,1
2020-08-04,Lassen,035,31185,645,556,2,558,0
2020-08-04,Los Angeles,037,10098052,210302,196014,659,196673,4764
2020-08-04,Madera,039,155013,3082,2161,8,2169,19
2020-08-04,Marin,041,260295,5573,5020,9,5029,43
2020-08-04,Mariposa,043,17540,64,51,0,51,2
2020-08-04,Mendocino,045,87422,376,248,0,248,1
2020-08-04,Merced,047,269075,6365,4085,3,4088,30
2020-08-04,Modoc,049,8938,7,3,0,3,0
2020-08-04,Mono,051,14174,158,104,1,105,1
2020-08-04,Monterey,053,433212,6064,4892,18,4910,32
2020-08-04,Napa,055,140530,1227,994,0,994,8
2020-08-04,Nevada,057,99092,357,322,13,335,2
2020-08-04,Orange,059,3164182,45073,37844,889,38733,659
2020-08-04,Placer,061,380077,2480,1964,4,1968,17
2020-08-04,Plumas,063,18699,36,25,0,25,0
2020-08-04,Riverside,065,2383286,46959,38991,46,39037,743
2020-08-04,Sacramento,067,1510023,13816,10205,13,10218,146
2020-08-04,San Benito,069,59416,767,608,0,608,2
2020-08-04,San Bernardino,071,2135413,42053,34215,195,34410,495
2020-08-04,San Diego,073,3302833,33786,30518,46,30564,568
2020-08-04,San Francisco,075,870044,7778,6568,7,6575,60
2020-08-04,San Joaquin,077,732212,15528,12087,16,12103,189
2020-08-04,San Luis Obispo,079,281455,2358,1886,13,1899,13
2020-08-04,San Mateo,081,765935,6903,5690,7,5697,116
2020-08-04,Santa Barbara,083,443738,7086,6591,66,6657,61
2020-08-04,Santa Clara,085,1922200,13969,10986,32,11018,175
2020-08-04,Santa Cruz,087,273765,1419,1202,8,1210,4
2020-08-04,Shasta,089,179085,519,335,3,338,9
2020-08-04,Sierra,091,2930,5,1,0,1,0
2020-08-04,Siskiyou,093,43540,103,71,0,71,0
2020-08-04,Solano,095,438530,4527,3690,27,3717,29
2020-08-04,Sonoma,097,501317,4090,3108,7,3115,33
2020-08-04,Stanislaus,099,539301,12485,9359,74,9433,97
2020-08-04,Sutter,101,95872,964,761,1,762,6
2020-08-04,Tehama,103,63373,301,226,2,228,1
2020-08-04,Trinity,105,12862,27,5,6,11,0
2020-08-04,Tulare,107,460477,11974,9866,35,9901,192
2020-08-04,Tuolumne,109,53932,158,127,2,129,0
2020-08-04,Ventura,111,848112,9286,8134,35,8169,75
2020-08-04,Yolo,113,214977,1960,1626,4,1630,37
2020-08-04,Yuba,115,75493,574,398,0,398,1
2020-08-03,Alameda,001,1643700,14427,11817,106,11923,189
2020-08-03,Alpine,003,1148,2,2,0,2,0
2020-08-03,Amador,005,37829,199,119,0,119,0
2020-08-03,Butte,007,227075,1253,989,14,1003,9
2020-08-03,Calaveras,009,45235,156,117,0,117,1
2020-08-03,Colusa,011,21464,392,336,0,336,2
2020-08-03,Contra Costa,013,1133247,11033,8069,30,8099,120
2020-08-03,Del Norte,015,27424,90,68,0,68,0
2020-08-03,El Dorado,017,186661,833,645,0,645,1
2020-08-03,Fresno,019,978130,22590,15945,207,16152,151
2020-08-03,Glenn,021,27897,389,316,0,316,1
2020-08-03,Humboldt,023,135768,277,234,1,235,4
2020-08-03,Imperial,025,180216,10487,7953,7,7960,161
2020-08-03,Inyo,027,18085,85,57,1,58,1
2020-08-03,Kern,029,883053,25733,21285,140,21425,176
2020-08-03,Kings,031,150075,4975,4107,26,4133,47
2020-08-03,Lake,033,64148,245,201,0,201,1
2020-08-03,Lassen,035,31185,645,555,2,557,0
2020-08-03,Los Angeles,037,10098052,208272,194103,628,194731,4706
2020-08-03,Madera,039,155013,3033,2143,7,2150,18
2020-08-03,Marin,041,260295,5526,5001,9,5010,43
2020-08-03,Mariposa,043,17540,63,52,0,52,2
2020-08-03,Mendocino,045,87422,353,248,0,248,1
2020-08-03,Merced,047,269075,6243,4028,3,4031,29
2020-08-03,Modoc,049,8938,7,2,0,2,0
2020-08-03,Mono,051,14174,158,104,1,105,1
2020-08-03,Monterey,053,433212,5913,4806,15,4821,28
2020-08-03,Napa,055,140530,1213,973,0,973,8
2020-08-03,Nevada,057,99092,352,315,13,328,2
2020-08-03,Orange,059,3164182,44679,37705,879,38584,651
2020-08-03,Placer,061,380077,2425,1947,3,1950,16
2020-08-03,Plumas,063,18699,36,25,0,25,0
2020-08-03,Riverside,065,2383286,46491,38642,46,38688,740
2020-08-03,Sacramento,067,1510023,13621,10143,13,10156,142
2020-08-03,San Benito,069,59416,755,603,0,603,2
2020-08-03,San Bernardino,071,2135413,41526,33979,189,34168,444
2020-08-03,San Diego,073,3302833,33472,30228,36,30264,565
2020-08-03,San Francisco,075,870044,7684,6319,7,6326,60
2020-08-03,San Joaquin,077,732212,15331,12007,15,12022,189
2020-08-03,San Luis Obispo,079,281455,2316,1863,10,1873,14
2020-08-03,San Mateo,081,765935,6822,5661,7,5668,115
2020-08-03,Santa Barbara,083,443738,7042,6580,66,6646,59
2020-08-03,Santa Clara,085,1922200,13693,10747,32,10779,172
2020-08-03,Santa Cruz,087,273765,1399,1154,8,1162,4
2020-08-03,Shasta,089,179085,512,322,3,325,9
2020-08-03,Sierra,091,2930,5,1,0,1,0
2020-08-03,Siskiyou,093,43540,99,67,0,67,0
2020-08-03,Solano,095,438530,4458,3610,26,3636,29
2020-08-03,Sonoma,097,501317,3989,3079,6,3085,33
2020-08-03,Stanislaus,099,539301,12276,9308,66,9374,96
2020-08-03,Sutter,101,95872,940,713,1,714,6
2020-08-03,Tehama,103,63373,293,225,2,227,1
2020-08-03,Trinity,105,12862,27,5,6,11,0
2020-08-03,Tulare,107,460477,11790,9703,35,9738,188
2020-08-03,Tuolumne,109,53932,158,123,2,125,0
2020-08-03,Ventura,111,848112,9195,8084,32,8116,74
2020-08-03,Yolo,113,214977,1925,1598,3,1601,37
2020-08-03,Yuba,115,75493,550,393,0,393,1
2020-08-02,Alameda,001,1643700,14180,11696,94,11790,188
2020-08-02,Alpine,003,1148,2,2,0,2,0
2020-08-02,Amador,005,37829,194,117,0,117,0
2020-08-02,Butte,007,227075,1218,987,14,1001,9
2020-08-02,Calaveras,009,45235,153,116,0,116,1
2020-08-02,Colusa,011,21464,387,335,0,335,2
2020-08-02,Contra Costa,013,1133247,10794,7995,30,8025,118
2020-08-02,Del Norte,015,27424,89,68,0,68,0
2020-08-02,El Dorado,017,186661,823,643,0,643,1
2020-08-02,Fresno,019,978130,22315,15759,201,15960,151
2020-08-02,Glenn,021,27897,388,315,0,315,1
2020-08-02,Humboldt,023,135768,272,232,1,233,4
2020-08-02,Imperial,025,180216,10424,7919,7,7926,157
2020-08-02,Inyo,027,18085,84,45,1,46,1
2020-08-02,Kern,029,883053,25435,21162,138,21300,176
2020-08-02,Kings,031,150075,4913,3964,25,3989,47
2020-08-02,Lake,033,64148,240,201,0,201,1
2020-08-02,Lassen,035,31185,645,555,2,557,0
2020-08-02,Los Angeles,037,10098052,206187,192480,610,193090,4698
2020-08-02,Madera,039,155013,2967,2123,5,2128,18
2020-08-02,Marin,041,260295,5491,4985,9,4994,43
2020-08-02,Mariposa,043,17540,61,52,0,52,2
2020-08-02,Mendocino,045,87422,343,247,0,247,1
2020-08-02,Merced,047,269075,6102,4011,3,4014,29
2020-08-02,Modoc,049,8938,7,2,0,2,0
2020-08-02,Mono,051,14174,151,104,1,105,1
2020-08-02,Monterey,053,433212,5787,4698,15,4713,28
2020-08-02,Napa,055,140530,1198,956,0,956,8
2020-08-02,Nevada,057,99092,349,314,13,327,2
2020-08-02,Orange,059,3164182,44297,37266,868,38134,651
2020-08-02,Placer,061,380077,2386,1920,3,1923,15
2020-08-02,Plumas,063,18699,36,25,0,25,0
2020-08-02,Riverside,065,2383286,46058,38507,45,38552,735
2020-08-02,Sacramento,067,1510023,13342,10099,13,10112,142
2020-08-02,San Benito,069,59416,741,599,0,599,2
2020-08-02,San Bernardino,071,2135413,40924,33643,185,33828,443
2020-08-02,San Diego,073,3302833,33132,29885,27,29912,565
2020-08-02,San Francisco,075,870044,7566,6297,7,6304,60
2020-08-02,San Joaquin,077,732212,15045,11937,13,11950,189
2020-08-02,San Luis Obispo,079,281455,2253,1821,10,1831,14
2020-08-02,San Mateo,081,765935,6707,5618,7,5625,115
2020-08-02,Santa Barbara,083,443738,6952,6532,66,6598,59
2020-08-02,Santa Clara,085,1922200,13475,10577,32,10609,172
2020-08-02,Santa Cruz,087,273765,1379,1162,8,1170,4
2020-08-02,Shasta,089,179085,508,318,3,321,9
2020-08-02,Sierra,091,2930,4,1,0,1,0
2020-08-02,Siskiyou,093,43540,99,65,0,65,0
2020-08-02,Solano,095,438530,4399,3609,26,3635,29
2020-08-02,Sonoma,097,501317,3905,3005,6,3011,33
2020-08-02,Stanislaus,099,539301,12061,9277,61,9338,96
2020-08-02,Sutter,101,95872,905,714,1,715,6
2020-08-02,Tehama,103,63373,287,222,2,224,1
2020-08-02,Trinity,105,12862,27,5,6,11,0
2020-08-02,Tulare,107,460477,11581,9593,35,9628,188
2020-08-02,Tuolumne,109,53932,155,123,2,125,0
2020-08-02,Ventura,111,848112,9048,8014,32,8046,73
2020-08-02,Yolo,113,214977,1900,1588,3,1591,37
2020-08-02,Yuba,115,75493,530,393,0,393,1
2020-08-01,Alameda,001,1643700,14068,11590,94,11684,188
2020-08-01,Alpine,003,1148,2,2,0,2,0
2020-08-01,Amador,005,37829,190,109,0,109,0
2020-08-01,Butte,007,227075,1204,976,14,990,9
2020-08-01,Calaveras,009,45235,149,116,0,116,1
2020-08-01,Colusa,011,21464,386,327,0,327,2
2020-08-01,Contra Costa,013,1133247,10661,7867,29,7896,116
2020-08-01,Del Norte,015,27424,89,68,0,68,0
2020-08-01,El Dorado,017,186661,820,637,0,637,1
2020-08-01,Fresno,019,978130,22178,15448,201,15649,149
2020-08-01,Glenn,021,27897,387,311,0,311,1
2020-08-01,Humboldt,023,135768,271,232,1,233,4
2020-08-01,Imperial,025,180216,10388,7919,7,7926,156
2020-08-01,Inyo,027,18085,82,45,1,46,1
2020-08-01,Kern,029,883053,25277,20796,134,20930,176
2020-08-01,Kings,031,150075,4887,3948,25,3973,47
2020-08-01,Lake,033,64148,238,194,0,194,1
2020-08-01,Lassen,035,31185,644,555,2,557,0
2020-08-01,Los Angeles,037,10098052,205294,191023,583,191606,4674
2020-08-01,Madera,039,155013,2928,2103,5,2108,18
2020-08-01,Marin,041,260295,5476,4945,9,4954,43
2020-08-01,Mariposa,043,17540,61,50,0,50,2
2020-08-01,Mendocino,045,87422,336,243,0,243,1
2020-08-01,Merced,047,269075,6054,3972,3,3975,29
2020-08-01,Modoc,049,8938,7,2,0,2,0
2020-08-01,Mono,051,14174,150,104,1,105,1
2020-08-01,Monterey,053,433212,5720,4611,14,4625,28
2020-08-01,Napa,055,140530,1189,923,0,923,8
2020-08-01,Nevada,057,99092,345,305,13,318,2
2020-08-01,Orange,059,3164182,44070,36703,862,37565,648
2020-08-01,Placer,061,380077,2352,1891,3,1894,14
2020-08-01,Plumas,063,18699,35,25,0,25,0
2020-08-01,Riverside,065,2383286,45846,38216,43,38259,704
2020-08-01,Sacramento,067,1510023,13191,10044,13,10057,141
2020-08-01,San Benito,069,59416,730,579,0,579,2
2020-08-01,San Bernardino,071,2135413,40688,32947,184,33131,440
2020-08-01,San Diego,073,3302833,32915,29579,19,29598,565
2020-08-01,San Francisco,075,870044,7504,6296,7,6303,60
2020-08-01,San Joaquin,077,732212,14972,11807,12,11819,189
2020-08-01,San Luis Obispo,079,281455,2224,1798,10,1808,13
2020-08-01,San Mateo,081,765935,6653,5520,7,5527,115
2020-08-01,Santa Barbara,083,443738,6912,6465,66,6531,59
2020-08-01,Santa Clara,085,1922200,13324,10281,31,10312,171
2020-08-01,Santa Cruz,087,273765,1363,1164,8,1172,4
2020-08-01,Shasta,089,179085,503,312,3,315,9
2020-08-01,Sierra,091,2930,3,1,0,1,0
2020-08-01,Siskiyou,093,43540,99,64,0,64,0
2020-08-01,Solano,095,438530,4365,3591,25,3616,29
2020-08-01,Sonoma,097,501317,3859,2890,6,2896,29
2020-08-01,Stanislaus,099,539301,11943,9221,53,9274,96
2020-08-01,Sutter,101,95872,901,714,1,715,6
2020-08-01,Tehama,103,63373,284,220,2,222,1
2020-08-01,Trinity,105,12862,27,5,6,11,0
2020-08-01,Tulare,107,460477,11513,9520,35,9555,188
2020-08-01,Tuolumne,109,53932,155,123,2,125,0
2020-08-01,Ventura,111,848112,9002,7819,32,7851,73
2020-08-01,Yolo,113,214977,1890,1557,3,1560,37
2020-08-01,Yuba,115,75493,525,387,0,387,1
2020-07-31,Alameda,001,1643700,13937,11441,94,11535,187
2020-07-31,Alpine,003,1148,2,2,0,2,0
2020-07-31,Amador,005,37829,189,98,0,98,0
2020-07-31,Butte,007,227075,1181,925,14,939,7
2020-07-31,Calaveras,009,45235,149,112,0,112,1
2020-07-31,Colusa,011,21464,376,319,0,319,2
2020-07-31,Contra Costa,013,1133247,10513,7697,28,7725,113
2020-07-31,Del Norte,015,27424,88,68,0,68,0
2020-07-31,El Dorado,017,186661,809,616,0,616,1
2020-07-31,Fresno,019,978130,21958,15083,201,15284,133
2020-07-31,Glenn,021,27897,380,304,0,304,1
2020-07-31,Humboldt,023,135768,264,229,1,230,4
2020-07-31,Imperial,025,180216,10356,7886,7,7893,155
2020-07-31,Inyo,027,18085,72,45,1,46,1
2020-07-31,Kern,029,883053,25036,20061,130,20191,173
2020-07-31,Kings,031,150075,4859,3807,25,3832,45
2020-07-31,Lake,033,64148,237,191,0,191,1
2020-07-31,Lassen,035,31185,639,544,2,546,0
2020-07-31,Los Angeles,037,10098052,203694,188688,570,189258,4628
2020-07-31,Madera,039,155013,2881,2036,5,2041,19
2020-07-31,Marin,041,260295,5432,4885,6,4891,43
2020-07-31,Mariposa,043,17540,61,49,0,49,2
2020-07-31,Mendocino,045,87422,321,232,0,232,1
2020-07-31,Merced,047,269075,5971,3789,3,3792,30
2020-07-31,Modoc,049,8938,6,0,0,0,0
2020-07-31,Mono,051,14174,149,104,1,105,1
2020-07-31,Monterey,053,433212,5628,4493,14,4507,24
2020-07-31,Napa,055,140530,1177,897,0,897,7
2020-07-31,Nevada,057,99092,343,302,13,315,2
2020-07-31,Orange,059,3164182,43771,36196,847,37043,620
2020-07-31,Placer,061,380077,2327,1853,3,1856,14
2020-07-31,Plumas,063,18699,34,25,0,25,0
2020-07-31,Riverside,065,2383286,45456,37612,42,37654,694
2020-07-31,Sacramento,067,1510023,13013,9872,13,9885,132
2020-07-31,San Benito,069,59416,722,567,0,567,2
2020-07-31,San Bernardino,071,2135413,40358,32332,183,32515,434
2020-07-31,San Diego,073,3302833,32681,29050,11,29061,561
2020-07-31,San Francisco,075,870044,7405,6126,7,6133,60
2020-07-31,San Joaquin,077,732212,14832,11561,12,11573,177
2020-07-31,San Luis Obispo,079,281455,2155,1746,10,1756,12
2020-07-31,San Mateo,081,765935,6581,5416,7,5423,115
2020-07-31,Santa Barbara,083,443738,6845,6375,66,6441,58
2020-07-31,Santa Clara,085,1922200,13103,9863,31,9894,171
2020-07-31,Santa Cruz,087,273765,1340,1118,8,1126,4
2020-07-31,Shasta,089,179085,493,305,3,308,9
2020-07-31,Sierra,091,2930,3,1,0,1,0
2020-07-31,Siskiyou,093,43540,97,61,0,61,0
2020-07-31,Solano,095,438530,4318,3510,24,3534,29
2020-07-31,Sonoma,097,501317,3801,2745,6,2751,27
2020-07-31,Stanislaus,099,539301,11836,9061,48,9109,94
2020-07-31,Sutter,101,95872,896,714,1,715,6
2020-07-31,Tehama,103,63373,281,213,2,215,1
2020-07-31,Trinity,105,12862,27,5,6,11,0
2020-07-31,Tulare,107,460477,11392,9365,35,9400,184
2020-07-31,Tuolumne,109,53932,155,120,2,122,0
2020-07-31,Ventura,111,848112,8927,7521,32,7553,71
2020-07-31,Yolo,113,214977,1864,1522,3,1525,38
2020-07-31,Yuba,115,75493,516,369,0,369,1
2020-07-30,Alameda,001,1643700,13734,11303,54,11357,185
2020-07-30,Alpine,003,1148,2,2,0,2,0
2020-07-30,Amador,005,37829,171,97,0,97,0
2020-07-30,Butte,007,227075,1165,915,14,929,7
2020-07-30,Calaveras,009,45235,145,111,0,111,1
2020-07-30,Colusa,011,21464,373,315,0,315,2
2020-07-30,Contra Costa,013,1133247,10328,7615,27,7642,112
2020-07-30,Del Norte,015,27424,88,68,0,68,0
2020-07-30,El Dorado,017,186661,802,608,0,608,1
2020-07-30,Fresno,019,978130,21622,14793,195,14988,133
2020-07-30,Glenn,021,27897,373,297,0,297,1
2020-07-30,Humboldt,023,135768,262,228,1,229,4
2020-07-30,Imperial,025,180216,10297,7849,7,7856,151
2020-07-30,Inyo,027,18085,68,44,1,45,1
2020-07-30,Kern,029,883053,24743,19552,126,19678,171
2020-07-30,Kings,031,150075,4755,3785,25,3810,43
2020-07-30,Lake,033,64148,231,181,0,181,1
2020-07-30,Lassen,035,31185,636,544,2,546,0
2020-07-30,Los Angeles,037,10098052,201665,186177,538,186715,4564
2020-07-30,Madera,039,155013,2811,2007,5,2012,18
2020-07-30,Marin,041,260295,5390,4835,5,4840,39
2020-07-30,Mariposa,043,17540,61,49,0,49,1
2020-07-30,Mendocino,045,87422,314,232,0,232,1
2020-07-30,Merced,047,269075,5806,3695,3,3698,30
2020-07-30,Modoc,049,8938,6,0,0,0,0
2020-07-30,Mono,051,14174,148,104,1,105,1
2020-07-30,Monterey,053,433212,5516,4352,14,4366,24
2020-07-30,Napa,055,140530,1160,874,0,874,7
2020-07-30,Nevada,057,99092,338,292,13,305,2
2020-07-30,Orange,059,3164182,43356,36105,822,36927,607
2020-07-30,Placer,061,380077,2276,1821,3,1824,14
2020-07-30,Plumas,063,18699,33,25,0,25,0
2020-07-30,Riverside,065,2383286,44915,37308,42,37350,685
2020-07-30,Sacramento,067,1510023,12794,9704,13,9717,126
2020-07-30,San Benito,069,59416,709,558,0,558,2
2020-07-30,San Bernardino,071,2135413,39835,32010,183,32193,427
2020-07-30,San Diego,073,3302833,32334,28670,9,28679,558
2020-07-30,San Francisco,075,870044,7305,6107,7,6114,59
2020-07-30,San Joaquin,077,732212,14638,11435,12,11447,161
2020-07-30,San Luis Obispo,079,281455,2119,1703,10,1713,12
2020-07-30,San Mateo,081,765935,6486,5369,7,5376,115
2020-07-30,Santa Barbara,083,443738,6765,6273,66,6339,52
2020-07-30,Santa Clara,085,1922200,12867,9708,30,9738,170
2020-07-30,Santa Cruz,087,273765,1312,1087,8,1095,4
2020-07-30,Shasta,089,179085,489,306,3,309,8
2020-07-30,Sierra,091,2930,3,1,0,1,0
2020-07-30,Siskiyou,093,43540,96,60,0,60,0
2020-07-30,Solano,095,438530,4267,3463,24,3487,29
2020-07-30,Sonoma,097,501317,3729,2684,6,2690,25
2020-07-30,Stanislaus,099,539301,11623,8890,40,8930,94
2020-07-30,Sutter,101,95872,877,698,1,699,6
2020-07-30,Tehama,103,63373,278,208,2,210,1
2020-07-30,Trinity,105,12862,26,4,6,10,0
2020-07-30,Tulare,107,460477,11263,9167,35,9202,177
2020-07-30,Tuolumne,109,53932,154,119,2,121,0
2020-07-30,Ventura,111,848112,8815,7304,30,7334,69
2020-07-30,Yolo,113,214977,1844,1511,3,1514,37
2020-07-30,Yuba,115,75493,503,362,0,362,1
2020-07-29,Alameda,001,1643700,13515,11177,49,11226,180
2020-07-29,Alpine,003,1148,2,2,0,2,0
2020-07-29,Amador,005,37829,163,80,0,80,0
2020-07-29,Butte,007,227075,1139,889,12,901,7
2020-07-29,Calaveras,009,45235,139,107,0,107,1
2020-07-29,Colusa,011,21464,369,302,0,302,2
2020-07-29,Contra Costa,013,1133247,10124,7520,27,7547,108
2020-07-29,Del Norte,015,27424,88,68,0,68,0
2020-07-29,El Dorado,017,186661,792,588,0,588,1
2020-07-29,Fresno,019,978130,21330,14312,195,14507,125
2020-07-29,Glenn,021,27897,366,294,0,294,1
2020-07-29,Humboldt,023,135768,259,221,1,222,4
2020-07-29,Imperial,025,180216,10249,7825,7,7832,147
2020-07-29,Inyo,027,18085,63,44,1,45,1
2020-07-29,Kern,029,883053,24405,19073,123,19196,162
2020-07-29,Kings,031,150075,4707,3755,25,3780,43
2020-07-29,Lake,033,64148,229,179,0,179,1
2020-07-29,Lassen,035,31185,621,513,2,515,0
2020-07-29,Los Angeles,037,10098052,199639,183600,521,184121,4523
2020-07-29,Madera,039,155013,2757,1941,5,1946,18
2020-07-29,Marin,041,260295,5352,4747,5,4752,34
2020-07-29,Mariposa,043,17540,60,47,0,47,1
2020-07-29,Mendocino,045,87422,306,228,0,228,0
2020-07-29,Merced,047,269075,5666,3605,3,3608,25
2020-07-29,Modoc,049,8938,5,0,0,0,0
2020-07-29,Mono,051,14174,145,102,1,103,1
2020-07-29,Monterey,053,433212,5417,4252,14,4266,24
2020-07-29,Napa,055,140530,1132,866,0,866,7
2020-07-29,Nevada,057,99092,334,288,13,301,1
2020-07-29,Orange,059,3164182,42922,35339,810,36149,589
2020-07-29,Placer,061,380077,2244,1798,3,1801,14
2020-07-29,Plumas,063,18699,33,25,0,25,0
2020-07-29,Riverside,065,2383286,44323,36968,42,37010,678
2020-07-29,Sacramento,067,1510023,12548,9538,13,9551,122
2020-07-29,San Benito,069,59416,694,537,0,537,2
2020-07-29,San Bernardino,071,2135413,39346,31168,172,31340,417
2020-07-29,San Diego,073,3302833,32009,28289,8,28297,552
2020-07-29,San Francisco,075,870044,7211,6041,7,6048,56
2020-07-29,San Joaquin,077,732212,14390,11249,9,11258,154
2020-07-29,San Luis Obispo,079,281455,2098,1673,10,1683,11
2020-07-29,San Mateo,081,765935,6398,5305,7,5312,114
2020-07-29,Santa Barbara,083,443738,6698,6215,66,6281,31
2020-07-29,Santa Clara,085,1922200,12660,9567,30,9597,165
2020-07-29,Santa Cruz,087,273765,1288,1051,8,1059,4
2020-07-29,Shasta,089,179085,477,297,3,300,8
2020-07-29,Sierra,091,2930,2,1,0,1,0
2020-07-29,Siskiyou,093,43540,94,58,0,58,0
2020-07-29,Solano,095,438530,4213,3380,24,3404,29
2020-07-29,Sonoma,097,501317,3652,2598,6,2604,26
2020-07-29,Stanislaus,099,539301,11402,8745,34,8779,94
2020-07-29,Sutter,101,95872,849,678,1,679,6
2020-07-29,Tehama,103,63373,274,206,2,208,1
2020-07-29,Trinity,105,12862,26,4,6,10,0
2020-07-29,Tulare,107,460477,11092,9028,35,9063,156
2020-07-29,Tuolumne,109,53932,154,118,2,120,0
2020-07-29,Ventura,111,848112,8710,7161,30,7191,68
2020-07-29,Yolo,113,214977,1818,1488,3,1491,36
2020-07-29,Yuba,115,75493,487,350,0,350,1
2020-07-28,Alameda,001,1643700,13287,10875,48,10923,180
2020-07-28,Alpine,003,1148,2,2,0,2,0
2020-07-28,Amador,005,37829,153,77,0,77,0
2020-07-28,Butte,007,227075,1104,857,12,869,7
2020-07-28,Calaveras,009,45235,138,105,0,105,1
2020-07-28,Colusa,011,21464,363,290,0,290,2
2020-07-28,Contra Costa,013,1133247,9902,7426,27,7453,107
2020-07-28,Del Norte,015,27424,87,68,0,68,0
2020-07-28,El Dorado,017,186661,777,558,0,558,1
2020-07-28,Fresno,019,978130,20994,13933,189,14122,125
2020-07-28,Glenn,021,27897,364,289,0,289,1
2020-07-28,Humboldt,023,135768,258,218,1,219,4
2020-07-28,Imperial,025,180216,10213,7804,7,7811,145
2020-07-28,Inyo,027,18085,61,43,1,44,1
2020-07-28,Kern,029,883053,24042,18834,117,18951,155
2020-07-28,Kings,031,150075,4661,3721,25,3746,41
2020-07-28,Lake,033,64148,225,179,0,179,1
2020-07-28,Lassen,035,31185,615,508,2,510,0
2020-07-28,Los Angeles,037,10098052,197410,179107,498,179605,4435
2020-07-28,Madera,039,155013,2691,1889,5,1894,18
2020-07-28,Marin,041,260295,5283,4698,5,4703,23
2020-07-28,Mariposa,043,17540,58,45,0,45,1
2020-07-28,Mendocino,045,87422,295,222,0,222,0
2020-07-28,Merced,047,269075,5521,3446,3,3449,23
2020-07-28,Modoc,049,8938,4,0,0,0,0
2020-07-28,Mono,051,14174,144,102,1,103,1
2020-07-28,Monterey,053,433212,5296,4047,14,4061,22
2020-07-28,Napa,055,140530,1110,824,0,824,6
2020-07-28,Nevada,057,99092,329,278,13,291,1
2020-07-28,Orange,059,3164182,42464,34832,797,35629,582
2020-07-28,Placer,061,380077,2209,1759,3,1762,14
2020-07-28,Plumas,063,18699,33,22,0,22,0
2020-07-28,Riverside,065,2383286,43721,36458,42,36500,668
2020-07-28,Sacramento,067,1510023,12289,9429,12,9441,117
2020-07-28,San Benito,069,59416,684,503,0,503,2
2020-07-28,San Bernardino,071,2135413,38822,30493,168,30661,412
2020-07-28,San Diego,073,3302833,31659,28007,6,28013,547
2020-07-28,San Francisco,075,870044,7098,5888,7,5895,56
2020-07-28,San Joaquin,077,732212,14107,10958,7,10965,141
2020-07-28,San Luis Obispo,079,281455,2065,1636,10,1646,9
2020-07-28,San Mateo,081,765935,6324,5171,7,5178,114
2020-07-28,Santa Barbara,083,443738,6635,6110,64,6174,31
2020-07-28,Santa Clara,085,1922200,12425,9307,30,9337,165
2020-07-28,Santa Cruz,087,273765,1261,1018,8,1026,4
2020-07-28,Shasta,089,179085,465,275,3,278,8
2020-07-28,Sierra,091,2930,2,1,0,1,0
2020-07-28,Siskiyou,093,43540,90,57,0,57,0
2020-07-28,Solano,095,438530,4166,3292,23,3315,29
2020-07-28,Sonoma,097,501317,3578,2553,6,2559,20
2020-07-28,Stanislaus,099,539301,11180,8492,26,8518,92
2020-07-28,Sutter,101,95872,812,653,0,653,2
2020-07-28,Tehama,103,63373,269,199,2,201,1
2020-07-28,Trinity,105,12862,26,3,6,9,0
2020-07-28,Tulare,107,460477,10905,8787,35,8822,96
2020-07-28,Tuolumne,109,53932,153,116,2,118,0
2020-07-28,Ventura,111,848112,8584,7045,29,7074,68
2020-07-28,Yolo,113,214977,1790,1459,3,1462,36
2020-07-28,Yuba,115,75493,470,333,0,333,1
2020-07-27,Alameda,001,1643700,13060,10645,45,10690,176
2020-07-27,Alpine,003,1148,2,2,0,2,0
2020-07-27,Amador,005,37829,148,72,0,72,0
2020-07-27,Butte,007,227075,1077,843,12,855,7
2020-07-27,Calaveras,009,45235,134,103,0,103,1
2020-07-27,Colusa,011,21464,356,271,0,271,2
2020-07-27,Contra Costa,013,1133247,9680,7256,27,7283,104
2020-07-27,Del Norte,015,27424,86,67,0,67,0
2020-07-27,El Dorado,017,186661,765,548,0,548,1
2020-07-27,Fresno,019,978130,20647,13485,183,13668,117
2020-07-27,Glenn,021,27897,362,277,0,277,1
2020-07-27,Humboldt,023,135768,253,218,1,219,4
2020-07-27,Imperial,025,180216,10163,7789,7,7796,144
2020-07-27,Inyo,027,18085,61,43,1,44,1
2020-07-27,Kern,029,883053,23540,17994,111,18105,148
2020-07-27,Kings,031,150075,4412,3685,25,3710,39
2020-07-27,Lake,033,64148,221,176,0,176,1
2020-07-27,Lassen,035,31185,615,503,2,505,0
2020-07-27,Los Angeles,037,10098052,194989,176351,480,176831,4379
2020-07-27,Madera,039,155013,2626,1793,5,1798,17
2020-07-27,Marin,041,260295,5195,4669,5,4674,22
2020-07-27,Mariposa,043,17540,58,43,0,43,1
2020-07-27,Mendocino,045,87422,282,209,0,209,0
2020-07-27,Merced,047,269075,5381,3292,3,3295,23
2020-07-27,Modoc,049,8938,3,0,0,0,0
2020-07-27,Mono,051,14174,140,99,1,100,1
2020-07-27,Monterey,053,433212,5106,3960,14,3974,21
2020-07-27,Napa,055,140530,1095,769,0,769,6
2020-07-27,Nevada,057,99092,325,268,13,281,1
2020-07-27,Orange,059,3164182,42024,34649,781,35430,566
2020-07-27,Placer,061,380077,2159,1679,3,1682,12
2020-07-27,Plumas,063,18699,33,22,0,22,0
2020-07-27,Riverside,065,2383286,43041,35822,42,35864,667
2020-07-27,Sacramento,067,1510023,11996,9091,12,9103,114
2020-07-27,San Benito,069,59416,669,498,0,498,2
2020-07-27,San Bernardino,071,2135413,38230,29928,158,30086,401
2020-07-27,San Diego,073,3302833,31285,27509,5,27514,533
2020-07-27,San Francisco,075,870044,7011,5825,7,5832,55
2020-07-27,San Joaquin,077,732212,13818,10728,7,10735,129
2020-07-27,San Luis Obispo,079,281455,2020,1612,10,1622,9
2020-07-27,San Mateo,081,765935,6215,5108,7,5115,113
2020-07-27,Santa Barbara,083,443738,6556,6026,62,6088,30
2020-07-27,Santa Clara,085,1922200,12156,9157,29,9186,166
2020-07-27,Santa Cruz,087,273765,1238,984,8,992,4
2020-07-27,Shasta,089,179085,458,275,3,278,8
2020-07-27,Sierra,091,2930,2,1,0,1,0
2020-07-27,Siskiyou,093,43540,88,54,0,54,0
2020-07-27,Solano,095,438530,4099,3198,22,3220,29
2020-07-27,Sonoma,097,501317,3487,2504,6,2510,20
2020-07-27,Stanislaus,099,539301,10953,8288,18,8306,84
2020-07-27,Sutter,101,95872,786,620,0,620,2
2020-07-27,Tehama,103,63373,261,192,2,194,1
2020-07-27,Trinity,105,12862,26,3,6,9,0
2020-07-27,Tulare,107,460477,10687,8462,35,8497,172
2020-07-27,Tuolumne,109,53932,150,115,2,117,0
2020-07-27,Ventura,111,848112,8456,6998,28,7026,68
2020-07-27,Yolo,113,214977,1745,1439,3,1442,33
2020-07-27,Yuba,115,75493,450,328,0,328,1
2020-07-26,Alameda,001,1643700,12822,10489,44,10533,176
2020-07-26,Alpine,003,1148,2,2,0,2,0
2020-07-26,Amador,005,37829,142,67,0,67,0
2020-07-26,Butte,007,227075,1040,822,12,834,5
2020-07-26,Calaveras,009,45235,131,103,0,103,1
2020-07-26,Colusa,011,21464,347,270,0,270,2
2020-07-26,Contra Costa,013,1133247,9443,7095,27,7122,104
2020-07-26,Del Norte,015,27424,84,67,0,67,0
2020-07-26,El Dorado,017,186661,747,539,0,539,1
2020-07-26,Fresno,019,978130,20256,13209,175,13384,117
2020-07-26,Glenn,021,27897,354,265,0,265,1
2020-07-26,Humboldt,023,135768,247,214,1,215,4
2020-07-26,Imperial,025,180216,10090,7781,7,7788,144
2020-07-26,Inyo,027,18085,56,43,1,44,1
2020-07-26,Kern,029,883053,23016,17394,108,17502,148
2020-07-26,Kings,031,150075,4353,3591,25,3616,39
2020-07-26,Lake,033,64148,213,174,0,174,1
2020-07-26,Lassen,035,31185,574,503,2,505,0
2020-07-26,Los Angeles,037,10098052,192422,174322,462,174784,4364
2020-07-26,Madera,039,155013,2539,1744,5,1749,17
2020-07-26,Marin,041,260295,5149,4595,5,4600,22
2020-07-26,Mariposa,043,17540,56,43,0,43,1
2020-07-26,Mendocino,045,87422,273,206,0,206,0
2020-07-26,Merced,047,269075,5201,3251,2,3253,23
2020-07-26,Modoc,049,8938,3,0,0,0,0
2020-07-26,Mono,051,14174,136,82,1,83,1
2020-07-26,Monterey,053,433212,4940,3901,14,3915,21
2020-07-26,Napa,055,140530,1076,769,0,769,6
2020-07-26,Nevada,057,99092,322,261,13,274,1
2020-07-26,Orange,059,3164182,41499,34352,750,35102,564
2020-07-26,Placer,061,380077,2095,1628,3,1631,12
2020-07-26,Plumas,063,18699,33,22,0,22,0
2020-07-26,Riverside,065,2383286,42480,35636,42,35678,665
2020-07-26,Sacramento,067,1510023,11691,8972,12,8984,114
2020-07-26,San Benito,069,59416,657,495,0,495,2
2020-07-26,San Bernardino,071,2135413,37591,29545,149,29694,400
2020-07-26,San Diego,073,3302833,30889,26986,4,26990,533
2020-07-26,San Francisco,075,870044,6903,5823,7,5830,55
2020-07-26,San Joaquin,077,732212,13525,10637,7,10644,129
2020-07-26,San Luis Obispo,079,281455,1977,1565,10,1575,8
2020-07-26,San Mateo,081,765935,6109,5078,7,5085,113
2020-07-26,Santa Barbara,083,443738,6455,5939,62,6001,30
2020-07-26,Santa Clara,085,1922200,11927,8986,29,9015,166
2020-07-26,Santa Cruz,087,273765,1211,970,8,978,4
2020-07-26,Shasta,089,179085,451,265,3,268,8
2020-07-26,Sierra,091,2930,2,1,0,1,0
2020-07-26,Siskiyou,093,43540,86,54,0,54,0
2020-07-26,Solano,095,438530,4019,3197,20,3217,29
2020-07-26,Sonoma,097,501317,3398,2503,5,2508,20
2020-07-26,Stanislaus,099,539301,10692,8228,17,8245,84
2020-07-26,Sutter,101,95872,772,612,0,612,2
2020-07-26,Tehama,103,63373,254,175,2,177,1
2020-07-26,Trinity,105,12862,26,3,6,9,0
2020-07-26,Tulare,107,460477,10480,8392,35,8427,172
2020-07-26,Tuolumne,109,53932,145,113,2,115,0
2020-07-26,Ventura,111,848112,8249,6844,28,6872,67
2020-07-26,Yolo,113,214977,1714,1408,3,1411,33
2020-07-26,Yuba,115,75493,431,313,0,313,1
2020-07-25,Alameda,001,1643700,12725,10361,42,10403,176
2020-07-25,Alpine,003,1148,2,2,0,2,0
2020-07-25,Amador,005,37829,139,67,0,67,0
2020-07-25,Butte,007,227075,1031,810,12,822,5
2020-07-25,Calaveras,009,45235,127,103,0,103,1
2020-07-25,Colusa,011,21464,340,265,0,265,2
2020-07-25,Contra Costa,013,1133247,9298,6920,27,6947,104
2020-07-25,Del Norte,015,27424,84,67,0,67,0
2020-07-25,El Dorado,017,186661,736,528,0,528,1
2020-07-25,Fresno,019,978130,20070,12866,175,13041,117
2020-07-25,Glenn,021,27897,352,260,0,260,1
2020-07-25,Humboldt,023,135768,244,212,1,213,4
2020-07-25,Imperial,025,180216,10064,7727,7,7734,144
2020-07-25,Inyo,027,18085,55,43,1,44,1
2020-07-25,Kern,029,883053,22798,16910,107,17017,148
2020-07-25,Kings,031,150075,4336,3516,25,3541,39
2020-07-25,Lake,033,64148,211,173,0,173,1
2020-07-25,Lassen,035,31185,574,503,2,505,0
2020-07-25,Los Angeles,037,10098052,191292,172611,455,173066,4357
2020-07-25,Madera,039,155013,2507,1724,5,1729,17
2020-07-25,Marin,041,260295,5133,4562,5,4567,22
2020-07-25,Mariposa,043,17540,55,43,0,43,1
2020-07-25,Mendocino,045,87422,267,190,0,190,0
2020-07-25,Merced,047,269075,5122,3176,2,3178,23
2020-07-25,Modoc,049,8938,3,0,0,0,0
2020-07-25,Mono,051,14174,136,82,1,83,1
2020-07-25,Monterey,053,433212,4863,3805,14,3819,21
2020-07-25,Napa,055,140530,1063,746,0,746,6
2020-07-25,Nevada,057,99092,320,257,13,270,1
2020-07-25,Orange,059,3164182,41279,33978,729,34707,561
2020-07-25,Placer,061,380077,2079,1596,3,1599,12
2020-07-25,Plumas,063,18699,33,22,0,22,0
2020-07-25,Riverside,065,2383286,42211,34921,42,34963,655
2020-07-25,Sacramento,067,1510023,11545,8674,12,8686,113
2020-07-25,San Benito,069,59416,641,492,0,492,2
2020-07-25,San Bernardino,071,2135413,37313,29265,146,29411,394
2020-07-25,San Diego,073,3302833,30628,26703,3,26706,533
2020-07-25,San Francisco,075,870044,6845,5644,7,5651,55
2020-07-25,San Joaquin,077,732212,13399,10347,6,10353,129
2020-07-25,San Luis Obispo,079,281455,1957,1530,9,1539,8
2020-07-25,San Mateo,081,765935,6046,5023,7,5030,113
2020-07-25,Santa Barbara,083,443738,6420,5880,62,5942,30
2020-07-25,Santa Clara,085,1922200,11793,8767,29,8796,166
2020-07-25,Santa Cruz,087,273765,1194,939,8,947,4
2020-07-25,Shasta,089,179085,446,263,1,264,8
2020-07-25,Sierra,091,2930,2,1,0,1,0
2020-07-25,Siskiyou,093,43540,84,54,0,54,0
2020-07-25,Solano,095,438530,3979,3107,18,3125,29
2020-07-25,Sonoma,097,501317,3359,2412,5,2417,20
2020-07-25,Stanislaus,099,539301,10589,7994,14,8008,84
2020-07-25,Sutter,101,95872,753,603,0,603,2
2020-07-25,Tehama,103,63373,253,169,2,171,1
2020-07-25,Trinity,105,12862,26,3,6,9,0
2020-07-25,Tulare,107,460477,10380,8310,35,8345,172
2020-07-25,Tuolumne,109,53932,144,99,2,101,0
2020-07-25,Ventura,111,848112,8176,6662,28,6690,62
2020-07-25,Yolo,113,214977,1699,1357,3,1360,35
2020-07-25,Yuba,115,75493,425,312,0,312,1
2020-07-24,Alameda,001,1643700,12583,10216,39,10255,176
2020-07-24,Alpine,003,1148,2,2,0,2,0
2020-07-24,Amador,005,37829,137,66,0,66,0
2020-07-24,Butte,007,227075,1019,751,12,763,5
2020-07-24,Calaveras,009,45235,123,102,0,102,0
2020-07-24,Colusa,011,21464,337,255,0,255,2
2020-07-24,Contra Costa,013,1133247,9152,6814,27,6841,100
2020-07-24,Del Norte,015,27424,84,66,0,66,0
2020-07-24,El Dorado,017,186661,714,516,0,516,1
2020-07-24,Fresno,019,978130,19844,12564,175,12739,115
2020-07-24,Glenn,021,27897,349,251,0,251,1
2020-07-24,Humboldt,023,135768,241,210,1,211,4
2020-07-24,Imperial,025,180216,10042,7686,7,7693,141
2020-07-24,Inyo,027,18085,55,41,1,42,1
2020-07-24,Kern,029,883053,22557,16124,107,16231,143
2020-07-24,Kings,031,150075,4306,3471,25,3496,39
2020-07-24,Lake,033,64148,209,167,0,167,1
2020-07-24,Lassen,035,31185,574,503,2,505,0
2020-07-24,Los Angeles,037,10098052,189273,169078,444,169522,4302
2020-07-24,Madera,039,155013,2474,1679,5,1684,16
2020-07-24,Marin,041,260295,5106,4517,5,4522,22
2020-07-24,Mariposa,043,17540,55,41,0,41,1
2020-07-24,Mendocino,045,87422,260,188,0,188,0
2020-07-24,Merced,047,269075,5037,3100,2,3102,23
2020-07-24,Modoc,049,8938,3,0,0,0,0
2020-07-24,Mono,051,14174,135,82,1,83,1
2020-07-24,Monterey,053,433212,4791,3748,14,3762,21
2020-07-24,Napa,055,140530,1050,741,0,741,6
2020-07-24,Nevada,057,99092,317,255,13,268,1
2020-07-24,Orange,059,3164182,40992,33530,713,34243,557
2020-07-24,Placer,061,380077,2048,1551,3,1554,12
2020-07-24,Plumas,063,18699,33,22,0,22,0
2020-07-24,Riverside,065,2383286,41788,34513,41,34554,631
2020-07-24,Sacramento,067,1510023,11357,8570,12,8582,110
2020-07-24,San Benito,069,59416,634,485,0,485,2
2020-07-24,San Bernardino,071,2135413,36940,28990,141,29131,386
2020-07-24,San Diego,073,3302833,30328,26100,3,26103,524
2020-07-24,San Francisco,075,870044,6751,5611,7,5618,55
2020-07-24,San Joaquin,077,732212,13250,10190,6,10196,118
2020-07-24,San Luis Obispo,079,281455,1933,1476,9,1485,8
2020-07-24,San Mateo,081,765935,5983,4954,7,4961,112
2020-07-24,Santa Barbara,083,443738,6367,5776,60,5836,30
2020-07-24,Santa Clara,085,1922200,11628,8658,29,8687,165
2020-07-24,Santa Cruz,087,273765,1174,930,8,938,4
2020-07-24,Shasta,089,179085,438,262,1,263,8
2020-07-24,Sierra,091,2930,2,1,0,1,0
2020-07-24,Siskiyou,093,43540,84,53,0,53,0
2020-07-24,Solano,095,438530,3943,3062,15,3077,29
2020-07-24,Sonoma,097,501317,3307,2345,5,2350,20
2020-07-24,Stanislaus,099,539301,10417,7861,11,7872,82
2020-07-24,Sutter,101,95872,742,593,0,593,2
2020-07-24,Tehama,103,63373,245,170,2,172,1
2020-07-24,Trinity,105,12862,25,3,6,9,0
2020-07-24,Tulare,107,460477,10286,8167,33,8200,167
2020-07-24,Tuolumne,109,53932,138,99,2,101,0
2020-07-24,Ventura,111,848112,8091,6553,28,6581,60
2020-07-24,Yolo,113,214977,1685,1329,3,1332,35
2020-07-24,Yuba,115,75493,410,307,0,307,1
2020-07-23,Alameda,001,1643700,12342,9924,39,9963,171
2020-07-23,Alpine,003,1148,2,2,0,2,0
2020-07-23,Amador,005,37829,120,61,0,61,0
2020-07-23,Butte,007,227075,1004,726,11,737,5
2020-07-23,Calaveras,009,45235,116,102,0,102,0
2020-07-23,Colusa,011,21464,329,242,0,242,2
2020-07-23,Contra Costa,013,1133247,8952,6619,25,6644,98
2020-07-23,Del Norte,015,27424,84,66,0,66,0
2020-07-23,El Dorado,017,186661,703,491,0,491,1
2020-07-23,Fresno,019,978130,19488,12164,172,12336,112
2020-07-23,Glenn,021,27897,344,246,0,246,1
2020-07-23,Humboldt,023,135768,240,208,1,209,4
2020-07-23,Imperial,025,180216,9992,7604,7,7611,138
2020-07-23,Inyo,027,18085,53,38,1,39,1
2020-07-23,Kern,029,883053,22150,14491,103,14594,128
2020-07-23,Kings,031,150075,4194,3371,25,3396,39
2020-07-23,Lake,033,64148,200,160,0,160,1
2020-07-23,Lassen,035,31185,571,503,2,505,0
2020-07-23,Los Angeles,037,10098052,186728,167198,417,167615,4265
2020-07-23,Madera,039,155013,2408,1659,4,1663,13
2020-07-23,Marin,041,260295,5054,4423,5,4428,22
2020-07-23,Mariposa,043,17540,55,40,0,40,1
2020-07-23,Mendocino,045,87422,250,178,0,178,0
2020-07-23,Merced,047,269075,4881,2972,2,2974,22
2020-07-23,Modoc,049,8938,3,0,0,0,0
2020-07-23,Mono,051,14174,131,82,1,83,1
2020-07-23,Monterey,053,433212,4673,3655,14,3669,21
2020-07-23,Napa,055,140530,1026,713,0,713,5
2020-07-23,Nevada,057,99092,314,247,13,260,1
2020-07-23,Orange,059,3164182,40495,32863,683,33546,544
2020-07-23,Placer,061,380077,2005,1519,3,1522,12
2020-07-23,Plumas,063,18699,32,21,0,21,0
2020-07-23,Riverside,065,2383286,41183,33833,41,33874,630
2020-07-23,Sacramento,067,1510023,11125,8222,12,8234,108
2020-07-23,San Benito,069,59416,619,478,0,478,2
2020-07-23,San Bernardino,071,2135413,36420,28121,135,28256,369
2020-07-23,San Diego,073,3302833,29954,25109,3,25112,505
2020-07-23,San Francisco,075,870044,6650,5543,7,5550,55
2020-07-23,San Joaquin,077,732212,13031,9861,6,9867,111
2020-07-23,San Luis Obispo,079,281455,1904,1438,9,1447,7
2020-07-23,San Mateo,081,765935,5878,4895,7,4902,113
2020-07-23,Santa Barbara,083,443738,6294,5628,60,5688,30
2020-07-23,Santa Clara,085,1922200,11410,8458,29,8487,165
2020-07-23,Santa Cruz,087,273765,1138,887,8,895,3
2020-07-23,Shasta,089,179085,427,254,1,255,9
2020-07-23,Sierra,091,2930,2,1,0,1,0
2020-07-23,Siskiyou,093,43540,82,53,0,53,0
2020-07-23,Solano,095,438530,3879,2962,13,2975,29
2020-07-23,Sonoma,097,501317,3231,2289,5,2294,18
2020-07-23,Stanislaus,099,539301,10175,7603,11,7614,71
2020-07-23,Sutter,101,95872,709,570,0,570,2
2020-07-23,Tehama,103,63373,239,158,2,160,1
2020-07-23,Trinity,105,12862,24,3,6,9,0
2020-07-23,Tulare,107,460477,10097,7898,33,7931,168
2020-07-23,Tuolumne,109,53932,138,93,2,95,0
2020-07-23,Ventura,111,848112,7967,6303,28,6331,56
2020-07-23,Yolo,113,214977,1667,1279,3,1282,35
2020-07-23,Yuba,115,75493,390,297,0,297,1
2020-07-22,Alameda,001,1643700,12123,9678,38,9716,169
2020-07-22,Alpine,003,1148,2,2,0,2,0
2020-07-22,Amador,005,37829,118,58,0,58,0
2020-07-22,Butte,007,227075,968,694,11,705,5
2020-07-22,Calaveras,009,45235,116,98,0,98,0
2020-07-22,Colusa,011,21464,322,236,0,236,0
2020-07-22,Contra Costa,013,1133247,8726,6401,25,6426,98
2020-07-22,Del Norte,015,27424,84,66,0,66,0
2020-07-22,El Dorado,017,186661,690,466,0,466,1
2020-07-22,Fresno,019,978130,19125,11756,166,11922,110
2020-07-22,Glenn,021,27897,338,236,0,236,1
2020-07-22,Humboldt,023,135768,238,201,1,202,4
2020-07-22,Imperial,025,180216,9932,7533,7,7540,134
2020-07-22,Inyo,027,18085,49,38,1,39,1
2020-07-22,Kern,029,883053,21718,13513,96,13609,127
2020-07-22,Kings,031,150075,4138,3271,25,3296,38
2020-07-22,Lake,033,64148,197,160,0,160,1
2020-07-22,Lassen,035,31185,568,500,2,502,0
2020-07-22,Los Angeles,037,10098052,184080,165242,394,165636,4218
2020-07-22,Madera,039,155013,2333,1578,4,1582,10
2020-07-22,Marin,041,260295,4998,4373,5,4378,23
2020-07-22,Mariposa,043,17540,55,38,0,38,1
2020-07-22,Mendocino,045,87422,243,166,0,166,0
2020-07-22,Merced,047,269075,4754,2828,2,2830,15
2020-07-22,Modoc,049,8938,3,0,0,0,0
2020-07-22,Mono,051,14174,128,82,1,83,1
2020-07-22,Monterey,053,433212,4572,3533,14,3547,20
2020-07-22,Napa,055,140530,1004,687,0,687,5
2020-07-22,Nevada,057,99092,308,239,12,251,1
2020-07-22,Orange,059,3164182,39996,32047,674,32721,522
2020-07-22,Placer,061,380077,1949,1469,3,1472,12
2020-07-22,Plumas,063,18699,31,20,0,20,0
2020-07-22,Riverside,065,2383286,40547,33093,41,33134,612
2020-07-22,Sacramento,067,1510023,10862,8028,11,8039,106
2020-07-22,San Benito,069,59416,605,465,0,465,2
2020-07-22,San Bernardino,071,2135413,35898,26820,124,26944,348
2020-07-22,San Diego,073,3302833,29566,25109,2,25111,505
2020-07-22,San Francisco,075,870044,6546,5473,6,5479,53
2020-07-22,San Joaquin,077,732212,12755,9628,6,9634,102
2020-07-22,San Luis Obispo,079,281455,1858,1373,9,1382,7
2020-07-22,San Mateo,081,765935,5789,4796,7,4803,112
2020-07-22,Santa Barbara,083,443738,6210,5508,58,5566,29
2020-07-22,Santa Clara,085,1922200,11164,8266,29,8295,166
2020-07-22,Santa Cruz,087,273765,1115,866,8,874,3
2020-07-22,Shasta,089,179085,417,246,1,247,9
2020-07-22,Sierra,091,2930,1,1,0,1,0
2020-07-22,Siskiyou,093,43540,81,52,0,52,0
2020-07-22,Solano,095,438530,3818,2839,12,2851,29
2020-07-22,Sonoma,097,501317,3154,2255,5,2260,17
2020-07-22,Stanislaus,099,539301,10004,7401,11,7412,71
2020-07-22,Sutter,101,95872,685,551,0,551,2
2020-07-22,Tehama,103,63373,231,155,2,157,1
2020-07-22,Trinity,105,12862,23,3,6,9,0
2020-07-22,Tulare,107,460477,9864,7640,33,7673,167
2020-07-22,Tuolumne,109,53932,134,91,2,93,0
2020-07-22,Ventura,111,848112,7839,6223,26,6249,56
2020-07-22,Yolo,113,214977,1624,1233,3,1236,34
2020-07-22,Yuba,115,75493,375,288,0,288,1
2020-07-21,Alameda,001,1643700,11909,9390,38,9428,166
2020-07-21,Alpine,003,1148,2,2,0,2,0
2020-07-21,Amador,005,37829,113,55,0,55,0
2020-07-21,Butte,007,227075,923,659,10,669,5
2020-07-21,Calaveras,009,45235,110,96,0,96,0
2020-07-21,Colusa,011,21464,298,227,0,227,0
2020-07-21,Contra Costa,013,1133247,8484,6210,25,6235,98
2020-07-21,Del Norte,015,27424,84,66,0,66,0
2020-07-21,El Dorado,017,186661,682,440,0,440,1
2020-07-21,Fresno,019,978130,18726,11412,160,11572,107
2020-07-21,Glenn,021,27897,331,229,0,229,1
2020-07-21,Humboldt,023,135768,236,198,1,199,4
2020-07-21,Imperial,025,180216,9883,7458,7,7465,128
2020-07-21,Inyo,027,18085,48,38,1,39,1
2020-07-21,Kern,029,883053,21296,11998,90,12088,119
2020-07-21,Kings,031,150075,4073,3187,24,3211,38
2020-07-21,Lake,033,64148,197,157,0,157,1
2020-07-21,Lassen,035,31185,566,474,2,476,0
2020-07-21,Los Angeles,037,10098052,181097,162205,371,162576,4159
2020-07-21,Madera,039,155013,2268,1508,3,1511,10
2020-07-21,Marin,041,260295,4926,4318,5,4323,21
2020-07-21,Mariposa,043,17540,54,37,0,37,1
2020-07-21,Mendocino,045,87422,232,160,0,160,0
2020-07-21,Merced,047,269075,4575,2725,2,2727,15
2020-07-21,Modoc,049,8938,3,0,0,0,0
2020-07-21,Mono,051,14174,124,79,1,80,1
2020-07-21,Monterey,053,433212,4440,3404,13,3417,20
2020-07-21,Napa,055,140530,977,660,0,660,5
2020-07-21,Nevada,057,99092,306,228,10,238,1
2020-07-21,Orange,059,3164182,39499,31356,642,31998,515
2020-07-21,Placer,061,380077,1908,1413,3,1416,11
2020-07-21,Plumas,063,18699,31,19,0,19,0
2020-07-21,Riverside,065,2383286,39845,32231,41,32272,583
2020-07-21,Sacramento,067,1510023,10590,7789,10,7799,102
2020-07-21,San Benito,069,59416,594,444,0,444,2
2020-07-21,San Bernardino,071,2135413,35249,25323,117,25440,343
2020-07-21,San Diego,073,3302833,29117,24522,2,24524,487
2020-07-21,San Francisco,075,870044,6437,5377,6,5383,53
2020-07-21,San Joaquin,077,732212,12426,9150,6,9156,99
2020-07-21,San Luis Obispo,079,281455,1809,1338,9,1347,7
2020-07-21,San Mateo,081,765935,5697,4733,7,4740,111
2020-07-21,Santa Barbara,083,443738,6130,5422,57,5479,29
2020-07-21,Santa Clara,085,1922200,10901,7989,29,8018,164
2020-07-21,Santa Cruz,087,273765,1082,835,8,843,3
2020-07-21,Shasta,089,179085,409,241,1,242,9
2020-07-21,Sierra,091,2930,1,1,0,1,0
2020-07-21,Siskiyou,093,43540,81,48,0,48,0
2020-07-21,Solano,095,438530,3745,2727,12,2739,27
2020-07-21,Sonoma,097,501317,3097,2200,5,2205,17
2020-07-21,Stanislaus,099,539301,9741,6984,11,6995,69
2020-07-21,Sutter,101,95872,669,533,0,533,2
2020-07-21,Tehama,103,63373,221,150,2,152,1
2020-07-21,Trinity,105,12862,23,2,6,8,0
2020-07-21,Tulare,107,460477,9662,7447,33,7480,167
2020-07-21,Tuolumne,109,53932,132,75,2,77,0
2020-07-21,Ventura,111,848112,7707,6131,26,6157,55
2020-07-21,Yolo,113,214977,1570,1204,3,1207,34
2020-07-21,Yuba,115,75493,369,269,0,269,1
2020-07-20,Alameda,001,1643700,11655,9244,37,9281,162
2020-07-20,Alpine,003,1148,2,2,0,2,0
2020-07-20,Amador,005,37829,110,53,0,53,0
2020-07-20,Butte,007,227075,885,586,10,596,4
2020-07-20,Calaveras,009,45235,107,90,0,90,0
2020-07-20,Colusa,011,21464,287,217,0,217,0
2020-07-20,Contra Costa,013,1133247,8276,5823,25,5848,97
2020-07-20,Del Norte,015,27424,84,61,0,61,0
2020-07-20,El Dorado,017,186661,659,407,0,407,0
2020-07-20,Fresno,019,978130,18285,10891,159,11050,106
2020-07-20,Glenn,021,27897,323,225,0,225,1
2020-07-20,Humboldt,023,135768,229,194,1,195,4
2020-07-20,Imperial,025,180216,9843,7337,7,7344,124
2020-07-20,Inyo,027,18085,46,38,1,39,1
2020-07-20,Kern,029,883053,20786,10908,86,10994,118
2020-07-20,Kings,031,150075,4023,3093,24,3117,37
2020-07-20,Lake,033,64148,194,147,0,147,1
2020-07-20,Lassen,035,31185,564,474,2,476,0
2020-07-20,Los Angeles,037,10098052,178138,159202,344,159546,4108
2020-07-20,Madera,039,155013,2193,1433,3,1436,10
2020-07-20,Marin,041,260295,4844,4255,5,4260,21
2020-07-20,Mariposa,043,17540,53,36,0,36,1
2020-07-20,Mendocino,045,87422,219,153,0,153,0
2020-07-20,Merced,047,269075,4405,2584,2,2586,15
2020-07-20,Modoc,049,8938,3,0,0,0,0
2020-07-20,Mono,051,14174,118,78,1,79,1
2020-07-20,Monterey,053,433212,4334,3205,13,3218,19
2020-07-20,Napa,055,140530,942,632,0,632,5
2020-07-20,Nevada,057,99092,298,218,10,228,1
2020-07-20,Orange,059,3164182,38889,30337,612,30949,507
2020-07-20,Placer,061,380077,1856,1364,3,1367,11
2020-07-20,Plumas,063,18699,30,17,0,17,0
2020-07-20,Riverside,065,2383286,39014,31163,41,31204,581
2020-07-20,Sacramento,067,1510023,10262,7369,10,7379,99
2020-07-20,San Benito,069,59416,576,433,0,433,2
2020-07-20,San Bernardino,071,2135413,34438,24226,113,24339,338
2020-07-20,San Diego,073,3302833,28675,24137,2,24139,478
2020-07-20,San Francisco,075,870044,6316,5090,6,5096,53
2020-07-20,San Joaquin,077,732212,12070,8583,6,8589,97
2020-07-20,San Luis Obispo,079,281455,1767,1282,9,1291,6
2020-07-20,San Mateo,081,765935,5596,4609,7,4616,111
2020-07-20,Santa Barbara,083,443738,6020,5266,55,5321,29
2020-07-20,Santa Clara,085,1922200,10672,7711,28,7739,164
2020-07-20,Santa Cruz,087,273765,1050,758,8,766,3
2020-07-20,Shasta,089,179085,394,233,1,234,9
2020-07-20,Sierra,091,2930,1,1,0,1,0
2020-07-20,Siskiyou,093,43540,77,42,0,42,0
2020-07-20,Solano,095,438530,3662,2537,12,2549,26
2020-07-20,Sonoma,097,501317,2989,2148,5,2153,17
2020-07-20,Stanislaus,099,539301,9458,6835,11,6846,58
2020-07-20,Sutter,101,95872,636,507,0,507,2
2020-07-20,Tehama,103,63373,211,146,2,148,1
2020-07-20,Trinity,105,12862,23,2,6,8,0
2020-07-20,Tulare,107,460477,9428,6974,33,7007,166
2020-07-20,Tuolumne,109,53932,131,75,2,77,0
2020-07-20,Ventura,111,848112,7573,5912,26,5938,52
2020-07-20,Yolo,113,214977,1530,1155,3,1158,30
2020-07-20,Yuba,115,75493,349,258,0,258,1
2020-07-19,Alameda,001,1643700,11416,9227,31,9258,162
2020-07-19,Alpine,003,1148,2,2,0,2,0
2020-07-19,Amador,005,37829,103,51,0,51,0
2020-07-19,Butte,007,227075,860,555,10,565,4
2020-07-19,Calaveras,009,45235,105,89,0,89,0
2020-07-19,Colusa,011,21464,279,187,0,187,0
2020-07-19,Contra Costa,013,1133247,7985,5691,23,5714,95
2020-07-19,Del Norte,015,27424,83,61,0,61,0
2020-07-19,El Dorado,017,186661,641,385,0,385,0
2020-07-19,Fresno,019,978130,17761,10639,147,10786,106
2020-07-19,Glenn,021,27897,309,215,0,215,0
2020-07-19,Humboldt,023,135768,221,195,1,196,4
2020-07-19,Imperial,025,180216,9752,7280,7,7287,124
2020-07-19,Inyo,027,18085,42,38,1,39,1
2020-07-19,Kern,029,883053,20169,10094,79,10173,115
2020-07-19,Kings,031,150075,3937,3035,24,3059,37
2020-07-19,Lake,033,64148,189,144,0,144,1
2020-07-19,Lassen,035,31185,545,474,2,476,0
2020-07-19,Los Angeles,037,10098052,174697,156039,321,156360,4100
2020-07-19,Madera,039,155013,2116,1301,3,1304,10
2020-07-19,Marin,041,260295,4789,4172,5,4177,21
2020-07-19,Mariposa,043,17540,49,35,0,35,1
2020-07-19,Mendocino,045,87422,214,137,0,137,0
2020-07-19,Merced,047,269075,4198,2460,2,2462,15
2020-07-19,Modoc,049,8938,3,0,0,0,0
2020-07-19,Mono,051,14174,107,63,1,64,1
2020-07-19,Monterey,053,433212,4214,3079,13,3092,18
2020-07-19,Napa,055,140530,913,612,0,612,5
2020-07-19,Nevada,057,99092,292,210,10,220,1
2020-07-19,Orange,059,3164182,38325,29941,599,30540,505
2020-07-19,Placer,061,380077,1808,1246,3,1249,11
2020-07-19,Plumas,063,18699,30,17,0,17,0
2020-07-19,Riverside,065,2383286,38309,30340,41,30381,581
2020-07-19,Sacramento,067,1510023,9870,6985,10,6995,97
2020-07-19,San Benito,069,59416,560,412,0,412,2
2020-07-19,San Bernardino,071,2135413,33664,23928,101,24029,337
2020-07-19,San Diego,073,3302833,28174,23684,2,23686,478
2020-07-19,San Francisco,075,870044,6169,5094,6,5100,52
2020-07-19,San Joaquin,077,732212,11664,8308,6,8314,93
2020-07-19,San Luis Obispo,079,281455,1723,1262,8,1270,6
2020-07-19,San Mateo,081,765935,5490,4522,7,4529,110
2020-07-19,Santa Barbara,083,443738,5918,5145,52,5197,29
2020-07-19,Santa Clara,085,1922200,10428,7403,28,7431,164
2020-07-19,Santa Cruz,087,273765,1006,753,8,761,3
2020-07-19,Shasta,089,179085,381,218,1,219,9
2020-07-19,Sierra,091,2930,1,1,0,1,0
2020-07-19,Siskiyou,093,43540,75,42,0,42,0
2020-07-19,Solano,095,438530,3557,2551,12,2563,26
2020-07-19,Sonoma,097,501317,2889,2074,5,2079,17
2020-07-19,Stanislaus,099,539301,9162,6508,11,6519,58
2020-07-19,Sutter,101,95872,605,480,0,480,2
2020-07-19,Tehama,103,63373,207,138,2,140,1
2020-07-19,Trinity,105,12862,23,2,6,8,0
2020-07-19,Tulare,107,460477,9180,6856,33,6889,166
2020-07-19,Tuolumne,109,53932,126,75,2,77,0
2020-07-19,Ventura,111,848112,7383,5706,26,5732,52
2020-07-19,Yolo,113,214977,1490,1127,3,1130,30
2020-07-19,Yuba,115,75493,329,240,0,240,1
2020-07-18,Alameda,001,1643700,11279,9089,30,9119,162
2020-07-18,Alpine,003,1148,2,2,0,2,0
2020-07-18,Amador,005,37829,99,49,0,49,0
2020-07-18,Butte,007,227075,851,551,10,561,4
2020-07-18,Calaveras,009,45235,101,89,0,89,0
2020-07-18,Colusa,011,21464,274,182,0,182,0
2020-07-18,Contra Costa,013,1133247,7851,5617,23,5640,95
2020-07-18,Del Norte,015,27424,83,61,0,61,0
2020-07-18,El Dorado,017,186661,638,385,0,385,0
2020-07-18,Fresno,019,978130,17512,10381,145,10526,106
2020-07-18,Glenn,021,27897,303,212,0,212,0
2020-07-18,Humboldt,023,135768,218,189,1,190,4
2020-07-18,Imperial,025,180216,9721,7268,7,7275,124
2020-07-18,Inyo,027,18085,42,38,1,39,1
2020-07-18,Kern,029,883053,19866,9250,76,9326,114
2020-07-18,Kings,031,150075,3897,2996,23,3019,37
2020-07-18,Lake,033,64148,186,142,0,142,1
2020-07-18,Lassen,035,31185,544,474,2,476,0
2020-07-18,Los Angeles,037,10098052,173253,153265,310,153575,4088
2020-07-18,Madera,039,155013,2070,1260,3,1263,9
2020-07-18,Marin,041,260295,4760,4089,5,4094,21
2020-07-18,Mariposa,043,17540,49,35,0,35,1
2020-07-18,Mendocino,045,87422,208,137,0,137,0
2020-07-18,Merced,047,269075,4079,2424,2,2426,15
2020-07-18,Modoc,049,8938,3,0,0,0,0
2020-07-18,Mono,051,14174,105,54,1,55,1
2020-07-18,Monterey,053,433212,4146,3020,13,3033,17
2020-07-18,Napa,055,140530,902,609,0,609,5
2020-07-18,Nevada,057,99092,288,204,9,213,1
2020-07-18,Orange,059,3164182,38006,29603,578,30181,493
2020-07-18,Placer,061,380077,1785,1233,3,1236,11
2020-07-18,Plumas,063,18699,30,17,0,17,0
2020-07-18,Riverside,065,2383286,37955,30245,40,30285,581
2020-07-18,Sacramento,067,1510023,9625,6739,10,6749,95
2020-07-18,San Benito,069,59416,545,407,0,407,2
2020-07-18,San Bernardino,071,2135413,33204,23680,94,23774,336
2020-07-18,San Diego,073,3302833,27871,23116,2,23118,478
2020-07-18,San Francisco,075,870044,6067,5051,6,5057,52
2020-07-18,San Joaquin,077,732212,11451,8118,6,8124,93
2020-07-18,San Luis Obispo,079,281455,1688,1234,8,1242,6
2020-07-18,San Mateo,081,765935,5430,4488,7,4495,110
2020-07-18,Santa Barbara,083,443738,5858,5110,50,5160,29
2020-07-18,Santa Clara,085,1922200,10278,7255,27,7282,164
2020-07-18,Santa Cruz,087,273765,989,751,8,759,3
2020-07-18,Shasta,089,179085,372,216,1,217,9
2020-07-18,Sierra,091,2930,1,1,0,1,0
2020-07-18,Siskiyou,093,43540,71,42,0,42,0
2020-07-18,Solano,095,438530,3516,2503,12,2515,26
2020-07-18,Sonoma,097,501317,2838,2019,5,2024,15
2020-07-18,Stanislaus,099,539301,9027,6344,11,6355,58
2020-07-18,Sutter,101,95872,599,473,0,473,2
2020-07-18,Tehama,103,63373,202,136,2,138,1
2020-07-18,Trinity,105,12862,23,2,6,8,0
2020-07-18,Tulare,107,460477,9089,6810,32,6842,167
2020-07-18,Tuolumne,109,53932,123,75,2,77,0
2020-07-18,Ventura,111,848112,7301,5630,26,5656,52
2020-07-18,Yolo,113,214977,1462,1077,3,1080,30
2020-07-18,Yuba,115,75493,318,237,0,237,1
2020-07-17,Alameda,001,1643700,11138,8893,29,8922,160
2020-07-17,Alpine,003,1148,2,1,0,1,0
2020-07-17,Amador,005,37829,97,48,0,48,0
2020-07-17,Butte,007,227075,837,497,10,507,4
2020-07-17,Calaveras,009,45235,99,86,0,86,0
2020-07-17,Colusa,011,21464,272,146,0,146,0
2020-07-17,Contra Costa,013,1133247,7703,5483,23,5506,93
2020-07-17,Del Norte,015,27424,82,60,0,60,0
2020-07-17,El Dorado,017,186661,622,368,0,368,0
2020-07-17,Fresno,019,978130,17214,9954,145,10099,104
2020-07-17,Glenn,021,27897,296,203,0,203,0
2020-07-17,Humboldt,023,135768,217,185,1,186,4
2020-07-17,Imperial,025,180216,9699,7193,7,7200,120
2020-07-17,Inyo,027,18085,42,38,1,39,1
2020-07-17,Kern,029,883053,19546,8291,75,8366,113
2020-07-17,Kings,031,150075,3858,2978,23,3001,37
2020-07-17,Lake,033,64148,184,139,0,139,1
2020-07-17,Lassen,035,31185,525,391,2,393,0
2020-07-17,Los Angeles,037,10098052,170881,150481,298,150779,4052
2020-07-17,Madera,039,155013,2026,1214,3,1217,9
2020-07-17,Marin,041,260295,4723,3839,5,3844,21
2020-07-17,Mariposa,043,17540,47,35,0,35,1
2020-07-17,Mendocino,045,87422,200,126,0,126,0
2020-07-17,Merced,047,269075,4004,2328,2,2330,12
2020-07-17,Modoc,049,8938,2,0,0,0,0
2020-07-17,Mono,051,14174,100,54,1,55,1
2020-07-17,Monterey,053,433212,4017,2922,13,2935,18
2020-07-17,Napa,055,140530,888,598,0,598,5
2020-07-17,Nevada,057,99092,281,200,9,209,1
2020-07-17,Orange,059,3164182,37543,28962,545,29507,485
2020-07-17,Placer,061,380077,1756,1207,3,1210,11
2020-07-17,Plumas,063,18699,27,16,0,16,0
2020-07-17,Riverside,065,2383286,37356,29639,40,29679,580
2020-07-17,Sacramento,067,1510023,9381,6563,10,6573,95
2020-07-17,San Benito,069,59416,530,399,0,399,2
2020-07-17,San Bernardino,071,2135413,32684,23057,91,23148,322
2020-07-17,San Diego,073,3302833,27482,22491,2,22493,472
2020-07-17,San Francisco,075,870044,5973,4967,6,4973,52
2020-07-17,San Joaquin,077,732212,11207,7925,6,7931,86
2020-07-17,San Luis Obispo,079,281455,1651,1190,8,1198,6
2020-07-17,San Mateo,081,765935,5334,4407,7,4414,110
2020-07-17,Santa Barbara,083,443738,5786,5001,49,5050,29
2020-07-17,Santa Clara,085,1922200,10060,7080,27,7107,164
2020-07-17,Santa Cruz,087,273765,967,716,8,724,3
2020-07-17,Shasta,089,179085,360,213,1,214,8
2020-07-17,Sierra,091,2930,1,1,0,1,0
2020-07-17,Siskiyou,093,43540,70,40,0,40,0
2020-07-17,Solano,095,438530,3467,2452,12,2464,26
2020-07-17,Sonoma,097,501317,2790,1982,5,1987,15
2020-07-17,Stanislaus,099,539301,8853,6220,11,6231,56
2020-07-17,Sutter,101,95872,586,458,0,458,2
2020-07-17,Tehama,103,63373,198,128,2,130,1
2020-07-17,Trinity,105,12862,23,2,6,8,0
2020-07-17,Tulare,107,460477,8953,6671,32,6703,166
2020-07-17,Tuolumne,109,53932,122,73,2,75,0
2020-07-17,Ventura,111,848112,7217,5451,26,5477,51
2020-07-17,Yolo,113,214977,1438,1055,3,1058,30
2020-07-17,Yuba,115,75493,308,231,0,231,1
2020-07-16,Alameda,001,1643700,10904,8719,24,8743,153
2020-07-16,Alpine,003,1148,2,1,0,1,0
2020-07-16,Amador,005,37829,94,46,0,46,0
2020-07-16,Butte,007,227075,800,465,9,474,4
2020-07-16,Calaveras,009,45235,97,82,0,82,0
2020-07-16,Colusa,011,21464,263,140,0,140,0
2020-07-16,Contra Costa,013,1133247,7491,5338,17,5355,91
2020-07-16,Del Norte,015,27424,82,60,0,60,0
2020-07-16,El Dorado,017,186661,605,357,0,357,0
2020-07-16,Fresno,019,978130,16703,9481,136,9617,101
2020-07-16,Glenn,021,27897,287,190,0,190,0
2020-07-16,Humboldt,023,135768,215,184,1,185,4
2020-07-16,Imperial,025,180216,9604,7148,7,7155,113
2020-07-16,Inyo,027,18085,42,38,1,39,1
2020-07-16,Kern,029,883053,19024,7435,73,7508,112
2020-07-16,Kings,031,150075,3691,2937,23,2960,37
2020-07-16,Lake,033,64148,179,128,0,128,1
2020-07-16,Lassen,035,31185,524,355,2,357,0
2020-07-16,Los Angeles,037,10098052,167663,147759,273,148032,3994
2020-07-16,Madera,039,155013,1962,1192,3,1195,8
2020-07-16,Marin,041,260295,4651,3546,5,3551,21
2020-07-16,Mariposa,043,17540,45,34,0,34,1
2020-07-16,Mendocino,045,87422,195,121,0,121,0
2020-07-16,Merced,047,269075,3842,2228,2,2230,12
2020-07-16,Modoc,049,8938,1,0,0,0,0
2020-07-16,Mono,051,14174,97,53,1,54,1
2020-07-16,Monterey,053,433212,3913,2857,12,2869,18
2020-07-16,Napa,055,140530,859,581,0,581,5
2020-07-16,Nevada,057,99092,278,191,9,200,1
2020-07-16,Orange,059,3164182,36842,28525,509,29034,471
2020-07-16,Placer,061,380077,1708,1168,3,1171,11
2020-07-16,Plumas,063,18699,25,16,0,16,0
2020-07-16,Riverside,065,2383286,36611,28904,38,28942,577
2020-07-16,Sacramento,067,1510023,9068,6440,9,6449,91
2020-07-16,San Benito,069,59416,513,389,0,389,2
2020-07-16,San Bernardino,071,2135413,31823,22355,73,22428,321
2020-07-16,San Diego,073,3302833,26995,21857,2,21859,465
2020-07-16,San Francisco,075,870044,5832,4838,6,4844,52
2020-07-16,San Joaquin,077,732212,10844,7713,6,7719,82
2020-07-16,San Luis Obispo,079,281455,1607,1146,8,1154,6
2020-07-16,San Mateo,081,765935,5230,4336,7,4343,110
2020-07-16,Santa Barbara,083,443738,5691,4872,48,4920,28
2020-07-16,Santa Clara,085,1922200,9780,6990,25,7015,164
2020-07-16,Santa Cruz,087,273765,926,698,8,706,3
2020-07-16,Shasta,089,179085,345,208,1,209,7
2020-07-16,Sierra,091,2930,1,1,0,1,0
2020-07-16,Siskiyou,093,43540,67,39,0,39,0
2020-07-16,Solano,095,438530,3373,2372,12,2384,25
2020-07-16,Sonoma,097,501317,2700,1954,5,1959,14
2020-07-16,Stanislaus,099,539301,8570,6077,10,6087,56
2020-07-16,Sutter,101,95872,570,444,0,444,2
2020-07-16,Tehama,103,63373,188,126,2,128,1
2020-07-16,Trinity,105,12862,23,2,5,7,0
2020-07-16,Tulare,107,460477,8737,6467,31,6498,163
2020-07-16,Tuolumne,109,53932,117,71,2,73,0
2020-07-16,Ventura,111,848112,7055,5231,26,5257,50
2020-07-16,Yolo,113,214977,1397,1034,3,1037,29
2020-07-16,Yuba,115,75493,290,221,0,221,1
2020-07-15,Alameda,001,1643700,10699,8615,19,8634,153
2020-07-15,Alpine,003,1148,2,1,0,1,0
2020-07-15,Amador,005,37829,73,44,0,44,0
2020-07-15,Butte,007,227075,758,420,9,429,4
2020-07-15,Calaveras,009,45235,97,75,0,75,0
2020-07-15,Colusa,011,21464,258,135,0,135,0
2020-07-15,Contra Costa,013,1133247,7260,5246,17,5263,90
2020-07-15,Del Norte,015,27424,81,60,0,60,0
2020-07-15,El Dorado,017,186661,581,339,0,339,0
2020-07-15,Fresno,019,978130,16229,9124,129,9253,101
2020-07-15,Glenn,021,27897,278,184,0,184,0
2020-07-15,Humboldt,023,135768,213,181,1,182,4
2020-07-15,Imperial,025,180216,9537,7110,7,7117,110
2020-07-15,Inyo,027,18085,42,36,1,37,1
2020-07-15,Kern,029,883053,18404,7155,70,7225,108
2020-07-15,Kings,031,150075,3630,2906,23,2929,37
2020-07-15,Lake,033,64148,177,122,0,122,1
2020-07-15,Lassen,035,31185,520,319,2,321,0
2020-07-15,Los Angeles,037,10098052,164199,143343,258,143601,3946
2020-07-15,Madera,039,155013,1893,1147,3,1150,4
2020-07-15,Marin,041,260295,4596,3458,5,3463,21
2020-07-15,Mariposa,043,17540,45,34,0,34,1
2020-07-15,Mendocino,045,87422,192,119,0,119,0
2020-07-15,Merced,047,269075,3693,2156,2,2158,12
2020-07-15,Modoc,049,8938,1,0,0,0,0
2020-07-15,Mono,051,14174,95,52,1,53,1
2020-07-15,Monterey,053,433212,3801,2780,12,2792,18
2020-07-15,Napa,055,140530,833,573,0,573,5
2020-07-15,Nevada,057,99092,274,185,7,192,1
2020-07-15,Orange,059,3164182,36042,27718,475,28193,454
2020-07-15,Placer,061,380077,1650,1145,3,1148,11
2020-07-15,Plumas,063,18699,25,16,0,16,0
2020-07-15,Riverside,065,2383286,35828,28492,36,28528,568
2020-07-15,Sacramento,067,1510023,8687,6217,9,6226,91
2020-07-15,San Benito,069,59416,504,388,0,388,2
2020-07-15,San Bernardino,071,2135413,31034,21508,57,21565,317
2020-07-15,San Diego,073,3302833,26528,21448,2,21450,448
2020-07-15,San Francisco,075,870044,5718,4757,6,4763,50
2020-07-15,San Joaquin,077,732212,10412,7381,5,7386,75
2020-07-15,San Luis Obispo,079,281455,1564,1097,8,1105,6
2020-07-15,San Mateo,081,765935,5117,4258,7,4265,109
2020-07-15,Santa Barbara,083,443738,5577,4733,48,4781,28
2020-07-15,Santa Clara,085,1922200,9476,6900,25,6925,164
2020-07-15,Santa Cruz,087,273765,890,660,7,667,3
2020-07-15,Shasta,089,179085,336,193,1,194,7
2020-07-15,Sierra,091,2930,1,1,0,1,0
2020-07-15,Siskiyou,093,43540,66,38,0,38,0
2020-07-15,Solano,095,438530,3278,2343,12,2355,25
2020-07-15,Sonoma,097,501317,2602,1920,5,1925,14
2020-07-15,Stanislaus,099,539301,8273,5777,10,5787,56
2020-07-15,Sutter,101,95872,544,433,0,433,2
2020-07-15,Tehama,103,63373,180,126,2,128,1
2020-07-15,Trinity,105,12862,22,2,5,7,0
2020-07-15,Tulare,107,460477,8526,6320,30,6350,156
2020-07-15,Tuolumne,109,53932,110,68,2,70,0
2020-07-15,Ventura,111,848112,6878,5087,26,5113,50
2020-07-15,Yolo,113,214977,1365,1002,3,1005,27
2020-07-15,Yuba,115,75493,278,221,0,221,1
2020-07-14,Alameda,001,1643700,10357,8388,13,8401,151
2020-07-14,Alpine,003,1148,2,1,0,1,0
2020-07-14,Amador,005,37829,69,44,0,44,0
2020-07-14,Butte,007,227075,712,382,9,391,4
2020-07-14,Calaveras,009,45235,95,74,0,74,0
2020-07-14,Colusa,011,21464,248,128,0,128,0
2020-07-14,Contra Costa,013,1133247,7023,5110,15,5125,90
2020-07-14,Del Norte,015,27424,80,60,0,60,0
2020-07-14,El Dorado,017,186661,566,324,0,324,0
2020-07-14,Fresno,019,978130,15809,8941,124,9065,98
2020-07-14,Glenn,021,27897,268,177,0,177,0
2020-07-14,Humboldt,023,135768,210,175,1,176,4
2020-07-14,Imperial,025,180216,9409,7095,7,7102,109
2020-07-14,Inyo,027,18085,42,35,1,36,1
2020-07-14,Kern,029,883053,17645,6979,57,7036,107
2020-07-14,Kings,031,150075,3563,2867,22,2889,37
2020-07-14,Lake,033,64148,171,120,0,120,1
2020-07-14,Lassen,035,31185,503,263,2,265,0
2020-07-14,Los Angeles,037,10098052,161066,140632,228,140860,3900
2020-07-14,Madera,039,155013,1819,1118,3,1121,4
2020-07-14,Marin,041,260295,4482,3451,5,3456,21
2020-07-14,Mariposa,043,17540,41,32,0,32,1
2020-07-14,Mendocino,045,87422,184,110,0,110,0
2020-07-14,Merced,047,269075,3514,2084,2,2086,12
2020-07-14,Modoc,049,8938,1,0,0,0,0
2020-07-14,Mono,051,14174,85,48,1,49,1
2020-07-14,Monterey,053,433212,3687,2724,12,2736,18
2020-07-14,Napa,055,140530,777,557,0,557,4
2020-07-14,Nevada,057,99092,257,180,6,186,1
2020-07-14,Orange,059,3164182,35162,26915,428,27343,432
2020-07-14,Placer,061,380077,1592,1122,3,1125,11
2020-07-14,Plumas,063,18699,24,14,0,14,0
2020-07-14,Riverside,065,2383286,35071,27850,35,27885,547
2020-07-14,Sacramento,067,1510023,8333,5978,9,5987,87
2020-07-14,San Benito,069,59416,485,360,0,360,2
2020-07-14,San Bernardino,071,2135413,30183,20489,47,20536,316
2020-07-14,San Diego,073,3302833,25908,20887,2,20889,436
2020-07-14,San Francisco,075,870044,5568,4659,5,4664,50
2020-07-14,San Joaquin,077,732212,9984,7143,5,7148,75
2020-07-14,San Luis Obispo,079,281455,1526,1060,8,1068,5
2020-07-14,San Mateo,081,765935,5024,4173,7,4180,108
2020-07-14,Santa Barbara,083,443738,5453,4641,46,4687,28
2020-07-14,Santa Clara,085,1922200,9148,6686,22,6708,164
2020-07-14,Santa Cruz,087,273765,851,639,7,646,3
2020-07-14,Shasta,089,179085,327,190,1,191,7
2020-07-14,Sierra,091,2930,1,1,0,1,0
2020-07-14,Siskiyou,093,43540,65,38,0,38,0
2020-07-14,Solano,095,438530,3178,2266,10,2276,25
2020-07-14,Sonoma,097,501317,2509,1866,5,1871,14
2020-07-14,Stanislaus,099,539301,7899,5631,9,5640,53
2020-07-14,Sutter,101,95872,525,405,0,405,2
2020-07-14,Tehama,103,63373,168,123,2,125,1
2020-07-14,Trinity,105,12862,21,2,5,7,0
2020-07-14,Tulare,107,460477,8280,6199,30,6229,156
2020-07-14,Tuolumne,109,53932,105,68,2,70,0
2020-07-14,Ventura,111,848112,6717,4950,26,4976,50
2020-07-14,Yolo,113,214977,1317,966,3,969,27
2020-07-14,Yuba,115,75493,261,210,0,210,1
2020-07-13,Alameda,001,1643700,10048,8115,13,8128,148
2020-07-13,Alpine,003,1148,2,1,0,1,0
2020-07-13,Amador,005,37829,65,42,0,42,0
2020-07-13,Butte,007,227075,676,354,9,363,4
2020-07-13,Calaveras,009,45235,87,63,0,63,0
2020-07-13,Colusa,011,21464,242,116,0,116,0
2020-07-13,Contra Costa,013,1133247,6751,4882,13,4895,88
2020-07-13,Del Norte,015,27424,74,59,0,59,0
2020-07-13,El Dorado,017,186661,535,298,0,298,0
2020-07-13,Fresno,019,978130,15378,8666,119,8785,95
2020-07-13,Glenn,021,27897,261,168,0,168,0
2020-07-13,Humboldt,023,135768,205,174,1,175,4
2020-07-13,Imperial,025,180216,9324,7052,7,7059,109
2020-07-13,Inyo,027,18085,41,35,1,36,1
2020-07-13,Kern,029,883053,16960,6808,52,6860,107
2020-07-13,Kings,031,150075,3512,2824,22,2846,37
2020-07-13,Lake,033,64148,166,118,0,118,1
2020-07-13,Lassen,035,31185,498,237,2,239,0
2020-07-13,Los Angeles,037,10098052,157834,136368,214,136582,3829
2020-07-13,Madera,039,155013,1750,1059,3,1062,4
2020-07-13,Marin,041,260295,4378,3402,5,3407,21
2020-07-13,Mariposa,043,17540,40,31,0,31,1
2020-07-13,Mendocino,045,87422,180,87,0,87,0
2020-07-13,Merced,047,269075,3365,2007,2,2009,12
2020-07-13,Modoc,049,8938,1,0,0,0,0
2020-07-13,Mono,051,14174,81,47,0,47,1
2020-07-13,Monterey,053,433212,3564,2613,9,2622,18
2020-07-13,Napa,055,140530,741,534,0,534,4
2020-07-13,Nevada,057,99092,243,172,6,178,1
2020-07-13,Orange,059,3164182,34297,25978,395,26373,423
2020-07-13,Placer,061,380077,1547,1096,3,1099,11
2020-07-13,Plumas,063,18699,22,14,0,14,0
2020-07-13,Riverside,065,2383286,34146,27136,33,27169,545
2020-07-13,Sacramento,067,1510023,8036,5747,9,5756,85
2020-07-13,San Benito,069,59416,472,343,0,343,2
2020-07-13,San Bernardino,071,2135413,29305,19610,41,19651,313
2020-07-13,San Diego,073,3302833,25341,20348,2,20350,422
2020-07-13,San Francisco,075,870044,5440,4534,4,4538,50
2020-07-13,San Joaquin,077,732212,9568,6927,5,6932,71
2020-07-13,San Luis Obispo,079,281455,1495,989,8,997,5
2020-07-13,San Mateo,081,765935,4893,4057,7,4064,108
2020-07-13,Santa Barbara,083,443738,5339,4441,45,4486,28
2020-07-13,Santa Clara,085,1922200,8825,6488,21,6509,164
2020-07-13,Santa Cruz,087,273765,813,574,7,581,3
2020-07-13,Shasta,089,179085,316,185,1,186,6
2020-07-13,Sierra,091,2930,1,1,0,1,0
2020-07-13,Siskiyou,093,43540,61,37,0,37,0
2020-07-13,Solano,095,438530,3066,2046,10,2056,23
2020-07-13,Sonoma,097,501317,2398,1818,5,1823,14
2020-07-13,Stanislaus,099,539301,7596,5324,8,5332,53
2020-07-13,Sutter,101,95872,487,379,0,379,2
2020-07-13,Tehama,103,63373,155,112,2,114,1
2020-07-13,Trinity,105,12862,21,2,5,7,0
2020-07-13,Tulare,107,460477,8019,5930,28,5958,147
2020-07-13,Tuolumne,109,53932,97,56,2,58,0
2020-07-13,Ventura,111,848112,6527,4800,23,4823,50
2020-07-13,Yolo,113,214977,1271,941,3,944,27
2020-07-13,Yuba,115,75493,246,194,0,194,1
2020-07-12,Alameda,001,1643700,9777,8056,13,8069,148
2020-07-12,Alpine,003,1148,2,1,0,1,0
2020-07-12,Amador,005,37829,55,40,0,40,0
2020-07-12,Butte,007,227075,626,341,8,349,4
2020-07-12,Calaveras,009,45235,87,62,0,62,0
2020-07-12,Colusa,011,21464,208,116,0,116,0
2020-07-12,Contra Costa,013,1133247,6480,4708,11,4719,88
2020-07-12,Del Norte,015,27424,63,59,0,59,0
2020-07-12,El Dorado,017,186661,513,290,0,290,0
2020-07-12,Fresno,019,978130,14952,8407,114,8521,95
2020-07-12,Glenn,021,27897,248,166,0,166,0
2020-07-12,Humboldt,023,135768,201,174,1,175,4
2020-07-12,Imperial,025,180216,9206,6999,7,7006,109
2020-07-12,Inyo,027,18085,39,35,1,36,1
2020-07-12,Kern,029,883053,16216,6662,49,6711,105
2020-07-12,Kings,031,150075,3450,2779,22,2801,34
2020-07-12,Lake,033,64148,157,114,0,114,1
2020-07-12,Lassen,035,31185,491,237,2,239,0
2020-07-12,Los Angeles,037,10098052,154417,133830,185,134015,3816
2020-07-12,Madera,039,155013,1695,1025,3,1028,4
2020-07-12,Marin,041,260295,4301,3358,5,3363,21
2020-07-12,Mariposa,043,17540,39,31,0,31,1
2020-07-12,Mendocino,045,87422,161,88,0,88,0
2020-07-12,Merced,047,269075,3235,1908,2,1910,12
2020-07-12,Modoc,049,8938,1,0,0,0,0
2020-07-12,Mono,051,14174,71,45,0,45,1
2020-07-12,Monterey,053,433212,3449,2521,9,2530,18
2020-07-12,Napa,055,140530,709,519,0,519,4
2020-07-12,Nevada,057,99092,233,166,6,172,1
2020-07-12,Orange,059,3164182,33422,25399,386,25785,422
2020-07-12,Placer,061,380077,1491,1058,3,1061,11
2020-07-12,Plumas,063,18699,21,14,0,14,0
2020-07-12,Riverside,065,2383286,33386,26404,33,26437,542
2020-07-12,Sacramento,067,1510023,7724,5515,7,5522,85
2020-07-12,San Benito,069,59416,457,324,0,324,2
2020-07-12,San Bernardino,071,2135413,28393,19042,36,19078,312
2020-07-12,San Diego,073,3302833,24710,19929,2,19931,422
2020-07-12,San Francisco,075,870044,5290,4535,4,4539,50
2020-07-12,San Joaquin,077,732212,9206,6703,5,6708,71
2020-07-12,San Luis Obispo,079,281455,1448,972,7,979,5
2020-07-12,San Mateo,081,765935,4775,3988,7,3995,108
2020-07-12,Santa Barbara,083,443738,5209,4353,44,4397,28
2020-07-12,Santa Clara,085,1922200,8587,6252,20,6272,164
2020-07-12,Santa Cruz,087,273765,771,573,5,578,3
2020-07-12,Shasta,089,179085,310,173,1,174,6
2020-07-12,Sierra,091,2930,1,1,0,1,0
2020-07-12,Siskiyou,093,43540,59,36,0,36,0
2020-07-12,Solano,095,438530,2941,2037,10,2047,23
2020-07-12,Sonoma,097,501317,2304,1743,5,1748,13
2020-07-12,Stanislaus,099,539301,7292,5177,8,5185,53
2020-07-12,Sutter,101,95872,469,362,0,362,2
2020-07-12,Tehama,103,63373,148,111,2,113,1
2020-07-12,Trinity,105,12862,21,2,5,7,0
2020-07-12,Tulare,107,460477,7764,5864,27,5891,146
2020-07-12,Tuolumne,109,53932,89,52,2,54,0
2020-07-12,Ventura,111,848112,6311,4724,22,4746,50
2020-07-12,Yolo,113,214977,1230,889,3,892,27
2020-07-12,Yuba,115,75493,235,188,0,188,1
2020-07-11,Alameda,001,1643700,9675,7845,13,7858,148
2020-07-11,Alpine,003,1148,2,1,0,1,0
2020-07-11,Amador,005,37829,51,37,0,37,0
2020-07-11,Butte,007,227075,610,325,8,333,4
2020-07-11,Calaveras,009,45235,84,62,0,62,0
2020-07-11,Colusa,011,21464,203,110,0,110,0
2020-07-11,Contra Costa,013,1133247,6363,4650,11,4661,87
2020-07-11,Del Norte,015,27424,63,59,0,59,0
2020-07-11,El Dorado,017,186661,502,283,0,283,0
2020-07-11,Fresno,019,978130,14692,8086,112,8198,95
2020-07-11,Glenn,021,27897,240,161,0,161,0
2020-07-11,Humboldt,023,135768,200,174,1,175,4
2020-07-11,Imperial,025,180216,9167,6884,7,6891,109
2020-07-11,Inyo,027,18085,39,35,1,36,1
2020-07-11,Kern,029,883053,15859,6509,48,6557,103
2020-07-11,Kings,031,150075,3423,2753,22,2775,33
2020-07-11,Lake,033,64148,156,110,0,110,1
2020-07-11,Lassen,035,31185,490,237,2,239,0
2020-07-11,Los Angeles,037,10098052,152700,130479,175,130654,3802
2020-07-11,Madera,039,155013,1654,988,3,991,4
2020-07-11,Marin,041,260295,4273,3191,5,3196,21
2020-07-11,Mariposa,043,17540,39,31,0,31,1
2020-07-11,Mendocino,045,87422,157,88,0,88,0
2020-07-11,Merced,047,269075,3154,1851,2,1853,12
2020-07-11,Modoc,049,8938,1,0,0,0,0
2020-07-11,Mono,051,14174,68,45,0,45,1
2020-07-11,Monterey,053,433212,3360,2376,8,2384,18
2020-07-11,Napa,055,140530,697,509,0,509,4
2020-07-11,Nevada,057,99092,224,163,5,168,1
2020-07-11,Orange,059,3164182,33045,24430,372,24802,422
2020-07-11,Placer,061,380077,1456,1029,3,1032,11
2020-07-11,Plumas,063,18699,21,12,0,12,0
2020-07-11,Riverside,065,2383286,32995,25994,33,26027,538
2020-07-11,Sacramento,067,1510023,7550,5367,7,5374,84
2020-07-11,San Benito,069,59416,442,314,0,314,2
2020-07-11,San Bernardino,071,2135413,27956,18907,34,18941,310
2020-07-11,San Diego,073,3302833,24321,19371,2,19373,422
2020-07-11,San Francisco,075,870044,5194,4430,3,4433,50
2020-07-11,San Joaquin,077,732212,9028,6518,5,6523,72
2020-07-11,San Luis Obispo,079,281455,1400,930,7,937,4
2020-07-11,San Mateo,081,765935,4707,3956,7,3963,108
2020-07-11,Santa Barbara,083,443738,5140,4283,43,4326,28
2020-07-11,Santa Clara,085,1922200,8428,5959,20,5979,164
2020-07-11,Santa Cruz,087,273765,740,571,5,576,3
2020-07-11,Shasta,089,179085,303,168,1,169,6
2020-07-11,Sierra,091,2930,1,1,0,1,0
2020-07-11,Siskiyou,093,43540,59,36,0,36,0
2020-07-11,Solano,095,438530,2900,2034,10,2044,23
2020-07-11,Sonoma,097,501317,2266,1690,5,1695,13
2020-07-11,Stanislaus,099,539301,7151,4911,8,4919,51
2020-07-11,Sutter,101,95872,453,352,0,352,2
2020-07-11,Tehama,103,63373,146,111,2,113,1
2020-07-11,Trinity,105,12862,21,2,5,7,0
2020-07-11,Tulare,107,460477,7658,5780,27,5807,149
2020-07-11,Tuolumne,109,53932,87,50,2,52,0
2020-07-11,Ventura,111,848112,6215,4545,21,4566,49
2020-07-11,Yolo,113,214977,1201,833,3,836,27
2020-07-11,Yuba,115,75493,225,175,0,175,1
2020-07-10,Alameda,001,1643700,9518,7551,13,7564,147
2020-07-10,Alpine,003,1148,2,1,0,1,0
2020-07-10,Amador,005,37829,47,37,0,37,0
2020-07-10,Butte,007,227075,599,318,8,326,4
2020-07-10,Calaveras,009,45235,84,61,0,61,0
2020-07-10,Colusa,011,21464,197,103,0,103,0
2020-07-10,Contra Costa,013,1133247,6220,4482,11,4493,86
2020-07-10,Del Norte,015,27424,63,57,0,57,0
2020-07-10,El Dorado,017,186661,484,266,0,266,0
2020-07-10,Fresno,019,978130,14360,7760,109,7869,93
2020-07-10,Glenn,021,27897,235,157,0,157,0
2020-07-10,Humboldt,023,135768,199,168,1,169,4
2020-07-10,Imperial,025,180216,9122,6878,6,6884,98
2020-07-10,Inyo,027,18085,39,35,1,36,1
2020-07-10,Kern,029,883053,15426,6344,47,6391,102
2020-07-10,Kings,031,150075,3387,2707,22,2729,33
2020-07-10,Lake,033,64148,149,104,0,104,1
2020-07-10,Lassen,035,31185,489,235,2,237,0
2020-07-10,Los Angeles,037,10098052,150282,127503,169,127672,3750
2020-07-10,Madera,039,155013,1608,914,3,917,4
2020-07-10,Marin,041,260295,4210,3101,5,3106,21
2020-07-10,Mariposa,043,17540,38,31,0,31,1
2020-07-10,Mendocino,045,87422,149,88,0,88,0
2020-07-10,Merced,047,269075,3075,1802,2,1804,12
2020-07-10,Modoc,049,8938,1,0,0,0,0
2020-07-10,Mono,051,14174,67,45,0,45,1
2020-07-10,Monterey,053,433212,3281,2285,8,2293,18
2020-07-10,Napa,055,140530,686,496,0,496,4
2020-07-10,Nevada,057,99092,219,161,5,166,1
2020-07-10,Orange,059,3164182,32458,23692,369,24061,416
2020-07-10,Placer,061,380077,1414,1002,3,1005,11
2020-07-10,Plumas,063,18699,19,12,0,12,0
2020-07-10,Riverside,065,2383286,32478,25481,33,25514,533
2020-07-10,Sacramento,067,1510023,7295,5181,7,5188,81
2020-07-10,San Benito,069,59416,433,302,0,302,2
2020-07-10,San Bernardino,071,2135413,27431,18242,31,18273,308
2020-07-10,San Diego,073,3302833,23936,18862,2,18864,420
2020-07-10,San Francisco,075,870044,5103,4305,3,4308,50
2020-07-10,San Joaquin,077,732212,8795,6225,5,6230,67
2020-07-10,San Luis Obispo,079,281455,1362,891,7,898,4
2020-07-10,San Mateo,081,765935,4642,3844,7,3851,107
2020-07-10,Santa Barbara,083,443738,5043,4177,42,4219,28
2020-07-10,Santa Clara,085,1922200,8204,5819,20,5839,164
2020-07-10,Santa Cruz,087,273765,713,540,5,545,3
2020-07-10,Shasta,089,179085,299,158,1,159,6
2020-07-10,Sierra,091,2930,1,1,0,1,0
2020-07-10,Siskiyou,093,43540,59,31,0,31,0
2020-07-10,Solano,095,438530,2853,1950,10,1960,23
2020-07-10,Sonoma,097,501317,2219,1606,4,1610,13
2020-07-10,Stanislaus,099,539301,6981,4781,8,4789,46
2020-07-10,Sutter,101,95872,446,338,0,338,2
2020-07-10,Tehama,103,63373,145,107,2,109,1
2020-07-10,Trinity,105,12862,21,2,5,7,0
2020-07-10,Tulare,107,460477,7521,5677,27,5704,150
2020-07-10,Tuolumne,109,53932,86,49,2,51,0
2020-07-10,Ventura,111,848112,6101,4416,21,4437,48
2020-07-10,Yolo,113,214977,1177,794,3,797,27
2020-07-10,Yuba,115,75493,211,164,0,164,1
2020-07-09,Alameda,001,1643700,9282,7433,13,7446,146
2020-07-09,Alpine,003,1148,2,1,0,1,0
2020-07-09,Amador,005,37829,44,36,0,36,0
2020-07-09,Butte,007,227075,567,295,8,303,4
2020-07-09,Calaveras,009,45235,83,59,0,59,0
2020-07-09,Colusa,011,21464,189,97,0,97,0
2020-07-09,Contra Costa,013,1133247,5977,4388,11,4399,86
2020-07-09,Del Norte,015,27424,63,57,0,57,0
2020-07-09,El Dorado,017,186661,459,255,0,255,0
2020-07-09,Fresno,019,978130,13906,7385,106,7491,90
2020-07-09,Glenn,021,27897,225,150,0,150,0
2020-07-09,Humboldt,023,135768,196,166,1,167,4
2020-07-09,Imperial,025,180216,9027,6778,6,6784,87
2020-07-09,Inyo,027,18085,37,35,1,36,1
2020-07-09,Kern,029,883053,14781,6100,45,6145,95
2020-07-09,Kings,031,150075,3323,2686,21,2707,33
2020-07-09,Lake,033,64148,146,99,0,99,1
2020-07-09,Lassen,035,31185,433,221,2,223,0
2020-07-09,Los Angeles,037,10098052,147024,125062,145,125207,3698
2020-07-09,Madera,039,155013,1531,850,3,853,4
2020-07-09,Marin,041,260295,4058,2975,4,2979,20
2020-07-09,Mariposa,043,17540,38,32,0,32,1
2020-07-09,Mendocino,045,87422,145,88,0,88,0
2020-07-09,Merced,047,269075,2942,1728,2,1730,11
2020-07-09,Modoc,049,8938,1,0,0,0,0
2020-07-09,Mono,051,14174,63,45,0,45,1
2020-07-09,Monterey,053,433212,3156,2223,8,2231,17
2020-07-09,Napa,055,140530,669,468,0,468,4
2020-07-09,Nevada,057,99092,213,156,5,161,1
2020-07-09,Orange,059,3164182,31487,22960,351,23311,407
2020-07-09,Placer,061,380077,1372,982,3,985,11
2020-07-09,Plumas,063,18699,19,12,0,12,0
2020-07-09,Riverside,065,2383286,31585,24980,32,25012,529
2020-07-09,Sacramento,067,1510023,6968,4950,7,4957,81
2020-07-09,San Benito,069,59416,417,295,0,295,2
2020-07-09,San Bernardino,071,2135413,26558,17339,25,17364,307
2020-07-09,San Diego,073,3302833,23343,18404,2,18406,415
2020-07-09,San Francisco,075,870044,4971,4143,3,4146,50
2020-07-09,San Joaquin,077,732212,8436,6004,5,6009,66
2020-07-09,San Luis Obispo,079,281455,1322,869,7,876,3
2020-07-09,San Mateo,081,765935,4515,3792,7,3799,106
2020-07-09,Santa Barbara,083,443738,4911,4068,42,4110,28
2020-07-09,Santa Clara,085,1922200,7947,5638,19,5657,164
2020-07-09,Santa Cruz,087,273765,686,526,5,531,3
2020-07-09,Shasta,089,179085,293,155,1,156,5
2020-07-09,Sierra,091,2930,1,1,0,1,0
2020-07-09,Siskiyou,093,43540,55,31,0,31,0
2020-07-09,Solano,095,438530,2755,1892,10,1902,23
2020-07-09,Sonoma,097,501317,2133,1584,4,1588,13
2020-07-09,Stanislaus,099,539301,6665,4633,7,4640,46
2020-07-09,Sutter,101,95872,429,321,0,321,2
2020-07-09,Tehama,103,63373,140,102,2,104,1
2020-07-09,Trinity,105,12862,21,2,5,7,0
2020-07-09,Tulare,107,460477,7302,5501,26,5527,146
2020-07-09,Tuolumne,109,53932,85,47,2,49,0
2020-07-09,Ventura,111,848112,5933,4278,21,4299,47
2020-07-09,Yolo,113,214977,1130,764,3,767,27
2020-07-09,Yuba,115,75493,194,152,0,152,1
2020-07-08,Alameda,001,1643700,8990,7335,13,7348,142
2020-07-08,Alpine,003,1148,2,1,0,1,0
2020-07-08,Amador,005,37829,41,35,0,35,0
2020-07-08,Butte,007,227075,530,281,8,289,3
2020-07-08,Calaveras,009,45235,78,58,0,58,0
2020-07-08,Colusa,011,21464,176,90,0,90,0
2020-07-08,Contra Costa,013,1133247,5731,4268,9,4277,84
2020-07-08,Del Norte,015,27424,61,57,0,57,0
2020-07-08,El Dorado,017,186661,438,248,0,248,0
2020-07-08,Fresno,019,978130,13489,7102,98,7200,86
2020-07-08,Glenn,021,27897,214,146,0,146,0
2020-07-08,Humboldt,023,135768,193,162,1,163,4
2020-07-08,Imperial,025,180216,8940,6727,6,6733,76
2020-07-08,Inyo,027,18085,37,35,1,36,1
2020-07-08,Kern,029,883053,14203,5873,43,5916,91
2020-07-08,Kings,031,150075,3263,2629,18,2647,33
2020-07-08,Lake,033,64148,139,97,0,97,1
2020-07-08,Lassen,035,31185,337,221,2,223,0
2020-07-08,Los Angeles,037,10098052,143824,123462,118,123580,3650
2020-07-08,Madera,039,155013,1461,828,3,831,4
2020-07-08,Marin,041,260295,3959,2756,4,2760,17
2020-07-08,Mariposa,043,17540,38,31,0,31,1
2020-07-08,Mendocino,045,87422,132,84,0,84,0
2020-07-08,Merced,047,269075,2822,1578,2,1580,11
2020-07-08,Modoc,049,8938,1,0,0,0,0
2020-07-08,Mono,051,14174,60,45,0,45,1
2020-07-08,Monterey,053,433212,3038,2182,7,2189,17
2020-07-08,Napa,055,140530,647,468,0,468,4
2020-07-08,Nevada,057,99092,204,156,5,161,1
2020-07-08,Orange,059,3164182,30535,22088,346,22434,378
2020-07-08,Placer,061,380077,1325,948,3,951,11
2020-07-08,Plumas,063,18699,19,12,0,12,0
2020-07-08,Riverside,065,2383286,30621,24042,31,24073,508
2020-07-08,Sacramento,067,1510023,6680,4799,7,4806,80
2020-07-08,San Benito,069,59416,401,282,0,282,2
2020-07-08,San Bernardino,071,2135413,25704,16510,21,16531,296
2020-07-08,San Diego,073,3302833,22774,17844,2,17846,406
2020-07-08,San Francisco,075,870044,4882,4093,3,4096,50
2020-07-08,San Joaquin,077,732212,8093,5759,5,5764,61
2020-07-08,San Luis Obispo,079,281455,1270,825,7,832,2
2020-07-08,San Mateo,081,765935,4394,3733,7,3740,106
2020-07-08,Santa Barbara,083,443738,4792,3985,42,4027,28
2020-07-08,Santa Clara,085,1922200,7714,5510,19,5529,164
2020-07-08,Santa Cruz,087,273765,653,509,4,513,3
2020-07-08,Shasta,089,179085,284,148,1,149,6
2020-07-08,Sierra,091,2930,1,1,0,1,0
2020-07-08,Siskiyou,093,43540,55,31,0,31,0
2020-07-08,Solano,095,438530,2639,1821,10,1831,23
2020-07-08,Sonoma,097,501317,2058,1495,4,1499,9
2020-07-08,Stanislaus,099,539301,6365,4344,7,4351,46
2020-07-08,Sutter,101,95872,404,298,0,298,2
2020-07-08,Tehama,103,63373,134,100,2,102,1
2020-07-08,Trinity,105,12862,20,2,5,7,0
2020-07-08,Tulare,107,460477,7110,5307,21,5328,138
2020-07-08,Tuolumne,109,53932,81,42,2,44,0
2020-07-08,Ventura,111,848112,5768,4139,21,4160,47
2020-07-08,Yolo,113,214977,1087,727,3,730,26
2020-07-08,Yuba,115,75493,181,145,0,145,1
2020-07-07,Alameda,001,1643700,8670,7097,12,7109,141
2020-07-07,Alpine,003,1148,2,1,0,1,0
2020-07-07,Amador,005,37829,41,33,0,33,0
2020-07-07,Butte,007,227075,487,269,8,277,3
2020-07-07,Calaveras,009,45235,76,58,0,58,0
2020-07-07,Colusa,011,21464,143,84,0,84,0
2020-07-07,Contra Costa,013,1133247,5495,4131,8,4139,84
2020-07-07,Del Norte,015,27424,61,57,0,57,0
2020-07-07,El Dorado,017,186661,418,244,0,244,0
2020-07-07,Fresno,019,978130,13036,6738,98,6836,84
2020-07-07,Glenn,021,27897,205,145,0,145,0
2020-07-07,Humboldt,023,135768,190,150,1,151,4
2020-07-07,Imperial,025,180216,8841,6678,6,6684,51
2020-07-07,Inyo,027,18085,36,32,1,33,1
2020-07-07,Kern,029,883053,13504,5645,39,5684,88
2020-07-07,Kings,031,150075,3200,2623,16,2639,33
2020-07-07,Lake,033,64148,129,94,0,94,1
2020-07-07,Lassen,035,31185,266,219,2,221,0
2020-07-07,Los Angeles,037,10098052,140258,121026,110,121136,3588
2020-07-07,Madera,039,155013,1417,794,3,797,4
2020-07-07,Marin,041,260295,3870,2627,4,2631,17
2020-07-07,Mariposa,043,17540,38,31,0,31,1
2020-07-07,Mendocino,045,87422,124,82,0,82,0
2020-07-07,Merced,047,269075,2648,1531,2,1533,10
2020-07-07,Modoc,049,8938,1,0,0,0,0
2020-07-07,Mono,051,14174,59,42,0,42,1
2020-07-07,Monterey,053,433212,2895,2166,7,2173,17
2020-07-07,Napa,055,140530,628,459,0,459,4
2020-07-07,Nevada,057,99092,198,150,5,155,1
2020-07-07,Orange,059,3164182,29524,21741,332,22073,373
2020-07-07,Placer,061,380077,1284,930,3,933,11
2020-07-07,Plumas,063,18699,17,12,0,12,0
2020-07-07,Riverside,065,2383286,29606,23279,31,23310,499
2020-07-07,Sacramento,067,1510023,6336,4592,7,4599,76
2020-07-07,San Benito,069,59416,383,274,0,274,2
2020-07-07,San Bernardino,071,2135413,24833,16004,19,16023,277
2020-07-07,San Diego,073,3302833,22055,17580,2,17582,399
2020-07-07,San Francisco,075,870044,4789,4045,2,4047,50
2020-07-07,San Joaquin,077,732212,7751,5547,5,5552,59
2020-07-07,San Luis Obispo,079,281455,1209,795,7,802,2
2020-07-07,San Mateo,081,765935,4279,3691,7,3698,106
2020-07-07,Santa Barbara,083,443738,4664,3866,41,3907,27
2020-07-07,Santa Clara,085,1922200,7445,5438,19,5457,164
2020-07-07,Santa Cruz,087,273765,619,502,3,505,2
2020-07-07,Shasta,089,179085,271,144,1,145,6
2020-07-07,Sierra,091,2930,1,1,0,1,0
2020-07-07,Siskiyou,093,43540,54,30,0,30,0
2020-07-07,Solano,095,438530,2528,1776,9,1785,22
2020-07-07,Sonoma,097,501317,1988,1473,4,1477,8
2020-07-07,Stanislaus,099,539301,6026,4101,7,4108,46
2020-07-07,Sutter,101,95872,378,273,0,273,2
2020-07-07,Tehama,103,63373,125,95,2,97,1
2020-07-07,Trinity,105,12862,20,2,5,7,0
2020-07-07,Tulare,107,460477,6930,5189,19,5208,137
2020-07-07,Tuolumne,109,53932,75,40,2,42,0
2020-07-07,Ventura,111,848112,5599,3992,19,4011,46
2020-07-07,Yolo,113,214977,1020,706,3,709,26
2020-07-07,Yuba,115,75493,161,138,0,138,1
2020-07-06,Alameda,001,1643700,8432,6970,12,6982,141
2020-07-06,Alpine,003,1148,1,1,0,1,0
2020-07-06,Amador,005,37829,39,33,0,33,0
2020-07-06,Butte,007,227075,431,257,8,265,2
2020-07-06,Calaveras,009,45235,73,45,0,45,0
2020-07-06,Colusa,011,21464,134,80,0,80,0
2020-07-06,Contra Costa,013,1133247,5264,3901,7,3908,83
2020-07-06,Del Norte,015,27424,60,57,0,57,0
2020-07-06,El Dorado,017,186661,403,232,0,232,0
2020-07-06,Fresno,019,978130,12568,6364,92,6456,82
2020-07-06,Glenn,021,27897,197,129,0,129,0
2020-07-06,Humboldt,023,135768,188,148,1,149,3
2020-07-06,Imperial,025,180216,8722,6443,6,6449,47
2020-07-06,Inyo,027,18085,36,32,1,33,1
2020-07-06,Kern,029,883053,12698,5491,37,5528,82
2020-07-06,Kings,031,150075,3149,2583,11,2594,33
2020-07-06,Lake,033,64148,122,93,0,93,1
2020-07-06,Lassen,035,31185,264,219,2,221,0
2020-07-06,Los Angeles,037,10098052,136657,116707,96,116803,3541
2020-07-06,Madera,039,155013,1347,734,3,737,4
2020-07-06,Marin,041,260295,3630,2136,4,2140,17
2020-07-06,Mariposa,043,17540,36,31,0,31,1
2020-07-06,Mendocino,045,87422,107,72,0,72,0
2020-07-06,Merced,047,269075,2497,1396,2,1398,10
2020-07-06,Modoc,049,8938,1,0,0,0,0
2020-07-06,Mono,051,14174,58,40,0,40,1
2020-07-06,Monterey,053,433212,2805,2078,7,2085,15
2020-07-06,Napa,055,140530,610,454,0,454,4
2020-07-06,Nevada,057,99092,192,146,5,151,1
2020-07-06,Orange,059,3164182,28462,20167,295,20462,372
2020-07-06,Placer,061,380077,1222,904,3,907,11
2020-07-06,Plumas,063,18699,17,11,0,11,0
2020-07-06,Riverside,065,2383286,28552,22485,30,22515,477
2020-07-06,Sacramento,067,1510023,5985,4420,7,4427,71
2020-07-06,San Benito,069,59416,368,264,0,264,2
2020-07-06,San Bernardino,071,2135413,23979,15346,16,15362,272
2020-07-06,San Diego,073,3302833,21324,17002,2,17004,387
2020-07-06,San Francisco,075,870044,4668,3861,2,3863,50
2020-07-06,San Joaquin,077,732212,7381,5104,5,5109,57
2020-07-06,San Luis Obispo,079,281455,1151,751,7,758,2
2020-07-06,San Mateo,081,765935,4187,3650,6,3656,106
2020-07-06,Santa Barbara,083,443738,4527,3763,40,3803,27
2020-07-06,Santa Clara,085,1922200,7174,5369,19,5388,165
2020-07-06,Santa Cruz,087,273765,597,466,2,468,2
2020-07-06,Shasta,089,179085,261,143,1,144,6
2020-07-06,Sierra,091,2930,1,1,0,1,0
2020-07-06,Siskiyou,093,43540,50,30,0,30,0
2020-07-06,Solano,095,438530,2395,1668,9,1677,22
2020-07-06,Sonoma,097,501317,1924,1369,4,1373,8
2020-07-06,Stanislaus,099,539301,5624,3983,7,3990,46
2020-07-06,Sutter,101,95872,351,250,0,250,2
2020-07-06,Tehama,103,63373,122,95,2,97,1
2020-07-06,Trinity,105,12862,19,2,5,7,0
2020-07-06,Tulare,107,460477,6725,5039,17,5056,136
2020-07-06,Tuolumne,109,53932,72,30,2,32,0
2020-07-06,Ventura,111,848112,5406,3912,19,3931,44
2020-07-06,Yolo,113,214977,964,685,3,688,26
2020-07-06,Yuba,115,75493,147,124,0,124,1
2020-07-05,Alameda,001,1643700,8180,6861,12,6873,141
2020-07-05,Alpine,003,1148,1,1,0,1,0
2020-07-05,Amador,005,37829,37,31,0,31,0
2020-07-05,Butte,007,227075,396,248,8,256,2
2020-07-05,Calaveras,009,45235,69,45,0,45,0
2020-07-05,Colusa,011,21464,124,79,0,79,0
2020-07-05,Contra Costa,013,1133247,5024,3665,6,3671,80
2020-07-05,Del Norte,015,27424,60,57,0,57,0
2020-07-05,El Dorado,017,186661,385,227,0,227,0
2020-07-05,Fresno,019,978130,12002,6186,91,6277,82
2020-07-05,Glenn,021,27897,194,129,0,129,0
2020-07-05,Humboldt,023,135768,184,147,1,148,3
2020-07-05,Imperial,025,180216,8588,6441,6,6447,47
2020-07-05,Inyo,027,18085,35,32,1,33,1
2020-07-05,Kern,029,883053,11989,5351,37,5388,82
2020-07-05,Kings,031,150075,3066,2546,10,2556,31
2020-07-05,Lake,033,64148,122,92,0,92,1
2020-07-05,Lassen,035,31185,258,219,2,221,0
2020-07-05,Los Angeles,037,10098052,133437,115133,90,115223,3495
2020-07-05,Madera,039,155013,1269,564,3,567,4
2020-07-05,Marin,041,260295,3447,2080,4,2084,17
2020-07-05,Mariposa,043,17540,36,31,0,31,1
2020-07-05,Mendocino,045,87422,104,72,0,72,0
2020-07-05,Merced,047,269075,2352,1340,2,1342,10
2020-07-05,Modoc,049,8938,1,0,0,0,0
2020-07-05,Mono,051,14174,54,39,0,39,1
2020-07-05,Monterey,053,433212,2702,1994,7,2001,15
2020-07-05,Napa,055,140530,580,450,0,450,4
2020-07-05,Nevada,057,99092,186,141,5,146,1
2020-07-05,Orange,059,3164182,27521,19430,282,19712,372
2020-07-05,Placer,061,380077,1165,855,3,858,11
2020-07-05,Plumas,063,18699,16,11,0,11,0
2020-07-05,Riverside,065,2383286,27695,21511,30,21541,474
2020-07-05,Sacramento,067,1510023,5670,4265,6,4271,71
2020-07-05,San Benito,069,59416,349,258,0,258,2
2020-07-05,San Bernardino,071,2135413,23102,15026,16,15042,270
2020-07-05,San Diego,073,3302833,20633,16728,2,16730,387
2020-07-05,San Francisco,075,870044,4550,3861,2,3863,50
2020-07-05,San Joaquin,077,732212,7062,5015,5,5020,57
2020-07-05,San Luis Obispo,079,281455,1072,730,7,737,2
2020-07-05,San Mateo,081,765935,4076,3575,6,3581,106
2020-07-05,Santa Barbara,083,443738,4380,3671,37,3708,27
2020-07-05,Santa Clara,085,1922200,6882,5237,19,5256,162
2020-07-05,Santa Cruz,087,273765,579,467,0,467,2
2020-07-05,Shasta,089,179085,255,138,1,139,6
2020-07-05,Sierra,091,2930,1,1,0,1,0
2020-07-05,Siskiyou,093,43540,46,30,0,30,0
2020-07-05,Solano,095,438530,2275,1547,9,1556,22
2020-07-05,Sonoma,097,501317,1843,1369,4,1373,8
2020-07-05,Stanislaus,099,539301,5293,3777,6,3783,45
2020-07-05,Sutter,101,95872,323,241,0,241,2
2020-07-05,Tehama,103,63373,120,95,2,97,1
2020-07-05,Trinity,105,12862,19,2,5,7,0
2020-07-05,Tulare,107,460477,6466,4981,15,4996,135
2020-07-05,Tuolumne,109,53932,67,30,2,32,0
2020-07-05,Ventura,111,848112,5203,3866,19,3885,44
2020-07-05,Yolo,113,214977,924,644,3,647,26
2020-07-05,Yuba,115,75493,137,115,0,115,1
2020-07-04,Alameda,001,1643700,8068,6737,12,6749,141
2020-07-04,Alpine,003,1148,1,1,0,1,0
2020-07-04,Amador,005,37829,36,31,0,31,0
2020-07-04,Butte,007,227075,378,224,8,232,2
2020-07-04,Calaveras,009,45235,69,45,0,45,0
2020-07-04,Colusa,011,21464,123,76,0,76,0
2020-07-04,Contra Costa,013,1133247,4876,3583,6,3589,80
2020-07-04,Del Norte,015,27424,60,50,0,50,0
2020-07-04,El Dorado,017,186661,366,211,0,211,0
2020-07-04,Fresno,019,978130,11685,5999,89,6088,82
2020-07-04,Glenn,021,27897,187,128,0,128,0
2020-07-04,Humboldt,023,135768,177,144,1,145,3
2020-07-04,Imperial,025,180216,8539,6441,6,6447,47
2020-07-04,Inyo,027,18085,35,32,1,33,1
2020-07-04,Kern,029,883053,11685,5231,37,5268,81
2020-07-04,Kings,031,150075,3023,2509,10,2519,31
2020-07-04,Lake,033,64148,115,86,0,86,1
2020-07-04,Lassen,035,31185,258,219,2,221,0
2020-07-04,Los Angeles,037,10098052,131620,107256,79,107335,3462
2020-07-04,Madera,039,155013,1223,568,3,571,4
2020-07-04,Marin,041,260295,3418,1962,4,1966,17
2020-07-04,Mariposa,043,17540,36,28,0,28,1
2020-07-04,Mendocino,045,87422,104,72,0,72,0
2020-07-04,Merced,047,269075,2249,1252,2,1254,10
2020-07-04,Modoc,049,8938,1,0,0,0,0
2020-07-04,Mono,051,14174,54,37,0,37,1
2020-07-04,Monterey,053,433212,2622,1878,7,1885,15
2020-07-04,Napa,055,140530,571,426,0,426,4
2020-07-04,Nevada,057,99092,183,125,5,130,1
2020-07-04,Orange,059,3164182,27088,19247,269,19516,372
2020-07-04,Placer,061,380077,1130,796,3,799,11
2020-07-04,Plumas,063,18699,16,11,0,11,0
2020-07-04,Riverside,065,2383286,27328,21508,30,21538,474
2020-07-04,Sacramento,067,1510023,5499,4039,6,4045,71
2020-07-04,San Benito,069,59416,336,255,0,255,2
2020-07-04,San Bernardino,071,2135413,22676,14636,14,14650,270
2020-07-04,San Diego,073,3302833,20173,16166,2,16168,387
2020-07-04,San Francisco,075,870044,4458,3861,2,3863,50
2020-07-04,San Joaquin,077,732212,6849,4807,5,4812,57
2020-07-04,San Luis Obispo,079,281455,1032,699,7,706,2
2020-07-04,San Mateo,081,765935,4013,3532,6,3538,106
2020-07-04,Santa Barbara,083,443738,4305,3520,35,3555,27
2020-07-04,Santa Clara,085,1922200,6690,5045,18,5063,161
2020-07-04,Santa Cruz,087,273765,569,466,0,466,2
2020-07-04,Shasta,089,179085,252,135,1,136,6
2020-07-04,Sierra,091,2930,1,1,0,1,0
2020-07-04,Siskiyou,093,43540,39,30,0,30,0
2020-07-04,Solano,095,438530,2239,1548,9,1557,22
2020-07-04,Sonoma,097,501317,1817,1370,4,1374,8
2020-07-04,Stanislaus,099,539301,5135,3572,6,3578,44
2020-07-04,Sutter,101,95872,304,225,0,225,2
2020-07-04,Tehama,103,63373,117,92,2,94,1
2020-07-04,Trinity,105,12862,19,2,5,7,0
2020-07-04,Tulare,107,460477,6354,4802,14,4816,135
2020-07-04,Tuolumne,109,53932,63,30,2,32,0
2020-07-04,Ventura,111,848112,5079,3687,19,3706,44
2020-07-04,Yolo,113,214977,899,615,3,618,26
2020-07-04,Yuba,115,75493,130,102,0,102,1
2020-07-03,Alameda,001,1643700,7947,6486,12,6498,141
2020-07-03,Alpine,003,1148,1,1,0,1,0
2020-07-03,Amador,005,37829,36,25,0,25,0
2020-07-03,Butte,007,227075,366,212,8,220,2
2020-07-03,Calaveras,009,45235,69,44,0,44,0
2020-07-03,Colusa,011,21464,117,70,0,70,0
2020-07-03,Contra Costa,013,1133247,4742,3447,6,3453,78
2020-07-03,Del Norte,015,27424,60,50,0,50,0
2020-07-03,El Dorado,017,186661,354,201,0,201,0
2020-07-03,Fresno,019,978130,11380,5783,87,5870,81
2020-07-03,Glenn,021,27897,182,122,0,122,0
2020-07-03,Humboldt,023,135768,173,143,1,144,3
2020-07-03,Imperial,025,180216,8491,6345,6,6351,47
2020-07-03,Inyo,027,18085,35,32,1,33,1
2020-07-03,Kern,029,883053,11424,5213,37,5250,81
2020-07-03,Kings,031,150075,2987,2492,10,2502,31
2020-07-03,Lake,033,64148,108,83,0,83,0
2020-07-03,Lassen,035,31185,258,219,2,221,0
2020-07-03,Los Angeles,037,10098052,130103,107236,75,107311,3461
2020-07-03,Madera,039,155013,1178,565,3,568,4
2020-07-03,Marin,041,260295,3390,1776,4,1780,17
2020-07-03,Mariposa,043,17540,36,28,0,28,1
2020-07-03,Mendocino,045,87422,103,72,0,72,0
2020-07-03,Merced,047,269075,2183,1188,2,1190,10
2020-07-03,Modoc,049,8938,1,0,0,0,0
2020-07-03,Mono,051,14174,54,37,0,37,1
2020-07-03,Monterey,053,433212,2551,1804,7,1811,15
2020-07-03,Napa,055,140530,553,388,0,388,4
2020-07-03,Nevada,057,99092,182,125,5,130,1
2020-07-03,Orange,059,3164182,26697,18819,261,19080,366
2020-07-03,Placer,061,380077,1103,745,3,748,11
2020-07-03,Plumas,063,18699,16,11,0,11,0
2020-07-03,Riverside,065,2383286,27022,21171,30,21201,472
2020-07-03,Sacramento,067,1510023,5365,3711,6,3717,71
2020-07-03,San Benito,069,59416,329,243,0,243,2
2020-07-03,San Bernardino,071,2135413,22287,14040,14,14054,269
2020-07-03,San Diego,073,3302833,19717,15698,2,15700,387
2020-07-03,San Francisco,075,870044,4411,3781,2,3783,50
2020-07-03,San Joaquin,077,732212,6711,4416,4,4420,56
2020-07-03,San Luis Obispo,079,281455,997,676,7,683,2
2020-07-03,San Mateo,081,765935,3956,3439,6,3445,106
2020-07-03,Santa Barbara,083,443738,4218,3406,34,3440,27
2020-07-03,Santa Clara,085,1922200,6577,4820,18,4838,161
2020-07-03,Santa Cruz,087,273765,556,436,0,436,2
2020-07-03,Shasta,089,179085,244,113,1,114,6
2020-07-03,Sierra,091,2930,1,1,0,1,0
2020-07-03,Siskiyou,093,43540,36,30,0,30,0
2020-07-03,Solano,095,438530,2195,1496,8,1504,22
2020-07-03,Sonoma,097,501317,1768,1282,4,1286,8
2020-07-03,Stanislaus,099,539301,5010,3021,6,3027,43
2020-07-03,Sutter,101,95872,294,205,0,205,2
2020-07-03,Tehama,103,63373,115,89,2,91,1
2020-07-03,Trinity,105,12862,19,2,5,7,0
2020-07-03,Tulare,107,460477,6239,4656,14,4670,134
2020-07-03,Tuolumne,109,53932,61,27,2,29,0
2020-07-03,Ventura,111,848112,4983,3536,19,3555,44
2020-07-03,Yolo,113,214977,865,586,3,589,25
2020-07-03,Yuba,115,75493,125,96,0,96,1
2020-07-02,Alameda,001,1643700,7821,6386,12,6398,139
2020-07-02,Alpine,003,1148,1,1,0,1,0
2020-07-02,Amador,005,37829,35,23,0,23,0
2020-07-02,Butte,007,227075,349,199,8,207,2
2020-07-02,Calaveras,009,45235,65,42,0,42,0
2020-07-02,Colusa,011,21464,109,60,0,60,0
2020-07-02,Contra Costa,013,1133247,4558,3347,6,3353,77
2020-07-02,Del Norte,015,27424,59,50,0,50,0
2020-07-02,El Dorado,017,186661,343,193,0,193,0
2020-07-02,Fresno,019,978130,10920,5402,86,5488,78
2020-07-02,Glenn,021,27897,176,114,0,114,0
2020-07-02,Humboldt,023,135768,169,138,1,139,3
2020-07-02,Imperial,025,180216,8390,6236,5,6241,47
2020-07-02,Inyo,027,18085,35,29,1,30,1
2020-07-02,Kern,029,883053,10888,5036,35,5071,78
2020-07-02,Kings,031,150075,2936,2419,10,2429,31
2020-07-02,Lake,033,64148,104,81,0,81,0
2020-07-02,Lassen,035,31185,256,218,2,220,0
2020-07-02,Los Angeles,037,10098052,128085,107144,52,107196,3458
2020-07-02,Madera,039,155013,1110,548,3,551,4
2020-07-02,Marin,041,260295,3304,1706,4,1710,17
2020-07-02,Mariposa,043,17540,35,28,0,28,1
2020-07-02,Mendocino,045,87422,99,71,0,71,0
2020-07-02,Merced,047,269075,2086,1122,2,1124,10
2020-07-02,Modoc,049,8938,1,0,0,0,0
2020-07-02,Mono,051,14174,54,37,0,37,1
2020-07-02,Monterey,053,433212,2491,1796,7,1803,15
2020-07-02,Napa,055,140530,536,352,0,352,4
2020-07-02,Nevada,057,99092,176,118,4,122,1
2020-07-02,Orange,059,3164182,25933,17056,248,17304,360
2020-07-02,Placer,061,380077,1079,740,3,743,11
2020-07-02,Plumas,063,18699,15,8,0,8,0
2020-07-02,Riverside,065,2383286,26449,20253,30,20283,458
2020-07-02,Sacramento,067,1510023,5138,3587,6,3593,70
2020-07-02,San Benito,069,59416,321,236,0,236,2
2020-07-02,San Bernardino,071,2135413,21751,13185,14,13199,260
2020-07-02,San Diego,073,3302833,19253,15208,2,15210,377
2020-07-02,San Francisco,075,870044,4316,3676,2,3678,50
2020-07-02,San Joaquin,077,732212,6364,4243,4,4247,56
2020-07-02,San Luis Obispo,079,281455,952,659,7,666,2
2020-07-02,San Mateo,081,765935,3876,3390,6,3396,107
2020-07-02,Santa Barbara,083,443738,4118,3385,32,3417,27
2020-07-02,Santa Clara,085,1922200,6451,4722,18,4740,160
2020-07-02,Santa Cruz,087,273765,533,414,0,414,2
2020-07-02,Shasta,089,179085,241,110,1,111,5
2020-07-02,Sierra,091,2930,1,1,0,1,0
2020-07-02,Siskiyou,093,43540,36,30,0,30,0
2020-07-02,Solano,095,438530,2112,1429,8,1437,21
2020-07-02,Sonoma,097,501317,1710,1244,4,1248,6
2020-07-02,Stanislaus,099,539301,4838,2850,6,2856,41
2020-07-02,Sutter,101,95872,282,195,0,195,2
2020-07-02,Tehama,103,63373,113,86,2,88,1
2020-07-02,Trinity,105,12862,19,2,5,7,0
2020-07-02,Tulare,107,460477,6072,4559,13,4572,132
2020-07-02,Tuolumne,109,53932,58,23,2,25,0
2020-07-02,Ventura,111,848112,4827,3394,19,3413,42
2020-07-02,Yolo,113,214977,833,554,3,557,24
2020-07-02,Yuba,115,75493,115,93,0,93,1
2020-07-01,Alameda,001,1643700,7599,6125,12,6137,137
2020-07-01,Alpine,003,1148,1,1,0,1,0
2020-07-01,Amador,005,37829,34,22,0,22,0
2020-07-01,Butte,007,227075,324,185,8,193,2
2020-07-01,Calaveras,009,45235,63,37,0,37,0
2020-07-01,Colusa,011,21464,103,53,0,53,0
2020-07-01,Contra Costa,013,1133247,4346,3259,6,3265,76
2020-07-01,Del Norte,015,27424,59,50,0,50,0
2020-07-01,El Dorado,017,186661,316,183,0,183,0
2020-07-01,Fresno,019,978130,10486,5111,83,5194,76
2020-07-01,Glenn,021,27897,170,110,0,110,0
2020-07-01,Humboldt,023,135768,164,134,0,134,3
2020-07-01,Imperial,025,180216,8293,6150,5,6155,46
2020-07-01,Inyo,027,18085,34,30,1,31,1
2020-07-01,Kern,029,883053,10255,4853,33,4886,78
2020-07-01,Kings,031,150075,2868,2360,10,2370,30
2020-07-01,Lake,033,64148,103,75,0,75,0
2020-07-01,Lassen,035,31185,255,217,2,219,0
2020-07-01,Los Angeles,037,10098052,124883,105325,43,105368,3408
2020-07-01,Madera,039,155013,1069,519,3,522,4
2020-07-01,Marin,041,260295,3147,1636,4,1640,17
2020-07-01,Mariposa,043,17540,35,29,0,29,1
2020-07-01,Mendocino,045,87422,95,70,0,70,0
2020-07-01,Merced,047,269075,1986,1052,2,1054,10
2020-07-01,Modoc,049,8938,1,0,0,0,0
2020-07-01,Mono,051,14174,51,37,0,37,1
2020-07-01,Monterey,053,433212,2383,1703,6,1709,15
2020-07-01,Napa,055,140530,513,347,0,347,4
2020-07-01,Nevada,057,99092,166,115,4,119,1
2020-07-01,Orange,059,3164182,25048,15662,227,15889,343
2020-07-01,Placer,061,380077,1032,713,3,716,11
2020-07-01,Plumas,063,18699,13,8,0,8,0
2020-07-01,Riverside,065,2383286,25607,19537,29,19566,457
2020-07-01,Sacramento,067,1510023,4883,3425,6,3431,64
2020-07-01,San Benito,069,59416,312,219,0,219,2
2020-07-01,San Bernardino,071,2135413,20856,12712,11,12723,253
2020-07-01,San Diego,073,3302833,18685,14624,2,14626,372
2020-07-01,San Francisco,075,870044,4223,3626,2,3628,50
2020-07-01,San Joaquin,077,732212,6006,3990,4,3994,54
2020-07-01,San Luis Obispo,079,281455,925,613,7,620,1
2020-07-01,San Mateo,081,765935,3814,3326,6,3332,84
2020-07-01,Santa Barbara,083,443738,3998,3268,31,3299,27
2020-07-01,Santa Clara,085,1922200,6264,4547,17,4564,159
2020-07-01,Santa Cruz,087,273765,511,398,0,398,2
2020-07-01,Shasta,089,179085,236,104,1,105,5
2020-07-01,Sierra,091,2930,1,1,0,1,0
2020-07-01,Siskiyou,093,43540,36,28,0,28,0
2020-07-01,Solano,095,438530,2023,1350,8,1358,21
2020-07-01,Sonoma,097,501317,1614,1178,4,1182,6
2020-07-01,Stanislaus,099,539301,4559,2619,6,2625,41
2020-07-01,Sutter,101,95872,269,188,0,188,2
2020-07-01,Tehama,103,63373,106,80,2,82,1
2020-07-01,Trinity,105,12862,19,2,4,6,0
2020-07-01,Tulare,107,460477,5894,4359,13,4372,128
2020-07-01,Tuolumne,109,53932,55,17,2,19,0
2020-07-01,Ventura,111,848112,4684,3224,17,3241,41
2020-07-01,Yolo,113,214977,783,526,3,529,24
2020-07-01,Yuba,115,75493,110,57,0,57,1
2020-06-30,Alameda,001,1643700,7350,5959,10,5969,137
2020-06-30,Alpine,003,1148,1,1,0,1,0
2020-06-30,Amador,005,37829,34,21,0,21,0
2020-06-30,Butte,007,227075,307,163,8,171,2
2020-06-30,Calaveras,009,45235,58,31,0,31,0
2020-06-30,Colusa,011,21464,94,33,0,33,0
2020-06-30,Contra Costa,013,1133247,4139,3140,6,3146,75
2020-06-30,Del Norte,015,27424,59,48,0,48,0
2020-06-30,El Dorado,017,186661,303,175,0,175,0
2020-06-30,Fresno,019,978130,10038,4826,77,4903,75
2020-06-30,Glenn,021,27897,165,96,0,96,0
2020-06-30,Humboldt,023,135768,160,132,0,132,3
2020-06-30,Imperial,025,180216,8195,5968,5,5973,45
2020-06-30,Inyo,027,18085,34,30,1,31,1
2020-06-30,Kern,029,883053,9608,4721,30,4751,75
2020-06-30,Kings,031,150075,2819,2315,7,2322,30
2020-06-30,Lake,033,64148,95,56,0,56,0
2020-06-30,Lassen,035,31185,248,215,2,217,0
2020-06-30,Los Angeles,037,10098052,121306,103640,40,103680,3378
2020-06-30,Madera,039,155013,1012,475,3,478,4
2020-06-30,Marin,041,260295,3076,1614,4,1618,17
2020-06-30,Mariposa,043,17540,34,27,0,27,1
2020-06-30,Mendocino,045,87422,90,65,0,65,0
2020-06-30,Merced,047,269075,1849,970,2,972,10
2020-06-30,Modoc,049,8938,1,0,0,0,0
2020-06-30,Mono,051,14174,49,36,0,36,1
2020-06-30,Monterey,053,433212,2285,1657,6,1663,15
2020-06-30,Napa,055,140530,488,342,0,342,4
2020-06-30,Nevada,057,99092,158,113,4,117,1
2020-06-30,Orange,059,3164182,24117,14354,217,14571,335
2020-06-30,Placer,061,380077,1005,667,3,670,11
2020-06-30,Plumas,063,18699,12,8,0,8,0
2020-06-30,Riverside,065,2383286,24890,18656,28,18684,449
2020-06-30,Sacramento,067,1510023,4594,3246,6,3252,64
2020-06-30,San Benito,069,59416,301,200,0,200,2
2020-06-30,San Bernardino,071,2135413,19873,12375,10,12385,249
2020-06-30,San Diego,073,3302833,17980,14150,2,14152,365
2020-06-30,San Francisco,075,870044,4118,3555,1,3556,50
2020-06-30,San Joaquin,077,732212,5631,3744,4,3748,52
2020-06-30,San Luis Obispo,079,281455,887,583,7,590,1
2020-06-30,San Mateo,081,765935,3736,3268,6,3274,84
2020-06-30,Santa Barbara,083,443738,3882,3102,31,3133,25
2020-06-30,Santa Clara,085,1922200,6062,4346,17,4363,157
2020-06-30,Santa Cruz,087,273765,486,379,0,379,2
2020-06-30,Shasta,089,179085,220,100,1,101,5
2020-06-30,Sierra,091,2930,1,1,0,1,0
2020-06-30,Siskiyou,093,43540,35,26,0,26,0
2020-06-30,Solano,095,438530,1931,1256,8,1264,21
2020-06-30,Sonoma,097,501317,1549,1122,4,1126,6
2020-06-30,Stanislaus,099,539301,4261,2578,6,2584,41
2020-06-30,Sutter,101,95872,246,168,0,168,2
2020-06-30,Tehama,103,63373,104,75,2,77,1
2020-06-30,Trinity,105,12862,19,2,4,6,0
2020-06-30,Tulare,107,460477,5685,4207,13,4220,117
2020-06-30,Tuolumne,109,53932,51,16,2,18,0
2020-06-30,Ventura,111,848112,4550,3030,17,3047,40
2020-06-30,Yolo,113,214977,745,515,3,518,24
2020-06-30,Yuba,115,75493,106,55,0,55,1
2020-06-29,Alameda,001,1643700,7140,5766,10,5776,135
2020-06-29,Alpine,003,1148,1,1,0,1,0
2020-06-29,Amador,005,37829,31,20,0,20,0
2020-06-29,Butte,007,227075,286,157,8,165,2
2020-06-29,Calaveras,009,45235,56,30,0,30,0
2020-06-29,Colusa,011,21464,89,17,0,17,0
2020-06-29,Contra Costa,013,1133247,3976,2976,5,2981,75
2020-06-29,Del Norte,015,27424,59,47,0,47,0
2020-06-29,El Dorado,017,186661,289,163,0,163,0
2020-06-29,Fresno,019,978130,9690,4531,75,4606,74
2020-06-29,Glenn,021,27897,156,77,0,77,0
2020-06-29,Humboldt,023,135768,159,128,0,128,3
2020-06-29,Imperial,025,180216,8064,5512,5,5517,45
2020-06-29,Inyo,027,18085,33,29,0,29,1
2020-06-29,Kern,029,883053,8945,4613,28,4641,73
2020-06-29,Kings,031,150075,2754,2280,7,2287,20
2020-06-29,Lake,033,64148,88,53,0,53,0
2020-06-29,Lassen,035,31185,240,77,2,79,0
2020-06-29,Los Angeles,037,10098052,118267,100846,34,100880,3337
2020-06-29,Madera,039,155013,955,422,3,425,4
2020-06-29,Marin,041,260295,3000,1517,4,1521,17
2020-06-29,Mariposa,043,17540,32,25,0,25,1
2020-06-29,Mendocino,045,87422,87,63,0,63,0
2020-06-29,Merced,047,269075,1743,848,2,850,10
2020-06-29,Modoc,049,8938,1,0,0,0,0
2020-06-29,Mono,051,14174,47,35,0,35,1
2020-06-29,Monterey,053,433212,2213,1614,6,1620,14
2020-06-29,Napa,055,140530,466,317,0,317,4
2020-06-29,Nevada,057,99092,155,107,3,110,1
2020-06-29,Orange,059,3164182,23127,13682,201,13883,324
2020-06-29,Placer,061,380077,969,628,3,631,11
2020-06-29,Plumas,063,18699,12,6,0,6,0
2020-06-29,Riverside,065,2383286,23856,17683,28,17711,432
2020-06-29,Sacramento,067,1510023,4307,2985,6,2991,62
2020-06-29,San Benito,069,59416,286,193,0,193,2
2020-06-29,San Bernardino,071,2135413,18912,11643,10,11653,245
2020-06-29,San Diego,073,3302833,17402,13834,2,13836,361
2020-06-29,San Francisco,075,870044,4041,3389,1,3390,50
2020-06-29,San Joaquin,077,732212,5273,3202,4,3206,52
2020-06-29,San Luis Obispo,079,281455,853,544,7,551,1
2020-06-29,San Mateo,081,765935,3682,3170,6,3176,84
2020-06-29,Santa Barbara,083,443738,3773,2933,30,2963,25
2020-06-29,Santa Clara,085,1922200,5890,4231,17,4248,157
2020-06-29,Santa Cruz,087,273765,468,348,0,348,2
2020-06-29,Shasta,089,179085,212,94,1,95,5
2020-06-29,Sierra,091,2930,1,1,0,1,0
2020-06-29,Siskiyou,093,43540,35,25,0,25,0
2020-06-29,Solano,095,438530,1829,1077,8,1085,21
2020-06-29,Sonoma,097,501317,1477,1103,4,1107,5
2020-06-29,Stanislaus,099,539301,4055,2400,5,2405,36
2020-06-29,Sutter,101,95872,224,152,0,152,2
2020-06-29,Tehama,103,63373,100,63,2,65,1
2020-06-29,Trinity,105,12862,18,2,4,6,0
2020-06-29,Tulare,107,460477,5530,3906,12,3918,117
2020-06-29,Tuolumne,109,53932,47,16,2,18,0
2020-06-29,Ventura,111,848112,4403,2794,17,2811,40
2020-06-29,Yolo,113,214977,712,483,3,486,24
2020-06-29,Yuba,115,75493,93,55,0,55,1
2020-06-28,Alameda,001,1643700,6881,5698,10,5708,135
2020-06-28,Alpine,003,1148,1,1,0,1,0
2020-06-28,Amador,005,37829,29,20,0,20,0
2020-06-28,Butte,007,227075,266,150,8,158,2
2020-06-28,Calaveras,009,45235,51,30,0,30,0
2020-06-28,Colusa,011,21464,74,17,0,17,0
2020-06-28,Contra Costa,013,1133247,3786,2803,4,2807,73
2020-06-28,Del Norte,015,27424,58,47,0,47,0
2020-06-28,El Dorado,017,186661,277,162,0,162,0
2020-06-28,Fresno,019,978130,9328,4365,75,4440,74
2020-06-28,Glenn,021,27897,148,77,0,77,0
2020-06-28,Humboldt,023,135768,156,127,0,127,3
2020-06-28,Imperial,025,180216,7876,5513,4,5517,45
2020-06-28,Inyo,027,18085,33,29,0,29,1
2020-06-28,Kern,029,883053,8394,4541,26,4567,72
2020-06-28,Kings,031,150075,2694,2234,7,2241,18
2020-06-28,Lake,033,64148,84,53,0,53,0
2020-06-28,Lassen,035,31185,240,77,2,79,0
2020-06-28,Los Angeles,037,10098052,115066,98003,30,98033,3316
2020-06-28,Madera,039,155013,907,424,3,427,4
2020-06-28,Marin,041,260295,2654,1473,4,1477,17
2020-06-28,Mariposa,043,17540,32,24,0,24,1
2020-06-28,Mendocino,045,87422,85,63,0,63,0
2020-06-28,Merced,047,269075,1630,814,2,816,10
2020-06-28,Modoc,049,8938,1,0,0,0,0
2020-06-28,Mono,051,14174,47,35,0,35,1
2020-06-28,Monterey,053,433212,2131,1560,6,1566,13
2020-06-28,Napa,055,140530,432,307,0,307,4
2020-06-28,Nevada,057,99092,144,102,3,105,1
2020-06-28,Orange,059,3164182,22153,13213,183,13396,324
2020-06-28,Placer,061,380077,930,618,3,621,11
2020-06-28,Plumas,063,18699,11,6,0,6,0
2020-06-28,Riverside,065,2383286,23028,16848,27,16875,432
2020-06-28,Sacramento,067,1510023,4079,2803,6,2809,63
2020-06-28,San Benito,069,59416,275,190,0,190,2
2020-06-28,San Bernardino,071,2135413,18159,11344,9,11353,245
2020-06-28,San Diego,073,3302833,16857,13333,2,13335,361
2020-06-28,San Francisco,075,870044,3962,3388,1,3389,50
2020-06-28,San Joaquin,077,732212,4936,3201,4,3205,52
2020-06-28,San Luis Obispo,079,281455,814,531,6,537,1
2020-06-28,San Mateo,081,765935,3604,3124,6,3130,84
2020-06-28,Santa Barbara,083,443738,3628,2872,30,2902,25
2020-06-28,Santa Clara,085,1922200,5728,4131,17,4148,156
2020-06-28,Santa Cruz,087,273765,445,349,0,349,2
2020-06-28,Shasta,089,179085,199,89,0,89,5
2020-06-28,Sierra,091,2930,1,1,0,1,0
2020-06-28,Siskiyou,093,43540,35,25,0,25,0
2020-06-28,Solano,095,438530,1754,1077,8,1085,21
2020-06-28,Sonoma,097,501317,1424,1084,4,1088,5
2020-06-28,Stanislaus,099,539301,3849,2376,5,2381,36
2020-06-28,Sutter,101,95872,198,145,0,145,2
2020-06-28,Tehama,103,63373,93,63,2,65,1
2020-06-28,Trinity,105,12862,17,2,4,6,0
2020-06-28,Tulare,107,460477,5362,3812,12,3824,117
2020-06-28,Tuolumne,109,53932,42,14,2,16,0
2020-06-28,Ventura,111,848112,4245,2650,17,2667,40
2020-06-28,Yolo,113,214977,677,468,3,471,24
2020-06-28,Yuba,115,75493,89,39,0,39,1
2020-06-27,Alameda,001,1643700,6785,5581,10,5591,135
2020-06-27,Alpine,003,1148,1,1,0,1,0
2020-06-27,Amador,005,37829,27,20,0,20,0
2020-06-27,Butte,007,227075,258,137,8,145,2
2020-06-27,Calaveras,009,45235,49,30,0,30,0
2020-06-27,Colusa,011,21464,68,17,0,17,0
2020-06-27,Contra Costa,013,1133247,3691,2717,3,2720,72
2020-06-27,Del Norte,015,27424,58,47,0,47,0
2020-06-27,El Dorado,017,186661,271,159,0,159,0
2020-06-27,Fresno,019,978130,9082,4238,75,4313,74
2020-06-27,Glenn,021,27897,144,77,0,77,0
2020-06-27,Humboldt,023,135768,154,127,0,127,3
2020-06-27,Imperial,025,180216,7815,5513,4,5517,45
2020-06-27,Inyo,027,18085,33,29,0,29,1
2020-06-27,Kern,029,883053,8130,4411,25,4436,70
2020-06-27,Kings,031,150075,2668,2187,7,2194,18
2020-06-27,Lake,033,64148,81,42,0,42,0
2020-06-27,Lassen,035,31185,240,33,2,35,0
2020-06-27,Los Angeles,037,10098052,113324,95341,27,95368,3291
2020-06-27,Madera,039,155013,864,427,2,429,4
2020-06-27,Marin,041,260295,2609,1423,4,1427,17
2020-06-27,Mariposa,043,17540,31,22,0,22,1
2020-06-27,Mendocino,045,87422,85,63,0,63,0
2020-06-27,Merced,047,269075,1572,807,1,808,10
2020-06-27,Modoc,049,8938,1,0,0,0,0
2020-06-27,Mono,051,14174,46,35,0,35,1
2020-06-27,Monterey,053,433212,2067,1455,6,1461,12
2020-06-27,Napa,055,140530,422,282,0,282,3
2020-06-27,Nevada,057,99092,140,102,2,104,1
2020-06-27,Orange,059,3164182,21642,12951,178,13129,320
2020-06-27,Placer,061,380077,909,584,3,587,10
2020-06-27,Plumas,063,18699,11,6,0,6,0
2020-06-27,Riverside,065,2383286,22639,16209,27,16236,432
2020-06-27,Sacramento,067,1510023,3962,2685,6,2691,63
2020-06-27,San Benito,069,59416,268,182,0,182,2
2020-06-27,San Bernardino,071,2135413,17780,11238,9,11247,243
2020-06-27,San Diego,073,3302833,16492,12836,2,12838,360
2020-06-27,San Francisco,075,870044,3907,3332,1,3333,49
2020-06-27,San Joaquin,077,732212,4770,2995,4,2999,52
2020-06-27,San Luis Obispo,079,281455,791,505,6,511,1
2020-06-27,San Mateo,081,765935,3547,3083,6,3089,83
2020-06-27,Santa Barbara,083,443738,3556,2799,30,2829,25
2020-06-27,Santa Clara,085,1922200,5622,4006,17,4023,157
2020-06-27,Santa Cruz,087,273765,438,347,0,347,2
2020-06-27,Shasta,089,179085,193,87,0,87,5
2020-06-27,Sierra,091,2930,1,1,0,1,0
2020-06-27,Siskiyou,093,43540,35,25,0,25,0
2020-06-27,Solano,095,438530,1721,1076,8,1084,21
2020-06-27,Sonoma,097,501317,1393,1004,4,1008,5
2020-06-27,Stanislaus,099,539301,3749,2164,5,2169,36
2020-06-27,Sutter,101,95872,191,141,0,141,2
2020-06-27,Tehama,103,63373,90,63,2,65,1
2020-06-27,Trinity,105,12862,17,2,4,6,0
2020-06-27,Tulare,107,460477,5266,3810,12,3822,117
2020-06-27,Tuolumne,109,53932,41,13,2,15,0
2020-06-27,Ventura,111,848112,4145,2471,17,2488,40
2020-06-27,Yolo,113,214977,653,432,3,435,24
2020-06-27,Yuba,115,75493,81,39,0,39,1
2020-06-26,Alameda,001,1643700,6699,5502,9,5511,132
2020-06-26,Alpine,003,1148,1,1,0,1,0
2020-06-26,Amador,005,37829,26,20,0,20,0
2020-06-26,Butte,007,227075,243,135,8,143,2
2020-06-26,Calaveras,009,45235,47,30,0,30,0
2020-06-26,Colusa,011,21464,63,17,0,17,0
2020-06-26,Contra Costa,013,1133247,3578,2676,3,2679,72
2020-06-26,Del Norte,015,27424,57,47,0,47,0
2020-06-26,El Dorado,017,186661,263,159,0,159,0
2020-06-26,Fresno,019,978130,8856,4166,75,4241,74
2020-06-26,Glenn,021,27897,137,71,0,71,0
2020-06-26,Humboldt,023,135768,152,126,0,126,3
2020-06-26,Imperial,025,180216,7752,5400,4,5404,44
2020-06-26,Inyo,027,18085,32,29,0,29,1
2020-06-26,Kern,029,883053,7800,4366,25,4391,70
2020-06-26,Kings,031,150075,2636,2176,6,2182,18
2020-06-26,Lake,033,64148,80,42,0,42,0
2020-06-26,Lassen,035,31185,239,30,2,32,0
2020-06-26,Los Angeles,037,10098052,111157,93328,27,93355,3275
2020-06-26,Madera,039,155013,832,409,2,411,4
2020-06-26,Marin,041,260295,2572,1406,4,1410,17
2020-06-26,Mariposa,043,17540,30,21,0,21,1
2020-06-26,Mendocino,045,87422,82,63,0,63,0
2020-06-26,Merced,047,269075,1526,797,1,798,10
2020-06-26,Modoc,049,8938,1,0,0,0,0
2020-06-26,Mono,051,14174,45,35,0,35,1
2020-06-26,Monterey,053,433212,2015,1449,6,1455,12
2020-06-26,Napa,055,140530,412,277,0,277,3
2020-06-26,Nevada,057,99092,136,101,1,102,1
2020-06-26,Orange,059,3164182,20966,12659,175,12834,320
2020-06-26,Placer,061,380077,880,584,3,587,10
2020-06-26,Plumas,063,18699,11,6,0,6,0
2020-06-26,Riverside,065,2383286,22176,15858,27,15885,430
2020-06-26,Sacramento,067,1510023,3797,2687,6,2693,63
2020-06-26,San Benito,069,59416,264,176,0,176,2
2020-06-26,San Bernardino,071,2135413,17403,11111,9,11120,243
2020-06-26,San Diego,073,3302833,16127,12402,2,12404,358
2020-06-26,San Francisco,075,870044,3852,3330,1,3331,49
2020-06-26,San Joaquin,077,732212,4556,2943,4,2947,52
2020-06-26,San Luis Obispo,079,281455,776,498,6,504,1
2020-06-26,San Mateo,081,765935,3495,3055,6,3061,83
2020-06-26,Santa Barbara,083,443738,3466,2784,28,2812,25
2020-06-26,Santa Clara,085,1922200,5521,3968,17,3985,156
2020-06-26,Santa Cruz,087,273765,431,344,0,344,2
2020-06-26,Shasta,089,179085,186,86,0,86,5
2020-06-26,Sierra,091,2930,1,1,0,1,0
2020-06-26,Siskiyou,093,43540,34,24,0,24,0
2020-06-26,Solano,095,438530,1679,1068,8,1076,21
2020-06-26,Sonoma,097,501317,1361,977,4,981,5
2020-06-26,Stanislaus,099,539301,3636,2157,5,2162,36
2020-06-26,Sutter,101,95872,184,138,0,138,2
2020-06-26,Tehama,103,63373,87,63,2,65,1
2020-06-26,Trinity,105,12862,17,2,4,6,0
2020-06-26,Tulare,107,460477,5177,3720,12,3732,117
2020-06-26,Tuolumne,109,53932,39,10,2,12,0
2020-06-26,Ventura,111,848112,4059,2444,17,2461,40
2020-06-26,Yolo,113,214977,630,418,3,421,24
2020-06-26,Yuba,115,75493,75,38,0,38,1
2020-06-25,Alameda,001,1643700,6510,5398,9,5407,130
2020-06-25,Alpine,003,1148,1,1,0,1,0
2020-06-25,Amador,005,37829,25,18,0,18,0
2020-06-25,Butte,007,227075,238,127,8,135,1
2020-06-25,Calaveras,009,45235,42,26,0,26,0
2020-06-25,Colusa,011,21464,53,14,0,14,0
2020-06-25,Contra Costa,013,1133247,3393,2591,3,2594,71
2020-06-25,Del Norte,015,27424,55,47,0,47,0
2020-06-25,El Dorado,017,186661,255,150,0,150,0
2020-06-25,Fresno,019,978130,8543,3938,74,4012,71
2020-06-25,Glenn,021,27897,132,59,0,59,0
2020-06-25,Humboldt,023,135768,151,121,0,121,3
2020-06-25,Imperial,025,180216,7623,5192,4,5196,44
2020-06-25,Inyo,027,18085,29,27,0,27,1
2020-06-25,Kern,029,883053,7375,4236,22,4258,69
2020-06-25,Kings,031,150075,2584,2110,6,2116,17
2020-06-25,Lake,033,64148,79,42,0,42,0
2020-06-25,Lassen,035,31185,233,13,2,15,0
2020-06-25,Los Angeles,037,10098052,108391,91524,27,91551,3239
2020-06-25,Madera,039,155013,788,380,2,382,4
2020-06-25,Marin,041,260295,2470,1321,4,1325,17
2020-06-25,Mariposa,043,17540,29,20,0,20,1
2020-06-25,Mendocino,045,87422,79,61,0,61,0
2020-06-25,Merced,047,269075,1439,747,1,748,10
2020-06-25,Modoc,049,8938,1,0,0,0,0
2020-06-25,Mono,051,14174,44,35,0,35,1
2020-06-25,Monterey,053,433212,1927,1426,5,1431,12
2020-06-25,Napa,055,140530,394,260,0,260,3
2020-06-25,Nevada,057,99092,128,92,1,93,1
2020-06-25,Orange,059,3164182,20044,12221,173,12394,311
2020-06-25,Placer,061,380077,826,574,3,577,10
2020-06-25,Plumas,063,18699,10,6,0,6,0
2020-06-25,Riverside,065,2383286,21421,15224,26,15250,427
2020-06-25,Sacramento,067,1510023,3574,2519,6,2525,62
2020-06-25,San Benito,069,59416,256,174,0,174,2
2020-06-25,San Bernardino,071,2135413,16652,10590,9,10599,242
2020-06-25,San Diego,073,3302833,15588,11963,2,11965,352
2020-06-25,San Francisco,075,870044,3786,3252,1,3253,48
2020-06-25,San Joaquin,077,732212,4283,2803,4,2807,50
2020-06-25,San Luis Obispo,079,281455,744,473,6,479,1
2020-06-25,San Mateo,081,765935,3427,2996,6,3002,82
2020-06-25,Santa Barbara,083,443738,3361,2622,27,2649,25
2020-06-25,Santa Clara,085,1922200,5372,3871,17,3888,156
2020-06-25,Santa Cruz,087,273765,419,335,0,335,2
2020-06-25,Shasta,089,179085,176,84,0,84,5
2020-06-25,Sierra,091,2930,1,1,0,1,0
2020-06-25,Siskiyou,093,43540,33,24,0,24,0
2020-06-25,Solano,095,438530,1626,1034,8,1042,21
2020-06-25,Sonoma,097,501317,1314,953,3,956,5
2020-06-25,Stanislaus,099,539301,3424,2130,5,2135,36
2020-06-25,Sutter,101,95872,172,126,0,126,2
2020-06-25,Tehama,103,63373,83,59,2,61,1
2020-06-25,Trinity,105,12862,17,2,4,6,0
2020-06-25,Tulare,107,460477,5046,3656,12,3668,117
2020-06-25,Tuolumne,109,53932,38,10,1,11,0
2020-06-25,Ventura,111,848112,3877,2346,16,2362,40
2020-06-25,Yolo,113,214977,601,397,3,400,24
2020-06-25,Yuba,115,75493,64,38,0,38,1
2020-06-24,Alameda,001,1643700,6348,5242,9,5251,123
2020-06-24,Alpine,003,1148,1,1,0,1,0
2020-06-24,Amador,005,37829,23,16,0,16,0
2020-06-24,Butte,007,227075,222,119,7,126,1
2020-06-24,Calaveras,009,45235,40,26,0,26,0
2020-06-24,Colusa,011,21464,44,11,0,11,0
2020-06-24,Contra Costa,013,1133247,3238,2520,3,2523,66
2020-06-24,Del Norte,015,27424,49,47,0,47,0
2020-06-24,El Dorado,017,186661,239,149,0,149,0
2020-06-24,Fresno,019,978130,8212,3765,74,3839,71
2020-06-24,Glenn,021,27897,124,54,0,54,0
2020-06-24,Humboldt,023,135768,151,117,0,117,3
2020-06-24,Imperial,025,180216,7505,5138,4,5142,38
2020-06-24,Inyo,027,18085,29,28,0,28,1
2020-06-24,Kern,029,883053,6982,4155,20,4175,67
2020-06-24,Kings,031,150075,2520,2063,6,2069,16
2020-06-24,Lake,033,64148,66,40,0,40,0
2020-06-24,Lassen,035,31185,232,9,2,11,0
2020-06-24,Los Angeles,037,10098052,105631,89566,27,89593,3186
2020-06-24,Madera,039,155013,766,373,2,375,4
2020-06-24,Marin,041,260295,2242,1261,4,1265,17
2020-06-24,Mariposa,043,17540,28,19,0,19,1
2020-06-24,Mendocino,045,87422,79,60,0,60,0
2020-06-24,Merced,047,269075,1353,696,1,697,8
2020-06-24,Modoc,049,8938,1,0,0,0,0
2020-06-24,Mono,051,14174,42,35,0,35,1
2020-06-24,Monterey,053,433212,1850,1407,5,1412,12
2020-06-24,Napa,055,140530,377,258,0,258,3
2020-06-24,Nevada,057,99092,122,92,1,93,1
2020-06-24,Orange,059,3164182,19047,11804,154,11958,303
2020-06-24,Placer,061,380077,787,548,3,551,10
2020-06-24,Plumas,063,18699,10,6,0,6,0
2020-06-24,Riverside,065,2383286,20574,14946,26,14972,410
2020-06-24,Sacramento,067,1510023,3370,2446,5,2451,62
2020-06-24,San Benito,069,59416,252,171,0,171,2
2020-06-24,San Bernardino,071,2135413,15838,10211,9,10220,239
2020-06-24,San Diego,073,3302833,15085,11628,2,11630,347
2020-06-24,San Francisco,075,870044,3723,3216,1,3217,48
2020-06-24,San Joaquin,077,732212,4062,2680,4,2684,49
2020-06-24,San Luis Obispo,079,281455,713,461,5,466,1
2020-06-24,San Mateo,081,765935,3370,2964,6,2970,82
2020-06-24,Santa Barbara,083,443738,3242,2569,25,2594,22
2020-06-24,Santa Clara,085,1922200,5241,3812,17,3829,155
2020-06-24,Santa Cruz,087,273765,407,329,0,329,2
2020-06-24,Shasta,089,179085,168,83,0,83,5
2020-06-24,Sierra,091,2930,1,1,0,1,0
2020-06-24,Siskiyou,093,43540,32,24,0,24,0
2020-06-24,Solano,095,438530,1536,979,7,986,21
2020-06-24,Sonoma,097,501317,1265,933,3,936,4
2020-06-24,Stanislaus,099,539301,3245,2039,5,2044,36
2020-06-24,Sutter,101,95872,159,118,0,118,2
2020-06-24,Tehama,103,63373,81,55,2,57,1
2020-06-24,Trinity,105,12862,16,2,3,5,0
2020-06-24,Tulare,107,460477,4891,3541,10,3551,116
2020-06-24,Tuolumne,109,53932,33,9,1,10,0
2020-06-24,Ventura,111,848112,3536,2314,16,2330,42
2020-06-24,Yolo,113,214977,566,376,3,379,24
2020-06-24,Yuba,115,75493,58,37,0,37,1
2020-06-23,Alameda,001,1643700,6167,5159,9,5168,121
2020-06-23,Alpine,003,1148,1,1,0,1,0
2020-06-23,Amador,005,37829,22,13,0,13,0
2020-06-23,Butte,007,227075,204,111,7,118,1
2020-06-23,Calaveras,009,45235,40,26,0,26,0
2020-06-23,Colusa,011,21464,40,7,0,7,0
2020-06-23,Contra Costa,013,1133247,3112,2453,3,2456,60
2020-06-23,Del Norte,015,27424,48,46,0,46,0
2020-06-23,El Dorado,017,186661,230,142,0,142,0
2020-06-23,Fresno,019,978130,7560,3569,72,3641,67
2020-06-23,Glenn,021,27897,120,47,0,47,0
2020-06-23,Humboldt,023,135768,151,110,0,110,3
2020-06-23,Imperial,025,180216,7342,5025,4,5029,38
2020-06-23,Inyo,027,18085,29,26,0,26,1
2020-06-23,Kern,029,883053,6614,4087,17,4104,64
2020-06-23,Kings,031,150075,2455,1727,6,1733,16
2020-06-23,Lake,033,64148,60,40,0,40,0
2020-06-23,Lassen,035,31185,228,9,2,11,0
2020-06-23,Los Angeles,037,10098052,102691,88433,26,88459,3152
2020-06-23,Madera,039,155013,727,369,2,371,4
2020-06-23,Marin,041,260295,1974,1139,4,1143,17
2020-06-23,Mariposa,043,17540,26,18,0,18,1
2020-06-23,Mendocino,045,87422,78,61,0,61,0
2020-06-23,Merced,047,269075,1255,656,1,657,8
2020-06-23,Modoc,049,8938,1,0,0,0,0
2020-06-23,Mono,051,14174,42,35,0,35,1
2020-06-23,Monterey,053,433212,1780,1346,5,1351,12
2020-06-23,Napa,055,140530,362,230,0,230,3
2020-06-23,Nevada,057,99092,116,81,1,82,1
2020-06-23,Orange,059,3164182,18078,11071,151,11222,278
2020-06-23,Placer,061,380077,761,525,3,528,10
2020-06-23,Plumas,063,18699,9,6,0,6,0
2020-06-23,Riverside,065,2383286,19554,14469,26,14495,406
2020-06-23,Sacramento,067,1510023,3191,2374,5,2379,62
2020-06-23,San Benito,069,59416,238,167,0,167,2
2020-06-23,San Bernardino,071,2135413,15058,9771,9,9780,229
2020-06-23,San Diego,073,3302833,14565,11296,2,11298,341
2020-06-23,San Francisco,075,870044,3649,3177,1,3178,48
2020-06-23,San Joaquin,077,732212,3803,2502,4,2506,48
2020-06-23,San Luis Obispo,079,281455,682,445,5,450,1
2020-06-23,San Mateo,081,765935,3305,2907,6,2913,81
2020-06-23,Santa Barbara,083,443738,3147,2498,25,2523,22
2020-06-23,Santa Clara,085,1922200,5095,3700,17,3717,155
2020-06-23,Santa Cruz,087,273765,397,313,0,313,2
2020-06-23,Shasta,089,179085,159,81,0,81,5
2020-06-23,Sierra,091,2930,1,1,0,1,0
2020-06-23,Siskiyou,093,43540,30,24,0,24,0
2020-06-23,Solano,095,438530,1479,941,6,947,21
2020-06-23,Sonoma,097,501317,1212,912,3,915,4
2020-06-23,Stanislaus,099,539301,3069,1850,5,1855,35
2020-06-23,Sutter,101,95872,149,112,0,112,2
2020-06-23,Tehama,103,63373,79,50,2,52,1
2020-06-23,Trinity,105,12862,16,2,3,5,0
2020-06-23,Tulare,107,460477,4769,3456,10,3466,111
2020-06-23,Tuolumne,109,53932,28,9,0,9,0
2020-06-23,Ventura,111,848112,3376,2209,15,2224,40
2020-06-23,Yolo,113,214977,540,350,0,350,24
2020-06-23,Yuba,115,75493,55,35,0,35,1
2020-06-22,Alameda,001,1643700,6016,4944,9,4953,121
2020-06-22,Alpine,003,1148,1,1,0,1,0
2020-06-22,Amador,005,37829,19,12,0,12,0
2020-06-22,Butte,007,227075,185,104,7,111,1
2020-06-22,Calaveras,009,45235,38,20,0,20,0
2020-06-22,Colusa,011,21464,37,7,0,7,0
2020-06-22,Contra Costa,013,1133247,2970,2363,3,2366,60
2020-06-22,Del Norte,015,27424,48,46,0,46,0
2020-06-22,El Dorado,017,186661,221,137,0,137,0
2020-06-22,Fresno,019,978130,7028,3425,72,3497,67
2020-06-22,Glenn,021,27897,111,40,0,40,0
2020-06-22,Humboldt,023,135768,148,110,0,110,3
2020-06-22,Imperial,025,180216,7185,4700,4,4704,38
2020-06-22,Inyo,027,18085,29,26,0,26,1
2020-06-22,Kern,029,883053,6262,3982,15,3997,60
2020-06-22,Kings,031,150075,2406,1513,6,1519,13
2020-06-22,Lake,033,64148,54,37,0,37,0
2020-06-22,Lassen,035,31185,118,7,2,9,0
2020-06-22,Los Angeles,037,10098052,99794,85925,24,85949,3117
2020-06-22,Madera,039,155013,702,333,2,335,4
2020-06-22,Marin,041,260295,1717,1029,4,1033,17
2020-06-22,Mariposa,043,17540,25,18,0,18,1
2020-06-22,Mendocino,045,87422,73,48,0,48,0
2020-06-22,Merced,047,269075,1166,619,1,620,8
2020-06-22,Modoc,049,8938,1,0,0,0,0
2020-06-22,Mono,051,14174,42,34,0,34,1
2020-06-22,Monterey,053,433212,1719,1293,5,1298,12
2020-06-22,Napa,055,140530,338,222,0,222,3
2020-06-22,Nevada,057,99092,111,79,1,80,1
2020-06-22,Orange,059,3164182,17146,10711,148,10859,275
2020-06-22,Placer,061,380077,735,512,3,515,9
2020-06-22,Plumas,063,18699,7,6,0,6,0
2020-06-22,Riverside,065,2383286,18582,13948,26,13974,403
2020-06-22,Sacramento,067,1510023,2974,2243,5,2248,62
2020-06-22,San Benito,069,59416,229,164,0,164,2
2020-06-22,San Bernardino,071,2135413,14284,9133,9,9142,229
2020-06-22,San Diego,073,3302833,14073,11098,2,11100,338
2020-06-22,San Francisco,075,870044,3556,3000,1,3001,47
2020-06-22,San Joaquin,077,732212,3555,2332,4,2336,48
2020-06-22,San Luis Obispo,079,281455,649,422,5,427,1
2020-06-22,San Mateo,081,765935,3232,2813,5,2818,81
2020-06-22,Santa Barbara,083,443738,3055,2447,25,2472,21
2020-06-22,Santa Clara,085,1922200,4932,3580,17,3597,155
2020-06-22,Santa Cruz,087,273765,384,290,0,290,3
2020-06-22,Shasta,089,179085,156,77,0,77,5
2020-06-22,Sierra,091,2930,1,1,0,1,0
2020-06-22,Siskiyou,093,43540,30,23,0,23,0
2020-06-22,Solano,095,438530,1401,784,5,789,21
2020-06-22,Sonoma,097,501317,1167,860,1,861,4
2020-06-22,Stanislaus,099,539301,2884,1784,5,1789,35
2020-06-22,Sutter,101,95872,140,100,0,100,2
2020-06-22,Tehama,103,63373,75,38,2,40,1
2020-06-22,Trinity,105,12862,16,2,3,5,0
2020-06-22,Tulare,107,460477,4632,3185,10,3195,111
2020-06-22,Tuolumne,109,53932,19,8,0,8,0
2020-06-22,Ventura,111,848112,3227,2065,15,2080,39
2020-06-22,Yolo,113,214977,514,333,0,333,24
2020-06-22,Yuba,115,75493,50,36,0,36,1
2020-06-21,Alameda,001,1643700,5821,4835,9,4844,121
2020-06-21,Alpine,003,1148,1,1,0,1,0
2020-06-21,Amador,005,37829,14,12,0,12,0
2020-06-21,Butte,007,227075,171,97,7,104,1
2020-06-21,Calaveras,009,45235,38,20,0,20,0
2020-06-21,Colusa,011,21464,29,7,0,7,0
2020-06-21,Contra Costa,013,1133247,2844,2282,3,2285,60
2020-06-21,Del Norte,015,27424,47,46,0,46,0
2020-06-21,El Dorado,017,186661,212,132,0,132,0
2020-06-21,Fresno,019,978130,6457,3296,70,3366,67
2020-06-21,Glenn,021,27897,102,40,0,40,0
2020-06-21,Humboldt,023,135768,143,108,0,108,3
2020-06-21,Imperial,025,180216,7002,4701,4,4705,38
2020-06-21,Inyo,027,18085,27,26,0,26,1
2020-06-21,Kern,029,883053,5970,3918,14,3932,60
2020-06-21,Kings,031,150075,2342,1334,6,1340,11
2020-06-21,Lake,033,64148,49,36,0,36,0
2020-06-21,Lassen,035,31185,25,7,2,9,0
2020-06-21,Los Angeles,037,10098052,96912,83383,23,83406,3101
2020-06-21,Madera,039,155013,668,319,2,321,4
2020-06-21,Marin,041,260295,1560,907,4,911,17
2020-06-21,Mariposa,043,17540,22,18,0,18,1
2020-06-21,Mendocino,045,87422,70,48,0,48,0
2020-06-21,Merced,047,269075,1071,577,1,578,8
2020-06-21,Modoc,049,8938,1,0,0,0,0
2020-06-21,Mono,051,14174,42,34,0,34,1
2020-06-21,Monterey,053,433212,1646,1227,5,1232,12
2020-06-21,Napa,055,140530,323,218,0,218,3
2020-06-21,Nevada,057,99092,108,79,1,80,1
2020-06-21,Orange,059,3164182,16314,10563,144,10707,275
2020-06-21,Placer,061,380077,695,498,3,501,9
2020-06-21,Plumas,063,18699,7,6,0,6,0
2020-06-21,Riverside,065,2383286,17876,13528,25,13553,402
2020-06-21,Sacramento,067,1510023,2773,2156,4,2160,62
2020-06-21,San Benito,069,59416,215,151,0,151,2
2020-06-21,San Bernardino,071,2135413,13510,8925,8,8933,229
2020-06-21,San Diego,073,3302833,13527,10796,2,10798,338
2020-06-21,San Francisco,075,870044,3450,3000,1,3001,47
2020-06-21,San Joaquin,077,732212,3319,2188,4,2192,48
2020-06-21,San Luis Obispo,079,281455,623,418,5,423,1
2020-06-21,San Mateo,081,765935,3174,2781,5,2786,81
2020-06-21,Santa Barbara,083,443738,2948,2430,24,2454,21
2020-06-21,Santa Clara,085,1922200,4794,3514,17,3531,154
2020-06-21,Santa Cruz,087,273765,374,290,0,290,3
2020-06-21,Shasta,089,179085,146,75,0,75,5
2020-06-21,Sierra,091,2930,1,1,0,1,0
2020-06-21,Siskiyou,093,43540,30,23,0,23,0
2020-06-21,Solano,095,438530,1301,783,4,787,21
2020-06-21,Sonoma,097,501317,1117,836,1,837,4
2020-06-21,Stanislaus,099,539301,2698,1688,5,1693,35
2020-06-21,Sutter,101,95872,132,96,0,96,2
2020-06-21,Tehama,103,63373,64,35,2,37,1
2020-06-21,Trinity,105,12862,15,2,3,5,0
2020-06-21,Tulare,107,460477,4463,3173,10,3183,111
2020-06-21,Tuolumne,109,53932,17,8,0,8,0
2020-06-21,Ventura,111,848112,3049,2021,15,2036,39
2020-06-21,Yolo,113,214977,482,323,0,323,24
2020-06-21,Yuba,115,75493,46,35,0,35,1
2020-06-20,Alameda,001,1643700,5759,4758,9,4767,119
2020-06-20,Alpine,003,1148,1,1,0,1,0
2020-06-20,Amador,005,37829,14,12,0,12,0
2020-06-20,Butte,007,227075,164,94,7,101,1
2020-06-20,Calaveras,009,45235,38,20,0,20,0
2020-06-20,Colusa,011,21464,26,7,0,7,0
2020-06-20,Contra Costa,013,1133247,2785,2231,3,2234,54
2020-06-20,Del Norte,015,27424,47,46,0,46,0
2020-06-20,El Dorado,017,186661,207,130,0,130,0
2020-06-20,Fresno,019,978130,6331,3222,67,3289,67
2020-06-20,Glenn,021,27897,97,40,0,40,0
2020-06-20,Humboldt,023,135768,143,108,0,108,3
2020-06-20,Imperial,025,180216,6921,4616,4,4620,37
2020-06-20,Inyo,027,18085,27,26,0,26,1
2020-06-20,Kern,029,883053,5805,3836,14,3850,59
2020-06-20,Kings,031,150075,2318,1331,6,1337,9
2020-06-20,Lake,033,64148,49,37,0,37,0
2020-06-20,Lassen,035,31185,24,7,2,9,0
2020-06-20,Los Angeles,037,10098052,95341,81604,22,81626,3093
2020-06-20,Madera,039,155013,635,321,2,323,4
2020-06-20,Marin,041,260295,1540,879,4,883,17
2020-06-20,Mariposa,043,17540,22,18,0,18,1
2020-06-20,Mendocino,045,87422,69,48,0,48,0
2020-06-20,Merced,047,269075,1031,566,1,567,8
2020-06-20,Modoc,049,8938,1,0,0,0,0
2020-06-20,Mono,051,14174,42,34,0,34,1
2020-06-20,Monterey,053,433212,1610,1181,5,1186,12
2020-06-20,Napa,055,140530,314,212,0,212,3
2020-06-20,Nevada,057,99092,105,73,1,74,1
2020-06-20,Orange,059,3164182,15964,10284,140,10424,273
2020-06-20,Placer,061,380077,670,483,3,486,9
2020-06-20,Plumas,063,18699,6,6,0,6,0
2020-06-20,Riverside,065,2383286,17577,13021,25,13046,402
2020-06-20,Sacramento,067,1510023,2702,2069,4,2073,63
2020-06-20,San Benito,069,59416,211,139,0,139,2
2020-06-20,San Bernardino,071,2135413,13148,8718,8,8726,229
2020-06-20,San Diego,073,3302833,13204,10486,2,10488,338
2020-06-20,San Francisco,075,870044,3406,2999,1,3000,47
2020-06-20,San Joaquin,077,732212,3237,2046,4,2050,48
2020-06-20,San Luis Obispo,079,281455,610,405,5,410,1
2020-06-20,San Mateo,081,765935,3126,2755,5,2760,81
2020-06-20,Santa Barbara,083,443738,2891,2358,23,2381,21
2020-06-20,Santa Clara,085,1922200,4720,3435,17,3452,154
2020-06-20,Santa Cruz,087,273765,372,287,0,287,3
2020-06-20,Shasta,089,179085,140,66,0,66,5
2020-06-20,Sierra,091,2930,1,1,0,1,0
2020-06-20,Siskiyou,093,43540,29,22,0,22,0
2020-06-20,Solano,095,438530,1277,784,4,788,21
2020-06-20,Sonoma,097,501317,1081,806,1,807,4
2020-06-20,Stanislaus,099,539301,2590,1598,5,1603,35
2020-06-20,Sutter,101,95872,130,89,0,89,2
2020-06-20,Tehama,103,63373,62,35,2,37,1
2020-06-20,Trinity,105,12862,15,2,3,5,0
2020-06-20,Tulare,107,460477,4390,3172,10,3182,111
2020-06-20,Tuolumne,109,53932,14,8,0,8,0
2020-06-20,Ventura,111,848112,2984,1946,15,1961,37
2020-06-20,Yolo,113,214977,466,309,0,309,24
2020-06-20,Yuba,115,75493,44,34,0,34,1
2020-06-19,Alameda,001,1643700,5688,4646,9,4655,119
2020-06-19,Alpine,003,1148,1,1,0,1,0
2020-06-19,Amador,005,37829,14,12,0,12,0
2020-06-19,Butte,007,227075,159,91,7,98,1
2020-06-19,Calaveras,009,45235,37,20,0,20,0
2020-06-19,Colusa,011,21464,24,7,0,7,0
2020-06-19,Contra Costa,013,1133247,2705,2106,3,2109,54
2020-06-19,Del Norte,015,27424,47,46,0,46,0
2020-06-19,El Dorado,017,186661,198,124,0,124,0
2020-06-19,Fresno,019,978130,6169,3109,65,3174,61
2020-06-19,Glenn,021,27897,91,40,0,40,0
2020-06-19,Humboldt,023,135768,141,106,0,106,3
2020-06-19,Imperial,025,180216,6830,4504,4,4508,36
2020-06-19,Inyo,027,18085,27,26,0,26,1
2020-06-19,Kern,029,883053,5582,3742,13,3755,57
2020-06-19,Kings,031,150075,2297,1285,6,1291,9
2020-06-19,Lake,033,64148,46,36,0,36,0
2020-06-19,Lassen,035,31185,23,7,2,9,0
2020-06-19,Los Angeles,037,10098052,93362,79572,21,79593,3047
2020-06-19,Madera,039,155013,616,300,2,302,4
2020-06-19,Marin,041,260295,1511,829,4,833,17
2020-06-19,Mariposa,043,17540,21,18,0,18,1
2020-06-19,Mendocino,045,87422,68,48,0,48,0
2020-06-19,Merced,047,269075,986,529,1,530,8
2020-06-19,Modoc,049,8938,1,0,0,0,0
2020-06-19,Mono,051,14174,42,34,0,34,1
2020-06-19,Monterey,053,433212,1581,1159,5,1164,12
2020-06-19,Napa,055,140530,304,209,0,209,3
2020-06-19,Nevada,057,99092,102,71,1,72,1
2020-06-19,Orange,059,3164182,15431,9972,133,10105,260
2020-06-19,Placer,061,380077,652,464,3,467,9
2020-06-19,Plumas,063,18699,6,5,0,5,0
2020-06-19,Riverside,065,2383286,17172,12710,25,12735,398
2020-06-19,Sacramento,067,1510023,2619,1976,4,1980,64
2020-06-19,San Benito,069,59416,210,136,0,136,2
2020-06-19,San Bernardino,071,2135413,12743,8454,7,8461,226
2020-06-19,San Diego,073,3302833,12841,10352,2,10354,332
2020-06-19,San Francisco,075,870044,3351,2968,1,2969,47
2020-06-19,San Joaquin,077,732212,3114,1969,4,1973,48
2020-06-19,San Luis Obispo,079,281455,594,392,5,397,1
2020-06-19,San Mateo,081,765935,3087,2713,5,2718,81
2020-06-19,Santa Barbara,083,443738,2818,2284,21,2305,21
2020-06-19,Santa Clara,085,1922200,4646,3376,17,3393,154
2020-06-19,Santa Cruz,087,273765,362,283,0,283,3
2020-06-19,Shasta,089,179085,137,58,0,58,5
2020-06-19,Sierra,091,2930,1,1,0,1,0
2020-06-19,Siskiyou,093,43540,29,21,0,21,0
2020-06-19,Solano,095,438530,1239,755,4,759,21
2020-06-19,Sonoma,097,501317,1054,803,1,804,4
2020-06-19,Stanislaus,099,539301,2480,1549,5,1554,35
2020-06-19,Sutter,101,95872,129,89,0,89,2
2020-06-19,Tehama,103,63373,61,35,2,37,1
2020-06-19,Trinity,105,12862,15,2,3,5,0
2020-06-19,Tulare,107,460477,4319,3053,10,3063,107
2020-06-19,Tuolumne,109,53932,13,8,0,8,0
2020-06-19,Ventura,111,848112,2900,1865,15,1880,37
2020-06-19,Yolo,113,214977,447,303,0,303,24
2020-06-19,Yuba,115,75493,43,33,0,33,1
2020-06-18,Alameda,001,1643700,5558,4589,9,4598,118
2020-06-18,Alpine,003,1148,1,1,0,1,0
2020-06-18,Amador,005,37829,13,12,0,12,0
2020-06-18,Butte,007,227075,154,88,7,95,1
2020-06-18,Calaveras,009,45235,37,20,0,20,0
2020-06-18,Colusa,011,21464,20,7,0,7,0
2020-06-18,Contra Costa,013,1133247,2599,2072,3,2075,53
2020-06-18,Del Norte,015,27424,47,46,0,46,0
2020-06-18,El Dorado,017,186661,194,121,0,121,0
2020-06-18,Fresno,019,978130,5902,2947,64,3011,57
2020-06-18,Glenn,021,27897,82,35,0,35,0
2020-06-18,Humboldt,023,135768,140,106,0,106,3
2020-06-18,Imperial,025,180216,6680,4366,4,4370,36
2020-06-18,Inyo,027,18085,26,25,0,25,1
2020-06-18,Kern,029,883053,5364,3634,13,3647,57
2020-06-18,Kings,031,150075,2238,1141,6,1147,8
2020-06-18,Lake,033,64148,45,36,0,36,0
2020-06-18,Lassen,035,31185,22,5,2,7,0
2020-06-18,Los Angeles,037,10098052,91094,78244,21,78265,3009
2020-06-18,Madera,039,155013,581,288,2,290,4
2020-06-18,Marin,041,260295,1448,819,4,823,17
2020-06-18,Mariposa,043,17540,19,18,0,18,1
2020-06-18,Mendocino,045,87422,64,45,0,45,0
2020-06-18,Merced,047,269075,934,486,1,487,7
2020-06-18,Modoc,049,8938,1,0,0,0,0
2020-06-18,Mono,051,14174,42,34,0,34,1
2020-06-18,Monterey,053,433212,1513,1127,5,1132,12
2020-06-18,Napa,055,140530,289,205,0,205,3
2020-06-18,Nevada,057,99092,98,68,1,69,1
2020-06-18,Orange,059,3164182,14776,9597,114,9711,255
2020-06-18,Placer,061,380077,629,457,3,460,9
2020-06-18,Plumas,063,18699,6,5,0,5,0
2020-06-18,Riverside,065,2383286,16556,12410,25,12435,392
2020-06-18,Sacramento,067,1510023,2503,1938,4,1942,63
2020-06-18,San Benito,069,59416,204,134,0,134,2
2020-06-18,San Bernardino,071,2135413,12103,8141,7,8148,226
2020-06-18,San Diego,073,3302833,12419,10094,2,10096,331
2020-06-18,San Francisco,075,870044,3302,2951,1,2952,47
2020-06-18,San Joaquin,077,732212,2962,1908,4,1912,47
2020-06-18,San Luis Obispo,079,281455,574,378,5,383,1
2020-06-18,San Mateo,081,765935,3048,2674,5,2679,78
2020-06-18,Santa Barbara,083,443738,2744,2201,21,2222,19
2020-06-18,Santa Clara,085,1922200,4543,3338,17,3355,152
2020-06-18,Santa Cruz,087,273765,345,275,0,275,3
2020-06-18,Shasta,089,179085,126,51,0,51,4
2020-06-18,Sierra,091,2930,1,1,0,1,0
2020-06-18,Siskiyou,093,43540,29,18,0,18,0
2020-06-18,Solano,095,438530,1201,735,4,739,21
2020-06-18,Sonoma,097,501317,1012,789,1,790,4
2020-06-18,Stanislaus,099,539301,2346,1495,5,1500,35
2020-06-18,Sutter,101,95872,125,85,0,85,2
2020-06-18,Tehama,103,63373,56,31,2,33,1
2020-06-18,Trinity,105,12862,15,2,3,5,0
2020-06-18,Tulare,107,460477,4197,3005,10,3015,107
2020-06-18,Tuolumne,109,53932,12,8,0,8,0
2020-06-18,Ventura,111,848112,2774,1781,15,1796,37
2020-06-18,Yolo,113,214977,414,294,0,294,24
2020-06-18,Yuba,115,75493,42,32,0,32,1
2020-06-17,Alameda,001,1643700,5435,4485,9,4494,117
2020-06-17,Alpine,003,1148,1,1,0,1,0
2020-06-17,Amador,005,37829,12,10,0,10,0
2020-06-17,Butte,007,227075,145,81,7,88,1
2020-06-17,Calaveras,009,45235,37,20,0,20,0
2020-06-17,Colusa,011,21464,19,7,0,7,0
2020-06-17,Contra Costa,013,1133247,2502,2020,3,2023,45
2020-06-17,Del Norte,015,27424,47,45,0,45,0
2020-06-17,El Dorado,017,186661,187,116,0,116,0
2020-06-17,Fresno,019,978130,5676,2801,61,2862,56
2020-06-17,Glenn,021,27897,75,31,0,31,0
2020-06-17,Humboldt,023,135768,138,105,0,105,3
2020-06-17,Imperial,025,180216,6507,4108,4,4112,36
2020-06-17,Inyo,027,18085,25,25,0,25,1
2020-06-17,Kern,029,883053,5163,3547,13,3560,56
2020-06-17,Kings,031,150075,2208,1097,6,1103,7
2020-06-17,Lake,033,64148,44,32,0,32,0
2020-06-17,Lassen,035,31185,18,5,2,7,0
2020-06-17,Los Angeles,037,10098052,88787,77166,21,77187,2973
2020-06-17,Madera,039,155013,559,258,2,260,4
2020-06-17,Marin,041,260295,1256,771,3,774,17
2020-06-17,Mariposa,043,17540,18,18,0,18,1
2020-06-17,Mendocino,045,87422,62,42,0,42,0
2020-06-17,Merced,047,269075,862,460,1,461,7
2020-06-17,Modoc,049,8938,1,0,0,0,0
2020-06-17,Mono,051,14174,42,34,0,34,1
2020-06-17,Monterey,053,433212,1461,1077,5,1082,12
2020-06-17,Napa,055,140530,274,202,0,202,3
2020-06-17,Nevada,057,99092,94,57,1,58,1
2020-06-17,Orange,059,3164182,14170,9278,108,9386,230
2020-06-17,Placer,061,380077,609,427,3,430,9
2020-06-17,Plumas,063,18699,6,5,0,5,0
2020-06-17,Riverside,065,2383286,15920,11859,25,11884,370
2020-06-17,Sacramento,067,1510023,2396,1889,4,1893,63
2020-06-17,San Benito,069,59416,199,116,0,116,2
2020-06-17,San Bernardino,071,2135413,11553,7670,7,7677,225
2020-06-17,San Diego,073,3302833,12040,9856,2,9858,327
2020-06-17,San Francisco,075,870044,3263,2906,1,2907,46
2020-06-17,San Joaquin,077,732212,2789,1825,4,1829,46
2020-06-17,San Luis Obispo,079,281455,555,362,5,367,1
2020-06-17,San Mateo,081,765935,3001,2649,5,2654,78
2020-06-17,Santa Barbara,083,443738,2671,2147,19,2166,19
2020-06-17,Santa Clara,085,1922200,4450,3264,16,3280,148
2020-06-17,Santa Cruz,087,273765,339,265,0,265,2
2020-06-17,Shasta,089,179085,124,51,0,51,4
2020-06-17,Sierra,091,2930,1,1,0,1,0
2020-06-17,Siskiyou,093,43540,28,16,0,16,0
2020-06-17,Solano,095,438530,1151,722,4,726,21
2020-06-17,Sonoma,097,501317,986,748,1,749,4
2020-06-17,Stanislaus,099,539301,2223,1387,5,1392,35
2020-06-17,Sutter,101,95872,119,79,0,79,2
2020-06-17,Tehama,103,63373,41,24,2,26,1
2020-06-17,Trinity,105,12862,14,2,3,5,0
2020-06-17,Tulare,107,460477,4087,2882,10,2892,106
2020-06-17,Tuolumne,109,53932,12,7,0,7,0
2020-06-17,Ventura,111,848112,2674,1729,15,1744,37
2020-06-17,Yolo,113,214977,394,277,0,277,24
2020-06-17,Yuba,115,75493,41,30,0,30,1
2020-06-16,Alameda,001,1643700,5317,4428,9,4437,113
2020-06-16,Alpine,003,1148,1,1,0,1,0
2020-06-16,Amador,005,37829,12,10,0,10,0
2020-06-16,Butte,007,227075,141,79,7,86,1
2020-06-16,Calaveras,009,45235,34,19,0,19,0
2020-06-16,Colusa,011,21464,16,7,0,7,0
2020-06-16,Contra Costa,013,1133247,2411,1971,2,1973,45
2020-06-16,Del Norte,015,27424,47,45,0,45,0
2020-06-16,El Dorado,017,186661,181,115,0,115,0
2020-06-16,Fresno,019,978130,5438,2731,59,2790,50
2020-06-16,Glenn,021,27897,71,30,0,30,0
2020-06-16,Humboldt,023,135768,135,105,0,105,3
2020-06-16,Imperial,025,180216,6348,3939,4,3943,36
2020-06-16,Inyo,027,18085,25,24,0,24,1
2020-06-16,Kern,029,883053,4940,3496,13,3509,55
2020-06-16,Kings,031,150075,2162,1044,6,1050,6
2020-06-16,Lake,033,64148,44,31,0,31,0
2020-06-16,Lassen,035,31185,15,5,2,7,0
2020-06-16,Los Angeles,037,10098052,86465,75051,21,75072,2942
2020-06-16,Madera,039,155013,533,239,2,241,3
2020-06-16,Marin,041,260295,1203,725,3,728,17
2020-06-16,Mariposa,043,17540,18,17,0,17,1
2020-06-16,Mendocino,045,87422,61,35,0,35,0
2020-06-16,Merced,047,269075,814,436,1,437,7
2020-06-16,Modoc,049,8938,1,0,0,0,0
2020-06-16,Mono,051,14174,42,34,0,34,1
2020-06-16,Monterey,053,433212,1413,1019,5,1024,12
2020-06-16,Napa,055,140530,259,196,0,196,3
2020-06-16,Nevada,057,99092,91,53,1,54,1
2020-06-16,Orange,059,3164182,13586,9163,104,9267,223
2020-06-16,Placer,061,380077,577,392,3,395,9
2020-06-16,Plumas,063,18699,6,5,0,5,0
2020-06-16,Riverside,065,2383286,15245,11638,25,11663,364
2020-06-16,Sacramento,067,1510023,2286,1825,4,1829,60
2020-06-16,San Benito,069,59416,191,110,0,110,2
2020-06-16,San Bernardino,071,2135413,11009,7463,7,7470,225
2020-06-16,San Diego,073,3302833,11678,9732,1,9733,323
2020-06-16,San Francisco,075,870044,3212,2893,1,2894,46
2020-06-16,San Joaquin,077,732212,2636,1718,4,1722,47
2020-06-16,San Luis Obispo,079,281455,531,343,5,348,1
2020-06-16,San Mateo,081,765935,2947,2618,5,2623,77
2020-06-16,Santa Barbara,083,443738,2604,2090,19,2109,16
2020-06-16,Santa Clara,085,1922200,4339,3228,15,3243,148
2020-06-16,Santa Cruz,087,273765,323,257,0,257,2
2020-06-16,Shasta,089,179085,115,51,0,51,4
2020-06-16,Sierra,091,2930,1,1,0,1,0
2020-06-16,Siskiyou,093,43540,27,15,0,15,0
2020-06-16,Solano,095,438530,1061,694,4,698,19
2020-06-16,Sonoma,097,501317,954,739,1,740,4
2020-06-16,Stanislaus,099,539301,2070,1278,5,1283,36
2020-06-16,Sutter,101,95872,112,73,0,73,2
2020-06-16,Tehama,103,63373,37,24,2,26,1
2020-06-16,Trinity,105,12862,14,2,3,5,0
2020-06-16,Tulare,107,460477,3968,2802,10,2812,96
2020-06-16,Tuolumne,109,53932,12,7,0,7,0
2020-06-16,Ventura,111,848112,2573,1676,15,1691,37
2020-06-16,Yolo,113,214977,371,262,0,262,24
2020-06-16,Yuba,115,75493,39,29,0,29,1
2020-06-15,Alameda,001,1643700,5191,4323,9,4332,112
2020-06-15,Alpine,003,1148,1,1,0,1,0
2020-06-15,Amador,005,37829,12,10,0,10,0
2020-06-15,Butte,007,227075,133,78,7,85,1
2020-06-15,Calaveras,009,45235,34,18,0,18,0
2020-06-15,Colusa,011,21464,14,7,0,7,0
2020-06-15,Contra Costa,013,1133247,2334,1918,2,1920,43
2020-06-15,Del Norte,015,27424,47,45,0,45,0
2020-06-15,El Dorado,017,186661,171,114,0,114,0
2020-06-15,Fresno,019,978130,5226,2616,58,2674,48
2020-06-15,Glenn,021,27897,66,21,0,21,0
2020-06-15,Humboldt,023,135768,133,105,0,105,3
2020-06-15,Imperial,025,180216,6173,3726,4,3730,36
2020-06-15,Inyo,027,18085,25,23,0,23,1
2020-06-15,Kern,029,883053,4716,3417,13,3430,55
2020-06-15,Kings,031,150075,2085,1022,6,1028,6
2020-06-15,Lake,033,64148,44,31,0,31,0
2020-06-15,Lassen,035,31185,15,5,2,7,0
2020-06-15,Los Angeles,037,10098052,84276,73705,21,73726,2908
2020-06-15,Madera,039,155013,511,203,2,205,3
2020-06-15,Marin,041,260295,1036,708,3,711,17
2020-06-15,Mariposa,043,17540,18,17,0,17,1
2020-06-15,Mendocino,045,87422,52,33,0,33,0
2020-06-15,Merced,047,269075,768,414,1,415,7
2020-06-15,Modoc,049,8938,1,0,0,0,0
2020-06-15,Mono,051,14174,42,34,0,34,1
2020-06-15,Monterey,053,433212,1347,998,5,1003,12
2020-06-15,Napa,055,140530,251,187,0,187,3
2020-06-15,Nevada,057,99092,85,52,1,53,1
2020-06-15,Orange,059,3164182,13018,8944,96,9040,212
2020-06-15,Placer,061,380077,555,386,3,389,9
2020-06-15,Plumas,063,18699,6,4,0,4,0
2020-06-15,Riverside,065,2383286,14627,11376,24,11400,364
2020-06-15,Sacramento,067,1510023,2170,1791,4,1795,60
2020-06-15,San Benito,069,59416,185,108,0,108,2
2020-06-15,San Bernardino,071,2135413,10506,7189,7,7196,224
2020-06-15,San Diego,073,3302833,11338,9612,1,9613,320
2020-06-15,San Francisco,075,870044,3168,2833,1,2834,45
2020-06-15,San Joaquin,077,732212,2500,1667,4,1671,43
2020-06-15,San Luis Obispo,079,281455,516,332,5,337,1
2020-06-15,San Mateo,081,765935,2900,2591,5,2596,75
2020-06-15,Santa Barbara,083,443738,2536,2054,19,2073,16
2020-06-15,Santa Clara,085,1922200,4239,3204,15,3219,148
2020-06-15,Santa Cruz,087,273765,312,254,0,254,2
2020-06-15,Shasta,089,179085,109,50,0,50,4
2020-06-15,Sierra,091,2930,1,1,0,1,0
2020-06-15,Siskiyou,093,43540,26,14,0,14,0
2020-06-15,Solano,095,438530,1001,638,4,642,19
2020-06-15,Sonoma,097,501317,925,726,1,727,4
2020-06-15,Stanislaus,099,539301,1953,1253,5,1258,35
2020-06-15,Sutter,101,95872,102,71,0,71,2
2020-06-15,Tehama,103,63373,37,17,2,19,1
2020-06-15,Trinity,105,12862,13,2,3,5,0
2020-06-15,Tulare,107,460477,3854,2662,10,2672,96
2020-06-15,Tuolumne,109,53932,11,7,0,7,0
2020-06-15,Ventura,111,848112,2492,1656,15,1671,37
2020-06-15,Yolo,113,214977,351,255,0,255,24
2020-06-15,Yuba,115,75493,39,28,0,28,1
2020-06-14,Alameda,001,1643700,5046,4271,9,4280,112
2020-06-14,Alpine,003,1148,1,1,0,1,0
2020-06-14,Amador,005,37829,12,10,0,10,0
2020-06-14,Butte,007,227075,125,78,7,85,1
2020-06-14,Calaveras,009,45235,33,18,0,18,0
2020-06-14,Colusa,011,21464,13,7,0,7,0
2020-06-14,Contra Costa,013,1133247,2265,1893,2,1895,43
2020-06-14,Del Norte,015,27424,47,45,0,45,0
2020-06-14,El Dorado,017,186661,167,110,0,110,0
2020-06-14,Fresno,019,978130,5041,2585,57,2642,48
2020-06-14,Glenn,021,27897,51,21,0,21,0
2020-06-14,Humboldt,023,135768,129,105,0,105,3
2020-06-14,Imperial,025,180216,5942,3730,4,3734,36
2020-06-14,Inyo,027,18085,24,23,0,23,1
2020-06-14,Kern,029,883053,4505,3328,13,3341,55
2020-06-14,Kings,031,150075,2034,1022,5,1027,6
2020-06-14,Lake,033,64148,41,31,0,31,0
2020-06-14,Lassen,035,31185,15,5,2,7,0
2020-06-14,Los Angeles,037,10098052,81949,72932,20,72952,2887
2020-06-14,Madera,039,155013,492,203,2,205,3
2020-06-14,Marin,041,260295,871,689,2,691,17
2020-06-14,Mariposa,043,17540,18,16,0,16,1
2020-06-14,Mendocino,045,87422,49,33,0,33,0
2020-06-14,Merced,047,269075,717,403,1,404,7
2020-06-14,Modoc,049,8938,1,0,0,0,0
2020-06-14,Mono,051,14174,42,34,0,34,1
2020-06-14,Monterey,053,433212,1286,949,5,954,12
2020-06-14,Napa,055,140530,229,181,0,181,3
2020-06-14,Nevada,057,99092,81,52,1,53,1
2020-06-14,Orange,059,3164182,12591,8744,91,8835,211
2020-06-14,Placer,061,380077,529,369,3,372,9
2020-06-14,Plumas,063,18699,5,4,0,4,0
2020-06-14,Riverside,065,2383286,14185,11218,24,11242,364
2020-06-14,Sacramento,067,1510023,2083,1750,4,1754,60
2020-06-14,San Benito,069,59416,174,104,0,104,2
2020-06-14,San Bernardino,071,2135413,9966,7015,7,7022,224
2020-06-14,San Diego,073,3302833,10963,9442,1,9443,319
2020-06-14,San Francisco,075,870044,3128,2834,1,2835,45
2020-06-14,San Joaquin,077,732212,2349,1603,4,1607,43
2020-06-14,San Luis Obispo,079,281455,501,330,5,335,1
2020-06-14,San Mateo,081,765935,2842,2571,5,2576,75
2020-06-14,Santa Barbara,083,443738,2459,2049,19,2068,17
2020-06-14,Santa Clara,085,1922200,4144,3178,15,3193,148
2020-06-14,Santa Cruz,087,273765,298,254,0,254,2
2020-06-14,Shasta,089,179085,103,48,0,48,4
2020-06-14,Sierra,091,2930,1,1,0,1,0
2020-06-14,Siskiyou,093,43540,25,13,0,13,0
2020-06-14,Solano,095,438530,952,638,4,642,19
2020-06-14,Sonoma,097,501317,897,724,1,725,4
2020-06-14,Stanislaus,099,539301,1805,1159,5,1164,35
2020-06-14,Sutter,101,95872,97,63,0,63,2
2020-06-14,Tehama,103,63373,34,17,2,19,1
2020-06-14,Trinity,105,12862,13,2,3,5,0
2020-06-14,Tulare,107,460477,3720,2646,10,2656,96
2020-06-14,Tuolumne,109,53932,11,7,0,7,0
2020-06-14,Ventura,111,848112,2393,1610,14,1624,37
2020-06-14,Yolo,113,214977,335,254,0,254,24
2020-06-14,Yuba,115,75493,38,28,0,28,1
2020-06-13,Alameda,001,1643700,4983,4196,9,4205,112
2020-06-13,Alpine,003,1148,1,1,0,1,0
2020-06-13,Amador,005,37829,11,10,0,10,0
2020-06-13,Butte,007,227075,116,72,7,79,1
2020-06-13,Calaveras,009,45235,31,18,0,18,0
2020-06-13,Colusa,011,21464,12,7,0,7,0
2020-06-13,Contra Costa,013,1133247,2229,1868,2,1870,43
2020-06-13,Del Norte,015,27424,47,45,0,45,0
2020-06-13,El Dorado,017,186661,163,110,0,110,0
2020-06-13,Fresno,019,978130,4943,2499,57,2556,48
2020-06-13,Glenn,021,27897,49,21,0,21,0
2020-06-13,Humboldt,023,135768,128,104,0,104,3
2020-06-13,Imperial,025,180216,5869,3646,4,3650,36
2020-06-13,Inyo,027,18085,24,23,0,23,1
2020-06-13,Kern,029,883053,4396,3239,13,3252,55
2020-06-13,Kings,031,150075,2014,1023,5,1028,6
2020-06-13,Lake,033,64148,40,29,0,29,0
2020-06-13,Lassen,035,31185,15,5,2,7,0
2020-06-13,Los Angeles,037,10098052,80911,71938,20,71958,2874
2020-06-13,Madera,039,155013,488,203,2,205,3
2020-06-13,Marin,041,260295,840,677,2,679,17
2020-06-13,Mariposa,043,17540,18,16,0,16,1
2020-06-13,Mendocino,045,87422,49,33,0,33,0
2020-06-13,Merced,047,269075,699,376,1,377,7
2020-06-13,Modoc,049,8938,1,0,0,0,0
2020-06-13,Mono,051,14174,42,35,0,35,1
2020-06-13,Monterey,053,433212,1248,900,5,905,11
2020-06-13,Napa,055,140530,226,171,0,171,3
2020-06-13,Nevada,057,99092,79,52,1,53,1
2020-06-13,Orange,059,3164182,12347,8581,88,8669,211
2020-06-13,Placer,061,380077,512,346,3,349,9
2020-06-13,Plumas,063,18699,5,4,0,4,0
2020-06-13,Riverside,065,2383286,13906,10931,24,10955,364
2020-06-13,Sacramento,067,1510023,2028,1713,4,1717,60
2020-06-13,San Benito,069,59416,167,99,0,99,2
2020-06-13,San Bernardino,071,2135413,9742,6885,7,6892,224
2020-06-13,San Diego,073,3302833,10791,9316,1,9317,319
2020-06-13,San Francisco,075,870044,3108,2834,1,2835,44
2020-06-13,San Joaquin,077,732212,2268,1461,4,1465,43
2020-06-13,San Luis Obispo,079,281455,490,326,5,331,1
2020-06-13,San Mateo,081,765935,2819,2551,5,2556,75
2020-06-13,Santa Barbara,083,443738,2401,1999,19,2018,15
2020-06-13,Santa Clara,085,1922200,4101,3141,15,3156,148
2020-06-13,Santa Cruz,087,273765,292,254,0,254,2
2020-06-13,Shasta,089,179085,101,48,0,48,4
2020-06-13,Sierra,091,2930,1,1,0,1,0
2020-06-13,Siskiyou,093,43540,25,13,0,13,0
2020-06-13,Solano,095,438530,924,637,4,641,19
2020-06-13,Sonoma,097,501317,882,711,1,712,4
2020-06-13,Stanislaus,099,539301,1748,1122,5,1127,33
2020-06-13,Sutter,101,95872,96,62,0,62,2
2020-06-13,Tehama,103,63373,33,17,2,19,1
2020-06-13,Trinity,105,12862,13,2,3,5,0
2020-06-13,Tulare,107,460477,3688,2626,10,2636,96
2020-06-13,Tuolumne,109,53932,10,7,0,7,0
2020-06-13,Ventura,111,848112,2347,1567,14,1581,37
2020-06-13,Yolo,113,214977,315,251,0,251,24
2020-06-13,Yuba,115,75493,38,28,0,28,1
2020-06-12,Alameda,001,1643700,4910,4167,9,4176,109
2020-06-12,Alpine,003,1148,1,1,0,1,0
2020-06-12,Amador,005,37829,11,10,0,10,0
2020-06-12,Butte,007,227075,112,71,7,78,1
2020-06-12,Calaveras,009,45235,28,18,0,18,0
2020-06-12,Colusa,011,21464,12,7,0,7,0
2020-06-12,Contra Costa,013,1133247,2192,1827,2,1829,43
2020-06-12,Del Norte,015,27424,47,45,0,45,0
2020-06-12,El Dorado,017,186661,163,110,0,110,0
2020-06-12,Fresno,019,978130,4805,2428,57,2485,47
2020-06-12,Glenn,021,27897,46,21,0,21,0
2020-06-12,Humboldt,023,135768,126,105,0,105,3
2020-06-12,Imperial,025,180216,5785,3543,4,3547,36
2020-06-12,Inyo,027,18085,24,23,0,23,1
2020-06-12,Kern,029,883053,4279,3152,13,3165,54
2020-06-12,Kings,031,150075,2001,987,5,992,6
2020-06-12,Lake,033,64148,39,29,0,29,0
2020-06-12,Lassen,035,31185,15,5,2,7,0
2020-06-12,Los Angeles,037,10098052,79506,70385,20,70405,2814
2020-06-12,Madera,039,155013,463,187,2,189,3
2020-06-12,Marin,041,260295,837,649,2,651,17
2020-06-12,Mariposa,043,17540,18,16,0,16,1
2020-06-12,Mendocino,045,87422,49,33,0,33,0
2020-06-12,Merced,047,269075,665,372,1,373,7
2020-06-12,Modoc,049,8938,1,0,0,0,0
2020-06-12,Mono,051,14174,39,35,0,35,1
2020-06-12,Monterey,053,433212,1207,864,4,868,11
2020-06-12,Napa,055,140530,223,162,0,162,3
2020-06-12,Nevada,057,99092,73,52,1,53,1
2020-06-12,Orange,059,3164182,12041,8440,87,8527,203
2020-06-12,Placer,061,380077,495,333,3,336,9
2020-06-12,Plumas,063,18699,5,4,0,4,0
2020-06-12,Riverside,065,2383286,13569,10616,24,10640,364
2020-06-12,Sacramento,067,1510023,1973,1702,4,1706,60
2020-06-12,San Benito,069,59416,160,96,0,96,2
2020-06-12,San Bernardino,071,2135413,9474,6707,7,6714,223
2020-06-12,San Diego,073,3302833,10621,9132,1,9133,313
2020-06-12,San Francisco,075,870044,3074,2823,1,2824,44
2020-06-12,San Joaquin,077,732212,2188,1406,4,1410,43
2020-06-12,San Luis Obispo,079,281455,474,321,5,326,1
2020-06-12,San Mateo,081,765935,2784,2533,5,2538,75
2020-06-12,Santa Barbara,083,443738,2347,1969,19,1988,14
2020-06-12,Santa Clara,085,1922200,4057,3099,15,3114,149
2020-06-12,Santa Cruz,087,273765,284,251,0,251,2
2020-06-12,Shasta,089,179085,94,48,0,48,5
2020-06-12,Sierra,091,2930,1,1,0,1,0
2020-06-12,Siskiyou,093,43540,25,13,0,13,0
2020-06-12,Solano,095,438530,910,620,4,624,19
2020-06-12,Sonoma,097,501317,863,696,1,697,4
2020-06-12,Stanislaus,099,539301,1689,1092,5,1097,33
2020-06-12,Sutter,101,95872,95,56,0,56,2
2020-06-12,Tehama,103,63373,32,13,2,15,1
2020-06-12,Trinity,105,12862,13,2,3,5,0
2020-06-12,Tulare,107,460477,3634,2552,10,2562,95
2020-06-12,Tuolumne,109,53932,10,7,0,7,0
2020-06-12,Ventura,111,848112,2295,1534,14,1548,35
2020-06-12,Yolo,113,214977,303,243,0,243,24
2020-06-12,Yuba,115,75493,36,27,0,27,1
2020-06-11,Alameda,001,1643700,4780,4073,8,4081,108
2020-06-11,Alpine,003,1148,1,1,0,1,0
2020-06-11,Amador,005,37829,10,10,0,10,0
2020-06-11,Butte,007,227075,106,72,7,79,1
2020-06-11,Calaveras,009,45235,27,16,0,16,0
2020-06-11,Colusa,011,21464,12,7,0,7,0
2020-06-11,Contra Costa,013,1133247,2139,1797,2,1799,43
2020-06-11,Del Norte,015,27424,47,45,0,45,0
2020-06-11,El Dorado,017,186661,155,109,0,109,0
2020-06-11,Fresno,019,978130,4651,2338,57,2395,45
2020-06-11,Glenn,021,27897,42,21,0,21,0
2020-06-11,Humboldt,023,135768,122,113,0,113,3
2020-06-11,Imperial,025,180216,5629,3463,4,3467,36
2020-06-11,Inyo,027,18085,22,23,0,23,1
2020-06-11,Kern,029,883053,4127,3047,11,3058,54
2020-06-11,Kings,031,150075,1968,963,5,968,6
2020-06-11,Lake,033,64148,39,28,0,28,0
2020-06-11,Lassen,035,31185,15,5,2,7,0
2020-06-11,Los Angeles,037,10098052,77840,68807,19,68826,2800
2020-06-11,Madera,039,155013,445,178,2,180,3
2020-06-11,Marin,041,260295,789,637,2,639,17
2020-06-11,Mariposa,043,17540,18,16,0,16,1
2020-06-11,Mendocino,045,87422,40,35,0,35,0
2020-06-11,Merced,047,269075,625,370,1,371,7
2020-06-11,Modoc,049,8938,1,0,0,0,0
2020-06-11,Mono,051,14174,39,35,0,35,1
2020-06-11,Monterey,053,433212,1160,813,4,817,11
2020-06-11,Napa,055,140530,214,162,0,162,3
2020-06-11,Nevada,057,99092,67,50,1,51,1
2020-06-11,Orange,059,3164182,11733,8304,86,8390,188
2020-06-11,Placer,061,380077,476,321,3,324,9
2020-06-11,Plumas,063,18699,5,4,0,4,0
2020-06-11,Riverside,065,2383286,13216,10014,24,10038,361
2020-06-11,Sacramento,067,1510023,1925,1669,4,1673,60
2020-06-11,San Benito,069,59416,154,94,0,94,2
2020-06-11,San Bernardino,071,2135413,9177,6509,7,6516,221
2020-06-11,San Diego,073,3302833,10391,9000,0,9000,308
2020-06-11,San Francisco,075,870044,3045,2766,1,2767,44
2020-06-11,San Joaquin,077,732212,2076,1351,4,1355,43
2020-06-11,San Luis Obispo,079,281455,460,307,5,312,1
2020-06-11,San Mateo,081,765935,2746,2499,5,2504,74
2020-06-11,Santa Barbara,083,443738,2286,1895,19,1914,14
2020-06-11,Santa Clara,085,1922200,3990,3049,15,3064,149
2020-06-11,Santa Cruz,087,273765,280,247,0,247,2
2020-06-11,Shasta,089,179085,87,47,0,47,5
2020-06-11,Sierra,091,2930,1,1,0,1,0
2020-06-11,Siskiyou,093,43540,25,14,0,14,0
2020-06-11,Solano,095,438530,884,616,4,620,19
2020-06-11,Sonoma,097,501317,840,682,1,683,4
2020-06-11,Stanislaus,099,539301,1598,1062,5,1067,30
2020-06-11,Sutter,101,95872,92,56,0,56,2
2020-06-11,Tehama,103,63373,27,10,2,12,1
2020-06-11,Trinity,105,12862,11,2,3,5,0
2020-06-11,Tulare,107,460477,3535,2473,10,2483,95
2020-06-11,Tuolumne,109,53932,10,7,0,7,0
2020-06-11,Ventura,111,848112,2218,1491,13,1504,34
2020-06-11,Yolo,113,214977,295,230,0,230,24
2020-06-11,Yuba,115,75493,36,27,0,27,1
2020-06-10,Alameda,001,1643700,4680,4027,7,4034,107
2020-06-10,Alpine,003,1148,1,1,0,1,0
2020-06-10,Amador,005,37829,10,10,0,10,0
2020-06-10,Butte,007,227075,102,71,7,78,1
2020-06-10,Calaveras,009,45235,27,16,0,16,0
2020-06-10,Colusa,011,21464,11,7,0,7,0
2020-06-10,Contra Costa,013,1133247,2095,1778,2,1780,43
2020-06-10,Del Norte,015,27424,47,45,0,45,0
2020-06-10,El Dorado,017,186661,152,109,0,109,0
2020-06-10,Fresno,019,978130,4474,2324,57,2381,45
2020-06-10,Glenn,021,27897,39,21,0,21,0
2020-06-10,Humboldt,023,135768,118,112,0,112,3
2020-06-10,Imperial,025,180216,5481,3454,4,3458,36
2020-06-10,Inyo,027,18085,22,23,0,23,1
2020-06-10,Kern,029,883053,4002,3000,10,3010,54
2020-06-10,Kings,031,150075,1922,952,4,956,6
2020-06-10,Lake,033,64148,39,28,0,28,0
2020-06-10,Lassen,035,31185,15,5,2,7,0
2020-06-10,Los Angeles,037,10098052,76319,67018,19,67037,2752
2020-06-10,Madera,039,155013,431,176,1,177,3
2020-06-10,Marin,041,260295,757,633,2,635,17
2020-06-10,Mariposa,043,17540,17,16,0,16,1
2020-06-10,Mendocino,045,87422,39,35,0,35,0
2020-06-10,Merced,047,269075,592,370,1,371,7
2020-06-10,Modoc,049,8938,1,0,0,0,0
2020-06-10,Mono,051,14174,39,35,0,35,1
2020-06-10,Monterey,053,433212,1106,791,4,795,11
2020-06-10,Napa,055,140530,211,159,0,159,3
2020-06-10,Nevada,057,99092,65,50,1,51,1
2020-06-10,Orange,059,3164182,11457,8222,83,8305,184
2020-06-10,Placer,061,380077,451,309,3,312,9
2020-06-10,Plumas,063,18699,5,4,0,4,0
2020-06-10,Riverside,065,2383286,12893,9857,24,9881,361
2020-06-10,Sacramento,067,1510023,1886,1643,2,1645,59
2020-06-10,San Benito,069,59416,145,94,0,94,2
2020-06-10,San Bernardino,071,2135413,8884,6438,7,6445,219
2020-06-10,San Diego,073,3302833,10227,8839,0,8839,305
2020-06-10,San Francisco,075,870044,3020,2774,1,2775,44
2020-06-10,San Joaquin,077,732212,1947,1282,4,1286,41
2020-06-10,San Luis Obispo,079,281455,440,306,5,311,1
2020-06-10,San Mateo,081,765935,2706,2492,5,2497,74
2020-06-10,Santa Barbara,083,443738,2230,1878,19,1897,13
2020-06-10,Santa Clara,085,1922200,3939,3032,15,3047,149
2020-06-10,Santa Cruz,087,273765,276,242,0,242,2
2020-06-10,Shasta,089,179085,82,45,0,45,5
2020-06-10,Sierra,091,2930,1,1,0,1,0
2020-06-10,Siskiyou,093,43540,25,14,0,14,0
2020-06-10,Solano,095,438530,848,608,4,612,19
2020-06-10,Sonoma,097,501317,822,673,1,674,4
2020-06-10,Stanislaus,099,539301,1508,1030,5,1035,29
2020-06-10,Sutter,101,95872,91,56,0,56,2
2020-06-10,Tehama,103,63373,25,10,2,12,1
2020-06-10,Trinity,105,12862,11,2,3,5,0
2020-06-10,Tulare,107,460477,3442,2455,10,2465,95
2020-06-10,Tuolumne,109,53932,10,7,0,7,0
2020-06-10,Ventura,111,848112,2172,1446,12,1458,34
2020-06-10,Yolo,113,214977,287,226,0,226,24
2020-06-10,Yuba,115,75493,35,27,0,27,1
2020-06-09,Alameda,001,1643700,4570,3963,7,3970,103
2020-06-09,Alpine,003,1148,1,1,0,1,0
2020-06-09,Amador,005,37829,10,10,0,10,0
2020-06-09,Butte,007,227075,101,70,6,76,1
2020-06-09,Calaveras,009,45235,27,16,0,16,0
2020-06-09,Colusa,011,21464,10,7,0,7,0
2020-06-09,Contra Costa,013,1133247,2054,1744,2,1746,42
2020-06-09,Del Norte,015,27424,47,45,0,45,0
2020-06-09,El Dorado,017,186661,142,108,0,108,0
2020-06-09,Fresno,019,978130,4322,2278,57,2335,43
2020-06-09,Glenn,021,27897,38,19,0,19,0
2020-06-09,Humboldt,023,135768,116,113,0,113,2
2020-06-09,Imperial,025,180216,5329,3067,4,3071,36
2020-06-09,Inyo,027,18085,22,22,0,22,1
2020-06-09,Kern,029,883053,3874,2920,10,2930,51
2020-06-09,Kings,031,150075,1890,934,4,938,6
2020-06-09,Lake,033,64148,39,28,0,28,0
2020-06-09,Lassen,035,31185,15,5,2,7,0
2020-06-09,Los Angeles,037,10098052,74661,65827,19,65846,2692
2020-06-09,Madera,039,155013,416,172,1,173,3
2020-06-09,Marin,041,260295,721,616,2,618,17
2020-06-09,Mariposa,043,17540,17,16,0,16,1
2020-06-09,Mendocino,045,87422,35,35,0,35,0
2020-06-09,Merced,047,269075,563,349,1,350,7
2020-06-09,Modoc,049,8938,1,0,0,0,0
2020-06-09,Mono,051,14174,39,35,0,35,1
2020-06-09,Monterey,053,433212,1065,772,4,776,11
2020-06-09,Napa,055,140530,201,156,0,156,3
2020-06-09,Nevada,057,99092,57,50,1,51,1
2020-06-09,Orange,059,3164182,11216,7991,81,8072,174
2020-06-09,Placer,061,380077,438,301,3,304,9
2020-06-09,Plumas,063,18699,5,4,0,4,0
2020-06-09,Riverside,065,2383286,12515,9511,24,9535,354
2020-06-09,Sacramento,067,1510023,1832,1625,2,1627,59
2020-06-09,San Benito,069,59416,139,95,0,95,2
2020-06-09,San Bernardino,071,2135413,8560,6268,6,6274,217
2020-06-09,San Diego,073,3302833,10042,8731,0,8731,301
2020-06-09,San Francisco,075,870044,2995,2749,1,2750,44
2020-06-09,San Joaquin,077,732212,1841,1240,4,1244,41
2020-06-09,San Luis Obispo,079,281455,427,301,4,305,1
2020-06-09,San Mateo,081,765935,2675,2463,5,2468,74
2020-06-09,Santa Barbara,083,443738,2174,1854,19,1873,13
2020-06-09,Santa Clara,085,1922200,3871,3006,14,3020,147
2020-06-09,Santa Cruz,087,273765,270,237,0,237,2
2020-06-09,Shasta,089,179085,78,44,0,44,4
2020-06-09,Sierra,091,2930,1,1,0,1,0
2020-06-09,Siskiyou,093,43540,20,10,0,10,0
2020-06-09,Solano,095,438530,813,596,4,600,18
2020-06-09,Sonoma,097,501317,799,661,1,662,4
2020-06-09,Stanislaus,099,539301,1407,993,5,998,25
2020-06-09,Sutter,101,95872,88,56,0,56,2
2020-06-09,Tehama,103,63373,25,9,2,11,1
2020-06-09,Trinity,105,12862,10,2,3,5,0
2020-06-09,Tulare,107,460477,3376,2393,10,2403,91
2020-06-09,Tuolumne,109,53932,10,8,0,8,0
2020-06-09,Ventura,111,848112,2106,1407,12,1419,34
2020-06-09,Yolo,113,214977,276,226,0,226,24
2020-06-09,Yuba,115,75493,34,27,0,27,1
2020-06-08,Alameda,001,1643700,4489,3937,7,3944,103
2020-06-08,Alpine,003,1148,1,1,0,1,0
2020-06-08,Amador,005,37829,10,10,0,10,0
2020-06-08,Butte,007,227075,97,68,6,74,1
2020-06-08,Calaveras,009,45235,27,16,0,16,0
2020-06-08,Colusa,011,21464,9,7,0,7,0
2020-06-08,Contra Costa,013,1133247,2011,1714,2,1716,41
2020-06-08,Del Norte,015,27424,47,45,0,45,0
2020-06-08,El Dorado,017,186661,138,107,0,107,0
2020-06-08,Fresno,019,978130,4198,2194,56,2250,42
2020-06-08,Glenn,021,27897,36,17,0,17,0
2020-06-08,Humboldt,023,135768,116,112,0,112,2
2020-06-08,Imperial,025,180216,5177,3051,4,3055,21
2020-06-08,Inyo,027,18085,22,22,0,22,1
2020-06-08,Kern,029,883053,3743,2853,9,2862,49
2020-06-08,Kings,031,150075,1814,892,4,896,6
2020-06-08,Lake,033,64148,39,28,0,28,0
2020-06-08,Lassen,035,31185,15,4,2,6,0
2020-06-08,Los Angeles,037,10098052,73199,64634,19,64653,2640
2020-06-08,Madera,039,155013,386,154,1,155,3
2020-06-08,Marin,041,260295,680,596,2,598,17
2020-06-08,Mariposa,043,17540,16,16,0,16,1
2020-06-08,Mendocino,045,87422,33,32,0,32,0
2020-06-08,Merced,047,269075,529,331,1,332,7
2020-06-08,Modoc,049,8938,1,0,0,0,0
2020-06-08,Mono,051,14174,39,35,0,35,1
2020-06-08,Monterey,053,433212,1014,751,3,754,10
2020-06-08,Napa,055,140530,185,151,0,151,3
2020-06-08,Nevada,057,99092,56,50,1,51,1
2020-06-08,Orange,059,3164182,10965,7786,79,7865,160
2020-06-08,Placer,061,380077,421,290,3,293,9
2020-06-08,Plumas,063,18699,5,4,0,4,0
2020-06-08,Riverside,065,2383286,12146,9246,24,9270,347
2020-06-08,Sacramento,067,1510023,1782,1591,2,1593,59
2020-06-08,San Benito,069,59416,132,93,0,93,2
2020-06-08,San Bernardino,071,2135413,8241,6122,6,6128,214
2020-06-08,San Diego,073,3302833,9885,8621,0,8621,296
2020-06-08,San Francisco,075,870044,2968,2715,1,2716,43
2020-06-08,San Joaquin,077,732212,1734,1198,4,1202,40
2020-06-08,San Luis Obispo,079,281455,421,300,4,304,1
2020-06-08,San Mateo,081,765935,2644,2431,4,2435,74
2020-06-08,Santa Barbara,083,443738,2119,1824,17,1841,13
2020-06-08,Santa Clara,085,1922200,3825,2971,14,2985,146
2020-06-08,Santa Cruz,087,273765,269,234,0,234,2
2020-06-08,Shasta,089,179085,74,43,0,43,4
2020-06-08,Sierra,091,2930,1,1,0,1,0
2020-06-08,Siskiyou,093,43540,20,8,0,8,0
2020-06-08,Solano,095,438530,786,560,4,564,19
2020-06-08,Sonoma,097,501317,783,654,1,655,4
2020-06-08,Stanislaus,099,539301,1325,956,5,961,28
2020-06-08,Sutter,101,95872,81,55,0,55,2
2020-06-08,Tehama,103,63373,19,8,2,10,1
2020-06-08,Trinity,105,12862,10,2,3,5,0
2020-06-08,Tulare,107,460477,3293,2301,10,2311,91
2020-06-08,Tuolumne,109,53932,9,8,0,8,0
2020-06-08,Ventura,111,848112,2048,1382,12,1394,30
2020-06-08,Yolo,113,214977,265,228,0,228,24
2020-06-08,Yuba,115,75493,32,27,0,27,1
2020-06-07,Alameda,001,1643700,4376,3866,7,3873,102
2020-06-07,Alpine,003,1148,1,1,0,1,0
2020-06-07,Amador,005,37829,10,10,0,10,0
2020-06-07,Butte,007,227075,95,64,5,69,1
2020-06-07,Calaveras,009,45235,25,16,0,16,0
2020-06-07,Colusa,011,21464,9,7,0,7,0
2020-06-07,Contra Costa,013,1133247,1960,1653,1,1654,38
2020-06-07,Del Norte,015,27424,45,45,0,45,0
2020-06-07,El Dorado,017,186661,138,104,0,104,0
2020-06-07,Fresno,019,978130,4068,2144,56,2200,41
2020-06-07,Glenn,021,27897,29,16,0,16,0
2020-06-07,Humboldt,023,135768,116,112,0,112,2
2020-06-07,Imperial,025,180216,5026,3048,4,3052,19
2020-06-07,Inyo,027,18085,22,21,0,21,1
2020-06-07,Kern,029,883053,3612,2771,9,2780,46
2020-06-07,Kings,031,150075,1765,882,4,886,6
2020-06-07,Lake,033,64148,36,28,0,28,0
2020-06-07,Lassen,035,31185,14,4,2,6,0
2020-06-07,Los Angeles,037,10098052,71496,63750,19,63769,2629
2020-06-07,Madera,039,155013,369,149,1,150,3
2020-06-07,Marin,041,260295,666,584,2,586,17
2020-06-07,Mariposa,043,17540,16,16,0,16,1
2020-06-07,Mendocino,045,87422,33,32,0,32,0
2020-06-07,Merced,047,269075,496,318,1,319,7
2020-06-07,Modoc,049,8938,1,0,0,0,0
2020-06-07,Mono,051,14174,39,35,0,35,1
2020-06-07,Monterey,053,433212,968,732,3,735,10
2020-06-07,Napa,055,140530,177,142,0,142,3
2020-06-07,Nevada,057,99092,55,50,1,51,1
2020-06-07,Orange,059,3164182,10708,7643,77,7720,158
2020-06-07,Placer,061,380077,400,273,2,275,9
2020-06-07,Plumas,063,18699,5,4,0,4,0
2020-06-07,Riverside,065,2383286,11850,9105,24,9129,344
2020-06-07,Sacramento,067,1510023,1734,1568,2,1570,59
2020-06-07,San Benito,069,59416,129,92,0,92,2
2020-06-07,San Bernardino,071,2135413,7955,6033,6,6039,214
2020-06-07,San Diego,073,3302833,9706,8478,0,8478,296
2020-06-07,San Francisco,075,870044,2924,2674,0,2674,43
2020-06-07,San Joaquin,077,732212,1633,1126,4,1130,37
2020-06-07,San Luis Obispo,079,281455,411,296,4,300,1
2020-06-07,San Mateo,081,765935,2617,2399,4,2403,73
2020-06-07,Santa Barbara,083,443738,2064,1818,17,1835,13
2020-06-07,Santa Clara,085,1922200,3773,2947,14,2961,146
2020-06-07,Santa Cruz,087,273765,261,230,0,230,2
2020-06-07,Shasta,089,179085,73,41,0,41,4
2020-06-07,Sierra,091,2930,1,1,0,1,0
2020-06-07,Siskiyou,093,43540,20,8,0,8,0
2020-06-07,Solano,095,438530,763,560,4,564,19
2020-06-07,Sonoma,097,501317,752,639,1,640,4
2020-06-07,Stanislaus,099,539301,1245,905,5,910,28
2020-06-07,Sutter,101,95872,73,55,0,55,2
2020-06-07,Tehama,103,63373,16,8,2,10,1
2020-06-07,Trinity,105,12862,8,2,3,5,0
2020-06-07,Tulare,107,460477,3171,2219,10,2229,90
2020-06-07,Tuolumne,109,53932,9,4,0,4,0
2020-06-07,Ventura,111,848112,1982,1337,12,1349,30
2020-06-07,Yolo,113,214977,255,224,0,224,24
2020-06-07,Yuba,115,75493,32,27,0,27,1
2020-06-06,Alameda,001,1643700,4331,3801,7,3808,102
2020-06-06,Alpine,003,1148,1,1,0,1,0
2020-06-06,Amador,005,37829,10,10,0,10,0
2020-06-06,Butte,007,227075,94,63,5,68,1
2020-06-06,Calaveras,009,45235,23,16,0,16,0
2020-06-06,Colusa,011,21464,9,7,0,7,0
2020-06-06,Contra Costa,013,1133247,1939,1619,1,1620,37
2020-06-06,Del Norte,015,27424,45,45,0,45,0
2020-06-06,El Dorado,017,186661,133,104,0,104,0
2020-06-06,Fresno,019,978130,4013,2117,56,2173,41
2020-06-06,Glenn,021,27897,27,16,0,16,0
2020-06-06,Humboldt,023,135768,116,112,0,112,2
2020-06-06,Imperial,025,180216,4950,3047,4,3051,19
2020-06-06,Inyo,027,18085,22,21,0,21,1
2020-06-06,Kern,029,883053,3541,2695,9,2704,46
2020-06-06,Kings,031,150075,1746,882,4,886,6
2020-06-06,Lake,033,64148,36,28,0,28,0
2020-06-06,Lassen,035,31185,14,4,2,6,0
2020-06-06,Los Angeles,037,10098052,70749,62269,19,62288,2607
2020-06-06,Madera,039,155013,360,149,1,150,3
2020-06-06,Marin,041,260295,661,556,2,558,17
2020-06-06,Mariposa,043,17540,16,16,0,16,1
2020-06-06,Mendocino,045,87422,33,32,0,32,0
2020-06-06,Merced,047,269075,494,315,1,316,7
2020-06-06,Modoc,049,8938,1,0,0,0,0
2020-06-06,Mono,051,14174,39,35,0,35,1
2020-06-06,Monterey,053,433212,944,679,3,682,10
2020-06-06,Napa,055,140530,171,136,0,136,3
2020-06-06,Nevada,057,99092,54,50,1,51,1
2020-06-06,Orange,059,3164182,10549,7576,76,7652,157
2020-06-06,Placer,061,380077,388,270,2,272,9
2020-06-06,Plumas,063,18699,5,4,0,4,0
2020-06-06,Riverside,065,2383286,11672,8935,24,8959,345
2020-06-06,Sacramento,067,1510023,1711,1533,2,1535,59
2020-06-06,San Benito,069,59416,119,92,0,92,2
2020-06-06,San Bernardino,071,2135413,7807,5946,6,5952,214
2020-06-06,San Diego,073,3302833,9585,8347,0,8347,296
2020-06-06,San Francisco,075,870044,2909,2674,0,2674,43
2020-06-06,San Joaquin,077,732212,1593,1076,4,1080,37
2020-06-06,San Luis Obispo,079,281455,405,295,4,299,1
2020-06-06,San Mateo,081,765935,2602,2342,4,2346,72
2020-06-06,Santa Barbara,083,443738,2025,1815,17,1832,13
2020-06-06,Santa Clara,085,1922200,3732,2934,14,2948,144
2020-06-06,Santa Cruz,087,273765,259,226,0,226,2
2020-06-06,Shasta,089,179085,73,40,0,40,4
2020-06-06,Sierra,091,2930,1,1,0,1,0
2020-06-06,Siskiyou,093,43540,18,8,0,8,0
2020-06-06,Solano,095,438530,748,560,4,564,19
2020-06-06,Sonoma,097,501317,740,622,1,623,4
2020-06-06,Stanislaus,099,539301,1211,858,5,863,27
2020-06-06,Sutter,101,95872,73,51,0,51,2
2020-06-06,Tehama,103,63373,15,8,2,10,1
2020-06-06,Trinity,105,12862,8,2,2,4,0
2020-06-06,Tulare,107,460477,3138,2213,10,2223,90
2020-06-06,Tuolumne,109,53932,9,4,0,4,0
2020-06-06,Ventura,111,848112,1958,1303,12,1315,30
2020-06-06,Yolo,113,214977,253,223,0,223,24
2020-06-06,Yuba,115,75493,32,27,0,27,1
2020-06-05,Alameda,001,1643700,4280,3734,7,3741,102
2020-06-05,Alpine,003,1148,1,1,0,1,0
2020-06-05,Amador,005,37829,10,10,0,10,0
2020-06-05,Butte,007,227075,91,61,5,66,1
2020-06-05,Calaveras,009,45235,22,16,0,16,0
2020-06-05,Colusa,011,21464,9,7,0,7,0
2020-06-05,Contra Costa,013,1133247,1924,1575,1,1576,37
2020-06-05,Del Norte,015,27424,45,45,0,45,0
2020-06-05,El Dorado,017,186661,131,101,0,101,0
2020-06-05,Fresno,019,978130,3949,2051,55,2106,38
2020-06-05,Glenn,021,27897,25,16,0,16,0
2020-06-05,Humboldt,023,135768,115,111,0,111,2
2020-06-05,Imperial,025,180216,4844,2778,4,2782,19
2020-06-05,Inyo,027,18085,22,21,0,21,1
2020-06-05,Kern,029,883053,3452,2624,9,2633,46
2020-06-05,Kings,031,150075,1731,865,4,869,6
2020-06-05,Lake,033,64148,35,28,0,28,0
2020-06-05,Lassen,035,31185,13,4,2,6,0
2020-06-05,Los Angeles,037,10098052,69602,60955,19,60974,2553
2020-06-05,Madera,039,155013,338,144,1,145,3
2020-06-05,Marin,041,260295,652,546,2,548,17
2020-06-05,Mariposa,043,17540,16,16,0,16,1
2020-06-05,Mendocino,045,87422,33,32,0,32,0
2020-06-05,Merced,047,269075,492,309,1,310,7
2020-06-05,Modoc,049,8938,1,0,0,0,0
2020-06-05,Mono,051,14174,39,35,0,35,1
2020-06-05,Monterey,053,433212,912,649,3,652,10
2020-06-05,Napa,055,140530,168,123,0,123,3
2020-06-05,Nevada,057,99092,54,50,1,51,1
2020-06-05,Orange,059,3164182,10353,7391,73,7464,153
2020-06-05,Placer,061,380077,378,265,2,267,9
2020-06-05,Plumas,063,18699,5,4,0,4,0
2020-06-05,Riverside,065,2383286,11413,8700,24,8724,345
2020-06-05,Sacramento,067,1510023,1689,1514,2,1516,59
2020-06-05,San Benito,069,59416,117,92,0,92,2
2020-06-05,San Bernardino,071,2135413,7625,5869,5,5874,212
2020-06-05,San Diego,073,3302833,9470,8182,0,8182,294
2020-06-05,San Francisco,075,870044,2891,2675,0,2675,43
2020-06-05,San Joaquin,077,732212,1514,1046,4,1050,36
2020-06-05,San Luis Obispo,079,281455,398,293,4,297,1
2020-06-05,San Mateo,081,765935,2577,2331,4,2335,72
2020-06-05,Santa Barbara,083,443738,1994,1795,17,1812,13
2020-06-05,Santa Clara,085,1922200,3697,2902,14,2916,144
2020-06-05,Santa Cruz,087,273765,256,222,0,222,2
2020-06-05,Shasta,089,179085,72,40,0,40,4
2020-06-05,Sierra,091,2930,1,1,0,1,0
2020-06-05,Siskiyou,093,43540,16,8,0,8,0
2020-06-05,Solano,095,438530,741,558,4,562,19
2020-06-05,Sonoma,097,501317,719,618,1,619,4
2020-06-05,Stanislaus,099,539301,1178,842,5,847,27
2020-06-05,Sutter,101,95872,73,49,0,49,2
2020-06-05,Tehama,103,63373,15,7,2,9,1
2020-06-05,Trinity,105,12862,8,1,2,3,0
2020-06-05,Tulare,107,460477,3089,2180,10,2190,90
2020-06-05,Tuolumne,109,53932,9,4,0,4,0
2020-06-05,Ventura,111,848112,1925,1274,12,1286,30
2020-06-05,Yolo,113,214977,252,216,0,216,24
2020-06-05,Yuba,115,75493,32,27,0,27,1
2020-06-04,Alameda,001,1643700,4181,3643,7,3650,99
2020-06-04,Alpine,003,1148,1,1,0,1,0
2020-06-04,Amador,005,37829,10,10,0,10,0
2020-06-04,Butte,007,227075,87,57,4,61,1
2020-06-04,Calaveras,009,45235,22,15,0,15,0
2020-06-04,Colusa,011,21464,9,7,0,7,0
2020-06-04,Contra Costa,013,1133247,1866,1551,1,1552,37
2020-06-04,Del Norte,015,27424,45,45,0,45,0
2020-06-04,El Dorado,017,186661,129,101,0,101,0
2020-06-04,Fresno,019,978130,3843,2007,54,2061,35
2020-06-04,Glenn,021,27897,22,16,0,16,0
2020-06-04,Humboldt,023,135768,115,109,0,109,2
2020-06-04,Imperial,025,180216,4662,2631,4,2635,19
2020-06-04,Inyo,027,18085,22,20,0,20,1
2020-06-04,Kern,029,883053,3336,2530,9,2539,46
2020-06-04,Kings,031,150075,1661,842,4,846,6
2020-06-04,Lake,033,64148,34,27,0,27,0
2020-06-04,Lassen,035,31185,11,4,2,6,0
2020-06-04,Los Angeles,037,10098052,68136,59596,19,59615,2515
2020-06-04,Madera,039,155013,330,127,1,128,3
2020-06-04,Marin,041,260295,630,533,2,535,14
2020-06-04,Mariposa,043,17540,16,16,0,16,1
2020-06-04,Mendocino,045,87422,33,29,0,29,0
2020-06-04,Merced,047,269075,472,304,1,305,7
2020-06-04,Modoc,049,8938,1,0,0,0,0
2020-06-04,Mono,051,14174,39,35,0,35,1
2020-06-04,Monterey,053,433212,877,621,2,623,10
2020-06-04,Napa,055,140530,164,117,0,117,3
2020-06-04,Nevada,057,99092,53,49,1,50,1
2020-06-04,Orange,059,3164182,10099,7192,72,7264,148
2020-06-04,Placer,061,380077,362,256,2,258,9
2020-06-04,Plumas,063,18699,4,4,0,4,0
2020-06-04,Riverside,065,2383286,11135,8473,24,8497,341
2020-06-04,Sacramento,067,1510023,1662,1492,2,1494,58
2020-06-04,San Benito,069,59416,115,88,0,88,2
2020-06-04,San Bernardino,071,2135413,7357,5726,5,5731,207
2020-06-04,San Diego,073,3302833,9307,7942,0,7942,288
2020-06-04,San Francisco,075,870044,2858,2636,0,2636,43
2020-06-04,San Joaquin,077,732212,1452,1016,4,1020,36
2020-06-04,San Luis Obispo,079,281455,387,288,4,292,1
2020-06-04,San Mateo,081,765935,2550,2284,4,2288,72
2020-06-04,Santa Barbara,083,443738,1963,1750,16,1766,13
2020-06-04,Santa Clara,085,1922200,3663,2871,14,2885,144
2020-06-04,Santa Cruz,087,273765,250,218,0,218,2
2020-06-04,Shasta,089,179085,66,40,0,40,4
2020-06-04,Sierra,091,2930,1,1,0,1,0
2020-06-04,Siskiyou,093,43540,15,8,0,8,0
2020-06-04,Solano,095,438530,724,551,4,555,19
2020-06-04,Sonoma,097,501317,700,591,1,592,4
2020-06-04,Stanislaus,099,539301,1102,806,5,811,28
2020-06-04,Sutter,101,95872,68,46,0,46,2
2020-06-04,Tehama,103,63373,14,6,1,7,1
2020-06-04,Trinity,105,12862,8,1,2,3,0
2020-06-04,Tulare,107,460477,2972,2086,10,2096,90
2020-06-04,Tuolumne,109,53932,8,4,0,4,0
2020-06-04,Ventura,111,848112,1881,1236,11,1247,30
2020-06-04,Yolo,113,214977,247,216,0,216,24
2020-06-04,Yuba,115,75493,31,27,0,27,1
2020-06-03,Alameda,001,1643700,4122,3589,6,3595,99
2020-06-03,Alpine,003,1148,1,1,0,1,0
2020-06-03,Amador,005,37829,10,10,0,10,0
2020-06-03,Butte,007,227075,85,53,4,57,1
2020-06-03,Calaveras,009,45235,21,15,0,15,0
2020-06-03,Colusa,011,21464,9,7,0,7,0
2020-06-03,Contra Costa,013,1133247,1818,1511,1,1512,37
2020-06-03,Del Norte,015,27424,45,39,0,39,0
2020-06-03,El Dorado,017,186661,126,90,0,90,0
2020-06-03,Fresno,019,978130,3744,1943,54,1997,35
2020-06-03,Glenn,021,27897,22,16,0,16,0
2020-06-03,Humboldt,023,135768,115,103,0,103,2
2020-06-03,Imperial,025,180216,4489,2540,4,2544,19
2020-06-03,Inyo,027,18085,22,20,0,20,1
2020-06-03,Kern,029,883053,3240,2452,8,2460,44
2020-06-03,Kings,031,150075,1596,744,4,748,6
2020-06-03,Lake,033,64148,32,26,0,26,0
2020-06-03,Lassen,035,31185,11,4,2,6,0
2020-06-03,Los Angeles,037,10098052,66527,58166,19,58185,2472
2020-06-03,Madera,039,155013,322,117,1,118,3
2020-06-03,Marin,041,260295,612,527,2,529,14
2020-06-03,Mariposa,043,17540,16,16,0,16,1
2020-06-03,Mendocino,045,87422,32,29,0,29,0
2020-06-03,Merced,047,269075,458,299,1,300,7
2020-06-03,Modoc,049,8938,1,0,0,0,0
2020-06-03,Mono,051,14174,39,35,0,35,1
2020-06-03,Monterey,053,433212,849,592,2,594,10
2020-06-03,Napa,055,140530,163,116,0,116,3
2020-06-03,Nevada,057,99092,52,43,1,44,1
2020-06-03,Orange,059,3164182,9873,6939,71,7010,145
2020-06-03,Placer,061,380077,342,243,2,245,9
2020-06-03,Plumas,063,18699,4,4,0,4,0
2020-06-03,Riverside,065,2383286,10860,8208,24,8232,335
2020-06-03,Sacramento,067,1510023,1632,1457,2,1459,58
2020-06-03,San Benito,069,59416,109,88,0,88,2
2020-06-03,San Bernardino,071,2135413,7134,5565,5,5570,203
2020-06-03,San Diego,073,3302833,9159,7800,0,7800,283
2020-06-03,San Francisco,075,870044,2827,2608,0,2608,43
2020-06-03,San Joaquin,077,732212,1388,1004,4,1008,35
2020-06-03,San Luis Obispo,079,281455,382,279,4,283,1
2020-06-03,San Mateo,081,765935,2522,2243,4,2247,71
2020-06-03,Santa Barbara,083,443738,1929,1722,15,1737,12
2020-06-03,Santa Clara,085,1922200,3621,2836,14,2850,144
2020-06-03,Santa Cruz,087,273765,244,217,0,217,2
2020-06-03,Shasta,089,179085,63,40,0,40,4
2020-06-03,Sierra,091,2930,1,1,0,1,0
2020-06-03,Siskiyou,093,43540,14,8,0,8,0
2020-06-03,Solano,095,438530,699,543,2,545,18
2020-06-03,Sonoma,097,501317,688,578,1,579,4
2020-06-03,Stanislaus,099,539301,1062,780,5,785,27
2020-06-03,Sutter,101,95872,60,45,0,45,2
2020-06-03,Tehama,103,63373,14,6,1,7,1
2020-06-03,Trinity,105,12862,8,1,2,3,0
2020-06-03,Tulare,107,460477,2903,2041,10,2051,88
2020-06-03,Tuolumne,109,53932,6,4,0,4,0
2020-06-03,Ventura,111,848112,1814,1202,11,1213,30
2020-06-03,Yolo,113,214977,243,213,0,213,24
2020-06-03,Yuba,115,75493,31,27,0,27,1
2020-06-02,Alameda,001,1643700,4046,3517,6,3523,99
2020-06-02,Alpine,003,1148,1,1,0,1,0
2020-06-02,Amador,005,37829,10,10,0,10,0
2020-06-02,Butte,007,227075,81,51,3,54,1
2020-06-02,Calaveras,009,45235,21,15,0,15,0
2020-06-02,Colusa,011,21464,9,7,0,7,0
2020-06-02,Contra Costa,013,1133247,1786,1505,1,1506,37
2020-06-02,Del Norte,015,27424,45,39,0,39,0
2020-06-02,El Dorado,017,186661,125,88,0,88,0
2020-06-02,Fresno,019,978130,3631,1917,54,1971,34
2020-06-02,Glenn,021,27897,21,16,0,16,0
2020-06-02,Humboldt,023,135768,115,101,0,101,2
2020-06-02,Imperial,025,180216,4296,2459,4,2463,19
2020-06-02,Inyo,027,18085,20,20,0,20,1
2020-06-02,Kern,029,883053,3141,2406,6,2412,41
2020-06-02,Kings,031,150075,1568,720,4,724,5
2020-06-02,Lake,033,64148,32,25,0,25,0
2020-06-02,Lassen,035,31185,10,4,2,6,0
2020-06-02,Los Angeles,037,10098052,65125,57144,19,57163,2430
2020-06-02,Madera,039,155013,301,110,1,111,2
2020-06-02,Marin,041,260295,585,509,2,511,14
2020-06-02,Mariposa,043,17540,16,16,0,16,1
2020-06-02,Mendocino,045,87422,32,29,0,29,0
2020-06-02,Merced,047,269075,442,297,1,298,6
2020-06-02,Modoc,049,8938,1,0,0,0,0
2020-06-02,Mono,051,14174,39,35,0,35,1
2020-06-02,Monterey,053,433212,819,582,2,584,10
2020-06-02,Napa,055,140530,154,116,0,116,3
2020-06-02,Nevada,057,99092,51,41,1,42,1
2020-06-02,Orange,059,3164182,9672,6790,70,6860,142
2020-06-02,Placer,061,380077,328,226,2,228,9
2020-06-02,Plumas,063,18699,4,4,0,4,0
2020-06-02,Riverside,065,2383286,10564,8091,22,8113,330
2020-06-02,Sacramento,067,1510023,1603,1428,2,1430,58
2020-06-02,San Benito,069,59416,108,86,0,86,2
2020-06-02,San Bernardino,071,2135413,6927,5438,5,5443,202
2020-06-02,San Diego,073,3302833,9013,7676,0,7676,276
2020-06-02,San Francisco,075,870044,2792,2554,0,2554,43
2020-06-02,San Joaquin,077,732212,1322,985,4,989,35
2020-06-02,San Luis Obispo,079,281455,377,275,4,279,1
2020-06-02,San Mateo,081,765935,2487,2203,4,2207,71
2020-06-02,Santa Barbara,083,443738,1889,1703,15,1718,12
2020-06-02,Santa Clara,085,1922200,3571,2819,14,2833,144
2020-06-02,Santa Cruz,087,273765,239,215,0,215,2
2020-06-02,Shasta,089,179085,62,38,0,38,4
2020-06-02,Sierra,091,2930,1,1,0,1,0
2020-06-02,Siskiyou,093,43540,13,8,0,8,0
2020-06-02,Solano,095,438530,684,537,1,538,18
2020-06-02,Sonoma,097,501317,677,571,1,572,4
2020-06-02,Stanislaus,099,539301,1003,772,5,777,27
2020-06-02,Sutter,101,95872,57,43,0,43,2
2020-06-02,Tehama,103,63373,14,6,1,7,1
2020-06-02,Trinity,105,12862,8,1,2,3,0
2020-06-02,Tulare,107,460477,2823,2012,10,2022,86
2020-06-02,Tuolumne,109,53932,6,4,0,4,0
2020-06-02,Ventura,111,848112,1761,1178,11,1189,30
2020-06-02,Yolo,113,214977,241,213,0,213,24
2020-06-02,Yuba,115,75493,31,27,0,27,1
2020-06-01,Alameda,001,1643700,3980,3460,6,3466,98
2020-06-01,Alpine,003,1148,1,1,0,1,0
2020-06-01,Amador,005,37829,10,10,0,10,0
2020-06-01,Butte,007,227075,80,50,2,52,1
2020-06-01,Calaveras,009,45235,21,15,0,15,0
2020-06-01,Colusa,011,21464,9,7,0,7,0
2020-06-01,Contra Costa,013,1133247,1750,1486,1,1487,37
2020-06-01,Del Norte,015,27424,45,38,0,38,0
2020-06-01,El Dorado,017,186661,123,88,0,88,0
2020-06-01,Fresno,019,978130,3536,1854,52,1906,33
2020-06-01,Glenn,021,27897,21,16,0,16,0
2020-06-01,Humboldt,023,135768,115,98,0,98,2
2020-06-01,Imperial,025,180216,4074,2366,4,2370,14
2020-06-01,Inyo,027,18085,20,20,0,20,1
2020-06-01,Kern,029,883053,3058,2366,6,2372,38
2020-06-01,Kings,031,150075,1300,703,4,707,4
2020-06-01,Lake,033,64148,32,22,0,22,0
2020-06-01,Lassen,035,31185,10,4,2,6,0
2020-06-01,Los Angeles,037,10098052,63662,55899,19,55918,2367
2020-06-01,Madera,039,155013,289,103,1,104,2
2020-06-01,Marin,041,260295,544,495,2,497,14
2020-06-01,Mariposa,043,17540,16,16,0,16,1
2020-06-01,Mendocino,045,87422,32,28,0,28,0
2020-06-01,Merced,047,269075,423,289,1,290,6
2020-06-01,Modoc,049,8938,1,0,0,0,0
2020-06-01,Mono,051,14174,39,35,0,35,1
2020-06-01,Monterey,053,433212,795,554,2,556,10
2020-06-01,Napa,055,140530,151,114,0,114,3
2020-06-01,Nevada,057,99092,51,41,1,42,1
2020-06-01,Orange,059,3164182,9475,6640,69,6709,135
2020-06-01,Placer,061,380077,316,218,2,220,9
2020-06-01,Plumas,063,18699,4,4,0,4,0
2020-06-01,Riverside,065,2383286,10112,7921,21,7942,322
2020-06-01,Sacramento,067,1510023,1564,1415,2,1417,58
2020-06-01,San Benito,069,59416,105,86,0,86,2
2020-06-01,San Bernardino,071,2135413,6721,5310,5,5315,202
2020-06-01,San Diego,073,3302833,8833,7556,0,7556,269
2020-06-01,San Francisco,075,870044,2755,2546,0,2546,43
2020-06-01,San Joaquin,077,732212,1257,957,4,961,35
2020-06-01,San Luis Obispo,079,281455,373,275,4,279,1
2020-06-01,San Mateo,081,765935,2457,2190,4,2194,71
2020-06-01,Santa Barbara,083,443738,1855,1671,14,1685,10
2020-06-01,Santa Clara,085,1922200,3533,2797,13,2810,142
2020-06-01,Santa Cruz,087,273765,235,215,0,215,2
2020-06-01,Shasta,089,179085,62,38,0,38,4
2020-06-01,Sierra,091,2930,1,1,0,1,0
2020-06-01,Siskiyou,093,43540,13,7,0,7,0
2020-06-01,Solano,095,438530,660,529,1,530,17
2020-06-01,Sonoma,097,501317,661,565,1,566,4
2020-06-01,Stanislaus,099,539301,966,758,5,763,27
2020-06-01,Sutter,101,95872,52,43,0,43,2
2020-06-01,Tehama,103,63373,11,5,1,6,1
2020-06-01,Trinity,105,12862,7,1,2,3,0
2020-06-01,Tulare,107,460477,2708,1976,10,1986,84
2020-06-01,Tuolumne,109,53932,5,4,0,4,0
2020-06-01,Ventura,111,848112,1708,1163,11,1174,29
2020-06-01,Yolo,113,214977,238,212,0,212,24
2020-06-01,Yuba,115,75493,30,26,0,26,1
2020-05-31,Alameda,001,1643700,3875,3362,6,3368,98
2020-05-31,Alpine,003,1148,1,1,0,1,0
2020-05-31,Amador,005,37829,10,10,0,10,0
2020-05-31,Butte,007,227075,78,51,2,53,0
2020-05-31,Calaveras,009,45235,18,15,0,15,0
2020-05-31,Colusa,011,21464,9,5,0,5,0
2020-05-31,Contra Costa,013,1133247,1716,1458,1,1459,37
2020-05-31,Del Norte,015,27424,45,37,0,37,0
2020-05-31,El Dorado,017,186661,119,88,0,88,0
2020-05-31,Fresno,019,978130,3371,1780,46,1826,31
2020-05-31,Glenn,021,27897,20,16,0,16,0
2020-05-31,Humboldt,023,135768,113,98,0,98,2
2020-05-31,Imperial,025,180216,3807,2197,4,2201,14
2020-05-31,Inyo,027,18085,20,20,0,20,1
2020-05-31,Kern,029,883053,2923,2300,6,2306,38
2020-05-31,Kings,031,150075,1263,703,4,707,3
2020-05-31,Lake,033,64148,32,19,0,19,0
2020-05-31,Lassen,035,31185,10,4,2,6,0
2020-05-31,Los Angeles,037,10098052,62372,54925,19,54944,2344
2020-05-31,Madera,039,155013,271,101,1,102,2
2020-05-31,Marin,041,260295,534,486,2,488,14
2020-05-31,Mariposa,043,17540,16,16,0,16,1
2020-05-31,Mendocino,045,87422,32,24,0,24,0
2020-05-31,Merced,047,269075,396,288,0,288,6
2020-05-31,Modoc,049,8938,0,0,0,0,0
2020-05-31,Mono,051,14174,39,34,0,34,1
2020-05-31,Monterey,053,433212,721,545,2,547,10
2020-05-31,Napa,055,140530,149,114,0,114,3
2020-05-31,Nevada,057,99092,50,41,1,42,1
2020-05-31,Orange,059,3164182,9265,6532,68,6600,135
2020-05-31,Placer,061,380077,294,215,2,217,9
2020-05-31,Plumas,063,18699,4,4,0,4,0
2020-05-31,Riverside,065,2383286,9856,7704,21,7725,321
2020-05-31,Sacramento,067,1510023,1533,1398,2,1400,57
2020-05-31,San Benito,069,59416,99,85,0,85,2
2020-05-31,San Bernardino,071,2135413,6453,5185,5,5190,198
2020-05-31,San Diego,073,3302833,8639,7483,0,7483,269
2020-05-31,San Francisco,075,870044,2719,2501,0,2501,43
2020-05-31,San Joaquin,077,732212,1192,888,4,892,34
2020-05-31,San Luis Obispo,079,281455,363,271,4,275,1
2020-05-31,San Mateo,081,765935,2411,2169,4,2173,71
2020-05-31,Santa Barbara,083,443738,1804,1662,13,1675,9
2020-05-31,Santa Clara,085,1922200,3489,2785,13,2798,142
2020-05-31,Santa Cruz,087,273765,232,210,0,210,2
2020-05-31,Shasta,089,179085,60,38,0,38,4
2020-05-31,Sierra,091,2930,1,1,0,1,0
2020-05-31,Siskiyou,093,43540,12,7,0,7,0
2020-05-31,Solano,095,438530,634,512,1,513,6
2020-05-31,Sonoma,097,501317,641,555,1,556,4
2020-05-31,Stanislaus,099,539301,912,738,5,743,27
2020-05-31,Sutter,101,95872,50,42,0,42,2
2020-05-31,Tehama,103,63373,10,4,1,5,1
2020-05-31,Trinity,105,12862,7,1,2,3,0
2020-05-31,Tulare,107,460477,2635,1884,10,1894,82
2020-05-31,Tuolumne,109,53932,5,4,0,4,0
2020-05-31,Ventura,111,848112,1647,1151,11,1162,30
2020-05-31,Yolo,113,214977,232,211,0,211,24
2020-05-31,Yuba,115,75493,30,26,0,26,1
2020-05-30,Alameda,001,1643700,3849,3304,6,3310,96
2020-05-30,Alpine,003,1148,1,1,0,1,0
2020-05-30,Amador,005,37829,10,10,0,10,0
2020-05-30,Butte,007,227075,77,44,2,46,0
2020-05-30,Calaveras,009,45235,17,15,0,15,0
2020-05-30,Colusa,011,21464,8,5,0,5,0
2020-05-30,Contra Costa,013,1133247,1700,1429,1,1430,37
2020-05-30,Del Norte,015,27424,45,37,0,37,0
2020-05-30,El Dorado,017,186661,118,86,0,86,0
2020-05-30,Fresno,019,978130,3310,1744,45,1789,31
2020-05-30,Glenn,021,27897,19,16,0,16,0
2020-05-30,Humboldt,023,135768,112,98,0,98,2
2020-05-30,Imperial,025,180216,3717,2091,4,2095,14
2020-05-30,Inyo,027,18085,20,20,0,20,1
2020-05-30,Kern,029,883053,2854,2217,6,2223,38
2020-05-30,Kings,031,150075,1249,703,4,707,3
2020-05-30,Lake,033,64148,31,18,0,18,0
2020-05-30,Lassen,035,31185,10,4,2,6,0
2020-05-30,Los Angeles,037,10098052,61836,53627,19,53646,2319
2020-05-30,Madera,039,155013,266,101,1,102,2
2020-05-30,Marin,041,260295,534,462,2,464,14
2020-05-30,Mariposa,043,17540,16,16,0,16,1
2020-05-30,Mendocino,045,87422,32,24,0,24,0
2020-05-30,Merced,047,269075,395,285,0,285,6
2020-05-30,Modoc,049,8938,0,0,0,0,0
2020-05-30,Mono,051,14174,39,34,0,34,1
2020-05-30,Monterey,053,433212,705,520,2,522,10
2020-05-30,Napa,055,140530,147,113,0,113,3
2020-05-30,Nevada,057,99092,50,41,1,42,1
2020-05-30,Orange,059,3164182,9108,6354,68,6422,134
2020-05-30,Placer,061,380077,286,199,1,200,9
2020-05-30,Plumas,063,18699,4,4,0,4,0
2020-05-30,Riverside,065,2383286,9712,7492,21,7513,316
2020-05-30,Sacramento,067,1510023,1522,1384,2,1386,57
2020-05-30,San Benito,069,59416,98,85,0,85,2
2020-05-30,San Bernardino,071,2135413,6344,5122,5,5127,198
2020-05-30,San Diego,073,3302833,8546,7387,0,7387,269
2020-05-30,San Francisco,075,870044,2694,2496,0,2496,41
2020-05-30,San Joaquin,077,732212,1154,888,4,892,34
2020-05-30,San Luis Obispo,079,281455,358,270,4,274,1
2020-05-30,San Mateo,081,765935,2387,2129,4,2133,71
2020-05-30,Santa Barbara,083,443738,1785,1660,13,1673,9
2020-05-30,Santa Clara,085,1922200,3473,2741,13,2754,141
2020-05-30,Santa Cruz,087,273765,232,206,0,206,2
2020-05-30,Shasta,089,179085,60,36,0,36,4
2020-05-30,Sierra,091,2930,1,1,0,1,0
2020-05-30,Siskiyou,093,43540,11,7,0,7,0
2020-05-30,Solano,095,438530,627,512,1,513,6
2020-05-30,Sonoma,097,501317,631,551,1,552,4
2020-05-30,Stanislaus,099,539301,895,712,5,717,27
2020-05-30,Sutter,101,95872,49,40,0,40,2
2020-05-30,Tehama,103,63373,10,4,1,5,1
2020-05-30,Trinity,105,12862,7,1,2,3,0
2020-05-30,Tulare,107,460477,2598,1879,10,1889,81
2020-05-30,Tuolumne,109,53932,5,4,0,4,0
2020-05-30,Ventura,111,848112,1630,1116,11,1127,30
2020-05-30,Yolo,113,214977,228,210,0,210,24
2020-05-30,Yuba,115,75493,30,25,0,25,1
2020-05-29,Alameda,001,1643700,3814,3209,6,3215,96
2020-05-29,Alpine,003,1148,1,1,0,1,0
2020-05-29,Amador,005,37829,10,10,0,10,0
2020-05-29,Butte,007,227075,72,41,2,43,0
2020-05-29,Calaveras,009,45235,17,15,0,15,0
2020-05-29,Colusa,011,21464,8,5,0,5,0
2020-05-29,Contra Costa,013,1133247,1684,1411,1,1412,37
2020-05-29,Del Norte,015,27424,45,37,0,37,0
2020-05-29,El Dorado,017,186661,117,85,0,85,0
2020-05-29,Fresno,019,978130,3260,1687,45,1732,31
2020-05-29,Glenn,021,27897,19,14,0,14,0
2020-05-29,Humboldt,023,135768,111,98,0,98,2
2020-05-29,Imperial,025,180216,3599,1607,4,1611,14
2020-05-29,Inyo,027,18085,20,20,0,20,1
2020-05-29,Kern,029,883053,2796,2128,6,2134,36
2020-05-29,Kings,031,150075,1238,693,4,697,3
2020-05-29,Lake,033,64148,30,17,0,17,0
2020-05-29,Lassen,035,31185,10,0,2,2,0
2020-05-29,Los Angeles,037,10098052,60881,51578,19,51597,2273
2020-05-29,Madera,039,155013,251,98,1,99,2
2020-05-29,Marin,041,260295,526,448,2,450,14
2020-05-29,Mariposa,043,17540,16,16,0,16,1
2020-05-29,Mendocino,045,87422,30,25,0,25,0
2020-05-29,Merced,047,269075,390,285,0,285,7
2020-05-29,Modoc,049,8938,0,0,0,0,0
2020-05-29,Mono,051,14174,38,34,0,34,1
2020-05-29,Monterey,053,433212,675,479,2,481,10
2020-05-29,Napa,055,140530,144,113,0,113,3
2020-05-29,Nevada,057,99092,50,41,1,42,1
2020-05-29,Orange,059,3164182,8923,6176,66,6242,133
2020-05-29,Placer,061,380077,264,199,1,200,9
2020-05-29,Plumas,063,18699,4,4,0,4,0
2020-05-29,Riverside,065,2383286,9526,7376,21,7397,313
2020-05-29,Sacramento,067,1510023,1499,1360,2,1362,57
2020-05-29,San Benito,069,59416,98,84,0,84,2
2020-05-29,San Bernardino,071,2135413,6236,4983,5,4988,196
2020-05-29,San Diego,073,3302833,8423,7242,0,7242,266
2020-05-29,San Francisco,075,870044,2670,2453,0,2453,41
2020-05-29,San Joaquin,077,732212,1117,855,4,859,34
2020-05-29,San Luis Obispo,079,281455,354,270,4,274,1
2020-05-29,San Mateo,081,765935,2371,2103,4,2107,71
2020-05-29,Santa Barbara,083,443738,1758,1656,13,1669,9
2020-05-29,Santa Clara,085,1922200,3445,2707,13,2720,141
2020-05-29,Santa Cruz,087,273765,229,203,0,203,2
2020-05-29,Shasta,089,179085,60,36,0,36,4
2020-05-29,Sierra,091,2930,1,1,0,1,0
2020-05-29,Siskiyou,093,43540,11,7,0,7,0
2020-05-29,Solano,095,438530,619,498,1,499,6
2020-05-29,Sonoma,097,501317,620,537,1,538,4
2020-05-29,Stanislaus,099,539301,865,698,5,703,27
2020-05-29,Sutter,101,95872,47,40,0,40,2
2020-05-29,Tehama,103,63373,9,4,1,5,1
2020-05-29,Trinity,105,12862,7,1,2,3,0
2020-05-29,Tulare,107,460477,2560,1852,10,1862,80
2020-05-29,Tuolumne,109,53932,5,4,0,4,0
2020-05-29,Ventura,111,848112,1606,1093,11,1104,29
2020-05-29,Yolo,113,214977,224,211,0,211,24
2020-05-29,Yuba,115,75493,29,25,0,25,1
2020-05-28,Alameda,001,1643700,3714,3083,6,3089,94
2020-05-28,Alpine,003,1148,1,1,0,1,0
2020-05-28,Amador,005,37829,10,10,0,10,0
2020-05-28,Butte,007,227075,71,40,2,42,0
2020-05-28,Calaveras,009,45235,16,15,0,15,0
2020-05-28,Colusa,011,21464,8,5,0,5,0
2020-05-28,Contra Costa,013,1133247,1645,1392,1,1393,37
2020-05-28,Del Norte,015,27424,45,37,0,37,0
2020-05-28,El Dorado,017,186661,114,82,0,82,0
2020-05-28,Fresno,019,978130,3179,1653,44,1697,31
2020-05-28,Glenn,021,27897,18,14,0,14,0
2020-05-28,Humboldt,023,135768,110,97,0,97,2
2020-05-28,Imperial,025,180216,3404,1430,4,1434,14
2020-05-28,Inyo,027,18085,20,20,0,20,1
2020-05-28,Kern,029,883053,2718,2069,6,2075,36
2020-05-28,Kings,031,150075,901,626,4,630,3
2020-05-28,Lake,033,64148,29,17,0,17,0
2020-05-28,Lassen,035,31185,10,0,2,2,0
2020-05-28,Los Angeles,037,10098052,59302,49861,19,49880,2222
2020-05-28,Madera,039,155013,233,93,1,94,2
2020-05-28,Marin,041,260295,501,443,2,445,14
2020-05-28,Mariposa,043,17540,16,16,0,16,1
2020-05-28,Mendocino,045,87422,28,24,0,24,0
2020-05-28,Merced,047,269075,381,283,0,283,7
2020-05-28,Modoc,049,8938,0,0,0,0,0
2020-05-28,Mono,051,14174,38,34,0,34,1
2020-05-28,Monterey,053,433212,643,471,2,473,10
2020-05-28,Napa,055,140530,141,113,0,113,3
2020-05-28,Nevada,057,99092,45,41,1,42,1
2020-05-28,Orange,059,3164182,8727,6045,66,6111,130
2020-05-28,Placer,061,380077,257,196,1,197,9
2020-05-28,Plumas,063,18699,4,4,0,4,0
2020-05-28,Riverside,065,2383286,9123,7240,20,7260,304
2020-05-28,Sacramento,067,1510023,1479,1339,2,1341,57
2020-05-28,San Benito,069,59416,97,82,0,82,2
2020-05-28,San Bernardino,071,2135413,6071,4831,5,4836,191
2020-05-28,San Diego,073,3302833,8266,7102,0,7102,260
2020-05-28,San Francisco,075,870044,2636,2417,0,2417,40
2020-05-28,San Joaquin,077,732212,1082,840,4,844,34
2020-05-28,San Luis Obispo,079,281455,351,267,4,271,1
2020-05-28,San Mateo,081,765935,2344,2070,4,2074,71
2020-05-28,Santa Barbara,083,443738,1729,1642,12,1654,9
2020-05-28,Santa Clara,085,1922200,3405,2698,13,2711,140
2020-05-28,Santa Cruz,087,273765,228,201,0,201,2
2020-05-28,Shasta,089,179085,58,36,0,36,4
2020-05-28,Sierra,091,2930,1,1,0,1,0
2020-05-28,Siskiyou,093,43540,9,6,0,6,0
2020-05-28,Solano,095,438530,602,489,1,490,6
2020-05-28,Sonoma,097,501317,598,529,1,530,4
2020-05-28,Stanislaus,099,539301,824,684,5,689,27
2020-05-28,Sutter,101,95872,47,40,0,40,2
2020-05-28,Tehama,103,63373,9,4,1,5,1
2020-05-28,Trinity,105,12862,6,1,2,3,0
2020-05-28,Tulare,107,460477,2524,1832,10,1842,79
2020-05-28,Tuolumne,109,53932,5,4,0,4,0
2020-05-28,Ventura,111,848112,1573,1083,11,1094,29
2020-05-28,Yolo,113,214977,221,206,0,206,22
2020-05-28,Yuba,115,75493,28,24,0,24,1
2020-05-27,Alameda,001,1643700,3631,3037,6,3043,94
2020-05-27,Alpine,003,1148,1,1,0,1,0
2020-05-27,Amador,005,37829,10,10,0,10,0
2020-05-27,Butte,007,227075,68,40,1,41,0
2020-05-27,Calaveras,009,45235,15,15,0,15,0
2020-05-27,Colusa,011,21464,8,5,0,5,0
2020-05-27,Contra Costa,013,1133247,1605,1373,1,1374,37
2020-05-27,Del Norte,015,27424,45,34,0,34,0
2020-05-27,El Dorado,017,186661,113,82,0,82,0
2020-05-27,Fresno,019,978130,3091,1620,44,1664,27
2020-05-27,Glenn,021,27897,18,14,0,14,0
2020-05-27,Humboldt,023,135768,110,86,0,86,2
2020-05-27,Imperial,025,180216,3224,1369,4,1373,14
2020-05-27,Inyo,027,18085,20,20,0,20,1
2020-05-27,Kern,029,883053,2653,1999,6,2005,37
2020-05-27,Kings,031,150075,874,586,4,590,3
2020-05-27,Lake,033,64148,29,13,0,13,0
2020-05-27,Lassen,035,31185,10,0,2,2,0
2020-05-27,Los Angeles,037,10098052,57927,48711,19,48730,2177
2020-05-27,Madera,039,155013,224,91,1,92,2
2020-05-27,Marin,041,260295,472,439,2,441,14
2020-05-27,Mariposa,043,17540,16,16,0,16,1
2020-05-27,Mendocino,045,87422,27,21,0,21,0
2020-05-27,Merced,047,269075,377,278,0,278,7
2020-05-27,Modoc,049,8938,0,0,0,0,0
2020-05-27,Mono,051,14174,38,34,0,34,1
2020-05-27,Monterey,053,433212,603,443,2,445,8
2020-05-27,Napa,055,140530,136,112,0,112,3
2020-05-27,Nevada,057,99092,44,41,1,42,1
2020-05-27,Orange,059,3164182,8572,5849,66,5915,121
2020-05-27,Placer,061,380077,238,196,0,196,9
2020-05-27,Plumas,063,18699,4,4,0,4,0
2020-05-27,Riverside,065,2383286,8744,7156,20,7176,299
2020-05-27,Sacramento,067,1510023,1451,1318,2,1320,50
2020-05-27,San Benito,069,59416,94,74,0,74,2
2020-05-27,San Bernardino,071,2135413,5887,4708,5,4713,183
2020-05-27,San Diego,073,3302833,8115,6985,0,6985,255
2020-05-27,San Francisco,075,870044,2607,2394,0,2394,40
2020-05-27,San Joaquin,077,732212,1040,825,4,829,34
2020-05-27,San Luis Obispo,079,281455,346,266,4,270,1
2020-05-27,San Mateo,081,765935,2304,2045,4,2049,71
2020-05-27,Santa Barbara,083,443738,1714,1629,12,1641,9
2020-05-27,Santa Clara,085,1922200,3372,2680,13,2693,140
2020-05-27,Santa Cruz,087,273765,224,202,0,202,2
2020-05-27,Shasta,089,179085,55,36,0,36,4
2020-05-27,Sierra,091,2930,1,1,0,1,0
2020-05-27,Siskiyou,093,43540,9,6,0,6,0
2020-05-27,Solano,095,438530,582,477,1,478,5
2020-05-27,Sonoma,097,501317,584,521,1,522,4
2020-05-27,Stanislaus,099,539301,799,675,5,680,27
2020-05-27,Sutter,101,95872,46,40,0,40,2
2020-05-27,Tehama,103,63373,9,3,1,4,1
2020-05-27,Trinity,105,12862,6,1,2,3,0
2020-05-27,Tulare,107,460477,2472,1817,10,1827,77
2020-05-27,Tuolumne,109,53932,5,4,0,4,0
2020-05-27,Ventura,111,848112,1548,1065,11,1076,28
2020-05-27,Yolo,113,214977,220,204,0,204,22
2020-05-27,Yuba,115,75493,28,24,0,24,1
2020-05-26,Alameda,001,1643700,3536,2956,6,2962,92
2020-05-26,Alpine,003,1148,1,1,0,1,0
2020-05-26,Amador,005,37829,10,10,0,10,0
2020-05-26,Butte,007,227075,66,37,1,38,0
2020-05-26,Calaveras,009,45235,15,13,0,13,0
2020-05-26,Colusa,011,21464,8,4,0,4,0
2020-05-26,Contra Costa,013,1133247,1570,1352,1,1353,37
2020-05-26,Del Norte,015,27424,44,30,0,30,0
2020-05-26,El Dorado,017,186661,109,79,0,79,0
2020-05-26,Fresno,019,978130,3004,1496,44,1540,22
2020-05-26,Glenn,021,27897,16,12,0,12,0
2020-05-26,Humboldt,023,135768,108,81,0,81,2
2020-05-26,Imperial,025,180216,3009,1369,4,1373,14
2020-05-26,Inyo,027,18085,20,20,0,20,1
2020-05-26,Kern,029,883053,2575,1890,6,1896,31
2020-05-26,Kings,031,150075,806,449,3,452,2
2020-05-26,Lake,033,64148,27,12,0,12,0
2020-05-26,Lassen,035,31185,9,0,2,2,0
2020-05-26,Los Angeles,037,10098052,56460,47760,19,47779,2121
2020-05-26,Madera,039,155013,209,83,1,84,2
2020-05-26,Marin,041,260295,460,424,2,426,14
2020-05-26,Mariposa,043,17540,16,16,0,16,1
2020-05-26,Mendocino,045,87422,25,20,0,20,0
2020-05-26,Merced,047,269075,362,266,0,266,7
2020-05-26,Modoc,049,8938,0,1,0,1,0
2020-05-26,Mono,051,14174,37,34,0,34,1
2020-05-26,Monterey,053,433212,575,424,1,425,8
2020-05-26,Napa,055,140530,131,109,0,109,3
2020-05-26,Nevada,057,99092,43,41,1,42,1
2020-05-26,Orange,059,3164182,8302,5651,65,5716,115
2020-05-26,Placer,061,380077,233,188,0,188,9
2020-05-26,Plumas,063,18699,4,4,0,4,0
2020-05-26,Riverside,065,2383286,8297,6917,20,6937,284
2020-05-26,Sacramento,067,1510023,1425,1298,2,1300,50
2020-05-26,San Benito,069,59416,89,69,0,69,2
2020-05-26,San Bernardino,071,2135413,5719,4430,5,4435,175
2020-05-26,San Diego,073,3302833,7972,6884,0,6884,249
2020-05-26,San Francisco,075,870044,2574,2363,0,2363,40
2020-05-26,San Joaquin,077,732212,993,760,4,764,33
2020-05-26,San Luis Obispo,079,281455,344,260,4,264,1
2020-05-26,San Mateo,081,765935,2266,1967,3,1970,71
2020-05-26,Santa Barbara,083,443738,1697,1590,11,1601,9
2020-05-26,Santa Clara,085,1922200,3340,2659,13,2672,139
2020-05-26,Santa Cruz,087,273765,222,197,0,197,2
2020-05-26,Shasta,089,179085,55,36,0,36,4
2020-05-26,Sierra,091,2930,1,1,0,1,0
2020-05-26,Siskiyou,093,43540,8,6,0,6,0
2020-05-26,Solano,095,438530,564,470,1,471,5
2020-05-26,Sonoma,097,501317,576,509,0,509,4
2020-05-26,Stanislaus,099,539301,779,663,5,668,27
2020-05-26,Sutter,101,95872,45,39,0,39,2
2020-05-26,Tehama,103,63373,8,2,1,3,1
2020-05-26,Trinity,105,12862,6,1,2,3,0
2020-05-26,Tulare,107,460477,2416,1768,10,1778,76
2020-05-26,Tuolumne,109,53932,5,2,0,2,0
2020-05-26,Ventura,111,848112,1511,1033,8,1041,27
2020-05-26,Yolo,113,214977,214,198,0,198,22
2020-05-26,Yuba,115,75493,27,24,0,24,1
2020-05-25,Alameda,001,1643700,3443,2900,5,2905,92
2020-05-25,Alpine,003,1148,1,1,0,1,0
2020-05-25,Amador,005,37829,10,10,0,10,0
2020-05-25,Butte,007,227075,63,37,1,38,0
2020-05-25,Calaveras,009,45235,15,13,0,13,0
2020-05-25,Colusa,011,21464,7,4,0,4,0
2020-05-25,Contra Costa,013,1133247,1537,1348,1,1349,37
2020-05-25,Del Norte,015,27424,44,20,0,20,0
2020-05-25,El Dorado,017,186661,101,78,0,78,0
2020-05-25,Fresno,019,978130,2900,1496,42,1538,22
2020-05-25,Glenn,021,27897,16,12,0,12,0
2020-05-25,Humboldt,023,135768,107,81,0,81,2
2020-05-25,Imperial,025,180216,2798,1369,4,1373,14
2020-05-25,Inyo,027,18085,19,20,0,20,1
2020-05-25,Kern,029,883053,2504,1890,6,1896,31
2020-05-25,Kings,031,150075,776,447,3,450,2
2020-05-25,Lake,033,64148,25,13,0,13,0
2020-05-25,Lassen,035,31185,9,0,2,2,0
2020-05-25,Los Angeles,037,10098052,54650,45952,18,45970,2094
2020-05-25,Madera,039,155013,196,83,1,84,2
2020-05-25,Marin,041,260295,442,415,2,417,14
2020-05-25,Mariposa,043,17540,16,15,0,15,1
2020-05-25,Mendocino,045,87422,22,19,0,19,0
2020-05-25,Merced,047,269075,355,262,0,262,6
2020-05-25,Modoc,049,8938,0,1,0,1,0
2020-05-25,Mono,051,14174,37,34,0,34,1
2020-05-25,Monterey,053,433212,545,418,1,419,8
2020-05-25,Napa,055,140530,131,107,0,107,3
2020-05-25,Nevada,057,99092,43,41,1,42,1
2020-05-25,Orange,059,3164182,8080,5601,64,5665,115
2020-05-25,Placer,061,380077,229,186,0,186,9
2020-05-25,Plumas,063,18699,4,4,0,4,0
2020-05-25,Riverside,065,2383286,8066,6900,20,6920,284
2020-05-25,Sacramento,067,1510023,1405,1290,1,1291,50
2020-05-25,San Benito,069,59416,88,70,0,70,2
2020-05-25,San Bernardino,071,2135413,5529,4393,4,4397,175
2020-05-25,San Diego,073,3302833,7796,6799,0,6799,249
2020-05-25,San Francisco,075,870044,2537,2358,0,2358,40
2020-05-25,San Joaquin,077,732212,967,760,4,764,33
2020-05-25,San Luis Obispo,079,281455,341,260,4,264,1
2020-05-25,San Mateo,081,765935,2229,1938,3,1941,71
2020-05-25,Santa Barbara,083,443738,1687,1590,11,1601,9
2020-05-25,Santa Clara,085,1922200,3307,2647,13,2660,139
2020-05-25,Santa Cruz,087,273765,220,191,0,191,2
2020-05-25,Shasta,089,179085,54,36,0,36,4
2020-05-25,Sierra,091,2930,1,1,0,1,0
2020-05-25,Siskiyou,093,43540,8,6,0,6,0
2020-05-25,Solano,095,438530,550,437,1,438,5
2020-05-25,Sonoma,097,501317,564,496,0,496,4
2020-05-25,Stanislaus,099,539301,749,651,5,656,27
2020-05-25,Sutter,101,95872,45,38,0,38,2
2020-05-25,Tehama,103,63373,7,2,1,3,1
2020-05-25,Trinity,105,12862,6,1,2,3,0
2020-05-25,Tulare,107,460477,2352,1747,10,1757,76
2020-05-25,Tuolumne,109,53932,5,2,0,2,0
2020-05-25,Ventura,111,848112,1470,1020,8,1028,27
2020-05-25,Yolo,113,214977,212,197,0,197,22
2020-05-25,Yuba,115,75493,26,24,0,24,1
2020-05-24,Alameda,001,1643700,3370,2830,5,2835,92
2020-05-24,Alpine,003,1148,1,1,0,1,0
2020-05-24,Amador,005,37829,10,9,0,9,0
2020-05-24,Butte,007,227075,61,35,1,36,0
2020-05-24,Calaveras,009,45235,15,13,0,13,0
2020-05-24,Colusa,011,21464,7,4,0,4,0
2020-05-24,Contra Costa,013,1133247,1509,1325,1,1326,37
2020-05-24,Del Norte,015,27424,43,16,0,16,0
2020-05-24,El Dorado,017,186661,100,76,0,76,0
2020-05-24,Fresno,019,978130,2833,1455,41,1496,22
2020-05-24,Glenn,021,27897,15,12,0,12,0
2020-05-24,Humboldt,023,135768,107,81,0,81,2
2020-05-24,Imperial,025,180216,2672,1369,4,1373,14
2020-05-24,Inyo,027,18085,19,20,0,20,1
2020-05-24,Kern,029,883053,2431,1861,5,1866,31
2020-05-24,Kings,031,150075,765,446,3,449,2
2020-05-24,Lake,033,64148,24,12,0,12,0
2020-05-24,Lassen,035,31185,8,0,2,2,0
2020-05-24,Los Angeles,037,10098052,53635,44954,18,44972,2085
2020-05-24,Madera,039,155013,190,83,1,84,2
2020-05-24,Marin,041,260295,440,401,2,403,14
2020-05-24,Mariposa,043,17540,16,15,0,15,1
2020-05-24,Mendocino,045,87422,21,19,0,19,0
2020-05-24,Merced,047,269075,354,258,0,258,6
2020-05-24,Modoc,049,8938,0,0,0,0,0
2020-05-24,Mono,051,14174,37,34,0,34,1
2020-05-24,Monterey,053,433212,517,405,1,406,8
2020-05-24,Napa,055,140530,129,104,0,104,3
2020-05-24,Nevada,057,99092,43,41,1,42,1
2020-05-24,Orange,059,3164182,7926,5439,63,5502,113
2020-05-24,Placer,061,380077,221,184,0,184,9
2020-05-24,Plumas,063,18699,4,4,0,4,0
2020-05-24,Riverside,065,2383286,7925,6571,20,6591,284
2020-05-24,Sacramento,067,1510023,1389,1283,1,1284,50
2020-05-24,San Benito,069,59416,87,67,0,67,2
2020-05-24,San Bernardino,071,2135413,5421,4262,4,4266,175
2020-05-24,San Diego,073,3302833,7653,6703,0,6703,249
2020-05-24,San Francisco,075,870044,2513,2318,0,2318,40
2020-05-24,San Joaquin,077,732212,948,760,4,764,33
2020-05-24,San Luis Obispo,079,281455,339,257,4,261,1
2020-05-24,San Mateo,081,765935,2194,1925,3,1928,71
2020-05-24,Santa Barbara,083,443738,1675,1573,11,1584,9
2020-05-24,Santa Clara,085,1922200,3287,2623,13,2636,139
2020-05-24,Santa Cruz,087,273765,217,185,0,185,2
2020-05-24,Shasta,089,179085,53,36,0,36,4
2020-05-24,Sierra,091,2930,1,1,0,1,0
2020-05-24,Siskiyou,093,43540,7,6,0,6,0
2020-05-24,Solano,095,438530,542,436,0,436,5
2020-05-24,Sonoma,097,501317,553,485,0,485,4
2020-05-24,Stanislaus,099,539301,729,634,5,639,27
2020-05-24,Sutter,101,95872,45,38,0,38,2
2020-05-24,Tehama,103,63373,5,2,1,3,1
2020-05-24,Trinity,105,12862,6,1,2,3,0
2020-05-24,Tulare,107,460477,2306,1684,10,1694,74
2020-05-24,Tuolumne,109,53932,5,2,0,2,0
2020-05-24,Ventura,111,848112,1458,982,8,990,27
2020-05-24,Yolo,113,214977,210,192,0,192,22
2020-05-24,Yuba,115,75493,26,24,0,24,1
2020-05-23,Alameda,001,1643700,3329,2783,5,2788,91
2020-05-23,Alpine,003,1148,1,1,0,1,0
2020-05-23,Amador,005,37829,10,9,0,9,0
2020-05-23,Butte,007,227075,60,34,1,35,0
2020-05-23,Calaveras,009,45235,15,13,0,13,0
2020-05-23,Colusa,011,21464,7,4,0,4,0
2020-05-23,Contra Costa,013,1133247,1498,1302,1,1303,36
2020-05-23,Del Norte,015,27424,43,10,0,10,0
2020-05-23,El Dorado,017,186661,100,74,0,74,0
2020-05-23,Fresno,019,978130,2813,1447,41,1488,21
2020-05-23,Glenn,021,27897,15,12,0,12,0
2020-05-23,Humboldt,023,135768,105,80,0,80,2
2020-05-23,Imperial,025,180216,2584,1283,4,1287,14
2020-05-23,Inyo,027,18085,19,20,0,20,1
2020-05-23,Kern,029,883053,2388,1806,5,1811,31
2020-05-23,Kings,031,150075,761,444,3,447,2
2020-05-23,Lake,033,64148,23,10,0,10,0
2020-05-23,Lassen,035,31185,8,0,2,2,0
2020-05-23,Los Angeles,037,10098052,53093,44029,18,44047,2069
2020-05-23,Madera,039,155013,186,83,1,84,2
2020-05-23,Marin,041,260295,440,393,1,394,14
2020-05-23,Mariposa,043,17540,16,15,0,15,1
2020-05-23,Mendocino,045,87422,21,13,0,13,0
2020-05-23,Merced,047,269075,351,247,0,247,6
2020-05-23,Modoc,049,8938,0,0,0,0,0
2020-05-23,Mono,051,14174,36,34,0,34,1
2020-05-23,Monterey,053,433212,503,397,1,398,8
2020-05-23,Napa,055,140530,125,101,0,101,3
2020-05-23,Nevada,057,99092,43,41,1,42,1
2020-05-23,Orange,059,3164182,7767,5313,62,5375,113
2020-05-23,Placer,061,380077,215,184,0,184,9
2020-05-23,Plumas,063,18699,4,4,0,4,0
2020-05-23,Riverside,065,2383286,7834,6460,20,6480,284
2020-05-23,Sacramento,067,1510023,1373,1275,1,1276,50
2020-05-23,San Benito,069,59416,82,67,0,67,2
2020-05-23,San Bernardino,071,2135413,5327,4172,4,4176,175
2020-05-23,San Diego,073,3302833,7562,6561,0,6561,249
2020-05-23,San Francisco,075,870044,2494,2312,0,2312,40
2020-05-23,San Joaquin,077,732212,933,759,4,763,33
2020-05-23,San Luis Obispo,079,281455,335,256,4,260,1
2020-05-23,San Mateo,081,765935,2166,1862,3,1865,71
2020-05-23,Santa Barbara,083,443738,1667,1566,11,1577,9
2020-05-23,Santa Clara,085,1922200,3273,2593,12,2605,139
2020-05-23,Santa Cruz,087,273765,215,177,0,177,2
2020-05-23,Shasta,089,179085,53,35,0,35,4
2020-05-23,Sierra,091,2930,1,1,0,1,0
2020-05-23,Siskiyou,093,43540,7,6,0,6,0
2020-05-23,Solano,095,438530,537,435,0,435,5
2020-05-23,Sonoma,097,501317,539,462,0,462,4
2020-05-23,Stanislaus,099,539301,721,625,5,630,27
2020-05-23,Sutter,101,95872,44,38,0,38,2
2020-05-23,Tehama,103,63373,5,2,1,3,1
2020-05-23,Trinity,105,12862,6,1,2,3,0
2020-05-23,Tulare,107,460477,2285,1682,10,1692,73
2020-05-23,Tuolumne,109,53932,5,2,0,2,0
2020-05-23,Ventura,111,848112,1438,961,8,969,27
2020-05-23,Yolo,113,214977,209,188,0,188,22
2020-05-23,Yuba,115,75493,26,24,0,24,1
2020-05-22,Alameda,001,1643700,3275,2722,5,2727,91
2020-05-22,Alpine,003,1148,1,1,0,1,0
2020-05-22,Amador,005,37829,10,9,0,9,0
2020-05-22,Butte,007,227075,58,34,1,35,0
2020-05-22,Calaveras,009,45235,15,13,0,13,0
2020-05-22,Colusa,011,21464,7,4,0,4,0
2020-05-22,Contra Costa,013,1133247,1486,1272,1,1273,36
2020-05-22,Del Norte,015,27424,41,9,0,9,0
2020-05-22,El Dorado,017,186661,97,74,0,74,0
2020-05-22,Fresno,019,978130,2754,1399,40,1439,20
2020-05-22,Glenn,021,27897,15,12,0,12,0
2020-05-22,Humboldt,023,135768,105,80,0,80,2
2020-05-22,Imperial,025,180216,2483,1214,4,1218,14
2020-05-22,Inyo,027,18085,19,20,0,20,1
2020-05-22,Kern,029,883053,2339,1749,5,1754,28
2020-05-22,Kings,031,150075,758,428,3,431,2
2020-05-22,Lake,033,64148,22,10,0,10,0
2020-05-22,Lassen,035,31185,6,0,2,2,0
2020-05-22,Los Angeles,037,10098052,52301,43025,18,43043,2027
2020-05-22,Madera,039,155013,182,82,1,83,2
2020-05-22,Marin,041,260295,436,372,1,373,14
2020-05-22,Mariposa,043,17540,16,15,0,15,1
2020-05-22,Mendocino,045,87422,20,13,0,13,0
2020-05-22,Merced,047,269075,351,233,0,233,6
2020-05-22,Modoc,049,8938,0,0,0,0,0
2020-05-22,Mono,051,14174,36,34,0,34,1
2020-05-22,Monterey,053,433212,492,372,1,373,8
2020-05-22,Napa,055,140530,123,97,0,97,3
2020-05-22,Nevada,057,99092,42,41,1,42,1
2020-05-22,Orange,059,3164182,7570,5144,60,5204,113
2020-05-22,Placer,061,380077,215,181,0,181,9
2020-05-22,Plumas,063,18699,4,4,0,4,0
2020-05-22,Riverside,065,2383286,7719,6351,20,6371,283
2020-05-22,Sacramento,067,1510023,1357,1262,1,1263,50
2020-05-22,San Benito,069,59416,81,64,0,64,2
2020-05-22,San Bernardino,071,2135413,5252,4107,4,4111,173
2020-05-22,San Diego,073,3302833,7476,6436,0,6436,242
2020-05-22,San Francisco,075,870044,2476,2251,0,2251,40
2020-05-22,San Joaquin,077,732212,920,747,4,751,33
2020-05-22,San Luis Obispo,079,281455,335,254,4,258,1
2020-05-22,San Mateo,081,765935,2147,1847,3,1850,71
2020-05-22,Santa Barbara,083,443738,1657,1554,11,1565,9
2020-05-22,Santa Clara,085,1922200,3253,2537,12,2549,139
2020-05-22,Santa Cruz,087,273765,212,171,0,171,2
2020-05-22,Shasta,089,179085,53,34,0,34,4
2020-05-22,Sierra,091,2930,1,0,0,0,0
2020-05-22,Siskiyou,093,43540,7,6,0,6,0
2020-05-22,Solano,095,438530,534,431,0,431,4
2020-05-22,Sonoma,097,501317,535,444,0,444,4
2020-05-22,Stanislaus,099,539301,711,616,5,621,27
2020-05-22,Sutter,101,95872,44,38,0,38,2
2020-05-22,Tehama,103,63373,5,2,0,2,1
2020-05-22,Trinity,105,12862,6,1,2,3,0
2020-05-22,Tulare,107,460477,2255,1662,10,1672,73
2020-05-22,Tuolumne,109,53932,5,2,0,2,0
2020-05-22,Ventura,111,848112,1420,937,8,945,27
2020-05-22,Yolo,113,214977,207,187,0,187,22
2020-05-22,Yuba,115,75493,26,24,0,24,1
2020-05-21,Alameda,001,1643700,3210,2606,5,2611,89
2020-05-21,Alpine,003,1148,1,1,0,1,0
2020-05-21,Amador,005,37829,10,9,0,9,0
2020-05-21,Butte,007,227075,57,31,1,32,0
2020-05-21,Calaveras,009,45235,14,13,0,13,0
2020-05-21,Colusa,011,21464,7,4,0,4,0
2020-05-21,Contra Costa,013,1133247,1450,1243,1,1244,36
2020-05-21,Del Norte,015,27424,38,9,0,9,0
2020-05-21,El Dorado,017,186661,95,67,0,67,0
2020-05-21,Fresno,019,978130,2662,1362,39,1401,20
2020-05-21,Glenn,021,27897,14,12,0,12,0
2020-05-21,Humboldt,023,135768,104,79,0,79,0
2020-05-21,Imperial,025,180216,2322,1096,4,1100,14
2020-05-21,Inyo,027,18085,19,20,0,20,1
2020-05-21,Kern,029,883053,2263,1684,4,1688,27
2020-05-21,Kings,031,150075,737,417,2,419,2
2020-05-21,Lake,033,64148,17,10,0,10,0
2020-05-21,Lassen,035,31185,6,0,2,2,0
2020-05-21,Los Angeles,037,10098052,51267,42063,18,42081,1996
2020-05-21,Madera,039,155013,179,82,1,83,2
2020-05-21,Marin,041,260295,425,359,1,360,14
2020-05-21,Mariposa,043,17540,16,15,0,15,1
2020-05-21,Mendocino,045,87422,20,12,0,12,0
2020-05-21,Merced,047,269075,340,226,0,226,6
2020-05-21,Modoc,049,8938,0,0,0,0,0
2020-05-21,Mono,051,14174,36,33,0,33,1
2020-05-21,Monterey,053,433212,481,363,1,364,8
2020-05-21,Napa,055,140530,121,96,0,96,3
2020-05-21,Nevada,057,99092,42,41,1,42,1
2020-05-21,Orange,059,3164182,7367,4975,59,5034,106
2020-05-21,Placer,061,380077,208,176,0,176,8
2020-05-21,Plumas,063,18699,4,4,0,4,0
2020-05-21,Riverside,065,2383286,7533,6245,20,6265,279
2020-05-21,Sacramento,067,1510023,1344,1258,1,1259,56
2020-05-21,San Benito,069,59416,78,61,0,61,2
2020-05-21,San Bernardino,071,2135413,5105,3950,4,3954,167
2020-05-21,San Diego,073,3302833,7340,6317,0,6317,241
2020-05-21,San Francisco,075,870044,2452,2248,0,2248,37
2020-05-21,San Joaquin,077,732212,884,730,4,734,33
2020-05-21,San Luis Obispo,079,281455,335,251,3,254,1
2020-05-21,San Mateo,081,765935,2111,1791,3,1794,74
2020-05-21,Santa Barbara,083,443738,1642,1541,11,1552,10
2020-05-21,Santa Clara,085,1922200,3230,2520,12,2532,138
2020-05-21,Santa Cruz,087,273765,204,164,0,164,3
2020-05-21,Shasta,089,179085,51,34,0,34,4
2020-05-21,Sierra,091,2930,1,0,0,0,0
2020-05-21,Siskiyou,093,43540,7,6,0,6,0
2020-05-21,Solano,095,438530,525,424,0,424,4
2020-05-21,Sonoma,097,501317,517,427,0,427,4
2020-05-21,Stanislaus,099,539301,700,602,5,607,27
2020-05-21,Sutter,101,95872,43,38,0,38,2
2020-05-21,Tehama,103,63373,4,2,0,2,1
2020-05-21,Trinity,105,12862,5,1,2,3,0
2020-05-21,Tulare,107,460477,2205,1606,8,1614,73
2020-05-21,Tuolumne,109,53932,3,2,0,2,0
2020-05-21,Ventura,111,848112,1371,907,8,915,30
2020-05-21,Yolo,113,214977,204,185,0,185,22
2020-05-21,Yuba,115,75493,26,24,0,24,1
2020-05-20,Alameda,001,1643700,3137,2554,5,2559,89
2020-05-20,Alpine,003,1148,1,1,0,1,0
2020-05-20,Amador,005,37829,10,9,0,9,0
2020-05-20,Butte,007,227075,54,30,1,31,0
2020-05-20,Calaveras,009,45235,14,13,0,13,0
2020-05-20,Colusa,011,21464,7,3,0,3,0
2020-05-20,Contra Costa,013,1133247,1420,1223,1,1224,33
2020-05-20,Del Norte,015,27424,31,9,0,9,0
2020-05-20,El Dorado,017,186661,94,67,0,67,0
2020-05-20,Fresno,019,978130,2589,1329,38,1367,17
2020-05-20,Glenn,021,27897,13,12,0,12,0
2020-05-20,Humboldt,023,135768,101,73,0,73,0
2020-05-20,Imperial,025,180216,2209,1047,4,1051,14
2020-05-20,Inyo,027,18085,19,20,0,20,1
2020-05-20,Kern,029,883053,2200,1639,3,1642,27
2020-05-20,Kings,031,150075,593,403,2,405,2
2020-05-20,Lake,033,64148,17,9,0,9,0
2020-05-20,Lassen,035,31185,5,0,2,2,0
2020-05-20,Los Angeles,037,10098052,50273,40932,18,40950,1955
2020-05-20,Madera,039,155013,177,82,1,83,2
2020-05-20,Marin,041,260295,398,348,1,349,14
2020-05-20,Mariposa,043,17540,16,15,0,15,1
2020-05-20,Mendocino,045,87422,20,12,0,12,0
2020-05-20,Merced,047,269075,333,225,0,225,6
2020-05-20,Modoc,049,8938,0,0,0,0,0
2020-05-20,Mono,051,14174,36,33,0,33,1
2020-05-20,Monterey,053,433212,467,356,1,357,8
2020-05-20,Napa,055,140530,114,93,0,93,3
2020-05-20,Nevada,057,99092,42,41,1,42,1
2020-05-20,Orange,059,3164182,7159,4866,57,4923,96
2020-05-20,Placer,061,380077,206,176,0,176,8
2020-05-20,Plumas,063,18699,4,4,0,4,0
2020-05-20,Riverside,065,2383286,7390,6090,20,6110,265
2020-05-20,Sacramento,067,1510023,1334,1244,1,1245,56
2020-05-20,San Benito,069,59416,77,61,0,61,2
2020-05-20,San Bernardino,071,2135413,4977,3771,4,3775,161
2020-05-20,San Diego,073,3302833,7223,6142,0,6142,230
2020-05-20,San Francisco,075,870044,2429,2199,0,2199,37
2020-05-20,San Joaquin,077,732212,848,713,4,717,33
2020-05-20,San Luis Obispo,079,281455,328,249,3,252,1
2020-05-20,San Mateo,081,765935,2058,1739,3,1742,74
2020-05-20,Santa Barbara,083,443738,1623,1524,11,1535,10
2020-05-20,Santa Clara,085,1922200,3209,2508,11,2519,138
2020-05-20,Santa Cruz,087,273765,201,163,0,163,3
2020-05-20,Shasta,089,179085,51,34,0,34,4
2020-05-20,Sierra,091,2930,1,0,0,0,0
2020-05-20,Siskiyou,093,43540,7,6,0,6,0
2020-05-20,Solano,095,438530,520,418,0,418,4
2020-05-20,Sonoma,097,501317,508,411,0,411,4
2020-05-20,Stanislaus,099,539301,684,584,4,588,25
2020-05-20,Sutter,101,95872,43,38,0,38,2
2020-05-20,Tehama,103,63373,4,2,0,2,1
2020-05-20,Trinity,105,12862,4,1,1,2,0
2020-05-20,Tulare,107,460477,2164,1585,8,1593,71
2020-05-20,Tuolumne,109,53932,3,2,0,2,0
2020-05-20,Ventura,111,848112,1335,879,8,887,29
2020-05-20,Yolo,113,214977,201,184,0,184,22
2020-05-20,Yuba,115,75493,26,23,0,23,1
2020-05-19,Alameda,001,1643700,3060,2493,3,2496,88
2020-05-19,Alpine,003,1148,1,1,0,1,0
2020-05-19,Amador,005,37829,10,9,0,9,0
2020-05-19,Butte,007,227075,52,25,1,26,0
2020-05-19,Calaveras,009,45235,14,13,0,13,0
2020-05-19,Colusa,011,21464,5,3,0,3,0
2020-05-19,Contra Costa,013,1133247,1397,1205,1,1206,33
2020-05-19,Del Norte,015,27424,28,8,0,8,0
2020-05-19,El Dorado,017,186661,91,67,0,67,0
2020-05-19,Fresno,019,978130,2475,1288,37,1325,15
2020-05-19,Glenn,021,27897,13,12,0,12,0
2020-05-19,Humboldt,023,135768,101,72,0,72,0
2020-05-19,Imperial,025,180216,2047,1012,4,1016,14
2020-05-19,Inyo,027,18085,19,20,0,20,1
2020-05-19,Kern,029,883053,2102,1601,3,1604,26
2020-05-19,Kings,031,150075,582,393,2,395,2
2020-05-19,Lake,033,64148,14,11,0,11,0
2020-05-19,Lassen,035,31185,5,0,2,2,0
2020-05-19,Los Angeles,037,10098052,49067,39670,18,39688,1906
2020-05-19,Madera,039,155013,173,80,1,81,2
2020-05-19,Marin,041,260295,374,340,1,341,14
2020-05-19,Mariposa,043,17540,16,15,0,15,1
2020-05-19,Mendocino,045,87422,20,12,0,12,0
2020-05-19,Merced,047,269075,325,222,0,222,5
2020-05-19,Modoc,049,8938,0,0,0,0,0
2020-05-19,Mono,051,14174,36,33,0,33,1
2020-05-19,Monterey,053,433212,455,350,1,351,8
2020-05-19,Napa,055,140530,113,93,0,93,3
2020-05-19,Nevada,057,99092,42,41,1,42,1
2020-05-19,Orange,059,3164182,6965,4746,55,4801,90
2020-05-19,Placer,061,380077,204,177,0,177,8
2020-05-19,Plumas,063,18699,4,5,0,5,0
2020-05-19,Riverside,065,2383286,7230,5963,19,5982,265
2020-05-19,Sacramento,067,1510023,1320,1239,1,1240,57
2020-05-19,San Benito,069,59416,75,59,0,59,2
2020-05-19,San Bernardino,071,2135413,4827,3656,4,3660,158
2020-05-19,San Diego,073,3302833,7079,6028,0,6028,222
2020-05-19,San Francisco,075,870044,2395,2186,0,2186,37
2020-05-19,San Joaquin,077,732212,826,705,4,709,33
2020-05-19,San Luis Obispo,079,281455,327,245,3,248,1
2020-05-19,San Mateo,081,765935,2017,1704,3,1707,71
2020-05-19,Santa Barbara,083,443738,1609,1521,11,1532,10
2020-05-19,Santa Clara,085,1922200,3159,2480,11,2491,138
2020-05-19,Santa Cruz,087,273765,190,161,0,161,3
2020-05-19,Shasta,089,179085,51,34,0,34,4
2020-05-19,Sierra,091,2930,0,0,0,0,0
2020-05-19,Siskiyou,093,43540,7,6,0,6,0
2020-05-19,Solano,095,438530,506,415,0,415,4
2020-05-19,Sonoma,097,501317,497,389,0,389,4
2020-05-19,Stanislaus,099,539301,670,582,4,586,25
2020-05-19,Sutter,101,95872,43,38,0,38,2
2020-05-19,Tehama,103,63373,4,2,0,2,1
2020-05-19,Trinity,105,12862,3,1,0,1,0
2020-05-19,Tulare,107,460477,2116,1551,8,1559,68
2020-05-19,Tuolumne,109,53932,3,2,0,2,0
2020-05-19,Ventura,111,848112,1294,861,7,868,28
2020-05-19,Yolo,113,214977,199,183,0,183,22
2020-05-19,Yuba,115,75493,26,23,0,23,1
2020-05-18,Alameda,001,1643700,2987,2442,3,2445,84
2020-05-18,Alpine,003,1148,1,1,0,1,0
2020-05-18,Amador,005,37829,10,8,0,8,0
2020-05-18,Butte,007,227075,50,24,1,25,0
2020-05-18,Calaveras,009,45235,14,13,0,13,0
2020-05-18,Colusa,011,21464,5,3,0,3,0
2020-05-18,Contra Costa,013,1133247,1366,1173,1,1174,33
2020-05-18,Del Norte,015,27424,23,8,0,8,0
2020-05-18,El Dorado,017,186661,89,67,0,67,0
2020-05-18,Fresno,019,978130,2397,1244,36,1280,14
2020-05-18,Glenn,021,27897,13,11,0,11,0
2020-05-18,Humboldt,023,135768,101,70,0,70,0
2020-05-18,Imperial,025,180216,1894,767,4,771,14
2020-05-18,Inyo,027,18085,19,20,0,20,1
2020-05-18,Kern,029,883053,2053,1566,3,1569,26
2020-05-18,Kings,031,150075,551,381,2,383,2
2020-05-18,Lake,033,64148,13,9,0,9,0
2020-05-18,Lassen,035,31185,5,0,2,2,0
2020-05-18,Los Angeles,037,10098052,48046,38477,18,38495,1825
2020-05-18,Madera,039,155013,167,74,1,75,2
2020-05-18,Marin,041,260295,361,329,1,330,14
2020-05-18,Mariposa,043,17540,16,15,0,15,1
2020-05-18,Mendocino,045,87422,15,12,0,12,0
2020-05-18,Merced,047,269075,316,217,0,217,5
2020-05-18,Modoc,049,8938,0,0,0,0,0
2020-05-18,Mono,051,14174,36,33,0,33,1
2020-05-18,Monterey,053,433212,444,345,1,346,8
2020-05-18,Napa,055,140530,109,92,0,92,3
2020-05-18,Nevada,057,99092,42,41,1,42,1
2020-05-18,Orange,059,3164182,6776,4558,53,4611,88
2020-05-18,Placer,061,380077,202,176,0,176,8
2020-05-18,Plumas,063,18699,4,5,0,5,0
2020-05-18,Riverside,065,2383286,7030,5873,18,5891,253
2020-05-18,Sacramento,067,1510023,1314,1233,0,1233,57
2020-05-18,San Benito,069,59416,73,59,0,59,2
2020-05-18,San Bernardino,071,2135413,4680,3558,4,3562,156
2020-05-18,San Diego,073,3302833,6946,5948,0,5948,211
2020-05-18,San Francisco,075,870044,2372,2183,0,2183,36
2020-05-18,San Joaquin,077,732212,814,697,4,701,33
2020-05-18,San Luis Obispo,079,281455,323,243,3,246,1
2020-05-18,San Mateo,081,765935,1979,1701,3,1704,68
2020-05-18,Santa Barbara,083,443738,1598,1501,11,1512,10
2020-05-18,Santa Clara,085,1922200,3126,2468,11,2479,137
2020-05-18,Santa Cruz,087,273765,188,160,0,160,3
2020-05-18,Shasta,089,179085,50,34,0,34,4
2020-05-18,Sierra,091,2930,0,0,0,0,0
2020-05-18,Siskiyou,093,43540,7,6,0,6,0
2020-05-18,Solano,095,438530,496,398,0,398,4
2020-05-18,Sonoma,097,501317,479,387,0,387,4
2020-05-18,Stanislaus,099,539301,658,572,4,576,25
2020-05-18,Sutter,101,95872,43,38,0,38,2
2020-05-18,Tehama,103,63373,4,2,0,2,1
2020-05-18,Trinity,105,12862,3,1,0,1,0
2020-05-18,Tulare,107,460477,2072,1491,8,1499,63
2020-05-18,Tuolumne,109,53932,3,2,0,2,0
2020-05-18,Ventura,111,848112,1271,850,6,856,27
2020-05-18,Yolo,113,214977,194,183,0,183,22
2020-05-18,Yuba,115,75493,26,23,0,23,1
2020-05-17,Alameda,001,1643700,2892,2389,3,2392,83
2020-05-17,Alpine,003,1148,1,1,0,1,0
2020-05-17,Amador,005,37829,10,8,0,8,0
2020-05-17,Butte,007,227075,49,23,1,24,0
2020-05-17,Calaveras,009,45235,14,13,0,13,0
2020-05-17,Colusa,011,21464,3,3,0,3,0
2020-05-17,Contra Costa,013,1133247,1327,1155,1,1156,33
2020-05-17,Del Norte,015,27424,23,7,0,7,0
2020-05-17,El Dorado,017,186661,89,65,0,65,0
2020-05-17,Fresno,019,978130,2291,1213,33,1246,14
2020-05-17,Glenn,021,27897,13,9,0,9,0
2020-05-17,Humboldt,023,135768,94,70,0,70,0
2020-05-17,Imperial,025,180216,1746,715,4,719,14
2020-05-17,Inyo,027,18085,19,20,0,20,1
2020-05-17,Kern,029,883053,1975,1546,3,1549,26
2020-05-17,Kings,031,150075,504,356,2,358,2
2020-05-17,Lake,033,64148,13,7,0,7,0
2020-05-17,Lassen,035,31185,5,0,2,2,0
2020-05-17,Los Angeles,037,10098052,46808,37996,18,38014,1807
2020-05-17,Madera,039,155013,165,69,1,70,2
2020-05-17,Marin,041,260295,350,315,1,316,14
2020-05-17,Mariposa,043,17540,15,15,0,15,1
2020-05-17,Mendocino,045,87422,14,10,0,10,0
2020-05-17,Merced,047,269075,305,214,0,214,5
2020-05-17,Modoc,049,8938,0,0,0,0,0
2020-05-17,Mono,051,14174,36,32,0,32,1
2020-05-17,Monterey,053,433212,424,342,1,343,8
2020-05-17,Napa,055,140530,105,89,0,89,3
2020-05-17,Nevada,057,99092,42,41,1,42,1
2020-05-17,Orange,059,3164182,6597,4466,52,4518,88
2020-05-17,Placer,061,380077,197,175,0,175,8
2020-05-17,Plumas,063,18699,4,4,0,4,0
2020-05-17,Riverside,065,2383286,6857,5776,18,5794,245
2020-05-17,Sacramento,067,1510023,1303,1224,0,1224,56
2020-05-17,San Benito,069,59416,72,59,0,59,2
2020-05-17,San Bernardino,071,2135413,4530,3467,4,3471,155
2020-05-17,San Diego,073,3302833,6814,5838,0,5838,209
2020-05-17,San Francisco,075,870044,2345,2132,0,2132,36
2020-05-17,San Joaquin,077,732212,784,688,4,692,32
2020-05-17,San Luis Obispo,079,281455,321,242,3,245,1
2020-05-17,San Mateo,081,765935,1942,1680,3,1683,68
2020-05-17,Santa Barbara,083,443738,1577,1457,11,1468,10
2020-05-17,Santa Clara,085,1922200,3088,2453,11,2464,135
2020-05-17,Santa Cruz,087,273765,177,155,0,155,3
2020-05-17,Shasta,089,179085,49,34,0,34,4
2020-05-17,Sierra,091,2930,0,0,0,0,0
2020-05-17,Siskiyou,093,43540,7,6,0,6,0
2020-05-17,Solano,095,438530,484,392,0,392,4
2020-05-17,Sonoma,097,501317,458,376,0,376,4
2020-05-17,Stanislaus,099,539301,647,566,4,570,25
2020-05-17,Sutter,101,95872,42,38,0,38,2
2020-05-17,Tehama,103,63373,3,2,0,2,1
2020-05-17,Trinity,105,12862,2,1,0,1,0
2020-05-17,Tulare,107,460477,1996,1430,7,1437,63
2020-05-17,Tuolumne,109,53932,3,2,0,2,0
2020-05-17,Ventura,111,848112,1226,838,6,844,27
2020-05-17,Yolo,113,214977,192,182,0,182,22
2020-05-17,Yuba,115,75493,26,21,0,21,1
2020-05-16,Alameda,001,1643700,2842,2327,3,2330,83
2020-05-16,Alpine,003,1148,1,1,0,1,0
2020-05-16,Amador,005,37829,10,8,0,8,0
2020-05-16,Butte,007,227075,44,22,1,23,0
2020-05-16,Calaveras,009,45235,14,13,0,13,0
2020-05-16,Colusa,011,21464,3,3,0,3,0
2020-05-16,Contra Costa,013,1133247,1309,1136,1,1137,33
2020-05-16,Del Norte,015,27424,19,4,0,4,0
2020-05-16,El Dorado,017,186661,89,65,0,65,0
2020-05-16,Fresno,019,978130,2234,1177,33,1210,14
2020-05-16,Glenn,021,27897,13,9,0,9,0
2020-05-16,Humboldt,023,135768,92,69,0,69,0
2020-05-16,Imperial,025,180216,1682,712,4,716,14
2020-05-16,Inyo,027,18085,19,20,0,20,1
2020-05-16,Kern,029,883053,1939,1509,3,1512,26
2020-05-16,Kings,031,150075,494,356,2,358,2
2020-05-16,Lake,033,64148,13,7,0,7,0
2020-05-16,Lassen,035,31185,4,0,2,2,0
2020-05-16,Los Angeles,037,10098052,46231,37352,18,37370,1778
2020-05-16,Madera,039,155013,163,70,1,71,2
2020-05-16,Marin,041,260295,346,297,1,298,14
2020-05-16,Mariposa,043,17540,15,15,0,15,1
2020-05-16,Mendocino,045,87422,14,10,0,10,0
2020-05-16,Merced,047,269075,303,201,0,201,5
2020-05-16,Modoc,049,8938,0,0,0,0,0
2020-05-16,Mono,051,14174,36,32,0,32,1
2020-05-16,Monterey,053,433212,409,329,1,330,8
2020-05-16,Napa,055,140530,105,86,0,86,3
2020-05-16,Nevada,057,99092,42,41,1,42,1
2020-05-16,Orange,059,3164182,6521,4396,52,4448,87
2020-05-16,Placer,061,380077,195,174,0,174,8
2020-05-16,Plumas,063,18699,4,4,0,4,0
2020-05-16,Riverside,065,2383286,6772,5633,18,5651,243
2020-05-16,Sacramento,067,1510023,1296,1209,0,1209,55
2020-05-16,San Benito,069,59416,67,58,0,58,2
2020-05-16,San Bernardino,071,2135413,4458,3362,4,3366,155
2020-05-16,San Diego,073,3302833,6728,5664,0,5664,209
2020-05-16,San Francisco,075,870044,2322,2094,0,2094,36
2020-05-16,San Joaquin,077,732212,776,668,4,672,32
2020-05-16,San Luis Obispo,079,281455,320,240,3,243,1
2020-05-16,San Mateo,081,765935,1927,1652,3,1655,68
2020-05-16,Santa Barbara,083,443738,1566,1422,10,1432,10
2020-05-16,Santa Clara,085,1922200,3070,2420,11,2431,135
2020-05-16,Santa Cruz,087,273765,174,154,0,154,3
2020-05-16,Shasta,089,179085,49,33,0,33,4
2020-05-16,Sierra,091,2930,0,0,0,0,0
2020-05-16,Siskiyou,093,43540,7,6,0,6,0
2020-05-16,Solano,095,438530,479,392,0,392,4
2020-05-16,Sonoma,097,501317,445,356,0,356,4
2020-05-16,Stanislaus,099,539301,638,546,4,550,24
2020-05-16,Sutter,101,95872,42,35,0,35,2
2020-05-16,Tehama,103,63373,3,2,0,2,1
2020-05-16,Trinity,105,12862,2,1,0,1,0
2020-05-16,Tulare,107,460477,1978,1426,7,1433,63
2020-05-16,Tuolumne,109,53932,3,2,0,2,0
2020-05-16,Ventura,111,848112,1200,813,6,819,25
2020-05-16,Yolo,113,214977,191,181,0,181,22
2020-05-16,Yuba,115,75493,26,21,0,21,1
2020-05-15,Alameda,001,1643700,2808,2289,3,2292,83
2020-05-15,Alpine,003,1148,1,1,0,1,0
2020-05-15,Amador,005,37829,10,8,0,8,0
2020-05-15,Butte,007,227075,42,22,1,23,0
2020-05-15,Calaveras,009,45235,14,13,0,13,0
2020-05-15,Colusa,011,21464,3,3,0,3,0
2020-05-15,Contra Costa,013,1133247,1291,1106,1,1107,33
2020-05-15,Del Norte,015,27424,14,4,0,4,0
2020-05-15,El Dorado,017,186661,89,64,0,64,0
2020-05-15,Fresno,019,978130,2167,1126,33,1159,14
2020-05-15,Glenn,021,27897,13,9,0,9,0
2020-05-15,Humboldt,023,135768,91,60,0,60,0
2020-05-15,Imperial,025,180216,1598,680,0,680,14
2020-05-15,Inyo,027,18085,19,20,0,20,1
2020-05-15,Kern,029,883053,1883,1472,3,1475,25
2020-05-15,Kings,031,150075,491,347,2,349,2
2020-05-15,Lake,033,64148,13,7,0,7,0
2020-05-15,Lassen,035,31185,4,0,2,2,0
2020-05-15,Los Angeles,037,10098052,45445,36317,18,36335,1734
2020-05-15,Madera,039,155013,162,71,1,72,2
2020-05-15,Marin,041,260295,338,295,1,296,14
2020-05-15,Mariposa,043,17540,15,15,0,15,1
2020-05-15,Mendocino,045,87422,14,10,0,10,0
2020-05-15,Merced,047,269075,300,191,0,191,5
2020-05-15,Modoc,049,8938,0,0,0,0,0
2020-05-15,Mono,051,14174,36,31,0,31,1
2020-05-15,Monterey,053,433212,403,321,1,322,8
2020-05-15,Napa,055,140530,105,83,0,83,3
2020-05-15,Nevada,057,99092,42,41,1,42,1
2020-05-15,Orange,059,3164182,6348,4281,52,4333,87
2020-05-15,Placer,061,380077,193,174,0,174,8
2020-05-15,Plumas,063,18699,4,4,0,4,0
2020-05-15,Riverside,065,2383286,6658,5496,18,5514,233
2020-05-15,Sacramento,067,1510023,1286,1203,0,1203,55
2020-05-15,San Benito,069,59416,64,57,0,57,2
2020-05-15,San Bernardino,071,2135413,4380,3225,4,3229,153
2020-05-15,San Diego,073,3302833,6621,5525,0,5525,208
2020-05-15,San Francisco,075,870044,2306,2062,0,2062,36
2020-05-15,San Joaquin,077,732212,770,656,4,660,32
2020-05-15,San Luis Obispo,079,281455,318,237,3,240,1
2020-05-15,San Mateo,081,765935,1905,1612,3,1615,68
2020-05-15,Santa Barbara,083,443738,1557,1409,9,1418,10
2020-05-15,Santa Clara,085,1922200,3027,2395,10,2405,135
2020-05-15,Santa Cruz,087,273765,173,146,0,146,3
2020-05-15,Shasta,089,179085,48,33,0,33,4
2020-05-15,Sierra,091,2930,0,0,0,0,0
2020-05-15,Siskiyou,093,43540,6,5,0,5,0
2020-05-15,Solano,095,438530,475,388,0,388,4
2020-05-15,Sonoma,097,501317,437,349,0,349,4
2020-05-15,Stanislaus,099,539301,631,540,4,544,23
2020-05-15,Sutter,101,95872,41,35,0,35,2
2020-05-15,Tehama,103,63373,3,1,0,1,1
2020-05-15,Trinity,105,12862,2,1,0,1,0
2020-05-15,Tulare,107,460477,1950,1356,7,1363,61
2020-05-15,Tuolumne,109,53932,3,2,0,2,0
2020-05-15,Ventura,111,848112,1182,789,5,794,25
2020-05-15,Yolo,113,214977,190,182,0,182,22
2020-05-15,Yuba,115,75493,26,21,0,21,1
2020-05-14,Alameda,001,1643700,2715,2255,3,2258,80
2020-05-14,Alpine,003,1148,1,1,0,1,0
2020-05-14,Amador,005,37829,10,8,0,8,0
2020-05-14,Butte,007,227075,40,22,1,23,0
2020-05-14,Calaveras,009,45235,14,13,0,13,0
2020-05-14,Colusa,011,21464,3,3,0,3,0
2020-05-14,Contra Costa,013,1133247,1265,1090,1,1091,32
2020-05-14,Del Norte,015,27424,14,4,0,4,0
2020-05-14,El Dorado,017,186661,80,59,0,59,0
2020-05-14,Fresno,019,978130,2107,1038,29,1067,12
2020-05-14,Glenn,021,27897,12,8,0,8,0
2020-05-14,Humboldt,023,135768,89,59,0,59,0
2020-05-14,Imperial,025,180216,1481,652,0,652,13
2020-05-14,Inyo,027,18085,19,20,0,20,1
2020-05-14,Kern,029,883053,1841,1430,3,1433,21
2020-05-14,Kings,031,150075,475,342,2,344,1
2020-05-14,Lake,033,64148,13,7,0,7,0
2020-05-14,Lassen,035,31185,4,0,2,2,0
2020-05-14,Los Angeles,037,10098052,44270,35427,18,35445,1693
2020-05-14,Madera,039,155013,153,69,1,70,2
2020-05-14,Marin,041,260295,320,283,1,284,14
2020-05-14,Mariposa,043,17540,15,15,0,15,0
2020-05-14,Mendocino,045,87422,13,10,0,10,0
2020-05-14,Merced,047,269075,290,182,0,182,3
2020-05-14,Modoc,049,8938,0,0,0,0,0
2020-05-14,Mono,051,14174,36,31,0,31,1
2020-05-14,Monterey,053,433212,393,317,1,318,7
2020-05-14,Napa,055,140530,103,83,0,83,3
2020-05-14,Nevada,057,99092,41,41,1,42,1
2020-05-14,Orange,059,3164182,6172,4163,50,4213,83
2020-05-14,Placer,061,380077,193,172,0,172,8
2020-05-14,Plumas,063,18699,4,4,0,4,0
2020-05-14,Riverside,065,2383286,6474,5339,18,5357,224
2020-05-14,Sacramento,067,1510023,1274,1181,0,1181,55
2020-05-14,San Benito,069,59416,62,56,0,56,2
2020-05-14,San Bernardino,071,2135413,4201,3149,4,3153,149
2020-05-14,San Diego,073,3302833,6486,5393,0,5393,200
2020-05-14,San Francisco,075,870044,2273,2029,0,2029,36
2020-05-14,San Joaquin,077,732212,755,643,4,647,31
2020-05-14,San Luis Obispo,079,281455,315,236,3,239,1
2020-05-14,San Mateo,081,765935,1873,1588,3,1591,67
2020-05-14,Santa Barbara,083,443738,1545,1395,9,1404,11
2020-05-14,Santa Clara,085,1922200,3004,2380,10,2390,134
2020-05-14,Santa Cruz,087,273765,171,145,0,145,3
2020-05-14,Shasta,089,179085,48,33,0,33,4
2020-05-14,Sierra,091,2930,0,0,0,0,0
2020-05-14,Siskiyou,093,43540,6,5,0,5,0
2020-05-14,Solano,095,438530,466,372,0,372,4
2020-05-14,Sonoma,097,501317,420,333,0,333,4
2020-05-14,Stanislaus,099,539301,612,533,4,537,23
2020-05-14,Sutter,101,95872,41,34,0,34,2
2020-05-14,Tehama,103,63373,3,1,0,1,1
2020-05-14,Trinity,105,12862,2,1,0,1,0
2020-05-14,Tulare,107,460477,1911,1317,7,1324,55
2020-05-14,Tuolumne,109,53932,3,2,0,2,0
2020-05-14,Ventura,111,848112,1151,760,5,765,25
2020-05-14,Yolo,113,214977,190,180,0,180,22
2020-05-14,Yuba,115,75493,26,21,0,21,1
2020-05-13,Alameda,001,1643700,2657,2181,3,2184,78
2020-05-13,Alpine,003,1148,1,1,0,1,0
2020-05-13,Amador,005,37829,10,8,0,8,0
2020-05-13,Butte,007,227075,40,21,1,22,0
2020-05-13,Calaveras,009,45235,14,13,0,13,0
2020-05-13,Colusa,011,21464,3,3,0,3,0
2020-05-13,Contra Costa,013,1133247,1243,1082,1,1083,32
2020-05-13,Del Norte,015,27424,13,4,0,4,0
2020-05-13,El Dorado,017,186661,79,58,0,58,0
2020-05-13,Fresno,019,978130,2010,993,29,1022,10
2020-05-13,Glenn,021,27897,11,6,0,6,0
2020-05-13,Humboldt,023,135768,83,58,0,58,0
2020-05-13,Imperial,025,180216,1411,610,0,610,11
2020-05-13,Inyo,027,18085,19,20,0,20,1
2020-05-13,Kern,029,883053,1795,1390,3,1393,19
2020-05-13,Kings,031,150075,461,314,2,316,1
2020-05-13,Lake,033,64148,13,7,0,7,0
2020-05-13,Lassen,035,31185,4,0,2,2,0
2020-05-13,Los Angeles,037,10098052,42964,34574,18,34592,1643
2020-05-13,Madera,039,155013,144,69,1,70,2
2020-05-13,Marin,041,260295,307,278,1,279,14
2020-05-13,Mariposa,043,17540,15,15,0,15,0
2020-05-13,Mendocino,045,87422,13,10,0,10,0
2020-05-13,Merced,047,269075,287,176,0,176,3
2020-05-13,Modoc,049,8938,0,0,0,0,0
2020-05-13,Mono,051,14174,35,31,0,31,1
2020-05-13,Monterey,053,433212,383,309,1,310,6
2020-05-13,Napa,055,140530,103,81,0,81,3
2020-05-13,Nevada,057,99092,41,41,1,42,1
2020-05-13,Orange,059,3164182,5926,4025,48,4073,79
2020-05-13,Placer,061,380077,192,170,0,170,8
2020-05-13,Plumas,063,18699,4,4,0,4,0
2020-05-13,Riverside,065,2383286,6351,5204,18,5222,216
2020-05-13,Sacramento,067,1510023,1259,1173,0,1173,53
2020-05-13,San Benito,069,59416,62,55,0,55,2
2020-05-13,San Bernardino,071,2135413,3945,3064,3,3067,140
2020-05-13,San Diego,073,3302833,6350,5280,0,5280,194
2020-05-13,San Francisco,075,870044,2245,2004,0,2004,35
2020-05-13,San Joaquin,077,732212,734,639,3,642,31
2020-05-13,San Luis Obispo,079,281455,313,231,3,234,1
2020-05-13,San Mateo,081,765935,1841,1550,3,1553,66
2020-05-13,Santa Barbara,083,443738,1534,1382,9,1391,10
2020-05-13,Santa Clara,085,1922200,2984,2370,10,2380,132
2020-05-13,Santa Cruz,087,273765,167,142,0,142,2
2020-05-13,Shasta,089,179085,48,32,0,32,4
2020-05-13,Sierra,091,2930,0,0,0,0,0
2020-05-13,Siskiyou,093,43540,6,5,0,5,0
2020-05-13,Solano,095,438530,453,368,0,368,4
2020-05-13,Sonoma,097,501317,410,330,0,330,4
2020-05-13,Stanislaus,099,539301,603,521,4,525,15
2020-05-13,Sutter,101,95872,41,33,0,33,2
2020-05-13,Tehama,103,63373,3,1,0,1,1
2020-05-13,Trinity,105,12862,2,2,0,2,0
2020-05-13,Tulare,107,460477,1878,1283,7,1290,54
2020-05-13,Tuolumne,109,53932,3,2,0,2,0
2020-05-13,Ventura,111,848112,1120,742,5,747,25
2020-05-13,Yolo,113,214977,188,178,0,178,22
2020-05-13,Yuba,115,75493,24,19,0,19,1
2020-05-12,Alameda,001,1643700,2592,2146,3,2149,74
2020-05-12,Alpine,003,1148,1,1,0,1,0
2020-05-12,Amador,005,37829,10,8,0,8,0
2020-05-12,Butte,007,227075,38,20,1,21,0
2020-05-12,Calaveras,009,45235,13,13,0,13,0
2020-05-12,Colusa,011,21464,3,3,0,3,0
2020-05-12,Contra Costa,013,1133247,1212,1067,1,1068,32
2020-05-12,Del Norte,015,27424,10,3,0,3,0
2020-05-12,El Dorado,017,186661,76,56,0,56,0
2020-05-12,Fresno,019,978130,1926,978,27,1005,9
2020-05-12,Glenn,021,27897,10,6,0,6,0
2020-05-12,Humboldt,023,135768,80,58,0,58,0
2020-05-12,Imperial,025,180216,1280,602,0,602,9
2020-05-12,Inyo,027,18085,19,20,0,20,1
2020-05-12,Kern,029,883053,1754,1363,3,1366,18
2020-05-12,Kings,031,150075,440,302,2,304,1
2020-05-12,Lake,033,64148,13,7,0,7,0
2020-05-12,Lassen,035,31185,4,0,2,2,0
2020-05-12,Los Angeles,037,10098052,41970,33281,17,33298,1601
2020-05-12,Madera,039,155013,138,69,1,70,2
2020-05-12,Marin,041,260295,302,274,1,275,14
2020-05-12,Mariposa,043,17540,15,15,0,15,0
2020-05-12,Mendocino,045,87422,13,10,0,10,0
2020-05-12,Merced,047,269075,276,175,0,175,3
2020-05-12,Modoc,049,8938,0,0,0,0,0
2020-05-12,Mono,051,14174,35,31,0,31,1
2020-05-12,Monterey,053,433212,376,298,1,299,6
2020-05-12,Napa,055,140530,101,80,0,80,3
2020-05-12,Nevada,057,99092,41,41,1,42,1
2020-05-12,Orange,059,3164182,5743,3843,46,3889,78
2020-05-12,Placer,061,380077,191,170,0,170,8
2020-05-12,Plumas,063,18699,4,4,0,4,0
2020-05-12,Riverside,065,2383286,6229,5134,18,5152,210
2020-05-12,Sacramento,067,1510023,1239,1166,0,1166,52
2020-05-12,San Benito,069,59416,62,55,0,55,2
2020-05-12,San Bernardino,071,2135413,3793,2997,3,3000,131
2020-05-12,San Diego,073,3302833,6206,3,0,3,0
2020-05-12,San Francisco,075,870044,2210,1981,0,1981,35
2020-05-12,San Joaquin,077,732212,719,625,3,628,30
2020-05-12,San Luis Obispo,079,281455,310,226,3,229,1
2020-05-12,San Mateo,081,765935,1815,1533,3,1536,66
2020-05-12,Santa Barbara,083,443738,1503,1377,9,1386,10
2020-05-12,Santa Clara,085,1922200,2954,2362,10,2372,131
2020-05-12,Santa Cruz,087,273765,165,141,0,141,2
2020-05-12,Shasta,089,179085,47,33,0,33,4
2020-05-12,Sierra,091,2930,0,0,0,0,0
2020-05-12,Siskiyou,093,43540,6,5,0,5,0
2020-05-12,Solano,095,438530,445,361,0,361,4
2020-05-12,Sonoma,097,501317,387,308,0,308,4
2020-05-12,Stanislaus,099,539301,596,515,4,519,15
2020-05-12,Sutter,101,95872,41,33,0,33,2
2020-05-12,Tehama,103,63373,3,1,0,1,1
2020-05-12,Trinity,105,12862,2,1,0,1,0
2020-05-12,Tulare,107,460477,1846,1261,7,1268,52
2020-05-12,Tuolumne,109,53932,3,2,0,2,0
2020-05-12,Ventura,111,848112,1064,718,5,723,20
2020-05-12,Yolo,113,214977,187,176,0,176,22
2020-05-12,Yuba,115,75493,24,19,0,19,1
2020-05-11,Alameda,001,1643700,2542,2103,3,2106,71
2020-05-11,Alpine,003,1148,1,1,0,1,0
2020-05-11,Amador,005,37829,10,8,0,8,0
2020-05-11,Butte,007,227075,37,19,1,20,0
2020-05-11,Calaveras,009,45235,13,13,0,13,0
2020-05-11,Colusa,011,21464,3,3,0,3,0
2020-05-11,Contra Costa,013,1133247,1198,1052,1,1053,32
2020-05-11,Del Norte,015,27424,8,3,0,3,0
2020-05-11,El Dorado,017,186661,76,55,0,55,0
2020-05-11,Fresno,019,978130,1835,937,26,963,8
2020-05-11,Glenn,021,27897,10,6,0,6,0
2020-05-11,Humboldt,023,135768,77,56,0,56,0
2020-05-11,Imperial,025,180216,1174,562,0,562,9
2020-05-11,Inyo,027,18085,19,20,0,20,1
2020-05-11,Kern,029,883053,1702,1331,3,1334,17
2020-05-11,Kings,031,150075,417,289,1,290,1
2020-05-11,Lake,033,64148,12,7,0,7,0
2020-05-11,Lassen,035,31185,4,0,2,2,0
2020-05-11,Los Angeles,037,10098052,40791,32279,17,32296,1553
2020-05-11,Madera,039,155013,129,68,1,69,2
2020-05-11,Marin,041,260295,293,271,1,272,14
2020-05-11,Mariposa,043,17540,15,15,0,15,0
2020-05-11,Mendocino,045,87422,13,10,0,10,0
2020-05-11,Merced,047,269075,261,158,0,158,3
2020-05-11,Modoc,049,8938,0,0,0,0,0
2020-05-11,Mono,051,14174,35,30,0,30,1
2020-05-11,Monterey,053,433212,373,286,1,287,6
2020-05-11,Napa,055,140530,95,79,0,79,2
2020-05-11,Nevada,057,99092,41,41,1,42,1
2020-05-11,Orange,059,3164182,5528,3699,39,3738,77
2020-05-11,Placer,061,380077,191,170,0,170,8
2020-05-11,Plumas,063,18699,4,4,0,4,0
2020-05-11,Riverside,065,2383286,6071,5082,17,5099,203
2020-05-11,Sacramento,067,1510023,1224,1160,0,1160,52
2020-05-11,San Benito,069,59416,60,52,0,52,2
2020-05-11,San Bernardino,071,2135413,3683,2945,3,2948,124
2020-05-11,San Diego,073,3302833,6053,5067,0,5067,175
2020-05-11,San Francisco,075,870044,2163,1974,0,1974,35
2020-05-11,San Joaquin,077,732212,709,620,3,623,30
2020-05-11,San Luis Obispo,079,281455,308,224,3,227,1
2020-05-11,San Mateo,081,765935,1789,1499,2,1501,66
2020-05-11,Santa Barbara,083,443738,1492,1372,8,1380,10
2020-05-11,Santa Clara,085,1922200,2937,2340,10,2350,129
2020-05-11,Santa Cruz,087,273765,162,140,0,140,2
2020-05-11,Shasta,089,179085,47,31,0,31,4
2020-05-11,Sierra,091,2930,0,0,0,0,0
2020-05-11,Siskiyou,093,43540,6,5,0,5,0
2020-05-11,Solano,095,438530,440,354,0,354,4
2020-05-11,Sonoma,097,501317,377,303,0,303,3
2020-05-11,Stanislaus,099,539301,586,507,4,511,14
2020-05-11,Sutter,101,95872,40,32,0,32,2
2020-05-11,Tehama,103,63373,3,1,0,1,1
2020-05-11,Trinity,105,12862,2,1,0,1,0
2020-05-11,Tulare,107,460477,1797,1203,7,1210,49
2020-05-11,Tuolumne,109,53932,3,2,0,2,0
2020-05-11,Ventura,111,848112,1003,698,4,702,19
2020-05-11,Yolo,113,214977,187,174,0,174,20
2020-05-11,Yuba,115,75493,24,18,0,18,1
2020-05-10,Alameda,001,1643700,2465,2047,3,2050,71
2020-05-10,Alpine,003,1148,1,1,0,1,0
2020-05-10,Amador,005,37829,10,8,0,8,0
2020-05-10,Butte,007,227075,32,18,1,19,0
2020-05-10,Calaveras,009,45235,13,13,0,13,0
2020-05-10,Colusa,011,21464,3,3,0,3,0
2020-05-10,Contra Costa,013,1133247,1184,1046,0,1046,31
2020-05-10,Del Norte,015,27424,7,3,0,3,0
2020-05-10,El Dorado,017,186661,76,55,0,55,0
2020-05-10,Fresno,019,978130,1750,894,26,920,8
2020-05-10,Glenn,021,27897,10,6,0,6,0
2020-05-10,Humboldt,023,135768,73,56,0,56,0
2020-05-10,Imperial,025,180216,1079,509,0,509,7
2020-05-10,Inyo,027,18085,19,20,0,20,1
2020-05-10,Kern,029,883053,1651,1300,2,1302,16
2020-05-10,Kings,031,150075,404,266,1,267,1
2020-05-10,Lake,033,64148,12,7,0,7,0
2020-05-10,Lassen,035,31185,4,0,2,2,0
2020-05-10,Los Angeles,037,10098052,39533,31711,17,31728,1514
2020-05-10,Madera,039,155013,127,65,1,66,2
2020-05-10,Marin,041,260295,285,267,1,268,14
2020-05-10,Mariposa,043,17540,15,15,0,15,0
2020-05-10,Mendocino,045,87422,12,10,0,10,0
2020-05-10,Merced,047,269075,246,154,0,154,3
2020-05-10,Modoc,049,8938,0,0,0,0,0
2020-05-10,Mono,051,14174,35,27,0,27,1
2020-05-10,Monterey,053,433212,359,282,1,283,6
2020-05-10,Napa,055,140530,89,79,0,79,2
2020-05-10,Nevada,057,99092,41,41,1,42,1
2020-05-10,Orange,059,3164182,5385,3627,39,3666,76
2020-05-10,Placer,061,380077,190,168,0,168,8
2020-05-10,Plumas,063,18699,4,4,0,4,0
2020-05-10,Riverside,065,2383286,5949,4951,17,4968,193
2020-05-10,Sacramento,067,1510023,1208,1152,0,1152,52
2020-05-10,San Benito,069,59416,60,52,0,52,2
2020-05-10,San Bernardino,071,2135413,3585,2910,3,2913,121
2020-05-10,San Diego,073,3302833,5901,4928,0,4928,175
2020-05-10,San Francisco,075,870044,2145,1953,0,1953,35
2020-05-10,San Joaquin,077,732212,694,611,3,614,29
2020-05-10,San Luis Obispo,079,281455,305,218,3,221,1
2020-05-10,San Mateo,081,765935,1767,1463,2,1465,65
2020-05-10,Santa Barbara,083,443738,1481,1323,8,1331,10
2020-05-10,Santa Clara,085,1922200,2910,2331,10,2341,129
2020-05-10,Santa Cruz,087,273765,161,139,0,139,2
2020-05-10,Shasta,089,179085,47,31,0,31,4
2020-05-10,Sierra,091,2930,0,0,0,0,0
2020-05-10,Siskiyou,093,43540,5,5,0,5,0
2020-05-10,Solano,095,438530,430,322,0,322,4
2020-05-10,Sonoma,097,501317,367,290,0,290,3
2020-05-10,Stanislaus,099,539301,579,498,4,502,14
2020-05-10,Sutter,101,95872,37,31,0,31,2
2020-05-10,Tehama,103,63373,3,1,0,1,1
2020-05-10,Trinity,105,12862,2,1,0,1,0
2020-05-10,Tulare,107,460477,1726,1143,7,1150,47
2020-05-10,Tuolumne,109,53932,3,2,0,2,0
2020-05-10,Ventura,111,848112,945,690,2,692,19
2020-05-10,Yolo,113,214977,187,173,0,173,20
2020-05-10,Yuba,115,75493,23,17,0,17,1
2020-05-09,Alameda,001,1643700,2422,2011,3,2014,71
2020-05-09,Alpine,003,1148,1,1,0,1,0
2020-05-09,Amador,005,37829,9,8,0,8,0
2020-05-09,Butte,007,227075,31,18,1,19,0
2020-05-09,Calaveras,009,45235,13,13,0,13,0
2020-05-09,Colusa,011,21464,3,3,0,3,0
2020-05-09,Contra Costa,013,1133247,1170,1039,0,1039,31
2020-05-09,Del Norte,015,27424,7,3,0,3,0
2020-05-09,El Dorado,017,186661,73,54,0,54,0
2020-05-09,Fresno,019,978130,1712,861,25,886,8
2020-05-09,Glenn,021,27897,9,6,0,6,0
2020-05-09,Humboldt,023,135768,71,55,0,55,0
2020-05-09,Imperial,025,180216,1023,474,0,474,7
2020-05-09,Inyo,027,18085,19,20,0,20,1
2020-05-09,Kern,029,883053,1615,1262,1,1263,15
2020-05-09,Kings,031,150075,399,264,1,265,1
2020-05-09,Lake,033,64148,12,7,0,7,0
2020-05-09,Lassen,035,31185,4,0,2,2,0
2020-05-09,Los Angeles,037,10098052,38911,31268,17,31285,1499
2020-05-09,Madera,039,155013,126,61,1,62,2
2020-05-09,Marin,041,260295,284,261,1,262,14
2020-05-09,Mariposa,043,17540,15,15,0,15,0
2020-05-09,Mendocino,045,87422,12,10,0,10,0
2020-05-09,Merced,047,269075,242,153,0,153,3
2020-05-09,Modoc,049,8938,0,0,0,0,0
2020-05-09,Mono,051,14174,35,27,0,27,1
2020-05-09,Monterey,053,433212,352,273,1,274,6
2020-05-09,Napa,055,140530,88,78,0,78,2
2020-05-09,Nevada,057,99092,41,41,1,42,1
2020-05-09,Orange,059,3164182,5303,3506,38,3544,75
2020-05-09,Placer,061,380077,189,168,0,168,8
2020-05-09,Plumas,063,18699,4,4,0,4,0
2020-05-09,Riverside,065,2383286,5854,4871,17,4888,183
2020-05-09,Sacramento,067,1510023,1204,1150,0,1150,52
2020-05-09,San Benito,069,59416,59,52,0,52,2
2020-05-09,San Bernardino,071,2135413,3529,2825,3,2828,121
2020-05-09,San Diego,073,3302833,5789,4778,0,4778,175
2020-05-09,San Francisco,075,870044,2130,1944,0,1944,34
2020-05-09,San Joaquin,077,732212,685,605,3,608,28
2020-05-09,San Luis Obispo,079,281455,301,213,3,216,1
2020-05-09,San Mateo,081,765935,1748,1453,2,1455,65
2020-05-09,Santa Barbara,083,443738,1473,1245,8,1253,10
2020-05-09,Santa Clara,085,1922200,2896,2317,10,2327,128
2020-05-09,Santa Cruz,087,273765,160,138,0,138,2
2020-05-09,Shasta,089,179085,47,31,0,31,4
2020-05-09,Sierra,091,2930,0,0,0,0,0
2020-05-09,Siskiyou,093,43540,5,5,0,5,0
2020-05-09,Solano,095,438530,424,321,0,321,4
2020-05-09,Sonoma,097,501317,363,288,0,288,3
2020-05-09,Stanislaus,099,539301,571,491,4,495,12
2020-05-09,Sutter,101,95872,37,31,0,31,2
2020-05-09,Tehama,103,63373,2,1,0,1,1
2020-05-09,Trinity,105,12862,2,1,0,1,0
2020-05-09,Tulare,107,460477,1698,1083,7,1090,47
2020-05-09,Tuolumne,109,53932,3,2,0,2,0
2020-05-09,Ventura,111,848112,924,679,2,681,19
2020-05-09,Yolo,113,214977,187,172,0,172,18
2020-05-09,Yuba,115,75493,23,17,0,17,1
2020-05-08,Alameda,001,1643700,2379,1955,3,1958,70
2020-05-08,Alpine,003,1148,1,1,0,1,0
2020-05-08,Amador,005,37829,9,8,0,8,0
2020-05-08,Butte,007,227075,31,18,1,19,0
2020-05-08,Calaveras,009,45235,13,13,0,13,0
2020-05-08,Colusa,011,21464,3,3,0,3,0
2020-05-08,Contra Costa,013,1133247,1158,1024,0,1024,29
2020-05-08,Del Norte,015,27424,7,3,0,3,0
2020-05-08,El Dorado,017,186661,72,54,0,54,0
2020-05-08,Fresno,019,978130,1670,838,23,861,8
2020-05-08,Glenn,021,27897,8,6,0,6,0
2020-05-08,Humboldt,023,135768,68,54,0,54,0
2020-05-08,Imperial,025,180216,979,467,0,467,7
2020-05-08,Inyo,027,18085,19,20,0,20,1
2020-05-08,Kern,029,883053,1584,1214,1,1215,13
2020-05-08,Kings,031,150075,390,236,1,237,1
2020-05-08,Lake,033,64148,12,7,0,7,0
2020-05-08,Lassen,035,31185,4,0,2,2,0
2020-05-08,Los Angeles,037,10098052,38178,30357,17,30374,1447
2020-05-08,Madera,039,155013,123,57,1,58,2
2020-05-08,Marin,041,260295,284,257,1,258,14
2020-05-08,Mariposa,043,17540,15,15,0,15,0
2020-05-08,Mendocino,045,87422,12,10,0,10,0
2020-05-08,Merced,047,269075,241,151,0,151,3
2020-05-08,Modoc,049,8938,0,0,0,0,0
2020-05-08,Mono,051,14174,32,27,0,27,1
2020-05-08,Monterey,053,433212,344,265,1,266,6
2020-05-08,Napa,055,140530,87,78,0,78,2
2020-05-08,Nevada,057,99092,41,41,1,42,1
2020-05-08,Orange,059,3164182,5157,3395,38,3433,72
2020-05-08,Placer,061,380077,187,166,0,166,8
2020-05-08,Plumas,063,18699,4,4,0,4,0
2020-05-08,Riverside,065,2383286,5754,4672,16,4688,181
2020-05-08,Sacramento,067,1510023,1199,1145,0,1145,51
2020-05-08,San Benito,069,59416,59,51,0,51,2
2020-05-08,San Bernardino,071,2135413,3481,2631,3,2634,119
2020-05-08,San Diego,073,3302833,5682,4664,0,4664,169
2020-05-08,San Francisco,075,870044,2112,1890,0,1890,33
2020-05-08,San Joaquin,077,732212,678,595,3,598,28
2020-05-08,San Luis Obispo,079,281455,298,210,3,213,1
2020-05-08,San Mateo,081,765935,1663,1423,2,1425,62
2020-05-08,Santa Barbara,083,443738,1464,1054,6,1060,8
2020-05-08,Santa Clara,085,1922200,2873,2285,10,2295,128
2020-05-08,Santa Cruz,087,273765,156,137,0,137,2
2020-05-08,Shasta,089,179085,47,31,0,31,4
2020-05-08,Sierra,091,2930,0,0,0,0,0
2020-05-08,Siskiyou,093,43540,5,5,0,5,0
2020-05-08,Solano,095,438530,419,314,0,314,4
2020-05-08,Sonoma,097,501317,358,285,0,285,3
2020-05-08,Stanislaus,099,539301,557,487,4,491,12
2020-05-08,Sutter,101,95872,37,30,0,30,2
2020-05-08,Tehama,103,63373,2,1,0,1,1
2020-05-08,Trinity,105,12862,2,0,0,0,0
2020-05-08,Tulare,107,460477,1653,1050,6,1056,43
2020-05-08,Tuolumne,109,53932,3,2,0,2,0
2020-05-08,Ventura,111,848112,906,665,2,667,19
2020-05-08,Yolo,113,214977,186,172,0,172,18
2020-05-08,Yuba,115,75493,22,16,0,16,1
2020-05-07,Alameda,001,1643700,2319,1914,3,1917,68
2020-05-07,Alpine,003,1148,1,1,0,1,0
2020-05-07,Amador,005,37829,9,8,0,8,0
2020-05-07,Butte,007,227075,31,19,1,20,0
2020-05-07,Calaveras,009,45235,13,13,0,13,0
2020-05-07,Colusa,011,21464,3,3,0,3,0
2020-05-07,Contra Costa,013,1133247,1144,1005,0,1005,29
2020-05-07,Del Norte,015,27424,6,3,0,3,0
2020-05-07,El Dorado,017,186661,71,54,0,54,0
2020-05-07,Fresno,019,978130,1584,812,22,834,8
2020-05-07,Glenn,021,27897,8,5,0,5,0
2020-05-07,Humboldt,023,135768,67,54,0,54,0
2020-05-07,Imperial,025,180216,916,442,0,442,6
2020-05-07,Inyo,027,18085,19,20,0,20,1
2020-05-07,Kern,029,883053,1540,1176,1,1177,13
2020-05-07,Kings,031,150075,367,219,1,220,1
2020-05-07,Lake,033,64148,11,7,0,7,0
2020-05-07,Lassen,035,31185,4,0,2,2,0
2020-05-07,Los Angeles,037,10098052,37057,29544,17,29561,1399
2020-05-07,Madera,039,155013,119,54,1,55,2
2020-05-07,Marin,041,260295,277,252,1,253,14
2020-05-07,Mariposa,043,17540,15,15,0,15,0
2020-05-07,Mendocino,045,87422,12,10,0,10,0
2020-05-07,Merced,047,269075,233,146,0,146,3
2020-05-07,Modoc,049,8938,0,0,0,0,0
2020-05-07,Mono,051,14174,32,26,0,26,1
2020-05-07,Monterey,053,433212,336,249,1,250,6
2020-05-07,Napa,055,140530,87,78,0,78,2
2020-05-07,Nevada,057,99092,41,41,1,42,1
2020-05-07,Orange,059,3164182,4972,3283,37,3320,69
2020-05-07,Placer,061,380077,187,165,0,165,8
2020-05-07,Plumas,063,18699,4,4,0,4,0
2020-05-07,Riverside,065,2383286,5638,4608,16,4624,170
2020-05-07,Sacramento,067,1510023,1193,1139,0,1139,50
2020-05-07,San Benito,069,59416,59,50,0,50,2
2020-05-07,San Bernardino,071,2135413,3389,2522,3,2525,115
2020-05-07,San Diego,073,3302833,5525,4431,0,4431,165
2020-05-07,San Francisco,075,870044,2081,1852,0,1852,33
2020-05-07,San Joaquin,077,732212,665,583,3,586,28
2020-05-07,San Luis Obispo,079,281455,287,209,3,212,1
2020-05-07,San Mateo,081,765935,1641,1398,2,1400,58
2020-05-07,Santa Barbara,083,443738,1437,720,5,725,8
2020-05-07,Santa Clara,085,1922200,2835,2281,10,2291,127
2020-05-07,Santa Cruz,087,273765,153,136,0,136,2
2020-05-07,Shasta,089,179085,46,31,0,31,4
2020-05-07,Sierra,091,2930,0,0,0,0,0
2020-05-07,Siskiyou,093,43540,5,5,0,5,0
2020-05-07,Solano,095,438530,413,307,0,307,4
2020-05-07,Sonoma,097,501317,346,282,0,282,3
2020-05-07,Stanislaus,099,539301,548,466,4,470,10
2020-05-07,Sutter,101,95872,37,29,0,29,2
2020-05-07,Tehama,103,63373,2,1,0,1,1
2020-05-07,Trinity,105,12862,2,0,0,0,0
2020-05-07,Tulare,107,460477,1585,1001,6,1007,41
2020-05-07,Tuolumne,109,53932,3,2,0,2,0
2020-05-07,Ventura,111,848112,882,647,1,648,19
2020-05-07,Yolo,113,214977,185,172,0,172,18
2020-05-07,Yuba,115,75493,22,16,0,16,1
2020-05-06,Alameda,001,1643700,2281,1864,3,1867,67
2020-05-06,Alpine,003,1148,1,1,0,1,0
2020-05-06,Amador,005,37829,9,8,0,8,0
2020-05-06,Butte,007,227075,30,19,1,20,0
2020-05-06,Calaveras,009,45235,13,13,0,13,0
2020-05-06,Colusa,011,21464,3,3,0,3,0
2020-05-06,Contra Costa,013,1133247,1123,990,0,990,29
2020-05-06,Del Norte,015,27424,6,3,0,3,0
2020-05-06,El Dorado,017,186661,69,53,0,53,0
2020-05-06,Fresno,019,978130,1521,773,20,793,8
2020-05-06,Glenn,021,27897,8,3,0,3,0
2020-05-06,Humboldt,023,135768,66,54,0,54,0
2020-05-06,Imperial,025,180216,848,399,0,399,6
2020-05-06,Inyo,027,18085,19,20,0,20,1
2020-05-06,Kern,029,883053,1484,1112,1,1113,12
2020-05-06,Kings,031,150075,349,208,1,209,1
2020-05-06,Lake,033,64148,11,7,0,7,0
2020-05-06,Lassen,035,31185,4,0,2,2,0
2020-05-06,Los Angeles,037,10098052,36053,28687,17,28704,1347
2020-05-06,Madera,039,155013,117,55,1,56,2
2020-05-06,Marin,041,260295,270,244,1,245,14
2020-05-06,Mariposa,043,17540,15,14,0,14,0
2020-05-06,Mendocino,045,87422,12,10,0,10,0
2020-05-06,Merced,047,269075,226,140,0,140,3
2020-05-06,Modoc,049,8938,0,0,0,0,0
2020-05-06,Mono,051,14174,32,26,0,26,1
2020-05-06,Monterey,053,433212,328,246,1,247,6
2020-05-06,Napa,055,140530,86,78,0,78,2
2020-05-06,Nevada,057,99092,41,41,1,42,1
2020-05-06,Orange,059,3164182,4788,3156,36,3192,66
2020-05-06,Placer,061,380077,184,164,0,164,8
2020-05-06,Plumas,063,18699,4,4,0,4,0
2020-05-06,Riverside,065,2383286,5494,4535,16,4551,163
2020-05-06,Sacramento,067,1510023,1187,1135,0,1135,49
2020-05-06,San Benito,069,59416,58,50,0,50,2
2020-05-06,San Bernardino,071,2135413,3267,2426,2,2428,110
2020-05-06,San Diego,073,3302833,5392,4321,0,4321,158
2020-05-06,San Francisco,075,870044,2056,1804,0,1804,32
2020-05-06,San Joaquin,077,732212,652,581,3,584,28
2020-05-06,San Luis Obispo,079,281455,284,207,3,210,1
2020-05-06,San Mateo,081,765935,1610,1348,2,1350,57
2020-05-06,Santa Barbara,083,443738,1396,565,4,569,8
2020-05-06,Santa Clara,085,1922200,2818,2270,9,2279,127
2020-05-06,Santa Cruz,087,273765,149,135,0,135,2
2020-05-06,Shasta,089,179085,45,31,0,31,4
2020-05-06,Sierra,091,2930,0,0,0,0,0
2020-05-06,Siskiyou,093,43540,5,5,0,5,0
2020-05-06,Solano,095,438530,403,300,0,300,4
2020-05-06,Sonoma,097,501317,330,269,0,269,3
2020-05-06,Stanislaus,099,539301,532,434,4,438,9
2020-05-06,Sutter,101,95872,37,29,0,29,2
2020-05-06,Tehama,103,63373,2,1,0,1,1
2020-05-06,Trinity,105,12862,2,0,0,0,0
2020-05-06,Tulare,107,460477,1537,963,6,969,40
2020-05-06,Tuolumne,109,53932,3,2,0,2,0
2020-05-06,Ventura,111,848112,855,619,1,620,19
2020-05-06,Yolo,113,214977,184,172,0,172,18
2020-05-06,Yuba,115,75493,22,15,0,15,1
2020-05-05,Alameda,001,1643700,2238,1819,3,1822,67
2020-05-05,Alpine,003,1148,1,1,0,1,0
2020-05-05,Amador,005,37829,9,8,0,8,0
2020-05-05,Butte,007,227075,29,19,1,20,0
2020-05-05,Calaveras,009,45235,13,13,0,13,0
2020-05-05,Colusa,011,21464,3,3,0,3,0
2020-05-05,Contra Costa,013,1133247,1105,976,0,976,29
2020-05-05,Del Norte,015,27424,6,3,0,3,0
2020-05-05,El Dorado,017,186661,67,54,0,54,0
2020-05-05,Fresno,019,978130,1448,726,18,744,8
2020-05-05,Glenn,021,27897,8,3,0,3,0
2020-05-05,Humboldt,023,135768,63,54,0,54,0
2020-05-05,Imperial,025,180216,793,389,0,389,6
2020-05-05,Inyo,027,18085,19,20,0,20,1
2020-05-05,Kern,029,883053,1432,1084,1,1085,11
2020-05-05,Kings,031,150075,331,187,1,188,1
2020-05-05,Lake,033,64148,10,7,0,7,0
2020-05-05,Lassen,035,31185,4,0,2,2,0
2020-05-05,Los Angeles,037,10098052,34981,27867,17,27884,1289
2020-05-05,Madera,039,155013,113,53,1,54,2
2020-05-05,Marin,041,260295,264,244,1,245,14
2020-05-05,Mariposa,043,17540,15,14,0,14,0
2020-05-05,Mendocino,045,87422,12,10,0,10,0
2020-05-05,Merced,047,269075,221,141,0,141,3
2020-05-05,Modoc,049,8938,0,0,0,0,0
2020-05-05,Mono,051,14174,32,25,0,25,1
2020-05-05,Monterey,053,433212,314,240,1,241,6
2020-05-05,Napa,055,140530,86,74,0,74,2
2020-05-05,Nevada,057,99092,41,41,1,42,1
2020-05-05,Orange,059,3164182,4664,3041,36,3077,63
2020-05-05,Placer,061,380077,184,162,0,162,8
2020-05-05,Plumas,063,18699,4,4,0,4,0
2020-05-05,Riverside,065,2383286,5384,4309,16,4325,161
2020-05-05,Sacramento,067,1510023,1180,1125,0,1125,48
2020-05-05,San Benito,069,59416,57,50,0,50,2
2020-05-05,San Bernardino,071,2135413,3174,2345,2,2347,104
2020-05-05,San Diego,073,3302833,5249,4162,0,4162,150
2020-05-05,San Francisco,075,870044,2021,1779,0,1779,31
2020-05-05,San Joaquin,077,732212,643,577,3,580,26
2020-05-05,San Luis Obispo,079,281455,282,203,3,206,1
2020-05-05,San Mateo,081,765935,1578,1335,2,1337,56
2020-05-05,Santa Barbara,083,443738,1175,541,4,545,7
2020-05-05,Santa Clara,085,1922200,2772,2249,8,2257,124
2020-05-05,Santa Cruz,087,273765,146,134,0,134,2
2020-05-05,Shasta,089,179085,44,31,0,31,4
2020-05-05,Sierra,091,2930,0,0,0,0,0
2020-05-05,Siskiyou,093,43540,5,5,0,5,0
2020-05-05,Solano,095,438530,387,299,0,299,4
2020-05-05,Sonoma,097,501317,327,263,0,263,3
2020-05-05,Stanislaus,099,539301,520,430,4,434,9
2020-05-05,Sutter,101,95872,36,29,0,29,2
2020-05-05,Tehama,103,63373,2,1,0,1,1
2020-05-05,Trinity,105,12862,2,0,0,0,0
2020-05-05,Tulare,107,460477,1439,869,6,875,40
2020-05-05,Tuolumne,109,53932,3,2,0,2,0
2020-05-05,Ventura,111,848112,831,607,1,608,19
2020-05-05,Yolo,113,214977,182,171,0,171,18
2020-05-05,Yuba,115,75493,22,15,0,15,1
2020-05-04,Alameda,001,1643700,2179,1762,3,1765,65
2020-05-04,Alpine,003,1148,1,1,0,1,0
2020-05-04,Amador,005,37829,8,8,0,8,0
2020-05-04,Butte,007,227075,28,16,1,17,0
2020-05-04,Calaveras,009,45235,13,13,0,13,0
2020-05-04,Colusa,011,21464,3,3,0,3,0
2020-05-04,Contra Costa,013,1133247,1087,949,0,949,28
2020-05-04,Del Norte,015,27424,5,3,0,3,0
2020-05-04,El Dorado,017,186661,66,51,0,51,0
2020-05-04,Fresno,019,978130,1378,680,17,697,8
2020-05-04,Glenn,021,27897,8,4,0,4,0
2020-05-04,Humboldt,023,135768,61,54,0,54,0
2020-05-04,Imperial,025,180216,741,351,0,351,6
2020-05-04,Inyo,027,18085,19,20,0,20,1
2020-05-04,Kern,029,883053,1390,1047,1,1048,8
2020-05-04,Kings,031,150075,314,153,1,154,1
2020-05-04,Lake,033,64148,9,7,0,7,0
2020-05-04,Lassen,035,31185,3,0,2,2,0
2020-05-04,Los Angeles,037,10098052,33684,26243,15,26258,1235
2020-05-04,Madera,039,155013,110,52,1,53,2
2020-05-04,Marin,041,260295,259,244,1,245,13
2020-05-04,Mariposa,043,17540,15,13,0,13,0
2020-05-04,Mendocino,045,87422,12,10,0,10,0
2020-05-04,Merced,047,269075,221,138,0,138,3
2020-05-04,Modoc,049,8938,0,0,0,0,0
2020-05-04,Mono,051,14174,32,25,0,25,1
2020-05-04,Monterey,053,433212,303,237,1,238,6
2020-05-04,Napa,055,140530,86,72,0,72,2
2020-05-04,Nevada,057,99092,41,41,1,42,1
2020-05-04,Orange,059,3164182,4526,2931,33,2964,57
2020-05-04,Placer,061,380077,182,162,0,162,8
2020-05-04,Plumas,063,18699,4,4,0,4,0
2020-05-04,Riverside,065,2383286,5290,4221,16,4237,147
2020-05-04,Sacramento,067,1510023,1170,1119,0,1119,44
2020-05-04,San Benito,069,59416,55,49,0,49,2
2020-05-04,San Bernardino,071,2135413,3034,2184,2,2186,99
2020-05-04,San Diego,073,3302833,5108,4022,0,4022,144
2020-05-04,San Francisco,075,870044,1983,1760,0,1760,31
2020-05-04,San Joaquin,077,732212,629,574,3,577,26
2020-05-04,San Luis Obispo,079,281455,279,202,3,205,1
2020-05-04,San Mateo,081,765935,1553,1313,2,1315,53
2020-05-04,Santa Barbara,083,443738,927,524,4,528,7
2020-05-04,Santa Clara,085,1922200,2757,2238,8,2246,119
2020-05-04,Santa Cruz,087,273765,145,133,0,133,2
2020-05-04,Shasta,089,179085,42,31,0,31,4
2020-05-04,Sierra,091,2930,0,0,0,0,0
2020-05-04,Siskiyou,093,43540,5,5,0,5,0
2020-05-04,Solano,095,438530,373,293,0,293,4
2020-05-04,Sonoma,097,501317,313,256,0,256,4
2020-05-04,Stanislaus,099,539301,514,422,4,426,8
2020-05-04,Sutter,101,95872,33,28,0,28,2
2020-05-04,Tehama,103,63373,2,1,0,1,1
2020-05-04,Trinity,105,12862,1,0,0,0,0
2020-05-04,Tulare,107,460477,1360,760,6,766,40
2020-05-04,Tuolumne,109,53932,3,3,0,3,0
2020-05-04,Ventura,111,848112,810,590,1,591,19
2020-05-04,Yolo,113,214977,181,171,0,171,18
2020-05-04,Yuba,115,75493,19,16,0,16,1
2020-05-03,Alameda,001,1643700,2122,1731,3,1734,64
2020-05-03,Alpine,003,1148,1,1,0,1,0
2020-05-03,Amador,005,37829,8,8,0,8,0
2020-05-03,Butte,007,227075,28,17,1,18,0
2020-05-03,Calaveras,009,45235,13,13,0,13,0
2020-05-03,Colusa,011,21464,3,3,0,3,0
2020-05-03,Contra Costa,013,1133247,1071,945,0,945,28
2020-05-03,Del Norte,015,27424,5,3,0,3,0
2020-05-03,El Dorado,017,186661,64,49,0,49,0
2020-05-03,Fresno,019,978130,1286,646,15,661,8
2020-05-03,Glenn,021,27897,7,5,0,5,0
2020-05-03,Humboldt,023,135768,60,54,0,54,0
2020-05-03,Imperial,025,180216,685,351,0,351,6
2020-05-03,Inyo,027,18085,19,20,0,20,1
2020-05-03,Kern,029,883053,1335,1025,1,1026,8
2020-05-03,Kings,031,150075,294,137,1,138,1
2020-05-03,Lake,033,64148,9,7,0,7,0
2020-05-03,Lassen,035,31185,3,0,2,2,0
2020-05-03,Los Angeles,037,10098052,32697,25708,15,25723,1210
2020-05-03,Madera,039,155013,103,46,1,47,2
2020-05-03,Marin,041,260295,254,243,1,244,13
2020-05-03,Mariposa,043,17540,15,13,0,13,0
2020-05-03,Mendocino,045,87422,12,10,0,10,0
2020-05-03,Merced,047,269075,213,134,0,134,3
2020-05-03,Modoc,049,8938,0,0,0,0,0
2020-05-03,Mono,051,14174,32,25,0,25,1
2020-05-03,Monterey,053,433212,294,235,1,236,6
2020-05-03,Napa,055,140530,86,72,0,72,2
2020-05-03,Nevada,057,99092,41,41,1,42,1
2020-05-03,Orange,059,3164182,4352,2859,32,2891,55
2020-05-03,Placer,061,380077,182,161,0,161,8
2020-05-03,Plumas,063,18699,4,4,0,4,0
2020-05-03,Riverside,065,2383286,5185,4034,16,4050,139
2020-05-03,Sacramento,067,1510023,1161,1109,0,1109,43
2020-05-03,San Benito,069,59416,55,49,0,49,2
2020-05-03,San Bernardino,071,2135413,2973,2123,2,2125,99
2020-05-03,San Diego,073,3302833,4970,3929,0,3929,142
2020-05-03,San Francisco,075,870044,1954,1692,0,1692,30
2020-05-03,San Joaquin,077,732212,622,570,3,573,26
2020-05-03,San Luis Obispo,079,281455,276,200,3,203,1
2020-05-03,San Mateo,081,765935,1525,1277,2,1279,53
2020-05-03,Santa Barbara,083,443738,568,512,4,516,7
2020-05-03,Santa Clara,085,1922200,2720,2235,8,2243,116
2020-05-03,Santa Cruz,087,273765,145,133,0,133,2
2020-05-03,Shasta,089,179085,40,31,0,31,4
2020-05-03,Sierra,091,2930,0,0,0,0,0
2020-05-03,Siskiyou,093,43540,5,5,0,5,0
2020-05-03,Solano,095,438530,363,266,0,266,4
2020-05-03,Sonoma,097,501317,304,254,0,254,4
2020-05-03,Stanislaus,099,539301,486,411,4,415,8
2020-05-03,Sutter,101,95872,31,28,0,28,2
2020-05-03,Tehama,103,63373,2,1,0,1,1
2020-05-03,Trinity,105,12862,1,0,0,0,0
2020-05-03,Tulare,107,460477,1281,736,6,742,40
2020-05-03,Tuolumne,109,53932,3,3,0,3,0
2020-05-03,Ventura,111,848112,776,583,1,584,19
2020-05-03,Yolo,113,214977,180,171,0,171,18
2020-05-03,Yuba,115,75493,19,16,0,16,1
2020-05-02,Alameda,001,1643700,2085,1678,3,1681,63
2020-05-02,Alpine,003,1148,1,1,0,1,0
2020-05-02,Amador,005,37829,8,8,0,8,0
2020-05-02,Butte,007,227075,28,17,1,18,0
2020-05-02,Calaveras,009,45235,13,13,0,13,0
2020-05-02,Colusa,011,21464,3,3,0,3,0
2020-05-02,Contra Costa,013,1133247,1053,929,0,929,28
2020-05-02,Del Norte,015,27424,5,3,0,3,0
2020-05-02,El Dorado,017,186661,64,47,0,47,0
2020-05-02,Fresno,019,978130,1260,629,14,643,8
2020-05-02,Glenn,021,27897,7,5,0,5,0
2020-05-02,Humboldt,023,135768,60,54,0,54,0
2020-05-02,Imperial,025,180216,658,345,0,345,6
2020-05-02,Inyo,027,18085,19,20,0,20,1
2020-05-02,Kern,029,883053,1309,1007,1,1008,8
2020-05-02,Kings,031,150075,291,120,1,121,1
2020-05-02,Lake,033,64148,9,7,0,7,0
2020-05-02,Lassen,035,31185,3,0,2,2,0
2020-05-02,Los Angeles,037,10098052,32168,24955,15,24970,1192
2020-05-02,Madera,039,155013,103,46,1,47,2
2020-05-02,Marin,041,260295,253,243,1,244,13
2020-05-02,Mariposa,043,17540,15,13,0,13,0
2020-05-02,Mendocino,045,87422,12,10,0,10,0
2020-05-02,Merced,047,269075,210,131,0,131,3
2020-05-02,Modoc,049,8938,0,0,0,0,0
2020-05-02,Mono,051,14174,32,25,0,25,1
2020-05-02,Monterey,053,433212,288,225,1,226,5
2020-05-02,Napa,055,140530,86,71,0,71,2
2020-05-02,Nevada,057,99092,41,41,1,42,1
2020-05-02,Orange,059,3164182,4238,2774,32,2806,52
2020-05-02,Placer,061,380077,180,150,0,150,8
2020-05-02,Plumas,063,18699,4,4,0,4,0
2020-05-02,Riverside,065,2383286,5119,3997,16,4013,137
2020-05-02,Sacramento,067,1510023,1158,1097,0,1097,43
2020-05-02,San Benito,069,59416,55,49,0,49,2
2020-05-02,San Bernardino,071,2135413,2934,2124,2,2126,99
2020-05-02,San Diego,073,3302833,4868,3844,0,3844,138
2020-05-02,San Francisco,075,870044,1931,1632,0,1632,29
2020-05-02,San Joaquin,077,732212,614,559,3,562,25
2020-05-02,San Luis Obispo,079,281455,270,193,3,196,1
2020-05-02,San Mateo,081,765935,1509,1272,2,1274,52
2020-05-02,Santa Barbara,083,443738,560,506,4,510,7
2020-05-02,Santa Clara,085,1922200,2710,2203,8,2211,115
2020-05-02,Santa Cruz,087,273765,144,131,0,131,2
2020-05-02,Shasta,089,179085,40,31,0,31,4
2020-05-02,Sierra,091,2930,0,0,0,0,0
2020-05-02,Siskiyou,093,43540,5,5,0,5,0
2020-05-02,Solano,095,438530,356,267,0,267,4
2020-05-02,Sonoma,097,501317,301,250,0,250,3
2020-05-02,Stanislaus,099,539301,478,388,4,392,8
2020-05-02,Sutter,101,95872,31,28,0,28,2
2020-05-02,Tehama,103,63373,2,1,0,1,1
2020-05-02,Trinity,105,12862,1,0,0,0,0
2020-05-02,Tulare,107,460477,1238,711,6,717,35
2020-05-02,Tuolumne,109,53932,3,3,0,3,0
2020-05-02,Ventura,111,848112,762,564,1,565,19
2020-05-02,Yolo,113,214977,180,169,0,169,17
2020-05-02,Yuba,115,75493,19,16,0,16,1
2020-05-01,Alameda,001,1643700,2048,1630,3,1633,63
2020-05-01,Alpine,003,1148,1,1,0,1,0
2020-05-01,Amador,005,37829,8,8,0,8,0
2020-05-01,Butte,007,227075,28,17,1,18,0
2020-05-01,Calaveras,009,45235,13,13,0,13,0
2020-05-01,Colusa,011,21464,3,3,0,3,0
2020-05-01,Contra Costa,013,1133247,1039,915,0,915,28
2020-05-01,Del Norte,015,27424,5,3,0,3,0
2020-05-01,El Dorado,017,186661,64,47,0,47,0
2020-05-01,Fresno,019,978130,1229,617,14,631,7
2020-05-01,Glenn,021,27897,7,4,0,4,0
2020-05-01,Humboldt,023,135768,60,54,0,54,0
2020-05-01,Imperial,025,180216,621,337,0,337,6
2020-05-01,Inyo,027,18085,19,20,0,20,1
2020-05-01,Kern,029,883053,1282,972,1,973,8
2020-05-01,Kings,031,150075,274,112,1,113,1
2020-05-01,Lake,033,64148,9,6,0,6,0
2020-05-01,Lassen,035,31185,3,0,2,2,0
2020-05-01,Los Angeles,037,10098052,31412,24306,15,24321,1155
2020-05-01,Madera,039,155013,99,46,1,47,2
2020-05-01,Marin,041,260295,253,242,1,243,13
2020-05-01,Mariposa,043,17540,15,10,0,10,0
2020-05-01,Mendocino,045,87422,12,11,0,11,0
2020-05-01,Merced,047,269075,207,131,0,131,3
2020-05-01,Modoc,049,8938,0,0,0,0,0
2020-05-01,Mono,051,14174,32,25,0,25,1
2020-05-01,Monterey,053,433212,284,222,1,223,5
2020-05-01,Napa,055,140530,86,69,0,69,2
2020-05-01,Nevada,057,99092,41,41,1,42,1
2020-05-01,Orange,059,3164182,4161,2660,30,2690,51
2020-05-01,Placer,061,380077,179,149,0,149,8
2020-05-01,Plumas,063,18699,4,4,0,4,0
2020-05-01,Riverside,065,2383286,5055,3893,16,3909,132
2020-05-01,Sacramento,067,1510023,1153,1081,0,1081,43
2020-05-01,San Benito,069,59416,55,49,0,49,2
2020-05-01,San Bernardino,071,2135413,2879,2084,2,2086,98
2020-05-01,San Diego,073,3302833,4777,3713,0,3713,134
2020-05-01,San Francisco,075,870044,1887,1552,0,1552,29
2020-05-01,San Joaquin,077,732212,610,554,3,557,25
2020-05-01,San Luis Obispo,079,281455,267,186,3,189,1
2020-05-01,San Mateo,081,765935,1487,1222,2,1224,52
2020-05-01,Santa Barbara,083,443738,554,499,3,502,7
2020-05-01,Santa Clara,085,1922200,2698,2176,8,2184,112
2020-05-01,Santa Cruz,087,273765,144,127,0,127,2
2020-05-01,Shasta,089,179085,40,31,0,31,4
2020-05-01,Sierra,091,2930,0,0,0,0,0
2020-05-01,Siskiyou,093,43540,5,5,0,5,0
2020-05-01,Solano,095,438530,348,266,0,266,4
2020-05-01,Sonoma,097,501317,298,242,0,242,3
2020-05-01,Stanislaus,099,539301,473,384,4,388,8
2020-05-01,Sutter,101,95872,31,28,0,28,2
2020-05-01,Tehama,103,63373,2,1,0,1,1
2020-05-01,Trinity,105,12862,1,0,0,0,0
2020-05-01,Tulare,107,460477,1194,685,6,691,32
2020-05-01,Tuolumne,109,53932,3,3,0,3,0
2020-05-01,Ventura,111,848112,749,556,1,557,18
2020-05-01,Yolo,113,214977,180,165,0,165,18
2020-05-01,Yuba,115,75493,19,16,0,16,1
2020-04-30,Alameda,001,1643700,1988,1599,3,1602,60
2020-04-30,Alpine,003,1148,1,1,0,1,0
2020-04-30,Amador,005,37829,8,8,0,8,0
2020-04-30,Butte,007,227075,28,16,1,17,0
2020-04-30,Calaveras,009,45235,13,13,0,13,0
2020-04-30,Colusa,011,21464,3,3,0,3,0
2020-04-30,Contra Costa,013,1133247,1017,900,0,900,25
2020-04-30,Del Norte,015,27424,4,3,0,3,0
2020-04-30,El Dorado,017,186661,64,44,0,44,0
2020-04-30,Fresno,019,978130,1163,562,11,573,7
2020-04-30,Glenn,021,27897,7,4,0,4,0
2020-04-30,Humboldt,023,135768,60,54,0,54,0
2020-04-30,Imperial,025,180216,575,322,0,322,6
2020-04-30,Inyo,027,18085,19,20,0,20,1
2020-04-30,Kern,029,883053,1250,941,1,942,8
2020-04-30,Kings,031,150075,262,87,1,88,1
2020-04-30,Lake,033,64148,9,6,0,6,0
2020-04-30,Lassen,035,31185,3,0,2,2,0
2020-04-30,Los Angeles,037,10098052,30405,23284,15,23299,1099
2020-04-30,Madera,039,155013,88,46,1,47,2
2020-04-30,Marin,041,260295,253,240,1,241,13
2020-04-30,Mariposa,043,17540,15,3,0,3,0
2020-04-30,Mendocino,045,87422,12,11,0,11,0
2020-04-30,Merced,047,269075,200,122,0,122,3
2020-04-30,Modoc,049,8938,0,0,0,0,0
2020-04-30,Mono,051,14174,31,25,0,25,1
2020-04-30,Monterey,053,433212,274,213,1,214,5
2020-04-30,Napa,055,140530,84,69,0,69,2
2020-04-30,Nevada,057,99092,41,41,1,42,1
2020-04-30,Orange,059,3164182,3938,2591,27,2618,46
2020-04-30,Placer,061,380077,178,148,0,148,8
2020-04-30,Plumas,063,18699,4,4,0,4,0
2020-04-30,Riverside,065,2383286,4955,3820,15,3835,124
2020-04-30,Sacramento,067,1510023,1147,1071,0,1071,43
2020-04-30,San Benito,069,59416,55,48,0,48,2
2020-04-30,San Bernardino,071,2135413,2677,2020,2,2022,96
2020-04-30,San Diego,073,3302833,4606,3566,0,3566,124
2020-04-30,San Francisco,075,870044,1853,1518,0,1518,26
2020-04-30,San Joaquin,077,732212,602,548,3,551,25
2020-04-30,San Luis Obispo,079,281455,264,182,3,185,1
2020-04-30,San Mateo,081,765935,1457,1194,2,1196,52
2020-04-30,Santa Barbara,083,443738,542,490,3,493,7
2020-04-30,Santa Clara,085,1922200,2658,2172,8,2180,111
2020-04-30,Santa Cruz,087,273765,143,126,0,126,2
2020-04-30,Shasta,089,179085,39,31,0,31,4
2020-04-30,Sierra,091,2930,0,0,0,0,0
2020-04-30,Siskiyou,093,43540,5,5,0,5,0
2020-04-30,Solano,095,438530,338,262,0,262,4
2020-04-30,Sonoma,097,501317,289,233,0,233,3
2020-04-30,Stanislaus,099,539301,466,378,4,382,7
2020-04-30,Sutter,101,95872,31,28,0,28,2
2020-04-30,Tehama,103,63373,1,1,0,1,1
2020-04-30,Trinity,105,12862,1,0,0,0,0
2020-04-30,Tulare,107,460477,1128,637,6,643,31
2020-04-30,Tuolumne,109,53932,3,3,0,3,0
2020-04-30,Ventura,111,848112,721,547,1,548,18
2020-04-30,Yolo,113,214977,179,164,0,164,16
2020-04-30,Yuba,115,75493,19,15,0,15,1
2020-04-29,Alameda,001,1643700,1930,1564,2,1566,60
2020-04-29,Alpine,003,1148,1,1,0,1,0
2020-04-29,Amador,005,37829,8,8,0,8,0
2020-04-29,Butte,007,227075,28,16,1,17,0
2020-04-29,Calaveras,009,45235,13,13,0,13,0
2020-04-29,Colusa,011,21464,3,3,0,3,0
2020-04-29,Contra Costa,013,1133247,998,885,0,885,25
2020-04-29,Del Norte,015,27424,4,3,0,3,0
2020-04-29,El Dorado,017,186661,62,44,0,44,0
2020-04-29,Fresno,019,978130,1111,544,11,555,7
2020-04-29,Glenn,021,27897,7,4,0,4,0
2020-04-29,Humboldt,023,135768,60,53,0,53,0
2020-04-29,Imperial,025,180216,545,300,0,300,6
2020-04-29,Inyo,027,18085,19,20,0,20,1
2020-04-29,Kern,029,883053,1207,910,1,911,6
2020-04-29,Kings,031,150075,243,80,1,81,1
2020-04-29,Lake,033,64148,9,6,0,6,0
2020-04-29,Lassen,035,31185,3,0,2,2,0
2020-04-29,Los Angeles,037,10098052,29428,22560,15,22575,1043
2020-04-29,Madera,039,155013,86,45,1,46,2
2020-04-29,Marin,041,260295,250,234,1,235,13
2020-04-29,Mariposa,043,17540,15,1,0,1,0
2020-04-29,Mendocino,045,87422,12,11,0,11,0
2020-04-29,Merced,047,269075,193,116,0,116,3
2020-04-29,Modoc,049,8938,0,0,0,0,0
2020-04-29,Mono,051,14174,31,25,0,25,1
2020-04-29,Monterey,053,433212,266,204,1,205,5
2020-04-29,Napa,055,140530,82,68,0,68,2
2020-04-29,Nevada,057,99092,41,41,1,42,1
2020-04-29,Orange,059,3164182,3802,2421,26,2447,43
2020-04-29,Placer,061,380077,176,145,0,145,8
2020-04-29,Plumas,063,18699,4,4,0,4,0
2020-04-29,Riverside,065,2383286,4878,3700,15,3715,116
2020-04-29,Sacramento,067,1510023,1125,1055,0,1055,41
2020-04-29,San Benito,069,59416,55,48,0,48,2
2020-04-29,San Bernardino,071,2135413,2590,1975,1,1976,91
2020-04-29,San Diego,073,3302833,4464,3434,0,3434,120
2020-04-29,San Francisco,075,870044,1825,1489,0,1489,23
2020-04-29,San Joaquin,077,732212,594,540,3,543,25
2020-04-29,San Luis Obispo,079,281455,262,181,3,184,1
2020-04-29,San Mateo,081,765935,1431,1170,2,1172,50
2020-04-29,Santa Barbara,083,443738,529,477,3,480,7
2020-04-29,Santa Clara,085,1922200,2631,2147,8,2155,108
2020-04-29,Santa Cruz,087,273765,142,124,0,124,2
2020-04-29,Shasta,089,179085,38,31,0,31,4
2020-04-29,Sierra,091,2930,0,0,0,0,0
2020-04-29,Siskiyou,093,43540,5,5,0,5,0
2020-04-29,Solano,095,438530,314,252,0,252,3
2020-04-29,Sonoma,097,501317,281,230,0,230,2
2020-04-29,Stanislaus,099,539301,453,374,4,378,5
2020-04-29,Sutter,101,95872,31,28,0,28,2
2020-04-29,Tehama,103,63373,1,1,0,1,1
2020-04-29,Trinity,105,12862,1,0,0,0,0
2020-04-29,Tulare,107,460477,1055,615,5,620,30
2020-04-29,Tuolumne,109,53932,3,4,0,4,0
2020-04-29,Ventura,111,848112,697,530,1,531,18
2020-04-29,Yolo,113,214977,176,161,0,161,11
2020-04-29,Yuba,115,75493,19,15,0,15,1
2020-04-28,Alameda,001,1643700,1873,1525,2,1527,55
2020-04-28,Alpine,003,1148,1,1,0,1,0
2020-04-28,Amador,005,37829,8,8,0,8,0
2020-04-28,Butte,007,227075,28,16,1,17,0
2020-04-28,Calaveras,009,45235,13,13,0,13,0
2020-04-28,Colusa,011,21464,3,3,0,3,0
2020-04-28,Contra Costa,013,1133247,991,866,0,866,25
2020-04-28,Del Norte,015,27424,4,3,0,3,0
2020-04-28,El Dorado,017,186661,61,43,0,43,0
2020-04-28,Fresno,019,978130,1060,525,9,534,7
2020-04-28,Glenn,021,27897,5,4,0,4,0
2020-04-28,Humboldt,023,135768,59,53,0,53,0
2020-04-28,Imperial,025,180216,511,295,0,295,6
2020-04-28,Inyo,027,18085,19,20,0,20,1
2020-04-28,Kern,029,883053,1164,882,1,883,5
2020-04-28,Kings,031,150075,230,57,1,58,1
2020-04-28,Lake,033,64148,9,6,0,6,0
2020-04-28,Lassen,035,31185,3,0,2,2,0
2020-04-28,Los Angeles,037,10098052,28363,21029,15,21044,984
2020-04-28,Madera,039,155013,86,44,1,45,2
2020-04-28,Marin,041,260295,249,228,1,229,12
2020-04-28,Mariposa,043,17540,15,0,0,0,0
2020-04-28,Mendocino,045,87422,12,10,0,10,0
2020-04-28,Merced,047,269075,186,108,0,108,3
2020-04-28,Modoc,049,8938,0,0,0,0,0
2020-04-28,Mono,051,14174,31,25,0,25,1
2020-04-28,Monterey,053,433212,260,191,1,192,5
2020-04-28,Napa,055,140530,81,67,0,67,2
2020-04-28,Nevada,057,99092,41,41,1,42,1
2020-04-28,Orange,059,3164182,3637,2324,25,2349,42
2020-04-28,Placer,061,380077,166,143,0,143,8
2020-04-28,Plumas,063,18699,4,4,0,4,0
2020-04-28,Riverside,065,2383286,4783,3504,15,3519,113
2020-04-28,Sacramento,067,1510023,1110,1044,0,1044,41
2020-04-28,San Benito,069,59416,53,46,0,46,2
2020-04-28,San Bernardino,071,2135413,2513,1891,1,1892,89
2020-04-28,San Diego,073,3302833,4334,3316,0,3316,118
2020-04-28,San Francisco,075,870044,1790,1471,0,1471,23
2020-04-28,San Joaquin,077,732212,588,532,3,535,25
2020-04-28,San Luis Obispo,079,281455,255,172,3,175,1
2020-04-28,San Mateo,081,765935,1418,1129,2,1131,48
2020-04-28,Santa Barbara,083,443738,524,469,2,471,7
2020-04-28,Santa Clara,085,1922200,2597,2130,8,2138,106
2020-04-28,Santa Cruz,087,273765,142,123,0,123,2
2020-04-28,Shasta,089,179085,38,29,0,29,4
2020-04-28,Sierra,091,2930,0,0,0,0,0
2020-04-28,Siskiyou,093,43540,5,5,0,5,0
2020-04-28,Solano,095,438530,295,246,0,246,3
2020-04-28,Sonoma,097,501317,278,226,0,226,1
2020-04-28,Stanislaus,099,539301,437,330,4,334,5
2020-04-28,Sutter,101,95872,31,25,0,25,2
2020-04-28,Tehama,103,63373,1,1,0,1,1
2020-04-28,Trinity,105,12862,1,0,0,0,0
2020-04-28,Tulare,107,460477,959,579,5,584,30
2020-04-28,Tuolumne,109,53932,3,4,0,4,0
2020-04-28,Ventura,111,848112,677,517,1,518,17
2020-04-28,Yolo,113,214977,176,160,0,160,10
2020-04-28,Yuba,115,75493,19,15,0,15,1
2020-04-27,Alameda,001,1643700,1813,1494,2,1496,53
2020-04-27,Alpine,003,1148,1,1,0,1,0
2020-04-27,Amador,005,37829,8,8,0,8,0
2020-04-27,Butte,007,227075,27,16,1,17,0
2020-04-27,Calaveras,009,45235,13,13,0,13,0
2020-04-27,Colusa,011,21464,3,3,0,3,0
2020-04-27,Contra Costa,013,1133247,979,843,0,843,25
2020-04-27,Del Norte,015,27424,4,3,0,3,0
2020-04-27,El Dorado,017,186661,60,43,0,43,0
2020-04-27,Fresno,019,978130,957,504,8,512,7
2020-04-27,Glenn,021,27897,5,4,0,4,0
2020-04-27,Humboldt,023,135768,59,52,0,52,0
2020-04-27,Imperial,025,180216,481,290,0,290,6
2020-04-27,Inyo,027,18085,19,20,0,20,1
2020-04-27,Kern,029,883053,1125,865,1,866,4
2020-04-27,Kings,031,150075,207,48,1,49,1
2020-04-27,Lake,033,64148,8,6,0,6,0
2020-04-27,Lassen,035,31185,3,0,2,2,0
2020-04-27,Los Angeles,037,10098052,27348,20456,15,20471,931
2020-04-27,Madera,039,155013,84,42,1,43,2
2020-04-27,Marin,041,260295,244,227,1,228,12
2020-04-27,Mariposa,043,17540,14,0,0,0,0
2020-04-27,Mendocino,045,87422,12,10,0,10,0
2020-04-27,Merced,047,269075,183,108,0,108,3
2020-04-27,Modoc,049,8938,0,0,0,0,0
2020-04-27,Mono,051,14174,31,23,0,23,1
2020-04-27,Monterey,053,433212,253,185,1,186,4
2020-04-27,Napa,055,140530,77,64,0,64,2
2020-04-27,Nevada,057,99092,41,39,1,40,1
2020-04-27,Orange,059,3164182,3468,2198,25,2223,42
2020-04-27,Placer,061,380077,166,142,0,142,8
2020-04-27,Plumas,063,18699,4,4,0,4,0
2020-04-27,Riverside,065,2383286,4660,3381,15,3396,100
2020-04-27,Sacramento,067,1510023,1095,1035,0,1035,41
2020-04-27,San Benito,069,59416,51,45,0,45,2
2020-04-27,San Bernardino,071,2135413,2399,1742,1,1743,82
2020-04-27,San Diego,073,3302833,4208,3143,0,3143,113
2020-04-27,San Francisco,075,870044,1736,1453,0,1453,23
2020-04-27,San Joaquin,077,732212,582,522,3,525,25
2020-04-27,San Luis Obispo,079,281455,247,166,3,169,1
2020-04-27,San Mateo,081,765935,1396,1092,2,1094,46
2020-04-27,Santa Barbara,083,443738,516,466,2,468,7
2020-04-27,Santa Clara,085,1922200,2572,2104,7,2111,105
2020-04-27,Santa Cruz,087,273765,142,123,0,123,2
2020-04-27,Shasta,089,179085,38,29,0,29,4
2020-04-27,Sierra,091,2930,0,0,0,0,0
2020-04-27,Siskiyou,093,43540,5,5,0,5,0
2020-04-27,Solano,095,438530,295,222,0,222,3
2020-04-27,Sonoma,097,501317,269,220,0,220,1
2020-04-27,Stanislaus,099,539301,421,316,4,320,5
2020-04-27,Sutter,101,95872,29,26,0,26,2
2020-04-27,Tehama,103,63373,1,1,0,1,1
2020-04-27,Trinity,105,12862,1,0,0,0,0
2020-04-27,Tulare,107,460477,888,535,5,540,28
2020-04-27,Tuolumne,109,53932,3,3,0,3,0
2020-04-27,Ventura,111,848112,658,513,1,514,17
2020-04-27,Yolo,113,214977,173,160,0,160,9
2020-04-27,Yuba,115,75493,19,15,0,15,1
2020-04-26,Alameda,001,1643700,1752,1449,2,1451,52
2020-04-26,Alpine,003,1148,1,1,0,1,0
2020-04-26,Amador,005,37829,8,8,0,8,0
2020-04-26,Butte,007,227075,27,16,1,17,0
2020-04-26,Calaveras,009,45235,13,13,0,13,0
2020-04-26,Colusa,011,21464,3,3,0,3,0
2020-04-26,Contra Costa,013,1133247,963,830,0,830,25
2020-04-26,Del Norte,015,27424,3,3,0,3,0
2020-04-26,El Dorado,017,186661,58,41,0,41,0
2020-04-26,Fresno,019,978130,863,476,7,483,7
2020-04-26,Glenn,021,27897,5,4,0,4,0
2020-04-26,Humboldt,023,135768,59,53,0,53,0
2020-04-26,Imperial,025,180216,447,272,0,272,6
2020-04-26,Inyo,027,18085,19,20,0,20,1
2020-04-26,Kern,029,883053,1075,831,1,832,4
2020-04-26,Kings,031,150075,182,33,1,34,1
2020-04-26,Lake,033,64148,8,6,0,6,0
2020-04-26,Lassen,035,31185,3,0,2,2,0
2020-04-26,Los Angeles,037,10098052,26196,19570,15,19585,901
2020-04-26,Madera,039,155013,82,39,1,40,2
2020-04-26,Marin,041,260295,238,225,1,226,12
2020-04-26,Mariposa,043,17540,14,0,0,0,0
2020-04-26,Mendocino,045,87422,12,5,0,5,0
2020-04-26,Merced,047,269075,166,104,0,104,3
2020-04-26,Modoc,049,8938,0,0,0,0,0
2020-04-26,Mono,051,14174,31,23,0,23,1
2020-04-26,Monterey,053,433212,246,182,1,183,4
2020-04-26,Napa,055,140530,76,62,0,62,2
2020-04-26,Nevada,057,99092,41,37,1,38,1
2020-04-26,Orange,059,3164182,3303,2124,25,2149,40
2020-04-26,Placer,061,380077,165,141,0,141,8
2020-04-26,Plumas,063,18699,4,4,0,4,0
2020-04-26,Riverside,065,2383286,4517,3301,15,3316,95
2020-04-26,Sacramento,067,1510023,1086,1027,0,1027,41
2020-04-26,San Benito,069,59416,51,45,0,45,2
2020-04-26,San Bernardino,071,2135413,2303,1681,1,1682,82
2020-04-26,San Diego,073,3302833,4066,3045,0,3045,111
2020-04-26,San Francisco,075,870044,1697,1403,0,1403,23
2020-04-26,San Joaquin,077,732212,574,514,3,517,25
2020-04-26,San Luis Obispo,079,281455,244,165,3,168,1
2020-04-26,San Mateo,081,765935,1370,1070,2,1072,46
2020-04-26,Santa Barbara,083,443738,509,464,2,466,7
2020-04-26,Santa Clara,085,1922200,2549,2097,6,2103,102
2020-04-26,Santa Cruz,087,273765,142,116,0,116,2
2020-04-26,Shasta,089,179085,35,29,0,29,4
2020-04-26,Sierra,091,2930,0,0,0,0,0
2020-04-26,Siskiyou,093,43540,5,5,0,5,0
2020-04-26,Solano,095,438530,286,205,0,205,3
2020-04-26,Sonoma,097,501317,258,216,0,216,1
2020-04-26,Stanislaus,099,539301,406,294,4,298,4
2020-04-26,Sutter,101,95872,29,26,0,26,2
2020-04-26,Tehama,103,63373,1,1,0,1,1
2020-04-26,Trinity,105,12862,1,0,0,0,0
2020-04-26,Tulare,107,460477,829,497,5,502,28
2020-04-26,Tuolumne,109,53932,3,3,0,3,0
2020-04-26,Ventura,111,848112,640,509,1,510,17
2020-04-26,Yolo,113,214977,172,158,0,158,8
2020-04-26,Yuba,115,75493,18,15,0,15,1
2020-04-25,Alameda,001,1643700,1727,1396,2,1398,52
2020-04-25,Alpine,003,1148,1,1,0,1,0
2020-04-25,Amador,005,37829,8,8,0,8,0
2020-04-25,Butte,007,227075,26,16,1,17,0
2020-04-25,Calaveras,009,45235,13,12,0,12,0
2020-04-25,Colusa,011,21464,3,3,0,3,0
2020-04-25,Contra Costa,013,1133247,949,821,0,821,24
2020-04-25,Del Norte,015,27424,2,2,0,2,0
2020-04-25,El Dorado,017,186661,57,41,0,41,0
2020-04-25,Fresno,019,978130,831,459,6,465,7
2020-04-25,Glenn,021,27897,5,4,0,4,0
2020-04-25,Humboldt,023,135768,59,53,0,53,0
2020-04-25,Imperial,025,180216,430,232,0,232,6
2020-04-25,Inyo,027,18085,19,20,0,20,1
2020-04-25,Kern,029,883053,1044,802,1,803,4
2020-04-25,Kings,031,150075,170,33,1,34,1
2020-04-25,Lake,033,64148,6,6,0,6,0
2020-04-25,Lassen,035,31185,3,0,2,2,0
2020-04-25,Los Angeles,037,10098052,25562,19144,15,19159,881
2020-04-25,Madera,039,155013,79,39,1,40,2
2020-04-25,Marin,041,260295,238,215,1,216,12
2020-04-25,Mariposa,043,17540,14,0,0,0,0
2020-04-25,Mendocino,045,87422,11,5,0,5,0
2020-04-25,Merced,047,269075,166,103,0,103,3
2020-04-25,Modoc,049,8938,0,0,0,0,0
2020-04-25,Mono,051,14174,31,23,0,23,1
2020-04-25,Monterey,053,433212,244,173,1,174,4
2020-04-25,Napa,055,140530,76,60,0,60,2
2020-04-25,Nevada,057,99092,41,37,1,38,1
2020-04-25,Orange,059,3164182,3195,2047,25,2072,40
2020-04-25,Placer,061,380077,165,137,0,137,8
2020-04-25,Plumas,063,18699,4,4,0,4,0
2020-04-25,Riverside,065,2383286,4427,3037,15,3052,93
2020-04-25,Sacramento,067,1510023,1084,1015,0,1015,41
2020-04-25,San Benito,069,59416,51,45,0,45,2
2020-04-25,San Bernardino,071,2135413,2258,1675,1,1676,82
2020-04-25,San Diego,073,3302833,3966,2945,0,2945,111
2020-04-25,San Francisco,075,870044,1672,1341,0,1341,22
2020-04-25,San Joaquin,077,732212,567,497,3,500,24
2020-04-25,San Luis Obispo,079,281455,243,159,3,162,1
2020-04-25,San Mateo,081,765935,1352,1054,2,1056,46
2020-04-25,Santa Barbara,083,443738,502,457,2,459,7
2020-04-25,Santa Clara,085,1922200,2527,2045,5,2050,99
2020-04-25,Santa Cruz,087,273765,142,112,0,112,2
2020-04-25,Shasta,089,179085,35,29,0,29,4
2020-04-25,Sierra,091,2930,0,0,0,0,0
2020-04-25,Siskiyou,093,43540,5,5,0,5,0
2020-04-25,Solano,095,438530,282,203,0,203,3
2020-04-25,Sonoma,097,501317,254,199,0,199,1
2020-04-25,Stanislaus,099,539301,398,276,4,280,4
2020-04-25,Sutter,101,95872,29,24,0,24,2
2020-04-25,Tehama,103,63373,1,1,0,1,1
2020-04-25,Trinity,105,12862,0,0,0,0,0
2020-04-25,Tulare,107,460477,796,478,5,483,28
2020-04-25,Tuolumne,109,53932,3,2,0,2,0
2020-04-25,Ventura,111,848112,626,494,1,495,16
2020-04-25,Yolo,113,214977,172,157,0,157,8
2020-04-25,Yuba,115,75493,17,15,0,15,1
2020-04-24,Alameda,001,1643700,1696,1385,2,1387,50
2020-04-24,Alpine,003,1148,1,1,0,1,0
2020-04-24,Amador,005,37829,8,8,0,8,0
2020-04-24,Butte,007,227075,25,15,1,16,0
2020-04-24,Calaveras,009,45235,13,12,0,12,0
2020-04-24,Colusa,011,21464,3,3,0,3,0
2020-04-24,Contra Costa,013,1133247,940,806,0,806,23
2020-04-24,Del Norte,015,27424,2,2,0,2,0
2020-04-24,El Dorado,017,186661,56,41,0,41,0
2020-04-24,Fresno,019,978130,808,449,6,455,7
2020-04-24,Glenn,021,27897,5,4,0,4,0
2020-04-24,Humboldt,023,135768,59,53,0,53,0
2020-04-24,Imperial,025,180216,414,232,0,232,6
2020-04-24,Inyo,027,18085,19,20,0,20,0
2020-04-24,Kern,029,883053,1020,770,1,771,4
2020-04-24,Kings,031,150075,141,30,1,31,1
2020-04-24,Lake,033,64148,6,6,0,6,0
2020-04-24,Lassen,035,31185,3,0,2,2,0
2020-04-24,Los Angeles,037,10098052,24631,18553,15,18568,836
2020-04-24,Madera,039,155013,79,39,1,40,2
2020-04-24,Marin,041,260295,238,211,1,212,11
2020-04-24,Mariposa,043,17540,8,0,0,0,0
2020-04-24,Mendocino,045,87422,11,5,0,5,0
2020-04-24,Merced,047,269075,163,102,0,102,3
2020-04-24,Modoc,049,8938,0,0,0,0,0
2020-04-24,Mono,051,14174,30,23,0,23,1
2020-04-24,Monterey,053,433212,237,167,1,168,4
2020-04-24,Napa,055,140530,75,59,0,59,2
2020-04-24,Nevada,057,99092,41,36,1,37,1
2020-04-24,Orange,059,3164182,3088,1945,25,1970,39
2020-04-24,Placer,061,380077,163,137,0,137,8
2020-04-24,Plumas,063,18699,4,4,0,4,0
2020-04-24,Riverside,065,2383286,4346,3044,15,3059,87
2020-04-24,Sacramento,067,1510023,1078,1009,0,1009,41
2020-04-24,San Benito,069,59416,51,45,0,45,2
2020-04-24,San Bernardino,071,2135413,2223,1667,1,1668,80
2020-04-24,San Diego,073,3302833,3855,2828,0,2828,102
2020-04-24,San Francisco,075,870044,1614,1345,0,1345,22
2020-04-24,San Joaquin,077,732212,560,484,3,487,24
2020-04-24,San Luis Obispo,079,281455,240,151,3,154,1
2020-04-24,San Mateo,081,765935,1329,1004,2,1006,43
2020-04-24,Santa Barbara,083,443738,496,450,2,452,6
2020-04-24,Santa Clara,085,1922200,2484,2026,5,2031,98
2020-04-24,Santa Cruz,087,273765,138,111,0,111,2
2020-04-24,Shasta,089,179085,35,28,0,28,4
2020-04-24,Sierra,091,2930,0,0,0,0,0
2020-04-24,Siskiyou,093,43540,5,5,0,5,0
2020-04-24,Solano,095,438530,280,203,0,203,3
2020-04-24,Sonoma,097,501317,250,199,0,199,1
2020-04-24,Stanislaus,099,539301,395,273,4,277,4
2020-04-24,Sutter,101,95872,28,24,0,24,2
2020-04-24,Tehama,103,63373,1,1,0,1,1
2020-04-24,Trinity,105,12862,0,0,0,0,0
2020-04-24,Tulare,107,460477,768,459,5,464,27
2020-04-24,Tuolumne,109,53932,3,2,0,2,0
2020-04-24,Ventura,111,848112,616,489,1,490,16
2020-04-24,Yolo,113,214977,171,155,0,155,8
2020-04-24,Yuba,115,75493,16,15,0,15,1
2020-04-23,Alameda,001,1643700,1658,1336,2,1338,46
2020-04-23,Alpine,003,1148,1,1,0,1,0
2020-04-23,Amador,005,37829,8,8,0,8,0
2020-04-23,Butte,007,227075,25,15,1,16,0
2020-04-23,Calaveras,009,45235,13,12,0,12,0
2020-04-23,Colusa,011,21464,3,3,0,3,0
2020-04-23,Contra Costa,013,1133247,919,786,0,786,23
2020-04-23,Del Norte,015,27424,2,2,0,2,0
2020-04-23,El Dorado,017,186661,55,39,0,39,0
2020-04-23,Fresno,019,978130,770,426,6,432,7
2020-04-23,Glenn,021,27897,5,3,0,3,0
2020-04-23,Humboldt,023,135768,59,53,0,53,0
2020-04-23,Imperial,025,180216,393,181,0,181,4
2020-04-23,Inyo,027,18085,19,19,0,19,0
2020-04-23,Kern,029,883053,972,732,1,733,4
2020-04-23,Kings,031,150075,126,28,1,29,1
2020-04-23,Lake,033,64148,6,6,0,6,0
2020-04-23,Lassen,035,31185,3,0,2,2,0
2020-04-23,Los Angeles,037,10098052,23571,17548,14,17562,784
2020-04-23,Madera,039,155013,77,37,1,38,2
2020-04-23,Marin,041,260295,225,209,1,210,11
2020-04-23,Mariposa,043,17540,7,0,0,0,0
2020-04-23,Mendocino,045,87422,9,5,0,5,0
2020-04-23,Merced,047,269075,159,98,0,98,3
2020-04-23,Modoc,049,8938,0,0,0,0,0
2020-04-23,Mono,051,14174,30,23,0,23,1
2020-04-23,Monterey,053,433212,233,161,1,162,4
2020-04-23,Napa,055,140530,68,59,0,59,2
2020-04-23,Nevada,057,99092,41,36,1,37,1
2020-04-23,Orange,059,3164182,2910,1841,24,1865,37
2020-04-23,Placer,061,380077,160,136,0,136,8
2020-04-23,Plumas,063,18699,4,4,0,4,0
2020-04-23,Riverside,065,2383286,4232,2935,14,2949,78
2020-04-23,Sacramento,067,1510023,1066,978,0,978,41
2020-04-23,San Benito,069,59416,48,43,0,43,2
2020-04-23,San Bernardino,071,2135413,2158,1604,1,1605,79
2020-04-23,San Diego,073,3302833,3694,2645,0,2645,100
2020-04-23,San Francisco,075,870044,1589,1312,0,1312,21
2020-04-23,San Joaquin,077,732212,550,479,3,482,20
2020-04-23,San Luis Obispo,079,281455,236,146,3,149,1
2020-04-23,San Mateo,081,765935,1290,970,2,972,42
2020-04-23,Santa Barbara,083,443738,490,445,2,447,6
2020-04-23,Santa Clara,085,1922200,2449,1996,5,2001,95
2020-04-23,Santa Cruz,087,273765,137,110,0,110,2
2020-04-23,Shasta,089,179085,35,27,0,27,3
2020-04-23,Sierra,091,2930,0,0,0,0,0
2020-04-23,Siskiyou,093,43540,5,5,0,5,0
2020-04-23,Solano,095,438530,266,196,0,196,3
2020-04-23,Sonoma,097,501317,238,187,0,187,1
2020-04-23,Stanislaus,099,539301,391,254,4,258,4
2020-04-23,Sutter,101,95872,28,24,0,24,2
2020-04-23,Tehama,103,63373,1,1,0,1,1
2020-04-23,Trinity,105,12862,0,0,0,0,0
2020-04-23,Tulare,107,460477,739,440,5,445,25
2020-04-23,Tuolumne,109,53932,3,2,0,2,0
2020-04-23,Ventura,111,848112,602,479,1,480,16
2020-04-23,Yolo,113,214977,168,151,0,151,8
2020-04-23,Yuba,115,75493,16,15,0,15,1
2020-04-22,Alameda,001,1643700,1609,1275,2,1277,46
2020-04-22,Alpine,003,1148,1,1,0,1,0
2020-04-22,Amador,005,37829,8,7,0,7,0
2020-04-22,Butte,007,227075,24,15,1,16,0
2020-04-22,Calaveras,009,45235,13,12,0,12,0
2020-04-22,Colusa,011,21464,3,3,0,3,0
2020-04-22,Contra Costa,013,1133247,904,772,0,772,22
2020-04-22,Del Norte,015,27424,2,2,0,2,0
2020-04-22,El Dorado,017,186661,55,39,0,39,0
2020-04-22,Fresno,019,978130,730,388,6,394,7
2020-04-22,Glenn,021,27897,5,3,0,3,0
2020-04-22,Humboldt,023,135768,59,53,0,53,0
2020-04-22,Imperial,025,180216,382,170,0,170,3
2020-04-22,Inyo,027,18085,19,18,0,18,0
2020-04-22,Kern,029,883053,950,713,1,714,4
2020-04-22,Kings,031,150075,105,28,1,29,1
2020-04-22,Lake,033,64148,6,6,0,6,0
2020-04-22,Lassen,035,31185,3,0,2,2,0
2020-04-22,Los Angeles,037,10098052,22544,16400,14,16414,715
2020-04-22,Madera,039,155013,75,37,1,38,2
2020-04-22,Marin,041,260295,223,202,1,203,11
2020-04-22,Mariposa,043,17540,6,0,0,0,0
2020-04-22,Mendocino,045,87422,6,5,0,5,0
2020-04-22,Merced,047,269075,147,92,0,92,3
2020-04-22,Modoc,049,8938,0,0,0,0,0
2020-04-22,Mono,051,14174,29,23,0,23,1
2020-04-22,Monterey,053,433212,226,154,1,155,4
2020-04-22,Napa,055,140530,67,58,0,58,2
2020-04-22,Nevada,057,99092,41,36,1,37,1
2020-04-22,Orange,059,3164182,2816,1785,23,1808,36
2020-04-22,Placer,061,380077,158,133,0,133,8
2020-04-22,Plumas,063,18699,4,4,0,4,0
2020-04-22,Riverside,065,2383286,4128,2822,14,2836,76
2020-04-22,Sacramento,067,1510023,1061,959,0,959,36
2020-04-22,San Benito,069,59416,47,43,0,43,2
2020-04-22,San Bernardino,071,2135413,2095,1564,1,1565,74
2020-04-22,San Diego,073,3302833,3566,2493,0,2493,96
2020-04-22,San Francisco,075,870044,1552,1255,0,1255,21
2020-04-22,San Joaquin,077,732212,539,462,3,465,20
2020-04-22,San Luis Obispo,079,281455,227,142,3,145,1
2020-04-22,San Mateo,081,765935,1267,945,2,947,40
2020-04-22,Santa Barbara,083,443738,485,437,2,439,6
2020-04-22,Santa Clara,085,1922200,2433,1969,5,1974,95
2020-04-22,Santa Cruz,087,273765,133,106,0,106,2
2020-04-22,Shasta,089,179085,34,26,0,26,3
2020-04-22,Sierra,091,2930,0,0,0,0,0
2020-04-22,Siskiyou,093,43540,5,5,0,5,0
2020-04-22,Solano,095,438530,247,195,0,195,3
2020-04-22,Sonoma,097,501317,235,185,0,185,1
2020-04-22,Stanislaus,099,539301,334,247,4,251,4
2020-04-22,Sutter,101,95872,28,22,0,22,2
2020-04-22,Tehama,103,63373,1,1,0,1,1
2020-04-22,Trinity,105,12862,0,0,0,0,0
2020-04-22,Tulare,107,460477,705,425,5,430,23
2020-04-22,Tuolumne,109,53932,3,2,0,2,0
2020-04-22,Ventura,111,848112,591,465,1,466,15
2020-04-22,Yolo,113,214977,168,147,0,147,8
2020-04-22,Yuba,115,75493,16,15,0,15,1
2020-04-21,Alameda,001,1643700,1579,1234,2,1236,46
2020-04-21,Alpine,003,1148,1,1,0,1,0
2020-04-21,Amador,005,37829,8,7,0,7,0
2020-04-21,Butte,007,227075,23,15,1,16,0
2020-04-21,Calaveras,009,45235,12,12,0,12,0
2020-04-21,Colusa,011,21464,3,3,0,3,0
2020-04-21,Contra Costa,013,1133247,890,766,0,766,22
2020-04-21,Del Norte,015,27424,2,2,0,2,0
2020-04-21,El Dorado,017,186661,54,36,0,36,0
2020-04-21,Fresno,019,978130,696,372,6,378,7
2020-04-21,Glenn,021,27897,5,3,0,3,0
2020-04-21,Humboldt,023,135768,58,53,0,53,0
2020-04-21,Imperial,025,180216,362,165,0,165,2
2020-04-21,Inyo,027,18085,19,18,0,18,0
2020-04-21,Kern,029,883053,908,676,1,677,4
2020-04-21,Kings,031,150075,91,28,1,29,1
2020-04-21,Lake,033,64148,6,6,0,6,0
2020-04-21,Lassen,035,31185,3,0,2,2,0
2020-04-21,Los Angeles,037,10098052,21685,15096,14,15110,650
2020-04-21,Madera,039,155013,75,37,1,38,2
2020-04-21,Marin,041,260295,217,202,1,203,10
2020-04-21,Mariposa,043,17540,5,0,0,0,0
2020-04-21,Mendocino,045,87422,6,5,0,5,0
2020-04-21,Merced,047,269075,143,89,0,89,3
2020-04-21,Modoc,049,8938,0,0,0,0,0
2020-04-21,Mono,051,14174,29,23,0,23,1
2020-04-21,Monterey,053,433212,223,151,1,152,4
2020-04-21,Napa,055,140530,66,58,0,58,2
2020-04-21,Nevada,057,99092,41,36,1,37,1
2020-04-21,Orange,059,3164182,2693,1717,22,1739,36
2020-04-21,Placer,061,380077,156,133,0,133,8
2020-04-21,Plumas,063,18699,4,4,0,4,0
2020-04-21,Riverside,065,2383286,3996,2631,14,2645,68
2020-04-21,Sacramento,067,1510023,1051,941,0,941,33
2020-04-21,San Benito,069,59416,45,43,0,43,2
2020-04-21,San Bernardino,071,2135413,2034,1499,1,1500,71
2020-04-21,San Diego,073,3302833,3410,2436,0,2436,87
2020-04-21,San Francisco,075,870044,1522,1232,0,1232,20
2020-04-21,San Joaquin,077,732212,529,447,3,450,20
2020-04-21,San Luis Obispo,079,281455,219,134,3,137,1
2020-04-21,San Mateo,081,765935,1221,933,2,935,34
2020-04-21,Santa Barbara,083,443738,476,414,2,416,5
2020-04-21,Santa Clara,085,1922200,2383,1943,5,1948,91
2020-04-21,Santa Cruz,087,273765,131,104,0,104,2
2020-04-21,Shasta,089,179085,33,26,0,26,3
2020-04-21,Sierra,091,2930,0,0,0,0,0
2020-04-21,Siskiyou,093,43540,5,5,0,5,0
2020-04-21,Solano,095,438530,239,193,0,193,3
2020-04-21,Sonoma,097,501317,225,182,0,182,1
2020-04-21,Stanislaus,099,539301,315,235,4,239,4
2020-04-21,Sutter,101,95872,28,22,0,22,2
2020-04-21,Tehama,103,63373,1,1,0,1,1
2020-04-21,Trinity,105,12862,0,0,0,0,0
2020-04-21,Tulare,107,460477,668,410,5,415,23
2020-04-21,Tuolumne,109,53932,3,2,0,2,0
2020-04-21,Ventura,111,848112,579,455,1,456,14
2020-04-21,Yolo,113,214977,166,143,0,143,8
2020-04-21,Yuba,115,75493,16,15,0,15,1
2020-04-20,Alameda,001,1643700,1546,1181,2,1183,42
2020-04-20,Alpine,003,1148,1,1,0,1,0
2020-04-20,Amador,005,37829,8,7,0,7,0
2020-04-20,Butte,007,227075,23,15,1,16,0
2020-04-20,Calaveras,009,45235,12,12,0,12,0
2020-04-20,Colusa,011,21464,3,3,0,3,0
2020-04-20,Contra Costa,013,1133247,880,753,0,753,22
2020-04-20,Del Norte,015,27424,2,2,0,2,0
2020-04-20,El Dorado,017,186661,54,36,0,36,0
2020-04-20,Fresno,019,978130,678,356,6,362,7
2020-04-20,Glenn,021,27897,4,3,0,3,0
2020-04-20,Humboldt,023,135768,58,53,0,53,0
2020-04-20,Imperial,025,180216,343,149,0,149,2
2020-04-20,Inyo,027,18085,19,17,0,17,0
2020-04-20,Kern,029,883053,876,651,1,652,3
2020-04-20,Kings,031,150075,80,19,1,20,1
2020-04-20,Lake,033,64148,6,6,0,6,0
2020-04-20,Lassen,035,31185,3,0,2,2,0
2020-04-20,Los Angeles,037,10098052,20769,13787,14,13801,608
2020-04-20,Madera,039,155013,74,35,1,36,2
2020-04-20,Marin,041,260295,213,200,1,201,10
2020-04-20,Mariposa,043,17540,5,0,0,0,0
2020-04-20,Mendocino,045,87422,6,5,0,5,0
2020-04-20,Merced,047,269075,136,88,0,88,3
2020-04-20,Modoc,049,8938,0,0,0,0,0
2020-04-20,Mono,051,14174,29,23,0,23,1
2020-04-20,Monterey,053,433212,214,147,1,148,4
2020-04-20,Napa,055,140530,66,55,0,55,2
2020-04-20,Nevada,057,99092,41,34,1,35,1
2020-04-20,Orange,059,3164182,2609,1679,22,1701,33
2020-04-20,Placer,061,380077,155,132,0,132,8
2020-04-20,Plumas,063,18699,4,4,0,4,0
2020-04-20,Riverside,065,2383286,3871,2477,14,2491,61
2020-04-20,Sacramento,067,1510023,1041,924,0,924,32
2020-04-20,San Benito,069,59416,45,43,0,43,2
2020-04-20,San Bernardino,071,2135413,1947,1344,1,1345,63
2020-04-20,San Diego,073,3302833,3268,2327,0,2327,72
2020-04-20,San Francisco,075,870044,1490,1223,0,1223,19
2020-04-20,San Joaquin,077,732212,525,422,3,425,17
2020-04-20,San Luis Obispo,079,281455,205,132,3,135,1
2020-04-20,San Mateo,081,765935,1198,890,2,892,31
2020-04-20,Santa Barbara,083,443738,469,388,2,390,4
2020-04-20,Santa Clara,085,1922200,2352,1920,5,1925,84
2020-04-20,Santa Cruz,087,273765,129,102,0,102,2
2020-04-20,Shasta,089,179085,33,26,0,26,3
2020-04-20,Sierra,091,2930,0,0,0,0,0
2020-04-20,Siskiyou,093,43540,5,5,0,5,0
2020-04-20,Solano,095,438530,236,185,0,185,2
2020-04-20,Sonoma,097,501317,217,178,0,178,1
2020-04-20,Stanislaus,099,539301,301,228,4,232,3
2020-04-20,Sutter,101,95872,27,22,0,22,2
2020-04-20,Tehama,103,63373,1,1,0,1,1
2020-04-20,Trinity,105,12862,0,0,0,0,0
2020-04-20,Tulare,107,460477,658,401,5,406,20
2020-04-20,Tuolumne,109,53932,3,2,0,2,0
2020-04-20,Ventura,111,848112,565,426,1,427,13
2020-04-20,Yolo,113,214977,165,125,0,125,5
2020-04-20,Yuba,115,75493,16,15,0,15,1
2020-04-19,Alameda,001,1643700,1496,1134,2,1136,41
2020-04-19,Alpine,003,1148,1,1,0,1,0
2020-04-19,Amador,005,37829,7,7,0,7,0
2020-04-19,Butte,007,227075,22,15,1,16,0
2020-04-19,Calaveras,009,45235,12,12,0,12,0
2020-04-19,Colusa,011,21464,3,3,0,3,0
2020-04-19,Contra Costa,013,1133247,866,731,0,731,20
2020-04-19,Del Norte,015,27424,2,2,0,2,0
2020-04-19,El Dorado,017,186661,54,36,0,36,0
2020-04-19,Fresno,019,978130,642,326,6,332,7
2020-04-19,Glenn,021,27897,4,3,0,3,0
2020-04-19,Humboldt,023,135768,58,53,0,53,0
2020-04-19,Imperial,025,180216,317,144,0,144,2
2020-04-19,Inyo,027,18085,19,17,0,17,0
2020-04-19,Kern,029,883053,851,629,1,630,3
2020-04-19,Kings,031,150075,70,17,1,18,1
2020-04-19,Lake,033,64148,6,6,0,6,0
2020-04-19,Lassen,035,31185,3,0,2,2,0
2020-04-19,Los Angeles,037,10098052,19774,12299,14,12313,589
2020-04-19,Madera,039,155013,72,34,1,35,2
2020-04-19,Marin,041,260295,212,194,1,195,10
2020-04-19,Mariposa,043,17540,2,0,0,0,0
2020-04-19,Mendocino,045,87422,6,4,0,4,0
2020-04-19,Merced,047,269075,131,85,0,85,3
2020-04-19,Modoc,049,8938,0,0,0,0,0
2020-04-19,Mono,051,14174,29,23,0,23,1
2020-04-19,Monterey,053,433212,205,140,1,141,4
2020-04-19,Napa,055,140530,64,49,0,49,2
2020-04-19,Nevada,057,99092,40,34,1,35,1
2020-04-19,Orange,059,3164182,2512,1591,21,1612,32
2020-04-19,Placer,061,380077,154,131,0,131,8
2020-04-19,Plumas,063,18699,4,4,0,4,0
2020-04-19,Riverside,065,2383286,3728,2316,14,2330,56
2020-04-19,Sacramento,067,1510023,1014,912,0,912,32
2020-04-19,San Benito,069,59416,43,40,0,40,2
2020-04-19,San Bernardino,071,2135413,1884,1262,1,1263,58
2020-04-19,San Diego,073,3302833,3101,2270,0,2270,71
2020-04-19,San Francisco,075,870044,1457,1153,0,1153,19
2020-04-19,San Joaquin,077,732212,507,404,3,407,17
2020-04-19,San Luis Obispo,079,281455,200,132,3,135,1
2020-04-19,San Mateo,081,765935,1162,845,2,847,31
2020-04-19,Santa Barbara,083,443738,462,377,2,379,3
2020-04-19,Santa Clara,085,1922200,2307,1878,5,1883,81
2020-04-19,Santa Cruz,087,273765,126,98,0,98,2
2020-04-19,Shasta,089,179085,31,26,0,26,3
2020-04-19,Sierra,091,2930,0,0,0,0,0
2020-04-19,Siskiyou,093,43540,5,5,0,5,0
2020-04-19,Solano,095,438530,228,174,0,174,2
2020-04-19,Sonoma,097,501317,211,172,0,172,1
2020-04-19,Stanislaus,099,539301,293,221,4,225,3
2020-04-19,Sutter,101,95872,26,21,0,21,2
2020-04-19,Tehama,103,63373,1,1,0,1,1
2020-04-19,Trinity,105,12862,0,0,0,0,0
2020-04-19,Tulare,107,460477,612,391,5,396,17
2020-04-19,Tuolumne,109,53932,3,2,0,2,0
2020-04-19,Ventura,111,848112,557,418,1,419,13
2020-04-19,Yolo,113,214977,165,120,0,120,5
2020-04-19,Yuba,115,75493,16,15,0,15,1
2020-04-18,Alameda,001,1643700,1471,1085,2,1087,40
2020-04-18,Alpine,003,1148,1,1,0,1,0
2020-04-18,Amador,005,37829,7,7,0,7,0
2020-04-18,Butte,007,227075,21,15,1,16,0
2020-04-18,Calaveras,009,45235,12,12,0,12,0
2020-04-18,Colusa,011,21464,3,3,0,3,0
2020-04-18,Contra Costa,013,1133247,854,721,0,721,17
2020-04-18,Del Norte,015,27424,2,2,0,2,0
2020-04-18,El Dorado,017,186661,54,36,0,36,0
2020-04-18,Fresno,019,978130,622,319,6,325,7
2020-04-18,Glenn,021,27897,4,3,0,3,0
2020-04-18,Humboldt,023,135768,58,52,0,52,0
2020-04-18,Imperial,025,180216,308,137,0,137,2
2020-04-18,Inyo,027,18085,19,17,0,17,0
2020-04-18,Kern,029,883053,829,626,1,627,3
2020-04-18,Kings,031,150075,69,17,1,18,1
2020-04-18,Lake,033,64148,6,6,0,6,0
2020-04-18,Lassen,035,31185,3,0,2,2,0
2020-04-18,Los Angeles,037,10098052,19248,11984,14,11998,566
2020-04-18,Madera,039,155013,71,34,1,35,2
2020-04-18,Marin,041,260295,210,193,1,194,10
2020-04-18,Mariposa,043,17540,2,0,0,0,0
2020-04-18,Mendocino,045,87422,6,4,0,4,0
2020-04-18,Merced,047,269075,129,82,0,82,3
2020-04-18,Modoc,049,8938,0,0,0,0,0
2020-04-18,Mono,051,14174,29,22,0,22,1
2020-04-18,Monterey,053,433212,201,135,1,136,3
2020-04-18,Napa,055,140530,64,49,0,49,2
2020-04-18,Nevada,057,99092,39,34,1,35,1
2020-04-18,Orange,059,3164182,2448,1569,20,1589,32
2020-04-18,Placer,061,380077,152,130,0,130,8
2020-04-18,Plumas,063,18699,4,4,0,4,0
2020-04-18,Riverside,065,2383286,3653,2257,14,2271,56
2020-04-18,Sacramento,067,1510023,1002,901,0,901,32
2020-04-18,San Benito,069,59416,43,40,0,40,2
2020-04-18,San Bernardino,071,2135413,1839,1255,1,1256,58
2020-04-18,San Diego,073,3302833,2999,2215,0,2215,71
2020-04-18,San Francisco,075,870044,1418,1144,0,1144,19
2020-04-18,San Joaquin,077,732212,498,392,3,395,17
2020-04-18,San Luis Obispo,079,281455,196,129,3,132,1
2020-04-18,San Mateo,081,765935,1140,821,2,823,31
2020-04-18,Santa Barbara,083,443738,456,372,2,374,3
2020-04-18,Santa Clara,085,1922200,2274,1862,5,1867,79
2020-04-18,Santa Cruz,087,273765,124,96,0,96,2
2020-04-18,Shasta,089,179085,31,26,0,26,3
2020-04-18,Sierra,091,2930,0,0,0,0,0
2020-04-18,Siskiyou,093,43540,5,5,0,5,0
2020-04-18,Solano,095,438530,225,175,0,175,2
2020-04-18,Sonoma,097,501317,207,168,0,168,1
2020-04-18,Stanislaus,099,539301,285,216,4,220,3
2020-04-18,Sutter,101,95872,26,21,0,21,2
2020-04-18,Tehama,103,63373,1,1,0,1,1
2020-04-18,Trinity,105,12862,0,0,0,0,0
2020-04-18,Tulare,107,460477,601,385,5,390,17
2020-04-18,Tuolumne,109,53932,3,2,0,2,0
2020-04-18,Ventura,111,848112,549,416,1,417,13
2020-04-18,Yolo,113,214977,163,118,0,118,5
2020-04-18,Yuba,115,75493,16,14,0,14,1
2020-04-17,Alameda,001,1643700,1415,1043,1,1044,40
2020-04-17,Alpine,003,1148,1,1,0,1,0
2020-04-17,Amador,005,37829,7,7,0,7,0
2020-04-17,Butte,007,227075,21,15,1,16,0
2020-04-17,Calaveras,009,45235,12,11,0,11,0
2020-04-17,Colusa,011,21464,3,3,0,3,0
2020-04-17,Contra Costa,013,1133247,843,687,0,687,15
2020-04-17,Del Norte,015,27424,2,2,0,2,0
2020-04-17,El Dorado,017,186661,54,35,0,35,0
2020-04-17,Fresno,019,978130,600,315,6,321,7
2020-04-17,Glenn,021,27897,4,3,0,3,0
2020-04-17,Humboldt,023,135768,57,52,0,52,0
2020-04-17,Imperial,025,180216,299,135,0,135,2
2020-04-17,Inyo,027,18085,19,17,0,17,0
2020-04-17,Kern,029,883053,809,612,1,613,3
2020-04-17,Kings,031,150075,67,15,1,16,1
2020-04-17,Lake,033,64148,6,6,0,6,0
2020-04-17,Lassen,035,31185,3,0,2,2,0
2020-04-17,Los Angeles,037,10098052,18607,11354,14,11368,489
2020-04-17,Madera,039,155013,71,34,1,35,2
2020-04-17,Marin,041,260295,207,189,1,190,10
2020-04-17,Mariposa,043,17540,1,0,0,0,0
2020-04-17,Mendocino,045,87422,6,4,0,4,0
2020-04-17,Merced,047,269075,128,80,0,80,3
2020-04-17,Modoc,049,8938,0,0,0,0,0
2020-04-17,Mono,051,14174,29,22,0,22,1
2020-04-17,Monterey,053,433212,196,119,1,120,3
2020-04-17,Napa,055,140530,62,46,0,46,2
2020-04-17,Nevada,057,99092,38,34,1,35,1
2020-04-17,Orange,059,3164182,2397,1496,20,1516,31
2020-04-17,Placer,061,380077,152,130,0,130,8
2020-04-17,Plumas,063,18699,4,4,0,4,0
2020-04-17,Riverside,065,2383286,3526,2080,14,2094,50
2020-04-17,Sacramento,067,1510023,995,882,0,882,32
2020-04-17,San Benito,069,59416,43,38,0,38,2
2020-04-17,San Bernardino,071,2135413,1800,1229,1,1230,57
2020-04-17,San Diego,073,3302833,2909,2160,0,2160,70
2020-04-17,San Francisco,075,870044,1392,1090,0,1090,19
2020-04-17,San Joaquin,077,732212,487,356,3,359,17
2020-04-17,San Luis Obispo,079,281455,189,116,3,119,1
2020-04-17,San Mateo,081,765935,1124,768,2,770,31
2020-04-17,Santa Barbara,083,443738,451,349,2,351,3
2020-04-17,Santa Clara,085,1922200,2238,1834,5,1839,74
2020-04-17,Santa Cruz,087,273765,123,94,0,94,2
2020-04-17,Shasta,089,179085,31,26,0,26,3
2020-04-17,Sierra,091,2930,0,0,0,0,0
2020-04-17,Siskiyou,093,43540,5,5,0,5,0
2020-04-17,Solano,095,438530,224,173,0,173,2
2020-04-17,Sonoma,097,501317,204,167,0,167,1
2020-04-17,Stanislaus,099,539301,283,201,4,205,3
2020-04-17,Sutter,101,95872,26,20,0,20,2
2020-04-17,Tehama,103,63373,1,1,0,1,1
2020-04-17,Trinity,105,12862,0,0,0,0,0
2020-04-17,Tulare,107,460477,594,370,5,375,17
2020-04-17,Tuolumne,109,53932,3,2,0,2,0
2020-04-17,Ventura,111,848112,544,398,1,399,13
2020-04-17,Yolo,113,214977,162,117,0,117,5
2020-04-17,Yuba,115,75493,16,14,0,14,1
2020-04-16,Alameda,001,1643700,1380,981,1,982,39
2020-04-16,Alpine,003,1148,1,1,0,1,0
2020-04-16,Amador,005,37829,7,7,0,7,0
2020-04-16,Butte,007,227075,20,15,1,16,0
2020-04-16,Calaveras,009,45235,12,10,0,10,0
2020-04-16,Colusa,011,21464,3,3,0,3,0
2020-04-16,Contra Costa,013,1133247,829,675,0,675,14
2020-04-16,Del Norte,015,27424,2,2,0,2,0
2020-04-16,El Dorado,017,186661,53,34,0,34,0
2020-04-16,Fresno,019,978130,570,289,6,295,7
2020-04-16,Glenn,021,27897,4,3,0,3,0
2020-04-16,Humboldt,023,135768,57,47,0,47,0
2020-04-16,Imperial,025,180216,285,132,0,132,2
2020-04-16,Inyo,027,18085,17,17,0,17,0
2020-04-16,Kern,029,883053,782,587,1,588,3
2020-04-16,Kings,031,150075,63,12,1,13,1
2020-04-16,Lake,033,64148,6,6,0,6,0
2020-04-16,Lassen,035,31185,3,0,2,2,0
2020-04-16,Los Angeles,037,10098052,17721,10786,14,10800,447
2020-04-16,Madera,039,155013,69,34,1,35,2
2020-04-16,Marin,041,260295,203,170,1,171,10
2020-04-16,Mariposa,043,17540,1,1,0,1,0
2020-04-16,Mendocino,045,87422,6,4,0,4,0
2020-04-16,Merced,047,269075,122,76,0,76,3
2020-04-16,Modoc,049,8938,0,0,0,0,0
2020-04-16,Mono,051,14174,29,22,0,22,1
2020-04-16,Monterey,053,433212,193,116,1,117,3
2020-04-16,Napa,055,140530,59,44,0,44,2
2020-04-16,Nevada,057,99092,38,34,1,35,1
2020-04-16,Orange,059,3164182,2332,1439,19,1458,28
2020-04-16,Placer,061,380077,150,129,0,129,7
2020-04-16,Plumas,063,18699,4,4,0,4,0
2020-04-16,Riverside,065,2383286,3406,1913,14,1927,45
2020-04-16,Sacramento,067,1510023,987,865,0,865,32
2020-04-16,San Benito,069,59416,43,36,0,36,2
2020-04-16,San Bernardino,071,2135413,1718,1143,0,1143,54
2020-04-16,San Diego,073,3302833,2801,2089,0,2089,63
2020-04-16,San Francisco,075,870044,1348,1039,0,1039,16
2020-04-16,San Joaquin,077,732212,472,345,3,348,17
2020-04-16,San Luis Obispo,079,281455,185,113,3,116,1
2020-04-16,San Mateo,081,765935,1095,745,2,747,29
2020-04-16,Santa Barbara,083,443738,440,331,2,333,3
2020-04-16,Santa Clara,085,1922200,2201,1789,5,1794,70
2020-04-16,Santa Cruz,087,273765,121,90,0,90,2
2020-04-16,Shasta,089,179085,31,25,0,25,3
2020-04-16,Sierra,091,2930,0,0,0,0,0
2020-04-16,Siskiyou,093,43540,5,5,0,5,0
2020-04-16,Solano,095,438530,221,162,0,162,2
2020-04-16,Sonoma,097,501317,199,145,0,145,1
2020-04-16,Stanislaus,099,539301,280,185,4,189,3
2020-04-16,Sutter,101,95872,25,21,0,21,2
2020-04-16,Tehama,103,63373,1,1,0,1,1
2020-04-16,Trinity,105,12862,0,0,0,0,0
2020-04-16,Tulare,107,460477,577,305,5,310,16
2020-04-16,Tuolumne,109,53932,3,1,0,1,0
2020-04-16,Ventura,111,848112,532,384,1,385,13
2020-04-16,Yolo,113,214977,160,98,0,98,4
2020-04-16,Yuba,115,75493,15,14,0,14,1
2020-04-15,Alameda,001,1643700,1330,915,1,916,38
2020-04-15,Alpine,003,1148,1,1,0,1,0
2020-04-15,Amador,005,37829,7,7,0,7,0
2020-04-15,Butte,007,227075,20,14,1,15,0
2020-04-15,Calaveras,009,45235,11,9,0,9,0
2020-04-15,Colusa,011,21464,3,3,0,3,0
2020-04-15,Contra Costa,013,1133247,807,645,0,645,14
2020-04-15,Del Norte,015,27424,2,2,0,2,0
2020-04-15,El Dorado,017,186661,51,33,0,33,0
2020-04-15,Fresno,019,978130,544,264,6,270,7
2020-04-15,Glenn,021,27897,4,3,0,3,0
2020-04-15,Humboldt,023,135768,57,47,0,47,0
2020-04-15,Imperial,025,180216,258,115,0,115,2
2020-04-15,Inyo,027,18085,17,12,0,12,0
2020-04-15,Kern,029,883053,760,500,1,501,3
2020-04-15,Kings,031,150075,59,12,1,13,1
2020-04-15,Lake,033,64148,6,4,0,4,0
2020-04-15,Lassen,035,31185,3,0,2,2,0
2020-04-15,Los Angeles,037,10098052,16901,10416,13,10429,394
2020-04-15,Madera,039,155013,69,30,1,31,2
2020-04-15,Marin,041,260295,200,162,1,163,10
2020-04-15,Mariposa,043,17540,0,0,0,0,0
2020-04-15,Mendocino,045,87422,5,4,0,4,0
2020-04-15,Merced,047,269075,120,74,0,74,3
2020-04-15,Modoc,049,8938,0,0,0,0,0
2020-04-15,Mono,051,14174,29,22,0,22,1
2020-04-15,Monterey,053,433212,185,106,1,107,3
2020-04-15,Napa,055,140530,56,34,0,34,2
2020-04-15,Nevada,057,99092,37,34,1,35,1
2020-04-15,Orange,059,3164182,2229,1377,19,1396,24
2020-04-15,Placer,061,380077,149,123,0,123,6
2020-04-15,Plumas,063,18699,4,4,0,4,0
2020-04-15,Riverside,065,2383286,3211,1723,14,1737,42
2020-04-15,Sacramento,067,1510023,978,839,0,839,32
2020-04-15,San Benito,069,59416,43,34,0,34,2
2020-04-15,San Bernardino,071,2135413,1648,1063,0,1063,45
2020-04-15,San Diego,073,3302833,2713,2014,0,2014,60
2020-04-15,San Francisco,075,870044,1312,1006,0,1006,16
2020-04-15,San Joaquin,077,732212,464,329,3,332,17
2020-04-15,San Luis Obispo,079,281455,177,112,3,115,1
2020-04-15,San Mateo,081,765935,1046,707,2,709,28
2020-04-15,Santa Barbara,083,443738,424,317,2,319,2
2020-04-15,Santa Clara,085,1922200,2162,1692,5,1697,69
2020-04-15,Santa Cruz,087,273765,117,92,0,92,2
2020-04-15,Shasta,089,179085,31,25,0,25,3
2020-04-15,Sierra,091,2930,0,0,0,0,0
2020-04-15,Siskiyou,093,43540,5,5,0,5,0
2020-04-15,Solano,095,438530,216,153,0,153,2
2020-04-15,Sonoma,097,501317,197,140,0,140,1
2020-04-15,Stanislaus,099,539301,273,174,4,178,3
2020-04-15,Sutter,101,95872,25,19,0,19,2
2020-04-15,Tehama,103,63373,1,1,0,1,1
2020-04-15,Trinity,105,12862,0,0,0,0,0
2020-04-15,Tulare,107,460477,559,289,5,294,14
2020-04-15,Tuolumne,109,53932,3,1,0,1,0
2020-04-15,Ventura,111,848112,517,365,1,366,13
2020-04-15,Yolo,113,214977,156,93,0,93,3
2020-04-15,Yuba,115,75493,15,15,0,15,1
2020-04-14,Alameda,001,1643700,1285,843,1,844,30
2020-04-14,Alpine,003,1148,1,1,0,1,0
2020-04-14,Amador,005,37829,7,6,0,6,0
2020-04-14,Butte,007,227075,20,13,1,14,0
2020-04-14,Calaveras,009,45235,11,5,0,5,0
2020-04-14,Colusa,011,21464,3,3,0,3,0
2020-04-14,Contra Costa,013,1133247,795,617,0,617,12
2020-04-14,Del Norte,015,27424,2,2,0,2,0
2020-04-14,El Dorado,017,186661,51,30,0,30,0
2020-04-14,Fresno,019,978130,521,244,6,250,6
2020-04-14,Glenn,021,27897,4,3,0,3,0
2020-04-14,Humboldt,023,135768,57,44,0,44,0
2020-04-14,Imperial,025,180216,238,86,0,86,2
2020-04-14,Inyo,027,18085,17,12,0,12,0
2020-04-14,Kern,029,883053,736,453,1,454,3
2020-04-14,Kings,031,150075,58,12,1,13,1
2020-04-14,Lake,033,64148,6,3,0,3,0
2020-04-14,Lassen,035,31185,3,0,2,2,0
2020-04-14,Los Angeles,037,10098052,16006,9948,12,9960,357
2020-04-14,Madera,039,155013,68,29,1,30,2
2020-04-14,Marin,041,260295,196,147,1,148,9
2020-04-14,Mariposa,043,17540,0,0,0,0,0
2020-04-14,Mendocino,045,87422,5,4,0,4,0
2020-04-14,Merced,047,269075,113,61,0,61,3
2020-04-14,Modoc,049,8938,0,0,0,0,0
2020-04-14,Mono,051,14174,29,22,0,22,1
2020-04-14,Monterey,053,433212,180,98,1,99,3
2020-04-14,Napa,055,140530,56,33,0,33,2
2020-04-14,Nevada,057,99092,37,34,1,35,1
2020-04-14,Orange,059,3164182,2127,1362,19,1381,24
2020-04-14,Placer,061,380077,148,117,0,117,5
2020-04-14,Plumas,063,18699,4,3,0,3,0
2020-04-14,Riverside,065,2383286,3076,1467,14,1481,40
2020-04-14,Sacramento,067,1510023,969,737,0,737,29
2020-04-14,San Benito,069,59416,40,34,0,34,2
2020-04-14,San Bernardino,071,2135413,1593,933,0,933,37
2020-04-14,San Diego,073,3302833,2618,1932,0,1932,53
2020-04-14,San Francisco,075,870044,1258,968,0,968,14
2020-04-14,San Joaquin,077,732212,454,280,3,283,17
2020-04-14,San Luis Obispo,079,281455,174,109,3,112,1
2020-04-14,San Mateo,081,765935,1012,681,2,683,28
2020-04-14,Santa Barbara,083,443738,400,292,2,294,2
2020-04-14,Santa Clara,085,1922200,2129,1561,5,1566,63
2020-04-14,Santa Cruz,087,273765,109,84,0,84,2
2020-04-14,Shasta,089,179085,31,24,0,24,3
2020-04-14,Sierra,091,2930,0,0,0,0,0
2020-04-14,Siskiyou,093,43540,5,5,0,5,0
2020-04-14,Solano,095,438530,213,140,0,140,2
2020-04-14,Sonoma,097,501317,193,133,0,133,1
2020-04-14,Stanislaus,099,539301,260,136,4,140,3
2020-04-14,Sutter,101,95872,24,19,0,19,2
2020-04-14,Tehama,103,63373,1,1,0,1,1
2020-04-14,Trinity,105,12862,0,0,0,0,0
2020-04-14,Tulare,107,460477,535,228,5,233,12
2020-04-14,Tuolumne,109,53932,3,0,0,0,0
2020-04-14,Ventura,111,848112,504,328,1,329,11
2020-04-14,Yolo,113,214977,153,81,0,81,3
2020-04-14,Yuba,115,75493,14,14,0,14,1
2020-04-13,Alameda,001,1643700,1246,821,1,822,23
2020-04-13,Alpine,003,1148,1,1,0,1,0
2020-04-13,Amador,005,37829,7,6,0,6,0
2020-04-13,Butte,007,227075,20,13,1,14,0
2020-04-13,Calaveras,009,45235,10,5,0,5,0
2020-04-13,Colusa,011,21464,3,3,0,3,0
2020-04-13,Contra Costa,013,1133247,779,569,0,569,12
2020-04-13,Del Norte,015,27424,2,2,0,2,0
2020-04-13,El Dorado,017,186661,49,29,0,29,0
2020-04-13,Fresno,019,978130,499,205,5,210,4
2020-04-13,Glenn,021,27897,4,3,0,3,0
2020-04-13,Humboldt,023,135768,57,44,0,44,0
2020-04-13,Imperial,025,180216,220,82,0,82,2
2020-04-13,Inyo,027,18085,17,12,0,12,0
2020-04-13,Kern,029,883053,711,346,1,347,3
2020-04-13,Kings,031,150075,54,9,1,10,0
2020-04-13,Lake,033,64148,6,3,0,3,0
2020-04-13,Lassen,035,31185,3,0,2,2,0
2020-04-13,Los Angeles,037,10098052,15292,9367,12,9379,317
2020-04-13,Madera,039,155013,66,29,1,30,2
2020-04-13,Marin,041,260295,192,144,1,145,6
2020-04-13,Mariposa,043,17540,0,0,0,0,0
2020-04-13,Mendocino,045,87422,5,4,0,4,0
2020-04-13,Merced,047,269075,112,60,0,60,3
2020-04-13,Modoc,049,8938,0,0,0,0,0
2020-04-13,Mono,051,14174,29,21,0,21,1
2020-04-13,Monterey,053,433212,173,86,1,87,3
2020-04-13,Napa,055,140530,55,30,0,30,2
2020-04-13,Nevada,057,99092,37,24,1,25,1
2020-04-13,Orange,059,3164182,2054,1313,19,1332,21
2020-04-13,Placer,061,380077,147,116,0,116,5
2020-04-13,Plumas,063,18699,4,3,0,3,0
2020-04-13,Riverside,065,2383286,2935,1460,13,1473,35
2020-04-13,Sacramento,067,1510023,957,723,0,723,25
2020-04-13,San Benito,069,59416,39,33,0,33,2
2020-04-13,San Bernardino,071,2135413,1518,920,0,920,30
2020-04-13,San Diego,073,3302833,2535,1849,0,1849,47
2020-04-13,San Francisco,075,870044,1220,948,0,948,12
2020-04-13,San Joaquin,077,732212,439,255,3,258,16
2020-04-13,San Luis Obispo,079,281455,169,106,3,109,1
2020-04-13,San Mateo,081,765935,972,679,2,681,25
2020-04-13,Santa Barbara,083,443738,381,271,1,272,2
2020-04-13,Santa Clara,085,1922200,2083,1540,5,1545,58
2020-04-13,Santa Cruz,087,273765,103,82,0,82,1
2020-04-13,Shasta,089,179085,30,24,0,24,3
2020-04-13,Sierra,091,2930,0,0,0,0,0
2020-04-13,Siskiyou,093,43540,5,5,0,5,0
2020-04-13,Solano,095,438530,210,136,0,136,2
2020-04-13,Sonoma,097,501317,186,133,0,133,1
2020-04-13,Stanislaus,099,539301,254,130,4,134,1
2020-04-13,Sutter,101,95872,24,18,0,18,2
2020-04-13,Tehama,103,63373,1,1,0,1,0
2020-04-13,Trinity,105,12862,0,0,0,0,0
2020-04-13,Tulare,107,460477,499,185,5,190,11
2020-04-13,Tuolumne,109,53932,3,0,0,0,0
2020-04-13,Ventura,111,848112,483,309,0,309,9
2020-04-13,Yolo,113,214977,147,81,0,81,3
2020-04-13,Yuba,115,75493,14,13,0,13,1
2020-04-12,Alameda,001,1643700,1203,774,1,775,23
2020-04-12,Alpine,003,1148,1,1,0,1,0
2020-04-12,Amador,005,37829,7,6,0,6,0
2020-04-12,Butte,007,227075,20,13,1,14,0
2020-04-12,Calaveras,009,45235,10,5,0,5,0
2020-04-12,Colusa,011,21464,3,3,0,3,0
2020-04-12,Contra Costa,013,1133247,766,553,0,553,12
2020-04-12,Del Norte,015,27424,2,2,0,2,0
2020-04-12,El Dorado,017,186661,49,28,0,28,0
2020-04-12,Fresno,019,978130,470,205,5,210,4
2020-04-12,Glenn,021,27897,4,3,0,3,0
2020-04-12,Humboldt,023,135768,57,43,0,43,0
2020-04-12,Imperial,025,180216,197,78,0,78,2
2020-04-12,Inyo,027,18085,15,12,0,12,0
2020-04-12,Kern,029,883053,679,319,0,319,3
2020-04-12,Kings,031,150075,52,9,1,10,0
2020-04-12,Lake,033,64148,6,3,0,3,0
2020-04-12,Lassen,035,31185,3,0,2,2,0
2020-04-12,Los Angeles,037,10098052,14579,9133,12,9145,294
2020-04-12,Madera,039,155013,65,29,1,30,2
2020-04-12,Marin,041,260295,181,138,1,139,6
2020-04-12,Mariposa,043,17540,0,0,0,0,0
2020-04-12,Mendocino,045,87422,5,4,0,4,0
2020-04-12,Merced,047,269075,106,58,0,58,3
2020-04-12,Modoc,049,8938,0,0,0,0,0
2020-04-12,Mono,051,14174,29,20,0,20,1
2020-04-12,Monterey,053,433212,159,85,1,86,3
2020-04-12,Napa,055,140530,53,29,0,29,2
2020-04-12,Nevada,057,99092,37,24,1,25,1
2020-04-12,Orange,059,3164182,1994,1283,18,1301,21
2020-04-12,Placer,061,380077,146,114,0,114,4
2020-04-12,Plumas,063,18699,4,3,0,3,0
2020-04-12,Riverside,065,2383286,2753,1330,13,1343,34
2020-04-12,Sacramento,067,1510023,920,689,0,689,25
2020-04-12,San Benito,069,59416,37,33,0,33,2
2020-04-12,San Bernardino,071,2135413,1441,827,0,827,30
2020-04-12,San Diego,073,3302833,2445,1806,0,1806,45
2020-04-12,San Francisco,075,870044,1193,886,0,886,11
2020-04-12,San Joaquin,077,732212,421,246,3,249,15
2020-04-12,San Luis Obispo,079,281455,166,102,2,104,1
2020-04-12,San Mateo,081,765935,946,664,2,666,25
2020-04-12,Santa Barbara,083,443738,362,261,1,262,2
2020-04-12,Santa Clara,085,1922200,2055,1461,5,1466,53
2020-04-12,Santa Cruz,087,273765,102,80,0,80,1
2020-04-12,Shasta,089,179085,30,24,0,24,3
2020-04-12,Sierra,091,2930,0,0,0,0,0
2020-04-12,Siskiyou,093,43540,5,5,0,5,0
2020-04-12,Solano,095,438530,204,136,0,136,2
2020-04-12,Sonoma,097,501317,183,131,0,131,1
2020-04-12,Stanislaus,099,539301,246,117,4,121,1
2020-04-12,Sutter,101,95872,23,18,0,18,2
2020-04-12,Tehama,103,63373,1,1,0,1,0
2020-04-12,Trinity,105,12862,0,0,0,0,0
2020-04-12,Tulare,107,460477,487,166,5,171,11
2020-04-12,Tuolumne,109,53932,3,0,0,0,0
2020-04-12,Ventura,111,848112,473,306,0,306,9
2020-04-12,Yolo,113,214977,135,67,0,67,3
2020-04-12,Yuba,115,75493,14,13,0,13,1
2020-04-11,Alameda,001,1643700,1162,751,1,752,23
2020-04-11,Alpine,003,1148,1,1,0,1,0
2020-04-11,Amador,005,37829,7,6,0,6,0
2020-04-11,Butte,007,227075,20,13,1,14,0
2020-04-11,Calaveras,009,45235,10,5,0,5,0
2020-04-11,Colusa,011,21464,3,3,0,3,0
2020-04-11,Contra Costa,013,1133247,757,550,0,550,12
2020-04-11,Del Norte,015,27424,2,2,0,2,0
2020-04-11,El Dorado,017,186661,48,29,0,29,0
2020-04-11,Fresno,019,978130,460,201,5,206,4
2020-04-11,Glenn,021,27897,4,3,0,3,0
2020-04-11,Humboldt,023,135768,57,38,0,38,0
2020-04-11,Imperial,025,180216,187,78,0,78,2
2020-04-11,Inyo,027,18085,15,12,0,12,0
2020-04-11,Kern,029,883053,651,304,0,304,3
2020-04-11,Kings,031,150075,49,9,1,10,0
2020-04-11,Lake,033,64148,6,3,0,3,0
2020-04-11,Lassen,035,31185,3,0,2,2,0
2020-04-11,Los Angeles,037,10098052,14108,8823,12,8835,262
2020-04-11,Madera,039,155013,64,29,1,30,2
2020-04-11,Marin,041,260295,178,136,1,137,6
2020-04-11,Mariposa,043,17540,0,0,0,0,0
2020-04-11,Mendocino,045,87422,5,4,0,4,0
2020-04-11,Merced,047,269075,103,59,0,59,3
2020-04-11,Modoc,049,8938,0,0,0,0,0
2020-04-11,Mono,051,14174,29,20,0,20,1
2020-04-11,Monterey,053,433212,153,78,1,79,3
2020-04-11,Napa,055,140530,53,29,0,29,2
2020-04-11,Nevada,057,99092,37,24,1,25,1
2020-04-11,Orange,059,3164182,1932,1267,18,1285,21
2020-04-11,Placer,061,380077,146,113,0,113,4
2020-04-11,Plumas,063,18699,4,3,0,3,0
2020-04-11,Riverside,065,2383286,2674,1260,13,1273,33
2020-04-11,Sacramento,067,1510023,909,685,0,685,25
2020-04-11,San Benito,069,59416,37,33,0,33,2
2020-04-11,San Bernardino,071,2135413,1405,826,0,826,28
2020-04-11,San Diego,073,3302833,2379,1763,0,1763,45
2020-04-11,San Francisco,075,870044,1171,860,0,860,11
2020-04-11,San Joaquin,077,732212,416,244,3,247,15
2020-04-11,San Luis Obispo,079,281455,166,100,1,101,1
2020-04-11,San Mateo,081,765935,934,662,2,664,25
2020-04-11,Santa Barbara,083,443738,354,258,1,259,2
2020-04-11,Santa Clara,085,1922200,1996,1441,5,1446,51
2020-04-11,Santa Cruz,087,273765,102,79,0,79,1
2020-04-11,Shasta,089,179085,30,24,0,24,3
2020-04-11,Sierra,091,2930,0,0,0,0,0
2020-04-11,Siskiyou,093,43540,5,5,0,5,0
2020-04-11,Solano,095,438530,200,138,0,138,2
2020-04-11,Sonoma,097,501317,181,131,0,131,1
2020-04-11,Stanislaus,099,539301,238,119,3,122,1
2020-04-11,Sutter,101,95872,23,18,0,18,2
2020-04-11,Tehama,103,63373,1,1,0,1,0
2020-04-11,Trinity,105,12862,0,0,0,0,0
2020-04-11,Tulare,107,460477,465,168,5,173,10
2020-04-11,Tuolumne,109,53932,3,0,0,0,0
2020-04-11,Ventura,111,848112,463,304,0,304,9
2020-04-11,Yolo,113,214977,132,67,0,67,3
2020-04-11,Yuba,115,75493,14,13,0,13,1
2020-04-10,Alameda,001,1643700,1121,706,1,707,21
2020-04-10,Alpine,003,1148,1,1,0,1,0
2020-04-10,Amador,005,37829,7,5,0,5,0
2020-04-10,Butte,007,227075,20,13,1,14,0
2020-04-10,Calaveras,009,45235,10,5,0,5,0
2020-04-10,Colusa,011,21464,3,3,0,3,0
2020-04-10,Contra Costa,013,1133247,744,537,0,537,10
2020-04-10,Del Norte,015,27424,2,2,0,2,0
2020-04-10,El Dorado,017,186661,48,26,0,26,0
2020-04-10,Fresno,019,978130,453,186,4,190,3
2020-04-10,Glenn,021,27897,4,3,0,3,0
2020-04-10,Humboldt,023,135768,57,36,0,36,0
2020-04-10,Imperial,025,180216,180,70,0,70,2
2020-04-10,Inyo,027,18085,13,11,0,11,0
2020-04-10,Kern,029,883053,627,272,0,272,3
2020-04-10,Kings,031,150075,46,7,1,8,0
2020-04-10,Lake,033,64148,6,3,0,3,0
2020-04-10,Lassen,035,31185,3,0,2,2,0
2020-04-10,Los Angeles,037,10098052,13594,8384,11,8395,239
2020-04-10,Madera,039,155013,63,29,1,30,2
2020-04-10,Marin,041,260295,173,128,1,129,6
2020-04-10,Mariposa,043,17540,0,0,0,0,0
2020-04-10,Mendocino,045,87422,5,4,0,4,0
2020-04-10,Merced,047,269075,100,56,0,56,3
2020-04-10,Modoc,049,8938,0,0,0,0,0
2020-04-10,Mono,051,14174,29,20,0,20,1
2020-04-10,Monterey,053,433212,142,78,1,79,3
2020-04-10,Napa,055,140530,50,28,0,28,2
2020-04-10,Nevada,057,99092,37,23,1,24,1
2020-04-10,Orange,059,3164182,1885,1167,18,1185,21
2020-04-10,Placer,061,380077,145,112,0,112,4
2020-04-10,Plumas,063,18699,4,3,0,3,0
2020-04-10,Riverside,065,2383286,2608,1162,13,1175,30
2020-04-10,Sacramento,067,1510023,900,642,0,642,24
2020-04-10,San Benito,069,59416,37,32,0,32,2
2020-04-10,San Bernardino,071,2135413,1357,779,0,779,27
2020-04-10,San Diego,073,3302833,2319,1695,0,1695,44
2020-04-10,San Francisco,075,870044,1140,797,0,797,10
2020-04-10,San Joaquin,077,732212,404,234,3,237,14
2020-04-10,San Luis Obispo,079,281455,166,97,1,98,1
2020-04-10,San Mateo,081,765935,918,642,2,644,24
2020-04-10,Santa Barbara,083,443738,346,254,1,255,2
2020-04-10,Santa Clara,085,1922200,1944,1351,5,1356,50
2020-04-10,Santa Cruz,087,273765,101,75,0,75,1
2020-04-10,Shasta,089,179085,30,24,0,24,3
2020-04-10,Sierra,091,2930,0,0,0,0,0
2020-04-10,Siskiyou,093,43540,5,5,0,5,0
2020-04-10,Solano,095,438530,197,129,0,129,2
2020-04-10,Sonoma,097,501317,180,129,0,129,1
2020-04-10,Stanislaus,099,539301,231,101,3,104,0
2020-04-10,Sutter,101,95872,23,18,0,18,2
2020-04-10,Tehama,103,63373,1,1,0,1,0
2020-04-10,Trinity,105,12862,0,0,0,0,0
2020-04-10,Tulare,107,460477,423,163,5,168,10
2020-04-10,Tuolumne,109,53932,3,0,0,0,0
2020-04-10,Ventura,111,848112,454,290,0,290,9
2020-04-10,Yolo,113,214977,130,62,0,62,3
2020-04-10,Yuba,115,75493,14,13,0,13,1
2020-04-09,Alameda,001,1643700,1071,641,1,642,17
2020-04-09,Alpine,003,1148,1,1,0,1,0
2020-04-09,Amador,005,37829,7,2,0,2,0
2020-04-09,Butte,007,227075,19,12,1,13,0
2020-04-09,Calaveras,009,45235,10,5,0,5,0
2020-04-09,Colusa,011,21464,3,3,0,3,0
2020-04-09,Contra Costa,013,1133247,701,505,0,505,7
2020-04-09,Del Norte,015,27424,2,2,0,2,0
2020-04-09,El Dorado,017,186661,47,25,0,25,0
2020-04-09,Fresno,019,978130,428,165,4,169,3
2020-04-09,Glenn,021,27897,4,2,0,2,0
2020-04-09,Humboldt,023,135768,57,36,0,36,0
2020-04-09,Imperial,025,180216,159,67,0,67,2
2020-04-09,Inyo,027,18085,12,11,0,11,0
2020-04-09,Kern,029,883053,591,241,0,241,2
2020-04-09,Kings,031,150075,43,5,1,6,0
2020-04-09,Lake,033,64148,5,1,0,1,0
2020-04-09,Lassen,035,31185,3,0,2,2,0
2020-04-09,Los Angeles,037,10098052,12966,7919,11,7930,220
2020-04-09,Madera,039,155013,63,28,1,29,2
2020-04-09,Marin,041,260295,171,126,1,127,7
2020-04-09,Mariposa,043,17540,0,0,0,0,0
2020-04-09,Mendocino,045,87422,5,4,0,4,0
2020-04-09,Merced,047,269075,97,41,0,41,3
2020-04-09,Modoc,049,8938,0,0,0,0,0
2020-04-09,Mono,051,14174,29,19,0,19,1
2020-04-09,Monterey,053,433212,124,70,1,71,3
2020-04-09,Napa,055,140530,46,27,0,27,2
2020-04-09,Nevada,057,99092,36,23,1,24,1
2020-04-09,Orange,059,3164182,1811,1105,18,1123,19
2020-04-09,Placer,061,380077,144,107,0,107,4
2020-04-09,Plumas,063,18699,4,3,0,3,0
2020-04-09,Riverside,065,2383286,2465,1083,13,1096,29
2020-04-09,Sacramento,067,1510023,877,601,0,601,21
2020-04-09,San Benito,069,59416,37,32,0,32,2
2020-04-09,San Bernardino,071,2135413,1288,717,0,717,27
2020-04-09,San Diego,073,3302833,2223,1630,0,1630,40
2020-04-09,San Francisco,075,870044,1120,748,0,748,8
2020-04-09,San Joaquin,077,732212,383,223,3,226,14
2020-04-09,San Luis Obispo,079,281455,158,93,1,94,1
2020-04-09,San Mateo,081,765935,902,630,2,632,23
2020-04-09,Santa Barbara,083,443738,336,232,1,233,2
2020-04-09,Santa Clara,085,1922200,1874,1301,5,1306,49
2020-04-09,Santa Cruz,087,273765,101,73,0,73,1
2020-04-09,Shasta,089,179085,30,22,0,22,3
2020-04-09,Sierra,091,2930,0,0,0,0,0
2020-04-09,Siskiyou,093,43540,5,4,0,4,0
2020-04-09,Solano,095,438530,188,118,0,118,2
2020-04-09,Sonoma,097,501317,176,113,0,113,1
2020-04-09,Stanislaus,099,539301,219,93,3,96,0
2020-04-09,Sutter,101,95872,23,17,0,17,2
2020-04-09,Tehama,103,63373,1,1,0,1,0
2020-04-09,Trinity,105,12862,0,0,0,0,0
2020-04-09,Tulare,107,460477,394,147,5,152,9
2020-04-09,Tuolumne,109,53932,3,0,0,0,0
2020-04-09,Ventura,111,848112,435,273,0,273,9
2020-04-09,Yolo,113,214977,121,59,0,59,3
2020-04-09,Yuba,115,75493,14,13,0,13,0
2020-04-08,Alameda,001,1643700,1029,594,1,595,15
2020-04-08,Alpine,003,1148,1,1,0,1,0
2020-04-08,Amador,005,37829,7,2,0,2,0
2020-04-08,Butte,007,227075,18,11,1,12,0
2020-04-08,Calaveras,009,45235,10,5,0,5,0
2020-04-08,Colusa,011,21464,3,3,0,3,0
2020-04-08,Contra Costa,013,1133247,688,481,0,481,7
2020-04-08,Del Norte,015,27424,2,2,0,2,0
2020-04-08,El Dorado,017,186661,47,25,0,25,0
2020-04-08,Fresno,019,978130,408,151,4,155,3
2020-04-08,Glenn,021,27897,4,2,0,2,0
2020-04-08,Humboldt,023,135768,57,40,0,40,0
2020-04-08,Imperial,025,180216,148,59,0,59,2
2020-04-08,Inyo,027,18085,12,11,0,11,0
2020-04-08,Kern,029,883053,550,198,0,198,2
2020-04-08,Kings,031,150075,43,5,1,6,0
2020-04-08,Lake,033,64148,5,1,0,1,0
2020-04-08,Lassen,035,31185,3,0,2,2,0
2020-04-08,Los Angeles,037,10098052,12364,7505,11,7516,196
2020-04-08,Madera,039,155013,62,28,1,29,2
2020-04-08,Marin,041,260295,165,125,1,126,7
2020-04-08,Mariposa,043,17540,0,0,0,0,0
2020-04-08,Mendocino,045,87422,5,4,0,4,0
2020-04-08,Merced,047,269075,82,35,0,35,1
2020-04-08,Modoc,049,8938,0,0,0,0,0
2020-04-08,Mono,051,14174,29,19,0,19,1
2020-04-08,Monterey,053,433212,115,68,1,69,3
2020-04-08,Napa,055,140530,44,21,0,21,2
2020-04-08,Nevada,057,99092,36,21,1,22,1
2020-04-08,Orange,059,3164182,1748,1034,18,1052,19
2020-04-08,Placer,061,380077,144,102,0,102,4
2020-04-08,Plumas,063,18699,4,3,0,3,0
2020-04-08,Riverside,065,2383286,2308,974,13,987,28
2020-04-08,Sacramento,067,1510023,843,565,0,565,21
2020-04-08,San Benito,069,59416,37,31,0,31,2
2020-04-08,San Bernardino,071,2135413,1231,635,0,635,22
2020-04-08,San Diego,073,3302833,2149,1532,0,1532,36
2020-04-08,San Francisco,075,870044,1053,687,0,687,7
2020-04-08,San Joaquin,077,732212,366,211,3,214,12
2020-04-08,San Luis Obispo,079,281455,156,90,1,91,1
2020-04-08,San Mateo,081,765935,887,608,2,610,22
2020-04-08,Santa Barbara,083,443738,319,221,1,222,2
2020-04-08,Santa Clara,085,1922200,1829,1257,5,1262,47
2020-04-08,Santa Cruz,087,273765,100,69,0,69,1
2020-04-08,Shasta,089,179085,30,18,0,18,3
2020-04-08,Sierra,091,2930,0,0,0,0,0
2020-04-08,Siskiyou,093,43540,5,4,0,4,0
2020-04-08,Solano,095,438530,175,111,0,111,2
2020-04-08,Sonoma,097,501317,171,107,0,107,1
2020-04-08,Stanislaus,099,539301,203,86,3,89,0
2020-04-08,Sutter,101,95872,22,17,0,17,2
2020-04-08,Tehama,103,63373,1,1,0,1,0
2020-04-08,Trinity,105,12862,0,0,0,0,0
2020-04-08,Tulare,107,460477,363,145,5,150,6
2020-04-08,Tuolumne,109,53932,3,0,0,0,0
2020-04-08,Ventura,111,848112,426,263,0,263,7
2020-04-08,Yolo,113,214977,104,56,0,56,3
2020-04-08,Yuba,115,75493,14,10,0,10,0
2020-04-07,Alameda,001,1643700,994,560,1,561,14
2020-04-07,Alpine,003,1148,1,1,0,1,0
2020-04-07,Amador,005,37829,7,2,0,2,0
2020-04-07,Butte,007,227075,17,11,1,12,0
2020-04-07,Calaveras,009,45235,9,5,0,5,0
2020-04-07,Colusa,011,21464,3,2,0,2,0
2020-04-07,Contra Costa,013,1133247,668,471,0,471,7
2020-04-07,Del Norte,015,27424,2,2,0,2,0
2020-04-07,El Dorado,017,186661,46,22,0,22,0
2020-04-07,Fresno,019,978130,393,138,4,142,3
2020-04-07,Glenn,021,27897,4,2,0,2,0
2020-04-07,Humboldt,023,135768,56,40,0,40,0
2020-04-07,Imperial,025,180216,129,53,0,53,2
2020-04-07,Inyo,027,18085,12,11,0,11,0
2020-04-07,Kern,029,883053,507,134,0,134,2
2020-04-07,Kings,031,150075,40,5,1,6,0
2020-04-07,Lake,033,64148,4,1,0,1,0
2020-04-07,Lassen,035,31185,3,0,2,2,0
2020-04-07,Los Angeles,037,10098052,11715,6885,11,6896,170
2020-04-07,Madera,039,155013,60,28,0,28,2
2020-04-07,Marin,041,260295,163,122,1,123,7
2020-04-07,Mariposa,043,17540,0,0,0,0,0
2020-04-07,Mendocino,045,87422,5,4,0,4,0
2020-04-07,Merced,047,269075,67,27,0,27,1
2020-04-07,Modoc,049,8938,0,0,0,0,0
2020-04-07,Mono,051,14174,28,18,0,18,1
2020-04-07,Monterey,053,433212,107,63,1,64,2
2020-04-07,Napa,055,140530,42,18,0,18,2
2020-04-07,Nevada,057,99092,36,20,1,21,1
2020-04-07,Orange,059,3164182,1701,971,16,987,19
2020-04-07,Placer,061,380077,139,94,0,94,3
2020-04-07,Plumas,063,18699,4,3,0,3,0
2020-04-07,Riverside,065,2383286,2151,905,13,918,25
2020-04-07,Sacramento,067,1510023,813,513,0,513,18
2020-04-07,San Benito,069,59416,37,26,0,26,2
2020-04-07,San Bernardino,071,2135413,1164,554,0,554,19
2020-04-07,San Diego,073,3302833,2072,1456,0,1456,31
2020-04-07,San Francisco,075,870044,993,636,0,636,6
2020-04-07,San Joaquin,077,732212,348,198,3,201,12
2020-04-07,San Luis Obispo,079,281455,149,87,1,88,1
2020-04-07,San Mateo,081,765935,866,573,2,575,22
2020-04-07,Santa Barbara,083,443738,305,209,1,210,2
2020-04-07,Santa Clara,085,1922200,1760,1193,4,1197,46
2020-04-07,Santa Cruz,087,273765,100,67,0,67,1
2020-04-07,Shasta,089,179085,29,16,0,16,3
2020-04-07,Sierra,091,2930,0,0,0,0,0
2020-04-07,Siskiyou,093,43540,5,4,0,4,0
2020-04-07,Solano,095,438530,170,99,0,99,1
2020-04-07,Sonoma,097,501317,168,102,0,102,1
2020-04-07,Stanislaus,099,539301,186,83,3,86,0
2020-04-07,Sutter,101,95872,22,16,0,16,2
2020-04-07,Tehama,103,63373,1,1,0,1,0
2020-04-07,Trinity,105,12862,0,0,0,0,0
2020-04-07,Tulare,107,460477,334,144,5,149,5
2020-04-07,Tuolumne,109,53932,3,1,0,1,0
2020-04-07,Ventura,111,848112,409,247,0,247,6
2020-04-07,Yolo,113,214977,97,51,0,51,2
2020-04-07,Yuba,115,75493,14,10,0,10,0
2020-04-06,Alameda,001,1643700,964,527,1,528,13
2020-04-06,Alpine,003,1148,1,1,0,1,0
2020-04-06,Amador,005,37829,6,2,0,2,0
2020-04-06,Butte,007,227075,16,11,1,12,0
2020-04-06,Calaveras,009,45235,9,4,0,4,0
2020-04-06,Colusa,011,21464,3,1,0,1,0
2020-04-06,Contra Costa,013,1133247,643,447,0,447,7
2020-04-06,Del Norte,015,27424,2,2,0,2,0
2020-04-06,El Dorado,017,186661,44,23,0,23,0
2020-04-06,Fresno,019,978130,371,122,4,126,1
2020-04-06,Glenn,021,27897,4,2,0,2,0
2020-04-06,Humboldt,023,135768,55,37,0,37,0
2020-04-06,Imperial,025,180216,122,47,0,47,1
2020-04-06,Inyo,027,18085,11,11,0,11,0
2020-04-06,Kern,029,883053,470,117,0,117,2
2020-04-06,Kings,031,150075,40,3,1,4,0
2020-04-06,Lake,033,64148,4,1,0,1,0
2020-04-06,Lassen,035,31185,3,0,2,2,0
2020-04-06,Los Angeles,037,10098052,10983,6346,11,6357,145
2020-04-06,Madera,039,155013,58,29,0,29,2
2020-04-06,Marin,041,260295,160,119,1,120,7
2020-04-06,Mariposa,043,17540,0,0,0,0,0
2020-04-06,Mendocino,045,87422,5,4,0,4,0
2020-04-06,Merced,047,269075,60,25,0,25,1
2020-04-06,Modoc,049,8938,0,0,0,0,0
2020-04-06,Mono,051,14174,28,18,0,18,1
2020-04-06,Monterey,053,433212,102,62,1,63,2
2020-04-06,Napa,055,140530,42,18,0,18,2
2020-04-06,Nevada,057,99092,36,19,1,20,1
2020-04-06,Orange,059,3164182,1657,910,15,925,17
2020-04-06,Placer,061,380077,139,90,0,90,3
2020-04-06,Plumas,063,18699,4,2,0,2,0
2020-04-06,Riverside,065,2383286,2025,854,13,867,17
2020-04-06,Sacramento,067,1510023,783,448,0,448,15
2020-04-06,San Benito,069,59416,35,25,0,25,1
2020-04-06,San Bernardino,071,2135413,1105,550,0,550,13
2020-04-06,San Diego,073,3302833,1990,1406,0,1406,19
2020-04-06,San Francisco,075,870044,953,586,0,586,6
2020-04-06,San Joaquin,077,732212,333,191,3,194,10
2020-04-06,San Luis Obispo,079,281455,147,85,1,86,1
2020-04-06,San Mateo,081,765935,848,569,2,571,20
2020-04-06,Santa Barbara,083,443738,296,189,1,190,2
2020-04-06,Santa Clara,085,1922200,1707,1128,4,1132,43
2020-04-06,Santa Cruz,087,273765,98,65,0,65,1
2020-04-06,Shasta,089,179085,29,16,0,16,3
2020-04-06,Sierra,091,2930,0,0,0,0,0
2020-04-06,Siskiyou,093,43540,4,4,0,4,0
2020-04-06,Solano,095,438530,163,95,0,95,1
2020-04-06,Sonoma,097,501317,167,102,0,102,1
2020-04-06,Stanislaus,099,539301,170,72,3,75,0
2020-04-06,Sutter,101,95872,22,14,0,14,2
2020-04-06,Tehama,103,63373,1,1,0,1,0
2020-04-06,Trinity,105,12862,0,0,0,0,0
2020-04-06,Tulare,107,460477,318,126,5,131,5
2020-04-06,Tuolumne,109,53932,3,1,0,1,0
2020-04-06,Ventura,111,848112,391,234,0,234,6
2020-04-06,Yolo,113,214977,93,43,0,43,1
2020-04-06,Yuba,115,75493,14,8,0,8,0
2020-04-05,Alameda,001,1643700,922,475,1,476,12
2020-04-05,Alpine,003,1148,1,1,0,1,0
2020-04-05,Amador,005,37829,6,2,0,2,0
2020-04-05,Butte,007,227075,16,10,1,11,0
2020-04-05,Calaveras,009,45235,9,3,0,3,0
2020-04-05,Colusa,011,21464,3,1,0,1,0
2020-04-05,Contra Costa,013,1133247,626,415,0,415,6
2020-04-05,Del Norte,015,27424,2,1,0,1,0
2020-04-05,El Dorado,017,186661,42,19,0,19,0
2020-04-05,Fresno,019,978130,337,102,4,106,1
2020-04-05,Glenn,021,27897,4,2,0,2,0
2020-04-05,Humboldt,023,135768,55,29,0,29,0
2020-04-05,Imperial,025,180216,114,42,0,42,1
2020-04-05,Inyo,027,18085,11,10,0,10,0
2020-04-05,Kern,029,883053,415,109,0,109,2
2020-04-05,Kings,031,150075,39,4,1,5,0
2020-04-05,Lake,033,64148,4,0,0,0,0
2020-04-05,Lassen,035,31185,3,0,2,2,0
2020-04-05,Los Angeles,037,10098052,10411,5892,11,5903,130
2020-04-05,Madera,039,155013,57,27,0,27,2
2020-04-05,Marin,041,260295,160,113,1,114,6
2020-04-05,Mariposa,043,17540,0,0,0,0,0
2020-04-05,Mendocino,045,87422,5,4,0,4,0
2020-04-05,Merced,047,269075,53,16,0,16,0
2020-04-05,Modoc,049,8938,0,0,0,0,0
2020-04-05,Mono,051,14174,28,18,0,18,1
2020-04-05,Monterey,053,433212,95,61,1,62,2
2020-04-05,Napa,055,140530,40,15,0,15,2
2020-04-05,Nevada,057,99092,36,19,1,20,1
2020-04-05,Orange,059,3164182,1600,820,15,835,15
2020-04-05,Placer,061,380077,136,86,0,86,3
2020-04-05,Plumas,063,18699,3,2,0,2,0
2020-04-05,Riverside,065,2383286,1896,669,13,682,17
2020-04-05,Sacramento,067,1510023,752,393,0,393,11
2020-04-05,San Benito,069,59416,35,22,0,22,1
2020-04-05,San Bernardino,071,2135413,1031,375,0,375,13
2020-04-05,San Diego,073,3302833,1908,1328,0,1328,19
2020-04-05,San Francisco,075,870044,906,559,0,559,6
2020-04-05,San Joaquin,077,732212,318,179,3,182,10
2020-04-05,San Luis Obispo,079,281455,145,83,1,84,1
2020-04-05,San Mateo,081,765935,828,528,2,530,19
2020-04-05,Santa Barbara,083,443738,280,171,1,172,1
2020-04-05,Santa Clara,085,1922200,1660,1052,4,1056,42
2020-04-05,Santa Cruz,087,273765,98,59,0,59,1
2020-04-05,Shasta,089,179085,28,11,0,11,2
2020-04-05,Sierra,091,2930,0,0,0,0,0
2020-04-05,Siskiyou,093,43540,4,3,0,3,0
2020-04-05,Solano,095,438530,159,78,0,78,1
2020-04-05,Sonoma,097,501317,165,88,0,88,1
2020-04-05,Stanislaus,099,539301,156,51,3,54,0
2020-04-05,Sutter,101,95872,22,14,0,14,1
2020-04-05,Tehama,103,63373,1,1,0,1,0
2020-04-05,Trinity,105,12862,0,0,0,0,0
2020-04-05,Tulare,107,460477,281,81,5,86,4
2020-04-05,Tuolumne,109,53932,3,1,0,1,0
2020-04-05,Ventura,111,848112,377,196,0,196,6
2020-04-05,Yolo,113,214977,75,37,0,37,2
2020-04-05,Yuba,115,75493,14,7,0,7,0
2020-04-04,Alameda,001,1643700,899,468,1,469,12
2020-04-04,Alpine,003,1148,1,1,0,1,0
2020-04-04,Amador,005,37829,5,2,0,2,0
2020-04-04,Butte,007,227075,16,10,1,11,0
2020-04-04,Calaveras,009,45235,9,3,0,3,0
2020-04-04,Colusa,011,21464,3,1,0,1,0
2020-04-04,Contra Costa,013,1133247,618,382,0,382,5
2020-04-04,Del Norte,015,27424,2,1,0,1,0
2020-04-04,El Dorado,017,186661,42,19,0,19,0
2020-04-04,Fresno,019,978130,327,102,4,106,1
2020-04-04,Glenn,021,27897,4,2,0,2,0
2020-04-04,Humboldt,023,135768,55,29,0,29,0
2020-04-04,Imperial,025,180216,113,42,0,42,1
2020-04-04,Inyo,027,18085,11,10,0,10,0
2020-04-04,Kern,029,883053,385,103,0,103,2
2020-04-04,Kings,031,150075,39,3,1,4,0
2020-04-04,Lake,033,64148,4,0,0,0,0
2020-04-04,Lassen,035,31185,3,0,2,2,0
2020-04-04,Los Angeles,037,10098052,9793,5275,11,5286,117
2020-04-04,Madera,039,155013,55,27,0,27,2
2020-04-04,Marin,041,260295,158,111,0,111,6
2020-04-04,Mariposa,043,17540,0,0,0,0,0
2020-04-04,Mendocino,045,87422,5,4,0,4,0
2020-04-04,Merced,047,269075,49,11,0,11,0
2020-04-04,Modoc,049,8938,0,0,0,0,0
2020-04-04,Mono,051,14174,28,18,0,18,1
2020-04-04,Monterey,053,433212,91,61,1,62,2
2020-04-04,Napa,055,140530,40,15,0,15,2
2020-04-04,Nevada,057,99092,36,19,1,20,1
2020-04-04,Orange,059,3164182,1558,781,14,795,15
2020-04-04,Placer,061,380077,135,87,0,87,2
2020-04-04,Plumas,063,18699,3,2,0,2,0
2020-04-04,Riverside,065,2383286,1795,652,13,665,15
2020-04-04,Sacramento,067,1510023,734,393,0,393,11
2020-04-04,San Benito,069,59416,35,22,0,22,1
2020-04-04,San Bernardino,071,2135413,983,373,0,373,13
2020-04-04,San Diego,073,3302833,1860,1211,0,1211,18
2020-04-04,San Francisco,075,870044,868,537,0,537,6
2020-04-04,San Joaquin,077,732212,295,171,3,174,10
2020-04-04,San Luis Obispo,079,281455,145,82,1,83,0
2020-04-04,San Mateo,081,765935,816,520,2,522,17
2020-04-04,Santa Barbara,083,443738,271,167,1,168,1
2020-04-04,Santa Clara,085,1922200,1608,1045,4,1049,39
2020-04-04,Santa Cruz,087,273765,98,56,0,56,1
2020-04-04,Shasta,089,179085,27,11,0,11,2
2020-04-04,Sierra,091,2930,0,0,0,0,0
2020-04-04,Siskiyou,093,43540,4,3,0,3,0
2020-04-04,Solano,095,438530,154,79,0,79,1
2020-04-04,Sonoma,097,501317,162,88,0,88,1
2020-04-04,Stanislaus,099,539301,145,51,3,54,0
2020-04-04,Sutter,101,95872,22,14,0,14,1
2020-04-04,Tehama,103,63373,1,1,0,1,0
2020-04-04,Trinity,105,12862,0,0,0,0,0
2020-04-04,Tulare,107,460477,267,79,5,84,4
2020-04-04,Tuolumne,109,53932,3,1,0,1,0
2020-04-04,Ventura,111,848112,364,194,0,194,6
2020-04-04,Yolo,113,214977,73,40,0,40,2
2020-04-04,Yuba,115,75493,13,7,0,7,0
2020-04-03,Alameda,001,1643700,863,395,1,396,11
2020-04-03,Alpine,003,1148,1,1,0,1,0
2020-04-03,Amador,005,37829,5,2,0,2,0
2020-04-03,Butte,007,227075,16,8,1,9,0
2020-04-03,Calaveras,009,45235,9,3,0,3,0
2020-04-03,Colusa,011,21464,3,1,0,1,0
2020-04-03,Contra Costa,013,1133247,595,327,0,327,5
2020-04-03,Del Norte,015,27424,2,1,0,1,0
2020-04-03,El Dorado,017,186661,40,16,0,16,0
2020-04-03,Fresno,019,978130,315,98,4,102,1
2020-04-03,Glenn,021,27897,4,2,0,2,0
2020-04-03,Humboldt,023,135768,55,34,0,34,0
2020-04-03,Imperial,025,180216,104,35,0,35,0
2020-04-03,Inyo,027,18085,11,10,0,10,0
2020-04-03,Kern,029,883053,359,87,0,87,1
2020-04-03,Kings,031,150075,37,3,1,4,0
2020-04-03,Lake,033,64148,3,0,0,0,0
2020-04-03,Lassen,035,31185,3,0,2,2,0
2020-04-03,Los Angeles,037,10098052,9178,4566,11,4577,91
2020-04-03,Madera,039,155013,54,28,0,28,2
2020-04-03,Marin,041,260295,156,106,0,106,6
2020-04-03,Mariposa,043,17540,0,0,0,0,0
2020-04-03,Mendocino,045,87422,5,4,0,4,0
2020-04-03,Merced,047,269075,46,9,0,9,0
2020-04-03,Modoc,049,8938,0,0,0,0,0
2020-04-03,Mono,051,14174,28,18,0,18,1
2020-04-03,Monterey,053,433212,88,58,1,59,2
2020-04-03,Napa,055,140530,39,13,0,13,1
2020-04-03,Nevada,057,99092,36,19,1,20,1
2020-04-03,Orange,059,3164182,1519,713,14,727,13
2020-04-03,Placer,061,380077,131,76,0,76,2
2020-04-03,Plumas,063,18699,3,2,0,2,0
2020-04-03,Riverside,065,2383286,1715,540,13,553,14
2020-04-03,Sacramento,067,1510023,713,363,0,363,11
2020-04-03,San Benito,069,59416,35,22,0,22,1
2020-04-03,San Bernardino,071,2135413,938,356,0,356,11
2020-04-03,San Diego,073,3302833,1800,1114,0,1114,17
2020-04-03,San Francisco,075,870044,844,506,0,506,6
2020-04-03,San Joaquin,077,732212,283,162,3,165,10
2020-04-03,San Luis Obispo,079,281455,144,82,1,83,0
2020-04-03,San Mateo,081,765935,799,474,2,476,13
2020-04-03,Santa Barbara,083,443738,260,154,1,155,1
2020-04-03,Santa Clara,085,1922200,1572,983,4,987,39
2020-04-03,Santa Cruz,087,273765,98,52,0,52,1
2020-04-03,Shasta,089,179085,27,10,0,10,1
2020-04-03,Sierra,091,2930,0,0,0,0,0
2020-04-03,Siskiyou,093,43540,4,3,0,3,0
2020-04-03,Solano,095,438530,146,72,0,72,1
2020-04-03,Sonoma,097,501317,162,84,0,84,1
2020-04-03,Stanislaus,099,539301,139,48,3,51,0
2020-04-03,Sutter,101,95872,22,12,0,12,1
2020-04-03,Tehama,103,63373,1,1,0,1,0
2020-04-03,Trinity,105,12862,0,0,0,0,0
2020-04-03,Tulare,107,460477,253,73,5,78,3
2020-04-03,Tuolumne,109,53932,3,1,0,1,0
2020-04-03,Ventura,111,848112,354,186,0,186,6
2020-04-03,Yolo,113,214977,72,33,0,33,1
2020-04-03,Yuba,115,75493,13,6,0,6,0
2020-04-02,Alameda,001,1643700,812,345,1,346,10
2020-04-02,Alpine,003,1148,1,1,0,1,0
2020-04-02,Amador,005,37829,5,2,0,2,0
2020-04-02,Butte,007,227075,16,7,0,7,0
2020-04-02,Calaveras,009,45235,7,3,0,3,0
2020-04-02,Colusa,011,21464,3,1,0,1,0
2020-04-02,Contra Costa,013,1133247,565,297,0,297,3
2020-04-02,Del Norte,015,27424,2,0,0,0,0
2020-04-02,El Dorado,017,186661,38,16,0,16,0
2020-04-02,Fresno,019,978130,299,92,4,96,0
2020-04-02,Glenn,021,27897,3,2,0,2,0
2020-04-02,Humboldt,023,135768,51,23,0,23,0
2020-04-02,Imperial,025,180216,100,24,0,24,0
2020-04-02,Inyo,027,18085,10,8,0,8,0
2020-04-02,Kern,029,883053,332,74,0,74,0
2020-04-02,Kings,031,150075,37,3,1,4,0
2020-04-02,Lake,033,64148,3,0,0,0,0
2020-04-02,Lassen,035,31185,3,0,2,2,0
2020-04-02,Los Angeles,037,10098052,8346,4040,11,4051,79
2020-04-02,Madera,039,155013,52,25,0,25,1
2020-04-02,Marin,041,260295,150,102,0,102,1
2020-04-02,Mariposa,043,17540,0,0,0,0,0
2020-04-02,Mendocino,045,87422,5,4,0,4,0
2020-04-02,Merced,047,269075,41,9,0,9,0
2020-04-02,Modoc,049,8938,0,0,0,0,0
2020-04-02,Mono,051,14174,28,16,0,16,1
2020-04-02,Monterey,053,433212,86,50,1,51,2
2020-04-02,Napa,055,140530,39,13,0,13,0
2020-04-02,Nevada,057,99092,35,17,1,18,0
2020-04-02,Orange,059,3164182,1467,640,13,653,12
2020-04-02,Placer,061,380077,130,72,0,72,2
2020-04-02,Plumas,063,18699,3,1,0,1,0
2020-04-02,Riverside,065,2383286,1598,438,13,451,13
2020-04-02,Sacramento,067,1510023,695,322,0,322,9
2020-04-02,San Benito,069,59416,33,18,0,18,1
2020-04-02,San Bernardino,071,2135413,883,335,0,335,8
2020-04-02,San Diego,073,3302833,1733,968,0,968,16
2020-04-02,San Francisco,075,870044,817,473,0,473,6
2020-04-02,San Joaquin,077,732212,264,148,3,151,9
2020-04-02,San Luis Obispo,079,281455,139,79,1,80,0
2020-04-02,San Mateo,081,765935,778,423,2,425,13
2020-04-02,Santa Barbara,083,443738,249,125,1,126,1
2020-04-02,Santa Clara,085,1922200,1521,908,4,912,38
2020-04-02,Santa Cruz,087,273765,96,49,0,49,1
2020-04-02,Shasta,089,179085,26,7,0,7,1
2020-04-02,Sierra,091,2930,0,0,0,0,0
2020-04-02,Siskiyou,093,43540,4,3,0,3,0
2020-04-02,Solano,095,438530,136,65,0,65,0
2020-04-02,Sonoma,097,501317,158,76,0,76,1
2020-04-02,Stanislaus,099,539301,128,40,3,43,0
2020-04-02,Sutter,101,95872,21,10,0,10,1
2020-04-02,Tehama,103,63373,1,1,0,1,0
2020-04-02,Trinity,105,12862,0,0,0,0,0
2020-04-02,Tulare,107,460477,219,64,5,69,1
2020-04-02,Tuolumne,109,53932,3,1,0,1,0
2020-04-02,Ventura,111,848112,336,178,0,178,5
2020-04-02,Yolo,113,214977,70,29,0,29,1
2020-04-02,Yuba,115,75493,10,5,0,5,0
2020-04-01,Alameda,001,1643700,785,287,1,288,8
2020-04-01,Alpine,003,1148,1,1,0,1,0
2020-04-01,Amador,005,37829,5,1,0,1,0
2020-04-01,Butte,007,227075,16,6,0,6,0
2020-04-01,Calaveras,009,45235,6,3,0,3,0
2020-04-01,Colusa,011,21464,3,1,0,1,0
2020-04-01,Contra Costa,013,1133247,521,267,0,267,3
2020-04-01,Del Norte,015,27424,2,0,0,0,0
2020-04-01,El Dorado,017,186661,37,14,0,14,0
2020-04-01,Fresno,019,978130,277,75,3,78,0
2020-04-01,Glenn,021,27897,3,2,0,2,0
2020-04-01,Humboldt,023,135768,51,19,0,19,0
2020-04-01,Imperial,025,180216,93,25,0,25,0
2020-04-01,Inyo,027,18085,10,8,0,8,0
2020-04-01,Kern,029,883053,305,53,0,53,0
2020-04-01,Kings,031,150075,35,3,1,4,0
2020-04-01,Lake,033,64148,3,0,0,0,0
2020-04-01,Lassen,035,31185,3,0,2,2,0
2020-04-01,Los Angeles,037,10098052,7696,3502,11,3513,66
2020-04-01,Madera,039,155013,50,17,0,17,1
2020-04-01,Marin,041,260295,146,87,0,87,1
2020-04-01,Mariposa,043,17540,0,0,0,0,0
2020-04-01,Mendocino,045,87422,5,4,0,4,0
2020-04-01,Merced,047,269075,38,7,0,7,0
2020-04-01,Modoc,049,8938,0,0,0,0,0
2020-04-01,Mono,051,14174,28,12,0,12,1
2020-04-01,Monterey,053,433212,85,47,1,48,2
2020-04-01,Napa,055,140530,36,11,0,11,0
2020-04-01,Nevada,057,99092,35,15,1,16,0
2020-04-01,Orange,059,3164182,1415,579,13,592,11
2020-04-01,Placer,061,380077,128,52,0,52,2
2020-04-01,Plumas,063,18699,3,1,0,1,0
2020-04-01,Riverside,065,2383286,1430,306,12,318,11
2020-04-01,Sacramento,067,1510023,662,299,0,299,8
2020-04-01,San Benito,069,59416,30,14,0,14,1
2020-04-01,San Bernardino,071,2135413,834,245,0,245,5
2020-04-01,San Diego,073,3302833,1663,851,0,851,11
2020-04-01,San Francisco,075,870044,789,432,0,432,6
2020-04-01,San Joaquin,077,732212,252,132,3,135,8
2020-04-01,San Luis Obispo,079,281455,133,69,1,70,0
2020-04-01,San Mateo,081,765935,760,354,2,356,13
2020-04-01,Santa Barbara,083,443738,236,103,1,104,0
2020-04-01,Santa Clara,085,1922200,1479,805,4,809,33
2020-04-01,Santa Cruz,087,273765,91,44,0,44,1
2020-04-01,Shasta,089,179085,25,5,0,5,1
2020-04-01,Sierra,091,2930,0,0,0,0,0
2020-04-01,Siskiyou,093,43540,4,3,0,3,0
2020-04-01,Solano,095,438530,131,57,0,57,0
2020-04-01,Sonoma,097,501317,154,60,0,60,1
2020-04-01,Stanislaus,099,539301,117,29,3,32,0
2020-04-01,Sutter,101,95872,21,9,0,9,1
2020-04-01,Tehama,103,63373,1,0,0,0,0
2020-04-01,Trinity,105,12862,0,0,0,0,0
2020-04-01,Tulare,107,460477,181,43,5,48,1
2020-04-01,Tuolumne,109,53932,3,1,0,1,0
2020-04-01,Ventura,111,848112,323,154,0,154,5
2020-04-01,Yolo,113,214977,65,22,0,22,1
2020-04-01,Yuba,115,75493,9,5,0,5,0
2020-03-31,Alameda,001,1643700,717,269,1,270,7
2020-03-31,Alpine,003,1148,1,1,0,1,0
2020-03-31,Amador,005,37829,5,1,0,1,0
2020-03-31,Butte,007,227075,16,6,0,6,0
2020-03-31,Calaveras,009,45235,6,3,0,3,0
2020-03-31,Colusa,011,21464,3,1,0,1,0
2020-03-31,Contra Costa,013,1133247,496,246,0,246,3
2020-03-31,Del Norte,015,27424,1,0,0,0,0
2020-03-31,El Dorado,017,186661,33,14,0,14,0
2020-03-31,Fresno,019,978130,252,59,3,62,0
2020-03-31,Glenn,021,27897,3,2,0,2,0
2020-03-31,Humboldt,023,135768,51,18,0,18,0
2020-03-31,Imperial,025,180216,88,17,0,17,0
2020-03-31,Inyo,027,18085,10,8,0,8,0
2020-03-31,Kern,029,883053,281,47,0,47,0
2020-03-31,Kings,031,150075,33,2,1,3,0
2020-03-31,Lake,033,64148,1,0,0,0,0
2020-03-31,Lassen,035,31185,3,0,2,2,0
2020-03-31,Los Angeles,037,10098052,7031,3001,11,3012,53
2020-03-31,Madera,039,155013,49,17,0,17,1
2020-03-31,Marin,041,260295,137,85,0,85,1
2020-03-31,Mariposa,043,17540,0,0,0,0,0
2020-03-31,Mendocino,045,87422,5,4,0,4,0
2020-03-31,Merced,047,269075,33,6,0,6,0
2020-03-31,Modoc,049,8938,0,0,0,0,0
2020-03-31,Mono,051,14174,26,12,0,12,0
2020-03-31,Monterey,053,433212,83,43,1,44,2
2020-03-31,Napa,055,140530,35,9,0,9,0
2020-03-31,Nevada,057,99092,35,15,1,16,0
2020-03-31,Orange,059,3164182,1345,506,13,519,7
2020-03-31,Placer,061,380077,121,49,0,49,2
2020-03-31,Plumas,063,18699,1,0,0,0,0
2020-03-31,Riverside,065,2383286,1284,284,12,296,8
2020-03-31,Sacramento,067,1510023,610,271,0,271,8
2020-03-31,San Benito,069,59416,30,14,0,14,1
2020-03-31,San Bernardino,071,2135413,749,193,0,193,5
2020-03-31,San Diego,073,3302833,1581,736,0,736,9
2020-03-31,San Francisco,075,870044,754,404,0,404,5
2020-03-31,San Joaquin,077,732212,236,122,3,125,7
2020-03-31,San Luis Obispo,079,281455,129,67,1,68,0
2020-03-31,San Mateo,081,765935,741,297,2,299,12
2020-03-31,Santa Barbara,083,443738,221,89,1,90,0
2020-03-31,Santa Clara,085,1922200,1429,777,4,781,30
2020-03-31,Santa Cruz,087,273765,84,40,0,40,1
2020-03-31,Shasta,089,179085,22,5,0,5,1
2020-03-31,Sierra,091,2930,0,0,0,0,0
2020-03-31,Siskiyou,093,43540,4,3,0,3,0
2020-03-31,Solano,095,438530,117,56,0,56,0
2020-03-31,Sonoma,097,501317,149,58,0,58,1
2020-03-31,Stanislaus,099,539301,102,28,3,31,0
2020-03-31,Sutter,101,95872,21,8,0,8,0
2020-03-31,Tehama,103,63373,1,0,0,0,0
2020-03-31,Trinity,105,12862,0,0,0,0,0
2020-03-31,Tulare,107,460477,158,42,4,46,1
2020-03-31,Tuolumne,109,53932,3,1,0,1,0
2020-03-31,Ventura,111,848112,312,143,0,143,4
2020-03-31,Yolo,113,214977,58,21,0,21,1
2020-03-31,Yuba,115,75493,9,5,0,5,0
2020-03-30,Alameda,001,1643700,677,250,1,251,7
2020-03-30,Alpine,003,1148,1,1,0,1,0
2020-03-30,Amador,005,37829,5,1,0,1,0
2020-03-30,Butte,007,227075,14,5,0,5,0
2020-03-30,Calaveras,009,45235,6,3,0,3,0
2020-03-30,Colusa,011,21464,3,1,0,1,0
2020-03-30,Contra Costa,013,1133247,470,212,0,212,3
2020-03-30,Del Norte,015,27424,0,0,0,0,0
2020-03-30,El Dorado,017,186661,33,11,0,11,0
2020-03-30,Fresno,019,978130,227,46,3,49,0
2020-03-30,Glenn,021,27897,3,2,0,2,0
2020-03-30,Humboldt,023,135768,49,11,0,11,0
2020-03-30,Imperial,025,180216,85,9,0,9,0
2020-03-30,Inyo,027,18085,10,5,0,5,0
2020-03-30,Kern,029,883053,248,30,0,30,0
2020-03-30,Kings,031,150075,33,1,1,2,0
2020-03-30,Lake,033,64148,1,0,0,0,0
2020-03-30,Lassen,035,31185,3,0,1,1,0
2020-03-30,Los Angeles,037,10098052,6375,2467,11,2478,44
2020-03-30,Madera,039,155013,48,14,0,14,1
2020-03-30,Marin,041,260295,130,78,0,78,0
2020-03-30,Mariposa,043,17540,0,0,0,0,0
2020-03-30,Mendocino,045,87422,5,2,0,2,0
2020-03-30,Merced,047,269075,29,6,0,6,0
2020-03-30,Modoc,049,8938,0,0,0,0,0
2020-03-30,Mono,051,14174,26,11,0,11,0
2020-03-30,Monterey,053,433212,78,41,1,42,1
2020-03-30,Napa,055,140530,34,9,0,9,0
2020-03-30,Nevada,057,99092,34,14,1,15,0
2020-03-30,Orange,059,3164182,1279,418,13,431,5
2020-03-30,Placer,061,380077,118,44,0,44,2
2020-03-30,Plumas,063,18699,1,0,0,0,0
2020-03-30,Riverside,065,2383286,1203,204,12,216,7
2020-03-30,Sacramento,067,1510023,586,238,0,238,8
2020-03-30,San Benito,069,59416,30,11,0,11,1
2020-03-30,San Bernardino,071,2135413,705,145,0,145,4
2020-03-30,San Diego,073,3302833,1511,605,0,605,7
2020-03-30,San Francisco,075,870044,714,368,0,368,5
2020-03-30,San Joaquin,077,732212,229,112,3,115,5
2020-03-30,San Luis Obispo,079,281455,126,62,1,63,0
2020-03-30,San Mateo,081,765935,717,257,2,259,11
2020-03-30,Santa Barbara,083,443738,212,79,1,80,0
2020-03-30,Santa Clara,085,1922200,1398,745,3,748,31
2020-03-30,Santa Cruz,087,273765,81,36,0,36,1
2020-03-30,Shasta,089,179085,21,4,0,4,1
2020-03-30,Sierra,091,2930,0,0,0,0,0
2020-03-30,Siskiyou,093,43540,4,2,0,2,0
2020-03-30,Solano,095,438530,111,50,0,50,0
2020-03-30,Sonoma,097,501317,146,57,0,57,1
2020-03-30,Stanislaus,099,539301,95,28,3,31,0
2020-03-30,Sutter,101,95872,20,6,0,6,0
2020-03-30,Tehama,103,63373,1,0,0,0,0
2020-03-30,Trinity,105,12862,0,0,0,0,0
2020-03-30,Tulare,107,460477,146,40,3,43,1
2020-03-30,Tuolumne,109,53932,3,1,0,1,0
2020-03-30,Ventura,111,848112,301,118,0,118,2
2020-03-30,Yolo,113,214977,55,17,0,17,1
2020-03-30,Yuba,115,75493,8,5,0,5,0
2020-03-29,Alameda,001,1643700,643,207,1,208,6
2020-03-29,Alpine,003,1148,1,0,0,0,0
2020-03-29,Amador,005,37829,5,1,0,1,0
2020-03-29,Butte,007,227075,14,4,0,4,0
2020-03-29,Calaveras,009,45235,6,2,0,2,0
2020-03-29,Colusa,011,21464,3,1,0,1,0
2020-03-29,Contra Costa,013,1133247,440,187,0,187,3
2020-03-29,Del Norte,015,27424,0,0,0,0,0
2020-03-29,El Dorado,017,186661,32,9,0,9,0
2020-03-29,Fresno,019,978130,203,31,3,34,0
2020-03-29,Glenn,021,27897,2,1,0,1,0
2020-03-29,Humboldt,023,135768,46,9,0,9,0
2020-03-29,Imperial,025,180216,79,9,0,9,0
2020-03-29,Inyo,027,18085,9,0,0,0,0
2020-03-29,Kern,029,883053,230,20,0,20,0
2020-03-29,Kings,031,150075,30,1,1,2,0
2020-03-29,Lake,033,64148,0,0,0,0,0
2020-03-29,Lassen,035,31185,3,0,1,1,0
2020-03-29,Los Angeles,037,10098052,5730,2119,11,2130,37
2020-03-29,Madera,039,155013,43,11,0,11,1
2020-03-29,Marin,041,260295,125,60,0,60,0
2020-03-29,Mariposa,043,17540,0,0,0,0,0
2020-03-29,Mendocino,045,87422,5,2,0,2,0
2020-03-29,Merced,047,269075,28,4,0,4,0
2020-03-29,Modoc,049,8938,0,0,0,0,0
2020-03-29,Mono,051,14174,26,8,0,8,0
2020-03-29,Monterey,053,433212,73,36,1,37,1
2020-03-29,Napa,055,140530,32,5,0,5,0
2020-03-29,Nevada,057,99092,32,13,1,14,0
2020-03-29,Orange,059,3164182,1206,343,13,356,2
2020-03-29,Placer,061,380077,117,35,0,35,2
2020-03-29,Plumas,063,18699,1,0,0,0,0
2020-03-29,Riverside,065,2383286,1079,122,12,134,7
2020-03-29,Sacramento,067,1510023,546,217,0,217,7
2020-03-29,San Benito,069,59416,29,10,0,10,1
2020-03-29,San Bernardino,071,2135413,653,94,0,94,2
2020-03-29,San Diego,073,3302833,1439,521,0,521,7
2020-03-29,San Francisco,075,870044,670,333,0,333,5
2020-03-29,San Joaquin,077,732212,220,86,3,89,4
2020-03-29,San Luis Obispo,079,281455,119,55,0,55,0
2020-03-29,San Mateo,081,765935,692,234,2,236,12
2020-03-29,Santa Barbara,083,443738,204,52,1,53,0
2020-03-29,Santa Clara,085,1922200,1341,591,3,594,30
2020-03-29,Santa Cruz,087,273765,81,33,0,33,1
2020-03-29,Shasta,089,179085,20,4,0,4,1
2020-03-29,Sierra,091,2930,0,0,0,0,0
2020-03-29,Siskiyou,093,43540,4,2,0,2,0
2020-03-29,Solano,095,438530,103,48,0,48,0
2020-03-29,Sonoma,097,501317,144,35,0,35,1
2020-03-29,Stanislaus,099,539301,90,19,3,22,0
2020-03-29,Sutter,101,95872,17,6,0,6,0
2020-03-29,Tehama,103,63373,1,0,0,0,0
2020-03-29,Trinity,105,12862,0,0,0,0,0
2020-03-29,Tulare,107,460477,121,24,3,27,1
2020-03-29,Tuolumne,109,53932,2,1,0,1,0
2020-03-29,Ventura,111,848112,274,92,0,92,2
2020-03-29,Yolo,113,214977,50,13,0,13,1
2020-03-29,Yuba,115,75493,8,3,0,3,0
2020-03-28,Alameda,001,1643700,616,410,1,411,12
2020-03-28,Alpine,003,1148,1,0,0,0,0
2020-03-28,Amador,005,37829,5,2,0,2,0
2020-03-28,Butte,007,227075,14,8,0,8,0
2020-03-28,Calaveras,009,45235,6,4,0,4,0
2020-03-28,Colusa,011,21464,3,2,0,2,0
2020-03-28,Contra Costa,013,1133247,417,350,0,350,4
2020-03-28,Del Norte,015,27424,0,0,0,0,0
2020-03-28,El Dorado,017,186661,31,18,0,18,0
2020-03-28,Fresno,019,978130,193,62,3,65,0
2020-03-28,Glenn,021,27897,2,2,0,2,0
2020-03-28,Humboldt,023,135768,46,18,0,18,0
2020-03-28,Imperial,025,180216,74,18,0,18,0
2020-03-28,Inyo,027,18085,9,0,0,0,0
2020-03-28,Kern,029,883053,213,40,0,40,0
2020-03-28,Kings,031,150075,29,2,1,3,0
2020-03-28,Lake,033,64148,0,0,0,0,0
2020-03-28,Lassen,035,31185,3,0,1,1,0
2020-03-28,Los Angeles,037,10098052,5344,3600,10,3610,64
2020-03-28,Madera,039,155013,43,22,0,22,2
2020-03-28,Marin,041,260295,120,116,0,116,0
2020-03-28,Mariposa,043,17540,0,0,0,0,0
2020-03-28,Mendocino,045,87422,5,4,0,4,0
2020-03-28,Merced,047,269075,27,8,0,8,0
2020-03-28,Modoc,049,8938,0,0,0,0,0
2020-03-28,Mono,051,14174,24,12,0,12,0
2020-03-28,Monterey,053,433212,72,64,1,65,2
2020-03-28,Napa,055,140530,27,10,0,10,0
2020-03-28,Nevada,057,99092,32,22,1,23,0
2020-03-28,Orange,059,3164182,1170,656,13,669,4
2020-03-28,Placer,061,380077,112,70,0,70,2
2020-03-28,Plumas,063,18699,1,0,0,0,0
2020-03-28,Riverside,065,2383286,1011,242,12,254,14
2020-03-28,Sacramento,067,1510023,528,406,0,406,14
2020-03-28,San Benito,069,59416,29,20,0,20,2
2020-03-28,San Bernardino,071,2135413,605,162,0,162,4
2020-03-28,San Diego,073,3302833,1380,980,0,980,14
2020-03-28,San Francisco,075,870044,646,600,0,600,6
2020-03-28,San Joaquin,077,732212,212,166,3,169,8
2020-03-28,San Luis Obispo,079,281455,117,104,0,104,0
2020-03-28,San Mateo,081,765935,672,462,2,464,17
2020-03-28,Santa Barbara,083,443738,194,98,1,99,0
2020-03-28,Santa Clara,085,1922200,1322,1174,3,1177,54
2020-03-28,Santa Cruz,087,273765,80,62,0,62,0
2020-03-28,Shasta,089,179085,20,8,0,8,2
2020-03-28,Sierra,091,2930,0,0,0,0,0
2020-03-28,Siskiyou,093,43540,4,4,0,4,0
2020-03-28,Solano,095,438530,99,96,0,96,0
2020-03-28,Sonoma,097,501317,142,70,0,70,2
2020-03-28,Stanislaus,099,539301,85,34,3,37,0
2020-03-28,Sutter,101,95872,17,6,0,6,0
2020-03-28,Tehama,103,63373,1,0,0,0,0
2020-03-28,Trinity,105,12862,0,0,0,0,0
2020-03-28,Tulare,107,460477,114,46,3,49,0
2020-03-28,Tuolumne,109,53932,2,2,0,2,0
2020-03-28,Ventura,111,848112,270,178,0,178,4
2020-03-28,Yolo,113,214977,49,26,0,26,2
2020-03-28,Yuba,115,75493,8,6,0,6,0
2020-03-27,Alameda,001,1643700,597,185,1,186,4
2020-03-27,Alpine,003,1148,1,0,0,0,0
2020-03-27,Amador,005,37829,4,1,0,1,0
2020-03-27,Butte,007,227075,12,4,0,4,0
2020-03-27,Calaveras,009,45235,6,2,0,2,0
2020-03-27,Colusa,011,21464,3,0,0,0,0
2020-03-27,Contra Costa,013,1133247,396,161,0,161,2
2020-03-27,Del Norte,015,27424,0,0,0,0,0
2020-03-27,El Dorado,017,186661,29,9,0,9,0
2020-03-27,Fresno,019,978130,181,29,2,31,0
2020-03-27,Glenn,021,27897,2,0,0,0,0
2020-03-27,Humboldt,023,135768,42,9,0,9,0
2020-03-27,Imperial,025,180216,69,9,0,9,0
2020-03-27,Inyo,027,18085,9,0,0,0,0
2020-03-27,Kern,029,883053,200,20,0,20,0
2020-03-27,Kings,031,150075,28,0,1,1,0
2020-03-27,Lake,033,64148,0,0,0,0,0
2020-03-27,Lassen,035,31185,3,0,1,1,0
2020-03-27,Los Angeles,037,10098052,4934,1474,10,1484,26
2020-03-27,Madera,039,155013,41,10,0,10,1
2020-03-27,Marin,041,260295,115,58,0,58,0
2020-03-27,Mariposa,043,17540,0,0,0,0,0
2020-03-27,Mendocino,045,87422,5,2,0,2,0
2020-03-27,Merced,047,269075,26,3,0,3,0
2020-03-27,Modoc,049,8938,0,0,0,0,0
2020-03-27,Mono,051,14174,24,6,0,6,0
2020-03-27,Monterey,053,433212,69,26,1,27,1
2020-03-27,Napa,055,140530,27,5,0,5,0
2020-03-27,Nevada,057,99092,32,6,1,7,0
2020-03-27,Orange,059,3164182,1120,299,13,312,2
2020-03-27,Placer,061,380077,109,33,0,33,1
2020-03-27,Plumas,063,18699,0,0,0,0,0
2020-03-27,Riverside,065,2383286,955,121,12,133,7
2020-03-27,Sacramento,067,1510023,505,163,0,163,6
2020-03-27,San Benito,069,59416,28,9,0,9,1
2020-03-27,San Bernardino,071,2135413,514,77,0,77,2
2020-03-27,San Diego,073,3302833,1323,419,0,419,5
2020-03-27,San Francisco,075,870044,621,285,0,285,2
2020-03-27,San Joaquin,077,732212,201,73,3,76,3
2020-03-27,San Luis Obispo,079,281455,115,46,0,46,0
2020-03-27,San Mateo,081,765935,646,213,2,215,7
2020-03-27,Santa Barbara,083,443738,180,37,1,38,0
2020-03-27,Santa Clara,085,1922200,1284,557,3,560,25
2020-03-27,Santa Cruz,087,273765,79,31,0,31,0
2020-03-27,Shasta,089,179085,17,3,0,3,1
2020-03-27,Sierra,091,2930,0,0,0,0,0
2020-03-27,Siskiyou,093,43540,4,2,0,2,0
2020-03-27,Solano,095,438530,93,48,0,48,0
2020-03-27,Sonoma,097,501317,134,35,0,35,1
2020-03-27,Stanislaus,099,539301,83,16,3,19,0
2020-03-27,Sutter,101,95872,16,2,0,2,0
2020-03-27,Tehama,103,63373,1,0,0,0,0
2020-03-27,Trinity,105,12862,0,0,0,0,0
2020-03-27,Tulare,107,460477,106,15,3,18,0
2020-03-27,Tuolumne,109,53932,2,1,0,1,0
2020-03-27,Ventura,111,848112,261,80,0,80,2
2020-03-27,Yolo,113,214977,48,13,0,13,1
2020-03-27,Yuba,115,75493,7,3,0,3,0
2020-03-26,Alameda,001,1643700,557,172,1,173,4
2020-03-26,Alpine,003,1148,1,0,0,0,0
2020-03-26,Amador,005,37829,4,1,0,1,0
2020-03-26,Butte,007,227075,12,4,0,4,0
2020-03-26,Calaveras,009,45235,6,2,0,2,0
2020-03-26,Colusa,011,21464,3,0,0,0,0
2020-03-26,Contra Costa,013,1133247,386,147,0,147,2
2020-03-26,Del Norte,015,27424,0,0,0,0,0
2020-03-26,El Dorado,017,186661,27,7,0,7,0
2020-03-26,Fresno,019,978130,172,25,2,27,0
2020-03-26,Glenn,021,27897,2,0,0,0,0
2020-03-26,Humboldt,023,135768,38,8,0,8,0
2020-03-26,Imperial,025,180216,65,8,0,8,0
2020-03-26,Inyo,027,18085,8,0,0,0,0
2020-03-26,Kern,029,883053,184,20,0,20,0
2020-03-26,Kings,031,150075,28,0,1,1,0
2020-03-26,Lake,033,64148,0,0,0,0,0
2020-03-26,Lassen,035,31185,3,0,1,1,0
2020-03-26,Los Angeles,037,10098052,4530,1075,10,1085,19
2020-03-26,Madera,039,155013,39,8,0,8,0
2020-03-26,Marin,041,260295,106,56,0,56,0
2020-03-26,Mariposa,043,17540,0,0,0,0,0
2020-03-26,Mendocino,045,87422,4,1,0,1,0
2020-03-26,Merced,047,269075,23,1,0,1,0
2020-03-26,Modoc,049,8938,0,0,0,0,0
2020-03-26,Mono,051,14174,23,5,0,5,0
2020-03-26,Monterey,053,433212,66,25,1,26,1
2020-03-26,Napa,055,140530,26,5,0,5,0
2020-03-26,Nevada,057,99092,32,7,1,8,0
2020-03-26,Orange,059,3164182,1058,279,11,290,1
2020-03-26,Placer,061,380077,106,34,0,34,1
2020-03-26,Plumas,063,18699,0,0,0,0,0
2020-03-26,Riverside,065,2383286,884,118,12,130,7
2020-03-26,Sacramento,067,1510023,472,147,0,147,5
2020-03-26,San Benito,069,59416,28,8,0,8,1
2020-03-26,San Bernardino,071,2135413,448,57,0,57,1
2020-03-26,San Diego,073,3302833,1256,299,0,299,2
2020-03-26,San Francisco,075,870044,594,261,0,261,1
2020-03-26,San Joaquin,077,732212,190,69,3,72,3
2020-03-26,San Luis Obispo,079,281455,110,38,0,38,0
2020-03-26,San Mateo,081,765935,612,122,2,124,5
2020-03-26,Santa Barbara,083,443738,167,33,1,34,0
2020-03-26,Santa Clara,085,1922200,1239,487,2,489,20
2020-03-26,Santa Cruz,087,273765,75,30,0,30,0
2020-03-26,Shasta,089,179085,17,3,0,3,1
2020-03-26,Sierra,091,2930,0,0,0,0,0
2020-03-26,Siskiyou,093,43540,4,2,0,2,0
2020-03-26,Solano,095,438530,85,41,0,41,0
2020-03-26,Sonoma,097,501317,129,33,0,33,1
2020-03-26,Stanislaus,099,539301,81,15,3,18,0
2020-03-26,Sutter,101,95872,12,2,0,2,0
2020-03-26,Tehama,103,63373,1,0,0,0,0
2020-03-26,Trinity,105,12862,0,0,0,0,0
2020-03-26,Tulare,107,460477,97,15,3,18,0
2020-03-26,Tuolumne,109,53932,2,0,0,0,0
2020-03-26,Ventura,111,848112,245,70,0,70,1
2020-03-26,Yolo,113,214977,44,13,0,13,1
2020-03-26,Yuba,115,75493,7,3,0,3,0
2020-03-25,Alameda,001,1643700,536,134,1,135,3
2020-03-25,Alpine,003,1148,1,0,0,0,0
2020-03-25,Amador,005,37829,4,1,0,1,0
2020-03-25,Butte,007,227075,12,4,0,4,0
2020-03-25,Calaveras,009,45235,6,2,0,2,0
2020-03-25,Colusa,011,21464,2,0,0,0,0
2020-03-25,Contra Costa,013,1133247,372,131,0,131,1
2020-03-25,Del Norte,015,27424,0,0,0,0,0
2020-03-25,El Dorado,017,186661,27,5,0,5,0
2020-03-25,Fresno,019,978130,152,21,2,23,0
2020-03-25,Glenn,021,27897,2,0,0,0,0
2020-03-25,Humboldt,023,135768,35,3,0,3,0
2020-03-25,Imperial,025,180216,57,8,0,8,0
2020-03-25,Inyo,027,18085,5,0,0,0,0
2020-03-25,Kern,029,883053,164,13,0,13,0
2020-03-25,Kings,031,150075,26,0,1,1,0
2020-03-25,Lake,033,64148,0,0,0,0,0
2020-03-25,Lassen,035,31185,3,0,1,1,0
2020-03-25,Los Angeles,037,10098052,4135,725,10,735,10
2020-03-25,Madera,039,155013,37,6,0,6,0
2020-03-25,Marin,041,260295,100,47,0,47,0
2020-03-25,Mariposa,043,17540,0,0,0,0,0
2020-03-25,Mendocino,045,87422,3,1,0,1,0
2020-03-25,Merced,047,269075,19,0,0,0,0
2020-03-25,Modoc,049,8938,0,0,0,0,0
2020-03-25,Mono,051,14174,22,4,0,4,0
2020-03-25,Monterey,053,433212,63,23,1,24,1
2020-03-25,Napa,055,140530,26,5,0,5,0
2020-03-25,Nevada,057,99092,31,5,1,6,0
2020-03-25,Orange,059,3164182,1000,214,9,223,1
2020-03-25,Placer,061,380077,100,30,0,30,1
2020-03-25,Plumas,063,18699,0,1,0,1,0
2020-03-25,Riverside,065,2383286,813,87,12,99,5
2020-03-25,Sacramento,067,1510023,446,114,0,114,5
2020-03-25,San Benito,069,59416,27,4,0,4,1
2020-03-25,San Bernardino,071,2135413,409,46,0,46,1
2020-03-25,San Diego,073,3302833,1194,238,0,238,2
2020-03-25,San Francisco,075,870044,553,212,0,212,1
2020-03-25,San Joaquin,077,732212,177,64,3,67,2
2020-03-25,San Luis Obispo,079,281455,105,35,0,35,0
2020-03-25,San Mateo,081,765935,577,111,2,113,5
2020-03-25,Santa Barbara,083,443738,157,25,1,26,0
2020-03-25,Santa Clara,085,1922200,1195,452,2,454,20
2020-03-25,Santa Cruz,087,273765,72,26,0,26,0
2020-03-25,Shasta,089,179085,16,3,0,3,1
2020-03-25,Sierra,091,2930,0,0,0,0,0
2020-03-25,Siskiyou,093,43540,4,2,0,2,0
2020-03-25,Solano,095,438530,80,39,0,39,0
2020-03-25,Sonoma,097,501317,124,31,0,31,1
2020-03-25,Stanislaus,099,539301,74,14,3,17,0
2020-03-25,Sutter,101,95872,9,1,0,1,0
2020-03-25,Tehama,103,63373,1,0,0,0,0
2020-03-25,Trinity,105,12862,0,0,0,0,0
2020-03-25,Tulare,107,460477,87,11,3,14,0
2020-03-25,Tuolumne,109,53932,2,0,0,0,0
2020-03-25,Ventura,111,848112,229,53,0,53,1
2020-03-25,Yolo,113,214977,42,9,0,9,1
2020-03-25,Yuba,115,75493,7,2,0,2,0
2020-03-24,Alameda,001,1643700,503,96,1,97,2
2020-03-24,Alpine,003,1148,1,0,0,0,0
2020-03-24,Amador,005,37829,2,1,0,1,0
2020-03-24,Butte,007,227075,11,3,0,3,0
2020-03-24,Calaveras,009,45235,5,2,0,2,0
2020-03-24,Colusa,011,21464,2,0,0,0,0
2020-03-24,Contra Costa,013,1133247,358,108,0,108,1
2020-03-24,Del Norte,015,27424,0,0,0,0,0
2020-03-24,El Dorado,017,186661,27,3,0,3,0
2020-03-24,Fresno,019,978130,133,18,2,20,0
2020-03-24,Glenn,021,27897,2,0,0,0,0
2020-03-24,Humboldt,023,135768,33,2,0,2,0
2020-03-24,Imperial,025,180216,54,3,0,3,0
2020-03-24,Inyo,027,18085,5,0,0,0,0
2020-03-24,Kern,029,883053,144,5,0,5,0
2020-03-24,Kings,031,150075,25,0,1,1,0
2020-03-24,Lake,033,64148,0,0,0,0,0
2020-03-24,Lassen,035,31185,3,0,1,1,0
2020-03-24,Los Angeles,037,10098052,3683,633,10,643,7
2020-03-24,Madera,039,155013,36,6,0,6,0
2020-03-24,Marin,041,260295,89,44,0,44,0
2020-03-24,Mariposa,043,17540,0,0,0,0,0
2020-03-24,Mendocino,045,87422,3,1,0,1,0
2020-03-24,Merced,047,269075,17,0,0,0,0
2020-03-24,Modoc,049,8938,0,0,0,0,0
2020-03-24,Mono,051,14174,21,1,0,1,0
2020-03-24,Monterey,053,433212,59,23,1,24,1
2020-03-24,Napa,055,140530,23,2,0,2,0
2020-03-24,Nevada,057,99092,30,4,1,5,0
2020-03-24,Orange,059,3164182,938,166,9,175,0
2020-03-24,Placer,061,380077,93,22,0,22,1
2020-03-24,Plumas,063,18699,0,1,0,1,0
2020-03-24,Riverside,065,2383286,746,56,12,68,5
2020-03-24,Sacramento,067,1510023,426,93,0,93,4
2020-03-24,San Benito,069,59416,26,4,0,4,1
2020-03-24,San Bernardino,071,2135413,365,27,0,27,0
2020-03-24,San Diego,073,3302833,1127,231,0,231,2
2020-03-24,San Francisco,075,870044,521,181,0,181,1
2020-03-24,San Joaquin,077,732212,166,52,3,55,2
2020-03-24,San Luis Obispo,079,281455,102,32,0,32,0
2020-03-24,San Mateo,081,765935,536,100,2,102,2
2020-03-24,Santa Barbara,083,443738,151,20,1,21,0
2020-03-24,Santa Clara,085,1922200,1126,389,2,391,17
2020-03-24,Santa Cruz,087,273765,67,22,0,22,0
2020-03-24,Shasta,089,179085,15,3,0,3,0
2020-03-24,Sierra,091,2930,0,0,0,0,0
2020-03-24,Siskiyou,093,43540,4,2,0,2,0
2020-03-24,Solano,095,438530,78,34,0,34,0
2020-03-24,Sonoma,097,501317,117,27,0,27,1
2020-03-24,Stanislaus,099,539301,65,13,3,16,0
2020-03-24,Sutter,101,95872,9,0,0,0,0
2020-03-24,Tehama,103,63373,1,0,0,0,0
2020-03-24,Trinity,105,12862,0,0,0,0,0
2020-03-24,Tulare,107,460477,77,10,3,13,0
2020-03-24,Tuolumne,109,53932,2,0,0,0,0
2020-03-24,Ventura,111,848112,213,44,0,44,1
2020-03-24,Yolo,113,214977,38,8,0,8,0
2020-03-24,Yuba,115,75493,7,2,0,2,0
2020-03-23,Alameda,001,1643700,472,88,1,89,1
2020-03-23,Alpine,003,1148,1,0,0,0,0
2020-03-23,Amador,005,37829,2,1,0,1,0
2020-03-23,Butte,007,227075,11,2,0,2,0
2020-03-23,Calaveras,009,45235,5,2,0,2,0
2020-03-23,Colusa,011,21464,1,0,0,0,0
2020-03-23,Contra Costa,013,1133247,338,91,0,91,2
2020-03-23,Del Norte,015,27424,0,0,0,0,0
2020-03-23,El Dorado,017,186661,26,3,0,3,0
2020-03-23,Fresno,019,978130,123,10,2,12,0
2020-03-23,Glenn,021,27897,2,0,0,0,0
2020-03-23,Humboldt,023,135768,31,2,0,2,0
2020-03-23,Imperial,025,180216,50,2,0,2,0
2020-03-23,Inyo,027,18085,3,0,0,0,0
2020-03-23,Kern,029,883053,130,5,0,5,0
2020-03-23,Kings,031,150075,25,0,1,1,0
2020-03-23,Lake,033,64148,0,0,0,0,0
2020-03-23,Lassen,035,31185,3,0,1,1,0
2020-03-23,Los Angeles,037,10098052,3379,389,10,399,4
2020-03-23,Madera,039,155013,36,4,0,4,0
2020-03-23,Marin,041,260295,84,30,0,30,0
2020-03-23,Mariposa,043,17540,0,0,0,0,0
2020-03-23,Mendocino,045,87422,3,1,0,1,0
2020-03-23,Merced,047,269075,11,0,0,0,0
2020-03-23,Modoc,049,8938,0,0,0,0,0
2020-03-23,Mono,051,14174,19,1,0,1,0
2020-03-23,Monterey,053,433212,54,14,1,15,1
2020-03-23,Napa,055,140530,21,1,0,1,0
2020-03-23,Nevada,057,99092,27,2,1,3,0
2020-03-23,Orange,059,3164182,883,138,7,145,0
2020-03-23,Placer,061,380077,90,19,0,19,1
2020-03-23,Plumas,063,18699,0,0,0,0,0
2020-03-23,Riverside,065,2383286,703,39,12,51,5
2020-03-23,Sacramento,067,1510023,393,87,0,87,4
2020-03-23,San Benito,069,59416,25,4,0,4,1
2020-03-23,San Bernardino,071,2135413,335,17,0,17,0
2020-03-23,San Diego,073,3302833,1068,178,0,178,1
2020-03-23,San Francisco,075,870044,492,152,0,152,0
2020-03-23,San Joaquin,077,732212,154,37,3,40,2
2020-03-23,San Luis Obispo,079,281455,96,23,0,23,0
2020-03-23,San Mateo,081,765935,497,88,2,90,1
2020-03-23,Santa Barbara,083,443738,133,18,1,19,0
2020-03-23,Santa Clara,085,1922200,1077,336,2,338,13
2020-03-23,Santa Cruz,087,273765,65,21,0,21,0
2020-03-23,Shasta,089,179085,13,2,0,2,0
2020-03-23,Sierra,091,2930,0,0,0,0,0
2020-03-23,Siskiyou,093,43540,4,2,0,2,0
2020-03-23,Solano,095,438530,74,33,0,33,0
2020-03-23,Sonoma,097,501317,105,19,0,19,1
2020-03-23,Stanislaus,099,539301,57,10,3,13,0
2020-03-23,Sutter,101,95872,9,0,0,0,0
2020-03-23,Tehama,103,63373,1,0,0,0,0
2020-03-23,Trinity,105,12862,0,0,0,0,0
2020-03-23,Tulare,107,460477,68,9,3,12,0
2020-03-23,Tuolumne,109,53932,2,0,0,0,0
2020-03-23,Ventura,111,848112,196,30,0,30,0
2020-03-23,Yolo,113,214977,37,8,0,8,0
2020-03-23,Yuba,115,75493,7,2,0,2,0
2020-03-22,Alameda,001,1643700,433,72,1,73,1
2020-03-22,Alpine,003,1148,1,0,0,0,0
2020-03-22,Amador,005,37829,2,1,0,1,0
2020-03-22,Butte,007,227075,8,1,0,1,0
2020-03-22,Calaveras,009,45235,4,2,0,2,0
2020-03-22,Colusa,011,21464,1,0,0,0,0
2020-03-22,Contra Costa,013,1133247,311,79,0,79,1
2020-03-22,Del Norte,015,27424,0,0,0,0,0
2020-03-22,El Dorado,017,186661,24,1,0,1,0
2020-03-22,Fresno,019,978130,103,8,2,10,0
2020-03-22,Glenn,021,27897,2,0,0,0,0
2020-03-22,Humboldt,023,135768,28,1,0,1,0
2020-03-22,Imperial,025,180216,48,2,0,2,0
2020-03-22,Inyo,027,18085,1,0,0,0,0
2020-03-22,Kern,029,883053,114,3,0,3,0
2020-03-22,Kings,031,150075,22,0,1,1,0
2020-03-22,Lake,033,64148,0,0,0,0,0
2020-03-22,Lassen,035,31185,3,0,1,1,0
2020-03-22,Los Angeles,037,10098052,3057,384,10,394,3
2020-03-22,Madera,039,155013,33,4,0,4,0
2020-03-22,Marin,041,260295,74,30,0,30,0
2020-03-22,Mariposa,043,17540,0,0,0,0,0
2020-03-22,Mendocino,045,87422,3,1,0,1,0
2020-03-22,Merced,047,269075,7,0,0,0,0
2020-03-22,Modoc,049,8938,0,0,0,0,0
2020-03-22,Mono,051,14174,14,1,0,1,0
2020-03-22,Monterey,053,433212,51,14,1,15,1
2020-03-22,Napa,055,140530,17,1,0,1,0
2020-03-22,Nevada,057,99092,23,2,1,3,0
2020-03-22,Orange,059,3164182,811,102,4,106,0
2020-03-22,Placer,061,380077,87,18,0,18,1
2020-03-22,Plumas,063,18699,0,0,0,0,0
2020-03-22,Riverside,065,2383286,613,26,8,34,5
2020-03-22,Sacramento,067,1510023,361,82,0,82,4
2020-03-22,San Benito,069,59416,20,4,0,4,1
2020-03-22,San Bernardino,071,2135413,292,16,0,16,0
2020-03-22,San Diego,073,3302833,980,161,0,161,0
2020-03-22,San Francisco,075,870044,455,134,0,134,0
2020-03-22,San Joaquin,077,732212,140,30,3,33,2
2020-03-22,San Luis Obispo,079,281455,89,19,0,19,0
2020-03-22,San Mateo,081,765935,464,82,2,84,1
2020-03-22,Santa Barbara,083,443738,119,16,1,17,0
2020-03-22,Santa Clara,085,1922200,1013,284,2,286,13
2020-03-22,Santa Cruz,087,273765,64,19,0,19,0
2020-03-22,Shasta,089,179085,13,1,0,1,0
2020-03-22,Sierra,091,2930,0,0,0,0,0
2020-03-22,Siskiyou,093,43540,4,2,0,2,0
2020-03-22,Solano,095,438530,65,30,0,30,0
2020-03-22,Sonoma,097,501317,100,18,0,18,1
2020-03-22,Stanislaus,099,539301,51,8,3,11,0
2020-03-22,Sutter,101,95872,8,0,0,0,0
2020-03-22,Tehama,103,63373,0,0,0,0,0
2020-03-22,Trinity,105,12862,0,0,0,0,0
2020-03-22,Tulare,107,460477,62,5,3,8,0
2020-03-22,Tuolumne,109,53932,2,0,0,0,0
2020-03-22,Ventura,111,848112,174,26,0,26,0
2020-03-22,Yolo,113,214977,31,6,0,6,0
2020-03-22,Yuba,115,75493,7,2,0,2,0
2020-03-21,Alameda,001,1643700,409,62,1,63,0
2020-03-21,Alpine,003,1148,1,0,0,0,0
2020-03-21,Amador,005,37829,2,1,0,1,0
2020-03-21,Butte,007,227075,7,1,0,1,0
2020-03-21,Calaveras,009,45235,4,2,0,2,0
2020-03-21,Colusa,011,21464,1,0,0,0,0
2020-03-21,Contra Costa,013,1133247,300,62,0,62,1
2020-03-21,Del Norte,015,27424,0,0,0,0,0
2020-03-21,El Dorado,017,186661,21,1,0,1,0
2020-03-21,Fresno,019,978130,99,8,2,10,0
2020-03-21,Glenn,021,27897,2,0,0,0,0
2020-03-21,Humboldt,023,135768,25,1,0,1,0
2020-03-21,Imperial,025,180216,44,2,0,2,0
2020-03-21,Inyo,027,18085,1,0,0,0,0
2020-03-21,Kern,029,883053,108,3,0,3,0
2020-03-21,Kings,031,150075,22,0,1,1,0
2020-03-21,Lake,033,64148,0,0,0,0,0
2020-03-21,Lassen,035,31185,3,0,1,1,0
2020-03-21,Los Angeles,037,10098052,2784,322,10,332,2
2020-03-21,Madera,039,155013,33,4,0,4,0
2020-03-21,Marin,041,260295,69,30,0,30,0
2020-03-21,Mariposa,043,17540,0,0,0,0,0
2020-03-21,Mendocino,045,87422,3,1,0,1,0
2020-03-21,Merced,047,269075,6,0,0,0,0
2020-03-21,Modoc,049,8938,0,0,0,0,0
2020-03-21,Mono,051,14174,14,1,0,1,0
2020-03-21,Monterey,053,433212,48,8,1,9,1
2020-03-21,Napa,055,140530,17,0,0,0,0
2020-03-21,Nevada,057,99092,23,2,1,3,0
2020-03-21,Orange,059,3164182,762,85,4,89,0
2020-03-21,Placer,061,380077,78,11,0,11,1
2020-03-21,Plumas,063,18699,0,0,0,0,0
2020-03-21,Riverside,065,2383286,566,20,8,28,3
2020-03-21,Sacramento,067,1510023,334,66,0,66,3
2020-03-21,San Benito,069,59416,18,4,0,4,1
2020-03-21,San Bernardino,071,2135413,272,13,0,13,0
2020-03-21,San Diego,073,3302833,903,121,0,121,0
2020-03-21,San Francisco,075,870044,419,106,0,106,0
2020-03-21,San Joaquin,077,732212,131,26,3,29,2
2020-03-21,San Luis Obispo,079,281455,84,16,0,16,0
2020-03-21,San Mateo,081,765935,426,78,2,80,1
2020-03-21,Santa Barbara,083,443738,109,8,1,9,0
2020-03-21,Santa Clara,085,1922200,951,269,2,271,10
2020-03-21,Santa Cruz,087,273765,62,17,0,17,0
2020-03-21,Shasta,089,179085,12,1,0,1,0
2020-03-21,Sierra,091,2930,0,0,0,0,0
2020-03-21,Siskiyou,093,43540,4,0,0,0,0
2020-03-21,Solano,095,438530,63,30,0,30,0
2020-03-21,Sonoma,097,501317,99,15,0,15,1
2020-03-21,Stanislaus,099,539301,45,7,3,10,0
2020-03-21,Sutter,101,95872,7,0,0,0,0
2020-03-21,Tehama,103,63373,0,0,0,0,0
2020-03-21,Trinity,105,12862,0,0,0,0,0
2020-03-21,Tulare,107,460477,54,5,3,8,0
2020-03-21,Tuolumne,109,53932,2,0,0,0,0
2020-03-21,Ventura,111,848112,166,22,0,22,0
2020-03-21,Yolo,113,214977,31,6,0,6,0
2020-03-21,Yuba,115,75493,7,1,0,1,0
2020-03-20,Alameda,001,1643700,388,42,1,43,0
2020-03-20,Alpine,003,1148,1,0,0,0,0
2020-03-20,Amador,005,37829,1,0,0,0,0
2020-03-20,Butte,007,227075,7,0,0,0,0
2020-03-20,Calaveras,009,45235,4,2,0,2,0
2020-03-20,Colusa,011,21464,1,0,0,0,0
2020-03-20,Contra Costa,013,1133247,270,52,0,52,1
2020-03-20,Del Norte,015,27424,0,0,0,0,0
2020-03-20,El Dorado,017,186661,20,1,0,1,0
2020-03-20,Fresno,019,978130,96,7,2,9,0
2020-03-20,Glenn,021,27897,1,0,0,0,0
2020-03-20,Humboldt,023,135768,25,1,0,1,0
2020-03-20,Imperial,025,180216,43,2,0,2,0
2020-03-20,Inyo,027,18085,0,0,0,0,0
2020-03-20,Kern,029,883053,93,3,0,3,0
2020-03-20,Kings,031,150075,21,0,1,1,0
2020-03-20,Lake,033,64148,0,0,0,0,0
2020-03-20,Lassen,035,31185,3,0,1,1,0
2020-03-20,Los Angeles,037,10098052,2558,267,9,276,1
2020-03-20,Madera,039,155013,32,4,0,4,0
2020-03-20,Marin,041,260295,66,30,0,30,0
2020-03-20,Mariposa,043,17540,0,0,0,0,0
2020-03-20,Mendocino,045,87422,3,1,0,1,0
2020-03-20,Merced,047,269075,6,0,0,0,0
2020-03-20,Modoc,049,8938,0,0,0,0,0
2020-03-20,Mono,051,14174,14,0,0,0,0
2020-03-20,Monterey,053,433212,47,4,1,5,0
2020-03-20,Napa,055,140530,16,0,0,0,0
2020-03-20,Nevada,057,99092,20,2,1,3,0
2020-03-20,Orange,059,3164182,715,71,4,75,2
2020-03-20,Placer,061,380077,72,9,0,9,1
2020-03-20,Plumas,063,18699,0,0,0,0,0
2020-03-20,Riverside,065,2383286,507,19,8,27,3
2020-03-20,Sacramento,067,1510023,313,56,0,56,4
2020-03-20,San Benito,069,59416,18,4,0,4,1
2020-03-20,San Bernardino,071,2135413,245,9,0,9,0
2020-03-20,San Diego,073,3302833,851,98,0,98,0
2020-03-20,San Francisco,075,870044,387,87,0,87,0
2020-03-20,San Joaquin,077,732212,116,18,3,21,2
2020-03-20,San Luis Obispo,079,281455,80,11,0,11,0
2020-03-20,San Mateo,081,765935,396,71,2,73,1
2020-03-20,Santa Barbara,083,443738,97,7,1,8,0
2020-03-20,Santa Clara,085,1922200,914,246,2,248,8
2020-03-20,Santa Cruz,087,273765,60,13,0,13,0
2020-03-20,Shasta,089,179085,11,1,0,1,0
2020-03-20,Sierra,091,2930,0,0,0,0,0
2020-03-20,Siskiyou,093,43540,4,0,0,0,0
2020-03-20,Solano,095,438530,59,29,0,29,0
2020-03-20,Sonoma,097,501317,91,7,0,7,0
2020-03-20,Stanislaus,099,539301,39,7,3,10,0
2020-03-20,Sutter,101,95872,7,0,0,0,0
2020-03-20,Tehama,103,63373,0,0,0,0,0
2020-03-20,Trinity,105,12862,0,0,0,0,0
2020-03-20,Tulare,107,460477,50,4,3,7,0
2020-03-20,Tuolumne,109,53932,2,0,0,0,0
2020-03-20,Ventura,111,848112,156,18,0,18,0
2020-03-20,Yolo,113,214977,29,5,0,5,0
2020-03-20,Yuba,115,75493,6,0,0,0,0
2020-03-19,Alameda,001,1643700,352,36,1,37,0
2020-03-19,Alpine,003,1148,1,0,0,0,0
2020-03-19,Amador,005,37829,1,0,0,0,0
2020-03-19,Butte,007,227075,5,0,0,0,0
2020-03-19,Calaveras,009,45235,4,2,0,2,0
2020-03-19,Colusa,011,21464,0,0,0,0,0
2020-03-19,Contra Costa,013,1133247,254,46,0,46,0
2020-03-19,Del Norte,015,27424,0,0,0,0,0
2020-03-19,El Dorado,017,186661,18,0,0,0,0
2020-03-19,Fresno,019,978130,87,6,2,8,0
2020-03-19,Glenn,021,27897,1,0,0,0,0
2020-03-19,Humboldt,023,135768,23,1,0,1,0
2020-03-19,Imperial,025,180216,36,2,0,2,0
2020-03-19,Inyo,027,18085,0,0,0,0,0
2020-03-19,Kern,029,883053,81,3,0,3,0
2020-03-19,Kings,031,150075,17,0,1,1,0
2020-03-19,Lake,033,64148,0,0,0,0,0
2020-03-19,Lassen,035,31185,2,0,1,1,0
2020-03-19,Los Angeles,037,10098052,2271,233,9,242,0
2020-03-19,Madera,039,155013,31,3,0,3,0
2020-03-19,Marin,041,260295,63,19,0,19,0
2020-03-19,Mariposa,043,17540,0,0,0,0,0
2020-03-19,Mendocino,045,87422,2,1,0,1,0
2020-03-19,Merced,047,269075,5,0,0,0,0
2020-03-19,Modoc,049,8938,0,0,0,0,0
2020-03-19,Mono,051,14174,12,0,0,0,0
2020-03-19,Monterey,053,433212,39,3,1,4,0
2020-03-19,Napa,055,140530,14,0,0,0,0
2020-03-19,Nevada,057,99092,18,2,1,3,0
2020-03-19,Orange,059,3164182,633,59,4,63,0
2020-03-19,Placer,061,380077,64,8,0,8,1
2020-03-19,Plumas,063,18699,0,0,0,0,0
2020-03-19,Riverside,065,2383286,396,14,6,20,3
2020-03-19,Sacramento,067,1510023,280,52,0,52,3
2020-03-19,San Benito,069,59416,15,3,0,3,0
2020-03-19,San Bernardino,071,2135413,215,7,0,7,0
2020-03-19,San Diego,073,3302833,768,68,0,68,0
2020-03-19,San Francisco,075,870044,351,80,0,80,0
2020-03-19,San Joaquin,077,732212,102,15,3,18,2
2020-03-19,San Luis Obispo,079,281455,77,6,0,6,0
2020-03-19,San Mateo,081,765935,361,58,2,60,1
2020-03-19,Santa Barbara,083,443738,85,5,0,5,0
2020-03-19,Santa Clara,085,1922200,847,183,2,185,8
2020-03-19,Santa Cruz,087,273765,57,13,0,13,0
2020-03-19,Shasta,089,179085,10,1,0,1,0
2020-03-19,Sierra,091,2930,0,0,0,0,0
2020-03-19,Siskiyou,093,43540,3,0,0,0,0
2020-03-19,Solano,095,438530,55,26,0,26,0
2020-03-19,Sonoma,097,501317,88,8,0,8,0
2020-03-19,Stanislaus,099,539301,38,7,3,10,0
2020-03-19,Sutter,101,95872,7,0,0,0,0
2020-03-19,Tehama,103,63373,0,0,0,0,0
2020-03-19,Trinity,105,12862,0,0,0,0,0
2020-03-19,Tulare,107,460477,44,3,3,6,0
2020-03-19,Tuolumne,109,53932,2,0,0,0,0
2020-03-19,Ventura,111,848112,134,15,0,15,0
2020-03-19,Yolo,113,214977,25,5,0,5,0
2020-03-19,Yuba,115,75493,5,0,0,0,0
2020-03-18,Alameda,001,1643700,324,29,1,30,0
2020-03-18,Alpine,003,1148,1,0,0,0,0
2020-03-18,Amador,005,37829,1,0,0,0,0
2020-03-18,Butte,007,227075,4,0,0,0,0
2020-03-18,Calaveras,009,45235,4,2,0,2,0
2020-03-18,Colusa,011,21464,0,0,0,0,0
2020-03-18,Contra Costa,013,1133247,232,44,0,44,0
2020-03-18,Del Norte,015,27424,0,0,0,0,0
2020-03-18,El Dorado,017,186661,17,0,0,0,0
2020-03-18,Fresno,019,978130,78,3,1,4,0
2020-03-18,Glenn,021,27897,1,0,0,0,0
2020-03-18,Humboldt,023,135768,19,1,0,1,0
2020-03-18,Imperial,025,180216,30,2,0,2,0
2020-03-18,Inyo,027,18085,0,0,0,0,0
2020-03-18,Kern,029,883053,66,1,0,1,0
2020-03-18,Kings,031,150075,15,0,1,1,0
2020-03-18,Lake,033,64148,0,0,0,0,0
2020-03-18,Lassen,035,31185,1,0,1,1,0
2020-03-18,Los Angeles,037,10098052,2033,47,9,56,0
2020-03-18,Madera,039,155013,30,2,0,2,0
2020-03-18,Marin,041,260295,58,10,0,10,0
2020-03-18,Mariposa,043,17540,0,0,0,0,0
2020-03-18,Mendocino,045,87422,2,0,0,0,0
2020-03-18,Merced,047,269075,5,0,0,0,0
2020-03-18,Modoc,049,8938,0,0,0,0,0
2020-03-18,Mono,051,14174,11,0,0,0,0
2020-03-18,Monterey,053,433212,31,1,0,1,0
2020-03-18,Napa,055,140530,11,0,0,0,0
2020-03-18,Nevada,057,99092,16,2,1,3,0
2020-03-18,Orange,059,3164182,576,38,4,42,0
2020-03-18,Placer,061,380077,57,8,0,8,1
2020-03-18,Plumas,063,18699,0,0,0,0,0
2020-03-18,Riverside,065,2383286,333,11,5,16,2
2020-03-18,Sacramento,067,1510023,257,46,0,46,3
2020-03-18,San Benito,069,59416,14,3,0,3,0
2020-03-18,San Bernardino,071,2135413,193,3,0,3,0
2020-03-18,San Diego,073,3302833,683,40,0,40,0
2020-03-18,San Francisco,075,870044,332,65,0,65,0
2020-03-18,San Joaquin,077,732212,90,14,3,17,2
2020-03-18,San Luis Obispo,079,281455,70,5,0,5,0
2020-03-18,San Mateo,081,765935,340,57,2,59,1
2020-03-18,Santa Barbara,083,443738,77,2,0,2,0
2020-03-18,Santa Clara,085,1922200,796,151,2,153,6
2020-03-18,Santa Cruz,087,273765,55,11,0,11,0
2020-03-18,Shasta,089,179085,9,1,0,1,0
2020-03-18,Sierra,091,2930,0,0,0,0,0
2020-03-18,Siskiyou,093,43540,3,0,0,0,0
2020-03-18,Solano,095,438530,51,26,0,26,0
2020-03-18,Sonoma,097,501317,79,6,0,6,0
2020-03-18,Stanislaus,099,539301,34,5,2,7,0
2020-03-18,Sutter,101,95872,5,0,0,0,0
2020-03-18,Tehama,103,63373,0,0,0,0,0
2020-03-18,Trinity,105,12862,0,0,0,0,0
2020-03-18,Tulare,107,460477,34,3,3,6,0
2020-03-18,Tuolumne,109,53932,2,0,0,0,0
2020-03-18,Ventura,111,848112,115,11,0,11,0
2020-03-18,Yolo,113,214977,22,4,0,4,0
2020-03-18,Yuba,115,75493,4,0,0,0,0
2020-03-17,Alameda,001,1643700,292,19,0,19,0
2020-03-17,Alpine,003,1148,0,0,0,0,0
2020-03-17,Amador,005,37829,1,0,0,0,0
2020-03-17,Butte,007,227075,4,0,0,0,0
2020-03-17,Calaveras,009,45235,4,2,0,2,0
2020-03-17,Colusa,011,21464,0,0,0,0,0
2020-03-17,Contra Costa,013,1133247,210,37,0,37,0
2020-03-17,Del Norte,015,27424,0,0,0,0,0
2020-03-17,El Dorado,017,186661,16,0,0,0,0
2020-03-17,Fresno,019,978130,68,2,1,3,0
2020-03-17,Glenn,021,27897,1,0,0,0,0
2020-03-17,Humboldt,023,135768,17,1,0,1,0
2020-03-17,Imperial,025,180216,24,2,0,2,0
2020-03-17,Inyo,027,18085,0,0,0,0,0
2020-03-17,Kern,029,883053,52,0,0,0,0
2020-03-17,Kings,031,150075,12,0,1,1,0
2020-03-17,Lake,033,64148,0,0,0,0,0
2020-03-17,Lassen,035,31185,1,0,1,1,0
2020-03-17,Los Angeles,037,10098052,1831,41,9,50,0
2020-03-17,Madera,039,155013,22,2,0,2,0
2020-03-17,Marin,041,260295,51,4,0,4,0
2020-03-17,Mariposa,043,17540,0,0,0,0,0
2020-03-17,Mendocino,045,87422,2,0,0,0,0
2020-03-17,Merced,047,269075,5,0,0,0,0
2020-03-17,Modoc,049,8938,0,0,0,0,0
2020-03-17,Mono,051,14174,9,0,0,0,0
2020-03-17,Monterey,053,433212,29,0,0,0,0
2020-03-17,Napa,055,140530,8,0,0,0,0
2020-03-17,Nevada,057,99092,15,1,1,2,0
2020-03-17,Orange,059,3164182,498,24,3,27,0
2020-03-17,Placer,061,380077,47,7,0,7,1
2020-03-17,Plumas,063,18699,0,0,0,0,0
2020-03-17,Riverside,065,2383286,271,11,5,16,0
2020-03-17,Sacramento,067,1510023,237,36,0,36,1
2020-03-17,San Benito,069,59416,12,2,0,2,0
2020-03-17,San Bernardino,071,2135413,165,2,0,2,0
2020-03-17,San Diego,073,3302833,616,17,0,17,0
2020-03-17,San Francisco,075,870044,305,46,0,46,0
2020-03-17,San Joaquin,077,732212,84,11,3,14,0
2020-03-17,San Luis Obispo,079,281455,62,1,0,1,0
2020-03-17,San Mateo,081,765935,308,46,2,48,1
2020-03-17,Santa Barbara,083,443738,65,0,0,0,0
2020-03-17,Santa Clara,085,1922200,738,121,2,123,4
2020-03-17,Santa Cruz,087,273765,52,10,0,10,0
2020-03-17,Shasta,089,179085,5,1,0,1,0
2020-03-17,Sierra,091,2930,0,0,0,0,0
2020-03-17,Siskiyou,093,43540,3,0,0,0,0
2020-03-17,Solano,095,438530,48,27,0,27,0
2020-03-17,Sonoma,097,501317,71,4,0,4,0
2020-03-17,Stanislaus,099,539301,31,4,2,6,0
2020-03-17,Sutter,101,95872,5,0,0,0,0
2020-03-17,Tehama,103,63373,0,0,0,0,0
2020-03-17,Trinity,105,12862,0,0,0,0,0
2020-03-17,Tulare,107,460477,29,2,3,5,0
2020-03-17,Tuolumne,109,53932,2,0,0,0,0
2020-03-17,Ventura,111,848112,98,7,0,7,0
2020-03-17,Yolo,113,214977,18,2,0,2,0
2020-03-17,Yuba,115,75493,4,0,0,0,0
2020-03-16,Alameda,001,1643700,263,17,0,17,0
2020-03-16,Alpine,003,1148,0,0,0,0,0
2020-03-16,Amador,005,37829,1,0,0,0,0
2020-03-16,Butte,007,227075,3,0,0,0,0
2020-03-16,Calaveras,009,45235,4,2,0,2,0
2020-03-16,Colusa,011,21464,0,0,0,0,0
2020-03-16,Contra Costa,013,1133247,186,36,0,36,0
2020-03-16,Del Norte,015,27424,0,0,0,0,0
2020-03-16,El Dorado,017,186661,15,0,0,0,0
2020-03-16,Fresno,019,978130,53,2,1,3,0
2020-03-16,Glenn,021,27897,0,0,0,0,0
2020-03-16,Humboldt,023,135768,13,1,0,1,0
2020-03-16,Imperial,025,180216,19,2,0,2,0
2020-03-16,Inyo,027,18085,0,0,0,0,0
2020-03-16,Kern,029,883053,43,0,0,0,0
2020-03-16,Kings,031,150075,11,0,1,1,0
2020-03-16,Lake,033,64148,0,0,0,0,0
2020-03-16,Lassen,035,31185,1,0,0,0,0
2020-03-16,Los Angeles,037,10098052,1596,43,9,52,0
2020-03-16,Madera,039,155013,21,2,0,2,0
2020-03-16,Marin,041,260295,48,4,0,4,0
2020-03-16,Mariposa,043,17540,0,0,0,0,0
2020-03-16,Mendocino,045,87422,2,0,0,0,0
2020-03-16,Merced,047,269075,5,0,0,0,0
2020-03-16,Modoc,049,8938,0,0,0,0,0
2020-03-16,Mono,051,14174,7,0,0,0,0
2020-03-16,Monterey,053,433212,28,0,0,0,0
2020-03-16,Napa,055,140530,7,0,0,0,0
2020-03-16,Nevada,057,99092,11,1,1,2,0
2020-03-16,Orange,059,3164182,415,18,3,21,0
2020-03-16,Placer,061,380077,39,7,0,7,1
2020-03-16,Plumas,063,18699,0,0,0,0,0
2020-03-16,Riverside,065,2383286,235,10,5,15,0
2020-03-16,Sacramento,067,1510023,210,34,0,34,1
2020-03-16,San Benito,069,59416,8,2,0,2,0
2020-03-16,San Bernardino,071,2135413,145,1,0,1,0
2020-03-16,San Diego,073,3302833,525,17,0,17,0
2020-03-16,San Francisco,075,870044,267,40,0,40,0
2020-03-16,San Joaquin,077,732212,74,9,3,12,0
2020-03-16,San Luis Obispo,079,281455,55,1,0,1,0
2020-03-16,San Mateo,081,765935,269,42,2,44,1
2020-03-16,Santa Barbara,083,443738,55,0,0,0,0
2020-03-16,Santa Clara,085,1922200,658,115,1,116,2
2020-03-16,Santa Cruz,087,273765,45,9,0,9,0
2020-03-16,Shasta,089,179085,5,1,0,1,0
2020-03-16,Sierra,091,2930,0,0,0,0,0
2020-03-16,Siskiyou,093,43540,2,0,0,0,0
2020-03-16,Solano,095,438530,43,27,0,27,0
2020-03-16,Sonoma,097,501317,63,4,0,4,0
2020-03-16,Stanislaus,099,539301,27,2,2,4,0
2020-03-16,Sutter,101,95872,3,0,0,0,0
2020-03-16,Tehama,103,63373,0,0,0,0,0
2020-03-16,Trinity,105,12862,0,0,0,0,0
2020-03-16,Tulare,107,460477,25,2,3,5,0
2020-03-16,Tuolumne,109,53932,2,0,0,0,0
2020-03-16,Ventura,111,848112,88,7,0,7,0
2020-03-16,Yolo,113,214977,17,2,0,2,0
2020-03-16,Yuba,115,75493,3,0,0,0,0
2020-03-15,Alameda,001,1643700,216,17,0,17,0
2020-03-15,Alpine,003,1148,0,0,0,0,0
2020-03-15,Amador,005,37829,1,0,0,0,0
2020-03-15,Butte,007,227075,3,0,0,0,0
2020-03-15,Calaveras,009,45235,2,2,0,2,0
2020-03-15,Colusa,011,21464,0,0,0,0,0
2020-03-15,Contra Costa,013,1133247,161,34,0,34,0
2020-03-15,Del Norte,015,27424,0,0,0,0,0
2020-03-15,El Dorado,017,186661,14,0,0,0,0
2020-03-15,Fresno,019,978130,33,1,1,2,0
2020-03-15,Glenn,021,27897,0,0,0,0,0
2020-03-15,Humboldt,023,135768,11,1,0,1,0
2020-03-15,Imperial,025,180216,14,2,0,2,0
2020-03-15,Inyo,027,18085,0,0,0,0,0
2020-03-15,Kern,029,883053,37,0,0,0,0
2020-03-15,Kings,031,150075,11,0,1,1,0
2020-03-15,Lake,033,64148,0,0,0,0,0
2020-03-15,Lassen,035,31185,1,0,0,0,0
2020-03-15,Los Angeles,037,10098052,1356,41,9,50,0
2020-03-15,Madera,039,155013,20,2,0,2,0
2020-03-15,Marin,041,260295,41,3,0,3,0
2020-03-15,Mariposa,043,17540,0,0,0,0,0
2020-03-15,Mendocino,045,87422,2,0,0,0,0
2020-03-15,Merced,047,269075,3,0,0,0,0
2020-03-15,Modoc,049,8938,0,0,0,0,0
2020-03-15,Mono,051,14174,6,0,0,0,0
2020-03-15,Monterey,053,433212,21,0,0,0,0
2020-03-15,Napa,055,140530,7,0,0,0,0
2020-03-15,Nevada,057,99092,11,0,1,1,0
2020-03-15,Orange,059,3164182,347,16,1,17,0
2020-03-15,Placer,061,380077,33,7,0,7,1
2020-03-15,Plumas,063,18699,0,0,0,0,0
2020-03-15,Riverside,065,2383286,183,10,5,15,0
2020-03-15,Sacramento,067,1510023,174,30,0,30,1
2020-03-15,San Benito,069,59416,8,2,0,2,0
2020-03-15,San Bernardino,071,2135413,123,0,0,0,0
2020-03-15,San Diego,073,3302833,438,16,0,16,0
2020-03-15,San Francisco,075,870044,209,31,0,31,0
2020-03-15,San Joaquin,077,732212,63,6,3,9,0
2020-03-15,San Luis Obispo,079,281455,45,1,0,1,0
2020-03-15,San Mateo,081,765935,235,29,1,30,1
2020-03-15,Santa Barbara,083,443738,46,0,0,0,0
2020-03-15,Santa Clara,085,1922200,586,79,1,80,2
2020-03-15,Santa Cruz,087,273765,38,8,0,8,0
2020-03-15,Shasta,089,179085,5,1,0,1,0
2020-03-15,Sierra,091,2930,0,0,0,0,0
2020-03-15,Siskiyou,093,43540,2,0,0,0,0
2020-03-15,Solano,095,438530,42,26,0,26,0
2020-03-15,Sonoma,097,501317,54,4,0,4,0
2020-03-15,Stanislaus,099,539301,26,2,2,4,0
2020-03-15,Sutter,101,95872,2,0,0,0,0
2020-03-15,Tehama,103,63373,0,0,0,0,0
2020-03-15,Trinity,105,12862,0,0,0,0,0
2020-03-15,Tulare,107,460477,19,2,3,5,0
2020-03-15,Tuolumne,109,53932,1,0,0,0,0
2020-03-15,Ventura,111,848112,77,5,0,5,0
2020-03-15,Yolo,113,214977,14,2,0,2,0
2020-03-15,Yuba,115,75493,2,0,0,0,0
2020-03-14,Alameda,001,1643700,197,11,0,11,0
2020-03-14,Alpine,003,1148,0,0,0,0,0
2020-03-14,Amador,005,37829,1,0,0,0,0
2020-03-14,Butte,007,227075,2,0,0,0,0
2020-03-14,Calaveras,009,45235,2,2,0,2,0
2020-03-14,Colusa,011,21464,0,0,0,0,0
2020-03-14,Contra Costa,013,1133247,139,30,0,30,0
2020-03-14,Del Norte,015,27424,0,0,0,0,0
2020-03-14,El Dorado,017,186661,12,0,0,0,0
2020-03-14,Fresno,019,978130,25,1,1,2,0
2020-03-14,Glenn,021,27897,0,0,0,0,0
2020-03-14,Humboldt,023,135768,7,1,0,1,0
2020-03-14,Imperial,025,180216,10,2,0,2,0
2020-03-14,Inyo,027,18085,0,0,0,0,0
2020-03-14,Kern,029,883053,32,0,0,0,0
2020-03-14,Kings,031,150075,11,0,1,1,0
2020-03-14,Lake,033,64148,0,0,0,0,0
2020-03-14,Lassen,035,31185,1,0,0,0,0
2020-03-14,Los Angeles,037,10098052,1178,35,9,44,0
2020-03-14,Madera,039,155013,19,2,0,2,0
2020-03-14,Marin,041,260295,37,3,0,3,0
2020-03-14,Mariposa,043,17540,0,0,0,0,0
2020-03-14,Mendocino,045,87422,2,0,0,0,0
2020-03-14,Merced,047,269075,3,0,0,0,0
2020-03-14,Modoc,049,8938,0,0,0,0,0
2020-03-14,Mono,051,14174,5,0,0,0,0
2020-03-14,Monterey,053,433212,15,0,0,0,0
2020-03-14,Napa,055,140530,5,0,0,0,0
2020-03-14,Nevada,057,99092,8,0,1,1,0
2020-03-14,Orange,059,3164182,308,14,0,14,0
2020-03-14,Placer,061,380077,29,6,0,6,1
2020-03-14,Plumas,063,18699,0,0,0,0,0
2020-03-14,Riverside,065,2383286,163,10,5,15,0
2020-03-14,Sacramento,067,1510023,152,31,0,31,1
2020-03-14,San Benito,069,59416,8,2,0,2,0
2020-03-14,San Bernardino,071,2135413,104,0,0,0,0
2020-03-14,San Diego,073,3302833,363,10,0,10,0
2020-03-14,San Francisco,075,870044,188,29,0,29,0
2020-03-14,San Joaquin,077,732212,54,6,3,9,0
2020-03-14,San Luis Obispo,079,281455,40,0,0,0,0
2020-03-14,San Mateo,081,765935,212,27,1,28,0
2020-03-14,Santa Barbara,083,443738,37,0,0,0,0
2020-03-14,Santa Clara,085,1922200,530,62,1,63,2
2020-03-14,Santa Cruz,087,273765,33,8,0,8,0
2020-03-14,Shasta,089,179085,5,1,0,1,0
2020-03-14,Sierra,091,2930,0,0,0,0,0
2020-03-14,Siskiyou,093,43540,1,0,0,0,0
2020-03-14,Solano,095,438530,40,26,0,26,0
2020-03-14,Sonoma,097,501317,41,2,0,2,0
2020-03-14,Stanislaus,099,539301,22,2,2,4,0
2020-03-14,Sutter,101,95872,2,0,0,0,0
2020-03-14,Tehama,103,63373,0,0,0,0,0
2020-03-14,Trinity,105,12862,0,0,0,0,0
2020-03-14,Tulare,107,460477,17,2,2,4,0
2020-03-14,Tuolumne,109,53932,1,0,0,0,0
2020-03-14,Ventura,111,848112,68,5,0,5,0
2020-03-14,Yolo,113,214977,14,2,0,2,0
2020-03-14,Yuba,115,75493,1,0,0,0,0
2020-03-13,Alameda,001,1643700,178,12,0,12,0
2020-03-13,Alpine,003,1148,0,0,0,0,0
2020-03-13,Amador,005,37829,1,0,0,0,0
2020-03-13,Butte,007,227075,0,0,0,0,0
2020-03-13,Calaveras,009,45235,2,2,0,2,0
2020-03-13,Colusa,011,21464,0,0,0,0,0
2020-03-13,Contra Costa,013,1133247,125,22,0,22,0
2020-03-13,Del Norte,015,27424,0,0,0,0,0
2020-03-13,El Dorado,017,186661,11,0,0,0,0
2020-03-13,Fresno,019,978130,20,1,1,2,0
2020-03-13,Glenn,021,27897,0,0,0,0,0
2020-03-13,Humboldt,023,135768,7,1,0,1,0
2020-03-13,Imperial,025,180216,9,2,0,2,0
2020-03-13,Inyo,027,18085,0,0,0,0,0
2020-03-13,Kern,029,883053,27,0,0,0,0
2020-03-13,Kings,031,150075,10,0,1,1,0
2020-03-13,Lake,033,64148,0,0,0,0,0
2020-03-13,Lassen,035,31185,1,0,0,0,0
2020-03-13,Los Angeles,037,10098052,1025,30,7,37,0
2020-03-13,Madera,039,155013,18,1,0,1,0
2020-03-13,Marin,041,260295,34,3,0,3,0
2020-03-13,Mariposa,043,17540,0,0,0,0,0
2020-03-13,Mendocino,045,87422,2,0,0,0,0
2020-03-13,Merced,047,269075,2,0,0,0,0
2020-03-13,Modoc,049,8938,0,0,0,0,0
2020-03-13,Mono,051,14174,3,0,0,0,0
2020-03-13,Monterey,053,433212,10,0,0,0,0
2020-03-13,Napa,055,140530,3,0,0,0,0
2020-03-13,Nevada,057,99092,7,0,1,1,0
2020-03-13,Orange,059,3164182,268,10,0,10,0
2020-03-13,Placer,061,380077,27,6,0,6,1
2020-03-13,Plumas,063,18699,0,0,0,0,0
2020-03-13,Riverside,065,2383286,133,5,4,9,0
2020-03-13,Sacramento,067,1510023,130,18,0,18,1
2020-03-13,San Benito,069,59416,6,2,0,2,0
2020-03-13,San Bernardino,071,2135413,97,0,0,0,0
2020-03-13,San Diego,073,3302833,313,8,0,8,0
2020-03-13,San Francisco,075,870044,174,28,0,28,0
2020-03-13,San Joaquin,077,732212,50,6,3,9,0
2020-03-13,San Luis Obispo,079,281455,33,0,0,0,0
2020-03-13,San Mateo,081,765935,191,24,1,25,0
2020-03-13,Santa Barbara,083,443738,33,0,0,0,0
2020-03-13,Santa Clara,085,1922200,468,59,1,60,1
2020-03-13,Santa Cruz,087,273765,32,7,0,7,0
2020-03-13,Shasta,089,179085,3,1,0,1,0
2020-03-13,Sierra,091,2930,0,0,0,0,0
2020-03-13,Siskiyou,093,43540,0,0,0,0,0
2020-03-13,Solano,095,438530,39,26,0,26,0
2020-03-13,Sonoma,097,501317,40,2,0,2,0
2020-03-13,Stanislaus,099,539301,17,2,2,4,0
2020-03-13,Sutter,101,95872,2,0,0,0,0
2020-03-13,Tehama,103,63373,0,0,0,0,0
2020-03-13,Trinity,105,12862,0,0,0,0,0
2020-03-13,Tulare,107,460477,14,2,2,4,0
2020-03-13,Tuolumne,109,53932,1,0,0,0,0
2020-03-13,Ventura,111,848112,54,5,0,5,0
2020-03-13,Yolo,113,214977,14,1,0,1,0
2020-03-13,Yuba,115,75493,1,0,0,0,0
2020-03-12,Alameda,001,1643700,152,9,0,9,0
2020-03-12,Alpine,003,1148,0,0,0,0,0
2020-03-12,Amador,005,37829,1,0,0,0,0
2020-03-12,Butte,007,227075,0,0,0,0,0
2020-03-12,Calaveras,009,45235,2,2,0,2,0
2020-03-12,Colusa,011,21464,0,0,0,0,0
2020-03-12,Contra Costa,013,1133247,108,18,0,18,0
2020-03-12,Del Norte,015,27424,0,0,0,0,0
2020-03-12,El Dorado,017,186661,9,0,0,0,0
2020-03-12,Fresno,019,978130,12,1,1,2,0
2020-03-12,Glenn,021,27897,0,0,0,0,0
2020-03-12,Humboldt,023,135768,6,1,0,1,0
2020-03-12,Imperial,025,180216,8,2,0,2,0
2020-03-12,Inyo,027,18085,0,0,0,0,0
2020-03-12,Kern,029,883053,18,0,0,0,0
2020-03-12,Kings,031,150075,7,0,1,1,0
2020-03-12,Lake,033,64148,0,0,0,0,0
2020-03-12,Lassen,035,31185,1,0,0,0,0
2020-03-12,Los Angeles,037,10098052,866,30,7,37,0
2020-03-12,Madera,039,155013,15,1,0,1,0
2020-03-12,Marin,041,260295,24,1,0,1,0
2020-03-12,Mariposa,043,17540,0,0,0,0,0
2020-03-12,Mendocino,045,87422,2,0,0,0,0
2020-03-12,Merced,047,269075,2,0,0,0,0
2020-03-12,Modoc,049,8938,0,0,0,0,0
2020-03-12,Mono,051,14174,3,0,0,0,0
2020-03-12,Monterey,053,433212,8,0,0,0,0
2020-03-12,Napa,055,140530,3,0,0,0,0
2020-03-12,Nevada,057,99092,4,0,1,1,0
2020-03-12,Orange,059,3164182,231,7,0,7,0
2020-03-12,Placer,061,380077,23,6,0,6,1
2020-03-12,Plumas,063,18699,0,0,0,0,0
2020-03-12,Riverside,065,2383286,107,5,2,7,0
2020-03-12,Sacramento,067,1510023,106,17,0,17,1
2020-03-12,San Benito,069,59416,5,2,0,2,0
2020-03-12,San Bernardino,071,2135413,81,0,0,0,0
2020-03-12,San Diego,073,3302833,258,9,0,9,0
2020-03-12,San Francisco,075,870044,149,20,0,20,0
2020-03-12,San Joaquin,077,732212,44,3,3,6,1
2020-03-12,San Luis Obispo,079,281455,26,0,0,0,0
2020-03-12,San Mateo,081,765935,157,21,1,22,0
2020-03-12,Santa Barbara,083,443738,22,0,0,0,0
2020-03-12,Santa Clara,085,1922200,410,51,1,52,1
2020-03-12,Santa Cruz,087,273765,29,5,0,5,0
2020-03-12,Shasta,089,179085,2,1,0,1,0
2020-03-12,Sierra,091,2930,0,0,0,0,0
2020-03-12,Siskiyou,093,43540,0,0,0,0,0
2020-03-12,Solano,095,438530,34,26,0,26,0
2020-03-12,Sonoma,097,501317,34,2,0,2,0
2020-03-12,Stanislaus,099,539301,15,2,2,4,0
2020-03-12,Sutter,101,95872,0,0,0,0,0
2020-03-12,Tehama,103,63373,0,0,0,0,0
2020-03-12,Trinity,105,12862,0,0,0,0,0
2020-03-12,Tulare,107,460477,12,1,1,2,0
2020-03-12,Tuolumne,109,53932,1,0,0,0,0
2020-03-12,Ventura,111,848112,45,3,0,3,0
2020-03-12,Yolo,113,214977,13,1,0,1,0
2020-03-12,Yuba,115,75493,1,0,0,0,0
2020-03-11,Alameda,001,1643700,120,5,0,5,0
2020-03-11,Alpine,003,1148,0,0,0,0,0
2020-03-11,Amador,005,37829,1,0,0,0,0
2020-03-11,Butte,007,227075,0,0,0,0,0
2020-03-11,Calaveras,009,45235,2,2,0,2,0
2020-03-11,Colusa,011,21464,0,0,0,0,0
2020-03-11,Contra Costa,013,1133247,93,16,0,16,0
2020-03-11,Del Norte,015,27424,0,0,0,0,0
2020-03-11,El Dorado,017,186661,8,0,0,0,0
2020-03-11,Fresno,019,978130,9,1,1,2,0
2020-03-11,Glenn,021,27897,0,0,0,0,0
2020-03-11,Humboldt,023,135768,6,1,0,1,0
2020-03-11,Imperial,025,180216,6,0,0,0,0
2020-03-11,Inyo,027,18085,0,0,0,0,0
2020-03-11,Kern,029,883053,16,0,0,0,0
2020-03-11,Kings,031,150075,5,0,1,1,0
2020-03-11,Lake,033,64148,0,0,0,0,0
2020-03-11,Lassen,035,31185,1,0,0,0,0
2020-03-11,Los Angeles,037,10098052,698,21,7,28,0
2020-03-11,Madera,039,155013,12,1,0,1,0
2020-03-11,Marin,041,260295,17,1,0,1,0
2020-03-11,Mariposa,043,17540,0,0,0,0,0
2020-03-11,Mendocino,045,87422,1,0,0,0,0
2020-03-11,Merced,047,269075,2,0,0,0,0
2020-03-11,Modoc,049,8938,0,0,0,0,0
2020-03-11,Mono,051,14174,3,0,0,0,0
2020-03-11,Monterey,053,433212,7,0,0,0,0
2020-03-11,Napa,055,140530,2,0,0,0,0
2020-03-11,Nevada,057,99092,4,0,1,1,0
2020-03-11,Orange,059,3164182,202,6,0,6,0
2020-03-11,Placer,061,380077,18,6,0,6,1
2020-03-11,Plumas,063,18699,0,0,0,0,0
2020-03-11,Riverside,065,2383286,81,4,1,5,0
2020-03-11,Sacramento,067,1510023,88,9,0,9,1
2020-03-11,San Benito,069,59416,5,2,0,2,0
2020-03-11,San Bernardino,071,2135413,74,0,0,0,0
2020-03-11,San Diego,073,3302833,208,4,0,4,0
2020-03-11,San Francisco,075,870044,124,17,0,17,0
2020-03-11,San Joaquin,077,732212,33,1,3,4,0
2020-03-11,San Luis Obispo,079,281455,23,0,0,0,0
2020-03-11,San Mateo,081,765935,139,16,0,16,0
2020-03-11,Santa Barbara,083,443738,13,0,0,0,0
2020-03-11,Santa Clara,085,1922200,370,48,1,49,1
2020-03-11,Santa Cruz,087,273765,26,2,0,2,0
2020-03-11,Shasta,089,179085,2,1,0,1,0
2020-03-11,Sierra,091,2930,0,0,0,0,0
2020-03-11,Siskiyou,093,43540,0,0,0,0,0
2020-03-11,Solano,095,438530,29,26,0,26,0
2020-03-11,Sonoma,097,501317,30,2,0,2,0
2020-03-11,Stanislaus,099,539301,15,2,2,4,0
2020-03-11,Sutter,101,95872,0,0,0,0,0
2020-03-11,Tehama,103,63373,0,0,0,0,0
2020-03-11,Trinity,105,12862,0,0,0,0,0
2020-03-11,Tulare,107,460477,10,0,1,1,0
2020-03-11,Tuolumne,109,53932,1,0,0,0,0
2020-03-11,Ventura,111,848112,37,3,0,3,0
2020-03-11,Yolo,113,214977,9,1,0,1,0
2020-03-11,Yuba,115,75493,1,0,0,0,0
2020-03-10,Alameda,001,1643700,99,4,0,4,0
2020-03-10,Alpine,003,1148,0,0,0,0,0
2020-03-10,Amador,005,37829,1,0,0,0,0
2020-03-10,Butte,007,227075,0,0,0,0,0
2020-03-10,Calaveras,009,45235,2,2,0,2,0
2020-03-10,Colusa,011,21464,0,0,0,0,0
2020-03-10,Contra Costa,013,1133247,84,11,0,11,0
2020-03-10,Del Norte,015,27424,0,0,0,0,0
2020-03-10,El Dorado,017,186661,7,0,0,0,0
2020-03-10,Fresno,019,978130,7,1,1,2,0
2020-03-10,Glenn,021,27897,0,0,0,0,0
2020-03-10,Humboldt,023,135768,6,1,0,1,0
2020-03-10,Imperial,025,180216,5,0,0,0,0
2020-03-10,Inyo,027,18085,0,0,0,0,0
2020-03-10,Kern,029,883053,11,0,0,0,0
2020-03-10,Kings,031,150075,5,0,1,1,0
2020-03-10,Lake,033,64148,0,0,0,0,0
2020-03-10,Lassen,035,31185,1,0,0,0,0
2020-03-10,Los Angeles,037,10098052,562,20,7,27,0
2020-03-10,Madera,039,155013,7,1,0,1,0
2020-03-10,Marin,041,260295,16,1,0,1,0
2020-03-10,Mariposa,043,17540,0,0,0,0,0
2020-03-10,Mendocino,045,87422,0,0,0,0,0
2020-03-10,Merced,047,269075,2,0,0,0,0
2020-03-10,Modoc,049,8938,0,0,0,0,0
2020-03-10,Mono,051,14174,3,0,0,0,0
2020-03-10,Monterey,053,433212,5,0,0,0,0
2020-03-10,Napa,055,140530,2,0,0,0,0
2020-03-10,Nevada,057,99092,3,0,1,1,0
2020-03-10,Orange,059,3164182,182,5,0,5,1
2020-03-10,Placer,061,380077,14,7,0,7,1
2020-03-10,Plumas,063,18699,0,0,0,0,0
2020-03-10,Riverside,065,2383286,59,4,1,5,0
2020-03-10,Sacramento,067,1510023,79,8,0,8,0
2020-03-10,San Benito,069,59416,5,2,0,2,0
2020-03-10,San Bernardino,071,2135413,66,0,0,0,0
2020-03-10,San Diego,073,3302833,165,3,0,3,0
2020-03-10,San Francisco,075,870044,92,16,0,16,0
2020-03-10,San Joaquin,077,732212,30,1,3,4,0
2020-03-10,San Luis Obispo,079,281455,15,0,0,0,0
2020-03-10,San Mateo,081,765935,123,11,0,11,0
2020-03-10,Santa Barbara,083,443738,10,0,0,0,0
2020-03-10,Santa Clara,085,1922200,322,45,1,46,1
2020-03-10,Santa Cruz,087,273765,22,2,0,2,0
2020-03-10,Shasta,089,179085,2,1,0,1,0
2020-03-10,Sierra,091,2930,0,0,0,0,0
2020-03-10,Siskiyou,093,43540,0,0,0,0,0
2020-03-10,Solano,095,438530,27,26,0,26,0
2020-03-10,Sonoma,097,501317,27,2,0,2,0
2020-03-10,Stanislaus,099,539301,11,0,2,2,0
2020-03-10,Sutter,101,95872,0,0,0,0,0
2020-03-10,Tehama,103,63373,0,0,0,0,0
2020-03-10,Trinity,105,12862,0,0,0,0,0
2020-03-10,Tulare,107,460477,9,0,1,1,0
2020-03-10,Tuolumne,109,53932,1,0,0,0,0
2020-03-10,Ventura,111,848112,29,1,0,1,0
2020-03-10,Yolo,113,214977,6,2,0,2,0
2020-03-10,Yuba,115,75493,1,0,0,0,0
2020-03-09,Alameda,001,1643700,71,4,0,4,0
2020-03-09,Alpine,003,1148,0,0,0,0,0
2020-03-09,Amador,005,37829,0,0,0,0,0
2020-03-09,Butte,007,227075,0,0,0,0,0
2020-03-09,Calaveras,009,45235,2,0,0,0,0
2020-03-09,Colusa,011,21464,0,0,0,0,0
2020-03-09,Contra Costa,013,1133247,72,9,0,9,0
2020-03-09,Del Norte,015,27424,0,0,0,0,0
2020-03-09,El Dorado,017,186661,5,0,0,0,0
2020-03-09,Fresno,019,978130,7,1,1,2,0
2020-03-09,Glenn,021,27897,0,0,0,0,0
2020-03-09,Humboldt,023,135768,5,1,0,1,0
2020-03-09,Imperial,025,180216,5,0,0,0,0
2020-03-09,Inyo,027,18085,0,0,0,0,0
2020-03-09,Kern,029,883053,8,0,0,0,0
2020-03-09,Kings,031,150075,4,0,1,1,0
2020-03-09,Lake,033,64148,0,0,0,0,0
2020-03-09,Lassen,035,31185,1,0,0,0,0
2020-03-09,Los Angeles,037,10098052,460,17,6,23,0
2020-03-09,Madera,039,155013,7,1,0,1,0
2020-03-09,Marin,041,260295,15,1,0,1,0
2020-03-09,Mariposa,043,17540,0,0,0,0,0
2020-03-09,Mendocino,045,87422,0,0,0,0,0
2020-03-09,Merced,047,269075,2,0,0,0,0
2020-03-09,Modoc,049,8938,0,0,0,0,0
2020-03-09,Mono,051,14174,3,0,0,0,0
2020-03-09,Monterey,053,433212,3,0,0,0,0
2020-03-09,Napa,055,140530,2,0,0,0,0
2020-03-09,Nevada,057,99092,2,0,1,1,0
2020-03-09,Orange,059,3164182,154,4,0,4,0
2020-03-09,Placer,061,380077,12,7,0,7,1
2020-03-09,Plumas,063,18699,0,0,0,0,0
2020-03-09,Riverside,065,2383286,49,4,1,5,0
2020-03-09,Sacramento,067,1510023,75,8,0,8,0
2020-03-09,San Benito,069,59416,3,2,0,2,0
2020-03-09,San Bernardino,071,2135413,55,0,0,0,0
2020-03-09,San Diego,073,3302833,126,2,0,2,0
2020-03-09,San Francisco,075,870044,72,14,0,14,0
2020-03-09,San Joaquin,077,732212,21,0,3,3,0
2020-03-09,San Luis Obispo,079,281455,15,0,0,0,0
2020-03-09,San Mateo,081,765935,109,6,0,6,0
2020-03-09,Santa Barbara,083,443738,8,0,0,0,0
2020-03-09,Santa Clara,085,1922200,278,42,1,43,1
2020-03-09,Santa Cruz,087,273765,19,2,0,2,0
2020-03-09,Shasta,089,179085,2,1,0,1,0
2020-03-09,Sierra,091,2930,0,0,0,0,0
2020-03-09,Siskiyou,093,43540,0,0,0,0,0
2020-03-09,Solano,095,438530,25,26,0,26,0
2020-03-09,Sonoma,097,501317,22,2,0,2,0
2020-03-09,Stanislaus,099,539301,11,0,2,2,0
2020-03-09,Sutter,101,95872,0,0,0,0,0
2020-03-09,Tehama,103,63373,0,0,0,0,0
2020-03-09,Trinity,105,12862,0,0,0,0,0
2020-03-09,Tulare,107,460477,9,0,1,1,0
2020-03-09,Tuolumne,109,53932,1,0,0,0,0
2020-03-09,Ventura,111,848112,25,1,0,1,0
2020-03-09,Yolo,113,214977,5,2,0,2,0
2020-03-09,Yuba,115,75493,0,0,0,0,0
2020-03-08,Alameda,001,1643700,46,4,0,4,0
2020-03-08,Alpine,003,1148,0,0,0,0,0
2020-03-08,Amador,005,37829,0,0,0,0,0
2020-03-08,Butte,007,227075,0,0,0,0,0
2020-03-08,Calaveras,009,45235,2,0,0,0,0
2020-03-08,Colusa,011,21464,0,0,0,0,0
2020-03-08,Contra Costa,013,1133247,58,9,0,9,0
2020-03-08,Del Norte,015,27424,0,0,0,0,0
2020-03-08,El Dorado,017,186661,5,0,0,0,0
2020-03-08,Fresno,019,978130,5,1,1,2,0
2020-03-08,Glenn,021,27897,0,0,0,0,0
2020-03-08,Humboldt,023,135768,5,1,0,1,0
2020-03-08,Imperial,025,180216,5,0,0,0,0
2020-03-08,Inyo,027,18085,0,0,0,0,0
2020-03-08,Kern,029,883053,8,0,0,0,0
2020-03-08,Kings,031,150075,3,0,1,1,0
2020-03-08,Lake,033,64148,0,0,0,0,0
2020-03-08,Lassen,035,31185,0,0,0,0,0
2020-03-08,Los Angeles,037,10098052,367,14,6,20,0
2020-03-08,Madera,039,155013,7,1,0,1,0
2020-03-08,Marin,041,260295,13,1,0,1,0
2020-03-08,Mariposa,043,17540,0,0,0,0,0
2020-03-08,Mendocino,045,87422,0,0,0,0,0
2020-03-08,Merced,047,269075,2,0,0,0,0
2020-03-08,Modoc,049,8938,0,0,0,0,0
2020-03-08,Mono,051,14174,3,0,0,0,0
2020-03-08,Monterey,053,433212,3,0,0,0,0
2020-03-08,Napa,055,140530,2,0,0,0,0
2020-03-08,Nevada,057,99092,1,0,1,1,0
2020-03-08,Orange,059,3164182,129,4,0,4,0
2020-03-08,Placer,061,380077,11,7,0,7,1
2020-03-08,Plumas,063,18699,0,0,0,0,0
2020-03-08,Riverside,065,2383286,41,1,1,2,0
2020-03-08,Sacramento,067,1510023,65,5,0,5,0
2020-03-08,San Benito,069,59416,3,2,0,2,0
2020-03-08,San Bernardino,071,2135413,44,0,0,0,0
2020-03-08,San Diego,073,3302833,92,2,0,2,0
2020-03-08,San Francisco,075,870044,53,9,0,9,0
2020-03-08,San Joaquin,077,732212,18,0,3,3,0
2020-03-08,San Luis Obispo,079,281455,9,0,0,0,0
2020-03-08,San Mateo,081,765935,96,4,0,4,0
2020-03-08,Santa Barbara,083,443738,5,0,0,0,0
2020-03-08,Santa Clara,085,1922200,236,36,1,37,0
2020-03-08,Santa Cruz,087,273765,17,1,0,1,0
2020-03-08,Shasta,089,179085,2,0,0,0,0
2020-03-08,Sierra,091,2930,0,0,0,0,0
2020-03-08,Siskiyou,093,43540,0,0,0,0,0
2020-03-08,Solano,095,438530,24,26,0,26,0
2020-03-08,Sonoma,097,501317,17,2,0,2,0
2020-03-08,Stanislaus,099,539301,10,0,2,2,0
2020-03-08,Sutter,101,95872,0,0,0,0,0
2020-03-08,Tehama,103,63373,0,0,0,0,0
2020-03-08,Trinity,105,12862,0,0,0,0,0
2020-03-08,Tulare,107,460477,9,0,0,0,0
2020-03-08,Tuolumne,109,53932,1,0,0,0,0
2020-03-08,Ventura,111,848112,21,1,0,1,0
2020-03-08,Yolo,113,214977,2,2,0,2,0
2020-03-08,Yuba,115,75493,0,0,0,0,0
2020-03-07,Alameda,001,1643700,41,3,0,3,0
2020-03-07,Alpine,003,1148,0,0,0,0,0
2020-03-07,Amador,005,37829,0,0,0,0,0
2020-03-07,Butte,007,227075,0,0,0,0,0
2020-03-07,Calaveras,009,45235,2,0,0,0,0
2020-03-07,Colusa,011,21464,0,0,0,0,0
2020-03-07,Contra Costa,013,1133247,55,4,0,4,0
2020-03-07,Del Norte,015,27424,0,0,0,0,0
2020-03-07,El Dorado,017,186661,4,0,0,0,0
2020-03-07,Fresno,019,978130,4,1,1,2,0
2020-03-07,Glenn,021,27897,0,0,0,0,0
2020-03-07,Humboldt,023,135768,5,1,0,1,0
2020-03-07,Imperial,025,180216,4,0,0,0,0
2020-03-07,Inyo,027,18085,0,0,0,0,0
2020-03-07,Kern,029,883053,7,0,0,0,0
2020-03-07,Kings,031,150075,3,0,1,1,0
2020-03-07,Lake,033,64148,0,0,0,0,0
2020-03-07,Lassen,035,31185,0,0,0,0,0
2020-03-07,Los Angeles,037,10098052,317,14,6,20,0
2020-03-07,Madera,039,155013,6,1,0,1,0
2020-03-07,Marin,041,260295,11,0,0,0,0
2020-03-07,Mariposa,043,17540,0,0,0,0,0
2020-03-07,Mendocino,045,87422,0,0,0,0,0
2020-03-07,Merced,047,269075,2,0,0,0,0
2020-03-07,Modoc,049,8938,0,0,0,0,0
2020-03-07,Mono,051,14174,3,0,0,0,0
2020-03-07,Monterey,053,433212,3,0,0,0,0
2020-03-07,Napa,055,140530,1,0,0,0,0
2020-03-07,Nevada,057,99092,1,0,1,1,0
2020-03-07,Orange,059,3164182,121,4,0,4,0
2020-03-07,Placer,061,380077,11,6,0,6,1
2020-03-07,Plumas,063,18699,0,0,0,0,0
2020-03-07,Riverside,065,2383286,31,0,1,1,0
2020-03-07,Sacramento,067,1510023,52,4,0,4,0
2020-03-07,San Benito,069,59416,3,2,0,2,0
2020-03-07,San Bernardino,071,2135413,42,0,0,0,0
2020-03-07,San Diego,073,3302833,74,2,0,2,0
2020-03-07,San Francisco,075,870044,47,9,0,9,0
2020-03-07,San Joaquin,077,732212,16,0,3,3,0
2020-03-07,San Luis Obispo,079,281455,6,0,0,0,0
2020-03-07,San Mateo,081,765935,86,1,0,1,0
2020-03-07,Santa Barbara,083,443738,5,0,0,0,0
2020-03-07,Santa Clara,085,1922200,206,31,1,32,0
2020-03-07,Santa Cruz,087,273765,17,1,0,1,0
2020-03-07,Shasta,089,179085,2,0,0,0,0
2020-03-07,Sierra,091,2930,0,0,0,0,0
2020-03-07,Siskiyou,093,43540,0,0,0,0,0
2020-03-07,Solano,095,438530,23,25,0,25,0
2020-03-07,Sonoma,097,501317,13,2,0,2,0
2020-03-07,Stanislaus,099,539301,9,0,2,2,0
2020-03-07,Sutter,101,95872,0,0,0,0,0
2020-03-07,Tehama,103,63373,0,0,0,0,0
2020-03-07,Trinity,105,12862,0,0,0,0,0
2020-03-07,Tulare,107,460477,6,0,0,0,0
2020-03-07,Tuolumne,109,53932,1,0,0,0,0
2020-03-07,Ventura,111,848112,18,1,0,1,0
2020-03-07,Yolo,113,214977,2,2,0,2,0
2020-03-07,Yuba,115,75493,0,0,0,0,0
2020-03-06,Alameda,001,1643700,39,3,0,3,0
2020-03-06,Alpine,003,1148,0,0,0,0,0
2020-03-06,Amador,005,37829,0,0,0,0,0
2020-03-06,Butte,007,227075,0,0,0,0,0
2020-03-06,Calaveras,009,45235,2,0,0,0,0
2020-03-06,Colusa,011,21464,0,0,0,0,0
2020-03-06,Contra Costa,013,1133247,46,4,0,4,0
2020-03-06,Del Norte,015,27424,0,0,0,0,0
2020-03-06,El Dorado,017,186661,3,0,0,0,0
2020-03-06,Fresno,019,978130,3,0,1,1,0
2020-03-06,Glenn,021,27897,0,0,0,0,0
2020-03-06,Humboldt,023,135768,4,1,0,1,0
2020-03-06,Imperial,025,180216,3,0,0,0,0
2020-03-06,Inyo,027,18085,0,0,0,0,0
2020-03-06,Kern,029,883053,6,0,0,0,0
2020-03-06,Kings,031,150075,3,0,1,1,0
2020-03-06,Lake,033,64148,0,0,0,0,0
2020-03-06,Lassen,035,31185,0,0,0,0,0
2020-03-06,Los Angeles,037,10098052,274,13,6,19,0
2020-03-06,Madera,039,155013,5,0,0,0,0
2020-03-06,Marin,041,260295,10,0,0,0,0
2020-03-06,Mariposa,043,17540,0,0,0,0,0
2020-03-06,Mendocino,045,87422,0,0,0,0,0
2020-03-06,Merced,047,269075,2,0,0,0,0
2020-03-06,Modoc,049,8938,0,0,0,0,0
2020-03-06,Mono,051,14174,1,0,0,0,0
2020-03-06,Monterey,053,433212,3,0,0,0,0
2020-03-06,Napa,055,140530,1,0,0,0,0
2020-03-06,Nevada,057,99092,1,0,1,1,0
2020-03-06,Orange,059,3164182,95,4,0,4,0
2020-03-06,Placer,061,380077,10,5,0,5,1
2020-03-06,Plumas,063,18699,0,0,0,0,0
2020-03-06,Riverside,065,2383286,30,0,1,1,0
2020-03-06,Sacramento,067,1510023,43,2,0,2,0
2020-03-06,San Benito,069,59416,3,2,0,2,0
2020-03-06,San Bernardino,071,2135413,40,0,0,0,0
2020-03-06,San Diego,073,3302833,61,2,0,2,0
2020-03-06,San Francisco,075,870044,41,2,0,2,0
2020-03-06,San Joaquin,077,732212,13,0,3,3,0
2020-03-06,San Luis Obispo,079,281455,4,0,0,0,0
2020-03-06,San Mateo,081,765935,78,1,0,1,0
2020-03-06,Santa Barbara,083,443738,3,0,0,0,0
2020-03-06,Santa Clara,085,1922200,188,20,1,21,0
2020-03-06,Santa Cruz,087,273765,15,0,0,0,0
2020-03-06,Shasta,089,179085,2,0,0,0,0
2020-03-06,Sierra,091,2930,0,0,0,0,0
2020-03-06,Siskiyou,093,43540,0,0,0,0,0
2020-03-06,Solano,095,438530,22,25,0,25,0
2020-03-06,Sonoma,097,501317,13,2,0,2,0
2020-03-06,Stanislaus,099,539301,5,0,2,2,0
2020-03-06,Sutter,101,95872,0,0,0,0,0
2020-03-06,Tehama,103,63373,0,0,0,0,0
2020-03-06,Trinity,105,12862,0,0,0,0,0
2020-03-06,Tulare,107,460477,6,0,0,0,0
2020-03-06,Tuolumne,109,53932,1,0,0,0,0
2020-03-06,Ventura,111,848112,15,1,0,1,0
2020-03-06,Yolo,113,214977,2,1,0,1,0
2020-03-06,Yuba,115,75493,0,0,0,0,0
2020-03-05,Alameda,001,1643700,34,2,0,2,0
2020-03-05,Alpine,003,1148,0,0,0,0,0
2020-03-05,Amador,005,37829,0,0,0,0,0
2020-03-05,Butte,007,227075,0,0,0,0,0
2020-03-05,Calaveras,009,45235,2,0,0,0,0
2020-03-05,Colusa,011,21464,0,0,0,0,0
2020-03-05,Contra Costa,013,1133247,39,1,0,1,0
2020-03-05,Del Norte,015,27424,0,0,0,0,0
2020-03-05,El Dorado,017,186661,1,0,0,0,0
2020-03-05,Fresno,019,978130,3,0,1,1,0
2020-03-05,Glenn,021,27897,0,0,0,0,0
2020-03-05,Humboldt,023,135768,4,1,0,1,0
2020-03-05,Imperial,025,180216,2,0,0,0,0
2020-03-05,Inyo,027,18085,0,0,0,0,0
2020-03-05,Kern,029,883053,6,0,0,0,0
2020-03-05,Kings,031,150075,3,0,1,1,0
2020-03-05,Lake,033,64148,0,0,0,0,0
2020-03-05,Lassen,035,31185,0,0,0,0,0
2020-03-05,Los Angeles,037,10098052,227,11,6,17,0
2020-03-05,Madera,039,155013,5,0,0,0,0
2020-03-05,Marin,041,260295,10,0,0,0,0
2020-03-05,Mariposa,043,17540,0,0,0,0,0
2020-03-05,Mendocino,045,87422,0,0,0,0,0
2020-03-05,Merced,047,269075,2,0,0,0,0
2020-03-05,Modoc,049,8938,0,0,0,0,0
2020-03-05,Mono,051,14174,1,0,0,0,0
2020-03-05,Monterey,053,433212,3,0,0,0,0
2020-03-05,Napa,055,140530,1,0,0,0,0
2020-03-05,Nevada,057,99092,0,0,1,1,0
2020-03-05,Orange,059,3164182,80,3,0,3,0
2020-03-05,Placer,061,380077,10,2,0,2,1
2020-03-05,Plumas,063,18699,0,0,0,0,0
2020-03-05,Riverside,065,2383286,27,0,1,1,0
2020-03-05,Sacramento,067,1510023,37,2,0,2,0
2020-03-05,San Benito,069,59416,1,2,0,2,0
2020-03-05,San Bernardino,071,2135413,35,0,0,0,0
2020-03-05,San Diego,073,3302833,54,2,0,2,0
2020-03-05,San Francisco,075,870044,31,2,0,2,0
2020-03-05,San Joaquin,077,732212,10,0,3,3,0
2020-03-05,San Luis Obispo,079,281455,4,0,0,0,0
2020-03-05,San Mateo,081,765935,65,1,0,1,0
2020-03-05,Santa Barbara,083,443738,2,0,0,0,0
2020-03-05,Santa Clara,085,1922200,164,14,1,15,0
2020-03-05,Santa Cruz,087,273765,13,0,0,0,0
2020-03-05,Shasta,089,179085,2,0,0,0,0
2020-03-05,Sierra,091,2930,0,0,0,0,0
2020-03-05,Siskiyou,093,43540,0,0,0,0,0
2020-03-05,Solano,095,438530,22,24,0,24,0
2020-03-05,Sonoma,097,501317,12,2,0,2,0
2020-03-05,Stanislaus,099,539301,4,0,2,2,0
2020-03-05,Sutter,101,95872,0,0,0,0,0
2020-03-05,Tehama,103,63373,0,0,0,0,0
2020-03-05,Trinity,105,12862,0,0,0,0,0
2020-03-05,Tulare,107,460477,6,0,0,0,0
2020-03-05,Tuolumne,109,53932,1,0,0,0,0
2020-03-05,Ventura,111,848112,13,0,0,0,0
2020-03-05,Yolo,113,214977,2,0,0,0,0
2020-03-05,Yuba,115,75493,0,0,0,0,0
2020-03-04,Alameda,001,1643700,30,2,0,2,0
2020-03-04,Alpine,003,1148,0,0,0,0,0
2020-03-04,Amador,005,37829,0,0,0,0,0
2020-03-04,Butte,007,227075,0,0,0,0,0
2020-03-04,Calaveras,009,45235,0,0,0,0,0
2020-03-04,Colusa,011,21464,0,0,0,0,0
2020-03-04,Contra Costa,013,1133247,34,1,0,1,0
2020-03-04,Del Norte,015,27424,0,0,0,0,0
2020-03-04,El Dorado,017,186661,1,0,0,0,0
2020-03-04,Fresno,019,978130,3,0,1,1,0
2020-03-04,Glenn,021,27897,0,0,0,0,0
2020-03-04,Humboldt,023,135768,1,1,0,1,0
2020-03-04,Imperial,025,180216,2,0,0,0,0
2020-03-04,Inyo,027,18085,0,0,0,0,0
2020-03-04,Kern,029,883053,6,0,0,0,0
2020-03-04,Kings,031,150075,3,0,1,1,0
2020-03-04,Lake,033,64148,0,0,0,0,0
2020-03-04,Lassen,035,31185,0,0,0,0,0
2020-03-04,Los Angeles,037,10098052,192,7,6,13,0
2020-03-04,Madera,039,155013,5,0,0,0,0
2020-03-04,Marin,041,260295,10,0,0,0,0
2020-03-04,Mariposa,043,17540,0,0,0,0,0
2020-03-04,Mendocino,045,87422,0,0,0,0,0
2020-03-04,Merced,047,269075,2,0,0,0,0
2020-03-04,Modoc,049,8938,0,0,0,0,0
2020-03-04,Mono,051,14174,1,0,0,0,0
2020-03-04,Monterey,053,433212,3,0,0,0,0
2020-03-04,Napa,055,140530,1,0,0,0,0
2020-03-04,Nevada,057,99092,0,0,1,1,0
2020-03-04,Orange,059,3164182,77,3,0,3,0
2020-03-04,Placer,061,380077,9,2,0,2,1
2020-03-04,Plumas,063,18699,0,0,0,0,0
2020-03-04,Riverside,065,2383286,23,0,1,1,0
2020-03-04,Sacramento,067,1510023,32,1,0,1,0
2020-03-04,San Benito,069,59416,1,2,0,2,0
2020-03-04,San Bernardino,071,2135413,32,0,0,0,0
2020-03-04,San Diego,073,3302833,41,2,0,2,0
2020-03-04,San Francisco,075,870044,26,0,0,0,0
2020-03-04,San Joaquin,077,732212,9,0,3,3,0
2020-03-04,San Luis Obispo,079,281455,4,0,0,0,0
2020-03-04,San Mateo,081,765935,60,1,0,1,0
2020-03-04,Santa Barbara,083,443738,2,0,0,0,0
2020-03-04,Santa Clara,085,1922200,147,12,1,13,0
2020-03-04,Santa Cruz,087,273765,13,0,0,0,0
2020-03-04,Shasta,089,179085,2,0,0,0,0
2020-03-04,Sierra,091,2930,0,0,0,0,0
2020-03-04,Siskiyou,093,43540,0,0,0,0,0
2020-03-04,Solano,095,438530,21,24,0,24,0
2020-03-04,Sonoma,097,501317,11,2,0,2,0
2020-03-04,Stanislaus,099,539301,4,0,2,2,0
2020-03-04,Sutter,101,95872,0,0,0,0,0
2020-03-04,Tehama,103,63373,0,0,0,0,0
2020-03-04,Trinity,105,12862,0,0,0,0,0
2020-03-04,Tulare,107,460477,6,0,0,0,0
2020-03-04,Tuolumne,109,53932,0,0,0,0,0
2020-03-04,Ventura,111,848112,12,0,0,0,0
2020-03-04,Yolo,113,214977,2,0,0,0,0
2020-03-04,Yuba,115,75493,0,0,0,0,0
2020-03-03,Alameda,001,1643700,24,2,0,2,0
2020-03-03,Alpine,003,1148,0,0,0,0,0
2020-03-03,Amador,005,37829,0,0,0,0,0
2020-03-03,Butte,007,227075,0,0,0,0,0
2020-03-03,Calaveras,009,45235,0,0,0,0,0
2020-03-03,Colusa,011,21464,0,0,0,0,0
2020-03-03,Contra Costa,013,1133247,30,0,0,0,0
2020-03-03,Del Norte,015,27424,0,0,0,0,0
2020-03-03,El Dorado,017,186661,1,0,0,0,0
2020-03-03,Fresno,019,978130,2,0,1,1,0
2020-03-03,Glenn,021,27897,0,0,0,0,0
2020-03-03,Humboldt,023,135768,1,1,0,1,0
2020-03-03,Imperial,025,180216,2,0,0,0,0
2020-03-03,Inyo,027,18085,0,0,0,0,0
2020-03-03,Kern,029,883053,4,0,0,0,0
2020-03-03,Kings,031,150075,3,0,1,1,0
2020-03-03,Lake,033,64148,0,0,0,0,0
2020-03-03,Lassen,035,31185,0,0,0,0,0
2020-03-03,Los Angeles,037,10098052,173,5,6,11,0
2020-03-03,Madera,039,155013,4,0,0,0,0
2020-03-03,Marin,041,260295,6,0,0,0,0
2020-03-03,Mariposa,043,17540,0,0,0,0,0
2020-03-03,Mendocino,045,87422,0,0,0,0,0
2020-03-03,Merced,047,269075,2,0,0,0,0
2020-03-03,Modoc,049,8938,0,0,0,0,0
2020-03-03,Mono,051,14174,1,0,0,0,0
2020-03-03,Monterey,053,433212,2,0,0,0,0
2020-03-03,Napa,055,140530,1,0,0,0,0
2020-03-03,Nevada,057,99092,0,0,1,1,0
2020-03-03,Orange,059,3164182,69,1,0,1,0
2020-03-03,Placer,061,380077,8,2,0,2,0
2020-03-03,Plumas,063,18699,0,0,0,0,0
2020-03-03,Riverside,065,2383286,20,0,1,1,0
2020-03-03,Sacramento,067,1510023,31,1,0,1,0
2020-03-03,San Benito,069,59416,1,2,0,2,0
2020-03-03,San Bernardino,071,2135413,29,0,0,0,0
2020-03-03,San Diego,073,3302833,34,2,0,2,0
2020-03-03,San Francisco,075,870044,24,0,0,0,0
2020-03-03,San Joaquin,077,732212,8,0,3,3,0
2020-03-03,San Luis Obispo,079,281455,2,0,0,0,0
2020-03-03,San Mateo,081,765935,53,1,0,1,0
2020-03-03,Santa Barbara,083,443738,1,0,0,0,0
2020-03-03,Santa Clara,085,1922200,132,11,1,12,0
2020-03-03,Santa Cruz,087,273765,10,0,0,0,0
2020-03-03,Shasta,089,179085,2,0,0,0,0
2020-03-03,Sierra,091,2930,0,0,0,0,0
2020-03-03,Siskiyou,093,43540,0,0,0,0,0
2020-03-03,Solano,095,438530,20,24,0,24,0
2020-03-03,Sonoma,097,501317,11,1,0,1,0
2020-03-03,Stanislaus,099,539301,4,0,2,2,0
2020-03-03,Sutter,101,95872,0,0,0,0,0
2020-03-03,Tehama,103,63373,0,0,0,0,0
2020-03-03,Trinity,105,12862,0,0,0,0,0
2020-03-03,Tulare,107,460477,6,0,0,0,0
2020-03-03,Tuolumne,109,53932,0,0,0,0,0
2020-03-03,Ventura,111,848112,11,0,0,0,0
2020-03-03,Yolo,113,214977,1,0,0,0,0
2020-03-03,Yuba,115,75493,0,0,0,0,0
2020-03-02,Alameda,001,1643700,21,1,0,1,0
2020-03-02,Alpine,003,1148,0,0,0,0,0
2020-03-02,Amador,005,37829,0,0,0,0,0
2020-03-02,Butte,007,227075,0,0,0,0,0
2020-03-02,Calaveras,009,45235,0,0,0,0,0
2020-03-02,Colusa,011,21464,0,0,0,0,0
2020-03-02,Contra Costa,013,1133247,27,0,0,0,0
2020-03-02,Del Norte,015,27424,0,0,0,0,0
2020-03-02,El Dorado,017,186661,1,0,0,0,0
2020-03-02,Fresno,019,978130,2,0,1,1,0
2020-03-02,Glenn,021,27897,0,0,0,0,0
2020-03-02,Humboldt,023,135768,1,1,0,1,0
2020-03-02,Imperial,025,180216,2,0,0,0,0
2020-03-02,Inyo,027,18085,0,0,0,0,0
2020-03-02,Kern,029,883053,4,0,0,0,0
2020-03-02,Kings,031,150075,3,0,1,1,0
2020-03-02,Lake,033,64148,0,0,0,0,0
2020-03-02,Lassen,035,31185,0,0,0,0,0
2020-03-02,Los Angeles,037,10098052,158,1,6,7,0
2020-03-02,Madera,039,155013,4,0,0,0,0
2020-03-02,Marin,041,260295,6,0,0,0,0
2020-03-02,Mariposa,043,17540,0,0,0,0,0
2020-03-02,Mendocino,045,87422,0,0,0,0,0
2020-03-02,Merced,047,269075,1,0,0,0,0
2020-03-02,Modoc,049,8938,0,0,0,0,0
2020-03-02,Mono,051,14174,1,0,0,0,0
2020-03-02,Monterey,053,433212,2,0,0,0,0
2020-03-02,Napa,055,140530,1,0,0,0,0
2020-03-02,Nevada,057,99092,0,0,1,1,0
2020-03-02,Orange,059,3164182,64,1,0,1,0
2020-03-02,Placer,061,380077,8,1,0,1,0
2020-03-02,Plumas,063,18699,0,0,0,0,0
2020-03-02,Riverside,065,2383286,19,0,1,1,0
2020-03-02,Sacramento,067,1510023,25,1,0,1,0
2020-03-02,San Benito,069,59416,1,2,0,2,0
2020-03-02,San Bernardino,071,2135413,29,0,0,0,0
2020-03-02,San Diego,073,3302833,28,2,0,2,0
2020-03-02,San Francisco,075,870044,17,0,0,0,0
2020-03-02,San Joaquin,077,732212,7,0,3,3,0
2020-03-02,San Luis Obispo,079,281455,2,0,0,0,0
2020-03-02,San Mateo,081,765935,44,1,0,1,0
2020-03-02,Santa Barbara,083,443738,1,0,0,0,0
2020-03-02,Santa Clara,085,1922200,110,7,1,8,0
2020-03-02,Santa Cruz,087,273765,9,0,0,0,0
2020-03-02,Shasta,089,179085,2,0,0,0,0
2020-03-02,Sierra,091,2930,0,0,0,0,0
2020-03-02,Siskiyou,093,43540,0,0,0,0,0
2020-03-02,Solano,095,438530,19,24,0,24,0
2020-03-02,Sonoma,097,501317,10,1,0,1,0
2020-03-02,Stanislaus,099,539301,2,0,2,2,0
2020-03-02,Sutter,101,95872,0,0,0,0,0
2020-03-02,Tehama,103,63373,0,0,0,0,0
2020-03-02,Trinity,105,12862,0,0,0,0,0
2020-03-02,Tulare,107,460477,6,0,0,0,0
2020-03-02,Tuolumne,109,53932,0,0,0,0,0
2020-03-02,Ventura,111,848112,10,0,0,0,0
2020-03-02,Yolo,113,214977,1,0,0,0,0
2020-03-02,Yuba,115,75493,0,0,0,0,0
2020-03-01,Alameda,001,1643700,20,1,0,1,0
2020-03-01,Alpine,003,1148,0,0,0,0,0
2020-03-01,Amador,005,37829,0,0,0,0,0
2020-03-01,Butte,007,227075,0,0,0,0,0
2020-03-01,Calaveras,009,45235,0,0,0,0,0
2020-03-01,Colusa,011,21464,0,0,0,0,0
2020-03-01,Contra Costa,013,1133247,24,0,0,0,0
2020-03-01,Del Norte,015,27424,0,0,0,0,0
2020-03-01,El Dorado,017,186661,1,0,0,0,0
2020-03-01,Fresno,019,978130,1,0,1,1,0
2020-03-01,Glenn,021,27897,0,0,0,0,0
2020-03-01,Humboldt,023,135768,1,1,0,1,0
2020-03-01,Imperial,025,180216,2,0,0,0,0
2020-03-01,Inyo,027,18085,0,0,0,0,0
2020-03-01,Kern,029,883053,2,0,0,0,0
2020-03-01,Kings,031,150075,3,0,1,1,0
2020-03-01,Lake,033,64148,0,0,0,0,0
2020-03-01,Lassen,035,31185,0,0,0,0,0
2020-03-01,Los Angeles,037,10098052,139,1,6,7,0
2020-03-01,Madera,039,155013,2,0,0,0,0
2020-03-01,Marin,041,260295,5,0,0,0,0
2020-03-01,Mariposa,043,17540,0,0,0,0,0
2020-03-01,Mendocino,045,87422,0,0,0,0,0
2020-03-01,Merced,047,269075,1,0,0,0,0
2020-03-01,Modoc,049,8938,0,0,0,0,0
2020-03-01,Mono,051,14174,1,0,0,0,0
2020-03-01,Monterey,053,433212,1,0,0,0,0
2020-03-01,Napa,055,140530,1,0,0,0,0
2020-03-01,Nevada,057,99092,0,0,1,1,0
2020-03-01,Orange,059,3164182,61,1,0,1,0
2020-03-01,Placer,061,380077,8,0,0,0,0
2020-03-01,Plumas,063,18699,0,0,0,0,0
2020-03-01,Riverside,065,2383286,18,0,1,1,0
2020-03-01,Sacramento,067,1510023,21,1,0,1,0
2020-03-01,San Benito,069,59416,0,2,0,2,0
2020-03-01,San Bernardino,071,2135413,27,0,0,0,0
2020-03-01,San Diego,073,3302833,21,2,0,2,0
2020-03-01,San Francisco,075,870044,13,0,0,0,0
2020-03-01,San Joaquin,077,732212,7,0,3,3,0
2020-03-01,San Luis Obispo,079,281455,2,0,0,0,0
2020-03-01,San Mateo,081,765935,36,0,0,0,0
2020-03-01,Santa Barbara,083,443738,1,0,0,0,0
2020-03-01,Santa Clara,085,1922200,97,6,1,7,0
2020-03-01,Santa Cruz,087,273765,8,0,0,0,0
2020-03-01,Shasta,089,179085,2,0,0,0,0
2020-03-01,Sierra,091,2930,0,0,0,0,0
2020-03-01,Siskiyou,093,43540,0,0,0,0,0
2020-03-01,Solano,095,438530,19,24,0,24,0
2020-03-01,Sonoma,097,501317,9,0,0,0,0
2020-03-01,Stanislaus,099,539301,2,0,2,2,0
2020-03-01,Sutter,101,95872,0,0,0,0,0
2020-03-01,Tehama,103,63373,0,0,0,0,0
2020-03-01,Trinity,105,12862,0,0,0,0,0
2020-03-01,Tulare,107,460477,6,0,0,0,0
2020-03-01,Tuolumne,109,53932,0,0,0,0,0
2020-03-01,Ventura,111,848112,8,0,0,0,0
2020-03-01,Yolo,113,214977,1,0,0,0,0
2020-03-01,Yuba,115,75493,0,0,0,0,0
2020-02-29,Alameda,001,1643700,16,0,0,0,0
2020-02-29,Alpine,003,1148,0,0,0,0,0
2020-02-29,Amador,005,37829,0,0,0,0,0
2020-02-29,Butte,007,227075,0,0,0,0,0
2020-02-29,Calaveras,009,45235,0,0,0,0,0
2020-02-29,Colusa,011,21464,0,0,0,0,0
2020-02-29,Contra Costa,013,1133247,20,0,0,0,0
2020-02-29,Del Norte,015,27424,0,0,0,0,0
2020-02-29,El Dorado,017,186661,1,0,0,0,0
2020-02-29,Fresno,019,978130,1,0,0,0,0
2020-02-29,Glenn,021,27897,0,0,0,0,0
2020-02-29,Humboldt,023,135768,1,1,0,1,0
2020-02-29,Imperial,025,180216,1,0,0,0,0
2020-02-29,Inyo,027,18085,0,0,0,0,0
2020-02-29,Kern,029,883053,2,0,0,0,0
2020-02-29,Kings,031,150075,3,0,1,1,0
2020-02-29,Lake,033,64148,0,0,0,0,0
2020-02-29,Lassen,035,31185,0,0,0,0,0
2020-02-29,Los Angeles,037,10098052,111,1,6,7,0
2020-02-29,Madera,039,155013,2,0,0,0,0
2020-02-29,Marin,041,260295,4,0,0,0,0
2020-02-29,Mariposa,043,17540,0,0,0,0,0
2020-02-29,Mendocino,045,87422,0,0,0,0,0
2020-02-29,Merced,047,269075,1,0,0,0,0
2020-02-29,Modoc,049,8938,0,0,0,0,0
2020-02-29,Mono,051,14174,1,0,0,0,0
2020-02-29,Monterey,053,433212,1,0,0,0,0
2020-02-29,Napa,055,140530,1,0,0,0,0
2020-02-29,Nevada,057,99092,0,0,1,1,0
2020-02-29,Orange,059,3164182,56,1,0,1,0
2020-02-29,Placer,061,380077,7,0,0,0,0
2020-02-29,Plumas,063,18699,0,0,0,0,0
2020-02-29,Riverside,065,2383286,15,0,1,1,0
2020-02-29,Sacramento,067,1510023,16,1,0,1,0
2020-02-29,San Benito,069,59416,0,2,0,2,0
2020-02-29,San Bernardino,071,2135413,25,0,0,0,0
2020-02-29,San Diego,073,3302833,16,2,0,2,0
2020-02-29,San Francisco,075,870044,12,0,0,0,0
2020-02-29,San Joaquin,077,732212,6,0,3,3,0
2020-02-29,San Luis Obispo,079,281455,2,0,0,0,0
2020-02-29,San Mateo,081,765935,29,0,0,0,0
2020-02-29,Santa Barbara,083,443738,0,0,0,0,0
2020-02-29,Santa Clara,085,1922200,75,3,1,4,0
2020-02-29,Santa Cruz,087,273765,8,0,0,0,0
2020-02-29,Shasta,089,179085,2,0,0,0,0
2020-02-29,Sierra,091,2930,0,0,0,0,0
2020-02-29,Siskiyou,093,43540,0,0,0,0,0
2020-02-29,Solano,095,438530,18,23,0,23,0
2020-02-29,Sonoma,097,501317,6,0,0,0,0
2020-02-29,Stanislaus,099,539301,2,0,2,2,0
2020-02-29,Sutter,101,95872,0,0,0,0,0
2020-02-29,Tehama,103,63373,0,0,0,0,0
2020-02-29,Trinity,105,12862,0,0,0,0,0
2020-02-29,Tulare,107,460477,4,0,0,0,0
2020-02-29,Tuolumne,109,53932,0,0,0,0,0
2020-02-29,Ventura,111,848112,6,0,0,0,0
2020-02-29,Yolo,113,214977,1,0,0,0,0
2020-02-29,Yuba,115,75493,0,0,0,0,0
2020-02-28,Alameda,001,1643700,14,0,0,0,0
2020-02-28,Alpine,003,1148,0,0,0,0,0
2020-02-28,Amador,005,37829,0,0,0,0,0
2020-02-28,Butte,007,227075,0,0,0,0,0
2020-02-28,Calaveras,009,45235,0,0,0,0,0
2020-02-28,Colusa,011,21464,0,0,0,0,0
2020-02-28,Contra Costa,013,1133247,20,0,0,0,0
2020-02-28,Del Norte,015,27424,0,0,0,0,0
2020-02-28,El Dorado,017,186661,0,0,0,0,0
2020-02-28,Fresno,019,978130,1,0,0,0,0
2020-02-28,Glenn,021,27897,0,0,0,0,0
2020-02-28,Humboldt,023,135768,1,1,0,1,0
2020-02-28,Imperial,025,180216,1,0,0,0,0
2020-02-28,Inyo,027,18085,0,0,0,0,0
2020-02-28,Kern,029,883053,2,0,0,0,0
2020-02-28,Kings,031,150075,3,0,1,1,0
2020-02-28,Lake,033,64148,0,0,0,0,0
2020-02-28,Lassen,035,31185,0,0,0,0,0
2020-02-28,Los Angeles,037,10098052,103,1,6,7,0
2020-02-28,Madera,039,155013,2,0,0,0,0
2020-02-28,Marin,041,260295,2,0,0,0,0
2020-02-28,Mariposa,043,17540,0,0,0,0,0
2020-02-28,Mendocino,045,87422,0,0,0,0,0
2020-02-28,Merced,047,269075,1,0,0,0,0
2020-02-28,Modoc,049,8938,0,0,0,0,0
2020-02-28,Mono,051,14174,0,0,0,0,0
2020-02-28,Monterey,053,433212,1,0,0,0,0
2020-02-28,Napa,055,140530,1,0,0,0,0
2020-02-28,Nevada,057,99092,0,0,1,1,0
2020-02-28,Orange,059,3164182,54,1,0,1,0
2020-02-28,Placer,061,380077,7,0,0,0,0
2020-02-28,Plumas,063,18699,0,0,0,0,0
2020-02-28,Riverside,065,2383286,13,0,1,1,0
2020-02-28,Sacramento,067,1510023,10,1,0,1,0
2020-02-28,San Benito,069,59416,0,2,0,2,0
2020-02-28,San Bernardino,071,2135413,25,0,0,0,0
2020-02-28,San Diego,073,3302833,13,2,0,2,0
2020-02-28,San Francisco,075,870044,10,0,0,0,0
2020-02-28,San Joaquin,077,732212,6,0,3,3,0
2020-02-28,San Luis Obispo,079,281455,2,0,0,0,0
2020-02-28,San Mateo,081,765935,24,0,0,0,0
2020-02-28,Santa Barbara,083,443738,0,0,0,0,0
2020-02-28,Santa Clara,085,1922200,70,3,1,4,0
2020-02-28,Santa Cruz,087,273765,8,0,0,0,0
2020-02-28,Shasta,089,179085,2,0,0,0,0
2020-02-28,Sierra,091,2930,0,0,0,0,0
2020-02-28,Siskiyou,093,43540,0,0,0,0,0
2020-02-28,Solano,095,438530,17,23,0,23,0
2020-02-28,Sonoma,097,501317,6,0,0,0,0
2020-02-28,Stanislaus,099,539301,2,0,2,2,0
2020-02-28,Sutter,101,95872,0,0,0,0,0
2020-02-28,Tehama,103,63373,0,0,0,0,0
2020-02-28,Trinity,105,12862,0,0,0,0,0
2020-02-28,Tulare,107,460477,3,0,0,0,0
2020-02-28,Tuolumne,109,53932,0,0,0,0,0
2020-02-28,Ventura,111,848112,6,0,0,0,0
2020-02-28,Yolo,113,214977,1,0,0,0,0
2020-02-28,Yuba,115,75493,0,0,0,0,0
2020-02-27,Alameda,001,1643700,13,0,0,0,0
2020-02-27,Alpine,003,1148,0,0,0,0,0
2020-02-27,Amador,005,37829,0,0,0,0,0
2020-02-27,Butte,007,227075,0,0,0,0,0
2020-02-27,Calaveras,009,45235,0,0,0,0,0
2020-02-27,Colusa,011,21464,0,0,0,0,0
2020-02-27,Contra Costa,013,1133247,14,0,0,0,0
2020-02-27,Del Norte,015,27424,0,0,0,0,0
2020-02-27,El Dorado,017,186661,0,0,0,0,0
2020-02-27,Fresno,019,978130,1,0,0,0,0
2020-02-27,Glenn,021,27897,0,0,0,0,0
2020-02-27,Humboldt,023,135768,1,1,0,1,0
2020-02-27,Imperial,025,180216,1,0,0,0,0
2020-02-27,Inyo,027,18085,0,0,0,0,0
2020-02-27,Kern,029,883053,2,0,0,0,0
2020-02-27,Kings,031,150075,3,0,1,1,0
2020-02-27,Lake,033,64148,0,0,0,0,0
2020-02-27,Lassen,035,31185,0,0,0,0,0
2020-02-27,Los Angeles,037,10098052,95,1,6,7,0
2020-02-27,Madera,039,155013,2,0,0,0,0
2020-02-27,Marin,041,260295,1,0,0,0,0
2020-02-27,Mariposa,043,17540,0,0,0,0,0
2020-02-27,Mendocino,045,87422,0,0,0,0,0
2020-02-27,Merced,047,269075,1,0,0,0,0
2020-02-27,Modoc,049,8938,0,0,0,0,0
2020-02-27,Mono,051,14174,0,0,0,0,0
2020-02-27,Monterey,053,433212,1,0,0,0,0
2020-02-27,Napa,055,140530,1,0,0,0,0
2020-02-27,Nevada,057,99092,0,0,1,1,0
2020-02-27,Orange,059,3164182,48,1,0,1,0
2020-02-27,Placer,061,380077,6,0,0,0,0
2020-02-27,Plumas,063,18699,0,0,0,0,0
2020-02-27,Riverside,065,2383286,12,0,1,1,0
2020-02-27,Sacramento,067,1510023,10,1,0,1,0
2020-02-27,San Benito,069,59416,0,2,0,2,0
2020-02-27,San Bernardino,071,2135413,25,0,0,0,0
2020-02-27,San Diego,073,3302833,12,2,0,2,0
2020-02-27,San Francisco,075,870044,9,0,0,0,0
2020-02-27,San Joaquin,077,732212,5,0,3,3,0
2020-02-27,San Luis Obispo,079,281455,2,0,0,0,0
2020-02-27,San Mateo,081,765935,20,0,0,0,0
2020-02-27,Santa Barbara,083,443738,0,0,0,0,0
2020-02-27,Santa Clara,085,1922200,59,2,1,3,0
2020-02-27,Santa Cruz,087,273765,6,0,0,0,0
2020-02-27,Shasta,089,179085,0,0,0,0,0
2020-02-27,Sierra,091,2930,0,0,0,0,0
2020-02-27,Siskiyou,093,43540,0,0,0,0,0
2020-02-27,Solano,095,438530,17,23,0,23,0
2020-02-27,Sonoma,097,501317,5,0,0,0,0
2020-02-27,Stanislaus,099,539301,2,0,2,2,0
2020-02-27,Sutter,101,95872,0,0,0,0,0
2020-02-27,Tehama,103,63373,0,0,0,0,0
2020-02-27,Trinity,105,12862,0,0,0,0,0
2020-02-27,Tulare,107,460477,3,0,0,0,0
2020-02-27,Tuolumne,109,53932,0,0,0,0,0
2020-02-27,Ventura,111,848112,4,0,0,0,0
2020-02-27,Yolo,113,214977,1,0,0,0,0
2020-02-27,Yuba,115,75493,0,0,0,0,0
2020-02-26,Alameda,001,1643700,13,0,0,0,0
2020-02-26,Alpine,003,1148,0,0,0,0,0
2020-02-26,Amador,005,37829,0,0,0,0,0
2020-02-26,Butte,007,227075,0,0,0,0,0
2020-02-26,Calaveras,009,45235,0,0,0,0,0
2020-02-26,Colusa,011,21464,0,0,0,0,0
2020-02-26,Contra Costa,013,1133247,13,0,0,0,0
2020-02-26,Del Norte,015,27424,0,0,0,0,0
2020-02-26,El Dorado,017,186661,0,0,0,0,0
2020-02-26,Fresno,019,978130,1,0,0,0,0
2020-02-26,Glenn,021,27897,0,0,0,0,0
2020-02-26,Humboldt,023,135768,1,1,0,1,0
2020-02-26,Imperial,025,180216,1,0,0,0,0
2020-02-26,Inyo,027,18085,0,0,0,0,0
2020-02-26,Kern,029,883053,2,0,0,0,0
2020-02-26,Kings,031,150075,3,0,1,1,0
2020-02-26,Lake,033,64148,0,0,0,0,0
2020-02-26,Lassen,035,31185,0,0,0,0,0
2020-02-26,Los Angeles,037,10098052,89,1,6,7,0
2020-02-26,Madera,039,155013,2,0,0,0,0
2020-02-26,Marin,041,260295,1,0,0,0,0
2020-02-26,Mariposa,043,17540,0,0,0,0,0
2020-02-26,Mendocino,045,87422,0,0,0,0,0
2020-02-26,Merced,047,269075,1,0,0,0,0
2020-02-26,Modoc,049,8938,0,0,0,0,0
2020-02-26,Mono,051,14174,0,0,0,0,0
2020-02-26,Monterey,053,433212,1,0,0,0,0
2020-02-26,Napa,055,140530,0,0,0,0,0
2020-02-26,Nevada,057,99092,0,0,1,1,0
2020-02-26,Orange,059,3164182,47,1,0,1,0
2020-02-26,Placer,061,380077,5,0,0,0,0
2020-02-26,Plumas,063,18699,0,0,0,0,0
2020-02-26,Riverside,065,2383286,10,0,1,1,0
2020-02-26,Sacramento,067,1510023,10,1,0,1,0
2020-02-26,San Benito,069,59416,0,2,0,2,0
2020-02-26,San Bernardino,071,2135413,23,0,0,0,0
2020-02-26,San Diego,073,3302833,11,2,0,2,0
2020-02-26,San Francisco,075,870044,9,0,0,0,0
2020-02-26,San Joaquin,077,732212,5,0,3,3,0
2020-02-26,San Luis Obispo,079,281455,2,0,0,0,0
2020-02-26,San Mateo,081,765935,18,0,0,0,0
2020-02-26,Santa Barbara,083,443738,0,0,0,0,0
2020-02-26,Santa Clara,085,1922200,50,2,1,3,0
2020-02-26,Santa Cruz,087,273765,6,0,0,0,0
2020-02-26,Shasta,089,179085,0,0,0,0,0
2020-02-26,Sierra,091,2930,0,0,0,0,0
2020-02-26,Siskiyou,093,43540,0,0,0,0,0
2020-02-26,Solano,095,438530,17,23,0,23,0
2020-02-26,Sonoma,097,501317,5,0,0,0,0
2020-02-26,Stanislaus,099,539301,2,0,2,2,0
2020-02-26,Sutter,101,95872,0,0,0,0,0
2020-02-26,Tehama,103,63373,0,0,0,0,0
2020-02-26,Trinity,105,12862,0,0,0,0,0
2020-02-26,Tulare,107,460477,3,0,0,0,0
2020-02-26,Tuolumne,109,53932,0,0,0,0,0
2020-02-26,Ventura,111,848112,4,0,0,0,0
2020-02-26,Yolo,113,214977,1,0,0,0,0
2020-02-26,Yuba,115,75493,0,0,0,0,0
2020-02-25,Alameda,001,1643700,13,0,0,0,0
2020-02-25,Alpine,003,1148,0,0,0,0,0
2020-02-25,Amador,005,37829,0,0,0,0,0
2020-02-25,Butte,007,227075,0,0,0,0,0
2020-02-25,Calaveras,009,45235,0,0,0,0,0
2020-02-25,Colusa,011,21464,0,0,0,0,0
2020-02-25,Contra Costa,013,1133247,11,0,0,0,0
2020-02-25,Del Norte,015,27424,0,0,0,0,0
2020-02-25,El Dorado,017,186661,0,0,0,0,0
2020-02-25,Fresno,019,978130,1,0,0,0,0
2020-02-25,Glenn,021,27897,0,0,0,0,0
2020-02-25,Humboldt,023,135768,1,1,0,1,0
2020-02-25,Imperial,025,180216,1,0,0,0,0
2020-02-25,Inyo,027,18085,0,0,0,0,0
2020-02-25,Kern,029,883053,2,0,0,0,0
2020-02-25,Kings,031,150075,3,0,1,1,0
2020-02-25,Lake,033,64148,0,0,0,0,0
2020-02-25,Lassen,035,31185,0,0,0,0,0
2020-02-25,Los Angeles,037,10098052,77,1,6,7,0
2020-02-25,Madera,039,155013,2,0,0,0,0
2020-02-25,Marin,041,260295,1,0,0,0,0
2020-02-25,Mariposa,043,17540,0,0,0,0,0
2020-02-25,Mendocino,045,87422,0,0,0,0,0
2020-02-25,Merced,047,269075,0,0,0,0,0
2020-02-25,Modoc,049,8938,0,0,0,0,0
2020-02-25,Mono,051,14174,0,0,0,0,0
2020-02-25,Monterey,053,433212,1,0,0,0,0
2020-02-25,Napa,055,140530,0,0,0,0,0
2020-02-25,Nevada,057,99092,0,0,1,1,0
2020-02-25,Orange,059,3164182,46,1,0,1,0
2020-02-25,Placer,061,380077,5,0,0,0,0
2020-02-25,Plumas,063,18699,0,0,0,0,0
2020-02-25,Riverside,065,2383286,10,0,1,1,0
2020-02-25,Sacramento,067,1510023,8,1,0,1,0
2020-02-25,San Benito,069,59416,0,2,0,2,0
2020-02-25,San Bernardino,071,2135413,21,0,0,0,0
2020-02-25,San Diego,073,3302833,7,2,0,2,0
2020-02-25,San Francisco,075,870044,7,0,0,0,0
2020-02-25,San Joaquin,077,732212,5,0,2,2,0
2020-02-25,San Luis Obispo,079,281455,2,0,0,0,0
2020-02-25,San Mateo,081,765935,17,0,0,0,0
2020-02-25,Santa Barbara,083,443738,0,0,0,0,0
2020-02-25,Santa Clara,085,1922200,40,2,1,3,0
2020-02-25,Santa Cruz,087,273765,5,0,0,0,0
2020-02-25,Shasta,089,179085,0,0,0,0,0
2020-02-25,Sierra,091,2930,0,0,0,0,0
2020-02-25,Siskiyou,093,43540,0,0,0,0,0
2020-02-25,Solano,095,438530,16,21,0,21,0
2020-02-25,Sonoma,097,501317,5,0,0,0,0
2020-02-25,Stanislaus,099,539301,2,0,2,2,0
2020-02-25,Sutter,101,95872,0,0,0,0,0
2020-02-25,Tehama,103,63373,0,0,0,0,0
2020-02-25,Trinity,105,12862,0,0,0,0,0
2020-02-25,Tulare,107,460477,3,0,0,0,0
2020-02-25,Tuolumne,109,53932,0,0,0,0,0
2020-02-25,Ventura,111,848112,4,0,0,0,0
2020-02-25,Yolo,113,214977,1,0,0,0,0
2020-02-25,Yuba,115,75493,0,0,0,0,0
2020-02-24,Alameda,001,1643700,13,0,0,0,0
2020-02-24,Alpine,003,1148,0,0,0,0,0
2020-02-24,Amador,005,37829,0,0,0,0,0
2020-02-24,Butte,007,227075,0,0,0,0,0
2020-02-24,Calaveras,009,45235,0,0,0,0,0
2020-02-24,Colusa,011,21464,0,0,0,0,0
2020-02-24,Contra Costa,013,1133247,9,0,0,0,0
2020-02-24,Del Norte,015,27424,0,0,0,0,0
2020-02-24,El Dorado,017,186661,0,0,0,0,0
2020-02-24,Fresno,019,978130,1,0,0,0,0
2020-02-24,Glenn,021,27897,0,0,0,0,0
2020-02-24,Humboldt,023,135768,1,1,0,1,0
2020-02-24,Imperial,025,180216,1,0,0,0,0
2020-02-24,Inyo,027,18085,0,0,0,0,0
2020-02-24,Kern,029,883053,2,0,0,0,0
2020-02-24,Kings,031,150075,3,0,1,1,0
2020-02-24,Lake,033,64148,0,0,0,0,0
2020-02-24,Lassen,035,31185,0,0,0,0,0
2020-02-24,Los Angeles,037,10098052,72,1,6,7,0
2020-02-24,Madera,039,155013,1,0,0,0,0
2020-02-24,Marin,041,260295,1,0,0,0,0
2020-02-24,Mariposa,043,17540,0,0,0,0,0
2020-02-24,Mendocino,045,87422,0,0,0,0,0
2020-02-24,Merced,047,269075,0,0,0,0,0
2020-02-24,Modoc,049,8938,0,0,0,0,0
2020-02-24,Mono,051,14174,0,0,0,0,0
2020-02-24,Monterey,053,433212,1,0,0,0,0
2020-02-24,Napa,055,140530,0,0,0,0,0
2020-02-24,Nevada,057,99092,0,0,1,1,0
2020-02-24,Orange,059,3164182,44,1,0,1,0
2020-02-24,Placer,061,380077,3,0,0,0,0
2020-02-24,Plumas,063,18699,0,0,0,0,0
2020-02-24,Riverside,065,2383286,9,0,1,1,0
2020-02-24,Sacramento,067,1510023,7,1,0,1,0
2020-02-24,San Benito,069,59416,0,2,0,2,0
2020-02-24,San Bernardino,071,2135413,21,0,0,0,0
2020-02-24,San Diego,073,3302833,7,2,0,2,0
2020-02-24,San Francisco,075,870044,6,0,0,0,0
2020-02-24,San Joaquin,077,732212,5,0,1,1,0
2020-02-24,San Luis Obispo,079,281455,2,0,0,0,0
2020-02-24,San Mateo,081,765935,13,0,0,0,0
2020-02-24,Santa Barbara,083,443738,0,0,0,0,0
2020-02-24,Santa Clara,085,1922200,38,2,1,3,0
2020-02-24,Santa Cruz,087,273765,5,0,0,0,0
2020-02-24,Shasta,089,179085,0,0,0,0,0
2020-02-24,Sierra,091,2930,0,0,0,0,0
2020-02-24,Siskiyou,093,43540,0,0,0,0,0
2020-02-24,Solano,095,438530,13,15,0,15,0
2020-02-24,Sonoma,097,501317,5,0,0,0,0
2020-02-24,Stanislaus,099,539301,2,0,2,2,0
2020-02-24,Sutter,101,95872,0,0,0,0,0
2020-02-24,Tehama,103,63373,0,0,0,0,0
2020-02-24,Trinity,105,12862,0,0,0,0,0
2020-02-24,Tulare,107,460477,3,0,0,0,0
2020-02-24,Tuolumne,109,53932,0,0,0,0,0
2020-02-24,Ventura,111,848112,4,0,0,0,0
2020-02-24,Yolo,113,214977,1,0,0,0,0
2020-02-24,Yuba,115,75493,0,0,0,0,0
2020-02-23,Alameda,001,1643700,11,0,0,0,0
2020-02-23,Alpine,003,1148,0,0,0,0,0
2020-02-23,Amador,005,37829,0,0,0,0,0
2020-02-23,Butte,007,227075,0,0,0,0,0
2020-02-23,Calaveras,009,45235,0,0,0,0,0
2020-02-23,Colusa,011,21464,0,0,0,0,0
2020-02-23,Contra Costa,013,1133247,6,0,0,0,0
2020-02-23,Del Norte,015,27424,0,0,0,0,0
2020-02-23,El Dorado,017,186661,0,0,0,0,0
2020-02-23,Fresno,019,978130,1,0,0,0,0
2020-02-23,Glenn,021,27897,0,0,0,0,0
2020-02-23,Humboldt,023,135768,1,1,0,1,0
2020-02-23,Imperial,025,180216,1,0,0,0,0
2020-02-23,Inyo,027,18085,0,0,0,0,0
2020-02-23,Kern,029,883053,2,0,0,0,0
2020-02-23,Kings,031,150075,3,0,1,1,0
2020-02-23,Lake,033,64148,0,0,0,0,0
2020-02-23,Lassen,035,31185,0,0,0,0,0
2020-02-23,Los Angeles,037,10098052,64,1,6,7,0
2020-02-23,Madera,039,155013,1,0,0,0,0
2020-02-23,Marin,041,260295,1,0,0,0,0
2020-02-23,Mariposa,043,17540,0,0,0,0,0
2020-02-23,Mendocino,045,87422,0,0,0,0,0
2020-02-23,Merced,047,269075,0,0,0,0,0
2020-02-23,Modoc,049,8938,0,0,0,0,0
2020-02-23,Mono,051,14174,0,0,0,0,0
2020-02-23,Monterey,053,433212,1,0,0,0,0
2020-02-23,Napa,055,140530,0,0,0,0,0
2020-02-23,Nevada,057,99092,0,0,1,1,0
2020-02-23,Orange,059,3164182,44,1,0,1,0
2020-02-23,Placer,061,380077,3,0,0,0,0
2020-02-23,Plumas,063,18699,0,0,0,0,0
2020-02-23,Riverside,065,2383286,9,0,0,0,0
2020-02-23,Sacramento,067,1510023,6,1,0,1,0
2020-02-23,San Benito,069,59416,0,2,0,2,0
2020-02-23,San Bernardino,071,2135413,20,0,0,0,0
2020-02-23,San Diego,073,3302833,6,2,0,2,0
2020-02-23,San Francisco,075,870044,5,0,0,0,0
2020-02-23,San Joaquin,077,732212,4,0,1,1,0
2020-02-23,San Luis Obispo,079,281455,2,0,0,0,0
2020-02-23,San Mateo,081,765935,10,0,0,0,0
2020-02-23,Santa Barbara,083,443738,0,0,0,0,0
2020-02-23,Santa Clara,085,1922200,26,2,1,3,0
2020-02-23,Santa Cruz,087,273765,2,0,0,0,0
2020-02-23,Shasta,089,179085,0,0,0,0,0
2020-02-23,Sierra,091,2930,0,0,0,0,0
2020-02-23,Siskiyou,093,43540,0,0,0,0,0
2020-02-23,Solano,095,438530,11,15,0,15,0
2020-02-23,Sonoma,097,501317,5,0,0,0,0
2020-02-23,Stanislaus,099,539301,2,0,2,2,0
2020-02-23,Sutter,101,95872,0,0,0,0,0
2020-02-23,Tehama,103,63373,0,0,0,0,0
2020-02-23,Trinity,105,12862,0,0,0,0,0
2020-02-23,Tulare,107,460477,2,0,0,0,0
2020-02-23,Tuolumne,109,53932,0,0,0,0,0
2020-02-23,Ventura,111,848112,4,0,0,0,0
2020-02-23,Yolo,113,214977,1,0,0,0,0
2020-02-23,Yuba,115,75493,0,0,0,0,0
2020-02-22,Alameda,001,1643700,10,0,0,0,0
2020-02-22,Alpine,003,1148,0,0,0,0,0
2020-02-22,Amador,005,37829,0,0,0,0,0
2020-02-22,Butte,007,227075,0,0,0,0,0
2020-02-22,Calaveras,009,45235,0,0,0,0,0
2020-02-22,Colusa,011,21464,0,0,0,0,0
2020-02-22,Contra Costa,013,1133247,5,0,0,0,0
2020-02-22,Del Norte,015,27424,0,0,0,0,0
2020-02-22,El Dorado,017,186661,0,0,0,0,0
2020-02-22,Fresno,019,978130,1,0,0,0,0
2020-02-22,Glenn,021,27897,0,0,0,0,0
2020-02-22,Humboldt,023,135768,1,1,0,1,0
2020-02-22,Imperial,025,180216,0,0,0,0,0
2020-02-22,Inyo,027,18085,0,0,0,0,0
2020-02-22,Kern,029,883053,2,0,0,0,0
2020-02-22,Kings,031,150075,3,0,1,1,0
2020-02-22,Lake,033,64148,0,0,0,0,0
2020-02-22,Lassen,035,31185,0,0,0,0,0
2020-02-22,Los Angeles,037,10098052,62,1,6,7,0
2020-02-22,Madera,039,155013,0,0,0,0,0
2020-02-22,Marin,041,260295,1,0,0,0,0
2020-02-22,Mariposa,043,17540,0,0,0,0,0
2020-02-22,Mendocino,045,87422,0,0,0,0,0
2020-02-22,Merced,047,269075,0,0,0,0,0
2020-02-22,Modoc,049,8938,0,0,0,0,0
2020-02-22,Mono,051,14174,0,0,0,0,0
2020-02-22,Monterey,053,433212,1,0,0,0,0
2020-02-22,Napa,055,140530,0,0,0,0,0
2020-02-22,Nevada,057,99092,0,0,1,1,0
2020-02-22,Orange,059,3164182,43,1,0,1,0
2020-02-22,Placer,061,380077,3,0,0,0,0
2020-02-22,Plumas,063,18699,0,0,0,0,0
2020-02-22,Riverside,065,2383286,9,0,0,0,0
2020-02-22,Sacramento,067,1510023,6,1,0,1,0
2020-02-22,San Benito,069,59416,0,2,0,2,0
2020-02-22,San Bernardino,071,2135413,18,0,0,0,0
2020-02-22,San Diego,073,3302833,5,2,0,2,0
2020-02-22,San Francisco,075,870044,3,0,0,0,0
2020-02-22,San Joaquin,077,732212,4,0,1,1,0
2020-02-22,San Luis Obispo,079,281455,2,0,0,0,0
2020-02-22,San Mateo,081,765935,8,0,0,0,0
2020-02-22,Santa Barbara,083,443738,0,0,0,0,0
2020-02-22,Santa Clara,085,1922200,23,2,1,3,0
2020-02-22,Santa Cruz,087,273765,2,0,0,0,0
2020-02-22,Shasta,089,179085,0,0,0,0,0
2020-02-22,Sierra,091,2930,0,0,0,0,0
2020-02-22,Siskiyou,093,43540,0,0,0,0,0
2020-02-22,Solano,095,438530,11,11,0,11,0
2020-02-22,Sonoma,097,501317,4,0,0,0,0
2020-02-22,Stanislaus,099,539301,2,0,2,2,0
2020-02-22,Sutter,101,95872,0,0,0,0,0
2020-02-22,Tehama,103,63373,0,0,0,0,0
2020-02-22,Trinity,105,12862,0,0,0,0,0
2020-02-22,Tulare,107,460477,2,0,0,0,0
2020-02-22,Tuolumne,109,53932,0,0,0,0,0
2020-02-22,Ventura,111,848112,4,0,0,0,0
2020-02-22,Yolo,113,214977,0,0,0,0,0
2020-02-22,Yuba,115,75493,0,0,0,0,0
2020-02-21,Alameda,001,1643700,9,0,0,0,0
2020-02-21,Alpine,003,1148,0,0,0,0,0
2020-02-21,Amador,005,37829,0,0,0,0,0
2020-02-21,Butte,007,227075,0,0,0,0,0
2020-02-21,Calaveras,009,45235,0,0,0,0,0
2020-02-21,Colusa,011,21464,0,0,0,0,0
2020-02-21,Contra Costa,013,1133247,4,0,0,0,0
2020-02-21,Del Norte,015,27424,0,0,0,0,0
2020-02-21,El Dorado,017,186661,0,0,0,0,0
2020-02-21,Fresno,019,978130,1,0,0,0,0
2020-02-21,Glenn,021,27897,0,0,0,0,0
2020-02-21,Humboldt,023,135768,1,1,0,1,0
2020-02-21,Imperial,025,180216,0,0,0,0,0
2020-02-21,Inyo,027,18085,0,0,0,0,0
2020-02-21,Kern,029,883053,2,0,0,0,0
2020-02-21,Kings,031,150075,3,0,1,1,0
2020-02-21,Lake,033,64148,0,0,0,0,0
2020-02-21,Lassen,035,31185,0,0,0,0,0
2020-02-21,Los Angeles,037,10098052,58,1,6,7,0
2020-02-21,Madera,039,155013,0,0,0,0,0
2020-02-21,Marin,041,260295,1,0,0,0,0
2020-02-21,Mariposa,043,17540,0,0,0,0,0
2020-02-21,Mendocino,045,87422,0,0,0,0,0
2020-02-21,Merced,047,269075,0,0,0,0,0
2020-02-21,Modoc,049,8938,0,0,0,0,0
2020-02-21,Mono,051,14174,0,0,0,0,0
2020-02-21,Monterey,053,433212,1,0,0,0,0
2020-02-21,Napa,055,140530,0,0,0,0,0
2020-02-21,Nevada,057,99092,0,0,1,1,0
2020-02-21,Orange,059,3164182,41,1,0,1,0
2020-02-21,Placer,061,380077,2,0,0,0,0
2020-02-21,Plumas,063,18699,0,0,0,0,0
2020-02-21,Riverside,065,2383286,9,0,0,0,0
2020-02-21,Sacramento,067,1510023,5,1,0,1,0
2020-02-21,San Benito,069,59416,0,2,0,2,0
2020-02-21,San Bernardino,071,2135413,17,0,0,0,0
2020-02-21,San Diego,073,3302833,5,2,0,2,0
2020-02-21,San Francisco,075,870044,3,0,0,0,0
2020-02-21,San Joaquin,077,732212,2,0,1,1,0
2020-02-21,San Luis Obispo,079,281455,2,0,0,0,0
2020-02-21,San Mateo,081,765935,8,0,0,0,0
2020-02-21,Santa Barbara,083,443738,0,0,0,0,0
2020-02-21,Santa Clara,085,1922200,21,2,1,3,0
2020-02-21,Santa Cruz,087,273765,2,0,0,0,0
2020-02-21,Shasta,089,179085,0,0,0,0,0
2020-02-21,Sierra,091,2930,0,0,0,0,0
2020-02-21,Siskiyou,093,43540,0,0,0,0,0
2020-02-21,Solano,095,438530,10,11,0,11,0
2020-02-21,Sonoma,097,501317,3,0,0,0,0
2020-02-21,Stanislaus,099,539301,2,0,2,2,0
2020-02-21,Sutter,101,95872,0,0,0,0,0
2020-02-21,Tehama,103,63373,0,0,0,0,0
2020-02-21,Trinity,105,12862,0,0,0,0,0
2020-02-21,Tulare,107,460477,2,0,0,0,0
2020-02-21,Tuolumne,109,53932,0,0,0,0,0
2020-02-21,Ventura,111,848112,4,0,0,0,0
2020-02-21,Yolo,113,214977,0,0,0,0,0
2020-02-21,Yuba,115,75493,0,0,0,0,0
2020-02-20,Alameda,001,1643700,7,0,0,0,0
2020-02-20,Alpine,003,1148,0,0,0,0,0
2020-02-20,Amador,005,37829,0,0,0,0,0
2020-02-20,Butte,007,227075,0,0,0,0,0
2020-02-20,Calaveras,009,45235,0,0,0,0,0
2020-02-20,Colusa,011,21464,0,0,0,0,0
2020-02-20,Contra Costa,013,1133247,3,0,0,0,0
2020-02-20,Del Norte,015,27424,0,0,0,0,0
2020-02-20,El Dorado,017,186661,0,0,0,0,0
2020-02-20,Fresno,019,978130,1,0,0,0,0
2020-02-20,Glenn,021,27897,0,0,0,0,0
2020-02-20,Humboldt,023,135768,1,1,0,1,0
2020-02-20,Imperial,025,180216,0,0,0,0,0
2020-02-20,Inyo,027,18085,0,0,0,0,0
2020-02-20,Kern,029,883053,2,0,0,0,0
2020-02-20,Kings,031,150075,3,0,1,1,0
2020-02-20,Lake,033,64148,0,0,0,0,0
2020-02-20,Lassen,035,31185,0,0,0,0,0
2020-02-20,Los Angeles,037,10098052,57,1,5,6,0
2020-02-20,Madera,039,155013,0,0,0,0,0
2020-02-20,Marin,041,260295,0,0,0,0,0
2020-02-20,Mariposa,043,17540,0,0,0,0,0
2020-02-20,Mendocino,045,87422,0,0,0,0,0
2020-02-20,Merced,047,269075,0,0,0,0,0
2020-02-20,Modoc,049,8938,0,0,0,0,0
2020-02-20,Mono,051,14174,0,0,0,0,0
2020-02-20,Monterey,053,433212,1,0,0,0,0
2020-02-20,Napa,055,140530,0,0,0,0,0
2020-02-20,Nevada,057,99092,0,0,1,1,0
2020-02-20,Orange,059,3164182,41,1,0,1,0
2020-02-20,Placer,061,380077,2,0,0,0,0
2020-02-20,Plumas,063,18699,0,0,0,0,0
2020-02-20,Riverside,065,2383286,7,0,0,0,0
2020-02-20,Sacramento,067,1510023,2,1,0,1,0
2020-02-20,San Benito,069,59416,0,2,0,2,0
2020-02-20,San Bernardino,071,2135413,15,0,0,0,0
2020-02-20,San Diego,073,3302833,5,2,0,2,0
2020-02-20,San Francisco,075,870044,3,0,0,0,0
2020-02-20,San Joaquin,077,732212,2,0,1,1,0
2020-02-20,San Luis Obispo,079,281455,2,0,0,0,0
2020-02-20,San Mateo,081,765935,7,0,0,0,0
2020-02-20,Santa Barbara,083,443738,0,0,0,0,0
2020-02-20,Santa Clara,085,1922200,17,2,1,3,0
2020-02-20,Santa Cruz,087,273765,2,0,0,0,0
2020-02-20,Shasta,089,179085,0,0,0,0,0
2020-02-20,Sierra,091,2930,0,0,0,0,0
2020-02-20,Siskiyou,093,43540,0,0,0,0,0
2020-02-20,Solano,095,438530,8,7,0,7,0
2020-02-20,Sonoma,097,501317,2,0,0,0,0
2020-02-20,Stanislaus,099,539301,2,0,2,2,0
2020-02-20,Sutter,101,95872,0,0,0,0,0
2020-02-20,Tehama,103,63373,0,0,0,0,0
2020-02-20,Trinity,105,12862,0,0,0,0,0
2020-02-20,Tulare,107,460477,2,0,0,0,0
2020-02-20,Tuolumne,109,53932,0,0,0,0,0
2020-02-20,Ventura,111,848112,4,0,0,0,0
2020-02-20,Yolo,113,214977,0,0,0,0,0
2020-02-20,Yuba,115,75493,0,0,0,0,0
2020-02-19,Alameda,001,1643700,6,0,0,0,0
2020-02-19,Alpine,003,1148,0,0,0,0,0
2020-02-19,Amador,005,37829,0,0,0,0,0
2020-02-19,Butte,007,227075,0,0,0,0,0
2020-02-19,Calaveras,009,45235,0,0,0,0,0
2020-02-19,Colusa,011,21464,0,0,0,0,0
2020-02-19,Contra Costa,013,1133247,3,0,0,0,0
2020-02-19,Del Norte,015,27424,0,0,0,0,0
2020-02-19,El Dorado,017,186661,0,0,0,0,0
2020-02-19,Fresno,019,978130,1,0,0,0,0
2020-02-19,Glenn,021,27897,0,0,0,0,0
2020-02-19,Humboldt,023,135768,1,0,0,0,0
2020-02-19,Imperial,025,180216,0,0,0,0,0
2020-02-19,Inyo,027,18085,0,0,0,0,0
2020-02-19,Kern,029,883053,2,0,0,0,0
2020-02-19,Kings,031,150075,3,0,1,1,0
2020-02-19,Lake,033,64148,0,0,0,0,0
2020-02-19,Lassen,035,31185,0,0,0,0,0
2020-02-19,Los Angeles,037,10098052,54,1,5,6,0
2020-02-19,Madera,039,155013,0,0,0,0,0
2020-02-19,Marin,041,260295,0,0,0,0,0
2020-02-19,Mariposa,043,17540,0,0,0,0,0
2020-02-19,Mendocino,045,87422,0,0,0,0,0
2020-02-19,Merced,047,269075,0,0,0,0,0
2020-02-19,Modoc,049,8938,0,0,0,0,0
2020-02-19,Mono,051,14174,0,0,0,0,0
2020-02-19,Monterey,053,433212,1,0,0,0,0
2020-02-19,Napa,055,140530,0,0,0,0,0
2020-02-19,Nevada,057,99092,0,0,1,1,0
2020-02-19,Orange,059,3164182,40,1,0,1,0
2020-02-19,Placer,061,380077,2,0,0,0,0
2020-02-19,Plumas,063,18699,0,0,0,0,0
2020-02-19,Riverside,065,2383286,5,0,0,0,0
2020-02-19,Sacramento,067,1510023,2,0,0,0,0
2020-02-19,San Benito,069,59416,0,2,0,2,0
2020-02-19,San Bernardino,071,2135413,14,0,0,0,0
2020-02-19,San Diego,073,3302833,4,2,0,2,0
2020-02-19,San Francisco,075,870044,2,0,0,0,0
2020-02-19,San Joaquin,077,732212,2,0,1,1,0
2020-02-19,San Luis Obispo,079,281455,2,0,0,0,0
2020-02-19,San Mateo,081,765935,6,0,0,0,0
2020-02-19,Santa Barbara,083,443738,0,0,0,0,0
2020-02-19,Santa Clara,085,1922200,15,2,1,3,0
2020-02-19,Santa Cruz,087,273765,0,0,0,0,0
2020-02-19,Shasta,089,179085,0,0,0,0,0
2020-02-19,Sierra,091,2930,0,0,0,0,0
2020-02-19,Siskiyou,093,43540,0,0,0,0,0
2020-02-19,Solano,095,438530,5,7,0,7,0
2020-02-19,Sonoma,097,501317,2,0,0,0,0
2020-02-19,Stanislaus,099,539301,1,0,2,2,0
2020-02-19,Sutter,101,95872,0,0,0,0,0
2020-02-19,Tehama,103,63373,0,0,0,0,0
2020-02-19,Trinity,105,12862,0,0,0,0,0
2020-02-19,Tulare,107,460477,2,0,0,0,0
2020-02-19,Tuolumne,109,53932,0,0,0,0,0
2020-02-19,Ventura,111,848112,2,0,0,0,0
2020-02-19,Yolo,113,214977,0,0,0,0,0
2020-02-19,Yuba,115,75493,0,0,0,0,0
2020-02-18,Alameda,001,1643700,6,0,0,0,0
2020-02-18,Alpine,003,1148,0,0,0,0,0
2020-02-18,Amador,005,37829,0,0,0,0,0
2020-02-18,Butte,007,227075,0,0,0,0,0
2020-02-18,Calaveras,009,45235,0,0,0,0,0
2020-02-18,Colusa,011,21464,0,0,0,0,0
2020-02-18,Contra Costa,013,1133247,3,0,0,0,0
2020-02-18,Del Norte,015,27424,0,0,0,0,0
2020-02-18,El Dorado,017,186661,0,0,0,0,0
2020-02-18,Fresno,019,978130,0,0,0,0,0
2020-02-18,Glenn,021,27897,0,0,0,0,0
2020-02-18,Humboldt,023,135768,1,0,0,0,0
2020-02-18,Imperial,025,180216,0,0,0,0,0
2020-02-18,Inyo,027,18085,0,0,0,0,0
2020-02-18,Kern,029,883053,2,0,0,0,0
2020-02-18,Kings,031,150075,3,0,1,1,0
2020-02-18,Lake,033,64148,0,0,0,0,0
2020-02-18,Lassen,035,31185,0,0,0,0,0
2020-02-18,Los Angeles,037,10098052,51,1,4,5,0
2020-02-18,Madera,039,155013,0,0,0,0,0
2020-02-18,Marin,041,260295,0,0,0,0,0
2020-02-18,Mariposa,043,17540,0,0,0,0,0
2020-02-18,Mendocino,045,87422,0,0,0,0,0
2020-02-18,Merced,047,269075,0,0,0,0,0
2020-02-18,Modoc,049,8938,0,0,0,0,0
2020-02-18,Mono,051,14174,0,0,0,0,0
2020-02-18,Monterey,053,433212,1,0,0,0,0
2020-02-18,Napa,055,140530,0,0,0,0,0
2020-02-18,Nevada,057,99092,0,0,1,1,0
2020-02-18,Orange,059,3164182,39,1,0,1,0
2020-02-18,Placer,061,380077,0,0,0,0,0
2020-02-18,Plumas,063,18699,0,0,0,0,0
2020-02-18,Riverside,065,2383286,5,0,0,0,0
2020-02-18,Sacramento,067,1510023,2,0,0,0,0
2020-02-18,San Benito,069,59416,0,2,0,2,0
2020-02-18,San Bernardino,071,2135413,13,0,0,0,0
2020-02-18,San Diego,073,3302833,4,2,0,2,0
2020-02-18,San Francisco,075,870044,2,0,0,0,0
2020-02-18,San Joaquin,077,732212,1,0,1,1,0
2020-02-18,San Luis Obispo,079,281455,2,0,0,0,0
2020-02-18,San Mateo,081,765935,5,0,0,0,0
2020-02-18,Santa Barbara,083,443738,0,0,0,0,0
2020-02-18,Santa Clara,085,1922200,14,2,1,3,0
2020-02-18,Santa Cruz,087,273765,0,0,0,0,0
2020-02-18,Shasta,089,179085,0,0,0,0,0
2020-02-18,Sierra,091,2930,0,0,0,0,0
2020-02-18,Siskiyou,093,43540,0,0,0,0,0
2020-02-18,Solano,095,438530,5,7,0,7,0
2020-02-18,Sonoma,097,501317,1,0,0,0,0
2020-02-18,Stanislaus,099,539301,1,0,2,2,0
2020-02-18,Sutter,101,95872,0,0,0,0,0
2020-02-18,Tehama,103,63373,0,0,0,0,0
2020-02-18,Trinity,105,12862,0,0,0,0,0
2020-02-18,Tulare,107,460477,2,0,0,0,0
2020-02-18,Tuolumne,109,53932,0,0,0,0,0
2020-02-18,Ventura,111,848112,2,0,0,0,0
2020-02-18,Yolo,113,214977,0,0,0,0,0
2020-02-18,Yuba,115,75493,0,0,0,0,0
2020-02-17,Alameda,001,1643700,6,0,0,0,0
2020-02-17,Alpine,003,1148,0,0,0,0,0
2020-02-17,Amador,005,37829,0,0,0,0,0
2020-02-17,Butte,007,227075,0,0,0,0,0
2020-02-17,Calaveras,009,45235,0,0,0,0,0
2020-02-17,Colusa,011,21464,0,0,0,0,0
2020-02-17,Contra Costa,013,1133247,3,0,0,0,0
2020-02-17,Del Norte,015,27424,0,0,0,0,0
2020-02-17,El Dorado,017,186661,0,0,0,0,0
2020-02-17,Fresno,019,978130,0,0,0,0,0
2020-02-17,Glenn,021,27897,0,0,0,0,0
2020-02-17,Humboldt,023,135768,1,0,0,0,0
2020-02-17,Imperial,025,180216,0,0,0,0,0
2020-02-17,Inyo,027,18085,0,0,0,0,0
2020-02-17,Kern,029,883053,2,0,0,0,0
2020-02-17,Kings,031,150075,3,0,0,0,0
2020-02-17,Lake,033,64148,0,0,0,0,0
2020-02-17,Lassen,035,31185,0,0,0,0,0
2020-02-17,Los Angeles,037,10098052,48,1,4,5,0
2020-02-17,Madera,039,155013,0,0,0,0,0
2020-02-17,Marin,041,260295,0,0,0,0,0
2020-02-17,Mariposa,043,17540,0,0,0,0,0
2020-02-17,Mendocino,045,87422,0,0,0,0,0
2020-02-17,Merced,047,269075,0,0,0,0,0
2020-02-17,Modoc,049,8938,0,0,0,0,0
2020-02-17,Mono,051,14174,0,0,0,0,0
2020-02-17,Monterey,053,433212,1,0,0,0,0
2020-02-17,Napa,055,140530,0,0,0,0,0
2020-02-17,Nevada,057,99092,0,0,1,1,0
2020-02-17,Orange,059,3164182,39,1,0,1,0
2020-02-17,Placer,061,380077,0,0,0,0,0
2020-02-17,Plumas,063,18699,0,0,0,0,0
2020-02-17,Riverside,065,2383286,5,0,0,0,0
2020-02-17,Sacramento,067,1510023,2,0,0,0,0
2020-02-17,San Benito,069,59416,0,2,0,2,0
2020-02-17,San Bernardino,071,2135413,11,0,0,0,0
2020-02-17,San Diego,073,3302833,4,2,0,2,0
2020-02-17,San Francisco,075,870044,2,0,0,0,0
2020-02-17,San Joaquin,077,732212,1,0,1,1,0
2020-02-17,San Luis Obispo,079,281455,1,0,0,0,0
2020-02-17,San Mateo,081,765935,5,0,0,0,0
2020-02-17,Santa Barbara,083,443738,0,0,0,0,0
2020-02-17,Santa Clara,085,1922200,12,2,1,3,0
2020-02-17,Santa Cruz,087,273765,0,0,0,0,0
2020-02-17,Shasta,089,179085,0,0,0,0,0
2020-02-17,Sierra,091,2930,0,0,0,0,0
2020-02-17,Siskiyou,093,43540,0,0,0,0,0
2020-02-17,Solano,095,438530,3,5,0,5,0
2020-02-17,Sonoma,097,501317,1,0,0,0,0
2020-02-17,Stanislaus,099,539301,1,0,2,2,0
2020-02-17,Sutter,101,95872,0,0,0,0,0
2020-02-17,Tehama,103,63373,0,0,0,0,0
2020-02-17,Trinity,105,12862,0,0,0,0,0
2020-02-17,Tulare,107,460477,2,0,0,0,0
2020-02-17,Tuolumne,109,53932,0,0,0,0,0
2020-02-17,Ventura,111,848112,2,0,0,0,0
2020-02-17,Yolo,113,214977,0,0,0,0,0
2020-02-17,Yuba,115,75493,0,0,0,0,0
2020-02-16,Alameda,001,1643700,5,0,0,0,0
2020-02-16,Alpine,003,1148,0,0,0,0,0
2020-02-16,Amador,005,37829,0,0,0,0,0
2020-02-16,Butte,007,227075,0,0,0,0,0
2020-02-16,Calaveras,009,45235,0,0,0,0,0
2020-02-16,Colusa,011,21464,0,0,0,0,0
2020-02-16,Contra Costa,013,1133247,3,0,0,0,0
2020-02-16,Del Norte,015,27424,0,0,0,0,0
2020-02-16,El Dorado,017,186661,0,0,0,0,0
2020-02-16,Fresno,019,978130,0,0,0,0,0
2020-02-16,Glenn,021,27897,0,0,0,0,0
2020-02-16,Humboldt,023,135768,1,0,0,0,0
2020-02-16,Imperial,025,180216,0,0,0,0,0
2020-02-16,Inyo,027,18085,0,0,0,0,0
2020-02-16,Kern,029,883053,2,0,0,0,0
2020-02-16,Kings,031,150075,3,0,0,0,0
2020-02-16,Lake,033,64148,0,0,0,0,0
2020-02-16,Lassen,035,31185,0,0,0,0,0
2020-02-16,Los Angeles,037,10098052,42,1,4,5,0
2020-02-16,Madera,039,155013,0,0,0,0,0
2020-02-16,Marin,041,260295,0,0,0,0,0
2020-02-16,Mariposa,043,17540,0,0,0,0,0
2020-02-16,Mendocino,045,87422,0,0,0,0,0
2020-02-16,Merced,047,269075,0,0,0,0,0
2020-02-16,Modoc,049,8938,0,0,0,0,0
2020-02-16,Mono,051,14174,0,0,0,0,0
2020-02-16,Monterey,053,433212,1,0,0,0,0
2020-02-16,Napa,055,140530,0,0,0,0,0
2020-02-16,Nevada,057,99092,0,0,0,0,0
2020-02-16,Orange,059,3164182,38,1,0,1,0
2020-02-16,Placer,061,380077,0,0,0,0,0
2020-02-16,Plumas,063,18699,0,0,0,0,0
2020-02-16,Riverside,065,2383286,5,0,0,0,0
2020-02-16,Sacramento,067,1510023,2,0,0,0,0
2020-02-16,San Benito,069,59416,0,2,0,2,0
2020-02-16,San Bernardino,071,2135413,10,0,0,0,0
2020-02-16,San Diego,073,3302833,4,2,0,2,0
2020-02-16,San Francisco,075,870044,2,0,0,0,0
2020-02-16,San Joaquin,077,732212,1,0,1,1,0
2020-02-16,San Luis Obispo,079,281455,1,0,0,0,0
2020-02-16,San Mateo,081,765935,4,0,0,0,0
2020-02-16,Santa Barbara,083,443738,0,0,0,0,0
2020-02-16,Santa Clara,085,1922200,10,2,1,3,0
2020-02-16,Santa Cruz,087,273765,0,0,0,0,0
2020-02-16,Shasta,089,179085,0,0,0,0,0
2020-02-16,Sierra,091,2930,0,0,0,0,0
2020-02-16,Siskiyou,093,43540,0,0,0,0,0
2020-02-16,Solano,095,438530,1,0,0,0,0
2020-02-16,Sonoma,097,501317,1,0,0,0,0
2020-02-16,Stanislaus,099,539301,1,0,2,2,0
2020-02-16,Sutter,101,95872,0,0,0,0,0
2020-02-16,Tehama,103,63373,0,0,0,0,0
2020-02-16,Trinity,105,12862,0,0,0,0,0
2020-02-16,Tulare,107,460477,2,0,0,0,0
2020-02-16,Tuolumne,109,53932,0,0,0,0,0
2020-02-16,Ventura,111,848112,2,0,0,0,0
2020-02-16,Yolo,113,214977,0,0,0,0,0
2020-02-16,Yuba,115,75493,0,0,0,0,0
2020-02-15,Alameda,001,1643700,5,0,0,0,0
2020-02-15,Alpine,003,1148,0,0,0,0,0
2020-02-15,Amador,005,37829,0,0,0,0,0
2020-02-15,Butte,007,227075,0,0,0,0,0
2020-02-15,Calaveras,009,45235,0,0,0,0,0
2020-02-15,Colusa,011,21464,0,0,0,0,0
2020-02-15,Contra Costa,013,1133247,3,0,0,0,0
2020-02-15,Del Norte,015,27424,0,0,0,0,0
2020-02-15,El Dorado,017,186661,0,0,0,0,0
2020-02-15,Fresno,019,978130,0,0,0,0,0
2020-02-15,Glenn,021,27897,0,0,0,0,0
2020-02-15,Humboldt,023,135768,1,0,0,0,0
2020-02-15,Imperial,025,180216,0,0,0,0,0
2020-02-15,Inyo,027,18085,0,0,0,0,0
2020-02-15,Kern,029,883053,2,0,0,0,0
2020-02-15,Kings,031,150075,3,0,0,0,0
2020-02-15,Lake,033,64148,0,0,0,0,0
2020-02-15,Lassen,035,31185,0,0,0,0,0
2020-02-15,Los Angeles,037,10098052,39,1,4,5,0
2020-02-15,Madera,039,155013,0,0,0,0,0
2020-02-15,Marin,041,260295,0,0,0,0,0
2020-02-15,Mariposa,043,17540,0,0,0,0,0
2020-02-15,Mendocino,045,87422,0,0,0,0,0
2020-02-15,Merced,047,269075,0,0,0,0,0
2020-02-15,Modoc,049,8938,0,0,0,0,0
2020-02-15,Mono,051,14174,0,0,0,0,0
2020-02-15,Monterey,053,433212,1,0,0,0,0
2020-02-15,Napa,055,140530,0,0,0,0,0
2020-02-15,Nevada,057,99092,0,0,0,0,0
2020-02-15,Orange,059,3164182,37,1,0,1,0
2020-02-15,Placer,061,380077,0,0,0,0,0
2020-02-15,Plumas,063,18699,0,0,0,0,0
2020-02-15,Riverside,065,2383286,4,0,0,0,0
2020-02-15,Sacramento,067,1510023,2,0,0,0,0
2020-02-15,San Benito,069,59416,0,2,0,2,0
2020-02-15,San Bernardino,071,2135413,9,0,0,0,0
2020-02-15,San Diego,073,3302833,4,2,0,2,0
2020-02-15,San Francisco,075,870044,2,0,0,0,0
2020-02-15,San Joaquin,077,732212,1,0,1,1,0
2020-02-15,San Luis Obispo,079,281455,1,0,0,0,0
2020-02-15,San Mateo,081,765935,4,0,0,0,0
2020-02-15,Santa Barbara,083,443738,0,0,0,0,0
2020-02-15,Santa Clara,085,1922200,10,2,1,3,0
2020-02-15,Santa Cruz,087,273765,0,0,0,0,0
2020-02-15,Shasta,089,179085,0,0,0,0,0
2020-02-15,Sierra,091,2930,0,0,0,0,0
2020-02-15,Siskiyou,093,43540,0,0,0,0,0
2020-02-15,Solano,095,438530,1,0,0,0,0
2020-02-15,Sonoma,097,501317,0,0,0,0,0
2020-02-15,Stanislaus,099,539301,1,0,2,2,0
2020-02-15,Sutter,101,95872,0,0,0,0,0
2020-02-15,Tehama,103,63373,0,0,0,0,0
2020-02-15,Trinity,105,12862,0,0,0,0,0
2020-02-15,Tulare,107,460477,2,0,0,0,0
2020-02-15,Tuolumne,109,53932,0,0,0,0,0
2020-02-15,Ventura,111,848112,2,0,0,0,0
2020-02-15,Yolo,113,214977,0,0,0,0,0
2020-02-15,Yuba,115,75493,0,0,0,0,0
2020-02-14,Alameda,001,1643700,4,0,0,0,0
2020-02-14,Alpine,003,1148,0,0,0,0,0
2020-02-14,Amador,005,37829,0,0,0,0,0
2020-02-14,Butte,007,227075,0,0,0,0,0
2020-02-14,Calaveras,009,45235,0,0,0,0,0
2020-02-14,Colusa,011,21464,0,0,0,0,0
2020-02-14,Contra Costa,013,1133247,3,0,0,0,0
2020-02-14,Del Norte,015,27424,0,0,0,0,0
2020-02-14,El Dorado,017,186661,0,0,0,0,0
2020-02-14,Fresno,019,978130,0,0,0,0,0
2020-02-14,Glenn,021,27897,0,0,0,0,0
2020-02-14,Humboldt,023,135768,1,0,0,0,0
2020-02-14,Imperial,025,180216,0,0,0,0,0
2020-02-14,Inyo,027,18085,0,0,0,0,0
2020-02-14,Kern,029,883053,2,0,0,0,0
2020-02-14,Kings,031,150075,1,0,0,0,0
2020-02-14,Lake,033,64148,0,0,0,0,0
2020-02-14,Lassen,035,31185,0,0,0,0,0
2020-02-14,Los Angeles,037,10098052,34,1,4,5,0
2020-02-14,Madera,039,155013,0,0,0,0,0
2020-02-14,Marin,041,260295,0,0,0,0,0
2020-02-14,Mariposa,043,17540,0,0,0,0,0
2020-02-14,Mendocino,045,87422,0,0,0,0,0
2020-02-14,Merced,047,269075,0,0,0,0,0
2020-02-14,Modoc,049,8938,0,0,0,0,0
2020-02-14,Mono,051,14174,0,0,0,0,0
2020-02-14,Monterey,053,433212,1,0,0,0,0
2020-02-14,Napa,055,140530,0,0,0,0,0
2020-02-14,Nevada,057,99092,0,0,0,0,0
2020-02-14,Orange,059,3164182,37,1,0,1,0
2020-02-14,Placer,061,380077,0,0,0,0,0
2020-02-14,Plumas,063,18699,0,0,0,0,0
2020-02-14,Riverside,065,2383286,4,0,0,0,0
2020-02-14,Sacramento,067,1510023,1,0,0,0,0
2020-02-14,San Benito,069,59416,0,2,0,2,0
2020-02-14,San Bernardino,071,2135413,9,0,0,0,0
2020-02-14,San Diego,073,3302833,3,2,0,2,0
2020-02-14,San Francisco,075,870044,2,0,0,0,0
2020-02-14,San Joaquin,077,732212,1,0,1,1,0
2020-02-14,San Luis Obispo,079,281455,0,0,0,0,0
2020-02-14,San Mateo,081,765935,3,0,0,0,0
2020-02-14,Santa Barbara,083,443738,0,0,0,0,0
2020-02-14,Santa Clara,085,1922200,8,2,1,3,0
2020-02-14,Santa Cruz,087,273765,0,0,0,0,0
2020-02-14,Shasta,089,179085,0,0,0,0,0
2020-02-14,Sierra,091,2930,0,0,0,0,0
2020-02-14,Siskiyou,093,43540,0,0,0,0,0
2020-02-14,Solano,095,438530,1,0,0,0,0
2020-02-14,Sonoma,097,501317,0,0,0,0,0
2020-02-14,Stanislaus,099,539301,1,0,2,2,0
2020-02-14,Sutter,101,95872,0,0,0,0,0
2020-02-14,Tehama,103,63373,0,0,0,0,0
2020-02-14,Trinity,105,12862,0,0,0,0,0
2020-02-14,Tulare,107,460477,2,0,0,0,0
2020-02-14,Tuolumne,109,53932,0,0,0,0,0
2020-02-14,Ventura,111,848112,2,0,0,0,0
2020-02-14,Yolo,113,214977,0,0,0,0,0
2020-02-14,Yuba,115,75493,0,0,0,0,0
2020-02-13,Alameda,001,1643700,4,0,0,0,0
2020-02-13,Alpine,003,1148,0,0,0,0,0
2020-02-13,Amador,005,37829,0,0,0,0,0
2020-02-13,Butte,007,227075,0,0,0,0,0
2020-02-13,Calaveras,009,45235,0,0,0,0,0
2020-02-13,Colusa,011,21464,0,0,0,0,0
2020-02-13,Contra Costa,013,1133247,3,0,0,0,0
2020-02-13,Del Norte,015,27424,0,0,0,0,0
2020-02-13,El Dorado,017,186661,0,0,0,0,0
2020-02-13,Fresno,019,978130,0,0,0,0,0
2020-02-13,Glenn,021,27897,0,0,0,0,0
2020-02-13,Humboldt,023,135768,1,0,0,0,0
2020-02-13,Imperial,025,180216,0,0,0,0,0
2020-02-13,Inyo,027,18085,0,0,0,0,0
2020-02-13,Kern,029,883053,2,0,0,0,0
2020-02-13,Kings,031,150075,1,0,0,0,0
2020-02-13,Lake,033,64148,0,0,0,0,0
2020-02-13,Lassen,035,31185,0,0,0,0,0
2020-02-13,Los Angeles,037,10098052,31,1,3,4,0
2020-02-13,Madera,039,155013,0,0,0,0,0
2020-02-13,Marin,041,260295,0,0,0,0,0
2020-02-13,Mariposa,043,17540,0,0,0,0,0
2020-02-13,Mendocino,045,87422,0,0,0,0,0
2020-02-13,Merced,047,269075,0,0,0,0,0
2020-02-13,Modoc,049,8938,0,0,0,0,0
2020-02-13,Mono,051,14174,0,0,0,0,0
2020-02-13,Monterey,053,433212,1,0,0,0,0
2020-02-13,Napa,055,140530,0,0,0,0,0
2020-02-13,Nevada,057,99092,0,0,0,0,0
2020-02-13,Orange,059,3164182,36,1,0,1,0
2020-02-13,Placer,061,380077,0,0,0,0,0
2020-02-13,Plumas,063,18699,0,0,0,0,0
2020-02-13,Riverside,065,2383286,4,0,0,0,0
2020-02-13,Sacramento,067,1510023,1,0,0,0,0
2020-02-13,San Benito,069,59416,0,2,0,2,0
2020-02-13,San Bernardino,071,2135413,8,0,0,0,0
2020-02-13,San Diego,073,3302833,2,2,0,2,0
2020-02-13,San Francisco,075,870044,2,0,0,0,0
2020-02-13,San Joaquin,077,732212,1,0,1,1,0
2020-02-13,San Luis Obispo,079,281455,0,0,0,0,0
2020-02-13,San Mateo,081,765935,2,0,0,0,0
2020-02-13,Santa Barbara,083,443738,0,0,0,0,0
2020-02-13,Santa Clara,085,1922200,7,2,0,2,0
2020-02-13,Santa Cruz,087,273765,0,0,0,0,0
2020-02-13,Shasta,089,179085,0,0,0,0,0
2020-02-13,Sierra,091,2930,0,0,0,0,0
2020-02-13,Siskiyou,093,43540,0,0,0,0,0
2020-02-13,Solano,095,438530,0,0,0,0,0
2020-02-13,Sonoma,097,501317,0,0,0,0,0
2020-02-13,Stanislaus,099,539301,1,0,1,1,0
2020-02-13,Sutter,101,95872,0,0,0,0,0
2020-02-13,Tehama,103,63373,0,0,0,0,0
2020-02-13,Trinity,105,12862,0,0,0,0,0
2020-02-13,Tulare,107,460477,2,0,0,0,0
2020-02-13,Tuolumne,109,53932,0,0,0,0,0
2020-02-13,Ventura,111,848112,2,0,0,0,0
2020-02-13,Yolo,113,214977,0,0,0,0,0
2020-02-13,Yuba,115,75493,0,0,0,0,0
2020-02-12,Alameda,001,1643700,4,0,0,0,0
2020-02-12,Alpine,003,1148,0,0,0,0,0
2020-02-12,Amador,005,37829,0,0,0,0,0
2020-02-12,Butte,007,227075,0,0,0,0,0
2020-02-12,Calaveras,009,45235,0,0,0,0,0
2020-02-12,Colusa,011,21464,0,0,0,0,0
2020-02-12,Contra Costa,013,1133247,3,0,0,0,0
2020-02-12,Del Norte,015,27424,0,0,0,0,0
2020-02-12,El Dorado,017,186661,0,0,0,0,0
2020-02-12,Fresno,019,978130,0,0,0,0,0
2020-02-12,Glenn,021,27897,0,0,0,0,0
2020-02-12,Humboldt,023,135768,1,0,0,0,0
2020-02-12,Imperial,025,180216,0,0,0,0,0
2020-02-12,Inyo,027,18085,0,0,0,0,0
2020-02-12,Kern,029,883053,2,0,0,0,0
2020-02-12,Kings,031,150075,1,0,0,0,0
2020-02-12,Lake,033,64148,0,0,0,0,0
2020-02-12,Lassen,035,31185,0,0,0,0,0
2020-02-12,Los Angeles,037,10098052,30,1,3,4,0
2020-02-12,Madera,039,155013,0,0,0,0,0
2020-02-12,Marin,041,260295,0,0,0,0,0
2020-02-12,Mariposa,043,17540,0,0,0,0,0
2020-02-12,Mendocino,045,87422,0,0,0,0,0
2020-02-12,Merced,047,269075,0,0,0,0,0
2020-02-12,Modoc,049,8938,0,0,0,0,0
2020-02-12,Mono,051,14174,0,0,0,0,0
2020-02-12,Monterey,053,433212,1,0,0,0,0
2020-02-12,Napa,055,140530,0,0,0,0,0
2020-02-12,Nevada,057,99092,0,0,0,0,0
2020-02-12,Orange,059,3164182,36,1,0,1,0
2020-02-12,Placer,061,380077,0,0,0,0,0
2020-02-12,Plumas,063,18699,0,0,0,0,0
2020-02-12,Riverside,065,2383286,4,0,0,0,0
2020-02-12,Sacramento,067,1510023,1,0,0,0,0
2020-02-12,San Benito,069,59416,0,2,0,2,0
2020-02-12,San Bernardino,071,2135413,8,0,0,0,0
2020-02-12,San Diego,073,3302833,2,2,0,2,0
2020-02-12,San Francisco,075,870044,2,0,0,0,0
2020-02-12,San Joaquin,077,732212,1,0,1,1,0
2020-02-12,San Luis Obispo,079,281455,0,0,0,0,0
2020-02-12,San Mateo,081,765935,2,0,0,0,0
2020-02-12,Santa Barbara,083,443738,0,0,0,0,0
2020-02-12,Santa Clara,085,1922200,6,2,0,2,0
2020-02-12,Santa Cruz,087,273765,0,0,0,0,0
2020-02-12,Shasta,089,179085,0,0,0,0,0
2020-02-12,Sierra,091,2930,0,0,0,0,0
2020-02-12,Siskiyou,093,43540,0,0,0,0,0
2020-02-12,Solano,095,438530,0,0,0,0,0
2020-02-12,Sonoma,097,501317,0,0,0,0,0
2020-02-12,Stanislaus,099,539301,1,0,1,1,0
2020-02-12,Sutter,101,95872,0,0,0,0,0
2020-02-12,Tehama,103,63373,0,0,0,0,0
2020-02-12,Trinity,105,12862,0,0,0,0,0
2020-02-12,Tulare,107,460477,2,0,0,0,0
2020-02-12,Tuolumne,109,53932,0,0,0,0,0
2020-02-12,Ventura,111,848112,2,0,0,0,0
2020-02-12,Yolo,113,214977,0,0,0,0,0
2020-02-12,Yuba,115,75493,0,0,0,0,0
2020-02-11,Alameda,001,1643700,4,0,0,0,0
2020-02-11,Alpine,003,1148,0,0,0,0,0
2020-02-11,Amador,005,37829,0,0,0,0,0
2020-02-11,Butte,007,227075,0,0,0,0,0
2020-02-11,Calaveras,009,45235,0,0,0,0,0
2020-02-11,Colusa,011,21464,0,0,0,0,0
2020-02-11,Contra Costa,013,1133247,3,0,0,0,0
2020-02-11,Del Norte,015,27424,0,0,0,0,0
2020-02-11,El Dorado,017,186661,0,0,0,0,0
2020-02-11,Fresno,019,978130,0,0,0,0,0
2020-02-11,Glenn,021,27897,0,0,0,0,0
2020-02-11,Humboldt,023,135768,1,0,0,0,0
2020-02-11,Imperial,025,180216,0,0,0,0,0
2020-02-11,Inyo,027,18085,0,0,0,0,0
2020-02-11,Kern,029,883053,2,0,0,0,0
2020-02-11,Kings,031,150075,1,0,0,0,0
2020-02-11,Lake,033,64148,0,0,0,0,0
2020-02-11,Lassen,035,31185,0,0,0,0,0
2020-02-11,Los Angeles,037,10098052,30,1,3,4,0
2020-02-11,Madera,039,155013,0,0,0,0,0
2020-02-11,Marin,041,260295,0,0,0,0,0
2020-02-11,Mariposa,043,17540,0,0,0,0,0
2020-02-11,Mendocino,045,87422,0,0,0,0,0
2020-02-11,Merced,047,269075,0,0,0,0,0
2020-02-11,Modoc,049,8938,0,0,0,0,0
2020-02-11,Mono,051,14174,0,0,0,0,0
2020-02-11,Monterey,053,433212,1,0,0,0,0
2020-02-11,Napa,055,140530,0,0,0,0,0
2020-02-11,Nevada,057,99092,0,0,0,0,0
2020-02-11,Orange,059,3164182,35,1,0,1,0
2020-02-11,Placer,061,380077,0,0,0,0,0
2020-02-11,Plumas,063,18699,0,0,0,0,0
2020-02-11,Riverside,065,2383286,4,0,0,0,0
2020-02-11,Sacramento,067,1510023,1,0,0,0,0
2020-02-11,San Benito,069,59416,0,2,0,2,0
2020-02-11,San Bernardino,071,2135413,8,0,0,0,0
2020-02-11,San Diego,073,3302833,2,1,0,1,0
2020-02-11,San Francisco,075,870044,2,0,0,0,0
2020-02-11,San Joaquin,077,732212,0,0,1,1,0
2020-02-11,San Luis Obispo,079,281455,0,0,0,0,0
2020-02-11,San Mateo,081,765935,2,0,0,0,0
2020-02-11,Santa Barbara,083,443738,0,0,0,0,0
2020-02-11,Santa Clara,085,1922200,5,2,0,2,0
2020-02-11,Santa Cruz,087,273765,0,0,0,0,0
2020-02-11,Shasta,089,179085,0,0,0,0,0
2020-02-11,Sierra,091,2930,0,0,0,0,0
2020-02-11,Siskiyou,093,43540,0,0,0,0,0
2020-02-11,Solano,095,438530,0,0,0,0,0
2020-02-11,Sonoma,097,501317,0,0,0,0,0
2020-02-11,Stanislaus,099,539301,1,0,1,1,0
2020-02-11,Sutter,101,95872,0,0,0,0,0
2020-02-11,Tehama,103,63373,0,0,0,0,0
2020-02-11,Trinity,105,12862,0,0,0,0,0
2020-02-11,Tulare,107,460477,2,0,0,0,0
2020-02-11,Tuolumne,109,53932,0,0,0,0,0
2020-02-11,Ventura,111,848112,2,0,0,0,0
2020-02-11,Yolo,113,214977,0,0,0,0,0
2020-02-11,Yuba,115,75493,0,0,0,0,0
2020-02-10,Alameda,001,1643700,4,0,0,0,0
2020-02-10,Alpine,003,1148,0,0,0,0,0
2020-02-10,Amador,005,37829,0,0,0,0,0
2020-02-10,Butte,007,227075,0,0,0,0,0
2020-02-10,Calaveras,009,45235,0,0,0,0,0
2020-02-10,Colusa,011,21464,0,0,0,0,0
2020-02-10,Contra Costa,013,1133247,3,0,0,0,0
2020-02-10,Del Norte,015,27424,0,0,0,0,0
2020-02-10,El Dorado,017,186661,0,0,0,0,0
2020-02-10,Fresno,019,978130,0,0,0,0,0
2020-02-10,Glenn,021,27897,0,0,0,0,0
2020-02-10,Humboldt,023,135768,0,0,0,0,0
2020-02-10,Imperial,025,180216,0,0,0,0,0
2020-02-10,Inyo,027,18085,0,0,0,0,0
2020-02-10,Kern,029,883053,2,0,0,0,0
2020-02-10,Kings,031,150075,1,0,0,0,0
2020-02-10,Lake,033,64148,0,0,0,0,0
2020-02-10,Lassen,035,31185,0,0,0,0,0
2020-02-10,Los Angeles,037,10098052,28,1,3,4,0
2020-02-10,Madera,039,155013,0,0,0,0,0
2020-02-10,Marin,041,260295,0,0,0,0,0
2020-02-10,Mariposa,043,17540,0,0,0,0,0
2020-02-10,Mendocino,045,87422,0,0,0,0,0
2020-02-10,Merced,047,269075,0,0,0,0,0
2020-02-10,Modoc,049,8938,0,0,0,0,0
2020-02-10,Mono,051,14174,0,0,0,0,0
2020-02-10,Monterey,053,433212,1,0,0,0,0
2020-02-10,Napa,055,140530,0,0,0,0,0
2020-02-10,Nevada,057,99092,0,0,0,0,0
2020-02-10,Orange,059,3164182,35,1,0,1,0
2020-02-10,Placer,061,380077,0,0,0,0,0
2020-02-10,Plumas,063,18699,0,0,0,0,0
2020-02-10,Riverside,065,2383286,4,0,0,0,0
2020-02-10,Sacramento,067,1510023,1,0,0,0,0
2020-02-10,San Benito,069,59416,0,2,0,2,0
2020-02-10,San Bernardino,071,2135413,7,0,0,0,0
2020-02-10,San Diego,073,3302833,2,0,0,0,0
2020-02-10,San Francisco,075,870044,2,0,0,0,0
2020-02-10,San Joaquin,077,732212,0,0,1,1,0
2020-02-10,San Luis Obispo,079,281455,0,0,0,0,0
2020-02-10,San Mateo,081,765935,2,0,0,0,0
2020-02-10,Santa Barbara,083,443738,0,0,0,0,0
2020-02-10,Santa Clara,085,1922200,5,2,0,2,0
2020-02-10,Santa Cruz,087,273765,0,0,0,0,0
2020-02-10,Shasta,089,179085,0,0,0,0,0
2020-02-10,Sierra,091,2930,0,0,0,0,0
2020-02-10,Siskiyou,093,43540,0,0,0,0,0
2020-02-10,Solano,095,438530,0,0,0,0,0
2020-02-10,Sonoma,097,501317,0,0,0,0,0
2020-02-10,Stanislaus,099,539301,1,0,0,0,0
2020-02-10,Sutter,101,95872,0,0,0,0,0
2020-02-10,Tehama,103,63373,0,0,0,0,0
2020-02-10,Trinity,105,12862,0,0,0,0,0
2020-02-10,Tulare,107,460477,2,0,0,0,0
2020-02-10,Tuolumne,109,53932,0,0,0,0,0
2020-02-10,Ventura,111,848112,2,0,0,0,0
2020-02-10,Yolo,113,214977,0,0,0,0,0
2020-02-10,Yuba,115,75493,0,0,0,0,0
2020-02-09,Alameda,001,1643700,4,0,0,0,0
2020-02-09,Alpine,003,1148,0,0,0,0,0
2020-02-09,Amador,005,37829,0,0,0,0,0
2020-02-09,Butte,007,227075,0,0,0,0,0
2020-02-09,Calaveras,009,45235,0,0,0,0,0
2020-02-09,Colusa,011,21464,0,0,0,0,0
2020-02-09,Contra Costa,013,1133247,3,0,0,0,0
2020-02-09,Del Norte,015,27424,0,0,0,0,0
2020-02-09,El Dorado,017,186661,0,0,0,0,0
2020-02-09,Fresno,019,978130,0,0,0,0,0
2020-02-09,Glenn,021,27897,0,0,0,0,0
2020-02-09,Humboldt,023,135768,0,0,0,0,0
2020-02-09,Imperial,025,180216,0,0,0,0,0
2020-02-09,Inyo,027,18085,0,0,0,0,0
2020-02-09,Kern,029,883053,2,0,0,0,0
2020-02-09,Kings,031,150075,1,0,0,0,0
2020-02-09,Lake,033,64148,0,0,0,0,0
2020-02-09,Lassen,035,31185,0,0,0,0,0
2020-02-09,Los Angeles,037,10098052,27,1,3,4,0
2020-02-09,Madera,039,155013,0,0,0,0,0
2020-02-09,Marin,041,260295,0,0,0,0,0
2020-02-09,Mariposa,043,17540,0,0,0,0,0
2020-02-09,Mendocino,045,87422,0,0,0,0,0
2020-02-09,Merced,047,269075,0,0,0,0,0
2020-02-09,Modoc,049,8938,0,0,0,0,0
2020-02-09,Mono,051,14174,0,0,0,0,0
2020-02-09,Monterey,053,433212,1,0,0,0,0
2020-02-09,Napa,055,140530,0,0,0,0,0
2020-02-09,Nevada,057,99092,0,0,0,0,0
2020-02-09,Orange,059,3164182,35,1,0,1,0
2020-02-09,Placer,061,380077,0,0,0,0,0
2020-02-09,Plumas,063,18699,0,0,0,0,0
2020-02-09,Riverside,065,2383286,4,0,0,0,0
2020-02-09,Sacramento,067,1510023,0,0,0,0,0
2020-02-09,San Benito,069,59416,0,2,0,2,0
2020-02-09,San Bernardino,071,2135413,7,0,0,0,0
2020-02-09,San Diego,073,3302833,2,0,0,0,0
2020-02-09,San Francisco,075,870044,1,0,0,0,0
2020-02-09,San Joaquin,077,732212,0,0,1,1,0
2020-02-09,San Luis Obispo,079,281455,0,0,0,0,0
2020-02-09,San Mateo,081,765935,2,0,0,0,0
2020-02-09,Santa Barbara,083,443738,0,0,0,0,0
2020-02-09,Santa Clara,085,1922200,4,2,0,2,0
2020-02-09,Santa Cruz,087,273765,0,0,0,0,0
2020-02-09,Shasta,089,179085,0,0,0,0,0
2020-02-09,Sierra,091,2930,0,0,0,0,0
2020-02-09,Siskiyou,093,43540,0,0,0,0,0
2020-02-09,Solano,095,438530,0,0,0,0,0
2020-02-09,Sonoma,097,501317,0,0,0,0,0
2020-02-09,Stanislaus,099,539301,0,0,0,0,0
2020-02-09,Sutter,101,95872,0,0,0,0,0
2020-02-09,Tehama,103,63373,0,0,0,0,0
2020-02-09,Trinity,105,12862,0,0,0,0,0
2020-02-09,Tulare,107,460477,2,0,0,0,0
2020-02-09,Tuolumne,109,53932,0,0,0,0,0
2020-02-09,Ventura,111,848112,1,0,0,0,0
2020-02-09,Yolo,113,214977,0,0,0,0,0
2020-02-09,Yuba,115,75493,0,0,0,0,0
2020-02-08,Alameda,001,1643700,3,0,0,0,0
2020-02-08,Alpine,003,1148,0,0,0,0,0
2020-02-08,Amador,005,37829,0,0,0,0,0
2020-02-08,Butte,007,227075,0,0,0,0,0
2020-02-08,Calaveras,009,45235,0,0,0,0,0
2020-02-08,Colusa,011,21464,0,0,0,0,0
2020-02-08,Contra Costa,013,1133247,2,0,0,0,0
2020-02-08,Del Norte,015,27424,0,0,0,0,0
2020-02-08,El Dorado,017,186661,0,0,0,0,0
2020-02-08,Fresno,019,978130,0,0,0,0,0
2020-02-08,Glenn,021,27897,0,0,0,0,0
2020-02-08,Humboldt,023,135768,0,0,0,0,0
2020-02-08,Imperial,025,180216,0,0,0,0,0
2020-02-08,Inyo,027,18085,0,0,0,0,0
2020-02-08,Kern,029,883053,2,0,0,0,0
2020-02-08,Kings,031,150075,1,0,0,0,0
2020-02-08,Lake,033,64148,0,0,0,0,0
2020-02-08,Lassen,035,31185,0,0,0,0,0
2020-02-08,Los Angeles,037,10098052,23,1,1,2,0
2020-02-08,Madera,039,155013,0,0,0,0,0
2020-02-08,Marin,041,260295,0,0,0,0,0
2020-02-08,Mariposa,043,17540,0,0,0,0,0
2020-02-08,Mendocino,045,87422,0,0,0,0,0
2020-02-08,Merced,047,269075,0,0,0,0,0
2020-02-08,Modoc,049,8938,0,0,0,0,0
2020-02-08,Mono,051,14174,0,0,0,0,0
2020-02-08,Monterey,053,433212,1,0,0,0,0
2020-02-08,Napa,055,140530,0,0,0,0,0
2020-02-08,Nevada,057,99092,0,0,0,0,0
2020-02-08,Orange,059,3164182,35,1,0,1,0
2020-02-08,Placer,061,380077,0,0,0,0,0
2020-02-08,Plumas,063,18699,0,0,0,0,0
2020-02-08,Riverside,065,2383286,4,0,0,0,0
2020-02-08,Sacramento,067,1510023,0,0,0,0,0
2020-02-08,San Benito,069,59416,0,2,0,2,0
2020-02-08,San Bernardino,071,2135413,7,0,0,0,0
2020-02-08,San Diego,073,3302833,1,0,0,0,0
2020-02-08,San Francisco,075,870044,1,0,0,0,0
2020-02-08,San Joaquin,077,732212,0,0,1,1,0
2020-02-08,San Luis Obispo,079,281455,0,0,0,0,0
2020-02-08,San Mateo,081,765935,2,0,0,0,0
2020-02-08,Santa Barbara,083,443738,0,0,0,0,0
2020-02-08,Santa Clara,085,1922200,4,2,0,2,0
2020-02-08,Santa Cruz,087,273765,0,0,0,0,0
2020-02-08,Shasta,089,179085,0,0,0,0,0
2020-02-08,Sierra,091,2930,0,0,0,0,0
2020-02-08,Siskiyou,093,43540,0,0,0,0,0
2020-02-08,Solano,095,438530,0,0,0,0,0
2020-02-08,Sonoma,097,501317,0,0,0,0,0
2020-02-08,Stanislaus,099,539301,0,0,0,0,0
2020-02-08,Sutter,101,95872,0,0,0,0,0
2020-02-08,Tehama,103,63373,0,0,0,0,0
2020-02-08,Trinity,105,12862,0,0,0,0,0
2020-02-08,Tulare,107,460477,2,0,0,0,0
2020-02-08,Tuolumne,109,53932,0,0,0,0,0
2020-02-08,Ventura,111,848112,1,0,0,0,0
2020-02-08,Yolo,113,214977,0,0,0,0,0
2020-02-08,Yuba,115,75493,0,0,0,0,0
2020-02-07,Alameda,001,1643700,3,0,0,0,0
2020-02-07,Alpine,003,1148,0,0,0,0,0
2020-02-07,Amador,005,37829,0,0,0,0,0
2020-02-07,Butte,007,227075,0,0,0,0,0
2020-02-07,Calaveras,009,45235,0,0,0,0,0
2020-02-07,Colusa,011,21464,0,0,0,0,0
2020-02-07,Contra Costa,013,1133247,2,0,0,0,0
2020-02-07,Del Norte,015,27424,0,0,0,0,0
2020-02-07,El Dorado,017,186661,0,0,0,0,0
2020-02-07,Fresno,019,978130,0,0,0,0,0
2020-02-07,Glenn,021,27897,0,0,0,0,0
2020-02-07,Humboldt,023,135768,0,0,0,0,0
2020-02-07,Imperial,025,180216,0,0,0,0,0
2020-02-07,Inyo,027,18085,0,0,0,0,0
2020-02-07,Kern,029,883053,2,0,0,0,0
2020-02-07,Kings,031,150075,1,0,0,0,0
2020-02-07,Lake,033,64148,0,0,0,0,0
2020-02-07,Lassen,035,31185,0,0,0,0,0
2020-02-07,Los Angeles,037,10098052,22,1,0,1,0
2020-02-07,Madera,039,155013,0,0,0,0,0
2020-02-07,Marin,041,260295,0,0,0,0,0
2020-02-07,Mariposa,043,17540,0,0,0,0,0
2020-02-07,Mendocino,045,87422,0,0,0,0,0
2020-02-07,Merced,047,269075,0,0,0,0,0
2020-02-07,Modoc,049,8938,0,0,0,0,0
2020-02-07,Mono,051,14174,0,0,0,0,0
2020-02-07,Monterey,053,433212,1,0,0,0,0
2020-02-07,Napa,055,140530,0,0,0,0,0
2020-02-07,Nevada,057,99092,0,0,0,0,0
2020-02-07,Orange,059,3164182,33,1,0,1,0
2020-02-07,Placer,061,380077,0,0,0,0,0
2020-02-07,Plumas,063,18699,0,0,0,0,0
2020-02-07,Riverside,065,2383286,4,0,0,0,0
2020-02-07,Sacramento,067,1510023,0,0,0,0,0
2020-02-07,San Benito,069,59416,0,2,0,2,0
2020-02-07,San Bernardino,071,2135413,4,0,0,0,0
2020-02-07,San Diego,073,3302833,1,0,0,0,0
2020-02-07,San Francisco,075,870044,1,0,0,0,0
2020-02-07,San Joaquin,077,732212,0,0,1,1,0
2020-02-07,San Luis Obispo,079,281455,0,0,0,0,0
2020-02-07,San Mateo,081,765935,1,0,0,0,0
2020-02-07,Santa Barbara,083,443738,0,0,0,0,0
2020-02-07,Santa Clara,085,1922200,4,2,0,2,0
2020-02-07,Santa Cruz,087,273765,0,0,0,0,0
2020-02-07,Shasta,089,179085,0,0,0,0,0
2020-02-07,Sierra,091,2930,0,0,0,0,0
2020-02-07,Siskiyou,093,43540,0,0,0,0,0
2020-02-07,Solano,095,438530,0,0,0,0,0
2020-02-07,Sonoma,097,501317,0,0,0,0,0
2020-02-07,Stanislaus,099,539301,0,0,0,0,0
2020-02-07,Sutter,101,95872,0,0,0,0,0
2020-02-07,Tehama,103,63373,0,0,0,0,0
2020-02-07,Trinity,105,12862,0,0,0,0,0
2020-02-07,Tulare,107,460477,2,0,0,0,0
2020-02-07,Tuolumne,109,53932,0,0,0,0,0
2020-02-07,Ventura,111,848112,1,0,0,0,0
2020-02-07,Yolo,113,214977,0,0,0,0,0
2020-02-07,Yuba,115,75493,0,0,0,0,0
2020-02-06,Alameda,001,1643700,3,0,0,0,0
2020-02-06,Alpine,003,1148,0,0,0,0,0
2020-02-06,Amador,005,37829,0,0,0,0,0
2020-02-06,Butte,007,227075,0,0,0,0,0
2020-02-06,Calaveras,009,45235,0,0,0,0,0
2020-02-06,Colusa,011,21464,0,0,0,0,0
2020-02-06,Contra Costa,013,1133247,2,0,0,0,0
2020-02-06,Del Norte,015,27424,0,0,0,0,0
2020-02-06,El Dorado,017,186661,0,0,0,0,0
2020-02-06,Fresno,019,978130,0,0,0,0,0
2020-02-06,Glenn,021,27897,0,0,0,0,0
2020-02-06,Humboldt,023,135768,0,0,0,0,0
2020-02-06,Imperial,025,180216,0,0,0,0,0
2020-02-06,Inyo,027,18085,0,0,0,0,0
2020-02-06,Kern,029,883053,2,0,0,0,0
2020-02-06,Kings,031,150075,0,0,0,0,0
2020-02-06,Lake,033,64148,0,0,0,0,0
2020-02-06,Lassen,035,31185,0,0,0,0,0
2020-02-06,Los Angeles,037,10098052,21,1,0,1,0
2020-02-06,Madera,039,155013,0,0,0,0,0
2020-02-06,Marin,041,260295,0,0,0,0,0
2020-02-06,Mariposa,043,17540,0,0,0,0,0
2020-02-06,Mendocino,045,87422,0,0,0,0,0
2020-02-06,Merced,047,269075,0,0,0,0,0
2020-02-06,Modoc,049,8938,0,0,0,0,0
2020-02-06,Mono,051,14174,0,0,0,0,0
2020-02-06,Monterey,053,433212,1,0,0,0,0
2020-02-06,Napa,055,140530,0,0,0,0,0
2020-02-06,Nevada,057,99092,0,0,0,0,0
2020-02-06,Orange,059,3164182,3,1,0,1,0
2020-02-06,Placer,061,380077,0,0,0,0,0
2020-02-06,Plumas,063,18699,0,0,0,0,0
2020-02-06,Riverside,065,2383286,4,0,0,0,0
2020-02-06,Sacramento,067,1510023,0,0,0,0,0
2020-02-06,San Benito,069,59416,0,2,0,2,0
2020-02-06,San Bernardino,071,2135413,4,0,0,0,0
2020-02-06,San Diego,073,3302833,1,0,0,0,0
2020-02-06,San Francisco,075,870044,1,0,0,0,0
2020-02-06,San Joaquin,077,732212,0,0,1,1,0
2020-02-06,San Luis Obispo,079,281455,0,0,0,0,0
2020-02-06,San Mateo,081,765935,1,0,0,0,0
2020-02-06,Santa Barbara,083,443738,0,0,0,0,0
2020-02-06,Santa Clara,085,1922200,4,2,0,2,0
2020-02-06,Santa Cruz,087,273765,0,0,0,0,0
2020-02-06,Shasta,089,179085,0,0,0,0,0
2020-02-06,Sierra,091,2930,0,0,0,0,0
2020-02-06,Siskiyou,093,43540,0,0,0,0,0
2020-02-06,Solano,095,438530,0,0,0,0,0
2020-02-06,Sonoma,097,501317,0,0,0,0,0
2020-02-06,Stanislaus,099,539301,0,0,0,0,0
2020-02-06,Sutter,101,95872,0,0,0,0,0
2020-02-06,Tehama,103,63373,0,0,0,0,0
2020-02-06,Trinity,105,12862,0,0,0,0,0
2020-02-06,Tulare,107,460477,2,0,0,0,0
2020-02-06,Tuolumne,109,53932,0,0,0,0,0
2020-02-06,Ventura,111,848112,1,0,0,0,0
2020-02-06,Yolo,113,214977,0,0,0,0,0
2020-02-06,Yuba,115,75493,0,0,0,0,0
2020-02-05,Alameda,001,1643700,3,0,0,0,0
2020-02-05,Alpine,003,1148,0,0,0,0,0
2020-02-05,Amador,005,37829,0,0,0,0,0
2020-02-05,Butte,007,227075,0,0,0,0,0
2020-02-05,Calaveras,009,45235,0,0,0,0,0
2020-02-05,Colusa,011,21464,0,0,0,0,0
2020-02-05,Contra Costa,013,1133247,2,0,0,0,0
2020-02-05,Del Norte,015,27424,0,0,0,0,0
2020-02-05,El Dorado,017,186661,0,0,0,0,0
2020-02-05,Fresno,019,978130,0,0,0,0,0
2020-02-05,Glenn,021,27897,0,0,0,0,0
2020-02-05,Humboldt,023,135768,0,0,0,0,0
2020-02-05,Imperial,025,180216,0,0,0,0,0
2020-02-05,Inyo,027,18085,0,0,0,0,0
2020-02-05,Kern,029,883053,1,0,0,0,0
2020-02-05,Kings,031,150075,0,0,0,0,0
2020-02-05,Lake,033,64148,0,0,0,0,0
2020-02-05,Lassen,035,31185,0,0,0,0,0
2020-02-05,Los Angeles,037,10098052,21,1,0,1,0
2020-02-05,Madera,039,155013,0,0,0,0,0
2020-02-05,Marin,041,260295,0,0,0,0,0
2020-02-05,Mariposa,043,17540,0,0,0,0,0
2020-02-05,Mendocino,045,87422,0,0,0,0,0
2020-02-05,Merced,047,269075,0,0,0,0,0
2020-02-05,Modoc,049,8938,0,0,0,0,0
2020-02-05,Mono,051,14174,0,0,0,0,0
2020-02-05,Monterey,053,433212,1,0,0,0,0
2020-02-05,Napa,055,140530,0,0,0,0,0
2020-02-05,Nevada,057,99092,0,0,0,0,0
2020-02-05,Orange,059,3164182,1,1,0,1,0
2020-02-05,Placer,061,380077,0,0,0,0,0
2020-02-05,Plumas,063,18699,0,0,0,0,0
2020-02-05,Riverside,065,2383286,4,0,0,0,0
2020-02-05,Sacramento,067,1510023,0,0,0,0,0
2020-02-05,San Benito,069,59416,0,2,0,2,0
2020-02-05,San Bernardino,071,2135413,4,0,0,0,0
2020-02-05,San Diego,073,3302833,0,0,0,0,0
2020-02-05,San Francisco,075,870044,1,0,0,0,0
2020-02-05,San Joaquin,077,732212,0,0,1,1,0
2020-02-05,San Luis Obispo,079,281455,0,0,0,0,0
2020-02-05,San Mateo,081,765935,1,0,0,0,0
2020-02-05,Santa Barbara,083,443738,0,0,0,0,0
2020-02-05,Santa Clara,085,1922200,2,2,0,2,0
2020-02-05,Santa Cruz,087,273765,0,0,0,0,0
2020-02-05,Shasta,089,179085,0,0,0,0,0
2020-02-05,Sierra,091,2930,0,0,0,0,0
2020-02-05,Siskiyou,093,43540,0,0,0,0,0
2020-02-05,Solano,095,438530,0,0,0,0,0
2020-02-05,Sonoma,097,501317,0,0,0,0,0
2020-02-05,Stanislaus,099,539301,0,0,0,0,0
2020-02-05,Sutter,101,95872,0,0,0,0,0
2020-02-05,Tehama,103,63373,0,0,0,0,0
2020-02-05,Trinity,105,12862,0,0,0,0,0
2020-02-05,Tulare,107,460477,2,0,0,0,0
2020-02-05,Tuolumne,109,53932,0,0,0,0,0
2020-02-05,Ventura,111,848112,0,0,0,0,0
2020-02-05,Yolo,113,214977,0,0,0,0,0
2020-02-05,Yuba,115,75493,0,0,0,0,0
2020-02-04,Alameda,001,1643700,3,0,0,0,0
2020-02-04,Alpine,003,1148,0,0,0,0,0
2020-02-04,Amador,005,37829,0,0,0,0,0
2020-02-04,Butte,007,227075,0,0,0,0,0
2020-02-04,Calaveras,009,45235,0,0,0,0,0
2020-02-04,Colusa,011,21464,0,0,0,0,0
2020-02-04,Contra Costa,013,1133247,2,0,0,0,0
2020-02-04,Del Norte,015,27424,0,0,0,0,0
2020-02-04,El Dorado,017,186661,0,0,0,0,0
2020-02-04,Fresno,019,978130,0,0,0,0,0
2020-02-04,Glenn,021,27897,0,0,0,0,0
2020-02-04,Humboldt,023,135768,0,0,0,0,0
2020-02-04,Imperial,025,180216,0,0,0,0,0
2020-02-04,Inyo,027,18085,0,0,0,0,0
2020-02-04,Kern,029,883053,0,0,0,0,0
2020-02-04,Kings,031,150075,0,0,0,0,0
2020-02-04,Lake,033,64148,0,0,0,0,0
2020-02-04,Lassen,035,31185,0,0,0,0,0
2020-02-04,Los Angeles,037,10098052,21,1,0,1,0
2020-02-04,Madera,039,155013,0,0,0,0,0
2020-02-04,Marin,041,260295,0,0,0,0,0
2020-02-04,Mariposa,043,17540,0,0,0,0,0
2020-02-04,Mendocino,045,87422,0,0,0,0,0
2020-02-04,Merced,047,269075,0,0,0,0,0
2020-02-04,Modoc,049,8938,0,0,0,0,0
2020-02-04,Mono,051,14174,0,0,0,0,0
2020-02-04,Monterey,053,433212,1,0,0,0,0
2020-02-04,Napa,055,140530,0,0,0,0,0
2020-02-04,Nevada,057,99092,0,0,0,0,0
2020-02-04,Orange,059,3164182,1,1,0,1,0
2020-02-04,Placer,061,380077,0,0,0,0,0
2020-02-04,Plumas,063,18699,0,0,0,0,0
2020-02-04,Riverside,065,2383286,4,0,0,0,0
2020-02-04,Sacramento,067,1510023,0,0,0,0,0
2020-02-04,San Benito,069,59416,0,2,0,2,0
2020-02-04,San Bernardino,071,2135413,3,0,0,0,0
2020-02-04,San Diego,073,3302833,0,0,0,0,0
2020-02-04,San Francisco,075,870044,1,0,0,0,0
2020-02-04,San Joaquin,077,732212,0,0,1,1,0
2020-02-04,San Luis Obispo,079,281455,0,0,0,0,0
2020-02-04,San Mateo,081,765935,0,0,0,0,0
2020-02-04,Santa Barbara,083,443738,0,0,0,0,0
2020-02-04,Santa Clara,085,1922200,2,2,0,2,0
2020-02-04,Santa Cruz,087,273765,0,0,0,0,0
2020-02-04,Shasta,089,179085,0,0,0,0,0
2020-02-04,Sierra,091,2930,0,0,0,0,0
2020-02-04,Siskiyou,093,43540,0,0,0,0,0
2020-02-04,Solano,095,438530,0,0,0,0,0
2020-02-04,Sonoma,097,501317,0,0,0,0,0
2020-02-04,Stanislaus,099,539301,0,0,0,0,0
2020-02-04,Sutter,101,95872,0,0,0,0,0
2020-02-04,Tehama,103,63373,0,0,0,0,0
2020-02-04,Trinity,105,12862,0,0,0,0,0
2020-02-04,Tulare,107,460477,2,0,0,0,0
2020-02-04,Tuolumne,109,53932,0,0,0,0,0
2020-02-04,Ventura,111,848112,0,0,0,0,0
2020-02-04,Yolo,113,214977,0,0,0,0,0
2020-02-04,Yuba,115,75493,0,0,0,0,0
2020-02-03,Alameda,001,1643700,3,0,0,0,0
2020-02-03,Alpine,003,1148,0,0,0,0,0
2020-02-03,Amador,005,37829,0,0,0,0,0
2020-02-03,Butte,007,227075,0,0,0,0,0
2020-02-03,Calaveras,009,45235,0,0,0,0,0
2020-02-03,Colusa,011,21464,0,0,0,0,0
2020-02-03,Contra Costa,013,1133247,2,0,0,0,0
2020-02-03,Del Norte,015,27424,0,0,0,0,0
2020-02-03,El Dorado,017,186661,0,0,0,0,0
2020-02-03,Fresno,019,978130,0,0,0,0,0
2020-02-03,Glenn,021,27897,0,0,0,0,0
2020-02-03,Humboldt,023,135768,0,0,0,0,0
2020-02-03,Imperial,025,180216,0,0,0,0,0
2020-02-03,Inyo,027,18085,0,0,0,0,0
2020-02-03,Kern,029,883053,0,0,0,0,0
2020-02-03,Kings,031,150075,0,0,0,0,0
2020-02-03,Lake,033,64148,0,0,0,0,0
2020-02-03,Lassen,035,31185,0,0,0,0,0
2020-02-03,Los Angeles,037,10098052,21,1,0,1,0
2020-02-03,Madera,039,155013,0,0,0,0,0
2020-02-03,Marin,041,260295,0,0,0,0,0
2020-02-03,Mariposa,043,17540,0,0,0,0,0
2020-02-03,Mendocino,045,87422,0,0,0,0,0
2020-02-03,Merced,047,269075,0,0,0,0,0
2020-02-03,Modoc,049,8938,0,0,0,0,0
2020-02-03,Mono,051,14174,0,0,0,0,0
2020-02-03,Monterey,053,433212,1,0,0,0,0
2020-02-03,Napa,055,140530,0,0,0,0,0
2020-02-03,Nevada,057,99092,0,0,0,0,0
2020-02-03,Orange,059,3164182,1,1,0,1,0
2020-02-03,Placer,061,380077,0,0,0,0,0
2020-02-03,Plumas,063,18699,0,0,0,0,0
2020-02-03,Riverside,065,2383286,4,0,0,0,0
2020-02-03,Sacramento,067,1510023,0,0,0,0,0
2020-02-03,San Benito,069,59416,0,2,0,2,0
2020-02-03,San Bernardino,071,2135413,3,0,0,0,0
2020-02-03,San Diego,073,3302833,0,0,0,0,0
2020-02-03,San Francisco,075,870044,1,0,0,0,0
2020-02-03,San Joaquin,077,732212,0,0,1,1,0
2020-02-03,San Luis Obispo,079,281455,0,0,0,0,0
2020-02-03,San Mateo,081,765935,0,0,0,0,0
2020-02-03,Santa Barbara,083,443738,0,0,0,0,0
2020-02-03,Santa Clara,085,1922200,2,2,0,2,0
2020-02-03,Santa Cruz,087,273765,0,0,0,0,0
2020-02-03,Shasta,089,179085,0,0,0,0,0
2020-02-03,Sierra,091,2930,0,0,0,0,0
2020-02-03,Siskiyou,093,43540,0,0,0,0,0
2020-02-03,Solano,095,438530,0,0,0,0,0
2020-02-03,Sonoma,097,501317,0,0,0,0,0
2020-02-03,Stanislaus,099,539301,0,0,0,0,0
2020-02-03,Sutter,101,95872,0,0,0,0,0
2020-02-03,Tehama,103,63373,0,0,0,0,0
2020-02-03,Trinity,105,12862,0,0,0,0,0
2020-02-03,Tulare,107,460477,2,0,0,0,0
2020-02-03,Tuolumne,109,53932,0,0,0,0,0
2020-02-03,Ventura,111,848112,0,0,0,0,0
2020-02-03,Yolo,113,214977,0,0,0,0,0
2020-02-03,Yuba,115,75493,0,0,0,0,0
2020-02-02,Alameda,001,1643700,3,0,0,0,0
2020-02-02,Alpine,003,1148,0,0,0,0,0
2020-02-02,Amador,005,37829,0,0,0,0,0
2020-02-02,Butte,007,227075,0,0,0,0,0
2020-02-02,Calaveras,009,45235,0,0,0,0,0
2020-02-02,Colusa,011,21464,0,0,0,0,0
2020-02-02,Contra Costa,013,1133247,1,0,0,0,0
2020-02-02,Del Norte,015,27424,0,0,0,0,0
2020-02-02,El Dorado,017,186661,0,0,0,0,0
2020-02-02,Fresno,019,978130,0,0,0,0,0
2020-02-02,Glenn,021,27897,0,0,0,0,0
2020-02-02,Humboldt,023,135768,0,0,0,0,0
2020-02-02,Imperial,025,180216,0,0,0,0,0
2020-02-02,Inyo,027,18085,0,0,0,0,0
2020-02-02,Kern,029,883053,0,0,0,0,0
2020-02-02,Kings,031,150075,0,0,0,0,0
2020-02-02,Lake,033,64148,0,0,0,0,0
2020-02-02,Lassen,035,31185,0,0,0,0,0
2020-02-02,Los Angeles,037,10098052,17,1,0,1,0
2020-02-02,Madera,039,155013,0,0,0,0,0
2020-02-02,Marin,041,260295,0,0,0,0,0
2020-02-02,Mariposa,043,17540,0,0,0,0,0
2020-02-02,Mendocino,045,87422,0,0,0,0,0
2020-02-02,Merced,047,269075,0,0,0,0,0
2020-02-02,Modoc,049,8938,0,0,0,0,0
2020-02-02,Mono,051,14174,0,0,0,0,0
2020-02-02,Monterey,053,433212,1,0,0,0,0
2020-02-02,Napa,055,140530,0,0,0,0,0
2020-02-02,Nevada,057,99092,0,0,0,0,0
2020-02-02,Orange,059,3164182,1,1,0,1,0
2020-02-02,Placer,061,380077,0,0,0,0,0
2020-02-02,Plumas,063,18699,0,0,0,0,0
2020-02-02,Riverside,065,2383286,3,0,0,0,0
2020-02-02,Sacramento,067,1510023,0,0,0,0,0
2020-02-02,San Benito,069,59416,0,2,0,2,0
2020-02-02,San Bernardino,071,2135413,2,0,0,0,0
2020-02-02,San Diego,073,3302833,0,0,0,0,0
2020-02-02,San Francisco,075,870044,1,0,0,0,0
2020-02-02,San Joaquin,077,732212,0,0,1,1,0
2020-02-02,San Luis Obispo,079,281455,0,0,0,0,0
2020-02-02,San Mateo,081,765935,0,0,0,0,0
2020-02-02,Santa Barbara,083,443738,0,0,0,0,0
2020-02-02,Santa Clara,085,1922200,2,2,0,2,0
2020-02-02,Santa Cruz,087,273765,0,0,0,0,0
2020-02-02,Shasta,089,179085,0,0,0,0,0
2020-02-02,Sierra,091,2930,0,0,0,0,0
2020-02-02,Siskiyou,093,43540,0,0,0,0,0
2020-02-02,Solano,095,438530,0,0,0,0,0
2020-02-02,Sonoma,097,501317,0,0,0,0,0
2020-02-02,Stanislaus,099,539301,0,0,0,0,0
2020-02-02,Sutter,101,95872,0,0,0,0,0
2020-02-02,Tehama,103,63373,0,0,0,0,0
2020-02-02,Trinity,105,12862,0,0,0,0,0
2020-02-02,Tulare,107,460477,2,0,0,0,0
2020-02-02,Tuolumne,109,53932,0,0,0,0,0
2020-02-02,Ventura,111,848112,0,0,0,0,0
2020-02-02,Yolo,113,214977,0,0,0,0,0
2020-02-02,Yuba,115,75493,0,0,0,0,0
2020-02-01,Alameda,001,1643700,3,0,0,0,0
2020-02-01,Alpine,003,1148,0,0,0,0,0
2020-02-01,Amador,005,37829,0,0,0,0,0
2020-02-01,Butte,007,227075,0,0,0,0,0
2020-02-01,Calaveras,009,45235,0,0,0,0,0
2020-02-01,Colusa,011,21464,0,0,0,0,0
2020-02-01,Contra Costa,013,1133247,0,0,0,0,0
2020-02-01,Del Norte,015,27424,0,0,0,0,0
2020-02-01,El Dorado,017,186661,0,0,0,0,0
2020-02-01,Fresno,019,978130,0,0,0,0,0
2020-02-01,Glenn,021,27897,0,0,0,0,0
2020-02-01,Humboldt,023,135768,0,0,0,0,0
2020-02-01,Imperial,025,180216,0,0,0,0,0
2020-02-01,Inyo,027,18085,0,0,0,0,0
2020-02-01,Kern,029,883053,0,0,0,0,0
2020-02-01,Kings,031,150075,0,0,0,0,0
2020-02-01,Lake,033,64148,0,0,0,0,0
2020-02-01,Lassen,035,31185,0,0,0,0,0
2020-02-01,Los Angeles,037,10098052,13,1,0,1,0
2020-02-01,Madera,039,155013,0,0,0,0,0
2020-02-01,Marin,041,260295,0,0,0,0,0
2020-02-01,Mariposa,043,17540,0,0,0,0,0
2020-02-01,Mendocino,045,87422,0,0,0,0,0
2020-02-01,Merced,047,269075,0,0,0,0,0
2020-02-01,Modoc,049,8938,0,0,0,0,0
2020-02-01,Mono,051,14174,0,0,0,0,0
2020-02-01,Monterey,053,433212,0,0,0,0,0
2020-02-01,Napa,055,140530,0,0,0,0,0
2020-02-01,Nevada,057,99092,0,0,0,0,0
2020-02-01,Orange,059,3164182,1,1,0,1,0
2020-02-01,Placer,061,380077,0,0,0,0,0
2020-02-01,Plumas,063,18699,0,0,0,0,0
2020-02-01,Riverside,065,2383286,2,0,0,0,0
2020-02-01,Sacramento,067,1510023,0,0,0,0,0
2020-02-01,San Benito,069,59416,0,0,0,0,0
2020-02-01,San Bernardino,071,2135413,1,0,0,0,0
2020-02-01,San Diego,073,3302833,0,0,0,0,0
2020-02-01,San Francisco,075,870044,1,0,0,0,0
2020-02-01,San Joaquin,077,732212,0,0,1,1,0
2020-02-01,San Luis Obispo,079,281455,0,0,0,0,0
2020-02-01,San Mateo,081,765935,0,0,0,0,0
2020-02-01,Santa Barbara,083,443738,0,0,0,0,0
2020-02-01,Santa Clara,085,1922200,2,1,0,1,0
2020-02-01,Santa Cruz,087,273765,0,0,0,0,0
2020-02-01,Shasta,089,179085,0,0,0,0,0
2020-02-01,Sierra,091,2930,0,0,0,0,0
2020-02-01,Siskiyou,093,43540,0,0,0,0,0
2020-02-01,Solano,095,438530,0,0,0,0,0
2020-02-01,Sonoma,097,501317,0,0,0,0,0
2020-02-01,Stanislaus,099,539301,0,0,0,0,0
2020-02-01,Sutter,101,95872,0,0,0,0,0
2020-02-01,Tehama,103,63373,0,0,0,0,0
2020-02-01,Trinity,105,12862,0,0,0,0,0
2020-02-01,Tulare,107,460477,1,0,0,0,0
2020-02-01,Tuolumne,109,53932,0,0,0,0,0
2020-02-01,Ventura,111,848112,0,0,0,0,0
2020-02-01,Yolo,113,214977,0,0,0,0,0
2020-02-01,Yuba,115,75493,0,0,0,0,0
