date,county,fips,population,confirmed_cases,reported_cases,probable_cases,reported_and_probable_cases,reported_deaths
2022-05-16,Alameda,001,1643700,272569,272530,15087,287617,1859
2022-05-16,Alpine,003,1148,126,126,1,127,0
2022-05-16,Amador,005,37829,8632,8592,669,9261,86
2022-05-16,Butte,007,227075,33495,33486,6801,40287,426
2022-05-16,Calaveras,009,45235,7401,7400,376,7776,120
2022-05-16,Colusa,011,21464,3467,3467,1082,4549,21
2022-05-16,Contra Costa,013,1133247,198264,198207,14033,212240,1303
2022-05-16,Del Norte,015,27424,6003,6001,213,6214,50
2022-05-16,El Dorado,017,186661,27384,27388,3292,30680,212
2022-05-16,Fresno,019,978130,234062,234055,24301,258356,2759
2022-05-16,Glenn,021,27897,5011,5012,1626,6638,48
2022-05-16,Humboldt,023,135768,17868,17868,3149,21017,146
2022-05-16,Imperial,025,180216,55917,55915,10959,66874,918
2022-05-16,Inyo,027,18085,4121,4120,522,4642,56
2022-05-16,Kern,029,883053,193404,193338,46863,240201,2327
2022-05-16,Kings,031,150075,51911,51903,3644,55547,447
2022-05-16,Lake,033,64148,10835,10831,909,11740,137
2022-05-16,Lassen,035,31185,8995,8994,891,9885,65
2022-05-16,Los Angeles,037,10098052,2780098,2780354,129578,2909932,31789
2022-05-16,Madera,039,155013,37668,37644,6163,43807,365
2022-05-16,Marin,041,260295,36023,36024,3199,39223,293
2022-05-16,Mariposa,043,17540,2482,2481,211,2692,30
2022-05-16,Mendocino,045,87422,13404,13403,3215,16618,124
2022-05-16,Merced,047,269075,62814,62802,8870,71672,818
2022-05-16,Modoc,049,8938,748,748,253,1001,8
2022-05-16,Mono,051,14174,3010,3010,142,3152,6
2022-05-16,Monterey,053,433212,81049,80955,14518,95473,735
2022-05-16,Napa,055,140530,26915,26912,1066,27978,143
2022-05-16,Nevada,057,99092,16355,16361,1263,17624,127
2022-05-16,Orange,059,3164182,560125,560094,43244,603338,7021
2022-05-16,Placer,061,380077,64453,64432,7564,71996,626
2022-05-16,Plumas,063,18699,3021,3022,373,3395,13
2022-05-16,Riverside,065,2383286,599967,599947,28778,628725,6471
2022-05-16,Sacramento,067,1510023,288356,288335,28005,316340,3022
2022-05-16,San Benito,069,59416,13185,13186,530,13716,98
2022-05-16,San Bernardino,071,2135413,573807,573790,25300,599090,7455
2022-05-16,San Diego,073,3302833,773935,773934,54200,828134,5277
2022-05-16,San Francisco,075,870044,137318,137341,9040,146381,869
2022-05-16,San Joaquin,077,732212,169077,169045,10325,179370,2236
2022-05-16,San Luis Obispo,079,281455,53745,53756,4053,57809,478
2022-05-16,San Mateo,081,765935,131333,131330,7758,139088,709
2022-05-16,Santa Barbara,083,443738,88339,88317,4909,93226,693
2022-05-16,Santa Clara,085,1922200,333251,333230,13406,346636,2300
2022-05-16,Santa Cruz,087,273765,51029,51020,2264,53284,263
2022-05-16,Shasta,089,179085,30902,30899,6189,37088,558
2022-05-16,Sierra,091,2930,275,275,49,324,4
2022-05-16,Siskiyou,093,43540,4496,4495,2793,7288,81
2022-05-16,Solano,095,438530,84538,84476,5743,90219,451
2022-05-16,Sonoma,097,501317,88193,88195,3119,91314,489
2022-05-16,Stanislaus,099,539301,119017,119025,17648,136673,1645
2022-05-16,Sutter,101,95872,20755,20763,2177,22940,226
2022-05-16,Tehama,103,63373,12129,12133,2638,14771,201
2022-05-16,Trinity,105,12862,1189,1189,296,1485,20
2022-05-16,Tulare,107,460477,107324,107292,29048,136340,1477
2022-05-16,Tuolumne,109,53932,12912,12917,587,13504,182
2022-05-16,Ventura,111,848112,177240,177233,9744,186977,1497
2022-05-16,Yolo,113,214977,38123,38139,3321,41460,316
2022-05-16,Yuba,115,75493,16112,16109,1258,17367,122
2022-05-15,Alameda,001,1643700,272569,268944,15087,284031,1857
2022-05-15,Alpine,003,1148,126,125,1,126,0
2022-05-15,Amador,005,37829,8632,8574,669,9243,86
2022-05-15,Butte,007,227075,33495,33377,6801,40178,424
2022-05-15,Calaveras,009,45235,7401,7378,376,7754,120
2022-05-15,Colusa,011,21464,3467,3463,1082,4545,21
2022-05-15,Contra Costa,013,1133247,198264,195925,14033,209958,1301
2022-05-15,Del Norte,015,27424,6003,5919,213,6132,50
2022-05-15,El Dorado,017,186661,27384,27216,3292,30508,212
2022-05-15,Fresno,019,978130,234062,233305,24301,257606,2757
2022-05-15,Glenn,021,27897,5011,5004,1626,6630,48
2022-05-15,Humboldt,023,135768,17868,17633,3149,20782,146
2022-05-15,Imperial,025,180216,55917,55756,10959,66715,917
2022-05-15,Inyo,027,18085,4121,4114,522,4636,56
2022-05-15,Kern,029,883053,193404,192939,46863,239802,2314
2022-05-15,Kings,031,150075,51911,51779,3644,55423,447
2022-05-15,Lake,033,64148,10835,10790,909,11699,137
2022-05-15,Lassen,035,31185,8995,8987,891,9878,65
2022-05-15,Los Angeles,037,10098052,2780098,2768726,129578,2898304,31768
2022-05-15,Madera,039,155013,37668,37520,6163,43683,365
2022-05-15,Marin,041,260295,36023,35486,3199,38685,293
2022-05-15,Mariposa,043,17540,2482,2463,211,2674,30
2022-05-15,Mendocino,045,87422,13404,13349,3215,16564,124
2022-05-15,Merced,047,269075,62814,62627,8870,71497,818
2022-05-15,Modoc,049,8938,748,747,253,1000,8
2022-05-15,Mono,051,14174,3010,3002,142,3144,6
2022-05-15,Monterey,053,433212,81049,80620,14518,95138,735
2022-05-15,Napa,055,140530,26915,26698,1066,27764,143
2022-05-15,Nevada,057,99092,16355,16240,1263,17503,127
2022-05-15,Orange,059,3164182,560125,557134,43244,600378,7017
2022-05-15,Placer,061,380077,64453,63963,7564,71527,626
2022-05-15,Plumas,063,18699,3021,3006,373,3379,13
2022-05-15,Riverside,065,2383286,599967,597914,28778,626692,6471
2022-05-15,Sacramento,067,1510023,288356,286403,28005,314408,3022
2022-05-15,San Benito,069,59416,13185,13106,530,13636,98
2022-05-15,San Bernardino,071,2135413,573807,572057,25300,597357,7423
2022-05-15,San Diego,073,3302833,773935,770323,54200,824523,5271
2022-05-15,San Francisco,075,870044,137318,134916,9040,143956,866
2022-05-15,San Joaquin,077,732212,169077,168174,10325,178499,2236
2022-05-15,San Luis Obispo,079,281455,53745,53502,4053,57555,478
2022-05-15,San Mateo,081,765935,131333,129480,7758,137238,709
2022-05-15,Santa Barbara,083,443738,88339,87773,4909,92682,693
2022-05-15,Santa Clara,085,1922200,333251,328609,13406,342015,2297
2022-05-15,Santa Cruz,087,273765,51029,50268,2264,52532,263
2022-05-15,Shasta,089,179085,30902,30799,6189,36988,557
2022-05-15,Sierra,091,2930,275,275,49,324,4
2022-05-15,Siskiyou,093,43540,4496,4482,2793,7275,81
2022-05-15,Solano,095,438530,84538,83669,5743,89412,451
2022-05-15,Sonoma,097,501317,88193,87070,3119,90189,488
2022-05-15,Stanislaus,099,539301,119017,118586,17648,136234,1645
2022-05-15,Sutter,101,95872,20755,20690,2177,22867,226
2022-05-15,Tehama,103,63373,12129,12115,2638,14753,201
2022-05-15,Trinity,105,12862,1189,1188,296,1484,20
2022-05-15,Tulare,107,460477,107324,107077,29048,136125,1469
2022-05-15,Tuolumne,109,53932,12912,12851,587,13438,182
2022-05-15,Ventura,111,848112,177240,176317,9744,186061,1497
2022-05-15,Yolo,113,214977,38123,37737,3321,41058,316
2022-05-15,Yuba,115,75493,16112,16028,1258,17286,122
2022-05-14,Alameda,001,1643700,272507,268944,15087,284031,1857
2022-05-14,Alpine,003,1148,125,125,1,126,0
2022-05-14,Amador,005,37829,8630,8574,669,9243,86
2022-05-14,Butte,007,227075,33491,33377,6801,40178,424
2022-05-14,Calaveras,009,45235,7401,7378,376,7754,120
2022-05-14,Colusa,011,21464,3467,3463,1082,4545,21
2022-05-14,Contra Costa,013,1133247,198229,195925,14033,209958,1301
2022-05-14,Del Norte,015,27424,6001,5919,213,6132,50
2022-05-14,El Dorado,017,186661,27379,27216,3292,30508,212
2022-05-14,Fresno,019,978130,234042,233305,24301,257606,2757
2022-05-14,Glenn,021,27897,5011,5004,1626,6630,48
2022-05-14,Humboldt,023,135768,17862,17633,3149,20782,146
2022-05-14,Imperial,025,180216,55913,55756,10959,66715,917
2022-05-14,Inyo,027,18085,4121,4114,522,4636,56
2022-05-14,Kern,029,883053,193398,192939,46863,239802,2314
2022-05-14,Kings,031,150075,51903,51779,3644,55423,447
2022-05-14,Lake,033,64148,10831,10790,909,11699,137
2022-05-14,Lassen,035,31185,8994,8987,891,9878,65
2022-05-14,Los Angeles,037,10098052,2780069,2768726,129578,2898304,31768
2022-05-14,Madera,039,155013,37665,37520,6163,43683,365
2022-05-14,Marin,041,260295,35986,35486,3199,38685,293
2022-05-14,Mariposa,043,17540,2482,2463,211,2674,30
2022-05-14,Mendocino,045,87422,13402,13349,3215,16564,124
2022-05-14,Merced,047,269075,62812,62627,8870,71497,818
2022-05-14,Modoc,049,8938,748,747,253,1000,8
2022-05-14,Mono,051,14174,3010,3002,142,3144,6
2022-05-14,Monterey,053,433212,81039,80620,14518,95138,735
2022-05-14,Napa,055,140530,26912,26698,1066,27764,143
2022-05-14,Nevada,057,99092,16352,16240,1263,17503,127
2022-05-14,Orange,059,3164182,560054,557134,43244,600378,7017
2022-05-14,Placer,061,380077,64442,63963,7564,71527,626
2022-05-14,Plumas,063,18699,3021,3006,373,3379,13
2022-05-14,Riverside,065,2383286,599946,597914,28778,626692,6471
2022-05-14,Sacramento,067,1510023,288312,286403,28005,314408,3022
2022-05-14,San Benito,069,59416,13184,13106,530,13636,98
2022-05-14,San Bernardino,071,2135413,573788,572057,25300,597357,7423
2022-05-14,San Diego,073,3302833,773830,770323,54200,824523,5271
2022-05-14,San Francisco,075,870044,137267,134916,9040,143956,866
2022-05-14,San Joaquin,077,732212,169058,168174,10325,178499,2236
2022-05-14,San Luis Obispo,079,281455,53743,53502,4053,57555,478
2022-05-14,San Mateo,081,765935,131303,129480,7758,137238,709
2022-05-14,Santa Barbara,083,443738,88324,87773,4909,92682,693
2022-05-14,Santa Clara,085,1922200,333188,328609,13406,342015,2297
2022-05-14,Santa Cruz,087,273765,51029,50268,2264,52532,263
2022-05-14,Shasta,089,179085,30902,30799,6189,36988,557
2022-05-14,Sierra,091,2930,275,275,49,324,4
2022-05-14,Siskiyou,093,43540,4496,4482,2793,7275,81
2022-05-14,Solano,095,438530,84521,83669,5743,89412,451
2022-05-14,Sonoma,097,501317,88174,87070,3119,90189,488
2022-05-14,Stanislaus,099,539301,118995,118586,17648,136234,1645
2022-05-14,Sutter,101,95872,20751,20690,2177,22867,226
2022-05-14,Tehama,103,63373,12129,12115,2638,14753,201
2022-05-14,Trinity,105,12862,1189,1188,296,1484,20
2022-05-14,Tulare,107,460477,107314,107077,29048,136125,1469
2022-05-14,Tuolumne,109,53932,12910,12851,587,13438,182
2022-05-14,Ventura,111,848112,177210,176317,9744,186061,1497
2022-05-14,Yolo,113,214977,38121,37737,3321,41058,316
2022-05-14,Yuba,115,75493,16109,16028,1258,17286,122
2022-05-13,Alameda,001,1643700,272308,268944,15087,284031,1857
2022-05-13,Alpine,003,1148,125,125,1,126,0
2022-05-13,Amador,005,37829,8630,8574,669,9243,86
2022-05-13,Butte,007,227075,33489,33377,6801,40178,424
2022-05-13,Calaveras,009,45235,7401,7378,376,7754,120
2022-05-13,Colusa,011,21464,3467,3463,1082,4545,21
2022-05-13,Contra Costa,013,1133247,198061,195925,14033,209958,1301
2022-05-13,Del Norte,015,27424,5999,5919,213,6132,50
2022-05-13,El Dorado,017,186661,27369,27216,3292,30508,212
2022-05-13,Fresno,019,978130,233983,233305,24301,257606,2757
2022-05-13,Glenn,021,27897,5011,5004,1626,6630,48
2022-05-13,Humboldt,023,135768,17859,17633,3149,20782,146
2022-05-13,Imperial,025,180216,55911,55756,10959,66715,917
2022-05-13,Inyo,027,18085,4121,4114,522,4636,56
2022-05-13,Kern,029,883053,193381,192939,46863,239802,2314
2022-05-13,Kings,031,150075,51893,51779,3644,55423,447
2022-05-13,Lake,033,64148,10831,10790,909,11699,137
2022-05-13,Lassen,035,31185,8994,8987,891,9878,65
2022-05-13,Los Angeles,037,10098052,2779487,2768726,129578,2898304,31768
2022-05-13,Madera,039,155013,37660,37520,6163,43683,365
2022-05-13,Marin,041,260295,35929,35486,3199,38685,293
2022-05-13,Mariposa,043,17540,2482,2463,211,2674,30
2022-05-13,Mendocino,045,87422,13399,13349,3215,16564,124
2022-05-13,Merced,047,269075,62801,62627,8870,71497,818
2022-05-13,Modoc,049,8938,748,747,253,1000,8
2022-05-13,Mono,051,14174,3008,3002,142,3144,6
2022-05-13,Monterey,053,433212,81017,80620,14518,95138,735
2022-05-13,Napa,055,140530,26893,26698,1066,27764,143
2022-05-13,Nevada,057,99092,16349,16240,1263,17503,127
2022-05-13,Orange,059,3164182,559931,557134,43244,600378,7017
2022-05-13,Placer,061,380077,64407,63963,7564,71527,626
2022-05-13,Plumas,063,18699,3019,3006,373,3379,13
2022-05-13,Riverside,065,2383286,599803,597914,28778,626692,6471
2022-05-13,Sacramento,067,1510023,288187,286403,28005,314408,3022
2022-05-13,San Benito,069,59416,13181,13106,530,13636,98
2022-05-13,San Bernardino,071,2135413,573745,572057,25300,597357,7423
2022-05-13,San Diego,073,3302833,773538,770323,54200,824523,5271
2022-05-13,San Francisco,075,870044,137035,134916,9040,143956,866
2022-05-13,San Joaquin,077,732212,169013,168174,10325,178499,2236
2022-05-13,San Luis Obispo,079,281455,53727,53502,4053,57555,478
2022-05-13,San Mateo,081,765935,131174,129480,7758,137238,709
2022-05-13,Santa Barbara,083,443738,88274,87773,4909,92682,693
2022-05-13,Santa Clara,085,1922200,332722,328609,13406,342015,2297
2022-05-13,Santa Cruz,087,273765,51006,50268,2264,52532,263
2022-05-13,Shasta,089,179085,30902,30799,6189,36988,557
2022-05-13,Sierra,091,2930,275,275,49,324,4
2022-05-13,Siskiyou,093,43540,4494,4482,2793,7275,81
2022-05-13,Solano,095,438530,84441,83669,5743,89412,451
2022-05-13,Sonoma,097,501317,88093,87070,3119,90189,488
2022-05-13,Stanislaus,099,539301,118944,118586,17648,136234,1645
2022-05-13,Sutter,101,95872,20743,20690,2177,22867,226
2022-05-13,Tehama,103,63373,12129,12115,2638,14753,201
2022-05-13,Trinity,105,12862,1188,1188,296,1484,20
2022-05-13,Tulare,107,460477,107294,107077,29048,136125,1469
2022-05-13,Tuolumne,109,53932,12905,12851,587,13438,182
2022-05-13,Ventura,111,848112,177149,176317,9744,186061,1497
2022-05-13,Yolo,113,214977,38094,37737,3321,41058,316
2022-05-13,Yuba,115,75493,16100,16028,1258,17286,122
2022-05-12,Alameda,001,1643700,271662,268944,15087,284031,1857
2022-05-12,Alpine,003,1148,125,125,1,126,0
2022-05-12,Amador,005,37829,8628,8574,669,9243,86
2022-05-12,Butte,007,227075,33472,33377,6801,40178,424
2022-05-12,Calaveras,009,45235,7394,7378,376,7754,120
2022-05-12,Colusa,011,21464,3465,3463,1082,4545,21
2022-05-12,Contra Costa,013,1133247,197643,195925,14033,209958,1301
2022-05-12,Del Norte,015,27424,5996,5919,213,6132,50
2022-05-12,El Dorado,017,186661,27338,27216,3292,30508,212
2022-05-12,Fresno,019,978130,233861,233305,24301,257606,2757
2022-05-12,Glenn,021,27897,5009,5004,1626,6630,48
2022-05-12,Humboldt,023,135768,17827,17633,3149,20782,146
2022-05-12,Imperial,025,180216,55898,55756,10959,66715,917
2022-05-12,Inyo,027,18085,4118,4114,522,4636,56
2022-05-12,Kern,029,883053,193329,192939,46863,239802,2314
2022-05-12,Kings,031,150075,51873,51779,3644,55423,447
2022-05-12,Lake,033,64148,10820,10790,909,11699,137
2022-05-12,Lassen,035,31185,8993,8987,891,9878,65
2022-05-12,Los Angeles,037,10098052,2777348,2768726,129578,2898304,31768
2022-05-12,Madera,039,155013,37637,37520,6163,43683,365
2022-05-12,Marin,041,260295,35851,35486,3199,38685,293
2022-05-12,Mariposa,043,17540,2480,2463,211,2674,30
2022-05-12,Mendocino,045,87422,13391,13349,3215,16564,124
2022-05-12,Merced,047,269075,62775,62627,8870,71497,818
2022-05-12,Modoc,049,8938,748,747,253,1000,8
2022-05-12,Mono,051,14174,3007,3002,142,3144,6
2022-05-12,Monterey,053,433212,80968,80620,14518,95138,735
2022-05-12,Napa,055,140530,26852,26698,1066,27764,143
2022-05-12,Nevada,057,99092,16329,16240,1263,17503,127
2022-05-12,Orange,059,3164182,559449,557134,43244,600378,7017
2022-05-12,Placer,061,380077,64341,63963,7564,71527,626
2022-05-12,Plumas,063,18699,3017,3006,373,3379,13
2022-05-12,Riverside,065,2383286,599460,597914,28778,626692,6471
2022-05-12,Sacramento,067,1510023,287835,286403,28005,314408,3022
2022-05-12,San Benito,069,59416,13166,13106,530,13636,98
2022-05-12,San Bernardino,071,2135413,573491,572057,25300,597357,7423
2022-05-12,San Diego,073,3302833,772840,770323,54200,824523,5271
2022-05-12,San Francisco,075,870044,136759,134916,9040,143956,866
2022-05-12,San Joaquin,077,732212,168868,168174,10325,178499,2236
2022-05-12,San Luis Obispo,079,281455,53686,53502,4053,57555,478
2022-05-12,San Mateo,081,765935,130862,129480,7758,137238,709
2022-05-12,Santa Barbara,083,443738,88186,87773,4909,92682,693
2022-05-12,Santa Clara,085,1922200,332001,328609,13406,342015,2297
2022-05-12,Santa Cruz,087,273765,50845,50268,2264,52532,263
2022-05-12,Shasta,089,179085,30894,30799,6189,36988,557
2022-05-12,Sierra,091,2930,275,275,49,324,4
2022-05-12,Siskiyou,093,43540,4491,4482,2793,7275,81
2022-05-12,Solano,095,438530,84277,83669,5743,89412,451
2022-05-12,Sonoma,097,501317,87917,87070,3119,90189,488
2022-05-12,Stanislaus,099,539301,118869,118586,17648,136234,1645
2022-05-12,Sutter,101,95872,20730,20690,2177,22867,226
2022-05-12,Tehama,103,63373,12125,12115,2638,14753,201
2022-05-12,Trinity,105,12862,1188,1188,296,1484,20
2022-05-12,Tulare,107,460477,107268,107077,29048,136125,1469
2022-05-12,Tuolumne,109,53932,12887,12851,587,13438,182
2022-05-12,Ventura,111,848112,177020,176317,9744,186061,1497
2022-05-12,Yolo,113,214977,38039,37737,3321,41058,316
2022-05-12,Yuba,115,75493,16086,16028,1258,17286,122
2022-05-11,Alameda,001,1643700,270997,267982,15087,283069,1853
2022-05-11,Alpine,003,1148,125,125,1,126,0
2022-05-11,Amador,005,37829,8625,8564,669,9233,86
2022-05-11,Butte,007,227075,33435,33339,6801,40140,423
2022-05-11,Calaveras,009,45235,7388,7368,376,7744,120
2022-05-11,Colusa,011,21464,3464,3462,1082,4544,21
2022-05-11,Contra Costa,013,1133247,197202,195153,14033,209186,1302
2022-05-11,Del Norte,015,27424,5988,5911,213,6124,50
2022-05-11,El Dorado,017,186661,27312,27172,3292,30464,212
2022-05-11,Fresno,019,978130,233723,233021,24301,257322,2754
2022-05-11,Glenn,021,27897,5009,5001,1626,6627,48
2022-05-11,Humboldt,023,135768,17783,17585,3149,20734,146
2022-05-11,Imperial,025,180216,55877,55751,10959,66710,917
2022-05-11,Inyo,027,18085,4118,4093,522,4615,56
2022-05-11,Kern,029,883053,193262,192795,46863,239658,2292
2022-05-11,Kings,031,150075,51852,51752,3644,55396,447
2022-05-11,Lake,033,64148,10812,10786,909,11695,137
2022-05-11,Lassen,035,31185,8993,8984,891,9875,65
2022-05-11,Los Angeles,037,10098052,2774781,2761410,129578,2890988,31747
2022-05-11,Madera,039,155013,37610,37496,6163,43659,365
2022-05-11,Marin,041,260295,35778,35336,3199,38535,292
2022-05-11,Mariposa,043,17540,2476,2461,211,2672,30
2022-05-11,Mendocino,045,87422,13378,13320,3215,16535,124
2022-05-11,Merced,047,269075,62746,62567,8870,71437,818
2022-05-11,Modoc,049,8938,747,747,253,1000,8
2022-05-11,Mono,051,14174,3007,2999,142,3141,6
2022-05-11,Monterey,053,433212,80921,80534,14518,95052,733
2022-05-11,Napa,055,140530,26819,26660,1066,27726,143
2022-05-11,Nevada,057,99092,16315,16230,1263,17493,127
2022-05-11,Orange,059,3164182,558882,556265,43244,599509,7009
2022-05-11,Placer,061,380077,64272,63823,7564,71387,625
2022-05-11,Plumas,063,18699,3015,2998,373,3371,13
2022-05-11,Riverside,065,2383286,599152,597302,28778,626080,6468
2022-05-11,Sacramento,067,1510023,287489,285799,28005,313804,3020
2022-05-11,San Benito,069,59416,13147,13088,530,13618,98
2022-05-11,San Bernardino,071,2135413,573205,571372,25300,596672,7354
2022-05-11,San Diego,073,3302833,771977,768135,54200,822335,5257
2022-05-11,San Francisco,075,870044,136369,134027,9040,143067,864
2022-05-11,San Joaquin,077,732212,168746,167949,10325,178274,2233
2022-05-11,San Luis Obispo,079,281455,53646,53420,4053,57473,478
2022-05-11,San Mateo,081,765935,130564,128821,7758,136579,711
2022-05-11,Santa Barbara,083,443738,88093,87593,4909,92502,693
2022-05-11,Santa Clara,085,1922200,331293,327177,13406,340583,2294
2022-05-11,Santa Cruz,087,273765,50736,50031,2264,52295,263
2022-05-11,Shasta,089,179085,30872,30768,6189,36957,564
2022-05-11,Sierra,091,2930,275,275,49,324,4
2022-05-11,Siskiyou,093,43540,4489,4478,2793,7271,81
2022-05-11,Solano,095,438530,84129,83464,5743,89207,450
2022-05-11,Sonoma,097,501317,87769,86798,3119,89917,488
2022-05-11,Stanislaus,099,539301,118803,118445,17648,136093,1644
2022-05-11,Sutter,101,95872,20716,20668,2177,22845,225
2022-05-11,Tehama,103,63373,12125,12106,2638,14744,201
2022-05-11,Trinity,105,12862,1187,1188,296,1484,20
2022-05-11,Tulare,107,460477,107227,107068,29048,136116,1468
2022-05-11,Tuolumne,109,53932,12877,12829,587,13416,181
2022-05-11,Ventura,111,848112,176879,175955,9744,185699,1491
2022-05-11,Yolo,113,214977,37981,37654,3321,40975,316
2022-05-11,Yuba,115,75493,16068,15997,1258,17255,122
2022-05-10,Alameda,001,1643700,270338,267982,15087,283069,1853
2022-05-10,Alpine,003,1148,125,125,1,126,0
2022-05-10,Amador,005,37829,8625,8564,669,9233,86
2022-05-10,Butte,007,227075,33412,33339,6801,40140,423
2022-05-10,Calaveras,009,45235,7387,7368,376,7744,120
2022-05-10,Colusa,011,21464,3464,3462,1081,4543,21
2022-05-10,Contra Costa,013,1133247,196740,195153,14033,209186,1302
2022-05-10,Del Norte,015,27424,5936,5911,212,6123,50
2022-05-10,El Dorado,017,186661,27283,27172,3292,30464,212
2022-05-10,Fresno,019,978130,233622,233021,24301,257322,2754
2022-05-10,Glenn,021,27897,5007,5001,1626,6627,48
2022-05-10,Humboldt,023,135768,17754,17585,3149,20734,146
2022-05-10,Imperial,025,180216,55850,55751,10959,66710,917
2022-05-10,Inyo,027,18085,4117,4093,520,4613,56
2022-05-10,Kern,029,883053,193175,192795,46859,239654,2292
2022-05-10,Kings,031,150075,51825,51752,3644,55396,447
2022-05-10,Lake,033,64148,10808,10786,909,11695,137
2022-05-10,Lassen,035,31185,8990,8984,891,9875,65
2022-05-10,Los Angeles,037,10098052,2771873,2761410,129576,2890986,31747
2022-05-10,Madera,039,155013,37586,37496,6163,43659,365
2022-05-10,Marin,041,260295,35682,35336,3159,38495,292
2022-05-10,Mariposa,043,17540,2476,2461,211,2672,30
2022-05-10,Mendocino,045,87422,13375,13320,3215,16535,124
2022-05-10,Merced,047,269075,62705,62567,8866,71433,818
2022-05-10,Modoc,049,8938,747,747,253,1000,8
2022-05-10,Mono,051,14174,3004,2999,140,3139,6
2022-05-10,Monterey,053,433212,80878,80534,14513,95047,733
2022-05-10,Napa,055,140530,26795,26660,1066,27726,143
2022-05-10,Nevada,057,99092,16304,16230,1263,17493,127
2022-05-10,Orange,059,3164182,558232,556265,43244,599509,7009
2022-05-10,Placer,061,380077,64169,63823,7564,71387,625
2022-05-10,Plumas,063,18699,3010,2998,373,3371,13
2022-05-10,Riverside,065,2383286,598832,597302,28778,626080,6468
2022-05-10,Sacramento,067,1510023,287053,285799,28004,313803,3020
2022-05-10,San Benito,069,59416,13130,13088,530,13618,98
2022-05-10,San Bernardino,071,2135413,572945,571372,25298,596670,7354
2022-05-10,San Diego,073,3302833,771010,768135,54132,822267,5257
2022-05-10,San Francisco,075,870044,135892,134027,9040,143067,864
2022-05-10,San Joaquin,077,732212,168641,167949,10253,178202,2233
2022-05-10,San Luis Obispo,079,281455,53580,53420,4053,57473,478
2022-05-10,San Mateo,081,765935,130242,128821,7758,136579,711
2022-05-10,Santa Barbara,083,443738,88000,87593,4909,92502,693
2022-05-10,Santa Clara,085,1922200,330414,327177,13406,340583,2294
2022-05-10,Santa Cruz,087,273765,50635,50031,2264,52295,263
2022-05-10,Shasta,089,179085,30855,30768,6189,36957,564
2022-05-10,Sierra,091,2930,275,275,49,324,4
2022-05-10,Siskiyou,093,43540,4488,4478,2793,7271,81
2022-05-10,Solano,095,438530,83981,83464,5743,89207,450
2022-05-10,Sonoma,097,501317,87567,86798,3119,89917,488
2022-05-10,Stanislaus,099,539301,118733,118445,17643,136088,1644
2022-05-10,Sutter,101,95872,20703,20668,2177,22845,225
2022-05-10,Tehama,103,63373,12122,12106,2638,14744,201
2022-05-10,Trinity,105,12862,1187,1188,296,1484,20
2022-05-10,Tulare,107,460477,107204,107068,29040,136108,1468
2022-05-10,Tuolumne,109,53932,12871,12829,587,13416,181
2022-05-10,Ventura,111,848112,176716,175955,9734,185689,1491
2022-05-10,Yolo,113,214977,37920,37654,3321,40975,316
2022-05-10,Yuba,115,75493,16049,15997,1258,17255,122
2022-05-09,Alameda,001,1643700,269722,267982,15087,283069,1853
2022-05-09,Alpine,003,1148,125,125,1,126,0
2022-05-09,Amador,005,37829,8620,8564,669,9233,86
2022-05-09,Butte,007,227075,33387,33339,6801,40140,423
2022-05-09,Calaveras,009,45235,7382,7368,376,7744,120
2022-05-09,Colusa,011,21464,3463,3462,1079,4541,21
2022-05-09,Contra Costa,013,1133247,196291,195153,14033,209186,1302
2022-05-09,Del Norte,015,27424,5929,5911,212,6123,50
2022-05-09,El Dorado,017,186661,27251,27172,3292,30464,212
2022-05-09,Fresno,019,978130,233502,233021,24301,257322,2754
2022-05-09,Glenn,021,27897,5005,5001,1626,6627,48
2022-05-09,Humboldt,023,135768,17712,17585,3149,20734,146
2022-05-09,Imperial,025,180216,55822,55751,10959,66710,917
2022-05-09,Inyo,027,18085,4114,4093,520,4613,56
2022-05-09,Kern,029,883053,193095,192795,46826,239621,2292
2022-05-09,Kings,031,150075,51798,51752,3644,55396,447
2022-05-09,Lake,033,64148,10800,10786,909,11695,137
2022-05-09,Lassen,035,31185,8988,8984,891,9875,65
2022-05-09,Los Angeles,037,10098052,2768748,2761410,129424,2890834,31747
2022-05-09,Madera,039,155013,37560,37496,6163,43659,365
2022-05-09,Marin,041,260295,35585,35336,3139,38475,292
2022-05-09,Mariposa,043,17540,2473,2461,211,2672,30
2022-05-09,Mendocino,045,87422,13366,13320,3215,16535,124
2022-05-09,Merced,047,269075,62675,62567,8865,71432,818
2022-05-09,Modoc,049,8938,747,747,253,1000,8
2022-05-09,Mono,051,14174,3003,2999,140,3139,6
2022-05-09,Monterey,053,433212,80808,80534,14510,95044,733
2022-05-09,Napa,055,140530,26758,26660,1066,27726,143
2022-05-09,Nevada,057,99092,16281,16230,1262,17492,127
2022-05-09,Orange,059,3164182,557619,556265,43243,599508,7009
2022-05-09,Placer,061,380077,64119,63823,7564,71387,625
2022-05-09,Plumas,063,18699,3000,2998,373,3371,13
2022-05-09,Riverside,065,2383286,598431,597302,28778,626080,6468
2022-05-09,Sacramento,067,1510023,286680,285799,28002,313801,3020
2022-05-09,San Benito,069,59416,13112,13088,530,13618,98
2022-05-09,San Bernardino,071,2135413,572682,571372,25298,596670,7354
2022-05-09,San Diego,073,3302833,770081,768135,54013,822148,5257
2022-05-09,San Francisco,075,870044,135409,134027,9039,143066,864
2022-05-09,San Joaquin,077,732212,168480,167949,10245,178194,2233
2022-05-09,San Luis Obispo,079,281455,53533,53420,4035,57455,478
2022-05-09,San Mateo,081,765935,129860,128821,7758,136579,711
2022-05-09,Santa Barbara,083,443738,87892,87593,4908,92501,693
2022-05-09,Santa Clara,085,1922200,329371,327177,13406,340583,2294
2022-05-09,Santa Cruz,087,273765,50509,50031,2263,52294,263
2022-05-09,Shasta,089,179085,30841,30768,6189,36957,564
2022-05-09,Sierra,091,2930,275,275,49,324,4
2022-05-09,Siskiyou,093,43540,4486,4478,2793,7271,81
2022-05-09,Solano,095,438530,83841,83464,5743,89207,450
2022-05-09,Sonoma,097,501317,87345,86798,3117,89915,488
2022-05-09,Stanislaus,099,539301,118651,118445,17621,136066,1644
2022-05-09,Sutter,101,95872,20690,20668,2177,22845,225
2022-05-09,Tehama,103,63373,12120,12106,2638,14744,201
2022-05-09,Trinity,105,12862,1187,1188,296,1484,20
2022-05-09,Tulare,107,460477,107172,107068,29036,136104,1468
2022-05-09,Tuolumne,109,53932,12864,12829,587,13416,181
2022-05-09,Ventura,111,848112,176526,175955,9727,185682,1491
2022-05-09,Yolo,113,214977,37848,37654,3321,40975,316
2022-05-09,Yuba,115,75493,16043,15997,1258,17255,122
2022-05-08,Alameda,001,1643700,268940,265198,15087,280285,1855
2022-05-08,Alpine,003,1148,125,125,1,126,0
2022-05-08,Amador,005,37829,8613,8556,669,9225,86
2022-05-08,Butte,007,227075,33367,33269,6801,40070,421
2022-05-08,Calaveras,009,45235,7379,7353,376,7729,120
2022-05-08,Colusa,011,21464,3462,3459,1079,4538,21
2022-05-08,Contra Costa,013,1133247,195833,193961,14032,207993,1302
2022-05-08,Del Norte,015,27424,5917,5884,212,6096,50
2022-05-08,El Dorado,017,186661,27218,27081,3291,30372,210
2022-05-08,Fresno,019,978130,233360,232655,24301,256956,2754
2022-05-08,Glenn,021,27897,5002,4996,1626,6622,48
2022-05-08,Humboldt,023,135768,17669,17410,3148,20558,146
2022-05-08,Imperial,025,180216,55792,55683,10958,66641,917
2022-05-08,Inyo,027,18085,4107,4087,520,4607,56
2022-05-08,Kern,029,883053,193011,192590,46798,239388,2287
2022-05-08,Kings,031,150075,51783,51702,3644,55346,447
2022-05-08,Lake,033,64148,10796,10766,909,11675,137
2022-05-08,Lassen,035,31185,8984,8978,891,9869,65
2022-05-08,Los Angeles,037,10098052,2765492,2751478,129232,2880710,31738
2022-05-08,Madera,039,155013,37540,37420,6163,43583,365
2022-05-08,Marin,041,260295,35479,34934,3107,38041,292
2022-05-08,Mariposa,043,17540,2466,2438,211,2649,30
2022-05-08,Mendocino,045,87422,13351,13270,3215,16485,124
2022-05-08,Merced,047,269075,62634,62471,8865,71336,818
2022-05-08,Modoc,049,8938,747,745,253,998,8
2022-05-08,Mono,051,14174,3002,2997,138,3135,6
2022-05-08,Monterey,053,433212,80744,80246,14499,94745,733
2022-05-08,Napa,055,140530,26729,26524,1066,27590,143
2022-05-08,Nevada,057,99092,16262,16171,1262,17433,127
2022-05-08,Orange,059,3164182,556974,554411,43243,597654,7007
2022-05-08,Placer,061,380077,64012,63577,7563,71140,625
2022-05-08,Plumas,063,18699,2998,2996,373,3369,13
2022-05-08,Riverside,065,2383286,598021,596022,28777,624799,6467
2022-05-08,Sacramento,067,1510023,286198,284564,28002,312566,3016
2022-05-08,San Benito,069,59416,13098,13047,530,13577,98
2022-05-08,San Bernardino,071,2135413,572303,570381,25296,595677,7306
2022-05-08,San Diego,073,3302833,769095,765377,53913,819290,5244
2022-05-08,San Francisco,075,870044,134790,132659,9039,141698,861
2022-05-08,San Joaquin,077,732212,168312,167568,10123,177691,2229
2022-05-08,San Luis Obispo,079,281455,53467,53273,4015,57288,477
2022-05-08,San Mateo,081,765935,129436,127615,7756,135371,709
2022-05-08,Santa Barbara,083,443738,87775,87305,4908,92213,692
2022-05-08,Santa Clara,085,1922200,328374,324946,13405,338351,2287
2022-05-08,Santa Cruz,087,273765,50344,49605,2260,51865,262
2022-05-08,Shasta,089,179085,30814,30721,6189,36910,563
2022-05-08,Sierra,091,2930,275,275,49,324,4
2022-05-08,Siskiyou,093,43540,4484,4470,2792,7262,81
2022-05-08,Solano,095,438530,83672,83038,5743,88781,450
2022-05-08,Sonoma,097,501317,87133,86150,3111,89261,488
2022-05-08,Stanislaus,099,539301,118552,118235,17600,135835,1643
2022-05-08,Sutter,101,95872,20669,20694,2173,22867,225
2022-05-08,Tehama,103,63373,12114,12098,2638,14736,201
2022-05-08,Trinity,105,12862,1187,1180,296,1476,20
2022-05-08,Tulare,107,460477,107140,106987,29032,136019,1468
2022-05-08,Tuolumne,109,53932,12852,12793,587,13380,181
2022-05-08,Ventura,111,848112,176310,175454,9708,185162,1491
2022-05-08,Yolo,113,214977,37788,37456,3321,40777,315
2022-05-08,Yuba,115,75493,16022,15964,1254,17218,122
2022-05-07,Alameda,001,1643700,268630,265198,15084,280282,1855
2022-05-07,Alpine,003,1148,125,125,1,126,0
2022-05-07,Amador,005,37829,8611,8556,669,9225,86
2022-05-07,Butte,007,227075,33359,33269,6799,40068,421
2022-05-07,Calaveras,009,45235,7373,7353,376,7729,120
2022-05-07,Colusa,011,21464,3462,3459,1079,4538,21
2022-05-07,Contra Costa,013,1133247,195625,193961,14025,207986,1302
2022-05-07,Del Norte,015,27424,5915,5884,212,6096,50
2022-05-07,El Dorado,017,186661,27203,27081,3291,30372,210
2022-05-07,Fresno,019,978130,233311,232655,24299,256954,2754
2022-05-07,Glenn,021,27897,5001,4996,1626,6622,48
2022-05-07,Humboldt,023,135768,17646,17410,3147,20557,146
2022-05-07,Imperial,025,180216,55769,55683,10958,66641,917
2022-05-07,Inyo,027,18085,4104,4087,520,4607,56
2022-05-07,Kern,029,883053,192985,192590,46783,239373,2287
2022-05-07,Kings,031,150075,51773,51702,3643,55345,447
2022-05-07,Lake,033,64148,10794,10766,909,11675,137
2022-05-07,Lassen,035,31185,8984,8978,891,9869,65
2022-05-07,Los Angeles,037,10098052,2764329,2751478,129119,2880597,31738
2022-05-07,Madera,039,155013,37535,37420,6163,43583,365
2022-05-07,Marin,041,260295,35417,34934,3083,38017,292
2022-05-07,Mariposa,043,17540,2463,2438,211,2649,30
2022-05-07,Mendocino,045,87422,13344,13270,3214,16484,124
2022-05-07,Merced,047,269075,62626,62471,8865,71336,818
2022-05-07,Modoc,049,8938,747,745,253,998,8
2022-05-07,Mono,051,14174,3002,2997,138,3135,6
2022-05-07,Monterey,053,433212,80696,80246,14485,94731,733
2022-05-07,Napa,055,140530,26703,26524,1066,27590,143
2022-05-07,Nevada,057,99092,16252,16171,1257,17428,127
2022-05-07,Orange,059,3164182,556670,554411,43203,597614,7007
2022-05-07,Placer,061,380077,63951,63577,7562,71139,625
2022-05-07,Plumas,063,18699,2998,2996,373,3369,13
2022-05-07,Riverside,065,2383286,597798,596022,28769,624791,6467
2022-05-07,Sacramento,067,1510023,286024,284564,28000,312564,3016
2022-05-07,San Benito,069,59416,13089,13047,530,13577,98
2022-05-07,San Bernardino,071,2135413,572121,570381,25296,595677,7306
2022-05-07,San Diego,073,3302833,768648,765377,53889,819266,5244
2022-05-07,San Francisco,075,870044,134480,132659,9034,141693,861
2022-05-07,San Joaquin,077,732212,168222,167568,10118,177686,2229
2022-05-07,San Luis Obispo,079,281455,53453,53273,4009,57282,477
2022-05-07,San Mateo,081,765935,129174,127615,7750,135365,709
2022-05-07,Santa Barbara,083,443738,87701,87305,4908,92213,692
2022-05-07,Santa Clara,085,1922200,327796,324946,13400,338346,2287
2022-05-07,Santa Cruz,087,273765,50298,49605,2257,51862,262
2022-05-07,Shasta,089,179085,30807,30721,6189,36910,563
2022-05-07,Sierra,091,2930,275,275,49,324,4
2022-05-07,Siskiyou,093,43540,4482,4470,2792,7262,81
2022-05-07,Solano,095,438530,83617,83038,5741,88779,450
2022-05-07,Sonoma,097,501317,87026,86150,3105,89255,488
2022-05-07,Stanislaus,099,539301,118504,118235,17594,135829,1643
2022-05-07,Sutter,101,95872,20660,20694,2173,22867,225
2022-05-07,Tehama,103,63373,12113,12098,2637,14735,201
2022-05-07,Trinity,105,12862,1187,1180,296,1476,20
2022-05-07,Tulare,107,460477,107122,106987,29027,136014,1468
2022-05-07,Tuolumne,109,53932,12847,12793,587,13380,181
2022-05-07,Ventura,111,848112,176218,175454,9704,185158,1491
2022-05-07,Yolo,113,214977,37754,37456,3321,40777,315
2022-05-07,Yuba,115,75493,16013,15964,1252,17216,122
2022-05-06,Alameda,001,1643700,268297,265198,15073,280271,1855
2022-05-06,Alpine,003,1148,125,125,1,126,0
2022-05-06,Amador,005,37829,8611,8556,668,9224,86
2022-05-06,Butte,007,227075,33351,33269,6799,40068,421
2022-05-06,Calaveras,009,45235,7371,7353,376,7729,120
2022-05-06,Colusa,011,21464,3462,3459,1079,4538,21
2022-05-06,Contra Costa,013,1133247,195415,193961,14017,207978,1302
2022-05-06,Del Norte,015,27424,5906,5884,212,6096,50
2022-05-06,El Dorado,017,186661,27182,27081,3289,30370,210
2022-05-06,Fresno,019,978130,233242,232655,24293,256948,2754
2022-05-06,Glenn,021,27897,5001,4996,1626,6622,48
2022-05-06,Humboldt,023,135768,17623,17410,3147,20557,146
2022-05-06,Imperial,025,180216,55761,55683,10958,66641,917
2022-05-06,Inyo,027,18085,4095,4087,520,4607,56
2022-05-06,Kern,029,883053,192942,192590,46762,239352,2287
2022-05-06,Kings,031,150075,51766,51702,3643,55345,447
2022-05-06,Lake,033,64148,10792,10766,909,11675,137
2022-05-06,Lassen,035,31185,8984,8978,891,9869,65
2022-05-06,Los Angeles,037,10098052,2762822,2751478,129017,2880495,31738
2022-05-06,Madera,039,155013,37527,37420,6163,43583,365
2022-05-06,Marin,041,260295,35345,34934,3041,37975,292
2022-05-06,Mariposa,043,17540,2461,2438,211,2649,30
2022-05-06,Mendocino,045,87422,13336,13270,3213,16483,124
2022-05-06,Merced,047,269075,62610,62471,8864,71335,818
2022-05-06,Modoc,049,8938,747,745,253,998,8
2022-05-06,Mono,051,14174,3001,2997,138,3135,6
2022-05-06,Monterey,053,433212,80662,80246,14477,94723,733
2022-05-06,Napa,055,140530,26687,26524,1066,27590,143
2022-05-06,Nevada,057,99092,16243,16171,1255,17426,127
2022-05-06,Orange,059,3164182,556341,554411,43140,597551,7007
2022-05-06,Placer,061,380077,63896,63577,7560,71137,625
2022-05-06,Plumas,063,18699,2998,2996,373,3369,13
2022-05-06,Riverside,065,2383286,597584,596022,28755,624777,6467
2022-05-06,Sacramento,067,1510023,285779,284564,27992,312556,3016
2022-05-06,San Benito,069,59416,13085,13047,530,13577,98
2022-05-06,San Bernardino,071,2135413,571959,570381,25293,595674,7306
2022-05-06,San Diego,073,3302833,768156,765377,53866,819243,5244
2022-05-06,San Francisco,075,870044,134182,132659,9012,141671,861
2022-05-06,San Joaquin,077,732212,168137,167568,10115,177683,2229
2022-05-06,San Luis Obispo,079,281455,53429,53273,4007,57280,477
2022-05-06,San Mateo,081,765935,128967,127615,7744,135359,709
2022-05-06,Santa Barbara,083,443738,87653,87305,4907,92212,692
2022-05-06,Santa Clara,085,1922200,327222,324946,13391,338337,2287
2022-05-06,Santa Cruz,087,273765,50238,49605,2255,51860,262
2022-05-06,Shasta,089,179085,30801,30721,6189,36910,563
2022-05-06,Sierra,091,2930,275,275,49,324,4
2022-05-06,Siskiyou,093,43540,4482,4470,2792,7262,81
2022-05-06,Solano,095,438530,83541,83038,5733,88771,450
2022-05-06,Sonoma,097,501317,86914,86150,3093,89243,488
2022-05-06,Stanislaus,099,539301,118451,118235,17592,135827,1643
2022-05-06,Sutter,101,95872,20654,20694,2173,22867,225
2022-05-06,Tehama,103,63373,12108,12098,2637,14735,201
2022-05-06,Trinity,105,12862,1186,1180,296,1476,20
2022-05-06,Tulare,107,460477,107105,106987,29023,136010,1468
2022-05-06,Tuolumne,109,53932,12840,12793,587,13380,181
2022-05-06,Ventura,111,848112,176111,175454,9701,185155,1491
2022-05-06,Yolo,113,214977,37720,37456,3321,40777,315
2022-05-06,Yuba,115,75493,16002,15964,1252,17216,122
2022-05-05,Alameda,001,1643700,267743,265198,15028,280226,1855
2022-05-05,Alpine,003,1148,125,125,1,126,0
2022-05-05,Amador,005,37829,8609,8556,668,9224,86
2022-05-05,Butte,007,227075,33334,33269,6795,40064,421
2022-05-05,Calaveras,009,45235,7368,7353,373,7726,120
2022-05-05,Colusa,011,21464,3462,3459,1076,4535,21
2022-05-05,Contra Costa,013,1133247,195054,193961,13984,207945,1302
2022-05-05,Del Norte,015,27424,5905,5884,212,6096,50
2022-05-05,El Dorado,017,186661,27160,27081,3284,30365,210
2022-05-05,Fresno,019,978130,233148,232655,24282,256937,2754
2022-05-05,Glenn,021,27897,5001,4996,1626,6622,48
2022-05-05,Humboldt,023,135768,17588,17410,3139,20549,146
2022-05-05,Imperial,025,180216,55753,55683,10955,66638,917
2022-05-05,Inyo,027,18085,4092,4087,519,4606,56
2022-05-05,Kern,029,883053,192891,192590,46733,239323,2287
2022-05-05,Kings,031,150075,51755,51702,3643,55345,447
2022-05-05,Lake,033,64148,10788,10766,909,11675,137
2022-05-05,Lassen,035,31185,8984,8978,891,9869,65
2022-05-05,Los Angeles,037,10098052,2760494,2751478,128826,2880304,31738
2022-05-05,Madera,039,155013,37511,37420,6160,43580,365
2022-05-05,Marin,041,260295,35239,34934,3023,37957,292
2022-05-05,Mariposa,043,17540,2460,2438,211,2649,30
2022-05-05,Mendocino,045,87422,13326,13270,3207,16477,124
2022-05-05,Merced,047,269075,62577,62471,8859,71330,818
2022-05-05,Modoc,049,8938,747,745,253,998,8
2022-05-05,Mono,051,14174,3001,2997,136,3133,6
2022-05-05,Monterey,053,433212,80615,80246,14459,94705,733
2022-05-05,Napa,055,140530,26660,26524,1065,27589,143
2022-05-05,Nevada,057,99092,16233,16171,1252,17423,127
2022-05-05,Orange,059,3164182,555848,554411,43079,597490,7007
2022-05-05,Placer,061,380077,63841,63577,7558,71135,625
2022-05-05,Plumas,063,18699,2997,2996,373,3369,13
2022-05-05,Riverside,065,2383286,597273,596022,28733,624755,6467
2022-05-05,Sacramento,067,1510023,285466,284564,27937,312501,3016
2022-05-05,San Benito,069,59416,13074,13047,530,13577,98
2022-05-05,San Bernardino,071,2135413,571682,570381,25282,595663,7306
2022-05-05,San Diego,073,3302833,767444,765377,53805,819182,5244
2022-05-05,San Francisco,075,870044,133791,132659,8977,141636,861
2022-05-05,San Joaquin,077,732212,168048,167568,10091,177659,2229
2022-05-05,San Luis Obispo,079,281455,53390,53273,3988,57261,477
2022-05-05,San Mateo,081,765935,128643,127615,7716,135331,709
2022-05-05,Santa Barbara,083,443738,87580,87305,4901,92206,692
2022-05-05,Santa Clara,085,1922200,326450,324946,13342,338288,2287
2022-05-05,Santa Cruz,087,273765,50144,49605,2251,51856,262
2022-05-05,Shasta,089,179085,30791,30721,6189,36910,563
2022-05-05,Sierra,091,2930,275,275,49,324,4
2022-05-05,Siskiyou,093,43540,4481,4470,2792,7262,81
2022-05-05,Solano,095,438530,83431,83038,5716,88754,450
2022-05-05,Sonoma,097,501317,86741,86150,3077,89227,488
2022-05-05,Stanislaus,099,539301,118394,118235,17581,135816,1643
2022-05-05,Sutter,101,95872,20652,20694,2173,22867,225
2022-05-05,Tehama,103,63373,12104,12098,2637,14735,201
2022-05-05,Trinity,105,12862,1186,1180,296,1476,20
2022-05-05,Tulare,107,460477,107077,106987,29009,135996,1468
2022-05-05,Tuolumne,109,53932,12823,12793,586,13379,181
2022-05-05,Ventura,111,848112,175941,175454,9681,185135,1491
2022-05-05,Yolo,113,214977,37659,37456,3314,40770,315
2022-05-05,Yuba,115,75493,15992,15964,1249,17213,122
2022-05-04,Alameda,001,1643700,267079,263736,14990,278726,1850
2022-05-04,Alpine,003,1148,125,124,1,125,0
2022-05-04,Amador,005,37829,8606,8546,667,9213,86
2022-05-04,Butte,007,227075,33315,33220,6788,40008,417
2022-05-04,Calaveras,009,45235,7363,7344,373,7717,120
2022-05-04,Colusa,011,21464,3461,3460,1076,4536,21
2022-05-04,Contra Costa,013,1133247,194710,193175,13940,207115,1302
2022-05-04,Del Norte,015,27424,5897,5866,212,6078,50
2022-05-04,El Dorado,017,186661,27137,27021,3278,30299,210
2022-05-04,Fresno,019,978130,233035,232332,24276,256608,2751
2022-05-04,Glenn,021,27897,5000,4995,1626,6621,48
2022-05-04,Humboldt,023,135768,17549,17316,3131,20447,146
2022-05-04,Imperial,025,180216,55731,55548,10949,66497,910
2022-05-04,Inyo,027,18085,4092,4085,516,4601,56
2022-05-04,Kern,029,883053,192839,192432,46706,239138,2281
2022-05-04,Kings,031,150075,51738,51663,3640,55303,447
2022-05-04,Lake,033,64148,10783,10758,909,11667,137
2022-05-04,Lassen,035,31185,8983,8972,890,9862,65
2022-05-04,Los Angeles,037,10098052,2757930,2744894,128659,2873553,31722
2022-05-04,Madera,039,155013,37490,37395,6151,43546,365
2022-05-04,Marin,041,260295,35159,34727,3002,37729,291
2022-05-04,Mariposa,043,17540,2454,2435,207,2642,30
2022-05-04,Mendocino,045,87422,13317,13247,3200,16447,123
2022-05-04,Merced,047,269075,62550,62419,8850,71269,818
2022-05-04,Modoc,049,8938,747,746,253,999,8
2022-05-04,Mono,051,14174,3001,2993,134,3127,6
2022-05-04,Monterey,053,433212,80556,80038,14447,94485,732
2022-05-04,Napa,055,140530,26625,26434,1062,27496,143
2022-05-04,Nevada,057,99092,16214,16136,1249,17385,127
2022-05-04,Orange,059,3164182,555268,553177,43007,596184,7006
2022-05-04,Placer,061,380077,63765,63410,7555,70965,625
2022-05-04,Plumas,063,18699,2996,2947,373,3320,13
2022-05-04,Riverside,065,2383286,596948,594981,28709,623690,6457
2022-05-04,Sacramento,067,1510023,285150,283939,27906,311845,3013
2022-05-04,San Benito,069,59416,13064,13019,529,13548,98
2022-05-04,San Bernardino,071,2135413,571449,569570,25267,594837,7240
2022-05-04,San Diego,073,3302833,766727,763453,53724,817177,5239
2022-05-04,San Francisco,075,870044,133387,131599,8960,140559,860
2022-05-04,San Joaquin,077,732212,167936,167280,10061,177341,2225
2022-05-04,San Luis Obispo,079,281455,53348,53156,3978,57134,477
2022-05-04,San Mateo,081,765935,128330,126800,7684,134484,710
2022-05-04,Santa Barbara,083,443738,87481,87058,4887,91945,688
2022-05-04,Santa Clara,085,1922200,325659,322805,13288,336093,2285
2022-05-04,Santa Cruz,087,273765,50029,49230,2249,51479,262
2022-05-04,Shasta,089,179085,30776,30681,6186,36867,556
2022-05-04,Sierra,091,2930,275,275,49,324,4
2022-05-04,Siskiyou,093,43540,4478,4463,2789,7252,81
2022-05-04,Solano,095,438530,83282,82796,5706,88502,449
2022-05-04,Sonoma,097,501317,86567,85694,3061,88755,488
2022-05-04,Stanislaus,099,539301,118335,118123,17575,135698,1643
2022-05-04,Sutter,101,95872,20643,20672,2171,22843,224
2022-05-04,Tehama,103,63373,12102,12090,2634,14724,201
2022-05-04,Trinity,105,12862,1186,1180,296,1476,20
2022-05-04,Tulare,107,460477,107061,106935,28996,135931,1464
2022-05-04,Tuolumne,109,53932,12816,12757,585,13342,181
2022-05-04,Ventura,111,848112,175784,175066,9663,184729,1486
2022-05-04,Yolo,113,214977,37615,37344,3309,40653,315
2022-05-04,Yuba,115,75493,15983,15940,1247,17187,122
2022-05-03,Alameda,001,1643700,266494,263736,14943,278679,1850
2022-05-03,Alpine,003,1148,125,124,1,125,0
2022-05-03,Amador,005,37829,8603,8546,667,9213,86
2022-05-03,Butte,007,227075,33299,33220,6782,40002,417
2022-05-03,Calaveras,009,45235,7358,7344,371,7715,120
2022-05-03,Colusa,011,21464,3460,3460,1076,4536,21
2022-05-03,Contra Costa,013,1133247,194328,193175,13912,207087,1302
2022-05-03,Del Norte,015,27424,5891,5866,210,6076,50
2022-05-03,El Dorado,017,186661,27115,27021,3274,30295,210
2022-05-03,Fresno,019,978130,232926,232332,24264,256596,2751
2022-05-03,Glenn,021,27897,4999,4995,1626,6621,48
2022-05-03,Humboldt,023,135768,17514,17316,3119,20435,146
2022-05-03,Imperial,025,180216,55710,55548,10942,66490,910
2022-05-03,Inyo,027,18085,4090,4085,516,4601,56
2022-05-03,Kern,029,883053,192761,192432,46681,239113,2281
2022-05-03,Kings,031,150075,51727,51663,3640,55303,447
2022-05-03,Lake,033,64148,10778,10758,909,11667,137
2022-05-03,Lassen,035,31185,8983,8972,890,9862,65
2022-05-03,Los Angeles,037,10098052,2754993,2744894,128455,2873349,31722
2022-05-03,Madera,039,155013,37461,37395,6146,43541,365
2022-05-03,Marin,041,260295,35055,34727,2979,37706,291
2022-05-03,Mariposa,043,17540,2446,2435,207,2642,30
2022-05-03,Mendocino,045,87422,13303,13247,3184,16431,123
2022-05-03,Merced,047,269075,62523,62419,8832,71251,818
2022-05-03,Modoc,049,8938,746,746,253,999,8
2022-05-03,Mono,051,14174,2998,2993,133,3126,6
2022-05-03,Monterey,053,433212,80506,80038,14420,94458,732
2022-05-03,Napa,055,140530,26590,26434,1057,27491,143
2022-05-03,Nevada,057,99092,16204,16136,1249,17385,127
2022-05-03,Orange,059,3164182,554738,553177,42932,596109,7006
2022-05-03,Placer,061,380077,63679,63410,7550,70960,625
2022-05-03,Plumas,063,18699,2993,2947,373,3320,13
2022-05-03,Riverside,065,2383286,596588,594981,28686,623667,6457
2022-05-03,Sacramento,067,1510023,284844,283939,27855,311794,3013
2022-05-03,San Benito,069,59416,13050,13019,529,13548,98
2022-05-03,San Bernardino,071,2135413,571197,569570,25256,594826,7240
2022-05-03,San Diego,073,3302833,765915,763453,53636,817089,5239
2022-05-03,San Francisco,075,870044,132919,131599,8929,140528,860
2022-05-03,San Joaquin,077,732212,167858,167280,10030,177310,2225
2022-05-03,San Luis Obispo,079,281455,53301,53156,3967,57123,477
2022-05-03,San Mateo,081,765935,127991,126800,7646,134446,710
2022-05-03,Santa Barbara,083,443738,87393,87058,4885,91943,688
2022-05-03,Santa Clara,085,1922200,324864,322805,13236,336041,2285
2022-05-03,Santa Cruz,087,273765,49944,49230,2244,51474,262
2022-05-03,Shasta,089,179085,30758,30681,6186,36867,556
2022-05-03,Sierra,091,2930,275,275,49,324,4
2022-05-03,Siskiyou,093,43540,4477,4463,2789,7252,81
2022-05-03,Solano,095,438530,83105,82796,5698,88494,449
2022-05-03,Sonoma,097,501317,86392,85694,3036,88730,488
2022-05-03,Stanislaus,099,539301,118286,118123,17565,135688,1643
2022-05-03,Sutter,101,95872,20638,20672,2170,22842,224
2022-05-03,Tehama,103,63373,12098,12090,2634,14724,201
2022-05-03,Trinity,105,12862,1186,1180,296,1476,20
2022-05-03,Tulare,107,460477,107035,106935,28982,135917,1464
2022-05-03,Tuolumne,109,53932,12804,12757,585,13342,181
2022-05-03,Ventura,111,848112,175621,175066,9640,184706,1486
2022-05-03,Yolo,113,214977,37563,37344,3307,40651,315
2022-05-03,Yuba,115,75493,15972,15940,1241,17181,122
2022-05-02,Alameda,001,1643700,265883,263736,14907,278643,1850
2022-05-02,Alpine,003,1148,125,124,1,125,0
2022-05-02,Amador,005,37829,8600,8546,666,9212,86
2022-05-02,Butte,007,227075,33278,33220,6780,40000,417
2022-05-02,Calaveras,009,45235,7357,7344,370,7714,120
2022-05-02,Colusa,011,21464,3460,3460,1076,4536,21
2022-05-02,Contra Costa,013,1133247,193970,193175,13880,207055,1302
2022-05-02,Del Norte,015,27424,5886,5866,205,6071,50
2022-05-02,El Dorado,017,186661,27093,27021,3270,30291,210
2022-05-02,Fresno,019,978130,232825,232332,24239,256571,2751
2022-05-02,Glenn,021,27897,4997,4995,1626,6621,48
2022-05-02,Humboldt,023,135768,17463,17316,3107,20423,146
2022-05-02,Imperial,025,180216,55698,55548,10937,66485,910
2022-05-02,Inyo,027,18085,4089,4085,514,4599,56
2022-05-02,Kern,029,883053,192681,192432,46654,239086,2281
2022-05-02,Kings,031,150075,51711,51663,3640,55303,447
2022-05-02,Lake,033,64148,10774,10758,909,11667,137
2022-05-02,Lassen,035,31185,8982,8972,890,9862,65
2022-05-02,Los Angeles,037,10098052,2752117,2744894,128286,2873180,31722
2022-05-02,Madera,039,155013,37444,37395,6140,43535,365
2022-05-02,Marin,041,260295,34935,34727,2956,37683,291
2022-05-02,Mariposa,043,17540,2441,2435,207,2642,30
2022-05-02,Mendocino,045,87422,13287,13247,3172,16419,123
2022-05-02,Merced,047,269075,62495,62419,8824,71243,818
2022-05-02,Modoc,049,8938,745,746,253,999,8
2022-05-02,Mono,051,14174,2996,2993,132,3125,6
2022-05-02,Monterey,053,433212,80428,80038,14382,94420,732
2022-05-02,Napa,055,140530,26556,26434,1055,27489,143
2022-05-02,Nevada,057,99092,16187,16136,1247,17383,127
2022-05-02,Orange,059,3164182,554196,553177,42841,596018,7006
2022-05-02,Placer,061,380077,63624,63410,7544,70954,625
2022-05-02,Plumas,063,18699,2993,2947,373,3320,13
2022-05-02,Riverside,065,2383286,596209,594981,28655,623636,6457
2022-05-02,Sacramento,067,1510023,284546,283939,27813,311752,3013
2022-05-02,San Benito,069,59416,13038,13019,529,13548,98
2022-05-02,San Bernardino,071,2135413,570923,569570,25238,594808,7240
2022-05-02,San Diego,073,3302833,765069,763453,53560,817013,5239
2022-05-02,San Francisco,075,870044,132477,131599,8906,140505,860
2022-05-02,San Joaquin,077,732212,167744,167280,10018,177298,2225
2022-05-02,San Luis Obispo,079,281455,53249,53156,3953,57109,477
2022-05-02,San Mateo,081,765935,127670,126800,7631,134431,710
2022-05-02,Santa Barbara,083,443738,87289,87058,4881,91939,688
2022-05-02,Santa Clara,085,1922200,323981,322805,13187,335992,2285
2022-05-02,Santa Cruz,087,273765,49819,49230,2239,51469,262
2022-05-02,Shasta,089,179085,30740,30681,6185,36866,556
2022-05-02,Sierra,091,2930,275,275,49,324,4
2022-05-02,Siskiyou,093,43540,4474,4463,2788,7251,81
2022-05-02,Solano,095,438530,82980,82796,5689,88485,449
2022-05-02,Sonoma,097,501317,86212,85694,3021,88715,488
2022-05-02,Stanislaus,099,539301,118211,118123,17550,135673,1643
2022-05-02,Sutter,101,95872,20631,20672,2169,22841,224
2022-05-02,Tehama,103,63373,12093,12090,2633,14723,201
2022-05-02,Trinity,105,12862,1185,1180,296,1476,20
2022-05-02,Tulare,107,460477,107010,106935,28963,135898,1464
2022-05-02,Tuolumne,109,53932,12799,12757,585,13342,181
2022-05-02,Ventura,111,848112,175460,175066,9615,184681,1486
2022-05-02,Yolo,113,214977,37516,37344,3301,40645,315
2022-05-02,Yuba,115,75493,15967,15940,1240,17180,122
2022-05-01,Alameda,001,1643700,265211,262027,14857,276884,1851
2022-05-01,Alpine,003,1148,125,124,1,125,0
2022-05-01,Amador,005,37829,8600,8533,666,9199,86
2022-05-01,Butte,007,227075,33250,33172,6775,39947,418
2022-05-01,Calaveras,009,45235,7353,7328,365,7693,120
2022-05-01,Colusa,011,21464,3460,3457,1076,4533,21
2022-05-01,Contra Costa,013,1133247,193609,192136,13821,205957,1301
2022-05-01,Del Norte,015,27424,5878,5841,205,6046,50
2022-05-01,El Dorado,017,186661,27063,26946,3266,30212,210
2022-05-01,Fresno,019,978130,232722,232067,24225,256292,2748
2022-05-01,Glenn,021,27897,4997,4995,1626,6621,48
2022-05-01,Humboldt,023,135768,17403,17194,3091,20285,145
2022-05-01,Imperial,025,180216,55677,55503,10931,66434,910
2022-05-01,Inyo,027,18085,4088,4084,513,4597,56
2022-05-01,Kern,029,883053,192622,192250,46609,238859,2265
2022-05-01,Kings,031,150075,51689,51640,3636,55276,447
2022-05-01,Lake,033,64148,10767,10742,907,11649,137
2022-05-01,Lassen,035,31185,8982,8966,890,9856,65
2022-05-01,Los Angeles,037,10098052,2749353,2736900,128074,2864974,31712
2022-05-01,Madera,039,155013,37426,37360,6130,43490,365
2022-05-01,Marin,041,260295,34849,34519,2924,37443,291
2022-05-01,Mariposa,043,17540,2440,2430,207,2637,30
2022-05-01,Mendocino,045,87422,13268,13219,3155,16374,123
2022-05-01,Merced,047,269075,62467,62357,8809,71166,818
2022-05-01,Modoc,049,8938,745,745,253,998,8
2022-05-01,Mono,051,14174,2993,2989,131,3120,6
2022-05-01,Monterey,053,433212,80347,79881,14340,94221,731
2022-05-01,Napa,055,140530,26514,26319,1052,27371,143
2022-05-01,Nevada,057,99092,16168,16100,1245,17345,127
2022-05-01,Orange,059,3164182,553643,551822,42743,594565,6998
2022-05-01,Placer,061,380077,63550,63273,7537,70810,625
2022-05-01,Plumas,063,18699,2992,2946,373,3319,13
2022-05-01,Riverside,065,2383286,595756,593965,28620,622585,6457
2022-05-01,Sacramento,067,1510023,284223,283048,27752,310800,3007
2022-05-01,San Benito,069,59416,13030,12988,527,13515,98
2022-05-01,San Bernardino,071,2135413,570610,568758,25226,593984,7191
2022-05-01,San Diego,073,3302833,764199,761253,53476,814729,5238
2022-05-01,San Francisco,075,870044,131993,130241,8876,139117,860
2022-05-01,San Joaquin,077,732212,167606,167028,9978,177006,2225
2022-05-01,San Luis Obispo,079,281455,53177,53040,3937,56977,477
2022-05-01,San Mateo,081,765935,127302,125807,7598,133405,705
2022-05-01,Santa Barbara,083,443738,87185,86768,4873,91641,688
2022-05-01,Santa Clara,085,1922200,323052,320709,13131,333840,2281
2022-05-01,Santa Cruz,087,273765,49667,48798,2232,51030,262
2022-05-01,Shasta,089,179085,30722,30649,6182,36831,554
2022-05-01,Sierra,091,2930,275,274,49,323,4
2022-05-01,Siskiyou,093,43540,4473,4458,2783,7241,81
2022-05-01,Solano,095,438530,82863,82459,5677,88136,449
2022-05-01,Sonoma,097,501317,86009,85290,2975,88265,488
2022-05-01,Stanislaus,099,539301,118155,117943,17534,135477,1643
2022-05-01,Sutter,101,95872,20622,20644,2163,22807,224
2022-05-01,Tehama,103,63373,12092,12078,2633,14711,202
2022-05-01,Trinity,105,12862,1185,1179,296,1475,20
2022-05-01,Tulare,107,460477,106979,106856,28943,135799,1458
2022-05-01,Tuolumne,109,53932,12782,12713,581,13294,181
2022-05-01,Ventura,111,848112,175293,174679,9578,184257,1486
2022-05-01,Yolo,113,214977,37478,37173,3288,40461,314
2022-05-01,Yuba,115,75493,15957,15917,1239,17156,121
2022-04-30,Alameda,001,1643700,264836,262027,14844,276871,1851
2022-04-30,Alpine,003,1148,125,124,1,125,0
2022-04-30,Amador,005,37829,8599,8533,666,9199,86
2022-04-30,Butte,007,227075,33245,33172,6770,39942,418
2022-04-30,Calaveras,009,45235,7349,7328,365,7693,120
2022-04-30,Colusa,011,21464,3459,3457,1076,4533,21
2022-04-30,Contra Costa,013,1133247,193375,192136,13812,205948,1301
2022-04-30,Del Norte,015,27424,5873,5841,205,6046,50
2022-04-30,El Dorado,017,186661,27046,26946,3262,30208,210
2022-04-30,Fresno,019,978130,232677,232067,24218,256285,2748
2022-04-30,Glenn,021,27897,4996,4995,1626,6621,48
2022-04-30,Humboldt,023,135768,17362,17194,3087,20281,145
2022-04-30,Imperial,025,180216,55664,55503,10930,66433,910
2022-04-30,Inyo,027,18085,4088,4084,513,4597,56
2022-04-30,Kern,029,883053,192588,192250,46591,238841,2265
2022-04-30,Kings,031,150075,51684,51640,3635,55275,447
2022-04-30,Lake,033,64148,10764,10742,907,11649,137
2022-04-30,Lassen,035,31185,8982,8966,890,9856,65
2022-04-30,Los Angeles,037,10098052,2748089,2736900,127926,2864826,31712
2022-04-30,Madera,039,155013,37415,37360,6129,43489,365
2022-04-30,Marin,041,260295,34806,34519,2892,37411,291
2022-04-30,Mariposa,043,17540,2438,2430,206,2636,30
2022-04-30,Mendocino,045,87422,13263,13219,3155,16374,123
2022-04-30,Merced,047,269075,62453,62357,8807,71164,818
2022-04-30,Modoc,049,8938,745,745,253,998,8
2022-04-30,Mono,051,14174,2993,2989,131,3120,6
2022-04-30,Monterey,053,433212,80282,79881,14325,94206,731
2022-04-30,Napa,055,140530,26493,26319,1051,27370,143
2022-04-30,Nevada,057,99092,16155,16100,1244,17344,127
2022-04-30,Orange,059,3164182,553389,551822,42703,594525,6998
2022-04-30,Placer,061,380077,63504,63273,7532,70805,625
2022-04-30,Plumas,063,18699,2989,2946,373,3319,13
2022-04-30,Riverside,065,2383286,595528,593965,28598,622563,6457
2022-04-30,Sacramento,067,1510023,284106,283048,27743,310791,3007
2022-04-30,San Benito,069,59416,13027,12988,527,13515,98
2022-04-30,San Bernardino,071,2135413,570444,568758,25214,593972,7191
2022-04-30,San Diego,073,3302833,763837,761253,53449,814702,5238
2022-04-30,San Francisco,075,870044,131718,130241,8850,139091,860
2022-04-30,San Joaquin,077,732212,167551,167028,9974,177002,2225
2022-04-30,San Luis Obispo,079,281455,53166,53040,3934,56974,477
2022-04-30,San Mateo,081,765935,127100,125807,7579,133386,705
2022-04-30,Santa Barbara,083,443738,87132,86768,4870,91638,688
2022-04-30,Santa Clara,085,1922200,322494,320709,13105,333814,2281
2022-04-30,Santa Cruz,087,273765,49622,48798,2232,51030,262
2022-04-30,Shasta,089,179085,30717,30649,6180,36829,554
2022-04-30,Sierra,091,2930,275,274,49,323,4
2022-04-30,Siskiyou,093,43540,4471,4458,2782,7240,81
2022-04-30,Solano,095,438530,82846,82459,5676,88135,449
2022-04-30,Sonoma,097,501317,85898,85290,2963,88253,488
2022-04-30,Stanislaus,099,539301,118128,117943,17528,135471,1643
2022-04-30,Sutter,101,95872,20617,20644,2162,22806,224
2022-04-30,Tehama,103,63373,12089,12078,2632,14710,202
2022-04-30,Trinity,105,12862,1185,1179,296,1475,20
2022-04-30,Tulare,107,460477,106961,106856,28931,135787,1458
2022-04-30,Tuolumne,109,53932,12774,12713,581,13294,181
2022-04-30,Ventura,111,848112,175212,174679,9555,184234,1486
2022-04-30,Yolo,113,214977,37438,37173,3288,40461,314
2022-04-30,Yuba,115,75493,15950,15917,1238,17155,121
2022-04-29,Alameda,001,1643700,264528,262027,14831,276858,1851
2022-04-29,Alpine,003,1148,124,124,1,125,0
2022-04-29,Amador,005,37829,8592,8533,666,9199,86
2022-04-29,Butte,007,227075,33241,33172,6765,39937,418
2022-04-29,Calaveras,009,45235,7347,7328,365,7693,120
2022-04-29,Colusa,011,21464,3458,3457,1076,4533,21
2022-04-29,Contra Costa,013,1133247,193189,192136,13800,205936,1301
2022-04-29,Del Norte,015,27424,5869,5841,205,6046,50
2022-04-29,El Dorado,017,186661,27035,26946,3260,30206,210
2022-04-29,Fresno,019,978130,232628,232067,24213,256280,2748
2022-04-29,Glenn,021,27897,4996,4995,1626,6621,48
2022-04-29,Humboldt,023,135768,17339,17194,3082,20276,145
2022-04-29,Imperial,025,180216,55648,55503,10929,66432,910
2022-04-29,Inyo,027,18085,4088,4084,511,4595,56
2022-04-29,Kern,029,883053,192561,192250,46580,238830,2265
2022-04-29,Kings,031,150075,51679,51640,3635,55275,447
2022-04-29,Lake,033,64148,10763,10742,907,11649,137
2022-04-29,Lassen,035,31185,8981,8966,890,9856,65
2022-04-29,Los Angeles,037,10098052,2746827,2736900,127794,2864694,31712
2022-04-29,Madera,039,155013,37405,37360,6129,43489,365
2022-04-29,Marin,041,260295,34742,34519,2871,37390,291
2022-04-29,Mariposa,043,17540,2436,2430,206,2636,30
2022-04-29,Mendocino,045,87422,13259,13219,3154,16373,123
2022-04-29,Merced,047,269075,62442,62357,8807,71164,818
2022-04-29,Modoc,049,8938,745,745,253,998,8
2022-04-29,Mono,051,14174,2993,2989,131,3120,6
2022-04-29,Monterey,053,433212,80249,79881,14310,94191,731
2022-04-29,Napa,055,140530,26465,26319,1050,27369,143
2022-04-29,Nevada,057,99092,16148,16100,1242,17342,127
2022-04-29,Orange,059,3164182,553131,551822,42653,594475,6998
2022-04-29,Placer,061,380077,63477,63273,7525,70798,625
2022-04-29,Plumas,063,18699,2988,2946,373,3319,13
2022-04-29,Riverside,065,2383286,595306,593965,28576,622541,6457
2022-04-29,Sacramento,067,1510023,283960,283048,27736,310784,3007
2022-04-29,San Benito,069,59416,13022,12988,527,13515,98
2022-04-29,San Bernardino,071,2135413,570283,568758,25207,593965,7191
2022-04-29,San Diego,073,3302833,763426,761253,53434,814687,5238
2022-04-29,San Francisco,075,870044,131495,130241,8831,139072,860
2022-04-29,San Joaquin,077,732212,167497,167028,9968,176996,2225
2022-04-29,San Luis Obispo,079,281455,53151,53040,3929,56969,477
2022-04-29,San Mateo,081,765935,126901,125807,7563,133370,705
2022-04-29,Santa Barbara,083,443738,87093,86768,4868,91636,688
2022-04-29,Santa Clara,085,1922200,321999,320709,13075,333784,2281
2022-04-29,Santa Cruz,087,273765,49566,48798,2228,51026,262
2022-04-29,Shasta,089,179085,30715,30649,6179,36828,554
2022-04-29,Sierra,091,2930,275,274,49,323,4
2022-04-29,Siskiyou,093,43540,4470,4458,2782,7240,81
2022-04-29,Solano,095,438530,82794,82459,5670,88129,449
2022-04-29,Sonoma,097,501317,85790,85290,2954,88244,488
2022-04-29,Stanislaus,099,539301,118108,117943,17523,135466,1643
2022-04-29,Sutter,101,95872,20612,20644,2161,22805,224
2022-04-29,Tehama,103,63373,12087,12078,2632,14710,202
2022-04-29,Trinity,105,12862,1185,1179,296,1475,20
2022-04-29,Tulare,107,460477,106943,106856,28917,135773,1458
2022-04-29,Tuolumne,109,53932,12767,12713,579,13292,181
2022-04-29,Ventura,111,848112,175139,174679,9541,184220,1486
2022-04-29,Yolo,113,214977,37410,37173,3285,40458,314
2022-04-29,Yuba,115,75493,15945,15917,1238,17155,121
2022-04-28,Alameda,001,1643700,264091,262027,14795,276822,1851
2022-04-28,Alpine,003,1148,124,124,1,125,0
2022-04-28,Amador,005,37829,8589,8533,666,9199,86
2022-04-28,Butte,007,227075,33232,33172,6761,39933,418
2022-04-28,Calaveras,009,45235,7343,7328,365,7693,120
2022-04-28,Colusa,011,21464,3457,3457,1076,4533,21
2022-04-28,Contra Costa,013,1133247,192935,192136,13769,205905,1301
2022-04-28,Del Norte,015,27424,5865,5841,205,6046,50
2022-04-28,El Dorado,017,186661,27014,26946,3258,30204,210
2022-04-28,Fresno,019,978130,232568,232067,24203,256270,2748
2022-04-28,Glenn,021,27897,4993,4995,1626,6621,48
2022-04-28,Humboldt,023,135768,17308,17194,3074,20268,145
2022-04-28,Imperial,025,180216,55635,55503,10924,66427,910
2022-04-28,Inyo,027,18085,4088,4084,511,4595,56
2022-04-28,Kern,029,883053,192518,192250,46564,238814,2265
2022-04-28,Kings,031,150075,51673,51640,3635,55275,447
2022-04-28,Lake,033,64148,10759,10742,907,11649,137
2022-04-28,Lassen,035,31185,8981,8966,890,9856,65
2022-04-28,Los Angeles,037,10098052,2744810,2736900,127628,2864528,31712
2022-04-28,Madera,039,155013,37399,37360,6125,43485,365
2022-04-28,Marin,041,260295,34693,34519,2855,37374,291
2022-04-28,Mariposa,043,17540,2436,2430,206,2636,30
2022-04-28,Mendocino,045,87422,13248,13219,3137,16356,123
2022-04-28,Merced,047,269075,62424,62357,8799,71156,818
2022-04-28,Modoc,049,8938,745,745,253,998,8
2022-04-28,Mono,051,14174,2991,2989,131,3120,6
2022-04-28,Monterey,053,433212,80211,79881,14284,94165,731
2022-04-28,Napa,055,140530,26435,26319,1047,27366,143
2022-04-28,Nevada,057,99092,16140,16100,1239,17339,127
2022-04-28,Orange,059,3164182,552774,551822,42586,594408,6998
2022-04-28,Placer,061,380077,63429,63273,7516,70789,625
2022-04-28,Plumas,063,18699,2987,2946,373,3319,13
2022-04-28,Riverside,065,2383286,595027,593965,28554,622519,6457
2022-04-28,Sacramento,067,1510023,283775,283048,27695,310743,3007
2022-04-28,San Benito,069,59416,13013,12988,525,13513,98
2022-04-28,San Bernardino,071,2135413,570085,568758,25200,593958,7191
2022-04-28,San Diego,073,3302833,762894,761253,53376,814629,5238
2022-04-28,San Francisco,075,870044,131200,130241,8797,139038,860
2022-04-28,San Joaquin,077,732212,167430,167028,9951,176979,2225
2022-04-28,San Luis Obispo,079,281455,53123,53040,3912,56952,477
2022-04-28,San Mateo,081,765935,126662,125807,7530,133337,705
2022-04-28,Santa Barbara,083,443738,87040,86768,4865,91633,688
2022-04-28,Santa Clara,085,1922200,321457,320709,13040,333749,2281
2022-04-28,Santa Cruz,087,273765,49468,48798,2225,51023,262
2022-04-28,Shasta,089,179085,30706,30649,6179,36828,554
2022-04-28,Sierra,091,2930,275,274,49,323,4
2022-04-28,Siskiyou,093,43540,4467,4458,2782,7240,81
2022-04-28,Solano,095,438530,82714,82459,5664,88123,449
2022-04-28,Sonoma,097,501317,85673,85290,2942,88232,488
2022-04-28,Stanislaus,099,539301,118067,117943,17515,135458,1643
2022-04-28,Sutter,101,95872,20602,20644,2158,22802,224
2022-04-28,Tehama,103,63373,12086,12078,2631,14709,202
2022-04-28,Trinity,105,12862,1185,1179,296,1475,20
2022-04-28,Tulare,107,460477,106923,106856,28903,135759,1458
2022-04-28,Tuolumne,109,53932,12756,12713,579,13292,181
2022-04-28,Ventura,111,848112,175052,174679,9507,184186,1486
2022-04-28,Yolo,113,214977,37382,37173,3280,40453,314
2022-04-28,Yuba,115,75493,15936,15917,1236,17153,121
2022-04-27,Alameda,001,1643700,263614,260871,14753,275624,1843
2022-04-27,Alpine,003,1148,124,124,1,125,0
2022-04-27,Amador,005,37829,8588,8518,666,9184,86
2022-04-27,Butte,007,227075,33220,33118,6756,39874,411
2022-04-27,Calaveras,009,45235,7340,7307,365,7672,119
2022-04-27,Colusa,011,21464,3456,3457,1076,4533,21
2022-04-27,Contra Costa,013,1133247,192671,191412,13738,205150,1300
2022-04-27,Del Norte,015,27424,5860,5833,205,6038,50
2022-04-27,El Dorado,017,186661,27003,26898,3254,30152,209
2022-04-27,Fresno,019,978130,232503,231951,24190,256141,2744
2022-04-27,Glenn,021,27897,4993,4993,1626,6619,48
2022-04-27,Humboldt,023,135768,17278,17138,3064,20202,145
2022-04-27,Imperial,025,180216,55617,55480,10920,66400,910
2022-04-27,Inyo,027,18085,4087,4080,510,4590,56
2022-04-27,Kern,029,883053,192477,192157,46544,238701,2271
2022-04-27,Kings,031,150075,51668,51617,3634,55251,444
2022-04-27,Lake,033,64148,10755,10732,907,11639,135
2022-04-27,Lassen,035,31185,8980,8965,890,9855,65
2022-04-27,Los Angeles,037,10098052,2742531,2731988,127449,2859437,31691
2022-04-27,Madera,039,155013,37390,37339,6123,43462,354
2022-04-27,Marin,041,260295,34634,34354,2841,37195,288
2022-04-27,Mariposa,043,17540,2434,2427,206,2633,30
2022-04-27,Mendocino,045,87422,13241,13188,3130,16318,123
2022-04-27,Merced,047,269075,62410,62315,8795,71110,815
2022-04-27,Modoc,049,8938,745,745,253,998,8
2022-04-27,Mono,051,14174,2991,2989,131,3120,6
2022-04-27,Monterey,053,433212,80169,79695,14246,93941,729
2022-04-27,Napa,055,140530,26403,26210,1043,27253,143
2022-04-27,Nevada,057,99092,16124,16080,1236,17316,127
2022-04-27,Orange,059,3164182,552401,550859,42525,593384,6991
2022-04-27,Placer,061,380077,63392,63154,7503,70657,623
2022-04-27,Plumas,063,18699,2986,2934,373,3307,13
2022-04-27,Riverside,065,2383286,594763,593397,28532,621929,6453
2022-04-27,Sacramento,067,1510023,283575,281802,27658,309460,3001
2022-04-27,San Benito,069,59416,12999,12989,524,13513,98
2022-04-27,San Bernardino,071,2135413,569882,568018,25189,593207,7105
2022-04-27,San Diego,073,3302833,762335,759873,53320,813193,5236
2022-04-27,San Francisco,075,870044,130848,129284,8769,138053,857
2022-04-27,San Joaquin,077,732212,167357,166848,9936,176784,2225
2022-04-27,San Luis Obispo,079,281455,53079,52911,3904,56815,476
2022-04-27,San Mateo,081,765935,126428,125018,7469,132487,702
2022-04-27,Santa Barbara,083,443738,86975,86557,4859,91416,685
2022-04-27,Santa Clara,085,1922200,320889,319077,12989,332066,2282
2022-04-27,Santa Cruz,087,273765,49387,48500,2220,50720,262
2022-04-27,Shasta,089,179085,30695,30633,6175,36808,554
2022-04-27,Sierra,091,2930,274,276,49,325,4
2022-04-27,Siskiyou,093,43540,4467,4455,2778,7233,81
2022-04-27,Solano,095,438530,82614,82220,5653,87873,448
2022-04-27,Sonoma,097,501317,85564,84983,2919,87902,487
2022-04-27,Stanislaus,099,539301,118023,117841,17504,135345,1643
2022-04-27,Sutter,101,95872,20598,20627,2156,22783,224
2022-04-27,Tehama,103,63373,12086,12073,2631,14704,201
2022-04-27,Trinity,105,12862,1185,1179,296,1475,20
2022-04-27,Tulare,107,460477,106906,106580,28892,135472,1453
2022-04-27,Tuolumne,109,53932,12739,12684,578,13262,181
2022-04-27,Ventura,111,848112,174953,174425,9498,183923,1480
2022-04-27,Yolo,113,214977,37340,37096,3274,40370,314
2022-04-27,Yuba,115,75493,15933,15902,1231,17133,121
2022-04-26,Alameda,001,1643700,263109,260871,14711,275582,1843
2022-04-26,Alpine,003,1148,124,124,1,125,0
2022-04-26,Amador,005,37829,8585,8518,666,9184,86
2022-04-26,Butte,007,227075,33201,33118,6750,39868,411
2022-04-26,Calaveras,009,45235,7336,7307,364,7671,119
2022-04-26,Colusa,011,21464,3456,3457,1076,4533,21
2022-04-26,Contra Costa,013,1133247,192416,191412,13708,205120,1300
2022-04-26,Del Norte,015,27424,5852,5833,205,6038,50
2022-04-26,El Dorado,017,186661,26982,26898,3250,30148,209
2022-04-26,Fresno,019,978130,232426,231951,24180,256131,2744
2022-04-26,Glenn,021,27897,4993,4993,1625,6618,48
2022-04-26,Humboldt,023,135768,17247,17138,3057,20195,145
2022-04-26,Imperial,025,180216,55596,55480,10912,66392,910
2022-04-26,Inyo,027,18085,4087,4080,510,4590,56
2022-04-26,Kern,029,883053,192428,192157,46521,238678,2271
2022-04-26,Kings,031,150075,51662,51617,3634,55251,444
2022-04-26,Lake,033,64148,10748,10732,907,11639,135
2022-04-26,Lassen,035,31185,8975,8965,890,9855,65
2022-04-26,Los Angeles,037,10098052,2740205,2731988,127279,2859267,31691
2022-04-26,Madera,039,155013,37382,37339,6119,43458,354
2022-04-26,Marin,041,260295,34579,34354,2822,37176,288
2022-04-26,Mariposa,043,17540,2434,2427,206,2633,30
2022-04-26,Mendocino,045,87422,13237,13188,3124,16312,123
2022-04-26,Merced,047,269075,62387,62315,8777,71092,815
2022-04-26,Modoc,049,8938,745,745,253,998,8
2022-04-26,Mono,051,14174,2991,2989,130,3119,6
2022-04-26,Monterey,053,433212,80116,79695,14205,93900,729
2022-04-26,Napa,055,140530,26375,26210,1039,27249,143
2022-04-26,Nevada,057,99092,16114,16080,1236,17316,127
2022-04-26,Orange,059,3164182,551996,550859,42464,593323,6991
2022-04-26,Placer,061,380077,63362,63154,7501,70655,623
2022-04-26,Plumas,063,18699,2986,2934,373,3307,13
2022-04-26,Riverside,065,2383286,594460,593397,28504,621901,6453
2022-04-26,Sacramento,067,1510023,283342,281802,27636,309438,3001
2022-04-26,San Benito,069,59416,12995,12989,523,13512,98
2022-04-26,San Bernardino,071,2135413,569674,568018,25173,593191,7105
2022-04-26,San Diego,073,3302833,761696,759873,53233,813106,5236
2022-04-26,San Francisco,075,870044,130453,129284,8746,138030,857
2022-04-26,San Joaquin,077,732212,167295,166848,9921,176769,2225
2022-04-26,San Luis Obispo,079,281455,53050,52911,3890,56801,476
2022-04-26,San Mateo,081,765935,126157,125018,7433,132451,702
2022-04-26,Santa Barbara,083,443738,86913,86557,4855,91412,685
2022-04-26,Santa Clara,085,1922200,320333,319077,12944,332021,2282
2022-04-26,Santa Cruz,087,273765,49287,48500,2216,50716,262
2022-04-26,Shasta,089,179085,30681,30633,6175,36808,554
2022-04-26,Sierra,091,2930,274,276,49,325,4
2022-04-26,Siskiyou,093,43540,4463,4455,2776,7231,81
2022-04-26,Solano,095,438530,82518,82220,5644,87864,448
2022-04-26,Sonoma,097,501317,85461,84983,2901,87884,487
2022-04-26,Stanislaus,099,539301,117986,117841,17493,135334,1643
2022-04-26,Sutter,101,95872,20588,20627,2156,22783,224
2022-04-26,Tehama,103,63373,12076,12073,2631,14704,201
2022-04-26,Trinity,105,12862,1185,1179,296,1475,20
2022-04-26,Tulare,107,460477,106878,106580,28875,135455,1453
2022-04-26,Tuolumne,109,53932,12721,12684,577,13261,181
2022-04-26,Ventura,111,848112,174843,174425,9479,183904,1480
2022-04-26,Yolo,113,214977,37299,37096,3266,40362,314
2022-04-26,Yuba,115,75493,15929,15902,1231,17133,121
2022-04-25,Alameda,001,1643700,262605,260871,14672,275543,1843
2022-04-25,Alpine,003,1148,124,124,1,125,0
2022-04-25,Amador,005,37829,8582,8518,666,9184,86
2022-04-25,Butte,007,227075,33188,33118,6741,39859,411
2022-04-25,Calaveras,009,45235,7333,7307,364,7671,119
2022-04-25,Colusa,011,21464,3456,3457,1076,4533,21
2022-04-25,Contra Costa,013,1133247,192155,191412,13675,205087,1300
2022-04-25,Del Norte,015,27424,5847,5833,203,6036,50
2022-04-25,El Dorado,017,186661,26960,26898,3248,30146,209
2022-04-25,Fresno,019,978130,232337,231951,24167,256118,2744
2022-04-25,Glenn,021,27897,4992,4993,1625,6618,48
2022-04-25,Humboldt,023,135768,17206,17138,3052,20190,145
2022-04-25,Imperial,025,180216,55576,55480,10907,66387,910
2022-04-25,Inyo,027,18085,4087,4080,510,4590,56
2022-04-25,Kern,029,883053,192382,192157,46500,238657,2271
2022-04-25,Kings,031,150075,51653,51617,3633,55250,444
2022-04-25,Lake,033,64148,10745,10732,907,11639,135
2022-04-25,Lassen,035,31185,8974,8965,890,9855,65
2022-04-25,Los Angeles,037,10098052,2737871,2731988,127123,2859111,31691
2022-04-25,Madera,039,155013,37369,37339,6115,43454,354
2022-04-25,Marin,041,260295,34515,34354,2800,37154,288
2022-04-25,Mariposa,043,17540,2434,2427,206,2633,30
2022-04-25,Mendocino,045,87422,13227,13188,3107,16295,123
2022-04-25,Merced,047,269075,62374,62315,8774,71089,815
2022-04-25,Modoc,049,8938,745,745,253,998,8
2022-04-25,Mono,051,14174,2990,2989,130,3119,6
2022-04-25,Monterey,053,433212,80079,79695,14180,93875,729
2022-04-25,Napa,055,140530,26334,26210,1037,27247,143
2022-04-25,Nevada,057,99092,16108,16080,1235,17315,127
2022-04-25,Orange,059,3164182,551598,550859,42400,593259,6991
2022-04-25,Placer,061,380077,63327,63154,7496,70650,623
2022-04-25,Plumas,063,18699,2984,2934,373,3307,13
2022-04-25,Riverside,065,2383286,594201,593397,28487,621884,6453
2022-04-25,Sacramento,067,1510023,283176,281802,27599,309401,3001
2022-04-25,San Benito,069,59416,12988,12989,522,13511,98
2022-04-25,San Bernardino,071,2135413,569453,568018,25160,593178,7105
2022-04-25,San Diego,073,3302833,761026,759873,53173,813046,5236
2022-04-25,San Francisco,075,870044,130091,129284,8727,138011,857
2022-04-25,San Joaquin,077,732212,167211,166848,9905,176753,2225
2022-04-25,San Luis Obispo,079,281455,53003,52911,3883,56794,476
2022-04-25,San Mateo,081,765935,125886,125018,7410,132428,702
2022-04-25,Santa Barbara,083,443738,86848,86557,4851,91408,685
2022-04-25,Santa Clara,085,1922200,319692,319077,12902,331979,2282
2022-04-25,Santa Cruz,087,273765,49147,48500,2206,50706,262
2022-04-25,Shasta,089,179085,30670,30633,6172,36805,554
2022-04-25,Sierra,091,2930,274,276,49,325,4
2022-04-25,Siskiyou,093,43540,4463,4455,2775,7230,81
2022-04-25,Solano,095,438530,82409,82220,5635,87855,448
2022-04-25,Sonoma,097,501317,85339,84983,2881,87864,487
2022-04-25,Stanislaus,099,539301,117941,117841,17486,135327,1643
2022-04-25,Sutter,101,95872,20585,20627,2156,22783,224
2022-04-25,Tehama,103,63373,12076,12073,2631,14704,201
2022-04-25,Trinity,105,12862,1184,1179,296,1475,20
2022-04-25,Tulare,107,460477,106855,106580,28862,135442,1453
2022-04-25,Tuolumne,109,53932,12710,12684,577,13261,181
2022-04-25,Ventura,111,848112,174733,174425,9460,183885,1480
2022-04-25,Yolo,113,214977,37255,37096,3261,40357,314
2022-04-25,Yuba,115,75493,15919,15902,1230,17132,121
2022-04-24,Alameda,001,1643700,262024,259619,14624,274243,1837
2022-04-24,Alpine,003,1148,124,124,1,125,0
2022-04-24,Amador,005,37829,8573,8509,665,9174,86
2022-04-24,Butte,007,227075,33166,33105,6734,39839,411
2022-04-24,Calaveras,009,45235,7325,7296,362,7658,119
2022-04-24,Colusa,011,21464,3455,3453,1076,4529,21
2022-04-24,Contra Costa,013,1133247,191850,190611,13640,204251,1298
2022-04-24,Del Norte,015,27424,5838,5827,201,6028,50
2022-04-24,El Dorado,017,186661,26943,26837,3246,30083,209
2022-04-24,Fresno,019,978130,232257,231751,24152,255903,2744
2022-04-24,Glenn,021,27897,4992,4989,1623,6612,48
2022-04-24,Humboldt,023,135768,17180,17033,3040,20073,145
2022-04-24,Imperial,025,180216,55560,55434,10898,66332,910
2022-04-24,Inyo,027,18085,4083,4079,509,4588,56
2022-04-24,Kern,029,883053,192333,192012,46483,238495,2267
2022-04-24,Kings,031,150075,51644,51588,3633,55221,444
2022-04-24,Lake,033,64148,10737,10720,904,11624,134
2022-04-24,Lassen,035,31185,8973,8966,890,9856,65
2022-04-24,Los Angeles,037,10098052,2735556,2725630,126977,2852607,31667
2022-04-24,Madera,039,155013,37355,37333,6110,43443,354
2022-04-24,Marin,041,260295,34463,34150,2767,36917,288
2022-04-24,Mariposa,043,17540,2431,2422,206,2628,30
2022-04-24,Mendocino,045,87422,13222,13158,3095,16253,122
2022-04-24,Merced,047,269075,62350,62286,8768,71054,815
2022-04-24,Modoc,049,8938,745,745,253,998,8
2022-04-24,Mono,051,14174,2989,2986,130,3116,6
2022-04-24,Monterey,053,433212,80027,79560,14148,93708,729
2022-04-24,Napa,055,140530,26299,26093,1036,27129,143
2022-04-24,Nevada,057,99092,16092,16052,1233,17285,127
2022-04-24,Orange,059,3164182,551173,549765,42335,592100,6989
2022-04-24,Placer,061,380077,63273,63037,7488,70525,622
2022-04-24,Plumas,063,18699,2982,2934,373,3307,13
2022-04-24,Riverside,065,2383286,593922,592683,28446,621129,6450
2022-04-24,Sacramento,067,1510023,282972,280551,27563,308114,2993
2022-04-24,San Benito,069,59416,12983,12966,522,13488,98
2022-04-24,San Bernardino,071,2135413,569223,566806,25136,591942,7047
2022-04-24,San Diego,073,3302833,760399,758311,53114,811425,5233
2022-04-24,San Francisco,075,870044,129647,128323,8703,137026,857
2022-04-24,San Joaquin,077,732212,167124,166626,9862,176488,2224
2022-04-24,San Luis Obispo,079,281455,52927,52826,3873,56699,476
2022-04-24,San Mateo,081,765935,125579,124106,7380,131486,703
2022-04-24,Santa Barbara,083,443738,86779,86376,4850,91226,685
2022-04-24,Santa Clara,085,1922200,319012,317487,12851,330338,2277
2022-04-24,Santa Cruz,087,273765,49034,48255,2202,50457,261
2022-04-24,Shasta,089,179085,30660,30607,6171,36778,557
2022-04-24,Sierra,091,2930,274,276,49,325,4
2022-04-24,Siskiyou,093,43540,4462,4453,2773,7226,81
2022-04-24,Solano,095,438530,82315,81982,5626,87608,448
2022-04-24,Sonoma,097,501317,85205,84581,2861,87442,486
2022-04-24,Stanislaus,099,539301,117889,117737,17481,135218,1632
2022-04-24,Sutter,101,95872,20575,20605,2153,22758,224
2022-04-24,Tehama,103,63373,12073,12064,2631,14695,201
2022-04-24,Trinity,105,12862,1184,1177,296,1473,20
2022-04-24,Tulare,107,460477,106832,106354,28851,135205,1446
2022-04-24,Tuolumne,109,53932,12698,12664,576,13240,181
2022-04-24,Ventura,111,848112,174620,174091,9444,183535,1479
2022-04-24,Yolo,113,214977,37223,36990,3258,40248,314
2022-04-24,Yuba,115,75493,15914,15888,1229,17117,121
2022-04-23,Alameda,001,1643700,261782,259619,14613,274232,1837
2022-04-23,Alpine,003,1148,124,124,1,125,0
2022-04-23,Amador,005,37829,8567,8509,665,9174,86
2022-04-23,Butte,007,227075,33157,33105,6731,39836,411
2022-04-23,Calaveras,009,45235,7317,7296,362,7658,119
2022-04-23,Colusa,011,21464,3455,3453,1076,4529,21
2022-04-23,Contra Costa,013,1133247,191697,190611,13629,204240,1298
2022-04-23,Del Norte,015,27424,5836,5827,200,6027,50
2022-04-23,El Dorado,017,186661,26933,26837,3245,30082,209
2022-04-23,Fresno,019,978130,232225,231751,24148,255899,2744
2022-04-23,Glenn,021,27897,4992,4989,1623,6612,48
2022-04-23,Humboldt,023,135768,17165,17033,3038,20071,145
2022-04-23,Imperial,025,180216,55551,55434,10896,66330,910
2022-04-23,Inyo,027,18085,4083,4079,508,4587,56
2022-04-23,Kern,029,883053,192308,192012,46468,238480,2267
2022-04-23,Kings,031,150075,51639,51588,3632,55220,444
2022-04-23,Lake,033,64148,10736,10720,904,11624,134
2022-04-23,Lassen,035,31185,8973,8966,890,9856,65
2022-04-23,Los Angeles,037,10098052,2734635,2725630,126882,2852512,31667
2022-04-23,Madera,039,155013,37348,37333,6109,43442,354
2022-04-23,Marin,041,260295,34428,34150,2721,36871,288
2022-04-23,Mariposa,043,17540,2431,2422,206,2628,30
2022-04-23,Mendocino,045,87422,13215,13158,3095,16253,122
2022-04-23,Merced,047,269075,62338,62286,8768,71054,815
2022-04-23,Modoc,049,8938,745,745,253,998,8
2022-04-23,Mono,051,14174,2989,2986,129,3115,6
2022-04-23,Monterey,053,433212,79959,79560,14134,93694,729
2022-04-23,Napa,055,140530,26278,26093,1034,27127,143
2022-04-23,Nevada,057,99092,16086,16052,1231,17283,127
2022-04-23,Orange,059,3164182,550958,549765,42283,592048,6989
2022-04-23,Placer,061,380077,63243,63037,7488,70525,622
2022-04-23,Plumas,063,18699,2982,2934,373,3307,13
2022-04-23,Riverside,065,2383286,593789,592683,28435,621118,6450
2022-04-23,Sacramento,067,1510023,282879,280551,27560,308111,2993
2022-04-23,San Benito,069,59416,12982,12966,522,13488,98
2022-04-23,San Bernardino,071,2135413,569112,566806,25130,591936,7047
2022-04-23,San Diego,073,3302833,760146,758311,53096,811407,5233
2022-04-23,San Francisco,075,870044,129443,128323,8679,137002,857
2022-04-23,San Joaquin,077,732212,167083,166626,9853,176479,2224
2022-04-23,San Luis Obispo,079,281455,52912,52826,3869,56695,476
2022-04-23,San Mateo,081,765935,125421,124106,7369,131475,703
2022-04-23,Santa Barbara,083,443738,86743,86376,4849,91225,685
2022-04-23,Santa Clara,085,1922200,318634,317487,12825,330312,2277
2022-04-23,Santa Cruz,087,273765,48985,48255,2201,50456,261
2022-04-23,Shasta,089,179085,30657,30607,6171,36778,557
2022-04-23,Sierra,091,2930,274,276,49,325,4
2022-04-23,Siskiyou,093,43540,4460,4453,2772,7225,81
2022-04-23,Solano,095,438530,82289,81982,5623,87605,448
2022-04-23,Sonoma,097,501317,85137,84581,2853,87434,486
2022-04-23,Stanislaus,099,539301,117855,117737,17478,135215,1632
2022-04-23,Sutter,101,95872,20569,20605,2153,22758,224
2022-04-23,Tehama,103,63373,12072,12064,2631,14695,201
2022-04-23,Trinity,105,12862,1184,1177,296,1473,20
2022-04-23,Tulare,107,460477,106824,106354,28841,135195,1446
2022-04-23,Tuolumne,109,53932,12694,12664,576,13240,181
2022-04-23,Ventura,111,848112,174560,174091,9437,183528,1479
2022-04-23,Yolo,113,214977,37199,36990,3254,40244,314
2022-04-23,Yuba,115,75493,15912,15888,1229,17117,121
2022-04-22,Alameda,001,1643700,261543,259619,14594,274213,1837
2022-04-22,Alpine,003,1148,124,124,1,125,0
2022-04-22,Amador,005,37829,8566,8509,663,9172,86
2022-04-22,Butte,007,227075,33151,33105,6729,39834,411
2022-04-22,Calaveras,009,45235,7316,7296,362,7658,119
2022-04-22,Colusa,011,21464,3455,3453,1076,4529,21
2022-04-22,Contra Costa,013,1133247,191567,190611,13613,204224,1298
2022-04-22,Del Norte,015,27424,5836,5827,200,6027,50
2022-04-22,El Dorado,017,186661,26919,26837,3240,30077,209
2022-04-22,Fresno,019,978130,232194,231751,24145,255896,2744
2022-04-22,Glenn,021,27897,4991,4989,1623,6612,48
2022-04-22,Humboldt,023,135768,17149,17033,3031,20064,145
2022-04-22,Imperial,025,180216,55546,55434,10896,66330,910
2022-04-22,Inyo,027,18085,4083,4079,507,4586,56
2022-04-22,Kern,029,883053,192287,192012,46465,238477,2267
2022-04-22,Kings,031,150075,51635,51588,3631,55219,444
2022-04-22,Lake,033,64148,10735,10720,904,11624,134
2022-04-22,Lassen,035,31185,8973,8966,890,9856,65
2022-04-22,Los Angeles,037,10098052,2733572,2725630,126824,2852454,31667
2022-04-22,Madera,039,155013,37343,37333,6109,43442,354
2022-04-22,Marin,041,260295,34389,34150,2710,36860,288
2022-04-22,Mariposa,043,17540,2430,2422,206,2628,30
2022-04-22,Mendocino,045,87422,13208,13158,3093,16251,122
2022-04-22,Merced,047,269075,62332,62286,8756,71042,815
2022-04-22,Modoc,049,8938,745,745,253,998,8
2022-04-22,Mono,051,14174,2989,2986,129,3115,6
2022-04-22,Monterey,053,433212,79924,79560,14120,93680,729
2022-04-22,Napa,055,140530,26261,26093,1032,27125,143
2022-04-22,Nevada,057,99092,16086,16052,1231,17283,127
2022-04-22,Orange,059,3164182,550771,549765,42234,591999,6989
2022-04-22,Placer,061,380077,63220,63037,7485,70522,622
2022-04-22,Plumas,063,18699,2982,2934,373,3307,13
2022-04-22,Riverside,065,2383286,593648,592683,28420,621103,6450
2022-04-22,Sacramento,067,1510023,282791,280551,27547,308098,2993
2022-04-22,San Benito,069,59416,12977,12966,522,13488,98
2022-04-22,San Bernardino,071,2135413,569001,566806,25122,591928,7047
2022-04-22,San Diego,073,3302833,759834,758311,53077,811388,5233
2022-04-22,San Francisco,075,870044,129278,128323,8652,136975,857
2022-04-22,San Joaquin,077,732212,167054,166626,9852,176478,2224
2022-04-22,San Luis Obispo,079,281455,52906,52826,3868,56694,476
2022-04-22,San Mateo,081,765935,125258,124106,7355,131461,703
2022-04-22,Santa Barbara,083,443738,86698,86376,4849,91225,685
2022-04-22,Santa Clara,085,1922200,318288,317487,12812,330299,2277
2022-04-22,Santa Cruz,087,273765,48947,48255,2201,50456,261
2022-04-22,Shasta,089,179085,30652,30607,6170,36777,557
2022-04-22,Sierra,091,2930,274,276,48,324,4
2022-04-22,Siskiyou,093,43540,4460,4453,2772,7225,81
2022-04-22,Solano,095,438530,82233,81982,5621,87603,448
2022-04-22,Sonoma,097,501317,85072,84581,2848,87429,486
2022-04-22,Stanislaus,099,539301,117833,117737,17474,135211,1632
2022-04-22,Sutter,101,95872,20563,20605,2153,22758,224
2022-04-22,Tehama,103,63373,12067,12064,2630,14694,201
2022-04-22,Trinity,105,12862,1184,1177,295,1472,20
2022-04-22,Tulare,107,460477,106814,106354,28832,135186,1446
2022-04-22,Tuolumne,109,53932,12687,12664,574,13238,181
2022-04-22,Ventura,111,848112,174485,174091,9425,183516,1479
2022-04-22,Yolo,113,214977,37180,36990,3251,40241,314
2022-04-22,Yuba,115,75493,15910,15888,1228,17116,121
2022-04-21,Alameda,001,1643700,261185,259619,14554,274173,1837
2022-04-21,Alpine,003,1148,124,124,1,125,0
2022-04-21,Amador,005,37829,8563,8509,663,9172,86
2022-04-21,Butte,007,227075,33144,33105,6722,39827,411
2022-04-21,Calaveras,009,45235,7313,7296,362,7658,119
2022-04-21,Colusa,011,21464,3454,3453,1076,4529,21
2022-04-21,Contra Costa,013,1133247,191372,190611,13589,204200,1298
2022-04-21,Del Norte,015,27424,5835,5827,200,6027,50
2022-04-21,El Dorado,017,186661,26904,26837,3239,30076,209
2022-04-21,Fresno,019,978130,232152,231751,24139,255890,2744
2022-04-21,Glenn,021,27897,4991,4989,1622,6611,48
2022-04-21,Humboldt,023,135768,17125,17033,3023,20056,145
2022-04-21,Imperial,025,180216,55537,55434,10896,66330,910
2022-04-21,Inyo,027,18085,4083,4079,507,4586,56
2022-04-21,Kern,029,883053,192253,192012,46448,238460,2267
2022-04-21,Kings,031,150075,51627,51588,3631,55219,444
2022-04-21,Lake,033,64148,10732,10720,903,11623,134
2022-04-21,Lassen,035,31185,8973,8966,890,9856,65
2022-04-21,Los Angeles,037,10098052,2731948,2725630,126713,2852343,31667
2022-04-21,Madera,039,155013,37340,37333,6108,43441,354
2022-04-21,Marin,041,260295,34342,34150,2701,36851,288
2022-04-21,Mariposa,043,17540,2429,2422,206,2628,30
2022-04-21,Mendocino,045,87422,13202,13158,3089,16247,122
2022-04-21,Merced,047,269075,62316,62286,8753,71039,815
2022-04-21,Modoc,049,8938,745,745,253,998,8
2022-04-21,Mono,051,14174,2988,2986,128,3114,6
2022-04-21,Monterey,053,433212,79897,79560,14108,93668,729
2022-04-21,Napa,055,140530,26230,26093,1031,27124,143
2022-04-21,Nevada,057,99092,16083,16052,1231,17283,127
2022-04-21,Orange,059,3164182,550512,549765,42194,591959,6989
2022-04-21,Placer,061,380077,63184,63037,7479,70516,622
2022-04-21,Plumas,063,18699,2982,2934,373,3307,13
2022-04-21,Riverside,065,2383286,593489,592683,28401,621084,6450
2022-04-21,Sacramento,067,1510023,282644,280551,27523,308074,2993
2022-04-21,San Benito,069,59416,12971,12966,522,13488,98
2022-04-21,San Bernardino,071,2135413,568809,566806,25112,591918,7047
2022-04-21,San Diego,073,3302833,759412,758311,53038,811349,5233
2022-04-21,San Francisco,075,870044,129054,128323,8625,136948,857
2022-04-21,San Joaquin,077,732212,166999,166626,9847,176473,2224
2022-04-21,San Luis Obispo,079,281455,52886,52826,3862,56688,476
2022-04-21,San Mateo,081,765935,125054,124106,7334,131440,703
2022-04-21,Santa Barbara,083,443738,86639,86376,4845,91221,685
2022-04-21,Santa Clara,085,1922200,317835,317487,12789,330276,2277
2022-04-21,Santa Cruz,087,273765,48902,48255,2198,50453,261
2022-04-21,Shasta,089,179085,30643,30607,6170,36777,557
2022-04-21,Sierra,091,2930,274,276,48,324,4
2022-04-21,Siskiyou,093,43540,4460,4453,2772,7225,81
2022-04-21,Solano,095,438530,82173,81982,5614,87596,448
2022-04-21,Sonoma,097,501317,84962,84581,2830,87411,486
2022-04-21,Stanislaus,099,539301,117794,117737,17466,135203,1632
2022-04-21,Sutter,101,95872,20554,20605,2152,22757,224
2022-04-21,Tehama,103,63373,12067,12064,2630,14694,201
2022-04-21,Trinity,105,12862,1184,1177,295,1472,20
2022-04-21,Tulare,107,460477,106806,106354,28828,135182,1446
2022-04-21,Tuolumne,109,53932,12682,12664,573,13237,181
2022-04-21,Ventura,111,848112,174400,174091,9420,183511,1479
2022-04-21,Yolo,113,214977,37159,36990,3251,40241,314
2022-04-21,Yuba,115,75493,15908,15888,1228,17116,121
2022-04-20,Alameda,001,1643700,260825,258734,14529,273263,1832
2022-04-20,Alpine,003,1148,124,124,1,125,0
2022-04-20,Amador,005,37829,8561,8494,663,9157,86
2022-04-20,Butte,007,227075,33136,33083,6714,39797,408
2022-04-20,Calaveras,009,45235,7307,7288,361,7649,119
2022-04-20,Colusa,011,21464,3454,3453,1076,4529,21
2022-04-20,Contra Costa,013,1133247,191144,190042,13565,203607,1299
2022-04-20,Del Norte,015,27424,5830,5814,200,6014,50
2022-04-20,El Dorado,017,186661,26889,26821,3235,30056,209
2022-04-20,Fresno,019,978130,232101,231568,24137,255705,2740
2022-04-20,Glenn,021,27897,4990,4988,1619,6607,48
2022-04-20,Humboldt,023,135768,17101,16976,3019,19995,145
2022-04-20,Imperial,025,180216,55530,55405,10893,66298,910
2022-04-20,Inyo,027,18085,4083,4075,506,4581,56
2022-04-20,Kern,029,883053,192214,191915,46431,238346,2262
2022-04-20,Kings,031,150075,51618,51571,3629,55200,445
2022-04-20,Lake,033,64148,10732,10711,903,11614,134
2022-04-20,Lassen,035,31185,8973,8951,890,9841,65
2022-04-20,Los Angeles,037,10098052,2730241,2721699,126601,2848300,31630
2022-04-20,Madera,039,155013,37337,37333,6105,43438,354
2022-04-20,Marin,041,260295,34301,33985,2677,36662,288
2022-04-20,Mariposa,043,17540,2427,2412,206,2618,30
2022-04-20,Mendocino,045,87422,13196,13128,3079,16207,122
2022-04-20,Merced,047,269075,62306,62322,8738,71060,813
2022-04-20,Modoc,049,8938,745,744,253,997,8
2022-04-20,Mono,051,14174,2987,2984,128,3112,6
2022-04-20,Monterey,053,433212,79850,79419,14089,93508,727
2022-04-20,Napa,055,140530,26197,26016,1028,27044,143
2022-04-20,Nevada,057,99092,16073,16034,1229,17263,127
2022-04-20,Orange,059,3164182,550188,549136,42146,591282,6963
2022-04-20,Placer,061,380077,63157,62928,7475,70403,619
2022-04-20,Plumas,063,18699,2982,2932,373,3305,13
2022-04-20,Riverside,065,2383286,593297,592224,28380,620604,6447
2022-04-20,Sacramento,067,1510023,282501,279326,27504,306830,2987
2022-04-20,San Benito,069,59416,12965,12971,522,13493,98
2022-04-20,San Bernardino,071,2135413,568602,565405,25093,590498,6977
2022-04-20,San Diego,073,3302833,758974,757138,52984,810122,5231
2022-04-20,San Francisco,075,870044,128751,127594,8605,136199,854
2022-04-20,San Joaquin,077,732212,166932,166531,9824,176355,2222
2022-04-20,San Luis Obispo,079,281455,52859,52740,3854,56594,476
2022-04-20,San Mateo,081,765935,124833,123279,7301,130580,701
2022-04-20,Santa Barbara,083,443738,86603,86214,4840,91054,685
2022-04-20,Santa Clara,085,1922200,317432,316355,12758,329113,2274
2022-04-20,Santa Cruz,087,273765,48838,47997,2194,50191,261
2022-04-20,Shasta,089,179085,30639,30590,6169,36759,554
2022-04-20,Sierra,091,2930,274,276,48,324,4
2022-04-20,Siskiyou,093,43540,4459,4446,2771,7217,80
2022-04-20,Solano,095,438530,82104,81841,5612,87453,447
2022-04-20,Sonoma,097,501317,84877,84429,2806,87235,485
2022-04-20,Stanislaus,099,539301,117760,117540,17456,134996,1630
2022-04-20,Sutter,101,95872,20547,20632,2152,22784,224
2022-04-20,Tehama,103,63373,12064,12061,2629,14690,199
2022-04-20,Trinity,105,12862,1184,1178,295,1473,20
2022-04-20,Tulare,107,460477,106800,105974,28817,134791,1439
2022-04-20,Tuolumne,109,53932,12677,12648,571,13219,180
2022-04-20,Ventura,111,848112,174315,173904,9412,183316,1475
2022-04-20,Yolo,113,214977,37130,36785,3246,40031,311
2022-04-20,Yuba,115,75493,15905,15868,1226,17094,121
2022-04-19,Alameda,001,1643700,260472,258734,14494,273228,1832
2022-04-19,Alpine,003,1148,124,124,1,125,0
2022-04-19,Amador,005,37829,8557,8494,661,9155,86
2022-04-19,Butte,007,227075,33130,33083,6711,39794,408
2022-04-19,Calaveras,009,45235,7304,7288,361,7649,119
2022-04-19,Colusa,011,21464,3454,3453,1076,4529,21
2022-04-19,Contra Costa,013,1133247,190899,190042,13551,203593,1299
2022-04-19,Del Norte,015,27424,5828,5814,198,6012,50
2022-04-19,El Dorado,017,186661,26874,26821,3232,30053,209
2022-04-19,Fresno,019,978130,232045,231568,24128,255696,2740
2022-04-19,Glenn,021,27897,4989,4988,1618,6606,48
2022-04-19,Humboldt,023,135768,17066,16976,3009,19985,145
2022-04-19,Imperial,025,180216,55523,55405,10889,66294,910
2022-04-19,Inyo,027,18085,4080,4075,506,4581,56
2022-04-19,Kern,029,883053,192178,191915,46419,238334,2262
2022-04-19,Kings,031,150075,51604,51571,3628,55199,445
2022-04-19,Lake,033,64148,10728,10711,903,11614,134
2022-04-19,Lassen,035,31185,8973,8951,890,9841,65
2022-04-19,Los Angeles,037,10098052,2728481,2721699,126475,2848174,31630
2022-04-19,Madera,039,155013,37334,37333,6104,43437,354
2022-04-19,Marin,041,260295,34250,33985,2661,36646,288
2022-04-19,Mariposa,043,17540,2427,2412,206,2618,30
2022-04-19,Mendocino,045,87422,13188,13128,3070,16198,122
2022-04-19,Merced,047,269075,62286,62322,8735,71057,813
2022-04-19,Modoc,049,8938,745,744,253,997,8
2022-04-19,Mono,051,14174,2986,2984,128,3112,6
2022-04-19,Monterey,053,433212,79829,79419,14076,93495,727
2022-04-19,Napa,055,140530,26175,26016,1020,27036,143
2022-04-19,Nevada,057,99092,16068,16034,1227,17261,127
2022-04-19,Orange,059,3164182,549907,549136,42104,591240,6963
2022-04-19,Placer,061,380077,63126,62928,7470,70398,619
2022-04-19,Plumas,063,18699,2982,2932,373,3305,13
2022-04-19,Riverside,065,2383286,593114,592224,28364,620588,6447
2022-04-19,Sacramento,067,1510023,282331,279326,27480,306806,2987
2022-04-19,San Benito,069,59416,12959,12971,522,13493,98
2022-04-19,San Bernardino,071,2135413,568385,565405,25070,590475,6977
2022-04-19,San Diego,073,3302833,758516,757138,52929,810067,5231
2022-04-19,San Francisco,075,870044,128415,127594,8586,136180,854
2022-04-19,San Joaquin,077,732212,166879,166531,9815,176346,2222
2022-04-19,San Luis Obispo,079,281455,52825,52740,3846,56586,476
2022-04-19,San Mateo,081,765935,124598,123279,7280,130559,701
2022-04-19,Santa Barbara,083,443738,86549,86214,4833,91047,685
2022-04-19,Santa Clara,085,1922200,317014,316355,12728,329083,2274
2022-04-19,Santa Cruz,087,273765,48784,47997,2192,50189,261
2022-04-19,Shasta,089,179085,30627,30590,6168,36758,554
2022-04-19,Sierra,091,2930,274,276,48,324,4
2022-04-19,Siskiyou,093,43540,4458,4446,2769,7215,80
2022-04-19,Solano,095,438530,82026,81841,5607,87448,447
2022-04-19,Sonoma,097,501317,84773,84429,2783,87212,485
2022-04-19,Stanislaus,099,539301,117734,117540,17452,134992,1630
2022-04-19,Sutter,101,95872,20547,20632,2152,22784,224
2022-04-19,Tehama,103,63373,12063,12061,2629,14690,199
2022-04-19,Trinity,105,12862,1183,1178,295,1473,20
2022-04-19,Tulare,107,460477,106783,105974,28811,134785,1439
2022-04-19,Tuolumne,109,53932,12674,12648,571,13219,180
2022-04-19,Ventura,111,848112,174222,173904,9402,183306,1475
2022-04-19,Yolo,113,214977,37098,36785,3244,40029,311
2022-04-19,Yuba,115,75493,15898,15868,1226,17094,121
2022-04-18,Alameda,001,1643700,260092,258734,14472,273206,1832
2022-04-18,Alpine,003,1148,124,124,1,125,0
2022-04-18,Amador,005,37829,8556,8494,660,9154,86
2022-04-18,Butte,007,227075,33127,33083,6705,39788,408
2022-04-18,Calaveras,009,45235,7300,7288,360,7648,119
2022-04-18,Colusa,011,21464,3453,3453,1076,4529,21
2022-04-18,Contra Costa,013,1133247,190664,190042,13530,203572,1299
2022-04-18,Del Norte,015,27424,5823,5814,198,6012,50
2022-04-18,El Dorado,017,186661,26858,26821,3229,30050,209
2022-04-18,Fresno,019,978130,231999,231568,24117,255685,2740
2022-04-18,Glenn,021,27897,4988,4988,1617,6605,48
2022-04-18,Humboldt,023,135768,17035,16976,3007,19983,145
2022-04-18,Imperial,025,180216,55511,55405,10887,66292,910
2022-04-18,Inyo,027,18085,4080,4075,506,4581,56
2022-04-18,Kern,029,883053,192134,191915,46406,238321,2262
2022-04-18,Kings,031,150075,51599,51571,3628,55199,445
2022-04-18,Lake,033,64148,10724,10711,903,11614,134
2022-04-18,Lassen,035,31185,8973,8951,890,9841,65
2022-04-18,Los Angeles,037,10098052,2726698,2721699,126361,2848060,31630
2022-04-18,Madera,039,155013,37326,37333,6104,43437,354
2022-04-18,Marin,041,260295,34186,33985,2637,36622,288
2022-04-18,Mariposa,043,17540,2425,2412,206,2618,30
2022-04-18,Mendocino,045,87422,13172,13128,3064,16192,122
2022-04-18,Merced,047,269075,62274,62322,8729,71051,813
2022-04-18,Modoc,049,8938,744,744,253,997,8
2022-04-18,Mono,051,14174,2985,2984,127,3111,6
2022-04-18,Monterey,053,433212,79755,79419,14060,93479,727
2022-04-18,Napa,055,140530,26139,26016,1019,27035,143
2022-04-18,Nevada,057,99092,16058,16034,1225,17259,127
2022-04-18,Orange,059,3164182,549622,549136,42071,591207,6963
2022-04-18,Placer,061,380077,63096,62928,7468,70396,619
2022-04-18,Plumas,063,18699,2982,2932,373,3305,13
2022-04-18,Riverside,065,2383286,592901,592224,28344,620568,6447
2022-04-18,Sacramento,067,1510023,282172,279326,27467,306793,2987
2022-04-18,San Benito,069,59416,12953,12971,522,13493,98
2022-04-18,San Bernardino,071,2135413,568172,565405,25047,590452,6977
2022-04-18,San Diego,073,3302833,758054,757138,52877,810015,5231
2022-04-18,San Francisco,075,870044,128092,127594,8574,136168,854
2022-04-18,San Joaquin,077,732212,166822,166531,9808,176339,2222
2022-04-18,San Luis Obispo,079,281455,52797,52740,3841,56581,476
2022-04-18,San Mateo,081,765935,124367,123279,7258,130537,701
2022-04-18,Santa Barbara,083,443738,86480,86214,4831,91045,685
2022-04-18,Santa Clara,085,1922200,316565,316355,12705,329060,2274
2022-04-18,Santa Cruz,087,273765,48679,47997,2187,50184,261
2022-04-18,Shasta,089,179085,30622,30590,6166,36756,554
2022-04-18,Sierra,091,2930,274,276,48,324,4
2022-04-18,Siskiyou,093,43540,4457,4446,2768,7214,80
2022-04-18,Solano,095,438530,81967,81841,5602,87443,447
2022-04-18,Sonoma,097,501317,84675,84429,2771,87200,485
2022-04-18,Stanislaus,099,539301,117704,117540,17448,134988,1630
2022-04-18,Sutter,101,95872,20545,20632,2149,22781,224
2022-04-18,Tehama,103,63373,12059,12061,2629,14690,199
2022-04-18,Trinity,105,12862,1183,1178,295,1473,20
2022-04-18,Tulare,107,460477,106767,105974,28800,134774,1439
2022-04-18,Tuolumne,109,53932,12666,12648,570,13218,180
2022-04-18,Ventura,111,848112,174128,173904,9395,183299,1475
2022-04-18,Yolo,113,214977,37055,36785,3244,40029,311
2022-04-18,Yuba,115,75493,15890,15868,1223,17091,121
2022-04-17,Alameda,001,1643700,259696,257897,14444,272341,1829
2022-04-17,Alpine,003,1148,124,124,1,125,0
2022-04-17,Amador,005,37829,8550,8491,658,9149,86
2022-04-17,Butte,007,227075,33124,33053,6702,39755,405
2022-04-17,Calaveras,009,45235,7296,7275,358,7633,119
2022-04-17,Colusa,011,21464,3452,3450,1076,4526,21
2022-04-17,Contra Costa,013,1133247,190435,189742,13494,203236,1298
2022-04-17,Del Norte,015,27424,5818,5809,198,6007,50
2022-04-17,El Dorado,017,186661,26847,26796,3228,30024,209
2022-04-17,Fresno,019,978130,231923,231455,24111,255566,2739
2022-04-17,Glenn,021,27897,4988,4991,1617,6608,48
2022-04-17,Humboldt,023,135768,17002,16929,3004,19933,143
2022-04-17,Imperial,025,180216,55503,55371,10885,66256,910
2022-04-17,Inyo,027,18085,4077,4075,506,4581,56
2022-04-17,Kern,029,883053,192099,191866,46391,238257,2258
2022-04-17,Kings,031,150075,51588,51544,3626,55170,445
2022-04-17,Lake,033,64148,10723,10702,903,11605,134
2022-04-17,Lassen,035,31185,8973,8950,890,9840,65
2022-04-17,Los Angeles,037,10098052,2724757,2717479,126242,2843721,31598
2022-04-17,Madera,039,155013,37320,37362,6104,43466,354
2022-04-17,Marin,041,260295,34119,33829,2607,36436,288
2022-04-17,Mariposa,043,17540,2417,2406,206,2612,30
2022-04-17,Mendocino,045,87422,13157,13107,3060,16167,122
2022-04-17,Merced,047,269075,62256,62295,8726,71021,813
2022-04-17,Modoc,049,8938,744,743,253,996,8
2022-04-17,Mono,051,14174,2985,2977,127,3104,6
2022-04-17,Monterey,053,433212,79725,79311,14039,93350,727
2022-04-17,Napa,055,140530,26098,25929,1013,26942,143
2022-04-17,Nevada,057,99092,16043,16014,1222,17236,123
2022-04-17,Orange,059,3164182,549256,548311,42021,590332,6945
2022-04-17,Placer,061,380077,63058,62882,7462,70344,618
2022-04-17,Plumas,063,18699,2982,2929,373,3302,13
2022-04-17,Riverside,065,2383286,592679,591772,28322,620094,6443
2022-04-17,Sacramento,067,1510023,282009,278523,27441,305964,2978
2022-04-17,San Benito,069,59416,12950,12926,521,13447,98
2022-04-17,San Bernardino,071,2135413,567932,564397,25030,589427,6948
2022-04-17,San Diego,073,3302833,757575,756165,52806,808971,5229
2022-04-17,San Francisco,075,870044,127777,126976,8558,135534,854
2022-04-17,San Joaquin,077,732212,166772,166645,9801,176446,2220
2022-04-17,San Luis Obispo,079,281455,52728,52698,3837,56535,476
2022-04-17,San Mateo,081,765935,124129,122652,7241,129893,699
2022-04-17,Santa Barbara,083,443738,86422,86030,4825,90855,684
2022-04-17,Santa Clara,085,1922200,316069,315296,12677,327973,2268
2022-04-17,Santa Cruz,087,273765,48557,47895,2184,50079,261
2022-04-17,Shasta,089,179085,30611,30578,6162,36740,554
2022-04-17,Sierra,091,2930,274,276,48,324,4
2022-04-17,Siskiyou,093,43540,4452,4444,2767,7211,80
2022-04-17,Solano,095,438530,81904,81781,5599,87380,447
2022-04-17,Sonoma,097,501317,84565,84172,2763,86935,485
2022-04-17,Stanislaus,099,539301,117673,117567,17441,135008,1619
2022-04-17,Sutter,101,95872,20539,20621,2148,22769,224
2022-04-17,Tehama,103,63373,12058,12061,2629,14690,199
2022-04-17,Trinity,105,12862,1182,1178,295,1473,20
2022-04-17,Tulare,107,460477,106753,105757,28791,134548,1428
2022-04-17,Tuolumne,109,53932,12660,12640,570,13210,180
2022-04-17,Ventura,111,848112,174032,173665,9383,183048,1474
2022-04-17,Yolo,113,214977,37026,36752,3242,39994,311
2022-04-17,Yuba,115,75493,15882,15857,1223,17080,121
2022-04-16,Alameda,001,1643700,259549,257897,14435,272332,1829
2022-04-16,Alpine,003,1148,124,124,1,125,0
2022-04-16,Amador,005,37829,8549,8491,658,9149,86
2022-04-16,Butte,007,227075,33121,33053,6700,39753,405
2022-04-16,Calaveras,009,45235,7295,7275,358,7633,119
2022-04-16,Colusa,011,21464,3452,3450,1076,4526,21
2022-04-16,Contra Costa,013,1133247,190347,189742,13488,203230,1298
2022-04-16,Del Norte,015,27424,5818,5809,198,6007,50
2022-04-16,El Dorado,017,186661,26836,26796,3228,30024,209
2022-04-16,Fresno,019,978130,231897,231455,24110,255565,2739
2022-04-16,Glenn,021,27897,4988,4991,1617,6608,48
2022-04-16,Humboldt,023,135768,16995,16929,2999,19928,143
2022-04-16,Imperial,025,180216,55497,55371,10884,66255,910
2022-04-16,Inyo,027,18085,4077,4075,506,4581,56
2022-04-16,Kern,029,883053,192089,191866,46378,238244,2258
2022-04-16,Kings,031,150075,51585,51544,3626,55170,445
2022-04-16,Lake,033,64148,10721,10702,903,11605,134
2022-04-16,Lassen,035,31185,8973,8950,890,9840,65
2022-04-16,Los Angeles,037,10098052,2724068,2717479,126192,2843671,31598
2022-04-16,Madera,039,155013,37319,37362,6104,43466,354
2022-04-16,Marin,041,260295,34082,33829,2581,36410,288
2022-04-16,Mariposa,043,17540,2416,2406,206,2612,30
2022-04-16,Mendocino,045,87422,13151,13107,3060,16167,122
2022-04-16,Merced,047,269075,62253,62295,8726,71021,813
2022-04-16,Modoc,049,8938,744,743,253,996,8
2022-04-16,Mono,051,14174,2985,2977,127,3104,6
2022-04-16,Monterey,053,433212,79709,79311,14030,93341,727
2022-04-16,Napa,055,140530,26075,25929,1010,26939,143
2022-04-16,Nevada,057,99092,16040,16014,1221,17235,123
2022-04-16,Orange,059,3164182,549141,548311,41992,590303,6945
2022-04-16,Placer,061,380077,63043,62882,7460,70342,618
2022-04-16,Plumas,063,18699,2980,2929,373,3302,13
2022-04-16,Riverside,065,2383286,592602,591772,28316,620088,6443
2022-04-16,Sacramento,067,1510023,281959,278523,27433,305956,2978
2022-04-16,San Benito,069,59416,12949,12926,521,13447,98
2022-04-16,San Bernardino,071,2135413,567834,564397,25026,589423,6948
2022-04-16,San Diego,073,3302833,757430,756165,52794,808959,5229
2022-04-16,San Francisco,075,870044,127622,126976,8549,135525,854
2022-04-16,San Joaquin,077,732212,166735,166645,9797,176442,2220
2022-04-16,San Luis Obispo,079,281455,52722,52698,3836,56534,476
2022-04-16,San Mateo,081,765935,124033,122652,7236,129888,699
2022-04-16,Santa Barbara,083,443738,86393,86030,4825,90855,684
2022-04-16,Santa Clara,085,1922200,315836,315296,12668,327964,2268
2022-04-16,Santa Cruz,087,273765,48530,47895,2184,50079,261
2022-04-16,Shasta,089,179085,30607,30578,6162,36740,554
2022-04-16,Sierra,091,2930,274,276,48,324,4
2022-04-16,Siskiyou,093,43540,4452,4444,2767,7211,80
2022-04-16,Solano,095,438530,81889,81781,5596,87377,447
2022-04-16,Sonoma,097,501317,84514,84172,2753,86925,485
2022-04-16,Stanislaus,099,539301,117653,117567,17436,135003,1619
2022-04-16,Sutter,101,95872,20536,20621,2148,22769,224
2022-04-16,Tehama,103,63373,12057,12061,2629,14690,199
2022-04-16,Trinity,105,12862,1182,1178,295,1473,20
2022-04-16,Tulare,107,460477,106742,105757,28788,134545,1428
2022-04-16,Tuolumne,109,53932,12659,12640,570,13210,180
2022-04-16,Ventura,111,848112,174005,173665,9380,183045,1474
2022-04-16,Yolo,113,214977,37017,36752,3241,39993,311
2022-04-16,Yuba,115,75493,15880,15857,1223,17080,121
2022-04-15,Alameda,001,1643700,259367,257897,14428,272325,1829
2022-04-15,Alpine,003,1148,124,124,1,125,0
2022-04-15,Amador,005,37829,8548,8491,657,9148,86
2022-04-15,Butte,007,227075,33119,33053,6697,39750,405
2022-04-15,Calaveras,009,45235,7293,7275,358,7633,119
2022-04-15,Colusa,011,21464,3452,3450,1076,4526,21
2022-04-15,Contra Costa,013,1133247,190233,189742,13484,203226,1298
2022-04-15,Del Norte,015,27424,5818,5809,198,6007,50
2022-04-15,El Dorado,017,186661,26822,26796,3227,30023,209
2022-04-15,Fresno,019,978130,231868,231455,24110,255565,2739
2022-04-15,Glenn,021,27897,4988,4991,1617,6608,48
2022-04-15,Humboldt,023,135768,16983,16929,2998,19927,143
2022-04-15,Imperial,025,180216,55495,55371,10884,66255,910
2022-04-15,Inyo,027,18085,4077,4075,505,4580,56
2022-04-15,Kern,029,883053,192075,191866,46370,238236,2258
2022-04-15,Kings,031,150075,51581,51544,3626,55170,445
2022-04-15,Lake,033,64148,10716,10702,903,11605,134
2022-04-15,Lassen,035,31185,8973,8950,890,9840,65
2022-04-15,Los Angeles,037,10098052,2723306,2717479,126124,2843603,31598
2022-04-15,Madera,039,155013,37317,37362,6104,43466,354
2022-04-15,Marin,041,260295,34048,33829,2560,36389,288
2022-04-15,Mariposa,043,17540,2415,2406,206,2612,30
2022-04-15,Mendocino,045,87422,13145,13107,3059,16166,122
2022-04-15,Merced,047,269075,62249,62295,8726,71021,813
2022-04-15,Modoc,049,8938,744,743,253,996,8
2022-04-15,Mono,051,14174,2981,2977,127,3104,6
2022-04-15,Monterey,053,433212,79684,79311,14024,93335,727
2022-04-15,Napa,055,140530,26058,25929,1008,26937,143
2022-04-15,Nevada,057,99092,16038,16014,1220,17234,123
2022-04-15,Orange,059,3164182,549023,548311,41963,590274,6945
2022-04-15,Placer,061,380077,63029,62882,7459,70341,618
2022-04-15,Plumas,063,18699,2980,2929,373,3302,13
2022-04-15,Riverside,065,2383286,592503,591772,28311,620083,6443
2022-04-15,Sacramento,067,1510023,281881,278523,27429,305952,2978
2022-04-15,San Benito,069,59416,12947,12926,520,13446,98
2022-04-15,San Bernardino,071,2135413,567754,564397,25023,589420,6948
2022-04-15,San Diego,073,3302833,757240,756165,52781,808946,5229
2022-04-15,San Francisco,075,870044,127472,126976,8536,135512,854
2022-04-15,San Joaquin,077,732212,166712,166645,9794,176439,2220
2022-04-15,San Luis Obispo,079,281455,52714,52698,3836,56534,476
2022-04-15,San Mateo,081,765935,123900,122652,7226,129878,699
2022-04-15,Santa Barbara,083,443738,86359,86030,4824,90854,684
2022-04-15,Santa Clara,085,1922200,315546,315296,12661,327957,2268
2022-04-15,Santa Cruz,087,273765,48501,47895,2183,50078,261
2022-04-15,Shasta,089,179085,30598,30578,6162,36740,554
2022-04-15,Sierra,091,2930,274,276,48,324,4
2022-04-15,Siskiyou,093,43540,4450,4444,2767,7211,80
2022-04-15,Solano,095,438530,81864,81781,5596,87377,447
2022-04-15,Sonoma,097,501317,84465,84172,2738,86910,485
2022-04-15,Stanislaus,099,539301,117634,117567,17434,135001,1619
2022-04-15,Sutter,101,95872,20533,20621,2148,22769,224
2022-04-15,Tehama,103,63373,12057,12061,2629,14690,199
2022-04-15,Trinity,105,12862,1182,1178,295,1473,20
2022-04-15,Tulare,107,460477,106736,105757,28782,134539,1428
2022-04-15,Tuolumne,109,53932,12657,12640,569,13209,180
2022-04-15,Ventura,111,848112,173976,173665,9373,183038,1474
2022-04-15,Yolo,113,214977,37007,36752,3241,39993,311
2022-04-15,Yuba,115,75493,15877,15857,1223,17080,121
2022-04-14,Alameda,001,1643700,259103,257897,14417,272314,1829
2022-04-14,Alpine,003,1148,124,124,1,125,0
2022-04-14,Amador,005,37829,8548,8491,657,9148,86
2022-04-14,Butte,007,227075,33114,33053,6691,39744,405
2022-04-14,Calaveras,009,45235,7292,7275,358,7633,119
2022-04-14,Colusa,011,21464,3452,3450,1076,4526,21
2022-04-14,Contra Costa,013,1133247,190078,189742,13474,203216,1298
2022-04-14,Del Norte,015,27424,5816,5809,198,6007,50
2022-04-14,El Dorado,017,186661,26819,26796,3225,30021,209
2022-04-14,Fresno,019,978130,231842,231455,24109,255564,2739
2022-04-14,Glenn,021,27897,4987,4991,1615,6606,48
2022-04-14,Humboldt,023,135768,16970,16929,2996,19925,143
2022-04-14,Imperial,025,180216,55485,55371,10884,66255,910
2022-04-14,Inyo,027,18085,4077,4075,504,4579,56
2022-04-14,Kern,029,883053,192055,191866,46362,238228,2258
2022-04-14,Kings,031,150075,51573,51544,3626,55170,445
2022-04-14,Lake,033,64148,10715,10702,903,11605,134
2022-04-14,Lassen,035,31185,8973,8950,889,9839,65
2022-04-14,Los Angeles,037,10098052,2722227,2717479,126032,2843511,31598
2022-04-14,Madera,039,155013,37315,37362,6104,43466,354
2022-04-14,Marin,041,260295,34013,33829,2533,36362,288
2022-04-14,Mariposa,043,17540,2414,2406,206,2612,30
2022-04-14,Mendocino,045,87422,13140,13107,3059,16166,122
2022-04-14,Merced,047,269075,62244,62295,8726,71021,813
2022-04-14,Modoc,049,8938,743,743,253,996,8
2022-04-14,Mono,051,14174,2981,2977,125,3102,6
2022-04-14,Monterey,053,433212,79659,79311,14018,93329,727
2022-04-14,Napa,055,140530,26035,25929,1007,26936,143
2022-04-14,Nevada,057,99092,16031,16014,1219,17233,123
2022-04-14,Orange,059,3164182,548836,548311,41935,590246,6945
2022-04-14,Placer,061,380077,63012,62882,7454,70336,618
2022-04-14,Plumas,063,18699,2980,2929,373,3302,13
2022-04-14,Riverside,065,2383286,592387,591772,28300,620072,6443
2022-04-14,Sacramento,067,1510023,281759,278523,27415,305938,2978
2022-04-14,San Benito,069,59416,12942,12926,520,13446,98
2022-04-14,San Bernardino,071,2135413,567578,564397,25017,589414,6948
2022-04-14,San Diego,073,3302833,756963,756165,52748,808913,5229
2022-04-14,San Francisco,075,870044,127265,126976,8524,135500,854
2022-04-14,San Joaquin,077,732212,166684,166645,9791,176436,2220
2022-04-14,San Luis Obispo,079,281455,52698,52698,3833,56531,476
2022-04-14,San Mateo,081,765935,123744,122652,7206,129858,699
2022-04-14,Santa Barbara,083,443738,86313,86030,4823,90853,684
2022-04-14,Santa Clara,085,1922200,315247,315296,12652,327948,2268
2022-04-14,Santa Cruz,087,273765,48471,47895,2182,50077,261
2022-04-14,Shasta,089,179085,30596,30578,6161,36739,554
2022-04-14,Sierra,091,2930,274,276,48,324,4
2022-04-14,Siskiyou,093,43540,4450,4444,2766,7210,80
2022-04-14,Solano,095,438530,81828,81781,5594,87375,447
2022-04-14,Sonoma,097,501317,84376,84172,2733,86905,485
2022-04-14,Stanislaus,099,539301,117616,117567,17431,134998,1619
2022-04-14,Sutter,101,95872,20531,20621,2139,22760,224
2022-04-14,Tehama,103,63373,12056,12061,2628,14689,199
2022-04-14,Trinity,105,12862,1182,1178,295,1473,20
2022-04-14,Tulare,107,460477,106722,105757,28778,134535,1428
2022-04-14,Tuolumne,109,53932,12653,12640,569,13209,180
2022-04-14,Ventura,111,848112,173925,173665,9366,183031,1474
2022-04-14,Yolo,113,214977,36996,36752,3237,39989,311
2022-04-14,Yuba,115,75493,15874,15857,1223,17080,121
2022-04-13,Alameda,001,1643700,258851,257440,14399,271839,1833
2022-04-13,Alpine,003,1148,124,124,1,125,0
2022-04-13,Amador,005,37829,8546,8490,657,9147,86
2022-04-13,Butte,007,227075,33106,33044,6691,39735,402
2022-04-13,Calaveras,009,45235,7291,7270,358,7628,119
2022-04-13,Colusa,011,21464,3452,3451,1076,4527,21
2022-04-13,Contra Costa,013,1133247,189950,189471,13460,202931,1298
2022-04-13,Del Norte,015,27424,5814,5812,198,6010,50
2022-04-13,El Dorado,017,186661,26815,26794,3225,30019,208
2022-04-13,Fresno,019,978130,231810,231325,24097,255422,2738
2022-04-13,Glenn,021,27897,4986,4989,1615,6604,48
2022-04-13,Humboldt,023,135768,16958,16922,2995,19917,143
2022-04-13,Imperial,025,180216,55473,55353,10880,66233,910
2022-04-13,Inyo,027,18085,4077,4074,501,4575,56
2022-04-13,Kern,029,883053,192032,191859,46356,238215,2249
2022-04-13,Kings,031,150075,51567,51535,3626,55161,443
2022-04-13,Lake,033,64148,10713,10695,903,11598,134
2022-04-13,Lassen,035,31185,8972,8949,889,9838,65
2022-04-13,Los Angeles,037,10098052,2720973,2715722,125958,2841680,31578
2022-04-13,Madera,039,155013,37312,37361,6103,43464,354
2022-04-13,Marin,041,260295,33974,33747,2503,36250,288
2022-04-13,Mariposa,043,17540,2408,2402,206,2608,29
2022-04-13,Mendocino,045,87422,13131,13101,3057,16158,120
2022-04-13,Merced,047,269075,62233,62276,8725,71001,811
2022-04-13,Modoc,049,8938,743,743,253,996,8
2022-04-13,Mono,051,14174,2979,2971,125,3096,6
2022-04-13,Monterey,053,433212,79645,79179,14008,93187,727
2022-04-13,Napa,055,140530,26019,25892,1004,26896,143
2022-04-13,Nevada,057,99092,16025,16002,1219,17221,123
2022-04-13,Orange,059,3164182,548634,547783,41908,589691,6935
2022-04-13,Placer,061,380077,62984,62851,7449,70300,615
2022-04-13,Plumas,063,18699,2979,2923,373,3296,13
2022-04-13,Riverside,065,2383286,592257,591659,28292,619951,6437
2022-04-13,Sacramento,067,1510023,281672,277866,27412,305278,2974
2022-04-13,San Benito,069,59416,12936,12927,520,13447,98
2022-04-13,San Bernardino,071,2135413,567436,563709,25010,588719,6905
2022-04-13,San Diego,073,3302833,756679,755584,52718,808302,5223
2022-04-13,San Francisco,075,870044,127093,126608,8508,135116,850
2022-04-13,San Joaquin,077,732212,166650,166654,9787,176441,2219
2022-04-13,San Luis Obispo,079,281455,52674,52660,3833,56493,476
2022-04-13,San Mateo,081,765935,123594,122167,7184,129351,699
2022-04-13,Santa Barbara,083,443738,86274,85938,4819,90757,684
2022-04-13,Santa Clara,085,1922200,314980,314863,12636,327499,2267
2022-04-13,Santa Cruz,087,273765,48417,47765,2181,49946,260
2022-04-13,Shasta,089,179085,30594,30569,6161,36730,551
2022-04-13,Sierra,091,2930,274,276,48,324,4
2022-04-13,Siskiyou,093,43540,4449,4444,2765,7209,80
2022-04-13,Solano,095,438530,81790,81843,5592,87435,448
2022-04-13,Sonoma,097,501317,84309,84033,2718,86751,485
2022-04-13,Stanislaus,099,539301,117599,117573,17428,135001,1577
2022-04-13,Sutter,101,95872,20527,20610,2139,22749,223
2022-04-13,Tehama,103,63373,12055,12062,2627,14689,200
2022-04-13,Trinity,105,12862,1182,1177,295,1472,20
2022-04-13,Tulare,107,460477,106715,105519,28773,134292,1426
2022-04-13,Tuolumne,109,53932,12647,12639,569,13208,180
2022-04-13,Ventura,111,848112,173869,173558,9362,182920,1474
2022-04-13,Yolo,113,214977,36975,36684,3235,39919,311
2022-04-13,Yuba,115,75493,15870,15851,1223,17074,121
2022-04-12,Alameda,001,1643700,258607,257440,14389,271829,1833
2022-04-12,Alpine,003,1148,124,124,1,125,0
2022-04-12,Amador,005,37829,8545,8490,657,9147,86
2022-04-12,Butte,007,227075,33094,33044,6686,39730,402
2022-04-12,Calaveras,009,45235,7286,7270,357,7627,119
2022-04-12,Colusa,011,21464,3452,3451,1076,4527,21
2022-04-12,Contra Costa,013,1133247,189791,189471,13446,202917,1298
2022-04-12,Del Norte,015,27424,5811,5812,198,6010,50
2022-04-12,El Dorado,017,186661,26803,26794,3225,30019,208
2022-04-12,Fresno,019,978130,231780,231325,24090,255415,2738
2022-04-12,Glenn,021,27897,4986,4989,1615,6604,48
2022-04-12,Humboldt,023,135768,16950,16922,2994,19916,143
2022-04-12,Imperial,025,180216,55468,55353,10876,66229,910
2022-04-12,Inyo,027,18085,4077,4074,500,4574,56
2022-04-12,Kern,029,883053,192013,191859,46347,238206,2249
2022-04-12,Kings,031,150075,51559,51535,3624,55159,443
2022-04-12,Lake,033,64148,10709,10695,902,11597,134
2022-04-12,Lassen,035,31185,8972,8949,889,9838,65
2022-04-12,Los Angeles,037,10098052,2719736,2715722,125858,2841580,31578
2022-04-12,Madera,039,155013,37311,37361,6103,43464,354
2022-04-12,Marin,041,260295,33929,33747,2476,36223,288
2022-04-12,Mariposa,043,17540,2408,2402,206,2608,29
2022-04-12,Mendocino,045,87422,13122,13101,3052,16153,120
2022-04-12,Merced,047,269075,62219,62276,8722,70998,811
2022-04-12,Modoc,049,8938,743,743,253,996,8
2022-04-12,Mono,051,14174,2979,2971,125,3096,6
2022-04-12,Monterey,053,433212,79621,79179,14002,93181,727
2022-04-12,Napa,055,140530,25996,25892,994,26886,143
2022-04-12,Nevada,057,99092,16022,16002,1218,17220,123
2022-04-12,Orange,059,3164182,548382,547783,41873,589656,6935
2022-04-12,Placer,061,380077,62961,62851,7443,70294,615
2022-04-12,Plumas,063,18699,2977,2923,373,3296,13
2022-04-12,Riverside,065,2383286,592112,591659,28270,619929,6437
2022-04-12,Sacramento,067,1510023,281554,277866,27410,305276,2974
2022-04-12,San Benito,069,59416,12932,12927,519,13446,98
2022-04-12,San Bernardino,071,2135413,567264,563709,25005,588714,6905
2022-04-12,San Diego,073,3302833,756350,755584,52679,808263,5223
2022-04-12,San Francisco,075,870044,126882,126608,8493,135101,850
2022-04-12,San Joaquin,077,732212,166619,166654,9785,176439,2219
2022-04-12,San Luis Obispo,079,281455,52641,52660,3828,56488,476
2022-04-12,San Mateo,081,765935,123436,122167,7157,129324,699
2022-04-12,Santa Barbara,083,443738,86223,85938,4816,90754,684
2022-04-12,Santa Clara,085,1922200,314686,314863,12628,327491,2267
2022-04-12,Santa Cruz,087,273765,48339,47765,2179,49944,260
2022-04-12,Shasta,089,179085,30594,30569,6160,36729,551
2022-04-12,Sierra,091,2930,274,276,48,324,4
2022-04-12,Siskiyou,093,43540,4449,4444,2763,7207,80
2022-04-12,Solano,095,438530,81754,81843,5590,87433,448
2022-04-12,Sonoma,097,501317,84251,84033,2712,86745,485
2022-04-12,Stanislaus,099,539301,117580,117573,17422,134995,1577
2022-04-12,Sutter,101,95872,20524,20610,2139,22749,223
2022-04-12,Tehama,103,63373,12053,12062,2627,14689,200
2022-04-12,Trinity,105,12862,1182,1177,295,1472,20
2022-04-12,Tulare,107,460477,106701,105519,28768,134287,1426
2022-04-12,Tuolumne,109,53932,12645,12639,567,13206,180
2022-04-12,Ventura,111,848112,173822,173558,9358,182916,1474
2022-04-12,Yolo,113,214977,36961,36684,3228,39912,311
2022-04-12,Yuba,115,75493,15865,15851,1223,17074,121
2022-04-11,Alameda,001,1643700,258319,256649,14372,271021,1826
2022-04-11,Alpine,003,1148,124,124,1,125,0
2022-04-11,Amador,005,37829,8544,8489,657,9146,86
2022-04-11,Butte,007,227075,33081,33031,6683,39714,399
2022-04-11,Calaveras,009,45235,7283,7260,357,7617,119
2022-04-11,Colusa,011,21464,3450,3449,1076,4525,21
2022-04-11,Contra Costa,013,1133247,189620,189154,13430,202584,1296
2022-04-11,Del Norte,015,27424,5810,5811,198,6009,50
2022-04-11,El Dorado,017,186661,26791,26757,3224,29981,207
2022-04-11,Fresno,019,978130,231760,231090,24089,255179,2731
2022-04-11,Glenn,021,27897,4985,4988,1614,6602,47
2022-04-11,Humboldt,023,135768,16934,16913,2994,19907,141
2022-04-11,Imperial,025,180216,55463,55267,10874,66141,910
2022-04-11,Inyo,027,18085,4077,4071,500,4571,56
2022-04-11,Kern,029,883053,191989,191542,46343,237885,2244
2022-04-11,Kings,031,150075,51555,51519,3624,55143,443
2022-04-11,Lake,033,64148,10708,10690,901,11591,134
2022-04-11,Lassen,035,31185,8972,8948,889,9837,65
2022-04-11,Los Angeles,037,10098052,2718494,2709735,125784,2835519,31509
2022-04-11,Madera,039,155013,37304,37356,6103,43459,354
2022-04-11,Marin,041,260295,33873,33648,2457,36105,288
2022-04-11,Mariposa,043,17540,2407,2394,206,2600,29
2022-04-11,Mendocino,045,87422,13118,13087,3050,16137,120
2022-04-11,Merced,047,269075,62209,62231,8720,70951,811
2022-04-11,Modoc,049,8938,743,743,253,996,8
2022-04-11,Mono,051,14174,2978,2967,124,3091,6
2022-04-11,Monterey,053,433212,79602,79103,13991,93094,727
2022-04-11,Napa,055,140530,25980,25824,992,26816,144
2022-04-11,Nevada,057,99092,16018,15976,1218,17194,123
2022-04-11,Orange,059,3164182,548179,546983,41838,588821,6912
2022-04-11,Placer,061,380077,62939,62831,7441,70272,616
2022-04-11,Plumas,063,18699,2975,2887,373,3260,13
2022-04-11,Riverside,065,2383286,591984,591268,28252,619520,6429
2022-04-11,Sacramento,067,1510023,281454,277125,27407,304532,2972
2022-04-11,San Benito,069,59416,12930,12917,519,13436,98
2022-04-11,San Bernardino,071,2135413,567109,562571,24995,587566,6892
2022-04-11,San Diego,073,3302833,756025,754281,52644,806925,5210
2022-04-11,San Francisco,075,870044,126653,125963,8480,134443,844
2022-04-11,San Joaquin,077,732212,166581,166547,9780,176327,2212
2022-04-11,San Luis Obispo,079,281455,52618,52609,3827,56436,476
2022-04-11,San Mateo,081,765935,123248,121514,7146,128660,698
2022-04-11,Santa Barbara,083,443738,86177,85754,4811,90565,680
2022-04-11,Santa Clara,085,1922200,314338,313965,12613,326578,2266
2022-04-11,Santa Cruz,087,273765,48244,47624,2170,49794,259
2022-04-11,Shasta,089,179085,30589,30586,6159,36745,549
2022-04-11,Sierra,091,2930,274,272,48,320,4
2022-04-11,Siskiyou,093,43540,4449,4444,2761,7205,80
2022-04-11,Solano,095,438530,81730,81886,5589,87475,448
2022-04-11,Sonoma,097,501317,84179,83600,2704,86304,485
2022-04-11,Stanislaus,099,539301,117545,117528,17414,134942,1578
2022-04-11,Sutter,101,95872,20521,20591,2139,22730,223
2022-04-11,Tehama,103,63373,12052,12059,2627,14686,201
2022-04-11,Trinity,105,12862,1182,1177,295,1472,20
2022-04-11,Tulare,107,460477,106690,105278,28760,134038,1415
2022-04-11,Tuolumne,109,53932,12642,12632,567,13199,180
2022-04-11,Ventura,111,848112,173764,173343,9357,182700,1467
2022-04-11,Yolo,113,214977,36942,36587,3225,39812,312
2022-04-11,Yuba,115,75493,15862,15848,1222,17070,121
2022-04-10,Alameda,001,1643700,257984,256649,14359,271008,1826
2022-04-10,Alpine,003,1148,124,124,1,125,0
2022-04-10,Amador,005,37829,8542,8489,657,9146,86
2022-04-10,Butte,007,227075,33076,33031,6680,39711,399
2022-04-10,Calaveras,009,45235,7280,7260,357,7617,119
2022-04-10,Colusa,011,21464,3449,3449,1076,4525,21
2022-04-10,Contra Costa,013,1133247,189458,189154,13413,202567,1296
2022-04-10,Del Norte,015,27424,5807,5811,198,6009,50
2022-04-10,El Dorado,017,186661,26785,26757,3222,29979,207
2022-04-10,Fresno,019,978130,231722,231090,24087,255177,2731
2022-04-10,Glenn,021,27897,4985,4988,1614,6602,47
2022-04-10,Humboldt,023,135768,16924,16913,2993,19906,141
2022-04-10,Imperial,025,180216,55460,55267,10870,66137,910
2022-04-10,Inyo,027,18085,4077,4071,498,4569,56
2022-04-10,Kern,029,883053,191970,191542,46338,237880,2244
2022-04-10,Kings,031,150075,51553,51519,3624,55143,443
2022-04-10,Lake,033,64148,10704,10690,899,11589,134
2022-04-10,Lassen,035,31185,8971,8948,889,9837,65
2022-04-10,Los Angeles,037,10098052,2717197,2709735,125691,2835426,31509
2022-04-10,Madera,039,155013,37299,37356,6102,43458,354
2022-04-10,Marin,041,260295,33833,33648,2429,36077,288
2022-04-10,Mariposa,043,17540,2405,2394,206,2600,29
2022-04-10,Mendocino,045,87422,13110,13087,3049,16136,120
2022-04-10,Merced,047,269075,62197,62231,8717,70948,811
2022-04-10,Modoc,049,8938,743,743,253,996,8
2022-04-10,Mono,051,14174,2973,2967,124,3091,6
2022-04-10,Monterey,053,433212,79587,79103,13981,93084,727
2022-04-10,Napa,055,140530,25958,25824,990,26814,144
2022-04-10,Nevada,057,99092,16001,15976,1218,17194,123
2022-04-10,Orange,059,3164182,547929,546983,41797,588780,6912
2022-04-10,Placer,061,380077,62909,62831,7440,70271,616
2022-04-10,Plumas,063,18699,2973,2887,373,3260,13
2022-04-10,Riverside,065,2383286,591848,591268,28240,619508,6429
2022-04-10,Sacramento,067,1510023,281359,277125,27396,304521,2972
2022-04-10,San Benito,069,59416,12927,12917,519,13436,98
2022-04-10,San Bernardino,071,2135413,566875,562571,24986,587557,6892
2022-04-10,San Diego,073,3302833,755702,754281,52600,806881,5210
2022-04-10,San Francisco,075,870044,126415,125963,8465,134428,844
2022-04-10,San Joaquin,077,732212,166532,166547,9773,176320,2212
2022-04-10,San Luis Obispo,079,281455,52584,52609,3824,56433,476
2022-04-10,San Mateo,081,765935,123080,121514,7134,128648,698
2022-04-10,Santa Barbara,083,443738,86094,85754,4802,90556,680
2022-04-10,Santa Clara,085,1922200,314006,313965,12599,326564,2266
2022-04-10,Santa Cruz,087,273765,48155,47624,2167,49791,259
2022-04-10,Shasta,089,179085,30582,30586,6159,36745,549
2022-04-10,Sierra,091,2930,274,272,48,320,4
2022-04-10,Siskiyou,093,43540,4449,4444,2759,7203,80
2022-04-10,Solano,095,438530,81685,81886,5585,87471,448
2022-04-10,Sonoma,097,501317,84078,83600,2700,86300,485
2022-04-10,Stanislaus,099,539301,117521,117528,17407,134935,1578
2022-04-10,Sutter,101,95872,20517,20591,2135,22726,223
2022-04-10,Tehama,103,63373,12050,12059,2627,14686,201
2022-04-10,Trinity,105,12862,1182,1177,295,1472,20
2022-04-10,Tulare,107,460477,106674,105278,28755,134033,1415
2022-04-10,Tuolumne,109,53932,12635,12632,567,13199,180
2022-04-10,Ventura,111,848112,173686,173343,9354,182697,1467
2022-04-10,Yolo,113,214977,36923,36587,3220,39807,312
2022-04-10,Yuba,115,75493,15861,15848,1222,17070,121
2022-04-09,Alameda,001,1643700,257811,256649,14354,271003,1826
2022-04-09,Alpine,003,1148,124,124,1,125,0
2022-04-09,Amador,005,37829,8542,8489,656,9145,86
2022-04-09,Butte,007,227075,33073,33031,6679,39710,399
2022-04-09,Calaveras,009,45235,7279,7260,357,7617,119
2022-04-09,Colusa,011,21464,3448,3449,1076,4525,21
2022-04-09,Contra Costa,013,1133247,189364,189154,13405,202559,1296
2022-04-09,Del Norte,015,27424,5806,5811,198,6009,50
2022-04-09,El Dorado,017,186661,26778,26757,3222,29979,207
2022-04-09,Fresno,019,978130,231701,231090,24087,255177,2731
2022-04-09,Glenn,021,27897,4985,4988,1614,6602,47
2022-04-09,Humboldt,023,135768,16917,16913,2993,19906,141
2022-04-09,Imperial,025,180216,55456,55267,10869,66136,910
2022-04-09,Inyo,027,18085,4077,4071,498,4569,56
2022-04-09,Kern,029,883053,191959,191542,46333,237875,2244
2022-04-09,Kings,031,150075,51547,51519,3624,55143,443
2022-04-09,Lake,033,64148,10702,10690,899,11589,134
2022-04-09,Lassen,035,31185,8971,8948,889,9837,65
2022-04-09,Los Angeles,037,10098052,2716527,2709735,125622,2835357,31509
2022-04-09,Madera,039,155013,37296,37356,6102,43458,354
2022-04-09,Marin,041,260295,33799,33648,2386,36034,288
2022-04-09,Mariposa,043,17540,2405,2394,206,2600,29
2022-04-09,Mendocino,045,87422,13109,13087,3049,16136,120
2022-04-09,Merced,047,269075,62180,62231,8715,70946,811
2022-04-09,Modoc,049,8938,743,743,253,996,8
2022-04-09,Mono,051,14174,2972,2967,124,3091,6
2022-04-09,Monterey,053,433212,79578,79103,13977,93080,727
2022-04-09,Napa,055,140530,25934,25824,990,26814,144
2022-04-09,Nevada,057,99092,15998,15976,1218,17194,123
2022-04-09,Orange,059,3164182,547807,546983,41777,588760,6912
2022-04-09,Placer,061,380077,62893,62831,7438,70269,616
2022-04-09,Plumas,063,18699,2973,2887,373,3260,13
2022-04-09,Riverside,065,2383286,591759,591268,28230,619498,6429
2022-04-09,Sacramento,067,1510023,281312,277125,27394,304519,2972
2022-04-09,San Benito,069,59416,12926,12917,519,13436,98
2022-04-09,San Bernardino,071,2135413,566813,562571,24981,587552,6892
2022-04-09,San Diego,073,3302833,755554,754281,52585,806866,5210
2022-04-09,San Francisco,075,870044,126295,125963,8458,134421,844
2022-04-09,San Joaquin,077,732212,166518,166547,9770,176317,2212
2022-04-09,San Luis Obispo,079,281455,52584,52609,3821,56430,476
2022-04-09,San Mateo,081,765935,122988,121514,7128,128642,698
2022-04-09,Santa Barbara,083,443738,86063,85754,4802,90556,680
2022-04-09,Santa Clara,085,1922200,313813,313965,12594,326559,2266
2022-04-09,Santa Cruz,087,273765,48122,47624,2165,49789,259
2022-04-09,Shasta,089,179085,30580,30586,6159,36745,549
2022-04-09,Sierra,091,2930,274,272,48,320,4
2022-04-09,Siskiyou,093,43540,4448,4444,2758,7202,80
2022-04-09,Solano,095,438530,81667,81886,5584,87470,448
2022-04-09,Sonoma,097,501317,84040,83600,2696,86296,485
2022-04-09,Stanislaus,099,539301,117509,117528,17405,134933,1578
2022-04-09,Sutter,101,95872,20516,20591,2135,22726,223
2022-04-09,Tehama,103,63373,12050,12059,2627,14686,201
2022-04-09,Trinity,105,12862,1182,1177,295,1472,20
2022-04-09,Tulare,107,460477,106671,105278,28753,134031,1415
2022-04-09,Tuolumne,109,53932,12633,12632,567,13199,180
2022-04-09,Ventura,111,848112,173651,173343,9351,182694,1467
2022-04-09,Yolo,113,214977,36906,36587,3220,39807,312
2022-04-09,Yuba,115,75493,15859,15848,1222,17070,121
2022-04-08,Alameda,001,1643700,257650,256649,14348,270997,1826
2022-04-08,Alpine,003,1148,124,124,1,125,0
2022-04-08,Amador,005,37829,8540,8489,655,9144,86
2022-04-08,Butte,007,227075,33068,33031,6676,39707,399
2022-04-08,Calaveras,009,45235,7277,7260,357,7617,119
2022-04-08,Colusa,011,21464,3448,3449,1076,4525,21
2022-04-08,Contra Costa,013,1133247,189288,189154,13395,202549,1296
2022-04-08,Del Norte,015,27424,5804,5811,198,6009,50
2022-04-08,El Dorado,017,186661,26776,26757,3222,29979,207
2022-04-08,Fresno,019,978130,231680,231090,24086,255176,2731
2022-04-08,Glenn,021,27897,4985,4988,1614,6602,47
2022-04-08,Humboldt,023,135768,16913,16913,2991,19904,141
2022-04-08,Imperial,025,180216,55451,55267,10869,66136,910
2022-04-08,Inyo,027,18085,4076,4071,497,4568,56
2022-04-08,Kern,029,883053,191941,191542,46332,237874,2244
2022-04-08,Kings,031,150075,51542,51519,3624,55143,443
2022-04-08,Lake,033,64148,10702,10690,899,11589,134
2022-04-08,Lassen,035,31185,8971,8948,889,9837,65
2022-04-08,Los Angeles,037,10098052,2715909,2709735,125568,2835303,31509
2022-04-08,Madera,039,155013,37294,37356,6101,43457,354
2022-04-08,Marin,041,260295,33781,33648,2370,36018,288
2022-04-08,Mariposa,043,17540,2405,2394,206,2600,29
2022-04-08,Mendocino,045,87422,13107,13087,3049,16136,120
2022-04-08,Merced,047,269075,62173,62231,8713,70944,811
2022-04-08,Modoc,049,8938,743,743,253,996,8
2022-04-08,Mono,051,14174,2971,2967,124,3091,6
2022-04-08,Monterey,053,433212,79568,79103,13976,93079,727
2022-04-08,Napa,055,140530,25922,25824,983,26807,144
2022-04-08,Nevada,057,99092,15995,15976,1217,17193,123
2022-04-08,Orange,059,3164182,547688,546983,41762,588745,6912
2022-04-08,Placer,061,380077,62875,62831,7436,70267,616
2022-04-08,Plumas,063,18699,2970,2887,373,3260,13
2022-04-08,Riverside,065,2383286,591680,591268,28227,619495,6429
2022-04-08,Sacramento,067,1510023,281266,277125,27392,304517,2972
2022-04-08,San Benito,069,59416,12926,12917,519,13436,98
2022-04-08,San Bernardino,071,2135413,566760,562571,24978,587549,6892
2022-04-08,San Diego,073,3302833,755386,754281,52577,806858,5210
2022-04-08,San Francisco,075,870044,126198,125963,8454,134417,844
2022-04-08,San Joaquin,077,732212,166501,166547,9768,176315,2212
2022-04-08,San Luis Obispo,079,281455,52579,52609,3821,56430,476
2022-04-08,San Mateo,081,765935,122883,121514,7123,128637,698
2022-04-08,Santa Barbara,083,443738,86042,85754,4802,90556,680
2022-04-08,Santa Clara,085,1922200,313633,313965,12587,326552,2266
2022-04-08,Santa Cruz,087,273765,48105,47624,2162,49786,259
2022-04-08,Shasta,089,179085,30577,30586,6159,36745,549
2022-04-08,Sierra,091,2930,274,272,48,320,4
2022-04-08,Siskiyou,093,43540,4448,4444,2758,7202,80
2022-04-08,Solano,095,438530,81648,81886,5583,87469,448
2022-04-08,Sonoma,097,501317,83989,83600,2691,86291,485
2022-04-08,Stanislaus,099,539301,117494,117528,17404,134932,1578
2022-04-08,Sutter,101,95872,20516,20591,2135,22726,223
2022-04-08,Tehama,103,63373,12050,12059,2627,14686,201
2022-04-08,Trinity,105,12862,1182,1177,295,1472,20
2022-04-08,Tulare,107,460477,106667,105278,28749,134027,1415
2022-04-08,Tuolumne,109,53932,12632,12632,567,13199,180
2022-04-08,Ventura,111,848112,173621,173343,9349,182692,1467
2022-04-08,Yolo,113,214977,36897,36587,3219,39806,312
2022-04-08,Yuba,115,75493,15858,15848,1222,17070,121
2022-04-07,Alameda,001,1643700,257460,256649,14340,270989,1826
2022-04-07,Alpine,003,1148,124,124,1,125,0
2022-04-07,Amador,005,37829,8539,8489,653,9142,86
2022-04-07,Butte,007,227075,33065,33031,6675,39706,399
2022-04-07,Calaveras,009,45235,7275,7260,357,7617,119
2022-04-07,Colusa,011,21464,3447,3449,1076,4525,21
2022-04-07,Contra Costa,013,1133247,189168,189154,13384,202538,1296
2022-04-07,Del Norte,015,27424,5803,5811,198,6009,50
2022-04-07,El Dorado,017,186661,26764,26757,3220,29977,207
2022-04-07,Fresno,019,978130,231654,231090,24084,255174,2731
2022-04-07,Glenn,021,27897,4983,4988,1613,6601,47
2022-04-07,Humboldt,023,135768,16906,16913,2989,19902,141
2022-04-07,Imperial,025,180216,55449,55267,10866,66133,910
2022-04-07,Inyo,027,18085,4076,4071,497,4568,56
2022-04-07,Kern,029,883053,191917,191542,46329,237871,2244
2022-04-07,Kings,031,150075,51534,51519,3624,55143,443
2022-04-07,Lake,033,64148,10698,10690,899,11589,134
2022-04-07,Lassen,035,31185,8971,8948,889,9837,65
2022-04-07,Los Angeles,037,10098052,2715004,2709735,125493,2835228,31509
2022-04-07,Madera,039,155013,37289,37356,6101,43457,354
2022-04-07,Marin,041,260295,33763,33648,2350,35998,288
2022-04-07,Mariposa,043,17540,2402,2394,205,2599,29
2022-04-07,Mendocino,045,87422,13103,13087,3048,16135,120
2022-04-07,Merced,047,269075,62164,62231,8709,70940,811
2022-04-07,Modoc,049,8938,743,743,253,996,8
2022-04-07,Mono,051,14174,2971,2967,123,3090,6
2022-04-07,Monterey,053,433212,79549,79103,13972,93075,727
2022-04-07,Napa,055,140530,25905,25824,979,26803,144
2022-04-07,Nevada,057,99092,15988,15976,1216,17192,123
2022-04-07,Orange,059,3164182,547532,546983,41732,588715,6912
2022-04-07,Placer,061,380077,62858,62831,7433,70264,616
2022-04-07,Plumas,063,18699,2970,2887,373,3260,13
2022-04-07,Riverside,065,2383286,591574,591268,28214,619482,6429
2022-04-07,Sacramento,067,1510023,281202,277125,27385,304510,2972
2022-04-07,San Benito,069,59416,12925,12917,519,13436,98
2022-04-07,San Bernardino,071,2135413,566599,562571,24965,587536,6892
2022-04-07,San Diego,073,3302833,755120,754281,52553,806834,5210
2022-04-07,San Francisco,075,870044,126042,125963,8438,134401,844
2022-04-07,San Joaquin,077,732212,166464,166547,9765,176312,2212
2022-04-07,San Luis Obispo,079,281455,52561,52609,3819,56428,476
2022-04-07,San Mateo,081,765935,122763,121514,7107,128621,698
2022-04-07,Santa Barbara,083,443738,85999,85754,4800,90554,680
2022-04-07,Santa Clara,085,1922200,313412,313965,12575,326540,2266
2022-04-07,Santa Cruz,087,273765,48086,47624,2158,49782,259
2022-04-07,Shasta,089,179085,30576,30586,6159,36745,549
2022-04-07,Sierra,091,2930,274,272,48,320,4
2022-04-07,Siskiyou,093,43540,4448,4444,2756,7200,80
2022-04-07,Solano,095,438530,81622,81886,5582,87468,448
2022-04-07,Sonoma,097,501317,83947,83600,2685,86285,485
2022-04-07,Stanislaus,099,539301,117472,117528,17400,134928,1578
2022-04-07,Sutter,101,95872,20513,20591,2134,22725,223
2022-04-07,Tehama,103,63373,12047,12059,2627,14686,201
2022-04-07,Trinity,105,12862,1182,1177,295,1472,20
2022-04-07,Tulare,107,460477,106661,105278,28747,134025,1415
2022-04-07,Tuolumne,109,53932,12630,12632,566,13198,180
2022-04-07,Ventura,111,848112,173592,173343,9347,182690,1467
2022-04-07,Yolo,113,214977,36884,36587,3219,39806,312
2022-04-07,Yuba,115,75493,15856,15848,1222,17070,121
2022-04-06,Alameda,001,1643700,257273,256143,14333,270476,1814
2022-04-06,Alpine,003,1148,124,124,1,125,0
2022-04-06,Amador,005,37829,8538,8488,653,9141,86
2022-04-06,Butte,007,227075,33060,32997,6673,39670,396
2022-04-06,Calaveras,009,45235,7273,7258,357,7615,120
2022-04-06,Colusa,011,21464,3447,3447,1076,4523,21
2022-04-06,Contra Costa,013,1133247,189100,188850,13370,202220,1296
2022-04-06,Del Norte,015,27424,5802,5809,198,6007,50
2022-04-06,El Dorado,017,186661,26761,26744,3220,29964,205
2022-04-06,Fresno,019,978130,231616,230942,24082,255024,2725
2022-04-06,Glenn,021,27897,4983,4986,1612,6598,47
2022-04-06,Humboldt,023,135768,16902,16904,2988,19892,140
2022-04-06,Imperial,025,180216,55442,55294,10866,66160,908
2022-04-06,Inyo,027,18085,4075,4068,495,4563,56
2022-04-06,Kern,029,883053,191895,191449,46326,237775,2234
2022-04-06,Kings,031,150075,51533,51491,3623,55114,443
2022-04-06,Lake,033,64148,10694,10679,899,11578,136
2022-04-06,Lassen,035,31185,8971,8945,889,9834,65
2022-04-06,Los Angeles,037,10098052,2713966,2707306,125430,2832736,31465
2022-04-06,Madera,039,155013,37284,37349,6101,43450,354
2022-04-06,Marin,041,260295,33743,33566,2342,35908,288
2022-04-06,Mariposa,043,17540,2401,2392,205,2597,29
2022-04-06,Mendocino,045,87422,13099,13074,3047,16121,119
2022-04-06,Merced,047,269075,62155,62195,8706,70901,810
2022-04-06,Modoc,049,8938,743,741,253,994,8
2022-04-06,Mono,051,14174,2970,2967,123,3090,6
2022-04-06,Monterey,053,433212,79535,79019,13962,92981,727
2022-04-06,Napa,055,140530,25888,25790,976,26766,143
2022-04-06,Nevada,057,99092,15986,15974,1216,17190,123
2022-04-06,Orange,059,3164182,547361,546491,41705,588196,6887
2022-04-06,Placer,061,380077,62852,62787,7432,70219,615
2022-04-06,Plumas,063,18699,2970,2850,373,3223,13
2022-04-06,Riverside,065,2383286,591477,590826,28209,619035,6424
2022-04-06,Sacramento,067,1510023,281123,276567,27381,303948,2953
2022-04-06,San Benito,069,59416,12924,12908,519,13427,98
2022-04-06,San Bernardino,071,2135413,566464,561648,24963,586611,6883
2022-04-06,San Diego,073,3302833,754822,753402,52518,805920,5192
2022-04-06,San Francisco,075,870044,125884,125536,8431,133967,843
2022-04-06,San Joaquin,077,732212,166433,166415,9762,176177,2207
2022-04-06,San Luis Obispo,079,281455,52539,52557,3817,56374,475
2022-04-06,San Mateo,081,765935,122655,121041,7095,128136,693
2022-04-06,Santa Barbara,083,443738,85958,85630,4796,90426,679
2022-04-06,Santa Clara,085,1922200,313215,313278,12552,325830,2265
2022-04-06,Santa Cruz,087,273765,48030,47446,2152,49598,259
2022-04-06,Shasta,089,179085,30575,30565,6159,36724,529
2022-04-06,Sierra,091,2930,274,272,48,320,4
2022-04-06,Siskiyou,093,43540,4448,4442,2756,7198,80
2022-04-06,Solano,095,438530,81589,81789,5577,87366,447
2022-04-06,Sonoma,097,501317,83887,83361,2678,86039,485
2022-04-06,Stanislaus,099,539301,117456,117534,17394,134928,1578
2022-04-06,Sutter,101,95872,20508,20581,2134,22715,222
2022-04-06,Tehama,103,63373,12047,12049,2627,14676,198
2022-04-06,Trinity,105,12862,1182,1173,295,1468,20
2022-04-06,Tulare,107,460477,106656,104826,28742,133568,1414
2022-04-06,Tuolumne,109,53932,12628,12621,566,13187,180
2022-04-06,Ventura,111,848112,173539,173179,9343,182522,1460
2022-04-06,Yolo,113,214977,36862,36393,3218,39611,314
2022-04-06,Yuba,115,75493,15852,15839,1222,17061,121
2022-04-05,Alameda,001,1643700,257059,256143,14324,270467,1814
2022-04-05,Alpine,003,1148,124,124,1,125,0
2022-04-05,Amador,005,37829,8536,8488,653,9141,86
2022-04-05,Butte,007,227075,33054,32997,6669,39666,396
2022-04-05,Calaveras,009,45235,7270,7258,357,7615,120
2022-04-05,Colusa,011,21464,3445,3447,1075,4522,21
2022-04-05,Contra Costa,013,1133247,189006,188850,13365,202215,1296
2022-04-05,Del Norte,015,27424,5800,5809,198,6007,50
2022-04-05,El Dorado,017,186661,26749,26744,3220,29964,205
2022-04-05,Fresno,019,978130,231584,230942,24075,255017,2725
2022-04-05,Glenn,021,27897,4983,4986,1611,6597,47
2022-04-05,Humboldt,023,135768,16896,16904,2988,19892,140
2022-04-05,Imperial,025,180216,55440,55294,10866,66160,908
2022-04-05,Inyo,027,18085,4074,4068,494,4562,56
2022-04-05,Kern,029,883053,191874,191449,46323,237772,2234
2022-04-05,Kings,031,150075,51530,51491,3623,55114,443
2022-04-05,Lake,033,64148,10691,10679,899,11578,136
2022-04-05,Lassen,035,31185,8971,8945,889,9834,65
2022-04-05,Los Angeles,037,10098052,2712917,2707306,125355,2832661,31465
2022-04-05,Madera,039,155013,37277,37349,6099,43448,354
2022-04-05,Marin,041,260295,33687,33566,2327,35893,288
2022-04-05,Mariposa,043,17540,2401,2392,205,2597,29
2022-04-05,Mendocino,045,87422,13093,13074,3046,16120,119
2022-04-05,Merced,047,269075,62144,62195,8699,70894,810
2022-04-05,Modoc,049,8938,743,741,253,994,8
2022-04-05,Mono,051,14174,2969,2967,123,3090,6
2022-04-05,Monterey,053,433212,79511,79019,13950,92969,727
2022-04-05,Napa,055,140530,25879,25790,971,26761,143
2022-04-05,Nevada,057,99092,15978,15974,1216,17190,123
2022-04-05,Orange,059,3164182,547177,546491,41676,588167,6887
2022-04-05,Placer,061,380077,62828,62787,7432,70219,615
2022-04-05,Plumas,063,18699,2970,2850,373,3223,13
2022-04-05,Riverside,065,2383286,591359,590826,28197,619023,6424
2022-04-05,Sacramento,067,1510023,281045,276567,27376,303943,2953
2022-04-05,San Benito,069,59416,12916,12908,519,13427,98
2022-04-05,San Bernardino,071,2135413,566333,561648,24951,586599,6883
2022-04-05,San Diego,073,3302833,754511,753402,52475,805877,5192
2022-04-05,San Francisco,075,870044,125680,125536,8423,133959,843
2022-04-05,San Joaquin,077,732212,166390,166415,9759,176174,2207
2022-04-05,San Luis Obispo,079,281455,52522,52557,3812,56369,475
2022-04-05,San Mateo,081,765935,122538,121041,7083,128124,693
2022-04-05,Santa Barbara,083,443738,85922,85630,4794,90424,679
2022-04-05,Santa Clara,085,1922200,312956,313278,12539,325817,2265
2022-04-05,Santa Cruz,087,273765,47963,47446,2149,49595,259
2022-04-05,Shasta,089,179085,30575,30565,6157,36722,529
2022-04-05,Sierra,091,2930,274,272,48,320,4
2022-04-05,Siskiyou,093,43540,4448,4442,2756,7198,80
2022-04-05,Solano,095,438530,81540,81789,5574,87363,447
2022-04-05,Sonoma,097,501317,83824,83361,2669,86030,485
2022-04-05,Stanislaus,099,539301,117443,117534,17385,134919,1578
2022-04-05,Sutter,101,95872,20504,20581,2133,22714,222
2022-04-05,Tehama,103,63373,12045,12049,2626,14675,198
2022-04-05,Trinity,105,12862,1182,1173,295,1468,20
2022-04-05,Tulare,107,460477,106645,104826,28739,133565,1414
2022-04-05,Tuolumne,109,53932,12626,12621,566,13187,180
2022-04-05,Ventura,111,848112,173484,173179,9337,182516,1460
2022-04-05,Yolo,113,214977,36849,36393,3215,39608,314
2022-04-05,Yuba,115,75493,15850,15839,1222,17061,121
2022-04-04,Alameda,001,1643700,256827,256143,14310,270453,1814
2022-04-04,Alpine,003,1148,124,124,1,125,0
2022-04-04,Amador,005,37829,8535,8488,652,9140,86
2022-04-04,Butte,007,227075,33049,32997,6666,39663,396
2022-04-04,Calaveras,009,45235,7270,7258,357,7615,120
2022-04-04,Colusa,011,21464,3444,3447,1075,4522,21
2022-04-04,Contra Costa,013,1133247,188906,188850,13361,202211,1296
2022-04-04,Del Norte,015,27424,5800,5809,198,6007,50
2022-04-04,El Dorado,017,186661,26744,26744,3219,29963,205
2022-04-04,Fresno,019,978130,231567,230942,24072,255014,2725
2022-04-04,Glenn,021,27897,4982,4986,1611,6597,47
2022-04-04,Humboldt,023,135768,16888,16904,2983,19887,140
2022-04-04,Imperial,025,180216,55436,55294,10866,66160,908
2022-04-04,Inyo,027,18085,4074,4068,492,4560,56
2022-04-04,Kern,029,883053,191851,191449,46317,237766,2234
2022-04-04,Kings,031,150075,51523,51491,3623,55114,443
2022-04-04,Lake,033,64148,10686,10679,899,11578,136
2022-04-04,Lassen,035,31185,8971,8945,889,9834,65
2022-04-04,Los Angeles,037,10098052,2711829,2707306,125309,2832615,31465
2022-04-04,Madera,039,155013,37273,37349,6099,43448,354
2022-04-04,Marin,041,260295,33669,33566,2318,35884,288
2022-04-04,Mariposa,043,17540,2400,2392,205,2597,29
2022-04-04,Mendocino,045,87422,13087,13074,3046,16120,119
2022-04-04,Merced,047,269075,62134,62195,8695,70890,810
2022-04-04,Modoc,049,8938,743,741,253,994,8
2022-04-04,Mono,051,14174,2969,2967,123,3090,6
2022-04-04,Monterey,053,433212,79495,79019,13944,92963,727
2022-04-04,Napa,055,140530,25861,25790,971,26761,143
2022-04-04,Nevada,057,99092,15973,15974,1216,17190,123
2022-04-04,Orange,059,3164182,547013,546491,41649,588140,6887
2022-04-04,Placer,061,380077,62818,62787,7431,70218,615
2022-04-04,Plumas,063,18699,2969,2850,373,3223,13
2022-04-04,Riverside,065,2383286,591265,590826,28185,619011,6424
2022-04-04,Sacramento,067,1510023,280951,276567,27366,303933,2953
2022-04-04,San Benito,069,59416,12914,12908,519,13427,98
2022-04-04,San Bernardino,071,2135413,566201,561648,24944,586592,6883
2022-04-04,San Diego,073,3302833,754190,753402,52442,805844,5192
2022-04-04,San Francisco,075,870044,125479,125536,8414,133950,843
2022-04-04,San Joaquin,077,732212,166364,166415,9756,176171,2207
2022-04-04,San Luis Obispo,079,281455,52499,52557,3810,56367,475
2022-04-04,San Mateo,081,765935,122404,121041,7069,128110,693
2022-04-04,Santa Barbara,083,443738,85877,85630,4793,90423,679
2022-04-04,Santa Clara,085,1922200,312689,313278,12530,325808,2265
2022-04-04,Santa Cruz,087,273765,47916,47446,2148,49594,259
2022-04-04,Shasta,089,179085,30572,30565,6156,36721,529
2022-04-04,Sierra,091,2930,274,272,48,320,4
2022-04-04,Siskiyou,093,43540,4448,4442,2756,7198,80
2022-04-04,Solano,095,438530,81501,81789,5571,87360,447
2022-04-04,Sonoma,097,501317,83772,83361,2662,86023,485
2022-04-04,Stanislaus,099,539301,117419,117534,17378,134912,1578
2022-04-04,Sutter,101,95872,20501,20581,2133,22714,222
2022-04-04,Tehama,103,63373,12043,12049,2626,14675,198
2022-04-04,Trinity,105,12862,1182,1173,295,1468,20
2022-04-04,Tulare,107,460477,106636,104826,28735,133561,1414
2022-04-04,Tuolumne,109,53932,12620,12621,566,13187,180
2022-04-04,Ventura,111,848112,173441,173179,9335,182514,1460
2022-04-04,Yolo,113,214977,36839,36393,3213,39606,314
2022-04-04,Yuba,115,75493,15848,15839,1222,17061,121
2022-04-03,Alameda,001,1643700,256574,255650,14309,269959,1813
2022-04-03,Alpine,003,1148,124,124,1,125,0
2022-04-03,Amador,005,37829,8535,8485,652,9137,86
2022-04-03,Butte,007,227075,33042,32981,6664,39645,396
2022-04-03,Calaveras,009,45235,7270,7254,357,7611,119
2022-04-03,Colusa,011,21464,3444,3445,1075,4520,21
2022-04-03,Contra Costa,013,1133247,188801,188658,13352,202010,1291
2022-04-03,Del Norte,015,27424,5800,5812,198,6010,50
2022-04-03,El Dorado,017,186661,26730,26732,3218,29950,200
2022-04-03,Fresno,019,978130,231534,230559,24069,254628,2722
2022-04-03,Glenn,021,27897,4982,4982,1611,6593,47
2022-04-03,Humboldt,023,135768,16883,16898,2983,19881,140
2022-04-03,Imperial,025,180216,55433,55266,10863,66129,908
2022-04-03,Inyo,027,18085,4072,4063,492,4555,56
2022-04-03,Kern,029,883053,191825,191384,46312,237696,2224
2022-04-03,Kings,031,150075,51517,51470,3621,55091,443
2022-04-03,Lake,033,64148,10684,10674,899,11573,136
2022-04-03,Lassen,035,31185,8970,8943,889,9832,65
2022-04-03,Los Angeles,037,10098052,2710637,2703576,125225,2828801,31410
2022-04-03,Madera,039,155013,37271,37333,6097,43430,354
2022-04-03,Marin,041,260295,33633,33493,2309,35802,287
2022-04-03,Mariposa,043,17540,2399,2391,205,2596,29
2022-04-03,Mendocino,045,87422,13081,13058,3044,16102,119
2022-04-03,Merced,047,269075,62119,62149,8691,70840,808
2022-04-03,Modoc,049,8938,742,741,253,994,8
2022-04-03,Mono,051,14174,2969,2967,123,3090,6
2022-04-03,Monterey,053,433212,79477,78964,13920,92884,726
2022-04-03,Napa,055,140530,25841,25757,970,26727,143
2022-04-03,Nevada,057,99092,15965,15962,1216,17178,123
2022-04-03,Orange,059,3164182,546812,546047,41623,587670,6880
2022-04-03,Placer,061,380077,62792,62740,7427,70167,614
2022-04-03,Plumas,063,18699,2968,2803,373,3176,14
2022-04-03,Riverside,065,2383286,591108,590563,28168,618731,6418
2022-04-03,Sacramento,067,1510023,280877,276218,27352,303570,2950
2022-04-03,San Benito,069,59416,12910,12901,519,13420,98
2022-04-03,San Bernardino,071,2135413,566056,561362,24939,586301,6865
2022-04-03,San Diego,073,3302833,753860,752281,52403,804684,5178
2022-04-03,San Francisco,075,870044,125250,125075,8408,133483,843
2022-04-03,San Joaquin,077,732212,166312,166336,9751,176087,2202
2022-04-03,San Luis Obispo,079,281455,52480,52512,3810,56322,475
2022-04-03,San Mateo,081,765935,122266,120717,7062,127779,693
2022-04-03,Santa Barbara,083,443738,85833,85611,4791,90402,678
2022-04-03,Santa Clara,085,1922200,312389,312517,12520,325037,2258
2022-04-03,Santa Cruz,087,273765,47861,47371,2146,49517,259
2022-04-03,Shasta,089,179085,30562,30556,6155,36711,530
2022-04-03,Sierra,091,2930,274,273,48,321,4
2022-04-03,Siskiyou,093,43540,4448,4439,2756,7195,80
2022-04-03,Solano,095,438530,81465,81848,5566,87414,446
2022-04-03,Sonoma,097,501317,83693,83235,2655,85890,485
2022-04-03,Stanislaus,099,539301,117387,117536,17373,134909,1581
2022-04-03,Sutter,101,95872,20498,20570,2133,22703,222
2022-04-03,Tehama,103,63373,12040,12046,2626,14672,198
2022-04-03,Trinity,105,12862,1182,1173,295,1468,20
2022-04-03,Tulare,107,460477,106629,104736,28724,133460,1410
2022-04-03,Tuolumne,109,53932,12619,12618,566,13184,180
2022-04-03,Ventura,111,848112,173390,173044,9332,182376,1460
2022-04-03,Yolo,113,214977,36821,36347,3211,39558,313
2022-04-03,Yuba,115,75493,15846,15835,1222,17057,120
2022-04-02,Alameda,001,1643700,256469,255650,14308,269958,1813
2022-04-02,Alpine,003,1148,124,124,1,125,0
2022-04-02,Amador,005,37829,8535,8485,652,9137,86
2022-04-02,Butte,007,227075,33038,32981,6664,39645,396
2022-04-02,Calaveras,009,45235,7270,7254,357,7611,119
2022-04-02,Colusa,011,21464,3444,3445,1075,4520,21
2022-04-02,Contra Costa,013,1133247,188745,188658,13349,202007,1291
2022-04-02,Del Norte,015,27424,5799,5812,198,6010,50
2022-04-02,El Dorado,017,186661,26727,26732,3218,29950,200
2022-04-02,Fresno,019,978130,231505,230559,24069,254628,2722
2022-04-02,Glenn,021,27897,4982,4982,1611,6593,47
2022-04-02,Humboldt,023,135768,16879,16898,2983,19881,140
2022-04-02,Imperial,025,180216,55429,55266,10863,66129,908
2022-04-02,Inyo,027,18085,4072,4063,492,4555,56
2022-04-02,Kern,029,883053,191811,191384,46308,237692,2224
2022-04-02,Kings,031,150075,51514,51470,3621,55091,443
2022-04-02,Lake,033,64148,10683,10674,899,11573,136
2022-04-02,Lassen,035,31185,8970,8943,889,9832,65
2022-04-02,Los Angeles,037,10098052,2710143,2703576,125184,2828760,31410
2022-04-02,Madera,039,155013,37268,37333,6097,43430,354
2022-04-02,Marin,041,260295,33609,33493,2301,35794,287
2022-04-02,Mariposa,043,17540,2398,2391,205,2596,29
2022-04-02,Mendocino,045,87422,13079,13058,3044,16102,119
2022-04-02,Merced,047,269075,62116,62149,8691,70840,808
2022-04-02,Modoc,049,8938,742,741,253,994,8
2022-04-02,Mono,051,14174,2969,2967,122,3089,6
2022-04-02,Monterey,053,433212,79464,78964,13915,92879,726
2022-04-02,Napa,055,140530,25827,25757,969,26726,143
2022-04-02,Nevada,057,99092,15962,15962,1215,17177,123
2022-04-02,Orange,059,3164182,546708,546047,41612,587659,6880
2022-04-02,Placer,061,380077,62783,62740,7425,70165,614
2022-04-02,Plumas,063,18699,2968,2803,373,3176,14
2022-04-02,Riverside,065,2383286,591034,590563,28163,618726,6418
2022-04-02,Sacramento,067,1510023,280841,276218,27351,303569,2950
2022-04-02,San Benito,069,59416,12909,12901,519,13420,98
2022-04-02,San Bernardino,071,2135413,566005,561362,24935,586297,6865
2022-04-02,San Diego,073,3302833,753734,752281,52394,804675,5178
2022-04-02,San Francisco,075,870044,125149,125075,8398,133473,843
2022-04-02,San Joaquin,077,732212,166292,166336,9749,176085,2202
2022-04-02,San Luis Obispo,079,281455,52475,52512,3810,56322,475
2022-04-02,San Mateo,081,765935,122173,120717,7053,127770,693
2022-04-02,Santa Barbara,083,443738,85814,85611,4790,90401,678
2022-04-02,Santa Clara,085,1922200,312226,312517,12516,325033,2258
2022-04-02,Santa Cruz,087,273765,47849,47371,2145,49516,259
2022-04-02,Shasta,089,179085,30561,30556,6155,36711,530
2022-04-02,Sierra,091,2930,274,273,48,321,4
2022-04-02,Siskiyou,093,43540,4447,4439,2755,7194,80
2022-04-02,Solano,095,438530,81450,81848,5566,87414,446
2022-04-02,Sonoma,097,501317,83646,83235,2649,85884,485
2022-04-02,Stanislaus,099,539301,117377,117536,17371,134907,1581
2022-04-02,Sutter,101,95872,20493,20570,2133,22703,222
2022-04-02,Tehama,103,63373,12040,12046,2626,14672,198
2022-04-02,Trinity,105,12862,1182,1173,295,1468,20
2022-04-02,Tulare,107,460477,106626,104736,28724,133460,1410
2022-04-02,Tuolumne,109,53932,12617,12618,566,13184,180
2022-04-02,Ventura,111,848112,173351,173044,9332,182376,1460
2022-04-02,Yolo,113,214977,36812,36347,3208,39555,313
2022-04-02,Yuba,115,75493,15845,15835,1222,17057,120
2022-04-01,Alameda,001,1643700,256355,255650,14304,269954,1813
2022-04-01,Alpine,003,1148,124,124,1,125,0
2022-04-01,Amador,005,37829,8535,8485,652,9137,86
2022-04-01,Butte,007,227075,33034,32981,6660,39641,396
2022-04-01,Calaveras,009,45235,7268,7254,357,7611,119
2022-04-01,Colusa,011,21464,3443,3445,1075,4520,21
2022-04-01,Contra Costa,013,1133247,188693,188658,13348,202006,1291
2022-04-01,Del Norte,015,27424,5797,5812,198,6010,50
2022-04-01,El Dorado,017,186661,26724,26732,3217,29949,200
2022-04-01,Fresno,019,978130,231479,230559,24067,254626,2722
2022-04-01,Glenn,021,27897,4982,4982,1611,6593,47
2022-04-01,Humboldt,023,135768,16877,16898,2983,19881,140
2022-04-01,Imperial,025,180216,55427,55266,10863,66129,908
2022-04-01,Inyo,027,18085,4070,4063,491,4554,56
2022-04-01,Kern,029,883053,191800,191384,46305,237689,2224
2022-04-01,Kings,031,150075,51511,51470,3621,55091,443
2022-04-01,Lake,033,64148,10681,10674,899,11573,136
2022-04-01,Lassen,035,31185,8969,8943,889,9832,65
2022-04-01,Los Angeles,037,10098052,2709646,2703576,125141,2828717,31410
2022-04-01,Madera,039,155013,37267,37333,6097,43430,354
2022-04-01,Marin,041,260295,33591,33493,2294,35787,287
2022-04-01,Mariposa,043,17540,2395,2391,205,2596,29
2022-04-01,Mendocino,045,87422,13076,13058,3044,16102,119
2022-04-01,Merced,047,269075,62108,62149,8689,70838,808
2022-04-01,Modoc,049,8938,742,741,253,994,8
2022-04-01,Mono,051,14174,2969,2967,122,3089,6
2022-04-01,Monterey,053,433212,79447,78964,13912,92876,726
2022-04-01,Napa,055,140530,25819,25757,969,26726,143
2022-04-01,Nevada,057,99092,15962,15962,1214,17176,123
2022-04-01,Orange,059,3164182,546600,546047,41602,587649,6880
2022-04-01,Placer,061,380077,62769,62740,7425,70165,614
2022-04-01,Plumas,063,18699,2968,2803,372,3175,14
2022-04-01,Riverside,065,2383286,590971,590563,28149,618712,6418
2022-04-01,Sacramento,067,1510023,280803,276218,27347,303565,2950
2022-04-01,San Benito,069,59416,12908,12901,519,13420,98
2022-04-01,San Bernardino,071,2135413,565951,561362,24931,586293,6865
2022-04-01,San Diego,073,3302833,753585,752281,52381,804662,5178
2022-04-01,San Francisco,075,870044,125040,125075,8391,133466,843
2022-04-01,San Joaquin,077,732212,166273,166336,9747,176083,2202
2022-04-01,San Luis Obispo,079,281455,52469,52512,3809,56321,475
2022-04-01,San Mateo,081,765935,122111,120717,7047,127764,693
2022-04-01,Santa Barbara,083,443738,85792,85611,4789,90400,678
2022-04-01,Santa Clara,085,1922200,312076,312517,12515,325032,2258
2022-04-01,Santa Cruz,087,273765,47833,47371,2143,49514,259
2022-04-01,Shasta,089,179085,30560,30556,6155,36711,530
2022-04-01,Sierra,091,2930,274,273,48,321,4
2022-04-01,Siskiyou,093,43540,4447,4439,2754,7193,80
2022-04-01,Solano,095,438530,81436,81848,5566,87414,446
2022-04-01,Sonoma,097,501317,83602,83235,2648,85883,485
2022-04-01,Stanislaus,099,539301,117366,117536,17368,134904,1581
2022-04-01,Sutter,101,95872,20493,20570,2133,22703,222
2022-04-01,Tehama,103,63373,12039,12046,2626,14672,198
2022-04-01,Trinity,105,12862,1182,1173,295,1468,20
2022-04-01,Tulare,107,460477,106621,104736,28720,133456,1410
2022-04-01,Tuolumne,109,53932,12616,12618,566,13184,180
2022-04-01,Ventura,111,848112,173320,173044,9328,182372,1460
2022-04-01,Yolo,113,214977,36802,36347,3207,39554,313
2022-04-01,Yuba,115,75493,15844,15835,1222,17057,120
2022-03-31,Alameda,001,1643700,256184,255650,14293,269943,1813
2022-03-31,Alpine,003,1148,124,124,1,125,0
2022-03-31,Amador,005,37829,8535,8485,652,9137,86
2022-03-31,Butte,007,227075,33030,32981,6657,39638,396
2022-03-31,Calaveras,009,45235,7265,7254,357,7611,119
2022-03-31,Colusa,011,21464,3442,3445,1075,4520,21
2022-03-31,Contra Costa,013,1133247,188601,188658,13342,202000,1291
2022-03-31,Del Norte,015,27424,5796,5812,198,6010,50
2022-03-31,El Dorado,017,186661,26716,26732,3217,29949,200
2022-03-31,Fresno,019,978130,231443,230559,24043,254602,2722
2022-03-31,Glenn,021,27897,4980,4982,1611,6593,47
2022-03-31,Humboldt,023,135768,16873,16898,2983,19881,140
2022-03-31,Imperial,025,180216,55424,55266,10862,66128,908
2022-03-31,Inyo,027,18085,4069,4063,488,4551,56
2022-03-31,Kern,029,883053,191786,191384,46296,237680,2224
2022-03-31,Kings,031,150075,51502,51470,3621,55091,443
2022-03-31,Lake,033,64148,10680,10674,898,11572,136
2022-03-31,Lassen,035,31185,8967,8943,889,9832,65
2022-03-31,Los Angeles,037,10098052,2708892,2703576,125089,2828665,31410
2022-03-31,Madera,039,155013,37264,37333,6097,43430,354
2022-03-31,Marin,041,260295,33566,33493,2282,35775,287
2022-03-31,Mariposa,043,17540,2394,2391,204,2595,29
2022-03-31,Mendocino,045,87422,13072,13058,3044,16102,119
2022-03-31,Merced,047,269075,62103,62149,8686,70835,808
2022-03-31,Modoc,049,8938,742,741,253,994,8
2022-03-31,Mono,051,14174,2969,2967,122,3089,6
2022-03-31,Monterey,053,433212,79429,78964,13900,92864,726
2022-03-31,Napa,055,140530,25810,25757,967,26724,143
2022-03-31,Nevada,057,99092,15955,15962,1213,17175,123
2022-03-31,Orange,059,3164182,546452,546047,41586,587633,6880
2022-03-31,Placer,061,380077,62745,62740,7423,70163,614
2022-03-31,Plumas,063,18699,2968,2803,371,3174,14
2022-03-31,Riverside,065,2383286,590864,590563,28145,618708,6418
2022-03-31,Sacramento,067,1510023,280731,276218,27339,303557,2950
2022-03-31,San Benito,069,59416,12907,12901,519,13420,98
2022-03-31,San Bernardino,071,2135413,565851,561362,24919,586281,6865
2022-03-31,San Diego,073,3302833,753339,752281,52355,804636,5178
2022-03-31,San Francisco,075,870044,124880,125075,8378,133453,843
2022-03-31,San Joaquin,077,732212,166239,166336,9733,176069,2202
2022-03-31,San Luis Obispo,079,281455,52455,52512,3808,56320,475
2022-03-31,San Mateo,081,765935,122000,120717,7045,127762,693
2022-03-31,Santa Barbara,083,443738,85764,85611,4788,90399,678
2022-03-31,Santa Clara,085,1922200,311850,312517,12500,325017,2258
2022-03-31,Santa Cruz,087,273765,47814,47371,2141,49512,259
2022-03-31,Shasta,089,179085,30554,30556,6155,36711,530
2022-03-31,Sierra,091,2930,271,273,48,321,4
2022-03-31,Siskiyou,093,43540,4445,4439,2754,7193,80
2022-03-31,Solano,095,438530,81409,81848,5563,87411,446
2022-03-31,Sonoma,097,501317,83558,83235,2642,85877,485
2022-03-31,Stanislaus,099,539301,117347,117536,17363,134899,1581
2022-03-31,Sutter,101,95872,20490,20570,2132,22702,222
2022-03-31,Tehama,103,63373,12039,12046,2625,14671,198
2022-03-31,Trinity,105,12862,1182,1173,295,1468,20
2022-03-31,Tulare,107,460477,106611,104736,28712,133448,1410
2022-03-31,Tuolumne,109,53932,12615,12618,566,13184,180
2022-03-31,Ventura,111,848112,173278,173044,9325,182369,1460
2022-03-31,Yolo,113,214977,36790,36347,3207,39554,313
2022-03-31,Yuba,115,75493,15844,15835,1218,17053,120
2022-03-30,Alameda,001,1643700,256052,255467,14285,269752,1812
2022-03-30,Alpine,003,1148,124,124,1,125,0
2022-03-30,Amador,005,37829,8535,8485,652,9137,86
2022-03-30,Butte,007,227075,33024,32968,6651,39619,396
2022-03-30,Calaveras,009,45235,7263,7253,356,7609,119
2022-03-30,Colusa,011,21464,3442,3445,1075,4520,21
2022-03-30,Contra Costa,013,1133247,188540,188496,13333,201829,1291
2022-03-30,Del Norte,015,27424,5794,5808,198,6006,50
2022-03-30,El Dorado,017,186661,26708,26722,3217,29939,200
2022-03-30,Fresno,019,978130,231432,230448,24037,254485,2720
2022-03-30,Glenn,021,27897,4980,4982,1611,6593,47
2022-03-30,Humboldt,023,135768,16870,16894,2983,19877,140
2022-03-30,Imperial,025,180216,55420,55252,10859,66111,908
2022-03-30,Inyo,027,18085,4068,4062,486,4548,56
2022-03-30,Kern,029,883053,191758,191363,46291,237654,2219
2022-03-30,Kings,031,150075,51496,51446,3619,55065,443
2022-03-30,Lake,033,64148,10678,10674,898,11572,136
2022-03-30,Lassen,035,31185,8967,8943,889,9832,65
2022-03-30,Los Angeles,037,10098052,2708078,2702536,125035,2827571,31384
2022-03-30,Madera,039,155013,37259,37330,6096,43426,354
2022-03-30,Marin,041,260295,33546,33453,2263,35716,287
2022-03-30,Mariposa,043,17540,2394,2390,204,2594,27
2022-03-30,Mendocino,045,87422,13068,13055,3041,16096,118
2022-03-30,Merced,047,269075,62096,62136,8680,70816,808
2022-03-30,Modoc,049,8938,742,739,253,992,8
2022-03-30,Mono,051,14174,2968,2967,122,3089,6
2022-03-30,Monterey,053,433212,79412,78911,13894,92805,726
2022-03-30,Napa,055,140530,25798,25745,966,26711,141
2022-03-30,Nevada,057,99092,15952,15960,1211,17171,123
2022-03-30,Orange,059,3164182,546298,545895,41563,587458,6876
2022-03-30,Placer,061,380077,62730,62705,7419,70124,614
2022-03-30,Plumas,063,18699,2968,2762,369,3131,13
2022-03-30,Riverside,065,2383286,590784,590437,28131,618568,6411
2022-03-30,Sacramento,067,1510023,280662,276081,27332,303413,2949
2022-03-30,San Benito,069,59416,12903,12898,519,13417,98
2022-03-30,San Bernardino,071,2135413,565769,561153,24914,586067,6863
2022-03-30,San Diego,073,3302833,753105,751684,52330,804014,5169
2022-03-30,San Francisco,075,870044,124771,124930,8367,133297,841
2022-03-30,San Joaquin,077,732212,166211,166299,9727,176026,2201
2022-03-30,San Luis Obispo,079,281455,52442,52484,3804,56288,475
2022-03-30,San Mateo,081,765935,121898,120548,7045,127593,693
2022-03-30,Santa Barbara,083,443738,85742,85488,4785,90273,677
2022-03-30,Santa Clara,085,1922200,311670,312253,12479,324732,2258
2022-03-30,Santa Cruz,087,273765,47757,47340,2141,49481,259
2022-03-30,Shasta,089,179085,30551,30555,6155,36710,530
2022-03-30,Sierra,091,2930,271,273,48,321,4
2022-03-30,Siskiyou,093,43540,4445,4439,2754,7193,80
2022-03-30,Solano,095,438530,81392,81816,5560,87376,443
2022-03-30,Sonoma,097,501317,83521,83163,2641,85804,485
2022-03-30,Stanislaus,099,539301,117335,117593,17360,134953,1559
2022-03-30,Sutter,101,95872,20485,20565,2132,22697,222
2022-03-30,Tehama,103,63373,12038,12045,2624,14669,198
2022-03-30,Trinity,105,12862,1181,1173,295,1468,20
2022-03-30,Tulare,107,460477,106605,104667,28706,133373,1410
2022-03-30,Tuolumne,109,53932,12613,12616,566,13182,180
2022-03-30,Ventura,111,848112,173238,172984,9317,182301,1460
2022-03-30,Yolo,113,214977,36783,36325,3204,39529,313
2022-03-30,Yuba,115,75493,15842,15830,1218,17048,120
2022-03-29,Alameda,001,1643700,255929,255261,14275,269536,1810
2022-03-29,Alpine,003,1148,124,124,1,125,0
2022-03-29,Amador,005,37829,8535,8483,652,9135,86
2022-03-29,Butte,007,227075,33022,32954,6650,39604,396
2022-03-29,Calaveras,009,45235,7262,7250,355,7605,119
2022-03-29,Colusa,011,21464,3442,3445,1075,4520,21
2022-03-29,Contra Costa,013,1133247,188452,188359,13326,201685,1290
2022-03-29,Del Norte,015,27424,5793,5806,197,6003,50
2022-03-29,El Dorado,017,186661,26704,26706,3217,29923,200
2022-03-29,Fresno,019,978130,231403,230256,24032,254288,2718
2022-03-29,Glenn,021,27897,4979,4983,1611,6594,47
2022-03-29,Humboldt,023,135768,16867,16892,2980,19872,140
2022-03-29,Imperial,025,180216,55404,55233,10858,66091,908
2022-03-29,Inyo,027,18085,4066,4062,485,4547,56
2022-03-29,Kern,029,883053,191726,191338,46284,237622,2220
2022-03-29,Kings,031,150075,51488,51416,3618,55034,443
2022-03-29,Lake,033,64148,10674,10674,898,11572,136
2022-03-29,Lassen,035,31185,8966,8943,889,9832,65
2022-03-29,Los Angeles,037,10098052,2707247,2702005,124988,2826993,31378
2022-03-29,Madera,039,155013,37250,37325,6094,43419,354
2022-03-29,Marin,041,260295,33526,33431,2258,35689,287
2022-03-29,Mariposa,043,17540,2394,2388,203,2591,23
2022-03-29,Mendocino,045,87422,13064,13053,3040,16093,119
2022-03-29,Merced,047,269075,62084,62123,8679,70802,806
2022-03-29,Modoc,049,8938,740,737,253,990,8
2022-03-29,Mono,051,14174,2968,2966,122,3088,5
2022-03-29,Monterey,053,433212,79400,78774,13886,92660,725
2022-03-29,Napa,055,140530,25791,25732,966,26698,141
2022-03-29,Nevada,057,99092,15944,15956,1211,17167,123
2022-03-29,Orange,059,3164182,546152,545832,41547,587379,6871
2022-03-29,Placer,061,380077,62712,62687,7414,70101,614
2022-03-29,Plumas,063,18699,2966,2761,369,3130,13
2022-03-29,Riverside,065,2383286,590684,590359,28123,618482,6403
2022-03-29,Sacramento,067,1510023,280597,276040,27319,303359,2946
2022-03-29,San Benito,069,59416,12901,12892,519,13411,97
2022-03-29,San Bernardino,071,2135413,565677,561026,24905,585931,6860
2022-03-29,San Diego,073,3302833,752858,751240,52307,803547,5159
2022-03-29,San Francisco,075,870044,124620,124789,8361,133150,840
2022-03-29,San Joaquin,077,732212,166174,166241,9719,175960,2198
2022-03-29,San Luis Obispo,079,281455,52426,52455,3800,56255,472
2022-03-29,San Mateo,081,765935,121805,120435,7042,127477,686
2022-03-29,Santa Barbara,083,443738,85720,85464,4785,90249,676
2022-03-29,Santa Clara,085,1922200,311420,312067,12462,324529,2259
2022-03-29,Santa Cruz,087,273765,47737,47323,2140,49463,259
2022-03-29,Shasta,089,179085,30544,30552,6152,36704,529
2022-03-29,Sierra,091,2930,271,273,48,321,4
2022-03-29,Siskiyou,093,43540,4445,4439,2753,7192,80
2022-03-29,Solano,095,438530,81373,81713,5557,87270,441
2022-03-29,Sonoma,097,501317,83487,83130,2634,85764,485
2022-03-29,Stanislaus,099,539301,117316,117683,17354,135037,1559
2022-03-29,Sutter,101,95872,20483,20556,2131,22687,221
2022-03-29,Tehama,103,63373,12036,12045,2624,14669,198
2022-03-29,Trinity,105,12862,1181,1173,295,1468,20
2022-03-29,Tulare,107,460477,106600,104622,28700,133322,1406
2022-03-29,Tuolumne,109,53932,12610,12615,566,13181,180
2022-03-29,Ventura,111,848112,173182,172946,9316,182262,1460
2022-03-29,Yolo,113,214977,36775,36296,3203,39499,313
2022-03-29,Yuba,115,75493,15838,15824,1217,17041,117
2022-03-28,Alameda,001,1643700,255776,255192,14265,269457,1808
2022-03-28,Alpine,003,1148,124,124,1,125,0
2022-03-28,Amador,005,37829,8534,8480,652,9132,86
2022-03-28,Butte,007,227075,33005,32947,6649,39596,392
2022-03-28,Calaveras,009,45235,7262,7247,355,7602,119
2022-03-28,Colusa,011,21464,3442,3445,1075,4520,21
2022-03-28,Contra Costa,013,1133247,188371,188305,13321,201626,1290
2022-03-28,Del Norte,015,27424,5791,5834,197,6031,50
2022-03-28,El Dorado,017,186661,26697,26703,3215,29918,200
2022-03-28,Fresno,019,978130,231377,230144,24015,254159,2717
2022-03-28,Glenn,021,27897,4979,4983,1611,6594,47
2022-03-28,Humboldt,023,135768,16866,16916,2980,19896,140
2022-03-28,Imperial,025,180216,55392,55245,10858,66103,909
2022-03-28,Inyo,027,18085,4065,4062,485,4547,56
2022-03-28,Kern,029,883053,191702,191333,46274,237607,2212
2022-03-28,Kings,031,150075,51475,51405,3618,55023,443
2022-03-28,Lake,033,64148,10672,10673,898,11571,136
2022-03-28,Lassen,035,31185,8966,8946,889,9835,63
2022-03-28,Los Angeles,037,10098052,2706358,2700997,124949,2825946,31349
2022-03-28,Madera,039,155013,37247,37324,6094,43418,354
2022-03-28,Marin,041,260295,33501,33391,2253,35644,287
2022-03-28,Mariposa,043,17540,2393,2388,203,2591,23
2022-03-28,Mendocino,045,87422,13062,13046,3039,16085,118
2022-03-28,Merced,047,269075,62075,62116,8674,70790,805
2022-03-28,Modoc,049,8938,739,736,253,989,7
2022-03-28,Mono,051,14174,2968,2966,122,3088,5
2022-03-28,Monterey,053,433212,79365,78784,13881,92665,724
2022-03-28,Napa,055,140530,25785,25723,965,26688,140
2022-03-28,Nevada,057,99092,15942,15969,1211,17180,123
2022-03-28,Orange,059,3164182,546020,545700,41519,587219,6860
2022-03-28,Placer,061,380077,62691,62687,7413,70100,613
2022-03-28,Plumas,063,18699,2965,2760,369,3129,13
2022-03-28,Riverside,065,2383286,590588,590298,28113,618411,6397
2022-03-28,Sacramento,067,1510023,280526,275889,27308,303197,2946
2022-03-28,San Benito,069,59416,12901,12889,519,13408,97
2022-03-28,San Bernardino,071,2135413,565594,560836,24892,585728,6858
2022-03-28,San Diego,073,3302833,752611,750659,52274,802933,5155
2022-03-28,San Francisco,075,870044,124478,124678,8350,133028,839
2022-03-28,San Joaquin,077,732212,166142,166247,9715,175962,2196
2022-03-28,San Luis Obispo,079,281455,52401,52434,3797,56231,470
2022-03-28,San Mateo,081,765935,121689,120337,7035,127372,686
2022-03-28,Santa Barbara,083,443738,85692,85442,4783,90225,675
2022-03-28,Santa Clara,085,1922200,311183,311953,12453,324406,2257
2022-03-28,Santa Cruz,087,273765,47704,47324,2140,49464,259
2022-03-28,Shasta,089,179085,30543,30550,6151,36701,527
2022-03-28,Sierra,091,2930,271,273,48,321,4
2022-03-28,Siskiyou,093,43540,4444,4438,2753,7191,80
2022-03-28,Solano,095,438530,81349,81704,5552,87256,441
2022-03-28,Sonoma,097,501317,83444,83105,2629,85734,485
2022-03-28,Stanislaus,099,539301,117305,117783,17349,135132,1562
2022-03-28,Sutter,101,95872,20478,20549,2131,22680,221
2022-03-28,Tehama,103,63373,12035,12041,2623,14664,200
2022-03-28,Trinity,105,12862,1181,1173,295,1468,20
2022-03-28,Tulare,107,460477,106587,104576,28693,133269,1404
2022-03-28,Tuolumne,109,53932,12610,12627,566,13193,180
2022-03-28,Ventura,111,848112,173142,172867,9315,182182,1455
2022-03-28,Yolo,113,214977,36765,36282,3201,39483,312
2022-03-28,Yuba,115,75493,15837,15821,1215,17036,117
2022-03-27,Alameda,001,1643700,255594,255132,14256,269388,1809
2022-03-27,Alpine,003,1148,124,124,1,125,0
2022-03-27,Amador,005,37829,8531,8480,652,9132,86
2022-03-27,Butte,007,227075,32992,32943,6642,39585,392
2022-03-27,Calaveras,009,45235,7260,7245,355,7600,119
2022-03-27,Colusa,011,21464,3442,3445,1074,4519,21
2022-03-27,Contra Costa,013,1133247,188257,188251,13305,201556,1290
2022-03-27,Del Norte,015,27424,5790,5836,197,6033,50
2022-03-27,El Dorado,017,186661,26683,26699,3212,29911,200
2022-03-27,Fresno,019,978130,231331,230049,23998,254047,2717
2022-03-27,Glenn,021,27897,4978,4983,1611,6594,47
2022-03-27,Humboldt,023,135768,16862,16920,2980,19900,140
2022-03-27,Imperial,025,180216,55380,55240,10855,66095,909
2022-03-27,Inyo,027,18085,4064,4062,483,4545,56
2022-03-27,Kern,029,883053,191664,191332,46268,237600,2213
2022-03-27,Kings,031,150075,51466,51400,3618,55018,443
2022-03-27,Lake,033,64148,10671,10672,897,11569,136
2022-03-27,Lassen,035,31185,8966,8946,889,9835,63
2022-03-27,Los Angeles,037,10098052,2705557,2700983,124901,2825884,31348
2022-03-27,Madera,039,155013,37243,37323,6092,43415,354
2022-03-27,Marin,041,260295,33464,33391,2243,35634,287
2022-03-27,Mariposa,043,17540,2393,2390,203,2593,23
2022-03-27,Mendocino,045,87422,13056,13046,3037,16083,118
2022-03-27,Merced,047,269075,62064,62110,8672,70782,805
2022-03-27,Modoc,049,8938,738,736,251,987,7
2022-03-27,Mono,051,14174,2968,2966,122,3088,5
2022-03-27,Monterey,053,433212,79344,78778,13869,92647,724
2022-03-27,Napa,055,140530,25771,25723,965,26688,140
2022-03-27,Nevada,057,99092,15938,15967,1209,17176,123
2022-03-27,Orange,059,3164182,545885,545644,41483,587127,6860
2022-03-27,Placer,061,380077,62672,62680,7413,70093,613
2022-03-27,Plumas,063,18699,2964,2760,367,3127,13
2022-03-27,Riverside,065,2383286,590502,590251,28102,618353,6395
2022-03-27,Sacramento,067,1510023,280444,275854,27301,303155,2941
2022-03-27,San Benito,069,59416,12896,12889,518,13407,97
2022-03-27,San Bernardino,071,2135413,565479,560853,24888,585741,6862
2022-03-27,San Diego,073,3302833,752357,750659,52251,802910,5155
2022-03-27,San Francisco,075,870044,124293,124619,8338,132957,839
2022-03-27,San Joaquin,077,732212,166105,166238,9712,175950,2196
2022-03-27,San Luis Obispo,079,281455,52380,52430,3795,56225,470
2022-03-27,San Mateo,081,765935,121581,120324,7029,127353,686
2022-03-27,Santa Barbara,083,443738,85657,85434,4781,90215,675
2022-03-27,Santa Clara,085,1922200,310970,311822,12445,324267,2257
2022-03-27,Santa Cruz,087,273765,47671,47321,2135,49456,259
2022-03-27,Shasta,089,179085,30538,30550,6149,36699,527
2022-03-27,Sierra,091,2930,271,273,48,321,4
2022-03-27,Siskiyou,093,43540,4444,4436,2752,7188,80
2022-03-27,Solano,095,438530,81314,81691,5549,87240,441
2022-03-27,Sonoma,097,501317,83388,83088,2625,85713,485
2022-03-27,Stanislaus,099,539301,117284,117778,17346,135124,1562
2022-03-27,Sutter,101,95872,20472,20545,2131,22676,221
2022-03-27,Tehama,103,63373,12035,12040,2623,14663,200
2022-03-27,Trinity,105,12862,1181,1173,295,1468,20
2022-03-27,Tulare,107,460477,106578,104582,28683,133265,1404
2022-03-27,Tuolumne,109,53932,12608,12628,566,13194,180
2022-03-27,Ventura,111,848112,173094,172831,9313,182144,1455
2022-03-27,Yolo,113,214977,36753,36232,3198,39430,312
2022-03-27,Yuba,115,75493,15834,15821,1208,17029,117
2022-03-26,Alameda,001,1643700,255516,254691,14254,268945,1803
2022-03-26,Alpine,003,1148,124,124,1,125,0
2022-03-26,Amador,005,37829,8531,8476,652,9128,86
2022-03-26,Butte,007,227075,32987,32929,6640,39569,391
2022-03-26,Calaveras,009,45235,7258,7240,355,7595,120
2022-03-26,Colusa,011,21464,3440,3445,1074,4519,21
2022-03-26,Contra Costa,013,1133247,188202,187990,13302,201292,1285
2022-03-26,Del Norte,015,27424,5788,5831,197,6028,50
2022-03-26,El Dorado,017,186661,26675,26674,3210,29884,200
2022-03-26,Fresno,019,978130,231308,229799,23997,253796,2710
2022-03-26,Glenn,021,27897,4978,4978,1611,6589,47
2022-03-26,Humboldt,023,135768,16858,16911,2980,19891,139
2022-03-26,Imperial,025,180216,55374,55230,10854,66084,913
2022-03-26,Inyo,027,18085,4064,4060,482,4542,56
2022-03-26,Kern,029,883053,191650,191288,46263,237551,2201
2022-03-26,Kings,031,150075,51465,51397,3618,55015,444
2022-03-26,Lake,033,64148,10671,10659,897,11556,136
2022-03-26,Lassen,035,31185,8966,8944,889,9833,63
2022-03-26,Los Angeles,037,10098052,2705111,2698028,124859,2822887,31291
2022-03-26,Madera,039,155013,37240,37321,6090,43411,354
2022-03-26,Marin,041,260295,33454,33317,2239,35556,287
2022-03-26,Mariposa,043,17540,2393,2386,203,2589,23
2022-03-26,Mendocino,045,87422,13053,13038,3037,16075,118
2022-03-26,Merced,047,269075,62058,62083,8670,70753,805
2022-03-26,Modoc,049,8938,738,736,251,987,7
2022-03-26,Mono,051,14174,2968,2966,122,3088,5
2022-03-26,Monterey,053,433212,79337,78688,13867,92555,724
2022-03-26,Napa,055,140530,25768,25701,965,26666,139
2022-03-26,Nevada,057,99092,15934,15960,1209,17169,123
2022-03-26,Orange,059,3164182,545809,545294,41472,586766,6853
2022-03-26,Placer,061,380077,62660,62634,7409,70043,613
2022-03-26,Plumas,063,18699,2964,2758,366,3124,13
2022-03-26,Riverside,065,2383286,590433,590060,28101,618161,6397
2022-03-26,Sacramento,067,1510023,280411,275529,27299,302828,2935
2022-03-26,San Benito,069,59416,12896,12885,518,13403,97
2022-03-26,San Bernardino,071,2135413,565427,560742,24884,585626,6840
2022-03-26,San Diego,073,3302833,752229,750170,52244,802414,5146
2022-03-26,San Francisco,075,870044,124187,124265,8329,132594,839
2022-03-26,San Joaquin,077,732212,166084,166079,9711,175790,2195
2022-03-26,San Luis Obispo,079,281455,52374,52369,3795,56164,469
2022-03-26,San Mateo,081,765935,121524,120165,7021,127186,684
2022-03-26,Santa Barbara,083,443738,85637,85477,4779,90256,674
2022-03-26,Santa Clara,085,1922200,310802,311189,12436,323625,2250
2022-03-26,Santa Cruz,087,273765,47660,47329,2135,49464,259
2022-03-26,Shasta,089,179085,30536,30542,6148,36690,527
2022-03-26,Sierra,091,2930,271,273,48,321,4
2022-03-26,Siskiyou,093,43540,4443,4433,2752,7185,80
2022-03-26,Solano,095,438530,81304,81659,5549,87208,441
2022-03-26,Sonoma,097,501317,83359,83113,2620,85733,485
2022-03-26,Stanislaus,099,539301,117277,117962,17345,135307,1565
2022-03-26,Sutter,101,95872,20470,20536,2131,22667,221
2022-03-26,Tehama,103,63373,12035,12036,2622,14658,195
2022-03-26,Trinity,105,12862,1181,1174,295,1469,20
2022-03-26,Tulare,107,460477,106571,104538,28682,133220,1400
2022-03-26,Tuolumne,109,53932,12606,12628,566,13194,180
2022-03-26,Ventura,111,848112,173054,172690,9309,181999,1455
2022-03-26,Yolo,113,214977,36748,36234,3198,39432,311
2022-03-26,Yuba,115,75493,15833,15807,1208,17015,117
2022-03-25,Alameda,001,1643700,255449,254691,14252,268943,1803
2022-03-25,Alpine,003,1148,124,124,1,125,0
2022-03-25,Amador,005,37829,8530,8476,652,9128,86
2022-03-25,Butte,007,227075,32981,32929,6639,39568,391
2022-03-25,Calaveras,009,45235,7257,7240,355,7595,120
2022-03-25,Colusa,011,21464,3440,3445,1074,4519,21
2022-03-25,Contra Costa,013,1133247,188155,187990,13298,201288,1285
2022-03-25,Del Norte,015,27424,5788,5831,197,6028,50
2022-03-25,El Dorado,017,186661,26671,26674,3210,29884,200
2022-03-25,Fresno,019,978130,231280,229799,23988,253787,2710
2022-03-25,Glenn,021,27897,4978,4978,1611,6589,47
2022-03-25,Humboldt,023,135768,16858,16911,2980,19891,139
2022-03-25,Imperial,025,180216,55369,55230,10853,66083,913
2022-03-25,Inyo,027,18085,4063,4060,482,4542,56
2022-03-25,Kern,029,883053,191640,191288,46262,237550,2201
2022-03-25,Kings,031,150075,51464,51397,3618,55015,444
2022-03-25,Lake,033,64148,10671,10659,897,11556,136
2022-03-25,Lassen,035,31185,8965,8944,889,9833,63
2022-03-25,Los Angeles,037,10098052,2704698,2698028,124827,2822855,31291
2022-03-25,Madera,039,155013,37238,37321,6089,43410,354
2022-03-25,Marin,041,260295,33439,33317,2230,35547,287
2022-03-25,Mariposa,043,17540,2393,2386,203,2589,23
2022-03-25,Mendocino,045,87422,13053,13038,3037,16075,118
2022-03-25,Merced,047,269075,62051,62083,8669,70752,805
2022-03-25,Modoc,049,8938,738,736,251,987,7
2022-03-25,Mono,051,14174,2967,2966,122,3088,5
2022-03-25,Monterey,053,433212,79327,78688,13864,92552,724
2022-03-25,Napa,055,140530,25761,25701,965,26666,139
2022-03-25,Nevada,057,99092,15933,15960,1209,17169,123
2022-03-25,Orange,059,3164182,545735,545294,41455,586749,6853
2022-03-25,Placer,061,380077,62654,62634,7406,70040,613
2022-03-25,Plumas,063,18699,2963,2758,366,3124,13
2022-03-25,Riverside,065,2383286,590371,590060,28090,618150,6397
2022-03-25,Sacramento,067,1510023,280370,275529,27297,302826,2935
2022-03-25,San Benito,069,59416,12896,12885,518,13403,97
2022-03-25,San Bernardino,071,2135413,565388,560742,24882,585624,6840
2022-03-25,San Diego,073,3302833,752104,750170,52234,802404,5146
2022-03-25,San Francisco,075,870044,124105,124265,8315,132580,839
2022-03-25,San Joaquin,077,732212,166070,166079,9708,175787,2195
2022-03-25,San Luis Obispo,079,281455,52371,52369,3794,56163,469
2022-03-25,San Mateo,081,765935,121470,120165,7021,127186,684
2022-03-25,Santa Barbara,083,443738,85622,85477,4777,90254,674
2022-03-25,Santa Clara,085,1922200,310643,311189,12432,323621,2250
2022-03-25,Santa Cruz,087,273765,47652,47329,2135,49464,259
2022-03-25,Shasta,089,179085,30534,30542,6147,36689,527
2022-03-25,Sierra,091,2930,271,273,48,321,4
2022-03-25,Siskiyou,093,43540,4441,4433,2750,7183,80
2022-03-25,Solano,095,438530,81290,81659,5547,87206,441
2022-03-25,Sonoma,097,501317,83323,83113,2620,85733,485
2022-03-25,Stanislaus,099,539301,117262,117962,17344,135306,1565
2022-03-25,Sutter,101,95872,20465,20536,2131,22667,221
2022-03-25,Tehama,103,63373,12033,12036,2622,14658,195
2022-03-25,Trinity,105,12862,1181,1174,295,1469,20
2022-03-25,Tulare,107,460477,106566,104538,28679,133217,1400
2022-03-25,Tuolumne,109,53932,12605,12628,566,13194,180
2022-03-25,Ventura,111,848112,173016,172690,9309,181999,1455
2022-03-25,Yolo,113,214977,36735,36234,3198,39432,311
2022-03-25,Yuba,115,75493,15828,15807,1207,17014,117
2022-03-24,Alameda,001,1643700,255332,254691,14236,268927,1803
2022-03-24,Alpine,003,1148,124,124,1,125,0
2022-03-24,Amador,005,37829,8530,8476,652,9128,86
2022-03-24,Butte,007,227075,32974,32929,6639,39568,391
2022-03-24,Calaveras,009,45235,7254,7240,355,7595,120
2022-03-24,Colusa,011,21464,3440,3445,1074,4519,21
2022-03-24,Contra Costa,013,1133247,188075,187990,13297,201287,1285
2022-03-24,Del Norte,015,27424,5785,5831,197,6028,50
2022-03-24,El Dorado,017,186661,26660,26674,3210,29884,200
2022-03-24,Fresno,019,978130,231238,229799,23976,253775,2710
2022-03-24,Glenn,021,27897,4977,4978,1611,6589,47
2022-03-24,Humboldt,023,135768,16853,16911,2978,19889,139
2022-03-24,Imperial,025,180216,55362,55230,10853,66083,913
2022-03-24,Inyo,027,18085,4062,4060,482,4542,56
2022-03-24,Kern,029,883053,191629,191288,46259,237547,2201
2022-03-24,Kings,031,150075,51455,51397,3616,55013,444
2022-03-24,Lake,033,64148,10670,10659,897,11556,136
2022-03-24,Lassen,035,31185,8964,8944,889,9833,63
2022-03-24,Los Angeles,037,10098052,2704132,2698028,124783,2822811,31291
2022-03-24,Madera,039,155013,37236,37321,6087,43408,354
2022-03-24,Marin,041,260295,33416,33317,2221,35538,287
2022-03-24,Mariposa,043,17540,2393,2386,203,2589,23
2022-03-24,Mendocino,045,87422,13048,13038,3034,16072,118
2022-03-24,Merced,047,269075,62045,62083,8668,70751,805
2022-03-24,Modoc,049,8938,738,736,251,987,7
2022-03-24,Mono,051,14174,2967,2966,122,3088,5
2022-03-24,Monterey,053,433212,79301,78688,13850,92538,724
2022-03-24,Napa,055,140530,25752,25701,965,26666,139
2022-03-24,Nevada,057,99092,15929,15960,1208,17168,123
2022-03-24,Orange,059,3164182,545633,545294,41438,586732,6853
2022-03-24,Placer,061,380077,62634,62634,7405,70039,613
2022-03-24,Plumas,063,18699,2963,2758,366,3124,13
2022-03-24,Riverside,065,2383286,590295,590060,28081,618141,6397
2022-03-24,Sacramento,067,1510023,280299,275529,27292,302821,2935
2022-03-24,San Benito,069,59416,12895,12885,517,13402,97
2022-03-24,San Bernardino,071,2135413,565307,560742,24878,585620,6840
2022-03-24,San Diego,073,3302833,751891,750170,52223,802393,5146
2022-03-24,San Francisco,075,870044,124025,124265,8309,132574,839
2022-03-24,San Joaquin,077,732212,166043,166079,9707,175786,2195
2022-03-24,San Luis Obispo,079,281455,52356,52369,3793,56162,469
2022-03-24,San Mateo,081,765935,121422,120165,7016,127181,684
2022-03-24,Santa Barbara,083,443738,85607,85477,4774,90251,674
2022-03-24,Santa Clara,085,1922200,310499,311189,12414,323603,2250
2022-03-24,Santa Cruz,087,273765,47635,47329,2134,49463,259
2022-03-24,Shasta,089,179085,30526,30542,6147,36689,527
2022-03-24,Sierra,091,2930,271,273,48,321,4
2022-03-24,Siskiyou,093,43540,4438,4433,2750,7183,80
2022-03-24,Solano,095,438530,81271,81659,5546,87205,441
2022-03-24,Sonoma,097,501317,83287,83113,2618,85731,485
2022-03-24,Stanislaus,099,539301,117254,117962,17341,135303,1565
2022-03-24,Sutter,101,95872,20460,20536,2131,22667,221
2022-03-24,Tehama,103,63373,12032,12036,2620,14656,195
2022-03-24,Trinity,105,12862,1181,1174,295,1469,20
2022-03-24,Tulare,107,460477,106556,104538,28673,133211,1400
2022-03-24,Tuolumne,109,53932,12603,12628,566,13194,180
2022-03-24,Ventura,111,848112,172973,172690,9308,181998,1455
2022-03-24,Yolo,113,214977,36728,36234,3194,39428,311
2022-03-24,Yuba,115,75493,15823,15807,1204,17011,117
2022-03-23,Alameda,001,1643700,255199,254559,14224,268783,1802
2022-03-23,Alpine,003,1148,124,124,1,125,0
2022-03-23,Amador,005,37829,8530,8475,652,9127,86
2022-03-23,Butte,007,227075,32961,32920,6638,39558,387
2022-03-23,Calaveras,009,45235,7249,7237,355,7592,120
2022-03-23,Colusa,011,21464,3439,3444,1074,4518,21
2022-03-23,Contra Costa,013,1133247,187977,187898,13285,201183,1279
2022-03-23,Del Norte,015,27424,5784,5830,196,6026,50
2022-03-23,El Dorado,017,186661,26654,26670,3210,29880,200
2022-03-23,Fresno,019,978130,231202,229656,23960,253616,2710
2022-03-23,Glenn,021,27897,4977,4975,1611,6586,47
2022-03-23,Humboldt,023,135768,16852,16908,2976,19884,139
2022-03-23,Imperial,025,180216,55357,55211,10852,66063,909
2022-03-23,Inyo,027,18085,4062,4060,482,4542,56
2022-03-23,Kern,029,883053,191612,191241,46254,237495,2196
2022-03-23,Kings,031,150075,51443,51384,3615,54999,442
2022-03-23,Lake,033,64148,10666,10658,896,11554,135
2022-03-23,Lassen,035,31185,8963,8944,888,9832,63
2022-03-23,Los Angeles,037,10098052,2703456,2697227,124751,2821978,31267
2022-03-23,Madera,039,155013,37231,37317,6083,43400,354
2022-03-23,Marin,041,260295,33391,33274,2216,35490,287
2022-03-23,Mariposa,043,17540,2391,2382,202,2584,11
2022-03-23,Mendocino,045,87422,13044,13033,3033,16066,118
2022-03-23,Merced,047,269075,62035,62056,8664,70720,805
2022-03-23,Modoc,049,8938,738,736,251,987,7
2022-03-23,Mono,051,14174,2967,2966,122,3088,5
2022-03-23,Monterey,053,433212,79283,78655,13825,92480,724
2022-03-23,Napa,055,140530,25739,25691,963,26654,139
2022-03-23,Nevada,057,99092,15927,15958,1208,17166,123
2022-03-23,Orange,059,3164182,545504,545158,41425,586583,6852
2022-03-23,Placer,061,380077,62615,62622,7403,70025,613
2022-03-23,Plumas,063,18699,2963,2747,366,3113,13
2022-03-23,Riverside,065,2383286,590221,589947,28076,618023,6388
2022-03-23,Sacramento,067,1510023,280238,275398,27285,302683,2934
2022-03-23,San Benito,069,59416,12894,12884,517,13401,97
2022-03-23,San Bernardino,071,2135413,565233,560550,24873,585423,6828
2022-03-23,San Diego,073,3302833,751693,749871,52200,802071,5143
2022-03-23,San Francisco,075,870044,123911,124110,8303,132413,838
2022-03-23,San Joaquin,077,732212,166007,166041,9700,175741,2187
2022-03-23,San Luis Obispo,079,281455,52339,52344,3787,56131,469
2022-03-23,San Mateo,081,765935,121339,120080,7006,127086,685
2022-03-23,Santa Barbara,083,443738,85588,85464,4773,90237,673
2022-03-23,Santa Clara,085,1922200,310336,310956,12403,323359,2250
2022-03-23,Santa Cruz,087,273765,47614,47314,2128,49442,259
2022-03-23,Shasta,089,179085,30522,30524,6146,36670,526
2022-03-23,Sierra,091,2930,271,273,48,321,4
2022-03-23,Siskiyou,093,43540,4437,4433,2750,7183,80
2022-03-23,Solano,095,438530,81237,81615,5545,87160,441
2022-03-23,Sonoma,097,501317,83254,83074,2615,85689,482
2022-03-23,Stanislaus,099,539301,117237,118041,17338,135379,1568
2022-03-23,Sutter,101,95872,20457,20532,2131,22663,218
2022-03-23,Tehama,103,63373,12030,12035,2620,14655,195
2022-03-23,Trinity,105,12862,1181,1174,295,1469,20
2022-03-23,Tulare,107,460477,106539,104489,28667,133156,1394
2022-03-23,Tuolumne,109,53932,12602,12629,566,13195,180
2022-03-23,Ventura,111,848112,172923,172647,9306,181953,1455
2022-03-23,Yolo,113,214977,36712,36197,3192,39389,308
2022-03-23,Yuba,115,75493,15817,15801,1203,17004,117
2022-03-22,Alameda,001,1643700,255080,254467,13847,268314,1802
2022-03-22,Alpine,003,1148,124,122,1,123,0
2022-03-22,Amador,005,37829,8529,8462,651,9113,86
2022-03-22,Butte,007,227075,32951,32907,6634,39541,387
2022-03-22,Calaveras,009,45235,7247,7237,355,7592,120
2022-03-22,Colusa,011,21464,3438,3445,1074,4519,21
2022-03-22,Contra Costa,013,1133247,187900,187813,13263,201076,1279
2022-03-22,Del Norte,015,27424,5779,5824,196,6020,50
2022-03-22,El Dorado,017,186661,26647,26661,3210,29871,200
2022-03-22,Fresno,019,978130,231154,229551,23952,253503,2708
2022-03-22,Glenn,021,27897,4974,4971,1611,6582,47
2022-03-22,Humboldt,023,135768,16849,16911,2976,19887,139
2022-03-22,Imperial,025,180216,55346,55170,10849,66019,908
2022-03-22,Inyo,027,18085,4062,4060,482,4542,56
2022-03-22,Kern,029,883053,191588,191213,46245,237458,2195
2022-03-22,Kings,031,150075,51431,51369,3614,54983,442
2022-03-22,Lake,033,64148,10664,10657,895,11552,135
2022-03-22,Lassen,035,31185,8963,8940,887,9827,63
2022-03-22,Los Angeles,037,10098052,2702794,2696746,124702,2821448,31250
2022-03-22,Madera,039,155013,37227,37304,6080,43384,354
2022-03-22,Marin,041,260295,33366,33253,2212,35465,287
2022-03-22,Mariposa,043,17540,2389,2382,202,2584,6
2022-03-22,Mendocino,045,87422,13039,13030,3031,16061,118
2022-03-22,Merced,047,269075,62025,62056,8660,70716,805
2022-03-22,Modoc,049,8938,738,735,251,986,7
2022-03-22,Mono,051,14174,2967,2963,122,3085,5
2022-03-22,Monterey,053,433212,79267,78614,13814,92428,724
2022-03-22,Napa,055,140530,25729,25688,962,26650,139
2022-03-22,Nevada,057,99092,15919,15950,1208,17158,123
2022-03-22,Orange,059,3164182,545359,545075,41406,586481,6843
2022-03-22,Placer,061,380077,62602,62604,7401,70005,610
2022-03-22,Plumas,063,18699,2962,2744,366,3110,13
2022-03-22,Riverside,065,2383286,590147,589816,28073,617889,6383
2022-03-22,Sacramento,067,1510023,280161,275374,27273,302647,2927
2022-03-22,San Benito,069,59416,12893,12884,516,13400,97
2022-03-22,San Bernardino,071,2135413,565152,560371,24853,585224,6811
2022-03-22,San Diego,073,3302833,751485,749647,52180,801827,5141
2022-03-22,San Francisco,075,870044,123803,123998,8297,132295,838
2022-03-22,San Joaquin,077,732212,165979,165992,9696,175688,2187
2022-03-22,San Luis Obispo,079,281455,52331,52257,3787,56044,465
2022-03-22,San Mateo,081,765935,121268,119975,7002,126977,686
2022-03-22,Santa Barbara,083,443738,85572,85457,4772,90229,672
2022-03-22,Santa Clara,085,1922200,310163,310787,12393,323180,2249
2022-03-22,Santa Cruz,087,273765,47595,47287,2127,49414,259
2022-03-22,Shasta,089,179085,30516,30528,6145,36673,525
2022-03-22,Sierra,091,2930,271,273,48,321,4
2022-03-22,Siskiyou,093,43540,4437,4429,2749,7178,80
2022-03-22,Solano,095,438530,81214,81587,5544,87131,440
2022-03-22,Sonoma,097,501317,83226,83042,2611,85653,482
2022-03-22,Stanislaus,099,539301,117220,118025,17335,135360,1568
2022-03-22,Sutter,101,95872,20456,20525,2127,22652,218
2022-03-22,Tehama,103,63373,12028,12034,2620,14654,162
2022-03-22,Trinity,105,12862,1181,1174,295,1469,20
2022-03-22,Tulare,107,460477,106527,104431,28658,133089,1391
2022-03-22,Tuolumne,109,53932,12602,12628,566,13194,180
2022-03-22,Ventura,111,848112,172875,172590,9304,181894,1455
2022-03-22,Yolo,113,214977,36695,36184,3191,39375,308
2022-03-22,Yuba,115,75493,15814,15795,1202,16997,117
2022-03-21,Alameda,001,1643700,254865,254354,13839,268193,1799
2022-03-21,Alpine,003,1148,124,122,1,123,0
2022-03-21,Amador,005,37829,8526,8461,650,9111,85
2022-03-21,Butte,007,227075,32940,32895,6630,39525,385
2022-03-21,Calaveras,009,45235,7246,7237,355,7592,119
2022-03-21,Colusa,011,21464,3438,3445,1074,4519,21
2022-03-21,Contra Costa,013,1133247,187836,187509,13246,200755,1276
2022-03-21,Del Norte,015,27424,5778,5824,196,6020,50
2022-03-21,El Dorado,017,186661,26635,26610,3209,29819,199
2022-03-21,Fresno,019,978130,231105,229374,23943,253317,2707
2022-03-21,Glenn,021,27897,4972,4972,1605,6577,46
2022-03-21,Humboldt,023,135768,16839,16912,2963,19875,139
2022-03-21,Imperial,025,180216,55332,55133,10848,65981,908
2022-03-21,Inyo,027,18085,4061,4060,482,4542,56
2022-03-21,Kern,029,883053,191554,191184,46239,237423,2187
2022-03-21,Kings,031,150075,51417,51366,3612,54978,441
2022-03-21,Lake,033,64148,10662,10655,895,11550,135
2022-03-21,Lassen,035,31185,8962,8939,887,9826,63
2022-03-21,Los Angeles,037,10098052,2701929,2694711,124652,2819363,31218
2022-03-21,Madera,039,155013,37221,37288,6076,43364,354
2022-03-21,Marin,041,260295,33322,33242,2207,35449,287
2022-03-21,Mariposa,043,17540,2388,2383,201,2584,6
2022-03-21,Mendocino,045,87422,13031,13028,3029,16057,118
2022-03-21,Merced,047,269075,62011,62048,8655,70703,803
2022-03-21,Modoc,049,8938,736,734,251,985,7
2022-03-21,Mono,051,14174,2967,2962,122,3084,5
2022-03-21,Monterey,053,433212,79219,78572,13800,92372,724
2022-03-21,Napa,055,140530,25721,25684,960,26644,138
2022-03-21,Nevada,057,99092,15915,15963,1207,17170,123
2022-03-21,Orange,059,3164182,545204,544943,41389,586332,6841
2022-03-21,Placer,061,380077,62583,62550,7400,69950,610
2022-03-21,Plumas,063,18699,2962,2744,366,3110,13
2022-03-21,Riverside,065,2383286,590065,589707,28067,617774,6376
2022-03-21,Sacramento,067,1510023,280070,275334,27259,302593,2925
2022-03-21,San Benito,069,59416,12887,12872,516,13388,97
2022-03-21,San Bernardino,071,2135413,565061,560210,24841,585051,6807
2022-03-21,San Diego,073,3302833,751252,748833,52159,800992,5138
2022-03-21,San Francisco,075,870044,123635,123912,8288,132200,835
2022-03-21,San Joaquin,077,732212,165953,165939,9693,175632,2185
2022-03-21,San Luis Obispo,079,281455,52306,52219,3782,56001,463
2022-03-21,San Mateo,081,765935,121108,119899,7000,126899,684
2022-03-21,Santa Barbara,083,443738,85556,85416,4770,90186,672
2022-03-21,Santa Clara,085,1922200,309892,310509,12390,322899,2245
2022-03-21,Santa Cruz,087,273765,47559,47267,2126,49393,259
2022-03-21,Shasta,089,179085,30510,30523,6143,36666,525
2022-03-21,Sierra,091,2930,271,273,48,321,4
2022-03-21,Siskiyou,093,43540,4437,4426,2749,7175,80
2022-03-21,Solano,095,438530,81186,81399,5544,86943,441
2022-03-21,Sonoma,097,501317,83188,82979,2606,85585,482
2022-03-21,Stanislaus,099,539301,117187,118144,17332,135476,1571
2022-03-21,Sutter,101,95872,20453,20523,2114,22637,218
2022-03-21,Tehama,103,63373,12024,12030,2620,14650,160
2022-03-21,Trinity,105,12862,1181,1174,295,1469,20
2022-03-21,Tulare,107,460477,106507,104350,28653,133003,1389
2022-03-21,Tuolumne,109,53932,12602,12620,566,13186,180
2022-03-21,Ventura,111,848112,172806,172537,9300,181837,1452
2022-03-21,Yolo,113,214977,36680,36141,3189,39330,307
2022-03-21,Yuba,115,75493,15811,15790,1201,16991,117
2022-03-20,Alameda,001,1643700,254725,254293,13828,268121,1801
2022-03-20,Alpine,003,1148,122,122,1,123,0
2022-03-20,Amador,005,37829,8523,8460,650,9110,85
2022-03-20,Butte,007,227075,32926,32892,6626,39518,385
2022-03-20,Calaveras,009,45235,7245,7233,352,7585,119
2022-03-20,Colusa,011,21464,3438,3446,1074,4520,21
2022-03-20,Contra Costa,013,1133247,187733,187467,13234,200701,1276
2022-03-20,Del Norte,015,27424,5775,5821,196,6017,50
2022-03-20,El Dorado,017,186661,26628,26608,3209,29817,199
2022-03-20,Fresno,019,978130,231028,229297,23936,253233,2707
2022-03-20,Glenn,021,27897,4970,4972,1605,6577,46
2022-03-20,Humboldt,023,135768,16837,16913,2961,19874,139
2022-03-20,Imperial,025,180216,55321,55133,10847,65980,908
2022-03-20,Inyo,027,18085,4061,4060,482,4542,56
2022-03-20,Kern,029,883053,191509,191170,46234,237404,2187
2022-03-20,Kings,031,150075,51405,51360,3612,54972,441
2022-03-20,Lake,033,64148,10658,10652,895,11547,135
2022-03-20,Lassen,035,31185,8960,8938,887,9825,63
2022-03-20,Los Angeles,037,10098052,2701137,2694698,124605,2819303,31219
2022-03-20,Madera,039,155013,37216,37284,6072,43356,354
2022-03-20,Marin,041,260295,33306,33232,2206,35438,275
2022-03-20,Mariposa,043,17540,2388,2383,201,2584,6
2022-03-20,Mendocino,045,87422,13024,13027,3024,16051,118
2022-03-20,Merced,047,269075,62000,62041,8649,70690,803
2022-03-20,Modoc,049,8938,736,734,251,985,7
2022-03-20,Mono,051,14174,2965,2962,122,3084,5
2022-03-20,Monterey,053,433212,79186,78566,13789,92355,723
2022-03-20,Napa,055,140530,25709,25682,959,26641,138
2022-03-20,Nevada,057,99092,15911,15964,1207,17171,123
2022-03-20,Orange,059,3164182,545082,544862,41370,586232,6841
2022-03-20,Placer,061,380077,62562,62525,7400,69925,610
2022-03-20,Plumas,063,18699,2962,2744,366,3110,13
2022-03-20,Riverside,065,2383286,589968,589657,28062,617719,6376
2022-03-20,Sacramento,067,1510023,279990,275317,27244,302561,2927
2022-03-20,San Benito,069,59416,12887,12869,515,13384,97
2022-03-20,San Bernardino,071,2135413,564981,560220,24833,585053,6805
2022-03-20,San Diego,073,3302833,751005,748833,52126,800959,5138
2022-03-20,San Francisco,075,870044,123484,123858,8275,132133,835
2022-03-20,San Joaquin,077,732212,165919,165927,9689,175616,2185
2022-03-20,San Luis Obispo,079,281455,52282,52217,3779,55996,463
2022-03-20,San Mateo,081,765935,121048,119901,6994,126895,684
2022-03-20,Santa Barbara,083,443738,85531,85412,4768,90180,672
2022-03-20,Santa Clara,085,1922200,309678,310412,12383,322795,2243
2022-03-20,Santa Cruz,087,273765,47532,47265,2125,49390,259
2022-03-20,Shasta,089,179085,30499,30522,6142,36664,525
2022-03-20,Sierra,091,2930,271,273,48,321,4
2022-03-20,Siskiyou,093,43540,4436,4426,2749,7175,80
2022-03-20,Solano,095,438530,81156,81393,5542,86935,441
2022-03-20,Sonoma,097,501317,83145,82965,2605,85570,481
2022-03-20,Stanislaus,099,539301,117162,118146,17328,135474,1572
2022-03-20,Sutter,101,95872,20446,20519,2104,22623,218
2022-03-20,Tehama,103,63373,12022,12030,2620,14650,160
2022-03-20,Trinity,105,12862,1181,1174,295,1469,20
2022-03-20,Tulare,107,460477,106485,104353,28638,132991,1389
2022-03-20,Tuolumne,109,53932,12597,12617,566,13183,180
2022-03-20,Ventura,111,848112,172753,172514,9295,181809,1451
2022-03-20,Yolo,113,214977,36660,36135,3188,39323,307
2022-03-20,Yuba,115,75493,15803,15787,1199,16986,117
2022-03-19,Alameda,001,1643700,254642,253936,13826,267762,1797
2022-03-19,Alpine,003,1148,122,122,1,123,0
2022-03-19,Amador,005,37829,8520,8456,650,9106,85
2022-03-19,Butte,007,227075,32919,32856,6626,39482,385
2022-03-19,Calaveras,009,45235,7244,7229,352,7581,119
2022-03-19,Colusa,011,21464,3436,3445,1074,4519,21
2022-03-19,Contra Costa,013,1133247,187697,187225,13233,200458,1276
2022-03-19,Del Norte,015,27424,5772,5815,196,6011,48
2022-03-19,El Dorado,017,186661,26624,26618,3209,29827,199
2022-03-19,Fresno,019,978130,231005,228965,23936,252901,2694
2022-03-19,Glenn,021,27897,4970,4971,1605,6576,44
2022-03-19,Humboldt,023,135768,16831,16901,2961,19862,138
2022-03-19,Imperial,025,180216,55320,55038,10846,65884,898
2022-03-19,Inyo,027,18085,4061,4061,482,4543,56
2022-03-19,Kern,029,883053,191496,190943,46226,237169,2184
2022-03-19,Kings,031,150075,51400,51334,3612,54946,441
2022-03-19,Lake,033,64148,10658,10641,895,11536,135
2022-03-19,Lassen,035,31185,8960,8925,887,9812,63
2022-03-19,Los Angeles,037,10098052,2700772,2686759,124571,2811330,31133
2022-03-19,Madera,039,155013,37216,37273,6072,43345,354
2022-03-19,Marin,041,260295,33288,33163,2202,35365,272
2022-03-19,Mariposa,043,17540,2387,2378,201,2579,6
2022-03-19,Mendocino,045,87422,13024,13012,3024,16036,117
2022-03-19,Merced,047,269075,61994,61985,8647,70632,800
2022-03-19,Modoc,049,8938,736,734,251,985,7
2022-03-19,Mono,051,14174,2965,2961,122,3083,5
2022-03-19,Monterey,053,433212,79174,78483,13782,92265,720
2022-03-19,Napa,055,140530,25706,25654,959,26613,138
2022-03-19,Nevada,057,99092,15909,15960,1207,17167,123
2022-03-19,Orange,059,3164182,545011,543907,41354,585261,6817
2022-03-19,Placer,061,380077,62547,62483,7400,69883,605
2022-03-19,Plumas,063,18699,2962,2724,366,3090,13
2022-03-19,Riverside,065,2383286,589916,589017,28054,617071,6359
2022-03-19,Sacramento,067,1510023,279950,274855,27240,302095,2913
2022-03-19,San Benito,069,59416,12886,12859,515,13374,97
2022-03-19,San Bernardino,071,2135413,564935,559935,24831,584766,6778
2022-03-19,San Diego,073,3302833,750901,747344,52114,799458,5133
2022-03-19,San Francisco,075,870044,123416,123587,8272,131859,833
2022-03-19,San Joaquin,077,732212,165893,165765,9686,175451,2181
2022-03-19,San Luis Obispo,079,281455,52276,52174,3779,55953,463
2022-03-19,San Mateo,081,765935,121012,119782,6993,126775,667
2022-03-19,Santa Barbara,083,443738,85517,85336,4767,90103,671
2022-03-19,Santa Clara,085,1922200,309556,309918,12375,322293,2225
2022-03-19,Santa Cruz,087,273765,47524,47203,2121,49324,256
2022-03-19,Shasta,089,179085,30495,30495,6142,36637,525
2022-03-19,Sierra,091,2930,271,273,48,321,4
2022-03-19,Siskiyou,093,43540,4435,4422,2749,7171,76
2022-03-19,Solano,095,438530,81147,81340,5539,86879,441
2022-03-19,Sonoma,097,501317,83127,82838,2602,85440,472
2022-03-19,Stanislaus,099,539301,117152,118138,17326,135464,1568
2022-03-19,Sutter,101,95872,20443,20503,2104,22607,218
2022-03-19,Tehama,103,63373,12022,12007,2620,14627,160
2022-03-19,Trinity,105,12862,1181,1173,295,1468,20
2022-03-19,Tulare,107,460477,106476,104290,28633,132923,1384
2022-03-19,Tuolumne,109,53932,12597,12617,566,13183,180
2022-03-19,Ventura,111,848112,172722,172380,9294,181674,1451
2022-03-19,Yolo,113,214977,36651,36086,3188,39274,306
2022-03-19,Yuba,115,75493,15799,15768,1198,16966,117
2022-03-18,Alameda,001,1643700,254582,253936,13822,267758,1797
2022-03-18,Alpine,003,1148,122,122,1,123,0
2022-03-18,Amador,005,37829,8520,8456,650,9106,85
2022-03-18,Butte,007,227075,32914,32856,6624,39480,385
2022-03-18,Calaveras,009,45235,7244,7229,352,7581,119
2022-03-18,Colusa,011,21464,3436,3445,1074,4519,21
2022-03-18,Contra Costa,013,1133247,187663,187225,13231,200456,1276
2022-03-18,Del Norte,015,27424,5770,5815,195,6010,48
2022-03-18,El Dorado,017,186661,26619,26618,3207,29825,199
2022-03-18,Fresno,019,978130,230972,228965,23936,252901,2694
2022-03-18,Glenn,021,27897,4970,4971,1605,6576,44
2022-03-18,Humboldt,023,135768,16828,16901,2960,19861,138
2022-03-18,Imperial,025,180216,55318,55038,10846,65884,898
2022-03-18,Inyo,027,18085,4061,4061,482,4543,56
2022-03-18,Kern,029,883053,191485,190943,46223,237166,2184
2022-03-18,Kings,031,150075,51394,51334,3612,54946,441
2022-03-18,Lake,033,64148,10656,10641,894,11535,135
2022-03-18,Lassen,035,31185,8959,8925,887,9812,63
2022-03-18,Los Angeles,037,10098052,2700426,2686759,124545,2811304,31133
2022-03-18,Madera,039,155013,37211,37273,6072,43345,354
2022-03-18,Marin,041,260295,33274,33163,2202,35365,272
2022-03-18,Mariposa,043,17540,2386,2378,201,2579,6
2022-03-18,Mendocino,045,87422,13019,13012,3024,16036,117
2022-03-18,Merced,047,269075,61984,61985,8647,70632,800
2022-03-18,Modoc,049,8938,736,734,251,985,7
2022-03-18,Mono,051,14174,2964,2961,122,3083,5
2022-03-18,Monterey,053,433212,79156,78483,13779,92262,720
2022-03-18,Napa,055,140530,25703,25654,959,26613,138
2022-03-18,Nevada,057,99092,15906,15960,1206,17166,123
2022-03-18,Orange,059,3164182,544943,543907,41345,585252,6817
2022-03-18,Placer,061,380077,62539,62483,7400,69883,605
2022-03-18,Plumas,063,18699,2962,2724,366,3090,13
2022-03-18,Riverside,065,2383286,589859,589017,28050,617067,6359
2022-03-18,Sacramento,067,1510023,279916,274855,27235,302090,2913
2022-03-18,San Benito,069,59416,12884,12859,515,13374,97
2022-03-18,San Bernardino,071,2135413,564896,559935,24829,584764,6778
2022-03-18,San Diego,073,3302833,750791,747344,52099,799443,5133
2022-03-18,San Francisco,075,870044,123336,123587,8265,131852,833
2022-03-18,San Joaquin,077,732212,165879,165765,9681,175446,2181
2022-03-18,San Luis Obispo,079,281455,52270,52174,3779,55953,463
2022-03-18,San Mateo,081,765935,120976,119782,6990,126772,667
2022-03-18,Santa Barbara,083,443738,85508,85336,4766,90102,671
2022-03-18,Santa Clara,085,1922200,309451,309918,12372,322290,2225
2022-03-18,Santa Cruz,087,273765,47512,47203,2120,49323,256
2022-03-18,Shasta,089,179085,30494,30495,6142,36637,525
2022-03-18,Sierra,091,2930,271,273,48,321,4
2022-03-18,Siskiyou,093,43540,4435,4422,2749,7171,76
2022-03-18,Solano,095,438530,81136,81340,5533,86873,441
2022-03-18,Sonoma,097,501317,83107,82838,2601,85439,472
2022-03-18,Stanislaus,099,539301,117139,118138,17326,135464,1568
2022-03-18,Sutter,101,95872,20440,20503,2104,22607,218
2022-03-18,Tehama,103,63373,12021,12007,2620,14627,160
2022-03-18,Trinity,105,12862,1181,1173,295,1468,20
2022-03-18,Tulare,107,460477,106470,104290,28626,132916,1384
2022-03-18,Tuolumne,109,53932,12596,12617,566,13183,180
2022-03-18,Ventura,111,848112,172702,172380,9290,181670,1451
2022-03-18,Yolo,113,214977,36640,36086,3188,39274,306
2022-03-18,Yuba,115,75493,15797,15768,1198,16966,117
2022-03-17,Alameda,001,1643700,254484,253936,13815,267751,1797
2022-03-17,Alpine,003,1148,122,122,1,123,0
2022-03-17,Amador,005,37829,8513,8456,650,9106,85
2022-03-17,Butte,007,227075,32900,32856,6622,39478,385
2022-03-17,Calaveras,009,45235,7241,7229,352,7581,119
2022-03-17,Colusa,011,21464,3436,3445,1074,4519,21
2022-03-17,Contra Costa,013,1133247,187598,187225,13221,200446,1276
2022-03-17,Del Norte,015,27424,5768,5815,195,6010,48
2022-03-17,El Dorado,017,186661,26612,26618,3207,29825,199
2022-03-17,Fresno,019,978130,230923,228965,23933,252898,2694
2022-03-17,Glenn,021,27897,4970,4971,1605,6576,44
2022-03-17,Humboldt,023,135768,16824,16901,2958,19859,138
2022-03-17,Imperial,025,180216,55307,55038,10846,65884,898
2022-03-17,Inyo,027,18085,4061,4061,482,4543,56
2022-03-17,Kern,029,883053,191455,190943,46220,237163,2184
2022-03-17,Kings,031,150075,51391,51334,3611,54945,441
2022-03-17,Lake,033,64148,10653,10641,894,11535,135
2022-03-17,Lassen,035,31185,8957,8925,887,9812,63
2022-03-17,Los Angeles,037,10098052,2699771,2686759,124508,2811267,31133
2022-03-17,Madera,039,155013,37207,37273,6071,43344,354
2022-03-17,Marin,041,260295,33262,33163,2201,35364,272
2022-03-17,Mariposa,043,17540,2386,2378,201,2579,6
2022-03-17,Mendocino,045,87422,13016,13012,3021,16033,117
2022-03-17,Merced,047,269075,61978,61985,8645,70630,800
2022-03-17,Modoc,049,8938,736,734,251,985,7
2022-03-17,Mono,051,14174,2964,2961,121,3082,5
2022-03-17,Monterey,053,433212,79134,78483,13773,92256,720
2022-03-17,Napa,055,140530,25698,25654,959,26613,138
2022-03-17,Nevada,057,99092,15903,15960,1206,17166,123
2022-03-17,Orange,059,3164182,544849,543907,41334,585241,6817
2022-03-17,Placer,061,380077,62523,62483,7398,69881,605
2022-03-17,Plumas,063,18699,2961,2724,366,3090,13
2022-03-17,Riverside,065,2383286,589780,589017,28043,617060,6359
2022-03-17,Sacramento,067,1510023,279850,274855,27227,302082,2913
2022-03-17,San Benito,069,59416,12883,12859,515,13374,97
2022-03-17,San Bernardino,071,2135413,564830,559935,24826,584761,6778
2022-03-17,San Diego,073,3302833,750614,747344,52085,799429,5133
2022-03-17,San Francisco,075,870044,123256,123587,8260,131847,833
2022-03-17,San Joaquin,077,732212,165856,165765,9679,175444,2181
2022-03-17,San Luis Obispo,079,281455,52256,52174,3777,55951,463
2022-03-17,San Mateo,081,765935,120930,119782,6986,126768,667
2022-03-17,Santa Barbara,083,443738,85491,85336,4766,90102,671
2022-03-17,Santa Clara,085,1922200,309331,309918,12367,322285,2225
2022-03-17,Santa Cruz,087,273765,47496,47203,2118,49321,256
2022-03-17,Shasta,089,179085,30491,30495,6140,36635,525
2022-03-17,Sierra,091,2930,271,273,48,321,4
2022-03-17,Siskiyou,093,43540,4434,4422,2749,7171,76
2022-03-17,Solano,095,438530,81107,81340,5530,86870,441
2022-03-17,Sonoma,097,501317,83077,82838,2599,85437,472
2022-03-17,Stanislaus,099,539301,117126,118138,17321,135459,1568
2022-03-17,Sutter,101,95872,20430,20503,2090,22593,218
2022-03-17,Tehama,103,63373,12021,12007,2619,14626,160
2022-03-17,Trinity,105,12862,1181,1173,295,1468,20
2022-03-17,Tulare,107,460477,106455,104290,28615,132905,1384
2022-03-17,Tuolumne,109,53932,12593,12617,565,13182,180
2022-03-17,Ventura,111,848112,172655,172380,9288,181668,1451
2022-03-17,Yolo,113,214977,36627,36086,3188,39274,306
2022-03-17,Yuba,115,75493,15795,15768,1197,16965,117
2022-03-16,Alameda,001,1643700,254385,253792,13811,267603,1794
2022-03-16,Alpine,003,1148,122,122,1,123,0
2022-03-16,Amador,005,37829,8505,8449,650,9099,85
2022-03-16,Butte,007,227075,32887,32837,6617,39454,385
2022-03-16,Calaveras,009,45235,7239,7229,352,7581,120
2022-03-16,Colusa,011,21464,3436,3445,1073,4518,22
2022-03-16,Contra Costa,013,1133247,187540,187100,13212,200312,1266
2022-03-16,Del Norte,015,27424,5767,5811,193,6004,48
2022-03-16,El Dorado,017,186661,26600,26602,3206,29808,199
2022-03-16,Fresno,019,978130,230875,228786,23921,252707,2689
2022-03-16,Glenn,021,27897,4970,4969,1604,6573,44
2022-03-16,Humboldt,023,135768,16821,16893,2958,19851,138
2022-03-16,Imperial,025,180216,55295,55002,10845,65847,897
2022-03-16,Inyo,027,18085,4060,4061,482,4543,56
2022-03-16,Kern,029,883053,191412,190835,46213,237048,2170
2022-03-16,Kings,031,150075,51376,51321,3611,54932,437
2022-03-16,Lake,033,64148,10651,10633,893,11526,133
2022-03-16,Lassen,035,31185,8954,8924,887,9811,62
2022-03-16,Los Angeles,037,10098052,2699142,2685789,124467,2810256,31102
2022-03-16,Madera,039,155013,37199,37262,6070,43332,354
2022-03-16,Marin,041,260295,33241,33136,2199,35335,272
2022-03-16,Mariposa,043,17540,2384,2376,201,2577,6
2022-03-16,Mendocino,045,87422,13013,13011,3020,16031,117
2022-03-16,Merced,047,269075,61962,61959,8639,70598,798
2022-03-16,Modoc,049,8938,735,734,251,985,7
2022-03-16,Mono,051,14174,2964,2960,121,3081,5
2022-03-16,Monterey,053,433212,79112,78416,13768,92184,720
2022-03-16,Napa,055,140530,25689,25638,958,26596,138
2022-03-16,Nevada,057,99092,15901,15960,1206,17166,123
2022-03-16,Orange,059,3164182,544727,543326,41310,584636,6791
2022-03-16,Placer,061,380077,62508,62435,7396,69831,605
2022-03-16,Plumas,063,18699,2961,2723,366,3089,13
2022-03-16,Riverside,065,2383286,589680,588761,28040,616801,6351
2022-03-16,Sacramento,067,1510023,279783,274709,27220,301929,2910
2022-03-16,San Benito,069,59416,12878,12854,515,13369,97
2022-03-16,San Bernardino,071,2135413,564750,559746,24821,584567,6775
2022-03-16,San Diego,073,3302833,750403,746970,52061,799031,5126
2022-03-16,San Francisco,075,870044,123156,123446,8252,131698,831
2022-03-16,San Joaquin,077,732212,165809,165703,9676,175379,2169
2022-03-16,San Luis Obispo,079,281455,52238,52132,3774,55906,462
2022-03-16,San Mateo,081,765935,120868,119680,6977,126657,660
2022-03-16,Santa Barbara,083,443738,85458,85322,4761,90083,670
2022-03-16,Santa Clara,085,1922200,309147,309689,12351,322040,2224
2022-03-16,Santa Cruz,087,273765,47467,47161,2118,49279,255
2022-03-16,Shasta,089,179085,30482,30489,6136,36625,527
2022-03-16,Sierra,091,2930,271,273,48,321,4
2022-03-16,Siskiyou,093,43540,4431,4419,2747,7166,76
2022-03-16,Solano,095,438530,81084,81277,5528,86805,440
2022-03-16,Sonoma,097,501317,83032,82791,2590,85381,472
2022-03-16,Stanislaus,099,539301,117100,118072,17319,135391,1567
2022-03-16,Sutter,101,95872,20428,20494,2089,22583,218
2022-03-16,Tehama,103,63373,12019,11999,2619,14618,160
2022-03-16,Trinity,105,12862,1181,1173,295,1468,20
2022-03-16,Tulare,107,460477,106441,104217,28608,132825,1377
2022-03-16,Tuolumne,109,53932,12588,12610,565,13175,180
2022-03-16,Ventura,111,848112,172615,172212,9284,181496,1451
2022-03-16,Yolo,113,214977,36605,36079,3186,39265,307
2022-03-16,Yuba,115,75493,15790,15758,1197,16955,117
2022-03-15,Alameda,001,1643700,254253,253694,13801,267495,1793
2022-03-15,Alpine,003,1148,122,122,1,123,0
2022-03-15,Amador,005,37829,8502,8448,650,9098,85
2022-03-15,Butte,007,227075,32874,32822,6615,39437,385
2022-03-15,Calaveras,009,45235,7237,7236,352,7588,118
2022-03-15,Colusa,011,21464,3436,3445,1073,4518,21
2022-03-15,Contra Costa,013,1133247,187460,187021,13203,200224,1265
2022-03-15,Del Norte,015,27424,5764,5806,190,5996,48
2022-03-15,El Dorado,017,186661,26597,26596,3205,29801,199
2022-03-15,Fresno,019,978130,230832,228631,23911,252542,2689
2022-03-15,Glenn,021,27897,4968,4966,1604,6570,44
2022-03-15,Humboldt,023,135768,16815,16889,2957,19846,138
2022-03-15,Imperial,025,180216,55285,54981,10841,65822,896
2022-03-15,Inyo,027,18085,4060,4062,481,4543,56
2022-03-15,Kern,029,883053,191383,190645,46203,236848,2168
2022-03-15,Kings,031,150075,51356,51317,3607,54924,437
2022-03-15,Lake,033,64148,10647,10631,893,11524,131
2022-03-15,Lassen,035,31185,8952,8926,886,9812,62
2022-03-15,Los Angeles,037,10098052,2698469,2685071,124407,2809478,31077
2022-03-15,Madera,039,155013,37189,37258,6069,43327,354
2022-03-15,Marin,041,260295,33218,33111,2198,35309,272
2022-03-15,Mariposa,043,17540,2382,2377,201,2578,6
2022-03-15,Mendocino,045,87422,13008,13005,3019,16024,117
2022-03-15,Merced,047,269075,61944,61916,8630,70546,798
2022-03-15,Modoc,049,8938,735,733,251,984,7
2022-03-15,Mono,051,14174,2964,2961,121,3082,5
2022-03-15,Monterey,053,433212,79081,78400,13760,92160,718
2022-03-15,Napa,055,140530,25681,25657,956,26613,138
2022-03-15,Nevada,057,99092,15899,15960,1204,17164,123
2022-03-15,Orange,059,3164182,544585,543197,41303,584500,6780
2022-03-15,Placer,061,380077,62490,62398,7392,69790,604
2022-03-15,Plumas,063,18699,2960,2722,366,3088,13
2022-03-15,Riverside,065,2383286,589579,588622,28032,616654,6333
2022-03-15,Sacramento,067,1510023,279701,274633,27213,301846,2907
2022-03-15,San Benito,069,59416,12874,12849,515,13364,95
2022-03-15,San Bernardino,071,2135413,564674,559605,24816,584421,6770
2022-03-15,San Diego,073,3302833,750154,746474,52039,798513,5116
2022-03-15,San Francisco,075,870044,123040,123526,8243,131769,831
2022-03-15,San Joaquin,077,732212,165766,165664,9670,175334,2161
2022-03-15,San Luis Obispo,079,281455,52228,52060,3770,55830,458
2022-03-15,San Mateo,081,765935,120817,119586,6971,126557,649
2022-03-15,Santa Barbara,083,443738,85433,85353,4757,90110,668
2022-03-15,Santa Clara,085,1922200,308986,309535,12339,321874,2224
2022-03-15,Santa Cruz,087,273765,47414,47117,2118,49235,255
2022-03-15,Shasta,089,179085,30473,30476,6133,36609,524
2022-03-15,Sierra,091,2930,271,273,48,321,4
2022-03-15,Siskiyou,093,43540,4431,4420,2747,7167,76
2022-03-15,Solano,095,438530,81049,81260,5527,86787,440
2022-03-15,Sonoma,097,501317,82989,82737,2590,85327,472
2022-03-15,Stanislaus,099,539301,117081,118085,17316,135401,1567
2022-03-15,Sutter,101,95872,20425,20480,2079,22559,217
2022-03-15,Tehama,103,63373,12016,11997,2618,14615,160
2022-03-15,Trinity,105,12862,1181,1173,295,1468,20
2022-03-15,Tulare,107,460477,106422,104153,28596,132749,1375
2022-03-15,Tuolumne,109,53932,12584,12602,565,13167,180
2022-03-15,Ventura,111,848112,172570,172150,9280,181430,1451
2022-03-15,Yolo,113,214977,36592,36079,3180,39259,308
2022-03-15,Yuba,115,75493,15781,15756,1197,16953,116
2022-03-14,Alameda,001,1643700,254136,253629,13796,267425,1791
2022-03-14,Alpine,003,1148,122,122,1,123,0
2022-03-14,Amador,005,37829,8497,8448,650,9098,85
2022-03-14,Butte,007,227075,32856,32812,6614,39426,385
2022-03-14,Calaveras,009,45235,7236,7245,352,7597,118
2022-03-14,Colusa,011,21464,3435,3445,1073,4518,21
2022-03-14,Contra Costa,013,1133247,187367,186969,13194,200163,1265
2022-03-14,Del Norte,015,27424,5758,5807,190,5997,48
2022-03-14,El Dorado,017,186661,26592,26570,3205,29775,199
2022-03-14,Fresno,019,978130,230756,228470,23902,252372,2682
2022-03-14,Glenn,021,27897,4966,4966,1603,6569,44
2022-03-14,Humboldt,023,135768,16808,16890,2955,19845,137
2022-03-14,Imperial,025,180216,55272,54933,10839,65772,897
2022-03-14,Inyo,027,18085,4060,4062,481,4543,56
2022-03-14,Kern,029,883053,191350,190526,46192,236718,2166
2022-03-14,Kings,031,150075,51338,51293,3606,54899,437
2022-03-14,Lake,033,64148,10644,10631,893,11524,131
2022-03-14,Lassen,035,31185,8952,8927,885,9812,62
2022-03-14,Los Angeles,037,10098052,2697848,2683369,124339,2807708,31034
2022-03-14,Madera,039,155013,37183,37255,6068,43323,354
2022-03-14,Marin,041,260295,33189,33099,2198,35297,272
2022-03-14,Mariposa,043,17540,2381,2376,201,2577,6
2022-03-14,Mendocino,045,87422,13002,12992,3012,16004,117
2022-03-14,Merced,047,269075,61926,61905,8628,70533,795
2022-03-14,Modoc,049,8938,734,731,251,982,7
2022-03-14,Mono,051,14174,2963,2961,121,3082,5
2022-03-14,Monterey,053,433212,79067,78376,13723,92099,718
2022-03-14,Napa,055,140530,25666,25649,956,26605,138
2022-03-14,Nevada,057,99092,15897,15954,1204,17158,123
2022-03-14,Orange,059,3164182,544445,543099,41295,584394,6775
2022-03-14,Placer,061,380077,62472,62389,7390,69779,601
2022-03-14,Plumas,063,18699,2960,2711,366,3077,13
2022-03-14,Riverside,065,2383286,589442,588531,28020,616551,6332
2022-03-14,Sacramento,067,1510023,279621,274682,27208,301890,2899
2022-03-14,San Benito,069,59416,12869,12846,514,13360,95
2022-03-14,San Bernardino,071,2135413,564588,559505,24810,584315,6767
2022-03-14,San Diego,073,3302833,749844,745515,52012,797527,5108
2022-03-14,San Francisco,075,870044,122950,123575,8237,131812,824
2022-03-14,San Joaquin,077,732212,165728,165662,9669,175331,2142
2022-03-14,San Luis Obispo,079,281455,52201,52046,3767,55813,458
2022-03-14,San Mateo,081,765935,120744,119564,6968,126532,649
2022-03-14,Santa Barbara,083,443738,85396,85396,4756,90152,667
2022-03-14,Santa Clara,085,1922200,308797,309600,12336,321936,2223
2022-03-14,Santa Cruz,087,273765,47376,47107,2115,49222,255
2022-03-14,Shasta,089,179085,30468,30462,6130,36592,520
2022-03-14,Sierra,091,2930,271,273,48,321,4
2022-03-14,Siskiyou,093,43540,4426,4419,2746,7165,76
2022-03-14,Solano,095,438530,81002,81233,5522,86755,440
2022-03-14,Sonoma,097,501317,82955,82731,2586,85317,473
2022-03-14,Stanislaus,099,539301,117043,118088,17313,135401,1567
2022-03-14,Sutter,101,95872,20418,20478,2079,22557,217
2022-03-14,Tehama,103,63373,12014,11996,2618,14614,160
2022-03-14,Trinity,105,12862,1181,1172,295,1467,20
2022-03-14,Tulare,107,460477,106392,104121,28585,132706,1365
2022-03-14,Tuolumne,109,53932,12583,12567,564,13131,180
2022-03-14,Ventura,111,848112,172517,172107,9278,181385,1442
2022-03-14,Yolo,113,214977,36576,36059,3178,39237,308
2022-03-14,Yuba,115,75493,15770,15748,1197,16945,116
2022-03-13,Alameda,001,1643700,254011,253547,13787,267334,1792
2022-03-13,Alpine,003,1148,122,122,1,123,0
2022-03-13,Amador,005,37829,8495,8444,650,9094,85
2022-03-13,Butte,007,227075,32837,32806,6610,39416,384
2022-03-13,Calaveras,009,45235,7231,7253,352,7605,118
2022-03-13,Colusa,011,21464,3435,3444,1071,4515,21
2022-03-13,Contra Costa,013,1133247,187274,186911,13179,200090,1265
2022-03-13,Del Norte,015,27424,5754,5808,190,5998,48
2022-03-13,El Dorado,017,186661,26587,26563,3204,29767,199
2022-03-13,Fresno,019,978130,230676,228421,23889,252310,2683
2022-03-13,Glenn,021,27897,4962,4966,1602,6568,44
2022-03-13,Humboldt,023,135768,16800,16883,2955,19838,137
2022-03-13,Imperial,025,180216,55262,54934,10837,65771,897
2022-03-13,Inyo,027,18085,4060,4062,480,4542,56
2022-03-13,Kern,029,883053,191296,190495,46178,236673,2166
2022-03-13,Kings,031,150075,51330,51273,3605,54878,437
2022-03-13,Lake,033,64148,10641,10626,893,11519,131
2022-03-13,Lassen,035,31185,8951,8929,884,9813,62
2022-03-13,Los Angeles,037,10098052,2697120,2683351,124295,2807646,31034
2022-03-13,Madera,039,155013,37175,37248,6068,43316,354
2022-03-13,Marin,041,260295,33164,33083,2196,35279,272
2022-03-13,Mariposa,043,17540,2379,2376,201,2577,6
2022-03-13,Mendocino,045,87422,12996,12987,3007,15994,117
2022-03-13,Merced,047,269075,61902,61895,8617,70512,795
2022-03-13,Modoc,049,8938,734,731,251,982,7
2022-03-13,Mono,051,14174,2963,2961,121,3082,5
2022-03-13,Monterey,053,433212,79031,78366,13673,92039,718
2022-03-13,Napa,055,140530,25651,25639,955,26594,138
2022-03-13,Nevada,057,99092,15890,15959,1204,17163,123
2022-03-13,Orange,059,3164182,544324,543036,41271,584307,6774
2022-03-13,Placer,061,380077,62445,62372,7387,69759,601
2022-03-13,Plumas,063,18699,2960,2711,366,3077,13
2022-03-13,Riverside,065,2383286,589308,588487,28014,616501,6332
2022-03-13,Sacramento,067,1510023,279520,274715,27196,301911,2899
2022-03-13,San Benito,069,59416,12863,12844,512,13356,95
2022-03-13,San Bernardino,071,2135413,564492,559450,24799,584249,6767
2022-03-13,San Diego,073,3302833,749494,745515,51978,797493,5108
2022-03-13,San Francisco,075,870044,122827,123622,8231,131853,824
2022-03-13,San Joaquin,077,732212,165680,165641,9667,175308,2142
2022-03-13,San Luis Obispo,079,281455,52171,52040,3764,55804,458
2022-03-13,San Mateo,081,765935,120666,119521,6959,126480,649
2022-03-13,Santa Barbara,083,443738,85354,85453,4754,90207,667
2022-03-13,Santa Clara,085,1922200,308627,309493,12326,321819,2225
2022-03-13,Santa Cruz,087,273765,47325,47087,2114,49201,255
2022-03-13,Shasta,089,179085,30451,30457,6128,36585,520
2022-03-13,Sierra,091,2930,271,273,48,321,4
2022-03-13,Siskiyou,093,43540,4426,4418,2746,7164,76
2022-03-13,Solano,095,438530,80967,81217,5518,86735,440
2022-03-13,Sonoma,097,501317,82918,82711,2581,85292,473
2022-03-13,Stanislaus,099,539301,117011,118075,17310,135385,1567
2022-03-13,Sutter,101,95872,20414,20474,2078,22552,217
2022-03-13,Tehama,103,63373,12013,11997,2617,14614,160
2022-03-13,Trinity,105,12862,1181,1172,295,1467,20
2022-03-13,Tulare,107,460477,106354,104119,28573,132692,1365
2022-03-13,Tuolumne,109,53932,12580,12565,564,13129,180
2022-03-13,Ventura,111,848112,172459,172080,9272,181352,1442
2022-03-13,Yolo,113,214977,36560,36019,3174,39193,308
2022-03-13,Yuba,115,75493,15765,15741,1197,16938,116
2022-03-12,Alameda,001,1643700,253946,253079,13782,266861,1783
2022-03-12,Alpine,003,1148,122,122,1,123,0
2022-03-12,Amador,005,37829,8491,8427,650,9077,84
2022-03-12,Butte,007,227075,32833,32774,6608,39382,380
2022-03-12,Calaveras,009,45235,7230,7253,352,7605,118
2022-03-12,Colusa,011,21464,3435,3440,1071,4511,21
2022-03-12,Contra Costa,013,1133247,187230,186618,13178,199796,1256
2022-03-12,Del Norte,015,27424,5753,5791,190,5981,48
2022-03-12,El Dorado,017,186661,26583,26538,3204,29742,199
2022-03-12,Fresno,019,978130,230653,228041,23889,251930,2653
2022-03-12,Glenn,021,27897,4962,4955,1602,6557,44
2022-03-12,Humboldt,023,135768,16796,16862,2954,19816,137
2022-03-12,Imperial,025,180216,55258,54837,10833,65670,896
2022-03-12,Inyo,027,18085,4060,4056,480,4536,56
2022-03-12,Kern,029,883053,191279,190330,46173,236503,2162
2022-03-12,Kings,031,150075,51324,51145,3605,54750,436
2022-03-12,Lake,033,64148,10638,10594,892,11486,131
2022-03-12,Lassen,035,31185,8950,8915,884,9799,62
2022-03-12,Los Angeles,037,10098052,2696801,2678858,124276,2803134,30901
2022-03-12,Madera,039,155013,37171,37223,6068,43291,354
2022-03-12,Marin,041,260295,33140,33015,2195,35210,272
2022-03-12,Mariposa,043,17540,2379,2372,201,2573,6
2022-03-12,Mendocino,045,87422,12992,12965,3007,15972,117
2022-03-12,Merced,047,269075,61897,61840,8616,70456,795
2022-03-12,Modoc,049,8938,734,730,251,981,7
2022-03-12,Mono,051,14174,2963,2960,120,3080,5
2022-03-12,Monterey,053,433212,79024,78285,13671,91956,716
2022-03-12,Napa,055,140530,25641,25584,954,26538,138
2022-03-12,Nevada,057,99092,15883,15947,1204,17151,123
2022-03-12,Orange,059,3164182,544259,542354,41262,583616,6718
2022-03-12,Placer,061,380077,62436,62282,7387,69669,598
2022-03-12,Plumas,063,18699,2960,2707,366,3073,13
2022-03-12,Riverside,065,2383286,589245,588022,28009,616031,6317
2022-03-12,Sacramento,067,1510023,279481,274519,27192,301711,2886
2022-03-12,San Benito,069,59416,12860,12868,512,13380,95
2022-03-12,San Bernardino,071,2135413,564450,559013,24798,583811,6734
2022-03-12,San Diego,073,3302833,749364,744386,51956,796342,5090
2022-03-12,San Francisco,075,870044,122763,123610,8225,131835,823
2022-03-12,San Joaquin,077,732212,165663,165516,9664,175180,2117
2022-03-12,San Luis Obispo,079,281455,52162,51947,3761,55708,457
2022-03-12,San Mateo,081,765935,120629,119288,6958,126246,641
2022-03-12,Santa Barbara,083,443738,85336,85421,4754,90175,664
2022-03-12,Santa Clara,085,1922200,308528,308989,12320,321309,2208
2022-03-12,Santa Cruz,087,273765,47312,46982,2113,49095,254
2022-03-12,Shasta,089,179085,30439,30419,6126,36545,517
2022-03-12,Sierra,091,2930,271,273,48,321,4
2022-03-12,Siskiyou,093,43540,4426,4405,2746,7151,75
2022-03-12,Solano,095,438530,80953,81058,5518,86576,436
2022-03-12,Sonoma,097,501317,82901,82622,2579,85201,473
2022-03-12,Stanislaus,099,539301,116997,117884,17309,135193,1564
2022-03-12,Sutter,101,95872,20412,20429,2078,22507,217
2022-03-12,Tehama,103,63373,12013,11983,2617,14600,159
2022-03-12,Trinity,105,12862,1180,1172,295,1467,20
2022-03-12,Tulare,107,460477,106348,103994,28568,132562,1358
2022-03-12,Tuolumne,109,53932,12579,12476,564,13040,180
2022-03-12,Ventura,111,848112,172434,171932,9270,181202,1442
2022-03-12,Yolo,113,214977,36553,35982,3172,39154,308
2022-03-12,Yuba,115,75493,15765,15722,1197,16919,116
2022-03-11,Alameda,001,1643700,253880,253079,13782,266861,1783
2022-03-11,Alpine,003,1148,122,122,1,123,0
2022-03-11,Amador,005,37829,8489,8427,650,9077,84
2022-03-11,Butte,007,227075,32829,32774,6607,39381,380
2022-03-11,Calaveras,009,45235,7230,7253,352,7605,118
2022-03-11,Colusa,011,21464,3435,3440,1071,4511,21
2022-03-11,Contra Costa,013,1133247,187182,186618,13176,199794,1256
2022-03-11,Del Norte,015,27424,5749,5791,190,5981,48
2022-03-11,El Dorado,017,186661,26579,26538,3204,29742,199
2022-03-11,Fresno,019,978130,230597,228041,23886,251927,2653
2022-03-11,Glenn,021,27897,4962,4955,1602,6557,44
2022-03-11,Humboldt,023,135768,16791,16862,2952,19814,137
2022-03-11,Imperial,025,180216,55251,54837,10832,65669,896
2022-03-11,Inyo,027,18085,4060,4056,480,4536,56
2022-03-11,Kern,029,883053,191258,190330,46168,236498,2162
2022-03-11,Kings,031,150075,51304,51145,3605,54750,436
2022-03-11,Lake,033,64148,10634,10594,892,11486,131
2022-03-11,Lassen,035,31185,8949,8915,884,9799,62
2022-03-11,Los Angeles,037,10098052,2696479,2678858,124251,2803109,30901
2022-03-11,Madera,039,155013,37166,37223,6068,43291,354
2022-03-11,Marin,041,260295,33124,33015,2194,35209,272
2022-03-11,Mariposa,043,17540,2379,2372,201,2573,6
2022-03-11,Mendocino,045,87422,12986,12965,3007,15972,117
2022-03-11,Merced,047,269075,61887,61840,8614,70454,795
2022-03-11,Modoc,049,8938,734,730,251,981,7
2022-03-11,Mono,051,14174,2962,2960,120,3080,5
2022-03-11,Monterey,053,433212,79011,78285,13665,91950,716
2022-03-11,Napa,055,140530,25631,25584,954,26538,138
2022-03-11,Nevada,057,99092,15880,15947,1204,17151,123
2022-03-11,Orange,059,3164182,544189,542354,41248,583602,6718
2022-03-11,Placer,061,380077,62426,62282,7386,69668,598
2022-03-11,Plumas,063,18699,2958,2707,366,3073,13
2022-03-11,Riverside,065,2383286,589172,588022,28005,616027,6317
2022-03-11,Sacramento,067,1510023,279414,274519,27189,301708,2886
2022-03-11,San Benito,069,59416,12859,12868,512,13380,95
2022-03-11,San Bernardino,071,2135413,564394,559013,24792,583805,6734
2022-03-11,San Diego,073,3302833,749197,744386,51942,796328,5090
2022-03-11,San Francisco,075,870044,122713,123610,8221,131831,823
2022-03-11,San Joaquin,077,732212,165630,165516,9661,175177,2117
2022-03-11,San Luis Obispo,079,281455,52154,51947,3760,55707,457
2022-03-11,San Mateo,081,765935,120580,119288,6955,126243,641
2022-03-11,Santa Barbara,083,443738,85316,85421,4753,90174,664
2022-03-11,Santa Clara,085,1922200,308427,308989,12316,321305,2208
2022-03-11,Santa Cruz,087,273765,47297,46982,2113,49095,254
2022-03-11,Shasta,089,179085,30433,30419,6123,36542,517
2022-03-11,Sierra,091,2930,271,273,48,321,4
2022-03-11,Siskiyou,093,43540,4424,4405,2744,7149,75
2022-03-11,Solano,095,438530,80939,81058,5517,86575,436
2022-03-11,Sonoma,097,501317,82876,82622,2577,85199,473
2022-03-11,Stanislaus,099,539301,116984,117884,17308,135192,1564
2022-03-11,Sutter,101,95872,20410,20429,2078,22507,217
2022-03-11,Tehama,103,63373,12011,11983,2617,14600,159
2022-03-11,Trinity,105,12862,1180,1172,295,1467,20
2022-03-11,Tulare,107,460477,106335,103994,28562,132556,1358
2022-03-11,Tuolumne,109,53932,12577,12476,564,13040,180
2022-03-11,Ventura,111,848112,172398,171932,9265,181197,1442
2022-03-11,Yolo,113,214977,36541,35982,3172,39154,308
2022-03-11,Yuba,115,75493,15762,15722,1197,16919,116
2022-03-10,Alameda,001,1643700,253768,253079,13775,266854,1783
2022-03-10,Alpine,003,1148,122,122,1,123,0
2022-03-10,Amador,005,37829,8488,8427,650,9077,84
2022-03-10,Butte,007,227075,32815,32774,6605,39379,380
2022-03-10,Calaveras,009,45235,7229,7253,351,7604,118
2022-03-10,Colusa,011,21464,3435,3440,1071,4511,21
2022-03-10,Contra Costa,013,1133247,187097,186618,13166,199784,1256
2022-03-10,Del Norte,015,27424,5740,5791,190,5981,48
2022-03-10,El Dorado,017,186661,26567,26538,3203,29741,199
2022-03-10,Fresno,019,978130,230522,228041,23877,251918,2653
2022-03-10,Glenn,021,27897,4960,4955,1602,6557,44
2022-03-10,Humboldt,023,135768,16782,16862,2951,19813,137
2022-03-10,Imperial,025,180216,55241,54837,10831,65668,896
2022-03-10,Inyo,027,18085,4059,4056,480,4536,56
2022-03-10,Kern,029,883053,191224,190330,46153,236483,2162
2022-03-10,Kings,031,150075,51275,51145,3604,54749,436
2022-03-10,Lake,033,64148,10624,10594,891,11485,131
2022-03-10,Lassen,035,31185,8949,8915,884,9799,62
2022-03-10,Los Angeles,037,10098052,2695927,2678858,124212,2803070,30901
2022-03-10,Madera,039,155013,37159,37223,6061,43284,354
2022-03-10,Marin,041,260295,33110,33015,2190,35205,272
2022-03-10,Mariposa,043,17540,2379,2372,201,2573,6
2022-03-10,Mendocino,045,87422,12982,12965,3007,15972,117
2022-03-10,Merced,047,269075,61870,61840,8608,70448,795
2022-03-10,Modoc,049,8938,733,730,251,981,7
2022-03-10,Mono,051,14174,2962,2960,120,3080,5
2022-03-10,Monterey,053,433212,78988,78285,13639,91924,716
2022-03-10,Napa,055,140530,25622,25584,953,26537,138
2022-03-10,Nevada,057,99092,15873,15947,1204,17151,123
2022-03-10,Orange,059,3164182,544066,542354,41232,583586,6718
2022-03-10,Placer,061,380077,62405,62282,7380,69662,598
2022-03-10,Plumas,063,18699,2957,2707,366,3073,13
2022-03-10,Riverside,065,2383286,589058,588022,27998,616020,6317
2022-03-10,Sacramento,067,1510023,279336,274519,27183,301702,2886
2022-03-10,San Benito,069,59416,12858,12868,511,13379,95
2022-03-10,San Bernardino,071,2135413,564321,559013,24784,583797,6734
2022-03-10,San Diego,073,3302833,748933,744386,51910,796296,5090
2022-03-10,San Francisco,075,870044,122646,123610,8214,131824,823
2022-03-10,San Joaquin,077,732212,165602,165516,9659,175175,2117
2022-03-10,San Luis Obispo,079,281455,52131,51947,3757,55704,457
2022-03-10,San Mateo,081,765935,120516,119288,6952,126240,641
2022-03-10,Santa Barbara,083,443738,85284,85421,4752,90173,664
2022-03-10,Santa Clara,085,1922200,308299,308989,12307,321296,2208
2022-03-10,Santa Cruz,087,273765,47264,46982,2113,49095,254
2022-03-10,Shasta,089,179085,30425,30419,6121,36540,517
2022-03-10,Sierra,091,2930,271,273,48,321,4
2022-03-10,Siskiyou,093,43540,4424,4405,2744,7149,75
2022-03-10,Solano,095,438530,80903,81058,5516,86574,436
2022-03-10,Sonoma,097,501317,82849,82622,2577,85199,473
2022-03-10,Stanislaus,099,539301,116946,117884,17306,135190,1564
2022-03-10,Sutter,101,95872,20405,20429,2078,22507,217
2022-03-10,Tehama,103,63373,12010,11983,2617,14600,159
2022-03-10,Trinity,105,12862,1180,1172,295,1467,20
2022-03-10,Tulare,107,460477,106315,103994,28556,132550,1358
2022-03-10,Tuolumne,109,53932,12574,12476,564,13040,180
2022-03-10,Ventura,111,848112,172357,171932,9262,181194,1442
2022-03-10,Yolo,113,214977,36527,35982,3171,39153,308
2022-03-10,Yuba,115,75493,15752,15722,1196,16918,116
2022-03-09,Alameda,001,1643700,253642,252893,13768,266661,1781
2022-03-09,Alpine,003,1148,122,125,1,126,0
2022-03-09,Amador,005,37829,8482,8409,650,9059,84
2022-03-09,Butte,007,227075,32806,32767,6600,39367,380
2022-03-09,Calaveras,009,45235,7227,7249,351,7600,117
2022-03-09,Colusa,011,21464,3434,3439,1071,4510,21
2022-03-09,Contra Costa,013,1133247,187004,186483,13150,199633,1256
2022-03-09,Del Norte,015,27424,5736,5765,190,5955,48
2022-03-09,El Dorado,017,186661,26562,26515,3203,29718,198
2022-03-09,Fresno,019,978130,230424,227885,23868,251753,2653
2022-03-09,Glenn,021,27897,4958,4953,1601,6554,44
2022-03-09,Humboldt,023,135768,16777,16854,2948,19802,137
2022-03-09,Imperial,025,180216,55234,54764,10829,65593,894
2022-03-09,Inyo,027,18085,4059,4056,480,4536,56
2022-03-09,Kern,029,883053,191174,190254,46140,236394,2159
2022-03-09,Kings,031,150075,51255,51122,3604,54726,435
2022-03-09,Lake,033,64148,10618,10586,891,11477,130
2022-03-09,Lassen,035,31185,8949,8901,884,9785,62
2022-03-09,Los Angeles,037,10098052,2695283,2677901,124172,2802073,30842
2022-03-09,Madera,039,155013,37152,37207,6060,43267,354
2022-03-09,Marin,041,260295,33092,32967,2190,35157,272
2022-03-09,Mariposa,043,17540,2376,2372,201,2573,6
2022-03-09,Mendocino,045,87422,12978,12957,3002,15959,117
2022-03-09,Merced,047,269075,61854,61792,8602,70394,792
2022-03-09,Modoc,049,8938,732,730,250,980,7
2022-03-09,Mono,051,14174,2962,2962,120,3082,5
2022-03-09,Monterey,053,433212,78964,78258,13592,91850,716
2022-03-09,Napa,055,140530,25601,25561,952,26513,138
2022-03-09,Nevada,057,99092,15864,15938,1203,17141,123
2022-03-09,Orange,059,3164182,543933,542278,41219,583497,6700
2022-03-09,Placer,061,380077,62382,62242,7376,69618,598
2022-03-09,Plumas,063,18699,2956,2708,366,3074,13
2022-03-09,Riverside,065,2383286,588961,587833,27988,615821,6305
2022-03-09,Sacramento,067,1510023,279252,274373,27166,301539,2877
2022-03-09,San Benito,069,59416,12855,12864,511,13375,95
2022-03-09,San Bernardino,071,2135413,564228,558795,24772,583567,6723
2022-03-09,San Diego,073,3302833,748656,743956,51883,795839,5083
2022-03-09,San Francisco,075,870044,122558,123676,8209,131885,812
2022-03-09,San Joaquin,077,732212,165563,165444,9653,175097,2113
2022-03-09,San Luis Obispo,079,281455,52112,51923,3754,55677,457
2022-03-09,San Mateo,081,765935,120458,119194,6940,126134,639
2022-03-09,Santa Barbara,083,443738,85267,85382,4750,90132,661
2022-03-09,Santa Clara,085,1922200,308169,308765,12296,321061,2206
2022-03-09,Santa Cruz,087,273765,47224,46917,2112,49029,254
2022-03-09,Shasta,089,179085,30403,30407,6120,36527,493
2022-03-09,Sierra,091,2930,271,273,48,321,4
2022-03-09,Siskiyou,093,43540,4422,4403,2743,7146,75
2022-03-09,Solano,095,438530,80867,80984,5514,86498,436
2022-03-09,Sonoma,097,501317,82816,82574,2575,85149,473
2022-03-09,Stanislaus,099,539301,116909,117827,17301,135128,1541
2022-03-09,Sutter,101,95872,20394,20409,2074,22483,217
2022-03-09,Tehama,103,63373,12006,11980,2617,14597,159
2022-03-09,Trinity,105,12862,1180,1174,295,1469,20
2022-03-09,Tulare,107,460477,106286,103932,28541,132473,1350
2022-03-09,Tuolumne,109,53932,12572,12444,564,13008,180
2022-03-09,Ventura,111,848112,172307,171852,9259,181111,1448
2022-03-09,Yolo,113,214977,36508,35973,3156,39129,308
2022-03-09,Yuba,115,75493,15747,15714,1195,16909,115
2022-03-08,Alameda,001,1643700,253487,252744,13756,266500,1769
2022-03-08,Alpine,003,1148,122,125,1,126,0
2022-03-08,Amador,005,37829,8468,8407,650,9057,84
2022-03-08,Butte,007,227075,32792,32759,6595,39354,380
2022-03-08,Calaveras,009,45235,7223,7245,351,7596,117
2022-03-08,Colusa,011,21464,3431,3439,1070,4509,21
2022-03-08,Contra Costa,013,1133247,186918,186396,13136,199532,1256
2022-03-08,Del Norte,015,27424,5731,5763,190,5953,48
2022-03-08,El Dorado,017,186661,26552,26503,3196,29699,197
2022-03-08,Fresno,019,978130,230324,227808,23860,251668,2653
2022-03-08,Glenn,021,27897,4957,4944,1600,6544,43
2022-03-08,Humboldt,023,135768,16765,16837,2935,19772,137
2022-03-08,Imperial,025,180216,55218,54721,10827,65548,890
2022-03-08,Inyo,027,18085,4056,4056,480,4536,56
2022-03-08,Kern,029,883053,191112,190208,46125,236333,2154
2022-03-08,Kings,031,150075,51213,51089,3601,54690,434
2022-03-08,Lake,033,64148,10607,10571,891,11462,130
2022-03-08,Lassen,035,31185,8948,8897,884,9781,62
2022-03-08,Los Angeles,037,10098052,2694591,2677166,124133,2801299,30803
2022-03-08,Madera,039,155013,37140,37185,6059,43244,354
2022-03-08,Marin,041,260295,33053,32943,2189,35132,272
2022-03-08,Mariposa,043,17540,2374,2371,201,2572,6
2022-03-08,Mendocino,045,87422,12974,12950,3001,15951,117
2022-03-08,Merced,047,269075,61834,61767,8591,70358,791
2022-03-08,Modoc,049,8938,731,729,250,979,7
2022-03-08,Mono,051,14174,2961,2961,120,3081,5
2022-03-08,Monterey,053,433212,78944,78247,13552,91799,711
2022-03-08,Napa,055,140530,25576,25528,951,26479,137
2022-03-08,Nevada,057,99092,15854,15939,1202,17141,122
2022-03-08,Orange,059,3164182,543783,542164,41198,583362,6692
2022-03-08,Placer,061,380077,62354,62221,7375,69596,594
2022-03-08,Plumas,063,18699,2956,2703,366,3069,13
2022-03-08,Riverside,065,2383286,588852,587686,27980,615666,6294
2022-03-08,Sacramento,067,1510023,279159,274276,27146,301422,2872
2022-03-08,San Benito,069,59416,12852,12855,511,13366,94
2022-03-08,San Bernardino,071,2135413,564137,558512,24762,583274,6715
2022-03-08,San Diego,073,3302833,748301,743604,51866,795470,5077
2022-03-08,San Francisco,075,870044,122468,123675,8204,131879,807
2022-03-08,San Joaquin,077,732212,165526,165381,9649,175030,2104
2022-03-08,San Luis Obispo,079,281455,52086,51900,3751,55651,451
2022-03-08,San Mateo,081,765935,120376,119103,6930,126033,638
2022-03-08,Santa Barbara,083,443738,85235,85363,4750,90113,659
2022-03-08,Santa Clara,085,1922200,307961,308528,12287,320815,2206
2022-03-08,Santa Cruz,087,273765,47188,46875,2111,48986,254
2022-03-08,Shasta,089,179085,30384,30372,6117,36489,493
2022-03-08,Sierra,091,2930,271,273,48,321,4
2022-03-08,Siskiyou,093,43540,4418,4404,2743,7147,74
2022-03-08,Solano,095,438530,80839,80924,5510,86434,434
2022-03-08,Sonoma,097,501317,82771,82571,2574,85145,473
2022-03-08,Stanislaus,099,539301,116865,117782,17292,135074,1541
2022-03-08,Sutter,101,95872,20385,20403,2074,22477,217
2022-03-08,Tehama,103,63373,12002,11972,2616,14588,158
2022-03-08,Trinity,105,12862,1180,1174,295,1469,20
2022-03-08,Tulare,107,460477,106246,103893,28529,132422,1334
2022-03-08,Tuolumne,109,53932,12567,12427,562,12989,180
2022-03-08,Ventura,111,848112,172244,171806,9252,181058,1447
2022-03-08,Yolo,113,214977,36483,35946,3155,39101,306
2022-03-08,Yuba,115,75493,15740,15705,1194,16899,115
2022-03-07,Alameda,001,1643700,253284,252578,13740,266318,1766
2022-03-07,Alpine,003,1148,122,125,1,126,0
2022-03-07,Amador,005,37829,8465,8368,650,9018,84
2022-03-07,Butte,007,227075,32777,32734,6592,39326,378
2022-03-07,Calaveras,009,45235,7219,7242,351,7593,116
2022-03-07,Colusa,011,21464,3429,3437,1070,4507,21
2022-03-07,Contra Costa,013,1133247,186820,186087,13112,199199,1256
2022-03-07,Del Norte,015,27424,5727,5758,190,5948,48
2022-03-07,El Dorado,017,186661,26545,26487,3195,29682,196
2022-03-07,Fresno,019,978130,230235,227670,23838,251508,2653
2022-03-07,Glenn,021,27897,4951,4939,1600,6539,43
2022-03-07,Humboldt,023,135768,16752,16829,2930,19759,137
2022-03-07,Imperial,025,180216,55195,54712,10822,65534,890
2022-03-07,Inyo,027,18085,4054,4054,480,4534,56
2022-03-07,Kern,029,883053,191052,190163,46100,236263,2152
2022-03-07,Kings,031,150075,51183,51065,3595,54660,433
2022-03-07,Lake,033,64148,10597,10562,890,11452,130
2022-03-07,Lassen,035,31185,8947,8896,884,9780,62
2022-03-07,Los Angeles,037,10098052,2693775,2675497,124092,2799589,30759
2022-03-07,Madera,039,155013,37130,37164,6056,43220,354
2022-03-07,Marin,041,260295,33015,32919,2186,35105,272
2022-03-07,Mariposa,043,17540,2373,2369,201,2570,6
2022-03-07,Mendocino,045,87422,12966,12940,3000,15940,117
2022-03-07,Merced,047,269075,61795,61751,8584,70335,791
2022-03-07,Modoc,049,8938,731,729,250,979,7
2022-03-07,Mono,051,14174,2961,2960,120,3080,5
2022-03-07,Monterey,053,433212,78909,78161,13503,91664,706
2022-03-07,Napa,055,140530,25546,25500,951,26451,136
2022-03-07,Nevada,057,99092,15847,15935,1196,17131,122
2022-03-07,Orange,059,3164182,543608,542028,41172,583200,6687
2022-03-07,Placer,061,380077,62325,62215,7373,69588,591
2022-03-07,Plumas,063,18699,2956,2702,366,3068,13
2022-03-07,Riverside,065,2383286,588720,587537,27972,615509,6279
2022-03-07,Sacramento,067,1510023,279056,274079,27133,301212,2866
2022-03-07,San Benito,069,59416,12846,12843,511,13354,94
2022-03-07,San Bernardino,071,2135413,564029,558265,24750,583015,6703
2022-03-07,San Diego,073,3302833,747955,742287,51823,794110,5068
2022-03-07,San Francisco,075,870044,122366,123655,8198,131853,807
2022-03-07,San Joaquin,077,732212,165473,165343,9641,174984,2091
2022-03-07,San Luis Obispo,079,281455,52045,51874,3746,55620,448
2022-03-07,San Mateo,081,765935,120301,119035,6923,125958,630
2022-03-07,Santa Barbara,083,443738,85197,85345,4749,90094,659
2022-03-07,Santa Clara,085,1922200,307774,308517,12281,320798,2202
2022-03-07,Santa Cruz,087,273765,47137,46823,2110,48933,254
2022-03-07,Shasta,089,179085,30371,30352,6114,36466,493
2022-03-07,Sierra,091,2930,271,273,48,321,4
2022-03-07,Siskiyou,093,43540,4414,4398,2742,7140,74
2022-03-07,Solano,095,438530,80782,80886,5508,86394,435
2022-03-07,Sonoma,097,501317,82728,82530,2573,85103,473
2022-03-07,Stanislaus,099,539301,116828,117713,17284,134997,1537
2022-03-07,Sutter,101,95872,20374,20400,2073,22473,217
2022-03-07,Tehama,103,63373,11996,11966,2613,14579,158
2022-03-07,Trinity,105,12862,1178,1173,295,1468,20
2022-03-07,Tulare,107,460477,106209,103834,28517,132351,1316
2022-03-07,Tuolumne,109,53932,12559,12408,561,12969,179
2022-03-07,Ventura,111,848112,172193,171886,9250,181136,1436
2022-03-07,Yolo,113,214977,36459,35934,3149,39083,306
2022-03-07,Yuba,115,75493,15734,15701,1193,16894,115
2022-03-06,Alameda,001,1643700,253099,252460,13731,266191,1766
2022-03-06,Alpine,003,1148,122,125,1,126,0
2022-03-06,Amador,005,37829,8462,8367,648,9015,84
2022-03-06,Butte,007,227075,32768,32714,6588,39302,376
2022-03-06,Calaveras,009,45235,7217,7236,350,7586,116
2022-03-06,Colusa,011,21464,3429,3435,1069,4504,21
2022-03-06,Contra Costa,013,1133247,186704,185974,13086,199060,1256
2022-03-06,Del Norte,015,27424,5712,5744,188,5932,48
2022-03-06,El Dorado,017,186661,26536,26478,3193,29671,196
2022-03-06,Fresno,019,978130,230091,227514,23827,251341,2653
2022-03-06,Glenn,021,27897,4946,4939,1600,6539,43
2022-03-06,Humboldt,023,135768,16740,16813,2927,19740,137
2022-03-06,Imperial,025,180216,55179,54719,10810,65529,890
2022-03-06,Inyo,027,18085,4051,4053,480,4533,56
2022-03-06,Kern,029,883053,190996,190088,46078,236166,2152
2022-03-06,Kings,031,150075,51114,51050,3592,54642,432
2022-03-06,Lake,033,64148,10583,10539,889,11428,130
2022-03-06,Lassen,035,31185,8934,8887,883,9770,62
2022-03-06,Los Angeles,037,10098052,2692844,2675456,124037,2799493,30759
2022-03-06,Madera,039,155013,37102,37135,6048,43183,354
2022-03-06,Marin,041,260295,32989,32879,2185,35064,272
2022-03-06,Mariposa,043,17540,2372,2365,200,2565,6
2022-03-06,Mendocino,045,87422,12954,12923,2996,15919,116
2022-03-06,Merced,047,269075,61763,61722,8567,70289,791
2022-03-06,Modoc,049,8938,731,729,250,979,7
2022-03-06,Mono,051,14174,2961,2959,120,3079,5
2022-03-06,Monterey,053,433212,78862,78154,13471,91625,706
2022-03-06,Napa,055,140530,25511,25457,949,26406,136
2022-03-06,Nevada,057,99092,15836,15924,1195,17119,122
2022-03-06,Orange,059,3164182,543449,541903,41124,583027,6688
2022-03-06,Placer,061,380077,62293,62185,7369,69554,591
2022-03-06,Plumas,063,18699,2951,2704,366,3070,13
2022-03-06,Riverside,065,2383286,588558,587388,27950,615338,6279
2022-03-06,Sacramento,067,1510023,278919,273935,27109,301044,2869
2022-03-06,San Benito,069,59416,12835,12835,510,13345,94
2022-03-06,San Bernardino,071,2135413,563902,558139,24736,582875,6701
2022-03-06,San Diego,073,3302833,747557,742287,51774,794061,5068
2022-03-06,San Francisco,075,870044,122242,123742,8195,131937,806
2022-03-06,San Joaquin,077,732212,165390,165252,9635,174887,2091
2022-03-06,San Luis Obispo,079,281455,52007,51828,3743,55571,448
2022-03-06,San Mateo,081,765935,120218,118916,6914,125830,630
2022-03-06,Santa Barbara,083,443738,85157,85317,4744,90061,659
2022-03-06,Santa Clara,085,1922200,307516,308250,12279,320529,2201
2022-03-06,Santa Cruz,087,273765,47084,46755,2109,48864,254
2022-03-06,Shasta,089,179085,30346,30332,6097,36429,493
2022-03-06,Sierra,091,2930,271,273,48,321,4
2022-03-06,Siskiyou,093,43540,4410,4398,2740,7138,74
2022-03-06,Solano,095,438530,80726,80833,5502,86335,435
2022-03-06,Sonoma,097,501317,82689,82458,2568,85026,473
2022-03-06,Stanislaus,099,539301,116777,117680,17274,134954,1536
2022-03-06,Sutter,101,95872,20363,20390,2069,22459,217
2022-03-06,Tehama,103,63373,11988,11963,2613,14576,158
2022-03-06,Trinity,105,12862,1178,1172,294,1466,20
2022-03-06,Tulare,107,460477,106146,103794,28502,132296,1316
2022-03-06,Tuolumne,109,53932,12554,12379,559,12938,179
2022-03-06,Ventura,111,848112,172124,171819,9248,181067,1436
2022-03-06,Yolo,113,214977,36435,35882,3145,39027,306
2022-03-06,Yuba,115,75493,15729,15694,1192,16886,115
2022-03-05,Alameda,001,1643700,252984,251988,13726,265714,1760
2022-03-05,Alpine,003,1148,122,125,1,126,0
2022-03-05,Amador,005,37829,8459,8344,648,8992,83
2022-03-05,Butte,007,227075,32761,32663,6583,39246,372
2022-03-05,Calaveras,009,45235,7214,7236,350,7586,116
2022-03-05,Colusa,011,21464,3429,3433,1069,4502,21
2022-03-05,Contra Costa,013,1133247,186644,185734,13080,198814,1235
2022-03-05,Del Norte,015,27424,5709,5725,188,5913,48
2022-03-05,El Dorado,017,186661,26529,26446,3190,29636,193
2022-03-05,Fresno,019,978130,230039,227154,23825,250979,2640
2022-03-05,Glenn,021,27897,4945,4927,1600,6527,43
2022-03-05,Humboldt,023,135768,16733,16781,2925,19706,136
2022-03-05,Imperial,025,180216,55169,54650,10808,65458,880
2022-03-05,Inyo,027,18085,4050,4043,479,4522,56
2022-03-05,Kern,029,883053,190964,189817,46060,235877,2141
2022-03-05,Kings,031,150075,51107,50926,3590,54516,431
2022-03-05,Lake,033,64148,10575,10512,888,11400,130
2022-03-05,Lassen,035,31185,8925,8818,883,9701,62
2022-03-05,Los Angeles,037,10098052,2692491,2671564,123999,2795563,30608
2022-03-05,Madera,039,155013,37088,37100,6048,43148,354
2022-03-05,Marin,041,260295,32977,32829,2185,35014,272
2022-03-05,Mariposa,043,17540,2372,2363,200,2563,6
2022-03-05,Mendocino,045,87422,12951,12845,2995,15840,113
2022-03-05,Merced,047,269075,61753,61653,8567,70220,789
2022-03-05,Modoc,049,8938,731,729,250,979,7
2022-03-05,Mono,051,14174,2961,2961,120,3081,5
2022-03-05,Monterey,053,433212,78843,78028,13464,91492,704
2022-03-05,Napa,055,140530,25493,25405,949,26354,134
2022-03-05,Nevada,057,99092,15832,15907,1195,17102,122
2022-03-05,Orange,059,3164182,543325,541463,41113,582576,6638
2022-03-05,Placer,061,380077,62279,62117,7362,69479,591
2022-03-05,Plumas,063,18699,2950,2701,366,3067,13
2022-03-05,Riverside,065,2383286,588467,586785,27946,614731,6239
2022-03-05,Sacramento,067,1510023,278857,273487,27104,300591,2847
2022-03-05,San Benito,069,59416,12833,12820,510,13330,94
2022-03-05,San Bernardino,071,2135413,563847,557421,24730,582151,6641
2022-03-05,San Diego,073,3302833,747359,740747,51763,792510,5045
2022-03-05,San Francisco,075,870044,122178,123537,8190,131727,798
2022-03-05,San Joaquin,077,732212,165349,165085,9627,174712,2069
2022-03-05,San Luis Obispo,079,281455,52000,51739,3740,55479,446
2022-03-05,San Mateo,081,765935,120162,118646,6911,125557,621
2022-03-05,Santa Barbara,083,443738,85142,85249,4744,89993,655
2022-03-05,Santa Clara,085,1922200,307398,307689,12276,319965,2195
2022-03-05,Santa Cruz,087,273765,47064,46622,2109,48731,253
2022-03-05,Shasta,089,179085,30334,30282,6096,36378,492
2022-03-05,Sierra,091,2930,271,273,47,320,4
2022-03-05,Siskiyou,093,43540,4409,4389,2739,7128,74
2022-03-05,Solano,095,438530,80709,80690,5502,86192,435
2022-03-05,Sonoma,097,501317,82666,82313,2568,84881,473
2022-03-05,Stanislaus,099,539301,116752,117501,17272,134773,1531
2022-03-05,Sutter,101,95872,20356,20346,2069,22415,217
2022-03-05,Tehama,103,63373,11986,11939,2613,14552,158
2022-03-05,Trinity,105,12862,1178,1170,292,1462,20
2022-03-05,Tulare,107,460477,106133,103534,28492,132026,1305
2022-03-05,Tuolumne,109,53932,12550,12325,558,12883,178
2022-03-05,Ventura,111,848112,172082,171666,9246,180912,1436
2022-03-05,Yolo,113,214977,36421,35856,3145,39001,306
2022-03-05,Yuba,115,75493,15721,15666,1192,16858,115
2022-03-04,Alameda,001,1643700,252894,251988,13718,265706,1760
2022-03-04,Alpine,003,1148,122,125,1,126,0
2022-03-04,Amador,005,37829,8458,8344,648,8992,83
2022-03-04,Butte,007,227075,32755,32663,6577,39240,372
2022-03-04,Calaveras,009,45235,7213,7236,350,7586,116
2022-03-04,Colusa,011,21464,3427,3433,1069,4502,21
2022-03-04,Contra Costa,013,1133247,186577,185734,13078,198812,1235
2022-03-04,Del Norte,015,27424,5699,5725,188,5913,48
2022-03-04,El Dorado,017,186661,26525,26446,3190,29636,193
2022-03-04,Fresno,019,978130,229975,227154,23819,250973,2640
2022-03-04,Glenn,021,27897,4944,4927,1600,6527,43
2022-03-04,Humboldt,023,135768,16730,16781,2925,19706,136
2022-03-04,Imperial,025,180216,55162,54650,10804,65454,880
2022-03-04,Inyo,027,18085,4050,4043,479,4522,56
2022-03-04,Kern,029,883053,190923,189817,46048,235865,2141
2022-03-04,Kings,031,150075,51094,50926,3590,54516,431
2022-03-04,Lake,033,64148,10574,10512,888,11400,130
2022-03-04,Lassen,035,31185,8923,8818,883,9701,62
2022-03-04,Los Angeles,037,10098052,2691998,2671564,123969,2795533,30608
2022-03-04,Madera,039,155013,37078,37100,6048,43148,354
2022-03-04,Marin,041,260295,32955,32829,2183,35012,272
2022-03-04,Mariposa,043,17540,2367,2363,200,2563,6
2022-03-04,Mendocino,045,87422,12945,12845,2995,15840,113
2022-03-04,Merced,047,269075,61741,61653,8565,70218,789
2022-03-04,Modoc,049,8938,731,729,250,979,7
2022-03-04,Mono,051,14174,2961,2961,120,3081,5
2022-03-04,Monterey,053,433212,78823,78028,13457,91485,704
2022-03-04,Napa,055,140530,25478,25405,948,26353,134
2022-03-04,Nevada,057,99092,15827,15907,1195,17102,122
2022-03-04,Orange,059,3164182,543206,541463,41094,582557,6638
2022-03-04,Placer,061,380077,62268,62117,7359,69476,591
2022-03-04,Plumas,063,18699,2950,2701,365,3066,13
2022-03-04,Riverside,065,2383286,588379,586785,27945,614730,6239
2022-03-04,Sacramento,067,1510023,278787,273487,27100,300587,2847
2022-03-04,San Benito,069,59416,12829,12820,510,13330,94
2022-03-04,San Bernardino,071,2135413,563766,557421,24729,582150,6641
2022-03-04,San Diego,073,3302833,747120,740747,51746,792493,5045
2022-03-04,San Francisco,075,870044,122119,123537,8183,131720,798
2022-03-04,San Joaquin,077,732212,165318,165085,9626,174711,2069
2022-03-04,San Luis Obispo,079,281455,51992,51739,3739,55478,446
2022-03-04,San Mateo,081,765935,120104,118646,6909,125555,621
2022-03-04,Santa Barbara,083,443738,85120,85249,4744,89993,655
2022-03-04,Santa Clara,085,1922200,307250,307689,12273,319962,2195
2022-03-04,Santa Cruz,087,273765,47042,46622,2109,48731,253
2022-03-04,Shasta,089,179085,30326,30282,6093,36375,492
2022-03-04,Sierra,091,2930,271,273,47,320,4
2022-03-04,Siskiyou,093,43540,4407,4389,2735,7124,74
2022-03-04,Solano,095,438530,80676,80690,5499,86189,435
2022-03-04,Sonoma,097,501317,82637,82313,2567,84880,473
2022-03-04,Stanislaus,099,539301,116733,117501,17270,134771,1531
2022-03-04,Sutter,101,95872,20352,20346,2069,22415,217
2022-03-04,Tehama,103,63373,11983,11939,2613,14552,158
2022-03-04,Trinity,105,12862,1178,1170,292,1462,20
2022-03-04,Tulare,107,460477,106115,103534,28487,132021,1305
2022-03-04,Tuolumne,109,53932,12545,12325,558,12883,178
2022-03-04,Ventura,111,848112,172036,171666,9243,180909,1436
2022-03-04,Yolo,113,214977,36404,35856,3145,39001,306
2022-03-04,Yuba,115,75493,15716,15666,1191,16857,115
2022-03-03,Alameda,001,1643700,252774,251988,13706,265694,1760
2022-03-03,Alpine,003,1148,122,125,1,126,0
2022-03-03,Amador,005,37829,8457,8344,648,8992,83
2022-03-03,Butte,007,227075,32738,32663,6571,39234,372
2022-03-03,Calaveras,009,45235,7200,7236,350,7586,116
2022-03-03,Colusa,011,21464,3427,3433,1069,4502,21
2022-03-03,Contra Costa,013,1133247,186503,185734,13065,198799,1235
2022-03-03,Del Norte,015,27424,5692,5725,188,5913,48
2022-03-03,El Dorado,017,186661,26508,26446,3189,29635,193
2022-03-03,Fresno,019,978130,229845,227154,23810,250964,2640
2022-03-03,Glenn,021,27897,4942,4927,1599,6526,43
2022-03-03,Humboldt,023,135768,16716,16781,2924,19705,136
2022-03-03,Imperial,025,180216,55146,54650,10802,65452,880
2022-03-03,Inyo,027,18085,4049,4043,479,4522,56
2022-03-03,Kern,029,883053,190855,189817,46029,235846,2141
2022-03-03,Kings,031,150075,51071,50926,3587,54513,431
2022-03-03,Lake,033,64148,10568,10512,886,11398,130
2022-03-03,Lassen,035,31185,8915,8818,883,9701,62
2022-03-03,Los Angeles,037,10098052,2691277,2671564,123928,2795492,30608
2022-03-03,Madera,039,155013,37061,37100,6043,43143,354
2022-03-03,Marin,041,260295,32929,32829,2183,35012,272
2022-03-03,Mariposa,043,17540,2366,2363,200,2563,6
2022-03-03,Mendocino,045,87422,12934,12845,2992,15837,113
2022-03-03,Merced,047,269075,61724,61653,8559,70212,789
2022-03-03,Modoc,049,8938,731,729,250,979,7
2022-03-03,Mono,051,14174,2960,2961,120,3081,5
2022-03-03,Monterey,053,433212,78795,78028,13439,91467,704
2022-03-03,Napa,055,140530,25455,25405,947,26352,134
2022-03-03,Nevada,057,99092,15822,15907,1190,17097,122
2022-03-03,Orange,059,3164182,543029,541463,41068,582531,6638
2022-03-03,Placer,061,380077,62246,62117,7355,69472,591
2022-03-03,Plumas,063,18699,2949,2701,365,3066,13
2022-03-03,Riverside,065,2383286,588247,586785,27940,614725,6239
2022-03-03,Sacramento,067,1510023,278675,273487,27082,300569,2847
2022-03-03,San Benito,069,59416,12826,12820,510,13330,94
2022-03-03,San Bernardino,071,2135413,563657,557421,24723,582144,6641
2022-03-03,San Diego,073,3302833,746772,740747,51728,792475,5045
2022-03-03,San Francisco,075,870044,122046,123537,8172,131709,798
2022-03-03,San Joaquin,077,732212,165245,165085,9623,174708,2069
2022-03-03,San Luis Obispo,079,281455,51937,51739,3731,55470,446
2022-03-03,San Mateo,081,765935,120029,118646,6899,125545,621
2022-03-03,Santa Barbara,083,443738,85100,85249,4735,89984,655
2022-03-03,Santa Clara,085,1922200,307067,307689,12259,319948,2195
2022-03-03,Santa Cruz,087,273765,46994,46622,2107,48729,253
2022-03-03,Shasta,089,179085,30309,30282,6089,36371,492
2022-03-03,Sierra,091,2930,271,273,47,320,4
2022-03-03,Siskiyou,093,43540,4404,4389,2735,7124,74
2022-03-03,Solano,095,438530,80627,80690,5497,86187,435
2022-03-03,Sonoma,097,501317,82589,82313,2562,84875,473
2022-03-03,Stanislaus,099,539301,116700,117501,17263,134764,1531
2022-03-03,Sutter,101,95872,20344,20346,2069,22415,217
2022-03-03,Tehama,103,63373,11979,11939,2613,14552,158
2022-03-03,Trinity,105,12862,1177,1170,292,1462,20
2022-03-03,Tulare,107,460477,106069,103534,28477,132011,1305
2022-03-03,Tuolumne,109,53932,12535,12325,558,12883,178
2022-03-03,Ventura,111,848112,171983,171666,9241,180907,1436
2022-03-03,Yolo,113,214977,36381,35856,3138,38994,306
2022-03-03,Yuba,115,75493,15710,15666,1186,16852,115
2022-03-02,Alameda,001,1643700,252594,251886,13690,265576,1759
2022-03-02,Alpine,003,1148,122,125,1,126,0
2022-03-02,Amador,005,37829,8445,8341,648,8989,83
2022-03-02,Butte,007,227075,32726,32636,6566,39202,372
2022-03-02,Calaveras,009,45235,7199,7225,350,7575,116
2022-03-02,Colusa,011,21464,3424,3428,1069,4497,21
2022-03-02,Contra Costa,013,1133247,186411,185589,13048,198637,1236
2022-03-02,Del Norte,015,27424,5685,5708,186,5894,47
2022-03-02,El Dorado,017,186661,26494,26433,3186,29619,192
2022-03-02,Fresno,019,978130,229712,226932,23799,250731,2629
2022-03-02,Glenn,021,27897,4942,4922,1598,6520,43
2022-03-02,Humboldt,023,135768,16706,16747,2917,19664,135
2022-03-02,Imperial,025,180216,55119,54629,10797,65426,878
2022-03-02,Inyo,027,18085,4047,4041,478,4519,56
2022-03-02,Kern,029,883053,190789,189656,46009,235665,2136
2022-03-02,Kings,031,150075,51045,50819,3584,54403,431
2022-03-02,Lake,033,64148,10554,10495,884,11379,130
2022-03-02,Lassen,035,31185,8912,8811,882,9693,62
2022-03-02,Los Angeles,037,10098052,2690396,2670287,123881,2794168,30535
2022-03-02,Madera,039,155013,37044,37077,6042,43119,354
2022-03-02,Marin,041,260295,32912,32794,2182,34976,272
2022-03-02,Mariposa,043,17540,2366,2359,200,2559,6
2022-03-02,Mendocino,045,87422,12921,12832,2987,15819,112
2022-03-02,Merced,047,269075,61697,61606,8549,70155,785
2022-03-02,Modoc,049,8938,731,729,250,979,7
2022-03-02,Mono,051,14174,2960,2961,120,3081,5
2022-03-02,Monterey,053,433212,78759,77963,13416,91379,703
2022-03-02,Napa,055,140530,25404,25382,945,26327,134
2022-03-02,Nevada,057,99092,15811,15920,1189,17109,122
2022-03-02,Orange,059,3164182,542824,541230,41041,582271,6623
2022-03-02,Placer,061,380077,62224,62066,7352,69418,589
2022-03-02,Plumas,063,18699,2949,2700,364,3064,13
2022-03-02,Riverside,065,2383286,588095,586513,27929,614442,6229
2022-03-02,Sacramento,067,1510023,278559,273291,27071,300362,2837
2022-03-02,San Benito,069,59416,12815,12814,510,13324,94
2022-03-02,San Bernardino,071,2135413,563548,557082,24717,581799,6619
2022-03-02,San Diego,073,3302833,746405,739803,51679,791482,5034
2022-03-02,San Francisco,075,870044,121953,123442,8170,131612,792
2022-03-02,San Joaquin,077,732212,165183,164968,9618,174586,2063
2022-03-02,San Luis Obispo,079,281455,51899,51686,3726,55412,446
2022-03-02,San Mateo,081,765935,119942,118518,6883,125401,617
2022-03-02,Santa Barbara,083,443738,85075,85183,4734,89917,655
2022-03-02,Santa Clara,085,1922200,306848,307354,12245,319599,2184
2022-03-02,Santa Cruz,087,273765,46925,46534,2106,48640,253
2022-03-02,Shasta,089,179085,30285,30253,6079,36332,490
2022-03-02,Sierra,091,2930,271,273,47,320,4
2022-03-02,Siskiyou,093,43540,4402,4384,2732,7116,74
2022-03-02,Solano,095,438530,80561,80626,5494,86120,433
2022-03-02,Sonoma,097,501317,82543,82208,2558,84766,473
2022-03-02,Stanislaus,099,539301,116664,117411,17235,134646,1519
2022-03-02,Sutter,101,95872,20322,20317,2051,22368,216
2022-03-02,Tehama,103,63373,11974,11930,2612,14542,158
2022-03-02,Trinity,105,12862,1175,1160,292,1452,20
2022-03-02,Tulare,107,460477,106026,103451,28460,131911,1302
2022-03-02,Tuolumne,109,53932,12530,12297,558,12855,179
2022-03-02,Ventura,111,848112,171930,171770,9237,181007,1427
2022-03-02,Yolo,113,214977,36363,35799,3132,38931,305
2022-03-02,Yuba,115,75493,15697,15653,1181,16834,115
2022-03-01,Alameda,001,1643700,252429,251830,13679,265509,1749
2022-03-01,Alpine,003,1148,122,125,1,126,0
2022-03-01,Amador,005,37829,8397,8334,646,8980,83
2022-03-01,Butte,007,227075,32702,32575,6562,39137,372
2022-03-01,Calaveras,009,45235,7196,7223,349,7572,116
2022-03-01,Colusa,011,21464,3423,3423,1069,4492,21
2022-03-01,Contra Costa,013,1133247,186300,185378,13034,198412,1231
2022-03-01,Del Norte,015,27424,5682,5701,184,5885,45
2022-03-01,El Dorado,017,186661,26476,26413,3184,29597,192
2022-03-01,Fresno,019,978130,229570,226594,23786,250380,2628
2022-03-01,Glenn,021,27897,4941,4919,1596,6515,40
2022-03-01,Humboldt,023,135768,16685,16727,2910,19637,135
2022-03-01,Imperial,025,180216,55101,54570,10791,65361,875
2022-03-01,Inyo,027,18085,4043,4041,477,4518,56
2022-03-01,Kern,029,883053,190713,189365,45985,235350,2120
2022-03-01,Kings,031,150075,51023,50763,3580,54343,427
2022-03-01,Lake,033,64148,10542,10471,882,11353,128
2022-03-01,Lassen,035,31185,8908,8801,882,9683,61
2022-03-01,Los Angeles,037,10098052,2689449,2669489,123823,2793312,30486
2022-03-01,Madera,039,155013,37024,37046,6035,43081,354
2022-03-01,Marin,041,260295,32887,32764,2180,34944,272
2022-03-01,Mariposa,043,17540,2365,2357,199,2556,6
2022-03-01,Mendocino,045,87422,12909,12818,2985,15803,112
2022-03-01,Merced,047,269075,61669,61549,8534,70083,781
2022-03-01,Modoc,049,8938,731,729,250,979,7
2022-03-01,Mono,051,14174,2959,2960,120,3080,6
2022-03-01,Monterey,053,433212,78733,77911,13404,91315,696
2022-03-01,Napa,055,140530,25371,25344,945,26289,134
2022-03-01,Nevada,057,99092,15803,15916,1186,17102,121
2022-03-01,Orange,059,3164182,542601,541054,41005,582059,6612
2022-03-01,Placer,061,380077,62197,62021,7346,69367,583
2022-03-01,Plumas,063,18699,2949,2694,364,3058,13
2022-03-01,Riverside,065,2383286,587928,586184,27928,614112,6198
2022-03-01,Sacramento,067,1510023,278428,273089,27057,300146,2831
2022-03-01,San Benito,069,59416,12811,12806,510,13316,94
2022-03-01,San Bernardino,071,2135413,563413,556743,24714,581457,6588
2022-03-01,San Diego,073,3302833,745965,739136,51638,790774,5029
2022-03-01,San Francisco,075,870044,121850,123481,8164,131645,792
2022-03-01,San Joaquin,077,732212,165116,164894,9613,174507,2062
2022-03-01,San Luis Obispo,079,281455,51863,51592,3722,55314,445
2022-03-01,San Mateo,081,765935,119866,118358,6876,125234,613
2022-03-01,Santa Barbara,083,443738,85036,85134,4730,89864,654
2022-03-01,Santa Clara,085,1922200,306600,306978,12233,319211,2190
2022-03-01,Santa Cruz,087,273765,46875,46471,2103,48574,253
2022-03-01,Shasta,089,179085,30255,30227,6076,36303,489
2022-03-01,Sierra,091,2930,271,274,47,321,5
2022-03-01,Siskiyou,093,43540,4398,4384,2727,7111,74
2022-03-01,Solano,095,438530,80498,80556,5491,86047,434
2022-03-01,Sonoma,097,501317,82473,82103,2552,84655,477
2022-03-01,Stanislaus,099,539301,116611,117308,17210,134518,1521
2022-03-01,Sutter,101,95872,20308,20288,2047,22335,217
2022-03-01,Tehama,103,63373,11967,11923,2609,14532,158
2022-03-01,Trinity,105,12862,1174,1159,292,1451,20
2022-03-01,Tulare,107,460477,105945,103371,28440,131811,1302
2022-03-01,Tuolumne,109,53932,12523,12276,556,12832,175
2022-03-01,Ventura,111,848112,171861,171672,9230,180902,1427
2022-03-01,Yolo,113,214977,36338,35801,3126,38927,299
2022-03-01,Yuba,115,75493,15689,15637,1181,16818,116
2022-02-28,Alameda,001,1643700,252212,251714,13665,265379,1742
2022-02-28,Alpine,003,1148,122,125,1,126,0
2022-02-28,Amador,005,37829,8391,8308,645,8953,83
2022-02-28,Butte,007,227075,32678,32550,6557,39107,368
2022-02-28,Calaveras,009,45235,7193,7220,348,7568,110
2022-02-28,Colusa,011,21464,3420,3422,1067,4489,21
2022-02-28,Contra Costa,013,1133247,186194,185272,13014,198286,1231
2022-02-28,Del Norte,015,27424,5678,5699,183,5882,45
2022-02-28,El Dorado,017,186661,26468,26409,3179,29588,191
2022-02-28,Fresno,019,978130,229373,226519,23764,250283,2622
2022-02-28,Glenn,021,27897,4937,4918,1596,6514,40
2022-02-28,Humboldt,023,135768,16670,16717,2906,19623,135
2022-02-28,Imperial,025,180216,55076,54517,10786,65303,875
2022-02-28,Inyo,027,18085,4043,4041,476,4517,56
2022-02-28,Kern,029,883053,190619,189245,45954,235199,2115
2022-02-28,Kings,031,150075,50984,50741,3579,54320,427
2022-02-28,Lake,033,64148,10531,10468,878,11346,128
2022-02-28,Lassen,035,31185,8851,8794,882,9676,55
2022-02-28,Los Angeles,037,10098052,2688273,2666804,123727,2790531,30410
2022-02-28,Madera,039,155013,36997,37023,6019,43042,354
2022-02-28,Marin,041,260295,32861,32775,2180,34955,272
2022-02-28,Mariposa,043,17540,2362,2354,197,2551,6
2022-02-28,Mendocino,045,87422,12901,12800,2977,15777,112
2022-02-28,Merced,047,269075,61625,61519,8516,70035,781
2022-02-28,Modoc,049,8938,731,727,250,977,7
2022-02-28,Mono,051,14174,2959,2961,120,3081,5
2022-02-28,Monterey,053,433212,78666,77865,13381,91246,693
2022-02-28,Napa,055,140530,25347,25317,945,26262,129
2022-02-28,Nevada,057,99092,15797,15908,1180,17088,121
2022-02-28,Orange,059,3164182,542347,540839,40991,581830,6605
2022-02-28,Placer,061,380077,62165,61976,7340,69316,577
2022-02-28,Plumas,063,18699,2949,2691,363,3054,13
2022-02-28,Riverside,065,2383286,587730,585891,27895,613786,6179
2022-02-28,Sacramento,067,1510023,278292,273038,27031,300069,2825
2022-02-28,San Benito,069,59416,12807,12798,510,13308,94
2022-02-28,San Bernardino,071,2135413,563217,556540,24700,581240,6576
2022-02-28,San Diego,073,3302833,745566,737760,51608,789368,5018
2022-02-28,San Francisco,075,870044,121691,123402,8156,131558,792
2022-02-28,San Joaquin,077,732212,165032,164833,9604,174437,2060
2022-02-28,San Luis Obispo,079,281455,51804,51565,3714,55279,440
2022-02-28,San Mateo,081,765935,119764,118301,6870,125171,611
2022-02-28,Santa Barbara,083,443738,84993,85076,4725,89801,653
2022-02-28,Santa Clara,085,1922200,306324,306930,12211,319141,2180
2022-02-28,Santa Cruz,087,273765,46804,46447,2102,48549,253
2022-02-28,Shasta,089,179085,30229,30213,6072,36285,488
2022-02-28,Sierra,091,2930,271,273,47,320,4
2022-02-28,Siskiyou,093,43540,4395,4382,2721,7103,74
2022-02-28,Solano,095,438530,80433,80544,5480,86024,430
2022-02-28,Sonoma,097,501317,82409,82058,2549,84607,477
2022-02-28,Stanislaus,099,539301,116544,117231,17194,134425,1521
2022-02-28,Sutter,101,95872,20295,20285,2044,22329,214
2022-02-28,Tehama,103,63373,11954,11917,2608,14525,158
2022-02-28,Trinity,105,12862,1174,1160,292,1452,20
2022-02-28,Tulare,107,460477,105895,103304,28422,131726,1300
2022-02-28,Tuolumne,109,53932,12512,12247,555,12802,175
2022-02-28,Ventura,111,848112,171777,171614,9229,180843,1423
2022-02-28,Yolo,113,214977,36301,35754,3119,38873,299
2022-02-28,Yuba,115,75493,15675,15625,1180,16805,115
2022-02-27,Alameda,001,1643700,251933,251624,13656,265280,1744
2022-02-27,Alpine,003,1148,122,125,1,126,0
2022-02-27,Amador,005,37829,8387,8305,642,8947,83
2022-02-27,Butte,007,227075,32641,32551,6545,39096,368
2022-02-27,Calaveras,009,45235,7186,7214,348,7562,110
2022-02-27,Colusa,011,21464,3419,3422,1067,4489,21
2022-02-27,Contra Costa,013,1133247,186066,185185,12994,198179,1230
2022-02-27,Del Norte,015,27424,5660,5691,181,5872,45
2022-02-27,El Dorado,017,186661,26449,26410,3177,29587,191
2022-02-27,Fresno,019,978130,229173,226397,23737,250134,2621
2022-02-27,Glenn,021,27897,4935,4915,1596,6511,40
2022-02-27,Humboldt,023,135768,16648,16713,2899,19612,135
2022-02-27,Imperial,025,180216,55027,54509,10770,65279,875
2022-02-27,Inyo,027,18085,4042,4041,472,4513,56
2022-02-27,Kern,029,883053,190498,189219,45914,235133,2115
2022-02-27,Kings,031,150075,50955,50733,3577,54310,428
2022-02-27,Lake,033,64148,10512,10463,878,11341,128
2022-02-27,Lassen,035,31185,8843,8786,882,9668,55
2022-02-27,Los Angeles,037,10098052,2686975,2666789,123643,2790432,30410
2022-02-27,Madera,039,155013,36971,37009,6011,43020,354
2022-02-27,Marin,041,260295,32823,32756,2178,34934,272
2022-02-27,Mariposa,043,17540,2359,2352,197,2549,6
2022-02-27,Mendocino,045,87422,12882,12798,2964,15762,112
2022-02-27,Merced,047,269075,61574,61491,8499,69990,779
2022-02-27,Modoc,049,8938,730,727,250,977,7
2022-02-27,Mono,051,14174,2958,2960,120,3080,5
2022-02-27,Monterey,053,433212,78606,77851,13356,91207,693
2022-02-27,Napa,055,140530,25308,25316,945,26261,129
2022-02-27,Nevada,057,99092,15789,15900,1176,17076,121
2022-02-27,Orange,059,3164182,542100,540659,40961,581620,6605
2022-02-27,Placer,061,380077,62123,61965,7336,69301,577
2022-02-27,Plumas,063,18699,2946,2691,363,3054,13
2022-02-27,Riverside,065,2383286,587490,585833,27869,613702,6179
2022-02-27,Sacramento,067,1510023,278107,272927,26999,299926,2822
2022-02-27,San Benito,069,59416,12800,12798,510,13308,94
2022-02-27,San Bernardino,071,2135413,563030,556457,24690,581147,6572
2022-02-27,San Diego,073,3302833,745080,737760,51566,789326,5018
2022-02-27,San Francisco,075,870044,121569,123327,8145,131472,791
2022-02-27,San Joaquin,077,732212,164925,164814,9600,174414,2060
2022-02-27,San Luis Obispo,079,281455,51712,51564,3707,55271,439
2022-02-27,San Mateo,081,765935,119649,118244,6865,125109,611
2022-02-27,Santa Barbara,083,443738,84953,85050,4721,89771,653
2022-02-27,Santa Clara,085,1922200,306033,306756,12181,318937,2180
2022-02-27,Santa Cruz,087,273765,46743,46411,2101,48512,253
2022-02-27,Shasta,089,179085,30197,30206,6066,36272,488
2022-02-27,Sierra,091,2930,271,273,47,320,4
2022-02-27,Siskiyou,093,43540,4390,4378,2708,7086,74
2022-02-27,Solano,095,438530,80357,80515,5469,85984,430
2022-02-27,Sonoma,097,501317,82327,82041,2543,84584,476
2022-02-27,Stanislaus,099,539301,116475,117200,17176,134376,1522
2022-02-27,Sutter,101,95872,20278,20280,2038,22318,214
2022-02-27,Tehama,103,63373,11942,11915,2607,14522,158
2022-02-27,Trinity,105,12862,1173,1158,292,1450,20
2022-02-27,Tulare,107,460477,105821,103270,28369,131639,1300
2022-02-27,Tuolumne,109,53932,12498,12243,554,12797,175
2022-02-27,Ventura,111,848112,171701,171660,9227,180887,1423
2022-02-27,Yolo,113,214977,36273,35744,3114,38858,299
2022-02-27,Yuba,115,75493,15664,15619,1178,16797,113
2022-02-26,Alameda,001,1643700,251824,250867,13651,264518,1716
2022-02-26,Alpine,003,1148,122,125,1,126,0
2022-02-26,Amador,005,37829,8384,8282,641,8923,83
2022-02-26,Butte,007,227075,32627,32466,6543,39009,368
2022-02-26,Calaveras,009,45235,7185,7192,348,7540,110
2022-02-26,Colusa,011,21464,3419,3414,1067,4481,21
2022-02-26,Contra Costa,013,1133247,185996,184686,12975,197661,1209
2022-02-26,Del Norte,015,27424,5655,5639,181,5820,45
2022-02-26,El Dorado,017,186661,26438,26355,3173,29528,191
2022-02-26,Fresno,019,978130,229083,225679,23737,249416,2597
2022-02-26,Glenn,021,27897,4933,4909,1595,6504,40
2022-02-26,Humboldt,023,135768,16623,16619,2898,19517,133
2022-02-26,Imperial,025,180216,55001,54367,10768,65135,871
2022-02-26,Inyo,027,18085,4041,4034,467,4501,56
2022-02-26,Kern,029,883053,190449,188584,45895,234479,2106
2022-02-26,Kings,031,150075,50942,50579,3577,54156,423
2022-02-26,Lake,033,64148,10506,10383,878,11261,128
2022-02-26,Lassen,035,31185,8842,8761,882,9643,55
2022-02-26,Los Angeles,037,10098052,2686418,2660973,123602,2784575,30202
2022-02-26,Madera,039,155013,36957,36933,6009,42942,330
2022-02-26,Marin,041,260295,32808,32651,2176,34827,267
2022-02-26,Mariposa,043,17540,2358,2332,197,2529,6
2022-02-26,Mendocino,045,87422,12876,12762,2964,15726,111
2022-02-26,Merced,047,269075,61553,61348,8498,69846,775
2022-02-26,Modoc,049,8938,730,726,250,976,7
2022-02-26,Mono,051,14174,2958,2959,119,3078,5
2022-02-26,Monterey,053,433212,78575,77610,13350,90960,692
2022-02-26,Napa,055,140530,25293,25221,944,26165,130
2022-02-26,Nevada,057,99092,15785,15850,1174,17024,121
2022-02-26,Orange,059,3164182,541990,539992,40944,580936,6540
2022-02-26,Placer,061,380077,62104,61803,7333,69136,573
2022-02-26,Plumas,063,18699,2946,2673,363,3036,13
2022-02-26,Riverside,065,2383286,587372,584835,27860,612695,6143
2022-02-26,Sacramento,067,1510023,278013,272339,26986,299325,2793
2022-02-26,San Benito,069,59416,12796,12770,510,13280,92
2022-02-26,San Bernardino,071,2135413,562943,555668,24685,580353,6505
2022-02-26,San Diego,073,3302833,744847,736049,51546,787595,5002
2022-02-26,San Francisco,075,870044,121500,123079,8137,131216,769
2022-02-26,San Joaquin,077,732212,164890,164418,9599,174017,2048
2022-02-26,San Luis Obispo,079,281455,51698,51358,3704,55062,438
2022-02-26,San Mateo,081,765935,119595,117860,6864,124724,603
2022-02-26,Santa Barbara,083,443738,84922,84830,4721,89551,652
2022-02-26,Santa Clara,085,1922200,305881,305895,12178,318073,2166
2022-02-26,Santa Cruz,087,273765,46721,46186,2101,48287,251
2022-02-26,Shasta,089,179085,30189,30108,6060,36168,485
2022-02-26,Sierra,091,2930,271,270,47,317,1
2022-02-26,Siskiyou,093,43540,4390,4359,2706,7065,72
2022-02-26,Solano,095,438530,80323,80225,5466,85691,428
2022-02-26,Sonoma,097,501317,82291,81702,2541,84243,432
2022-02-26,Stanislaus,099,539301,116437,116896,17171,134067,1503
2022-02-26,Sutter,101,95872,20269,20230,2038,22268,214
2022-02-26,Tehama,103,63373,11936,11878,2605,14483,158
2022-02-26,Trinity,105,12862,1172,1156,292,1448,20
2022-02-26,Tulare,107,460477,105784,102983,28354,131337,1295
2022-02-26,Tuolumne,109,53932,12496,12169,554,12723,175
2022-02-26,Ventura,111,848112,171668,171292,9225,180517,1411
2022-02-26,Yolo,113,214977,36252,35615,3111,38726,296
2022-02-26,Yuba,115,75493,15653,15587,1178,16765,113
2022-02-25,Alameda,001,1643700,251699,250867,13641,264508,1716
2022-02-25,Alpine,003,1148,122,125,1,126,0
2022-02-25,Amador,005,37829,8373,8282,641,8923,83
2022-02-25,Butte,007,227075,32615,32466,6541,39007,368
2022-02-25,Calaveras,009,45235,7183,7192,348,7540,110
2022-02-25,Colusa,011,21464,3419,3414,1067,4481,21
2022-02-25,Contra Costa,013,1133247,185910,184686,12953,197639,1209
2022-02-25,Del Norte,015,27424,5645,5639,181,5820,45
2022-02-25,El Dorado,017,186661,26429,26355,3173,29528,191
2022-02-25,Fresno,019,978130,228986,225679,23731,249410,2597
2022-02-25,Glenn,021,27897,4931,4909,1595,6504,40
2022-02-25,Humboldt,023,135768,16612,16619,2898,19517,133
2022-02-25,Imperial,025,180216,54983,54367,10767,65134,871
2022-02-25,Inyo,027,18085,4040,4034,467,4501,56
2022-02-25,Kern,029,883053,190383,188584,45882,234466,2106
2022-02-25,Kings,031,150075,50928,50579,3576,54155,423
2022-02-25,Lake,033,64148,10491,10383,878,11261,128
2022-02-25,Lassen,035,31185,8839,8761,882,9643,55
2022-02-25,Los Angeles,037,10098052,2685829,2660973,123572,2784545,30202
2022-02-25,Madera,039,155013,36937,36933,6008,42941,330
2022-02-25,Marin,041,260295,32794,32651,2176,34827,267
2022-02-25,Mariposa,043,17540,2355,2332,197,2529,6
2022-02-25,Mendocino,045,87422,12873,12762,2964,15726,111
2022-02-25,Merced,047,269075,61521,61348,8493,69841,775
2022-02-25,Modoc,049,8938,730,726,250,976,7
2022-02-25,Mono,051,14174,2957,2959,119,3078,5
2022-02-25,Monterey,053,433212,78548,77610,13344,90954,692
2022-02-25,Napa,055,140530,25284,25221,944,26165,130
2022-02-25,Nevada,057,99092,15774,15850,1171,17021,121
2022-02-25,Orange,059,3164182,541857,539992,40921,580913,6540
2022-02-25,Placer,061,380077,62088,61803,7327,69130,573
2022-02-25,Plumas,063,18699,2944,2673,362,3035,13
2022-02-25,Riverside,065,2383286,587214,584835,27848,612683,6143
2022-02-25,Sacramento,067,1510023,277914,272339,26981,299320,2793
2022-02-25,San Benito,069,59416,12794,12770,510,13280,92
2022-02-25,San Bernardino,071,2135413,562837,555668,24678,580346,6505
2022-02-25,San Diego,073,3302833,744547,736049,51527,787576,5002
2022-02-25,San Francisco,075,870044,121420,123079,8134,131213,769
2022-02-25,San Joaquin,077,732212,164850,164418,9594,174012,2048
2022-02-25,San Luis Obispo,079,281455,51694,51358,3695,55053,438
2022-02-25,San Mateo,081,765935,119534,117860,6860,124720,603
2022-02-25,Santa Barbara,083,443738,84887,84830,4721,89551,652
2022-02-25,Santa Clara,085,1922200,305697,305895,12175,318070,2166
2022-02-25,Santa Cruz,087,273765,46687,46186,2099,48285,251
2022-02-25,Shasta,089,179085,30179,30108,6058,36166,485
2022-02-25,Sierra,091,2930,271,270,47,317,1
2022-02-25,Siskiyou,093,43540,4390,4359,2705,7064,72
2022-02-25,Solano,095,438530,80294,80225,5465,85690,428
2022-02-25,Sonoma,097,501317,82241,81702,2539,84241,432
2022-02-25,Stanislaus,099,539301,116410,116896,17167,134063,1503
2022-02-25,Sutter,101,95872,20260,20230,2038,22268,214
2022-02-25,Tehama,103,63373,11934,11878,2605,14483,158
2022-02-25,Trinity,105,12862,1172,1156,292,1448,20
2022-02-25,Tulare,107,460477,105748,102983,28331,131314,1295
2022-02-25,Tuolumne,109,53932,12494,12169,554,12723,175
2022-02-25,Ventura,111,848112,171617,171292,9225,180517,1411
2022-02-25,Yolo,113,214977,36237,35615,3111,38726,296
2022-02-25,Yuba,115,75493,15645,15587,1178,16765,113
2022-02-24,Alameda,001,1643700,251493,250867,13632,264499,1716
2022-02-24,Alpine,003,1148,122,125,1,126,0
2022-02-24,Amador,005,37829,8368,8282,640,8922,83
2022-02-24,Butte,007,227075,32594,32466,6536,39002,368
2022-02-24,Calaveras,009,45235,7180,7192,346,7538,110
2022-02-24,Colusa,011,21464,3418,3414,1066,4480,21
2022-02-24,Contra Costa,013,1133247,185782,184686,12945,197631,1209
2022-02-24,Del Norte,015,27424,5630,5639,180,5819,45
2022-02-24,El Dorado,017,186661,26415,26355,3173,29528,191
2022-02-24,Fresno,019,978130,228789,225679,23716,249395,2597
2022-02-24,Glenn,021,27897,4929,4909,1594,6503,40
2022-02-24,Humboldt,023,135768,16594,16619,2897,19516,133
2022-02-24,Imperial,025,180216,54944,54367,10757,65124,871
2022-02-24,Inyo,027,18085,4039,4034,466,4500,56
2022-02-24,Kern,029,883053,190240,188584,45848,234432,2106
2022-02-24,Kings,031,150075,50898,50579,3571,54150,423
2022-02-24,Lake,033,64148,10472,10383,878,11261,128
2022-02-24,Lassen,035,31185,8835,8761,881,9642,55
2022-02-24,Los Angeles,037,10098052,2684678,2660973,123516,2784489,30202
2022-02-24,Madera,039,155013,36910,36933,6006,42939,330
2022-02-24,Marin,041,260295,32774,32651,2175,34826,267
2022-02-24,Mariposa,043,17540,2349,2332,196,2528,6
2022-02-24,Mendocino,045,87422,12866,12762,2960,15722,111
2022-02-24,Merced,047,269075,61491,61348,8484,69832,775
2022-02-24,Modoc,049,8938,729,726,250,976,7
2022-02-24,Mono,051,14174,2956,2959,119,3078,5
2022-02-24,Monterey,053,433212,78495,77610,13335,90945,692
2022-02-24,Napa,055,140530,25243,25221,940,26161,130
2022-02-24,Nevada,057,99092,15760,15850,1171,17021,121
2022-02-24,Orange,059,3164182,541608,539992,40887,580879,6540
2022-02-24,Placer,061,380077,62050,61803,7325,69128,573
2022-02-24,Plumas,063,18699,2939,2673,361,3034,13
2022-02-24,Riverside,065,2383286,586961,584835,27822,612657,6143
2022-02-24,Sacramento,067,1510023,277740,272339,26963,299302,2793
2022-02-24,San Benito,069,59416,12783,12770,509,13279,92
2022-02-24,San Bernardino,071,2135413,562645,555668,24666,580334,6505
2022-02-24,San Diego,073,3302833,744110,736049,51485,787534,5002
2022-02-24,San Francisco,075,870044,121297,123079,8127,131206,769
2022-02-24,San Joaquin,077,732212,164718,164418,9589,174007,2048
2022-02-24,San Luis Obispo,079,281455,51648,51358,3693,55051,438
2022-02-24,San Mateo,081,765935,119442,117860,6853,124713,603
2022-02-24,Santa Barbara,083,443738,84823,84830,4720,89550,652
2022-02-24,Santa Clara,085,1922200,305457,305895,12161,318056,2166
2022-02-24,Santa Cruz,087,273765,46605,46186,2097,48283,251
2022-02-24,Shasta,089,179085,30160,30108,6052,36160,485
2022-02-24,Sierra,091,2930,271,270,47,317,1
2022-02-24,Siskiyou,093,43540,4387,4359,2701,7060,72
2022-02-24,Solano,095,438530,80215,80225,5462,85687,428
2022-02-24,Sonoma,097,501317,82187,81702,2534,84236,432
2022-02-24,Stanislaus,099,539301,116332,116896,17157,134053,1503
2022-02-24,Sutter,101,95872,20246,20230,2022,22252,214
2022-02-24,Tehama,103,63373,11928,11878,2604,14482,158
2022-02-24,Trinity,105,12862,1170,1156,292,1448,20
2022-02-24,Tulare,107,460477,105691,102983,28298,131281,1295
2022-02-24,Tuolumne,109,53932,12483,12169,552,12721,175
2022-02-24,Ventura,111,848112,171538,171292,9222,180514,1411
2022-02-24,Yolo,113,214977,36212,35615,3109,38724,296
2022-02-24,Yuba,115,75493,15632,15587,1178,16765,113
2022-02-23,Alameda,001,1643700,251265,247686,13614,261300,1713
2022-02-23,Alpine,003,1148,122,125,1,126,0
2022-02-23,Amador,005,37829,8351,8274,640,8914,79
2022-02-23,Butte,007,227075,32566,32417,6533,38950,367
2022-02-23,Calaveras,009,45235,7170,7182,345,7527,107
2022-02-23,Colusa,011,21464,3414,3411,1066,4477,21
2022-02-23,Contra Costa,013,1133247,185637,184013,12931,196944,1209
2022-02-23,Del Norte,015,27424,5618,5625,179,5804,45
2022-02-23,El Dorado,017,186661,26399,26317,3169,29486,189
2022-02-23,Fresno,019,978130,228599,225308,23694,249002,2596
2022-02-23,Glenn,021,27897,4925,4909,1592,6501,40
2022-02-23,Humboldt,023,135768,16578,16601,2894,19495,132
2022-02-23,Imperial,025,180216,54908,54292,10743,65035,871
2022-02-23,Inyo,027,18085,4038,4031,463,4494,54
2022-02-23,Kern,029,883053,190133,188432,45798,234230,2106
2022-02-23,Kings,031,150075,50865,50416,3569,53985,423
2022-02-23,Lake,033,64148,10454,10368,877,11245,126
2022-02-23,Lassen,035,31185,8819,8749,881,9630,55
2022-02-23,Los Angeles,037,10098052,2683312,2659569,123470,2783039,30167
2022-02-23,Madera,039,155013,36878,36876,5996,42872,330
2022-02-23,Marin,041,260295,32751,32625,2174,34799,267
2022-02-23,Mariposa,043,17540,2344,2325,195,2520,6
2022-02-23,Mendocino,045,87422,12858,12747,2956,15703,111
2022-02-23,Merced,047,269075,61462,61295,8479,69774,772
2022-02-23,Modoc,049,8938,729,723,249,972,7
2022-02-23,Mono,051,14174,2955,2960,119,3079,5
2022-02-23,Monterey,053,433212,78456,77472,13312,90784,691
2022-02-23,Napa,055,140530,25220,25185,935,26120,128
2022-02-23,Nevada,057,99092,15754,15825,1168,16993,121
2022-02-23,Orange,059,3164182,541301,539631,40864,580495,6520
2022-02-23,Placer,061,380077,62003,61758,7317,69075,573
2022-02-23,Plumas,063,18699,2935,2663,361,3024,13
2022-02-23,Riverside,065,2383286,586668,584381,27785,612166,6119
2022-02-23,Sacramento,067,1510023,277579,272057,26940,298997,2796
2022-02-23,San Benito,069,59416,12776,12756,508,13264,92
2022-02-23,San Bernardino,071,2135413,562481,555238,24648,579886,6479
2022-02-23,San Diego,073,3302833,743587,735406,51443,786849,4988
2022-02-23,San Francisco,075,870044,121170,122127,8125,130252,769
2022-02-23,San Joaquin,077,732212,164627,164257,9584,173841,2042
2022-02-23,San Luis Obispo,079,281455,51600,51264,3692,54956,434
2022-02-23,San Mateo,081,765935,119350,117585,6844,124429,603
2022-02-23,Santa Barbara,083,443738,84763,84760,4716,89476,651
2022-02-23,Santa Clara,085,1922200,305198,305484,12152,317636,2157
2022-02-23,Santa Cruz,087,273765,46536,46059,2096,48155,251
2022-02-23,Shasta,089,179085,30133,30066,6049,36115,481
2022-02-23,Sierra,091,2930,271,270,47,317,1
2022-02-23,Siskiyou,093,43540,4384,4356,2699,7055,71
2022-02-23,Solano,095,438530,80126,80103,5460,85563,427
2022-02-23,Sonoma,097,501317,82134,81594,2532,84126,432
2022-02-23,Stanislaus,099,539301,116257,116789,17148,133937,1482
2022-02-23,Sutter,101,95872,20229,20194,2018,22212,213
2022-02-23,Tehama,103,63373,11918,11863,2604,14467,154
2022-02-23,Trinity,105,12862,1170,1156,292,1448,20
2022-02-23,Tulare,107,460477,105624,102812,28270,131082,1290
2022-02-23,Tuolumne,109,53932,12473,12158,551,12709,175
2022-02-23,Ventura,111,848112,171451,171163,9215,180378,1401
2022-02-23,Yolo,113,214977,36175,35590,3102,38692,296
2022-02-23,Yuba,115,75493,15629,15571,1176,16747,113
2022-02-22,Alameda,001,1643700,251027,247434,13599,261033,1706
2022-02-22,Alpine,003,1148,122,124,1,125,0
2022-02-22,Amador,005,37829,8341,8243,640,8883,79
2022-02-22,Butte,007,227075,32531,32359,6528,38887,366
2022-02-22,Calaveras,009,45235,7161,7178,345,7523,107
2022-02-22,Colusa,011,21464,3414,3402,1064,4466,21
2022-02-22,Contra Costa,013,1133247,185484,183812,12912,196724,1201
2022-02-22,Del Norte,015,27424,5610,5611,178,5789,45
2022-02-22,El Dorado,017,186661,26389,26289,3169,29458,189
2022-02-22,Fresno,019,978130,228368,225104,23664,248768,2592
2022-02-22,Glenn,021,27897,4924,4900,1591,6491,40
2022-02-22,Humboldt,023,135768,16557,16559,2890,19449,132
2022-02-22,Imperial,025,180216,54872,54227,10739,64966,864
2022-02-22,Inyo,027,18085,4037,4026,461,4487,54
2022-02-22,Kern,029,883053,189991,188237,45761,233998,2102
2022-02-22,Kings,031,150075,50802,50359,3566,53925,423
2022-02-22,Lake,033,64148,10443,10353,875,11228,126
2022-02-22,Lassen,035,31185,8815,8730,881,9611,55
2022-02-22,Los Angeles,037,10098052,2681849,2658230,123382,2781612,30129
2022-02-22,Madera,039,155013,36846,36833,5986,42819,330
2022-02-22,Marin,041,260295,32726,32591,2173,34764,267
2022-02-22,Mariposa,043,17540,2336,2322,195,2517,6
2022-02-22,Mendocino,045,87422,12844,12714,2946,15660,110
2022-02-22,Merced,047,269075,61402,61241,8472,69713,770
2022-02-22,Modoc,049,8938,726,720,249,969,6
2022-02-22,Mono,051,14174,2955,2961,119,3080,5
2022-02-22,Monterey,053,433212,78402,77359,13292,90651,690
2022-02-22,Napa,055,140530,25191,25151,934,26085,128
2022-02-22,Nevada,057,99092,15738,15815,1167,16982,121
2022-02-22,Orange,059,3164182,541013,539390,40831,580221,6502
2022-02-22,Placer,061,380077,61965,61709,7312,69021,572
2022-02-22,Plumas,063,18699,2929,2659,359,3018,13
2022-02-22,Riverside,065,2383286,586411,583969,27763,611732,6097
2022-02-22,Sacramento,067,1510023,277388,271789,26916,298705,2775
2022-02-22,San Benito,069,59416,12765,12742,507,13249,92
2022-02-22,San Bernardino,071,2135413,562283,554903,24629,579532,6451
2022-02-22,San Diego,073,3302833,743053,734536,51393,785929,4974
2022-02-22,San Francisco,075,870044,121041,121954,8121,130075,769
2022-02-22,San Joaquin,077,732212,164507,164111,9573,173684,2040
2022-02-22,San Luis Obispo,079,281455,51515,51193,3686,54879,431
2022-02-22,San Mateo,081,765935,119255,117418,6839,124257,603
2022-02-22,Santa Barbara,083,443738,84700,84701,4710,89411,650
2022-02-22,Santa Clara,085,1922200,304918,305045,12146,317191,2155
2022-02-22,Santa Cruz,087,273765,46471,45958,2096,48054,251
2022-02-22,Shasta,089,179085,30109,30024,6044,36068,479
2022-02-22,Sierra,091,2930,271,269,46,315,0
2022-02-22,Siskiyou,093,43540,4381,4350,2694,7044,70
2022-02-22,Solano,095,438530,80050,79968,5458,85426,425
2022-02-22,Sonoma,097,501317,82067,81412,2528,83940,431
2022-02-22,Stanislaus,099,539301,116176,116676,17130,133806,1475
2022-02-22,Sutter,101,95872,20213,20164,2015,22179,210
2022-02-22,Tehama,103,63373,11910,11852,2603,14455,152
2022-02-22,Trinity,105,12862,1170,1147,291,1438,20
2022-02-22,Tulare,107,460477,105513,102717,28234,130951,1287
2022-02-22,Tuolumne,109,53932,12453,12136,550,12686,175
2022-02-22,Ventura,111,848112,171366,171064,9209,180273,1401
2022-02-22,Yolo,113,214977,36138,35527,3096,38623,292
2022-02-22,Yuba,115,75493,15619,15550,1175,16725,110
2022-02-21,Alameda,001,1643700,250738,247434,13583,261017,1704
2022-02-21,Alpine,003,1148,122,124,1,125,0
2022-02-21,Amador,005,37829,8335,8246,640,8886,79
2022-02-21,Butte,007,227075,32489,32356,6505,38861,366
2022-02-21,Calaveras,009,45235,7153,7175,345,7520,107
2022-02-21,Colusa,011,21464,3412,3401,1062,4463,21
2022-02-21,Contra Costa,013,1133247,185258,183701,12898,196599,1201
2022-02-21,Del Norte,015,27424,5592,5601,177,5778,45
2022-02-21,El Dorado,017,186661,26363,26273,3164,29437,189
2022-02-21,Fresno,019,978130,228048,224923,23605,248528,2592
2022-02-21,Glenn,021,27897,4920,4897,1591,6488,40
2022-02-21,Humboldt,023,135768,16513,16548,2882,19430,132
2022-02-21,Imperial,025,180216,54816,54208,10722,64930,864
2022-02-21,Inyo,027,18085,4033,4023,461,4484,54
2022-02-21,Kern,029,883053,189797,188188,45708,233896,2102
2022-02-21,Kings,031,150075,50736,50188,3563,53751,422
2022-02-21,Lake,033,64148,10421,10334,873,11207,126
2022-02-21,Lassen,035,31185,8807,8705,876,9581,55
2022-02-21,Los Angeles,037,10098052,2680052,2656873,123283,2780156,30108
2022-02-21,Madera,039,155013,36806,36796,5965,42761,330
2022-02-21,Marin,041,260295,32702,32570,2173,34743,258
2022-02-21,Mariposa,043,17540,2333,2321,195,2516,6
2022-02-21,Mendocino,045,87422,12818,12706,2934,15640,110
2022-02-21,Merced,047,269075,61345,61209,8455,69664,770
2022-02-21,Modoc,049,8938,725,718,249,967,6
2022-02-21,Mono,051,14174,2954,2960,119,3079,5
2022-02-21,Monterey,053,433212,78308,77354,13250,90604,690
2022-02-21,Napa,055,140530,25150,25126,934,26060,128
2022-02-21,Nevada,057,99092,15726,15810,1164,16974,121
2022-02-21,Orange,059,3164182,540657,539068,40806,579874,6502
2022-02-21,Placer,061,380077,61911,61727,7308,69035,572
2022-02-21,Plumas,063,18699,2925,2657,354,3011,13
2022-02-21,Riverside,065,2383286,586039,583712,27714,611426,6097
2022-02-21,Sacramento,067,1510023,277129,271588,26883,298471,2769
2022-02-21,San Benito,069,59416,12752,12731,507,13238,92
2022-02-21,San Bernardino,071,2135413,562039,554662,24607,579269,6441
2022-02-21,San Diego,073,3302833,742422,732298,51322,783620,4974
2022-02-21,San Francisco,075,870044,120860,121865,8117,129982,769
2022-02-21,San Joaquin,077,732212,164364,164036,9562,173598,2040
2022-02-21,San Luis Obispo,079,281455,51423,51184,3679,54863,429
2022-02-21,San Mateo,081,765935,119164,117259,6831,124090,605
2022-02-21,Santa Barbara,083,443738,84624,84626,4702,89328,650
2022-02-21,Santa Clara,085,1922200,304581,304858,12140,316998,2158
2022-02-21,Santa Cruz,087,273765,46346,45941,2095,48036,251
2022-02-21,Shasta,089,179085,30062,30004,6036,36040,479
2022-02-21,Sierra,091,2930,271,269,46,315,0
2022-02-21,Siskiyou,093,43540,4369,4337,2689,7026,70
2022-02-21,Solano,095,438530,79957,79906,5452,85358,425
2022-02-21,Sonoma,097,501317,81954,81361,2522,83883,431
2022-02-21,Stanislaus,099,539301,116064,116597,17106,133703,1475
2022-02-21,Sutter,101,95872,20187,20152,2013,22165,210
2022-02-21,Tehama,103,63373,11897,11842,2602,14444,152
2022-02-21,Trinity,105,12862,1169,1147,291,1438,20
2022-02-21,Tulare,107,460477,105415,102614,28184,130798,1287
2022-02-21,Tuolumne,109,53932,12444,12126,547,12673,175
2022-02-21,Ventura,111,848112,171226,170939,9200,180139,1401
2022-02-21,Yolo,113,214977,36095,35518,3087,38605,292
2022-02-21,Yuba,115,75493,15599,15546,1166,16712,110
2022-02-20,Alameda,001,1643700,250513,246028,13573,259601,1700
2022-02-20,Alpine,003,1148,122,124,1,125,0
2022-02-20,Amador,005,37829,8324,8203,640,8843,79
2022-02-20,Butte,007,227075,32459,32173,6500,38673,364
2022-02-20,Calaveras,009,45235,7150,7136,344,7480,107
2022-02-20,Colusa,011,21464,3409,3389,1061,4450,21
2022-02-20,Contra Costa,013,1133247,185132,182797,12893,195690,1190
2022-02-20,Del Norte,015,27424,5577,5511,177,5688,45
2022-02-20,El Dorado,017,186661,26341,26101,3163,29264,189
2022-02-20,Fresno,019,978130,227856,223594,23592,247186,2544
2022-02-20,Glenn,021,27897,4917,4881,1591,6472,39
2022-02-20,Humboldt,023,135768,16501,16393,2878,19271,132
2022-02-20,Imperial,025,180216,54756,53967,10709,64676,862
2022-02-20,Inyo,027,18085,4032,4018,460,4478,52
2022-02-20,Kern,029,883053,189665,187158,45664,232822,2095
2022-02-20,Kings,031,150075,50708,49724,3559,53283,421
2022-02-20,Lake,033,64148,10388,10184,872,11056,126
2022-02-20,Lassen,035,31185,8795,8640,876,9516,55
2022-02-20,Los Angeles,037,10098052,2678728,2642878,123197,2766075,29842
2022-02-20,Madera,039,155013,36775,36526,5961,42487,330
2022-02-20,Marin,041,260295,32685,32441,2172,34613,258
2022-02-20,Mariposa,043,17540,2327,2310,193,2503,6
2022-02-20,Mendocino,045,87422,12808,12625,2931,15556,110
2022-02-20,Merced,047,269075,61317,60886,8453,69339,769
2022-02-20,Modoc,049,8938,724,714,249,963,6
2022-02-20,Mono,051,14174,2954,2956,119,3075,5
2022-02-20,Monterey,053,433212,78249,76765,13236,90001,682
2022-02-20,Napa,055,140530,25130,24970,932,25902,127
2022-02-20,Nevada,057,99092,15715,15715,1163,16878,121
2022-02-20,Orange,059,3164182,540337,538019,40771,578790,6416
2022-02-20,Placer,061,380077,61879,61417,7300,68717,560
2022-02-20,Plumas,063,18699,2921,2646,352,2998,13
2022-02-20,Riverside,065,2383286,585765,581788,27686,609474,6087
2022-02-20,Sacramento,067,1510023,276952,270080,26858,296938,2747
2022-02-20,San Benito,069,59416,12749,12665,507,13172,92
2022-02-20,San Bernardino,071,2135413,561832,553151,24589,577740,6400
2022-02-20,San Diego,073,3302833,741823,729549,51268,780817,4947
2022-02-20,San Francisco,075,870044,120720,121197,8107,129304,756
2022-02-20,San Joaquin,077,732212,164241,163083,9551,172634,2033
2022-02-20,San Luis Obispo,079,281455,51392,50823,3675,54498,424
2022-02-20,San Mateo,081,765935,119092,116648,6823,123471,598
2022-02-20,Santa Barbara,083,443738,84579,83988,4700,88688,642
2022-02-20,Santa Clara,085,1922200,304302,303077,12132,315209,2138
2022-02-20,Santa Cruz,087,273765,46280,45532,2092,47624,250
2022-02-20,Shasta,089,179085,30030,29847,6029,35876,479
2022-02-20,Sierra,091,2930,271,269,46,315,0
2022-02-20,Siskiyou,093,43540,4363,4307,2688,6995,70
2022-02-20,Solano,095,438530,79882,78914,5448,84362,424
2022-02-20,Sonoma,097,501317,81878,80843,2519,83362,431
2022-02-20,Stanislaus,099,539301,115997,115976,17089,133065,1454
2022-02-20,Sutter,101,95872,20174,20060,2010,22070,210
2022-02-20,Tehama,103,63373,11885,11760,2599,14359,152
2022-02-20,Trinity,105,12862,1168,1130,291,1421,20
2022-02-20,Tulare,107,460477,105324,101996,28157,130153,1286
2022-02-20,Tuolumne,109,53932,12422,12036,546,12582,175
2022-02-20,Ventura,111,848112,171128,170331,9195,179526,1384
2022-02-20,Yolo,113,214977,36069,35363,3084,38447,293
2022-02-20,Yuba,115,75493,15583,15449,1165,16614,112
2022-02-19,Alameda,001,1643700,250341,246028,13571,259599,1700
2022-02-19,Alpine,003,1148,122,124,1,125,0
2022-02-19,Amador,005,37829,8320,8203,640,8843,79
2022-02-19,Butte,007,227075,32435,32173,6497,38670,364
2022-02-19,Calaveras,009,45235,7150,7136,344,7480,107
2022-02-19,Colusa,011,21464,3408,3389,1059,4448,21
2022-02-19,Contra Costa,013,1133247,185035,182797,12892,195689,1190
2022-02-19,Del Norte,015,27424,5567,5511,176,5687,45
2022-02-19,El Dorado,017,186661,26325,26101,3161,29262,189
2022-02-19,Fresno,019,978130,227738,223594,23585,247179,2544
2022-02-19,Glenn,021,27897,4913,4881,1591,6472,39
2022-02-19,Humboldt,023,135768,16486,16393,2878,19271,132
2022-02-19,Imperial,025,180216,54740,53967,10703,64670,862
2022-02-19,Inyo,027,18085,4031,4018,459,4477,52
2022-02-19,Kern,029,883053,189566,187158,45639,232797,2095
2022-02-19,Kings,031,150075,50685,49724,3557,53281,421
2022-02-19,Lake,033,64148,10380,10184,872,11056,126
2022-02-19,Lassen,035,31185,8783,8640,875,9515,55
2022-02-19,Los Angeles,037,10098052,2677947,2642878,123156,2766034,29842
2022-02-19,Madera,039,155013,36753,36526,5960,42486,330
2022-02-19,Marin,041,260295,32662,32441,2171,34612,258
2022-02-19,Mariposa,043,17540,2324,2310,193,2503,6
2022-02-19,Mendocino,045,87422,12798,12625,2931,15556,110
2022-02-19,Merced,047,269075,61272,60886,8449,69335,769
2022-02-19,Modoc,049,8938,724,714,248,962,6
2022-02-19,Mono,051,14174,2953,2956,119,3075,5
2022-02-19,Monterey,053,433212,78160,76765,13225,89990,682
2022-02-19,Napa,055,140530,25120,24970,932,25902,127
2022-02-19,Nevada,057,99092,15707,15715,1163,16878,121
2022-02-19,Orange,059,3164182,540137,538019,40747,578766,6416
2022-02-19,Placer,061,380077,61833,61417,7299,68716,560
2022-02-19,Plumas,063,18699,2920,2646,352,2998,13
2022-02-19,Riverside,065,2383286,585586,581788,27673,609461,6087
2022-02-19,Sacramento,067,1510023,276813,270080,26847,296927,2747
2022-02-19,San Benito,069,59416,12736,12665,506,13171,92
2022-02-19,San Bernardino,071,2135413,561669,553151,24582,577733,6400
2022-02-19,San Diego,073,3302833,741466,729549,51226,780775,4947
2022-02-19,San Francisco,075,870044,120634,121197,8103,129300,756
2022-02-19,San Joaquin,077,732212,164165,163083,9540,172623,2033
2022-02-19,San Luis Obispo,079,281455,51380,50823,3671,54494,424
2022-02-19,San Mateo,081,765935,119052,116648,6821,123469,598
2022-02-19,Santa Barbara,083,443738,84510,83988,4699,88687,642
2022-02-19,Santa Clara,085,1922200,304106,303077,12130,315207,2138
2022-02-19,Santa Cruz,087,273765,46242,45532,2090,47622,250
2022-02-19,Shasta,089,179085,30016,29847,6026,35873,479
2022-02-19,Sierra,091,2930,271,269,46,315,0
2022-02-19,Siskiyou,093,43540,4361,4307,2688,6995,70
2022-02-19,Solano,095,438530,79840,78914,5447,84361,424
2022-02-19,Sonoma,097,501317,81833,80843,2519,83362,431
2022-02-19,Stanislaus,099,539301,115927,115976,17083,133059,1454
2022-02-19,Sutter,101,95872,20166,20060,2010,22070,210
2022-02-19,Tehama,103,63373,11878,11760,2599,14359,152
2022-02-19,Trinity,105,12862,1166,1130,291,1421,20
2022-02-19,Tulare,107,460477,105274,101996,28130,130126,1286
2022-02-19,Tuolumne,109,53932,12414,12036,546,12582,175
2022-02-19,Ventura,111,848112,171053,170331,9192,179523,1384
2022-02-19,Yolo,113,214977,36038,35363,3080,38443,293
2022-02-19,Yuba,115,75493,15574,15449,1165,16614,112
2022-02-18,Alameda,001,1643700,250176,246028,13563,259591,1700
2022-02-18,Alpine,003,1148,121,124,1,125,0
2022-02-18,Amador,005,37829,8312,8203,638,8841,79
2022-02-18,Butte,007,227075,32415,32173,6492,38665,364
2022-02-18,Calaveras,009,45235,7145,7136,343,7479,107
2022-02-18,Colusa,011,21464,3406,3389,1059,4448,21
2022-02-18,Contra Costa,013,1133247,184928,182797,12886,195683,1190
2022-02-18,Del Norte,015,27424,5556,5511,176,5687,45
2022-02-18,El Dorado,017,186661,26314,26101,3160,29261,189
2022-02-18,Fresno,019,978130,227551,223594,23575,247169,2544
2022-02-18,Glenn,021,27897,4912,4881,1590,6471,39
2022-02-18,Humboldt,023,135768,16469,16393,2873,19266,132
2022-02-18,Imperial,025,180216,54717,53967,10692,64659,862
2022-02-18,Inyo,027,18085,4030,4018,459,4477,52
2022-02-18,Kern,029,883053,189451,187158,45594,232752,2095
2022-02-18,Kings,031,150075,50597,49724,3557,53281,421
2022-02-18,Lake,033,64148,10363,10184,870,11054,126
2022-02-18,Lassen,035,31185,8763,8640,874,9514,55
2022-02-18,Los Angeles,037,10098052,2676975,2642878,123101,2765979,29842
2022-02-18,Madera,039,155013,36730,36526,5958,42484,330
2022-02-18,Marin,041,260295,32644,32441,2169,34610,258
2022-02-18,Mariposa,043,17540,2322,2310,193,2503,6
2022-02-18,Mendocino,045,87422,12787,12625,2931,15556,110
2022-02-18,Merced,047,269075,61228,60886,8439,69325,769
2022-02-18,Modoc,049,8938,724,714,248,962,6
2022-02-18,Mono,051,14174,2953,2956,119,3075,5
2022-02-18,Monterey,053,433212,78088,76765,13217,89982,682
2022-02-18,Napa,055,140530,25102,24970,932,25902,127
2022-02-18,Nevada,057,99092,15699,15715,1163,16878,121
2022-02-18,Orange,059,3164182,539900,538019,40708,578727,6416
2022-02-18,Placer,061,380077,61803,61417,7291,68708,560
2022-02-18,Plumas,063,18699,2917,2646,352,2998,13
2022-02-18,Riverside,065,2383286,585405,581788,27664,609452,6087
2022-02-18,Sacramento,067,1510023,276621,270080,26839,296919,2747
2022-02-18,San Benito,069,59416,12728,12665,506,13171,92
2022-02-18,San Bernardino,071,2135413,561487,553151,24577,577728,6400
2022-02-18,San Diego,073,3302833,741033,729549,51204,780753,4947
2022-02-18,San Francisco,075,870044,120546,121197,8095,129292,756
2022-02-18,San Joaquin,077,732212,164098,163083,9532,172615,2033
2022-02-18,San Luis Obispo,079,281455,51364,50823,3668,54491,424
2022-02-18,San Mateo,081,765935,118987,116648,6818,123466,598
2022-02-18,Santa Barbara,083,443738,84470,83988,4697,88685,642
2022-02-18,Santa Clara,085,1922200,303866,303077,12129,315206,2138
2022-02-18,Santa Cruz,087,273765,46208,45532,2089,47621,250
2022-02-18,Shasta,089,179085,30004,29847,6025,35872,479
2022-02-18,Sierra,091,2930,271,269,46,315,0
2022-02-18,Siskiyou,093,43540,4358,4307,2686,6993,70
2022-02-18,Solano,095,438530,79770,78914,5446,84360,424
2022-02-18,Sonoma,097,501317,81775,80843,2518,83361,431
2022-02-18,Stanislaus,099,539301,115877,115976,17069,133045,1454
2022-02-18,Sutter,101,95872,20155,20060,2010,22070,210
2022-02-18,Tehama,103,63373,11867,11760,2599,14359,152
2022-02-18,Trinity,105,12862,1165,1130,290,1420,20
2022-02-18,Tulare,107,460477,105232,101996,28086,130082,1286
2022-02-18,Tuolumne,109,53932,12408,12036,545,12581,175
2022-02-18,Ventura,111,848112,170963,170331,9188,179519,1384
2022-02-18,Yolo,113,214977,36010,35363,3078,38441,293
2022-02-18,Yuba,115,75493,15561,15449,1165,16614,112
2022-02-17,Alameda,001,1643700,249914,246028,13542,259570,1700
2022-02-17,Alpine,003,1148,121,124,1,125,0
2022-02-17,Amador,005,37829,8308,8203,636,8839,79
2022-02-17,Butte,007,227075,32377,32173,6487,38660,364
2022-02-17,Calaveras,009,45235,7136,7136,340,7476,107
2022-02-17,Colusa,011,21464,3403,3389,1059,4448,21
2022-02-17,Contra Costa,013,1133247,184734,182797,12852,195649,1190
2022-02-17,Del Norte,015,27424,5535,5511,176,5687,45
2022-02-17,El Dorado,017,186661,26289,26101,3150,29251,189
2022-02-17,Fresno,019,978130,227261,223594,23544,247138,2544
2022-02-17,Glenn,021,27897,4910,4881,1587,6468,39
2022-02-17,Humboldt,023,135768,16428,16393,2872,19265,132
2022-02-17,Imperial,025,180216,54649,53967,10675,64642,862
2022-02-17,Inyo,027,18085,4029,4018,458,4476,52
2022-02-17,Kern,029,883053,189298,187158,45544,232702,2095
2022-02-17,Kings,031,150075,50532,49724,3551,53275,421
2022-02-17,Lake,033,64148,10333,10184,866,11050,126
2022-02-17,Lassen,035,31185,8753,8640,872,9512,55
2022-02-17,Los Angeles,037,10098052,2675139,2642878,123020,2765898,29842
2022-02-17,Madera,039,155013,36687,36526,5952,42478,330
2022-02-17,Marin,041,260295,32618,32441,2167,34608,258
2022-02-17,Mariposa,043,17540,2319,2310,192,2502,6
2022-02-17,Mendocino,045,87422,12770,12625,2928,15553,110
2022-02-17,Merced,047,269075,61152,60886,8421,69307,769
2022-02-17,Modoc,049,8938,723,714,248,962,6
2022-02-17,Mono,051,14174,2951,2956,119,3075,5
2022-02-17,Monterey,053,433212,77976,76765,13175,89940,682
2022-02-17,Napa,055,140530,25071,24970,930,25900,127
2022-02-17,Nevada,057,99092,15687,15715,1162,16877,121
2022-02-17,Orange,059,3164182,539564,538019,40680,578699,6416
2022-02-17,Placer,061,380077,61762,61417,7283,68700,560
2022-02-17,Plumas,063,18699,2914,2646,352,2998,13
2022-02-17,Riverside,065,2383286,585017,581788,27637,609425,6087
2022-02-17,Sacramento,067,1510023,276332,270080,26791,296871,2747
2022-02-17,San Benito,069,59416,12717,12665,506,13171,92
2022-02-17,San Bernardino,071,2135413,561188,553151,24562,577713,6400
2022-02-17,San Diego,073,3302833,740415,729549,51158,780707,4947
2022-02-17,San Francisco,075,870044,120411,121197,8084,129281,756
2022-02-17,San Joaquin,077,732212,163936,163083,9518,172601,2033
2022-02-17,San Luis Obispo,079,281455,51259,50823,3660,54483,424
2022-02-17,San Mateo,081,765935,118893,116648,6809,123457,598
2022-02-17,Santa Barbara,083,443738,84368,83988,4689,88677,642
2022-02-17,Santa Clara,085,1922200,303503,303077,12114,315191,2138
2022-02-17,Santa Cruz,087,273765,46127,45532,2087,47619,250
2022-02-17,Shasta,089,179085,29976,29847,6022,35869,479
2022-02-17,Sierra,091,2930,271,269,46,315,0
2022-02-17,Siskiyou,093,43540,4349,4307,2682,6989,70
2022-02-17,Solano,095,438530,79689,78914,5439,84353,424
2022-02-17,Sonoma,097,501317,81708,80843,2511,83354,431
2022-02-17,Stanislaus,099,539301,115773,115976,17052,133028,1454
2022-02-17,Sutter,101,95872,20140,20060,2002,22062,210
2022-02-17,Tehama,103,63373,11858,11760,2598,14358,152
2022-02-17,Trinity,105,12862,1163,1130,288,1418,20
2022-02-17,Tulare,107,460477,105117,101996,28059,130055,1286
2022-02-17,Tuolumne,109,53932,12397,12036,545,12581,175
2022-02-17,Ventura,111,848112,170823,170331,9187,179518,1384
2022-02-17,Yolo,113,214977,35972,35363,3077,38440,293
2022-02-17,Yuba,115,75493,15546,15449,1165,16614,112
2022-02-16,Alameda,001,1643700,249598,245662,13503,259165,1691
2022-02-16,Alpine,003,1148,121,124,1,125,0
2022-02-16,Amador,005,37829,8290,8197,634,8831,77
2022-02-16,Butte,007,227075,32335,32095,6475,38570,363
2022-02-16,Calaveras,009,45235,7130,7129,337,7466,107
2022-02-16,Colusa,011,21464,3398,3384,1059,4443,21
2022-02-16,Contra Costa,013,1133247,184498,182423,12815,195238,1179
2022-02-16,Del Norte,015,27424,5513,5473,172,5645,45
2022-02-16,El Dorado,017,186661,26261,26061,3146,29207,189
2022-02-16,Fresno,019,978130,226899,223056,23494,246550,2542
2022-02-16,Glenn,021,27897,4906,4873,1582,6455,39
2022-02-16,Humboldt,023,135768,16403,16342,2861,19203,132
2022-02-16,Imperial,025,180216,54578,53901,10645,64546,861
2022-02-16,Inyo,027,18085,4025,4013,455,4468,52
2022-02-16,Kern,029,883053,189080,186740,45453,232193,2084
2022-02-16,Kings,031,150075,50479,49575,3542,53117,420
2022-02-16,Lake,033,64148,10306,10145,866,11011,125
2022-02-16,Lassen,035,31185,8720,8618,872,9490,55
2022-02-16,Los Angeles,037,10098052,2673039,2640005,122907,2762912,29749
2022-02-16,Madera,039,155013,36619,36382,5937,42319,330
2022-02-16,Marin,041,260295,32582,32381,2164,34545,257
2022-02-16,Mariposa,043,17540,2317,2305,192,2497,6
2022-02-16,Mendocino,045,87422,12748,12605,2918,15523,108
2022-02-16,Merced,047,269075,61086,60776,8388,69164,767
2022-02-16,Modoc,049,8938,723,711,244,955,6
2022-02-16,Mono,051,14174,2949,2953,119,3072,5
2022-02-16,Monterey,053,433212,77828,76624,13134,89758,682
2022-02-16,Napa,055,140530,25032,24897,927,25824,128
2022-02-16,Nevada,057,99092,15671,15677,1158,16835,121
2022-02-16,Orange,059,3164182,539162,537934,40635,578569,6392
2022-02-16,Placer,061,380077,61719,61278,7270,68548,556
2022-02-16,Plumas,063,18699,2911,2644,350,2994,13
2022-02-16,Riverside,065,2383286,584624,580828,27590,608418,6064
2022-02-16,Sacramento,067,1510023,276008,269416,26735,296151,2736
2022-02-16,San Benito,069,59416,12691,12644,506,13150,92
2022-02-16,San Bernardino,071,2135413,560914,552353,24537,576890,6379
2022-02-16,San Diego,073,3302833,739629,728610,51084,779694,4931
2022-02-16,San Francisco,075,870044,120239,120987,8079,129066,756
2022-02-16,San Joaquin,077,732212,163768,162752,9508,172260,2032
2022-02-16,San Luis Obispo,079,281455,51189,50704,3647,54351,425
2022-02-16,San Mateo,081,765935,118775,116438,6791,123229,595
2022-02-16,Santa Barbara,083,443738,84293,83968,4676,88644,642
2022-02-16,Santa Clara,085,1922200,303119,302439,12079,314518,2130
2022-02-16,Santa Cruz,087,273765,46037,45274,2085,47359,250
2022-02-16,Shasta,089,179085,29937,29767,6010,35777,477
2022-02-16,Sierra,091,2930,270,269,46,315,0
2022-02-16,Siskiyou,093,43540,4342,4302,2676,6978,71
2022-02-16,Solano,095,438530,79574,78742,5432,84174,422
2022-02-16,Sonoma,097,501317,81587,80642,2501,83143,431
2022-02-16,Stanislaus,099,539301,115656,115751,17021,132772,1443
2022-02-16,Sutter,101,95872,20123,20020,1999,22019,210
2022-02-16,Tehama,103,63373,11840,11738,2596,14334,152
2022-02-16,Trinity,105,12862,1163,1130,287,1417,20
2022-02-16,Tulare,107,460477,104993,101817,28006,129823,1281
2022-02-16,Tuolumne,109,53932,12385,11991,544,12535,171
2022-02-16,Ventura,111,848112,170688,170117,9179,179296,1372
2022-02-16,Yolo,113,214977,35921,35284,3074,38358,292
2022-02-16,Yuba,115,75493,15524,15405,1162,16567,110
2022-02-15,Alameda,001,1643700,249250,245265,13474,258739,1683
2022-02-15,Alpine,003,1148,121,124,1,125,0
2022-02-15,Amador,005,37829,8279,8183,633,8816,77
2022-02-15,Butte,007,227075,32284,32011,6461,38472,361
2022-02-15,Calaveras,009,45235,7121,7115,337,7452,106
2022-02-15,Colusa,011,21464,3390,3374,1058,4432,21
2022-02-15,Contra Costa,013,1133247,184241,182041,12783,194824,1179
2022-02-15,Del Norte,015,27424,5487,5439,170,5609,45
2022-02-15,El Dorado,017,186661,26242,25988,3141,29129,189
2022-02-15,Fresno,019,978130,226516,222673,23429,246102,2543
2022-02-15,Glenn,021,27897,4897,4862,1581,6443,39
2022-02-15,Humboldt,023,135768,16360,16297,2846,19143,132
2022-02-15,Imperial,025,180216,54514,53813,10630,64443,860
2022-02-15,Inyo,027,18085,4024,4009,454,4463,52
2022-02-15,Kern,029,883053,188862,186324,45362,231686,2072
2022-02-15,Kings,031,150075,50385,49473,3533,53006,418
2022-02-15,Lake,033,64148,10273,10112,860,10972,123
2022-02-15,Lassen,035,31185,8705,8587,870,9457,55
2022-02-15,Los Angeles,037,10098052,2670788,2638266,122771,2761037,29691
2022-02-15,Madera,039,155013,36554,36260,5917,42177,330
2022-02-15,Marin,041,260295,32540,32355,2162,34517,255
2022-02-15,Mariposa,043,17540,2316,2302,192,2494,6
2022-02-15,Mendocino,045,87422,12731,12580,2899,15479,108
2022-02-15,Merced,047,269075,61003,60674,8357,69031,763
2022-02-15,Modoc,049,8938,721,710,241,951,6
2022-02-15,Mono,051,14174,2948,2952,119,3071,5
2022-02-15,Monterey,053,433212,77702,75530,13074,88604,682
2022-02-15,Napa,055,140530,24982,24832,920,25752,127
2022-02-15,Nevada,057,99092,15644,15643,1157,16800,121
2022-02-15,Orange,059,3164182,538702,537478,40590,578068,6374
2022-02-15,Placer,061,380077,61658,61170,7259,68429,554
2022-02-15,Plumas,063,18699,2907,2638,350,2988,13
2022-02-15,Riverside,065,2383286,584132,579940,27530,607470,6049
2022-02-15,Sacramento,067,1510023,275626,268950,26650,295600,2721
2022-02-15,San Benito,069,59416,12672,12616,506,13122,91
2022-02-15,San Bernardino,071,2135413,560543,551803,24514,576317,6372
2022-02-15,San Diego,073,3302833,738642,727486,50993,778479,4914
2022-02-15,San Francisco,075,870044,120067,120759,8067,128826,756
2022-02-15,San Joaquin,077,732212,163551,162518,9494,172012,2021
2022-02-15,San Luis Obispo,079,281455,51088,50534,3632,54166,419
2022-02-15,San Mateo,081,765935,118639,116253,6769,123022,595
2022-02-15,Santa Barbara,083,443738,84155,83734,4662,88396,640
2022-02-15,Santa Clara,085,1922200,302624,301831,12040,313871,2130
2022-02-15,Santa Cruz,087,273765,45933,45171,2080,47251,250
2022-02-15,Shasta,089,179085,29888,29684,5996,35680,477
2022-02-15,Sierra,091,2930,270,269,46,315,0
2022-02-15,Siskiyou,093,43540,4335,4288,2669,6957,70
2022-02-15,Solano,095,438530,79441,78626,5425,84051,426
2022-02-15,Sonoma,097,501317,81467,80433,2495,82928,431
2022-02-15,Stanislaus,099,539301,115517,115549,16988,132537,1429
2022-02-15,Sutter,101,95872,20095,19980,1994,21974,208
2022-02-15,Tehama,103,63373,11823,11717,2594,14311,151
2022-02-15,Trinity,105,12862,1157,1125,284,1409,20
2022-02-15,Tulare,107,460477,104839,101645,27948,129593,1278
2022-02-15,Tuolumne,109,53932,12365,11945,542,12487,171
2022-02-15,Ventura,111,848112,170516,169942,9171,179113,1372
2022-02-15,Yolo,113,214977,35870,35241,3064,38305,289
2022-02-15,Yuba,115,75493,15495,15372,1157,16529,109
2022-02-14,Alameda,001,1643700,248812,244315,13441,257756,1677
2022-02-14,Alpine,003,1148,121,125,1,126,0
2022-02-14,Amador,005,37829,8264,8164,630,8794,77
2022-02-14,Butte,007,227075,32224,31946,6447,38393,360
2022-02-14,Calaveras,009,45235,7109,7097,335,7432,106
2022-02-14,Colusa,011,21464,3387,3367,1054,4421,21
2022-02-14,Contra Costa,013,1133247,183953,181753,12744,194497,1167
2022-02-14,Del Norte,015,27424,5465,5426,169,5595,45
2022-02-14,El Dorado,017,186661,26208,25915,3133,29048,188
2022-02-14,Fresno,019,978130,226028,222360,23338,245698,2538
2022-02-14,Glenn,021,27897,4891,4854,1581,6435,39
2022-02-14,Humboldt,023,135768,16319,16264,2821,19085,132
2022-02-14,Imperial,025,180216,54441,53765,10601,64366,860
2022-02-14,Inyo,027,18085,4023,4010,453,4463,52
2022-02-14,Kern,029,883053,188516,186037,45253,231290,2063
2022-02-14,Kings,031,150075,50281,49395,3524,52919,419
2022-02-14,Lake,033,64148,10238,10090,857,10947,123
2022-02-14,Lassen,035,31185,8694,8539,868,9407,55
2022-02-14,Los Angeles,037,10098052,2668206,2636064,122641,2758705,29650
2022-02-14,Madera,039,155013,36489,36194,5894,42088,330
2022-02-14,Marin,041,260295,32504,32304,2159,34463,255
2022-02-14,Mariposa,043,17540,2310,2295,192,2487,6
2022-02-14,Mendocino,045,87422,12704,12541,2867,15408,108
2022-02-14,Merced,047,269075,60913,60591,8312,68903,758
2022-02-14,Modoc,049,8938,716,707,241,948,6
2022-02-14,Mono,051,14174,2947,2954,119,3073,5
2022-02-14,Monterey,053,433212,77527,75407,12990,88397,678
2022-02-14,Napa,055,140530,24923,24776,920,25696,127
2022-02-14,Nevada,057,99092,15625,15629,1156,16785,121
2022-02-14,Orange,059,3164182,538198,536924,40524,577448,6355
2022-02-14,Placer,061,380077,61588,61123,7244,68367,554
2022-02-14,Plumas,063,18699,2905,2631,350,2981,13
2022-02-14,Riverside,065,2383286,583581,579174,27460,606634,5994
2022-02-14,Sacramento,067,1510023,275182,268547,26536,295083,2717
2022-02-14,San Benito,069,59416,12648,12598,505,13103,91
2022-02-14,San Bernardino,071,2135413,560111,551338,24494,575832,6372
2022-02-14,San Diego,073,3302833,737653,723902,50900,774802,4894
2022-02-14,San Francisco,075,870044,119877,120581,8057,128638,756
2022-02-14,San Joaquin,077,732212,163311,162363,9471,171834,2018
2022-02-14,San Luis Obispo,079,281455,50976,50465,3622,54087,416
2022-02-14,San Mateo,081,765935,118471,116129,6760,122889,592
2022-02-14,Santa Barbara,083,443738,84009,83697,4652,88349,636
2022-02-14,Santa Clara,085,1922200,302082,301319,12016,313335,2127
2022-02-14,Santa Cruz,087,273765,45769,45042,2076,47118,250
2022-02-14,Shasta,089,179085,29803,29595,5978,35573,474
2022-02-14,Sierra,091,2930,270,269,46,315,0
2022-02-14,Siskiyou,093,43540,4322,4278,2655,6933,69
2022-02-14,Solano,095,438530,79264,78533,5413,83946,427
2022-02-14,Sonoma,097,501317,81321,80336,2485,82821,431
2022-02-14,Stanislaus,099,539301,115340,115426,16944,132370,1406
2022-02-14,Sutter,101,95872,20066,19957,1988,21945,209
2022-02-14,Tehama,103,63373,11800,11686,2593,14279,151
2022-02-14,Trinity,105,12862,1154,1123,284,1407,20
2022-02-14,Tulare,107,460477,104631,101448,27846,129294,1276
2022-02-14,Tuolumne,109,53932,12334,11920,539,12459,170
2022-02-14,Ventura,111,848112,170339,169725,9159,178884,1361
2022-02-14,Yolo,113,214977,35812,35112,3054,38166,286
2022-02-14,Yuba,115,75493,15465,15375,1153,16528,108
2022-02-13,Alameda,001,1643700,248311,243681,13408,257089,1677
2022-02-13,Alpine,003,1148,121,125,1,126,0
2022-02-13,Amador,005,37829,8235,8146,627,8773,77
2022-02-13,Butte,007,227075,32148,31865,6424,38289,360
2022-02-13,Calaveras,009,45235,7101,7083,332,7415,106
2022-02-13,Colusa,011,21464,3383,3366,1052,4418,21
2022-02-13,Contra Costa,013,1133247,183586,181313,12679,193992,1159
2022-02-13,Del Norte,015,27424,5433,5379,169,5548,45
2022-02-13,El Dorado,017,186661,26172,25871,3124,28995,188
2022-02-13,Fresno,019,978130,225484,221686,23279,244965,2537
2022-02-13,Glenn,021,27897,4881,4847,1578,6425,39
2022-02-13,Humboldt,023,135768,16273,16210,2793,19003,132
2022-02-13,Imperial,025,180216,54342,53658,10563,64221,860
2022-02-13,Inyo,027,18085,4020,4006,451,4457,52
2022-02-13,Kern,029,883053,188270,185640,45166,230806,2063
2022-02-13,Kings,031,150075,50154,49243,3510,52753,416
2022-02-13,Lake,033,64148,10176,10042,849,10891,123
2022-02-13,Lassen,035,31185,8663,8503,866,9369,55
2022-02-13,Los Angeles,037,10098052,2665040,2631267,122498,2753765,29595
2022-02-13,Madera,039,155013,36371,36054,5865,41919,330
2022-02-13,Marin,041,260295,32433,32222,2152,34374,255
2022-02-13,Mariposa,043,17540,2304,2292,190,2482,6
2022-02-13,Mendocino,045,87422,12673,12521,2826,15347,108
2022-02-13,Merced,047,269075,60769,60460,8258,68718,758
2022-02-13,Modoc,049,8938,714,704,234,938,6
2022-02-13,Mono,051,14174,2945,2949,119,3068,5
2022-02-13,Monterey,053,433212,77319,75295,12915,88210,678
2022-02-13,Napa,055,140530,24845,24743,917,25660,127
2022-02-13,Nevada,057,99092,15590,15590,1149,16739,121
2022-02-13,Orange,059,3164182,537567,536134,40462,576596,6355
2022-02-13,Placer,061,380077,61511,61020,7220,68240,554
2022-02-13,Plumas,063,18699,2896,2626,347,2973,13
2022-02-13,Riverside,065,2383286,582985,578363,27415,605778,5995
2022-02-13,Sacramento,067,1510023,274672,267947,26403,294350,2699
2022-02-13,San Benito,069,59416,12615,12578,504,13082,91
2022-02-13,San Bernardino,071,2135413,559598,550632,24460,575092,6367
2022-02-13,San Diego,073,3302833,736484,723902,50792,774694,4894
2022-02-13,San Francisco,075,870044,119622,120295,8045,128340,756
2022-02-13,San Joaquin,077,732212,162999,162028,9442,171470,2018
2022-02-13,San Luis Obispo,079,281455,50831,50384,3614,53998,415
2022-02-13,San Mateo,081,765935,118247,115876,6735,122611,592
2022-02-13,Santa Barbara,083,443738,83844,83547,4644,88191,635
2022-02-13,Santa Clara,085,1922200,301432,300412,11979,312391,2114
2022-02-13,Santa Cruz,087,273765,45613,44887,2074,46961,240
2022-02-13,Shasta,089,179085,29721,29531,5953,35484,474
2022-02-13,Sierra,091,2930,270,269,46,315,0
2022-02-13,Siskiyou,093,43540,4315,4264,2639,6903,69
2022-02-13,Solano,095,438530,79109,78424,5389,83813,426
2022-02-13,Sonoma,097,501317,81152,80172,2473,82645,431
2022-02-13,Stanislaus,099,539301,115139,115156,16903,132059,1406
2022-02-13,Sutter,101,95872,20025,19900,1988,21888,209
2022-02-13,Tehama,103,63373,11772,11644,2588,14232,151
2022-02-13,Trinity,105,12862,1151,1120,281,1401,20
2022-02-13,Tulare,107,460477,104408,101135,27752,128887,1276
2022-02-13,Tuolumne,109,53932,12309,11891,534,12425,170
2022-02-13,Ventura,111,848112,170144,169422,9139,178561,1361
2022-02-13,Yolo,113,214977,35745,35057,3042,38099,286
2022-02-13,Yuba,115,75493,15431,15346,1151,16497,107
2022-02-12,Alameda,001,1643700,248091,242137,13394,255531,1668
2022-02-12,Alpine,003,1148,121,124,1,125,0
2022-02-12,Amador,005,37829,8229,8091,627,8718,76
2022-02-12,Butte,007,227075,32122,31601,6419,38020,360
2022-02-12,Calaveras,009,45235,7098,7022,331,7353,106
2022-02-12,Colusa,011,21464,3379,3345,1052,4397,21
2022-02-12,Contra Costa,013,1133247,183396,180270,12672,192942,1141
2022-02-12,Del Norte,015,27424,5413,5262,169,5431,45
2022-02-12,El Dorado,017,186661,26156,25692,3124,28816,188
2022-02-12,Fresno,019,978130,225270,219909,23263,243172,2509
2022-02-12,Glenn,021,27897,4880,4818,1577,6395,39
2022-02-12,Humboldt,023,135768,16250,16058,2789,18847,132
2022-02-12,Imperial,025,180216,54297,53304,10552,63856,860
2022-02-12,Inyo,027,18085,4018,3991,451,4442,52
2022-02-12,Kern,029,883053,188163,184639,45129,229768,2037
2022-02-12,Kings,031,150075,50114,48893,3503,52396,415
2022-02-12,Lake,033,64148,10155,9926,844,10770,123
2022-02-12,Lassen,035,31185,8640,8477,865,9342,55
2022-02-12,Los Angeles,037,10098052,2663905,2616426,122421,2738847,29364
2022-02-12,Madera,039,155013,36338,35710,5858,41568,330
2022-02-12,Marin,041,260295,32400,32048,2149,34197,255
2022-02-12,Mariposa,043,17540,2304,2286,190,2476,6
2022-02-12,Mendocino,045,87422,12657,12439,2826,15265,107
2022-02-12,Merced,047,269075,60717,60187,8253,68440,758
2022-02-12,Modoc,049,8938,714,697,234,931,6
2022-02-12,Mono,051,14174,2945,2939,119,3058,5
2022-02-12,Monterey,053,433212,77259,74842,12890,87732,672
2022-02-12,Napa,055,140530,24817,24530,917,25447,124
2022-02-12,Nevada,057,99092,15578,15499,1147,16646,119
2022-02-12,Orange,059,3164182,537278,534503,40426,574929,6305
2022-02-12,Placer,061,380077,61452,60636,7217,67853,554
2022-02-12,Plumas,063,18699,2895,2617,346,2963,13
2022-02-12,Riverside,065,2383286,582629,575566,27391,602957,5961
2022-02-12,Sacramento,067,1510023,274436,266347,26394,292741,2686
2022-02-12,San Benito,069,59416,12603,12526,504,13030,91
2022-02-12,San Bernardino,071,2135413,559364,548822,24447,573269,6360
2022-02-12,San Diego,073,3302833,735959,720287,50746,771033,4854
2022-02-12,San Francisco,075,870044,119501,119113,8034,127147,740
2022-02-12,San Joaquin,077,732212,162871,161234,9436,170670,2014
2022-02-12,San Luis Obispo,079,281455,50795,50064,3610,53674,416
2022-02-12,San Mateo,081,765935,118157,115235,6727,121962,589
2022-02-12,Santa Barbara,083,443738,83756,83390,4634,88024,631
2022-02-12,Santa Clara,085,1922200,301088,298176,11971,310147,2093
2022-02-12,Santa Cruz,087,273765,45577,44447,2072,46519,239
2022-02-12,Shasta,089,179085,29693,29370,5949,35319,473
2022-02-12,Sierra,091,2930,270,268,46,314,0
2022-02-12,Siskiyou,093,43540,4308,4231,2636,6867,68
2022-02-12,Solano,095,438530,79067,77865,5386,83251,424
2022-02-12,Sonoma,097,501317,81047,79533,2471,82004,431
2022-02-12,Stanislaus,099,539301,115014,114531,16891,131422,1406
2022-02-12,Sutter,101,95872,20010,19800,1988,21788,211
2022-02-12,Tehama,103,63373,11758,11580,2588,14168,151
2022-02-12,Trinity,105,12862,1150,1115,281,1396,20
2022-02-12,Tulare,107,460477,104311,100434,27713,128147,1273
2022-02-12,Tuolumne,109,53932,12291,11754,534,12288,125
2022-02-12,Ventura,111,848112,170036,168736,9134,177870,1340
2022-02-12,Yolo,113,214977,35704,34773,3039,37812,286
2022-02-12,Yuba,115,75493,15415,15242,1150,16392,107
2022-02-11,Alameda,001,1643700,247810,242137,13380,255517,1668
2022-02-11,Alpine,003,1148,121,124,1,125,0
2022-02-11,Amador,005,37829,8216,8091,627,8718,76
2022-02-11,Butte,007,227075,32078,31601,6408,38009,360
2022-02-11,Calaveras,009,45235,7095,7022,331,7353,106
2022-02-11,Colusa,011,21464,3377,3345,1051,4396,21
2022-02-11,Contra Costa,013,1133247,183192,180270,12652,192922,1141
2022-02-11,Del Norte,015,27424,5398,5262,168,5430,45
2022-02-11,El Dorado,017,186661,26136,25692,3123,28815,188
2022-02-11,Fresno,019,978130,224975,219909,23246,243155,2509
2022-02-11,Glenn,021,27897,4876,4818,1577,6395,39
2022-02-11,Humboldt,023,135768,16220,16058,2784,18842,132
2022-02-11,Imperial,025,180216,54267,53304,10541,63845,860
2022-02-11,Inyo,027,18085,4015,3991,446,4437,52
2022-02-11,Kern,029,883053,188001,184639,45075,229714,2037
2022-02-11,Kings,031,150075,50075,48893,3502,52395,415
2022-02-11,Lake,033,64148,10129,9926,842,10768,123
2022-02-11,Lassen,035,31185,8600,8477,865,9342,55
2022-02-11,Los Angeles,037,10098052,2662272,2616426,122332,2738758,29364
2022-02-11,Madera,039,155013,36296,35710,5853,41563,330
2022-02-11,Marin,041,260295,32367,32048,2146,34194,255
2022-02-11,Mariposa,043,17540,2299,2286,190,2476,6
2022-02-11,Mendocino,045,87422,12641,12439,2826,15265,107
2022-02-11,Merced,047,269075,60668,60187,8246,68433,758
2022-02-11,Modoc,049,8938,712,697,234,931,6
2022-02-11,Mono,051,14174,2944,2939,119,3058,5
2022-02-11,Monterey,053,433212,77140,74842,12876,87718,672
2022-02-11,Napa,055,140530,24789,24530,917,25447,124
2022-02-11,Nevada,057,99092,15563,15499,1144,16643,119
2022-02-11,Orange,059,3164182,536927,534503,40361,574864,6305
2022-02-11,Placer,061,380077,61400,60636,7215,67851,554
2022-02-11,Plumas,063,18699,2891,2617,344,2961,13
2022-02-11,Riverside,065,2383286,582208,575566,27375,602941,5961
2022-02-11,Sacramento,067,1510023,274172,266347,26381,292728,2686
2022-02-11,San Benito,069,59416,12598,12526,504,13030,91
2022-02-11,San Bernardino,071,2135413,559046,548822,24432,573254,6360
2022-02-11,San Diego,073,3302833,735240,720287,50690,770977,4854
2022-02-11,San Francisco,075,870044,119381,119113,8018,127131,740
2022-02-11,San Joaquin,077,732212,162702,161234,9424,170658,2014
2022-02-11,San Luis Obispo,079,281455,50758,50064,3606,53670,416
2022-02-11,San Mateo,081,765935,118040,115235,6718,121953,589
2022-02-11,Santa Barbara,083,443738,83672,83390,4633,88023,631
2022-02-11,Santa Clara,085,1922200,300664,298176,11952,310128,2093
2022-02-11,Santa Cruz,087,273765,45485,44447,2072,46519,239
2022-02-11,Shasta,089,179085,29662,29370,5941,35311,473
2022-02-11,Sierra,091,2930,269,268,45,313,0
2022-02-11,Siskiyou,093,43540,4297,4231,2630,6861,68
2022-02-11,Solano,095,438530,78943,77865,5381,83246,424
2022-02-11,Sonoma,097,501317,80958,79533,2466,81999,431
2022-02-11,Stanislaus,099,539301,114913,114531,16878,131409,1406
2022-02-11,Sutter,101,95872,19987,19800,1986,21786,211
2022-02-11,Tehama,103,63373,11745,11580,2587,14167,151
2022-02-11,Trinity,105,12862,1149,1115,280,1395,20
2022-02-11,Tulare,107,460477,104194,100434,27659,128093,1273
2022-02-11,Tuolumne,109,53932,12276,11754,532,12286,125
2022-02-11,Ventura,111,848112,169896,168736,9129,177865,1340
2022-02-11,Yolo,113,214977,35671,34773,3037,37810,286
2022-02-11,Yuba,115,75493,15399,15242,1149,16391,107
2022-02-10,Alameda,001,1643700,247275,242137,13334,255471,1668
2022-02-10,Alpine,003,1148,121,124,1,125,0
2022-02-10,Amador,005,37829,8205,8091,620,8711,76
2022-02-10,Butte,007,227075,32025,31601,6396,37997,360
2022-02-10,Calaveras,009,45235,7083,7022,329,7351,106
2022-02-10,Colusa,011,21464,3371,3345,1049,4394,21
2022-02-10,Contra Costa,013,1133247,182827,180270,12587,192857,1141
2022-02-10,Del Norte,015,27424,5368,5262,166,5428,45
2022-02-10,El Dorado,017,186661,26091,25692,3116,28808,188
2022-02-10,Fresno,019,978130,224384,219909,23155,243064,2509
2022-02-10,Glenn,021,27897,4871,4818,1575,6393,39
2022-02-10,Humboldt,023,135768,16170,16058,2762,18820,132
2022-02-10,Imperial,025,180216,54196,53304,10500,63804,860
2022-02-10,Inyo,027,18085,4011,3991,446,4437,52
2022-02-10,Kern,029,883053,187693,184639,44962,229601,2037
2022-02-10,Kings,031,150075,49963,48893,3491,52384,415
2022-02-10,Lake,033,64148,10098,9926,840,10766,123
2022-02-10,Lassen,035,31185,8586,8477,863,9340,55
2022-02-10,Los Angeles,037,10098052,2659119,2616426,122144,2738570,29364
2022-02-10,Madera,039,155013,36198,35710,5821,41531,330
2022-02-10,Marin,041,260295,32309,32048,2134,34182,255
2022-02-10,Mariposa,043,17540,2295,2286,189,2475,6
2022-02-10,Mendocino,045,87422,12619,12439,2801,15240,107
2022-02-10,Merced,047,269075,60540,60187,8191,68378,758
2022-02-10,Modoc,049,8938,711,697,233,930,6
2022-02-10,Mono,051,14174,2942,2939,118,3057,5
2022-02-10,Monterey,053,433212,76957,74842,12789,87631,672
2022-02-10,Napa,055,140530,24722,24530,915,25445,124
2022-02-10,Nevada,057,99092,15538,15499,1143,16642,119
2022-02-10,Orange,059,3164182,536276,534503,40292,574795,6305
2022-02-10,Placer,061,380077,61319,60636,7206,67842,554
2022-02-10,Plumas,063,18699,2888,2617,337,2954,13
2022-02-10,Riverside,065,2383286,581473,575566,27317,602883,5961
2022-02-10,Sacramento,067,1510023,273692,266347,26289,292636,2686
2022-02-10,San Benito,069,59416,12577,12526,502,13028,91
2022-02-10,San Bernardino,071,2135413,558496,548822,24400,573222,6360
2022-02-10,San Diego,073,3302833,734091,720287,50570,770857,4854
2022-02-10,San Francisco,075,870044,119168,119113,8000,127113,740
2022-02-10,San Joaquin,077,732212,162387,161234,9416,170650,2014
2022-02-10,San Luis Obispo,079,281455,50659,50064,3595,53659,416
2022-02-10,San Mateo,081,765935,117815,115235,6701,121936,589
2022-02-10,Santa Barbara,083,443738,83488,83390,4626,88016,631
2022-02-10,Santa Clara,085,1922200,299982,298176,11894,310070,2093
2022-02-10,Santa Cruz,087,273765,45340,44447,2071,46518,239
2022-02-10,Shasta,089,179085,29600,29370,5921,35291,473
2022-02-10,Sierra,091,2930,269,268,45,313,0
2022-02-10,Siskiyou,093,43540,4292,4231,2617,6848,68
2022-02-10,Solano,095,438530,78752,77865,5363,83228,424
2022-02-10,Sonoma,097,501317,80824,79533,2450,81983,431
2022-02-10,Stanislaus,099,539301,114733,114531,16834,131365,1406
2022-02-10,Sutter,101,95872,19948,19800,1971,21771,211
2022-02-10,Tehama,103,63373,11712,11580,2584,14164,151
2022-02-10,Trinity,105,12862,1146,1115,279,1394,20
2022-02-10,Tulare,107,460477,103988,100434,27577,128011,1273
2022-02-10,Tuolumne,109,53932,12254,11754,527,12281,125
2022-02-10,Ventura,111,848112,169616,168736,9115,177851,1340
2022-02-10,Yolo,113,214977,35592,34773,3031,37804,286
2022-02-10,Yuba,115,75493,15368,15242,1143,16385,107
2022-02-09,Alameda,001,1643700,246746,241141,13275,254416,1668
2022-02-09,Alpine,003,1148,120,124,1,125,0
2022-02-09,Amador,005,37829,8191,8069,615,8684,76
2022-02-09,Butte,007,227075,31933,31433,6380,37813,359
2022-02-09,Calaveras,009,45235,7065,7005,325,7330,106
2022-02-09,Colusa,011,21464,3368,3331,1048,4379,21
2022-02-09,Contra Costa,013,1133247,182474,179695,12540,192235,1132
2022-02-09,Del Norte,015,27424,5321,5204,165,5369,45
2022-02-09,El Dorado,017,186661,26055,25572,3105,28677,186
2022-02-09,Fresno,019,978130,223772,218989,23064,242053,2502
2022-02-09,Glenn,021,27897,4859,4804,1574,6378,39
2022-02-09,Humboldt,023,135768,16123,15929,2737,18666,131
2022-02-09,Imperial,025,180216,54092,53102,10427,63529,858
2022-02-09,Inyo,027,18085,4005,3989,445,4434,52
2022-02-09,Kern,029,883053,187315,184068,44847,228915,2021
2022-02-09,Kings,031,150075,49852,48718,3485,52203,410
2022-02-09,Lake,033,64148,10058,9880,835,10715,124
2022-02-09,Lassen,035,31185,8558,8459,862,9321,55
2022-02-09,Los Angeles,037,10098052,2655452,2611611,122008,2733619,29263
2022-02-09,Madera,039,155013,36100,35559,5791,41350,330
2022-02-09,Marin,041,260295,32258,31965,2127,34092,255
2022-02-09,Mariposa,043,17540,2292,2279,189,2468,6
2022-02-09,Mendocino,045,87422,12585,12378,2772,15150,107
2022-02-09,Merced,047,269075,60410,59952,8139,68091,755
2022-02-09,Modoc,049,8938,707,691,232,923,6
2022-02-09,Mono,051,14174,2940,2937,118,3055,5
2022-02-09,Monterey,053,433212,76757,74500,12698,87198,670
2022-02-09,Napa,055,140530,24677,24429,910,25339,123
2022-02-09,Nevada,057,99092,15518,15446,1141,16587,119
2022-02-09,Orange,059,3164182,535643,534316,40212,574528,6263
2022-02-09,Placer,061,380077,61222,60490,7186,67676,553
2022-02-09,Plumas,063,18699,2883,2609,333,2942,13
2022-02-09,Riverside,065,2383286,580733,573907,27270,601177,5911
2022-02-09,Sacramento,067,1510023,273118,265624,26162,291786,2673
2022-02-09,San Benito,069,59416,12553,12492,502,12994,91
2022-02-09,San Bernardino,071,2135413,557890,547768,24372,572140,6349
2022-02-09,San Diego,073,3302833,732719,717896,50462,768358,4832
2022-02-09,San Francisco,075,870044,118919,118550,7989,126539,731
2022-02-09,San Joaquin,077,732212,162084,160618,9406,170024,2014
2022-02-09,San Luis Obispo,079,281455,50514,49833,3590,53423,414
2022-02-09,San Mateo,081,765935,117626,114890,6660,121550,589
2022-02-09,Santa Barbara,083,443738,83309,82830,4620,87450,629
2022-02-09,Santa Clara,085,1922200,299258,297157,11836,308993,2090
2022-02-09,Santa Cruz,087,273765,45157,44200,2064,46264,239
2022-02-09,Shasta,089,179085,29530,29215,5900,35115,471
2022-02-09,Sierra,091,2930,268,268,44,312,0
2022-02-09,Siskiyou,093,43540,4278,4217,2611,6828,68
2022-02-09,Solano,095,438530,78561,77299,5351,82650,423
2022-02-09,Sonoma,097,501317,80650,79165,2443,81608,431
2022-02-09,Stanislaus,099,539301,114485,114039,16586,130625,1406
2022-02-09,Sutter,101,95872,19906,19758,1958,21716,207
2022-02-09,Tehama,103,63373,11685,11542,2580,14122,149
2022-02-09,Trinity,105,12862,1142,1110,278,1388,20
2022-02-09,Tulare,107,460477,103774,100049,27477,127526,1271
2022-02-09,Tuolumne,109,53932,12217,11702,524,12226,95
2022-02-09,Ventura,111,848112,169380,168253,9103,177356,1325
2022-02-09,Yolo,113,214977,35520,34588,3017,37605,285
2022-02-09,Yuba,115,75493,15337,15187,1131,16318,105
2022-02-08,Alameda,001,1643700,246116,240587,13201,253788,1651
2022-02-08,Alpine,003,1148,120,124,1,125,0
2022-02-08,Amador,005,37829,8183,8050,608,8658,76
2022-02-08,Butte,007,227075,31849,31353,6357,37710,359
2022-02-08,Calaveras,009,45235,7049,6981,323,7304,101
2022-02-08,Colusa,011,21464,3359,3320,1047,4367,21
2022-02-08,Contra Costa,013,1133247,182047,179078,12463,191541,1132
2022-02-08,Del Norte,015,27424,5295,5156,160,5316,44
2022-02-08,El Dorado,017,186661,26009,25446,3094,28540,186
2022-02-08,Fresno,019,978130,223038,218416,22958,241374,2502
2022-02-08,Glenn,021,27897,4842,4784,1570,6354,39
2022-02-08,Humboldt,023,135768,16063,15865,2704,18569,130
2022-02-08,Imperial,025,180216,53964,52977,10382,63359,855
2022-02-08,Inyo,027,18085,4000,3983,445,4428,52
2022-02-08,Kern,029,883053,186987,183519,44714,228233,2010
2022-02-08,Kings,031,150075,49701,48479,3473,51952,411
2022-02-08,Lake,033,64148,10028,9806,829,10635,125
2022-02-08,Lassen,035,31185,8549,8423,858,9281,55
2022-02-08,Los Angeles,037,10098052,2651161,2611204,121817,2733021,29259
2022-02-08,Madera,039,155013,35993,35381,5735,41116,330
2022-02-08,Marin,041,260295,32183,31878,2122,34000,255
2022-02-08,Mariposa,043,17540,2290,2266,181,2447,6
2022-02-08,Mendocino,045,87422,12552,12336,2741,15077,107
2022-02-08,Merced,047,269075,60302,59789,8080,67869,751
2022-02-08,Modoc,049,8938,703,684,232,916,6
2022-02-08,Mono,051,14174,2939,2932,118,3050,5
2022-02-08,Monterey,053,433212,76550,74316,12604,86920,670
2022-02-08,Napa,055,140530,24603,24346,903,25249,121
2022-02-08,Nevada,057,99092,15491,15383,1138,16521,117
2022-02-08,Orange,059,3164182,534959,533507,40125,573632,6205
2022-02-08,Placer,061,380077,61114,60301,7173,67474,553
2022-02-08,Plumas,063,18699,2872,2596,326,2922,13
2022-02-08,Riverside,065,2383286,579908,571892,27194,599086,5908
2022-02-08,Sacramento,067,1510023,272450,264479,25979,290458,2664
2022-02-08,San Benito,069,59416,12529,12434,500,12934,91
2022-02-08,San Bernardino,071,2135413,557202,544658,24327,568985,6335
2022-02-08,San Diego,073,3302833,731122,717896,50333,768229,4832
2022-02-08,San Francisco,075,870044,118607,117942,7980,125922,731
2022-02-08,San Joaquin,077,732212,161706,160147,9388,169535,2005
2022-02-08,San Luis Obispo,079,281455,50347,49556,3558,53114,410
2022-02-08,San Mateo,081,765935,117405,114541,6630,121171,589
2022-02-08,Santa Barbara,083,443738,83142,82461,4594,87055,627
2022-02-08,Santa Clara,085,1922200,298377,295679,11786,307465,2091
2022-02-08,Santa Cruz,087,273765,45005,43884,2059,45943,239
2022-02-08,Shasta,089,179085,29444,29084,5871,34955,470
2022-02-08,Sierra,091,2930,268,267,44,311,0
2022-02-08,Siskiyou,093,43540,4268,4191,2601,6792,68
2022-02-08,Solano,095,438530,78330,77031,5337,82368,421
2022-02-08,Sonoma,097,501317,80434,78798,2421,81219,431
2022-02-08,Stanislaus,099,539301,114231,113733,16510,130243,1406
2022-02-08,Sutter,101,95872,19867,19717,1946,21663,203
2022-02-08,Tehama,103,63373,11661,11491,2572,14063,149
2022-02-08,Trinity,105,12862,1136,1110,278,1388,20
2022-02-08,Tulare,107,460477,103489,99694,27341,127035,1267
2022-02-08,Tuolumne,109,53932,12194,11665,522,12187,92
2022-02-08,Ventura,111,848112,169146,167830,9087,176917,1325
2022-02-08,Yolo,113,214977,35438,34462,3003,37465,281
2022-02-08,Yuba,115,75493,15292,15126,1109,16235,107
2022-02-07,Alameda,001,1643700,245411,238678,13133,251811,1643
2022-02-07,Alpine,003,1148,120,124,1,125,0
2022-02-07,Amador,005,37829,8155,7980,600,8580,75
2022-02-07,Butte,007,227075,31763,31184,6331,37515,355
2022-02-07,Calaveras,009,45235,7027,6910,322,7232,100
2022-02-07,Colusa,011,21464,3349,3283,1041,4324,21
2022-02-07,Contra Costa,013,1133247,181591,177767,12394,190161,1130
2022-02-07,Del Norte,015,27424,5256,5093,155,5248,44
2022-02-07,El Dorado,017,186661,25947,25257,3082,28339,185
2022-02-07,Fresno,019,978130,222190,216495,22816,239311,2493
2022-02-07,Glenn,021,27897,4835,4762,1566,6328,39
2022-02-07,Humboldt,023,135768,15988,15764,2679,18443,129
2022-02-07,Imperial,025,180216,53852,52689,10314,63003,853
2022-02-07,Inyo,027,18085,3995,3976,439,4415,51
2022-02-07,Kern,029,883053,186518,182047,44543,226590,1998
2022-02-07,Kings,031,150075,49516,48147,3457,51604,403
2022-02-07,Lake,033,64148,9982,9519,821,10340,125
2022-02-07,Lassen,035,31185,8530,8362,852,9214,55
2022-02-07,Los Angeles,037,10098052,2646738,2607438,121605,2729043,29210
2022-02-07,Madera,039,155013,35868,35083,5685,40768,330
2022-02-07,Marin,041,260295,32117,31670,2111,33781,255
2022-02-07,Mariposa,043,17540,2285,2253,177,2430,6
2022-02-07,Mendocino,045,87422,12494,12237,2703,14940,107
2022-02-07,Merced,047,269075,60177,59472,7988,67460,748
2022-02-07,Modoc,049,8938,699,679,232,911,6
2022-02-07,Mono,051,14174,2937,2917,118,3035,5
2022-02-07,Monterey,053,433212,76299,69433,12496,81929,670
2022-02-07,Napa,055,140530,24517,23237,893,24130,120
2022-02-07,Nevada,057,99092,15457,15268,1132,16400,113
2022-02-07,Orange,059,3164182,534199,531442,40042,571484,6179
2022-02-07,Placer,061,380077,60990,59894,7158,67052,546
2022-02-07,Plumas,063,18699,2861,2573,316,2889,13
2022-02-07,Riverside,065,2383286,578972,568874,27107,595981,5868
2022-02-07,Sacramento,067,1510023,271776,262834,25786,288620,2631
2022-02-07,San Benito,069,59416,12491,12285,498,12783,90
2022-02-07,San Bernardino,071,2135413,556415,542846,24288,567134,6335
2022-02-07,San Diego,073,3302833,729377,716244,50150,766394,4811
2022-02-07,San Francisco,075,870044,118269,113945,7955,121900,727
2022-02-07,San Joaquin,077,732212,161326,159358,9368,168726,1998
2022-02-07,San Luis Obispo,079,281455,50180,48994,3537,52531,406
2022-02-07,San Mateo,081,765935,117121,107060,6601,113661,589
2022-02-07,Santa Barbara,083,443738,82955,81608,4579,86187,624
2022-02-07,Santa Clara,085,1922200,297423,293360,11738,305098,2085
2022-02-07,Santa Cruz,087,273765,44790,43244,2055,45299,239
2022-02-07,Shasta,089,179085,29356,28900,5844,34744,468
2022-02-07,Sierra,091,2930,268,265,44,309,0
2022-02-07,Siskiyou,093,43540,4257,4157,2585,6742,68
2022-02-07,Solano,095,438530,78073,73934,5311,79245,420
2022-02-07,Sonoma,097,501317,80177,78296,2410,80706,431
2022-02-07,Stanislaus,099,539301,113971,113029,16356,129385,1406
2022-02-07,Sutter,101,95872,19835,19599,1918,21517,203
2022-02-07,Tehama,103,63373,11623,11418,2564,13982,146
2022-02-07,Trinity,105,12862,1132,1109,275,1384,20
2022-02-07,Tulare,107,460477,103131,98774,27195,125969,1263
2022-02-07,Tuolumne,109,53932,12146,11578,518,12096,92
2022-02-07,Ventura,111,848112,168829,166904,9074,175978,1324
2022-02-07,Yolo,113,214977,35329,34007,2988,36995,281
2022-02-07,Yuba,115,75493,15246,14998,1102,16100,105
2022-02-06,Alameda,001,1643700,244508,237188,13050,250238,1643
2022-02-06,Alpine,003,1148,120,123,1,124,0
2022-02-06,Amador,005,37829,8126,7922,588,8510,73
2022-02-06,Butte,007,227075,31636,31021,6285,37306,355
2022-02-06,Calaveras,009,45235,7000,6870,317,7187,99
2022-02-06,Colusa,011,21464,3340,3282,1040,4322,21
2022-02-06,Contra Costa,013,1133247,180968,176863,12237,189100,1128
2022-02-06,Del Norte,015,27424,5200,5038,153,5191,44
2022-02-06,El Dorado,017,186661,25884,25165,3070,28235,185
2022-02-06,Fresno,019,978130,221349,214726,22555,237281,2489
2022-02-06,Glenn,021,27897,4822,4738,1556,6294,39
2022-02-06,Humboldt,023,135768,15901,15658,2639,18297,128
2022-02-06,Imperial,025,180216,53661,52396,10266,62662,853
2022-02-06,Inyo,027,18085,3993,3970,436,4406,51
2022-02-06,Kern,029,883053,185968,181188,44302,225490,1996
2022-02-06,Kings,031,150075,49294,47669,3431,51100,401
2022-02-06,Lake,033,64148,9914,9468,803,10271,125
2022-02-06,Lassen,035,31185,8511,8326,847,9173,55
2022-02-06,Los Angeles,037,10098052,2641234,2602620,121338,2723958,29180
2022-02-06,Madera,039,155013,35683,34901,5591,40492,330
2022-02-06,Marin,041,260295,32020,31488,2098,33586,255
2022-02-06,Mariposa,043,17540,2277,2244,166,2410,6
2022-02-06,Mendocino,045,87422,12451,12169,2633,14802,107
2022-02-06,Merced,047,269075,59958,59112,7826,66938,748
2022-02-06,Modoc,049,8938,694,675,231,906,6
2022-02-06,Mono,051,14174,2932,2901,116,3017,5
2022-02-06,Monterey,053,433212,75934,67912,12331,80243,670
2022-02-06,Napa,055,140530,24398,23230,885,24115,120
2022-02-06,Nevada,057,99092,15392,15192,1119,16311,113
2022-02-06,Orange,059,3164182,533252,527906,39941,567847,6171
2022-02-06,Placer,061,380077,60814,59507,7132,66639,544
2022-02-06,Plumas,063,18699,2847,2559,307,2866,13
2022-02-06,Riverside,065,2383286,577838,568276,27028,595304,5865
2022-02-06,Sacramento,067,1510023,270899,261353,25514,286867,2631
2022-02-06,San Benito,069,59416,12436,12186,490,12676,90
2022-02-06,San Bernardino,071,2135413,555452,541103,24218,565321,6334
2022-02-06,San Diego,073,3302833,727297,709938,49910,759848,4786
2022-02-06,San Francisco,075,870044,117887,113115,7928,121043,728
2022-02-06,San Joaquin,077,732212,160765,158510,9328,167838,1997
2022-02-06,San Luis Obispo,079,281455,49956,48843,3480,52323,405
2022-02-06,San Mateo,081,765935,116781,105556,6561,112117,587
2022-02-06,Santa Barbara,083,443738,82638,81118,4540,85658,623
2022-02-06,Santa Clara,085,1922200,296303,291732,11617,303349,2075
2022-02-06,Santa Cruz,087,273765,44476,42952,2040,44992,239
2022-02-06,Shasta,089,179085,29228,28762,5794,34556,468
2022-02-06,Sierra,091,2930,268,265,44,309,0
2022-02-06,Siskiyou,093,43540,4236,4118,2559,6677,68
2022-02-06,Solano,095,438530,77774,73475,5270,78745,419
2022-02-06,Sonoma,097,501317,79841,77887,2395,80282,431
2022-02-06,Stanislaus,099,539301,113573,112521,16212,128733,1406
2022-02-06,Sutter,101,95872,19791,19523,1875,21398,203
2022-02-06,Tehama,103,63373,11583,11366,2544,13910,146
2022-02-06,Trinity,105,12862,1131,1102,274,1376,20
2022-02-06,Tulare,107,460477,102686,98260,26990,125250,1262
2022-02-06,Tuolumne,109,53932,12095,11507,501,12008,92
2022-02-06,Ventura,111,848112,168453,166235,9063,175298,1323
2022-02-06,Yolo,113,214977,35189,33784,2972,36756,281
2022-02-06,Yuba,115,75493,15199,14917,1093,16010,104
2022-02-05,Alameda,001,1643700,244099,235698,13041,248739,1638
2022-02-05,Alpine,003,1148,120,124,1,125,0
2022-02-05,Amador,005,37829,8117,7855,585,8440,71
2022-02-05,Butte,007,227075,31583,30733,6271,37004,355
2022-02-05,Calaveras,009,45235,6984,6789,317,7106,99
2022-02-05,Colusa,011,21464,3333,3234,1038,4272,21
2022-02-05,Contra Costa,013,1133247,180699,175871,12221,188092,1115
2022-02-05,Del Norte,015,27424,5160,4978,151,5129,44
2022-02-05,El Dorado,017,186661,25854,24813,3068,27881,185
2022-02-05,Fresno,019,978130,221006,213539,22531,236070,2477
2022-02-05,Glenn,021,27897,4820,4691,1549,6240,39
2022-02-05,Humboldt,023,135768,15854,15514,2635,18149,127
2022-02-05,Imperial,025,180216,53600,52153,10253,62406,853
2022-02-05,Inyo,027,18085,3990,3948,436,4384,51
2022-02-05,Kern,029,883053,185761,180296,44197,224493,1987
2022-02-05,Kings,031,150075,49210,47538,3424,50962,402
2022-02-05,Lake,033,64148,9895,9289,796,10085,124
2022-02-05,Lassen,035,31185,8500,8288,845,9133,55
2022-02-05,Los Angeles,037,10098052,2639067,2572702,121211,2693913,28947
2022-02-05,Madera,039,155013,35630,34471,5579,40050,329
2022-02-05,Marin,041,260295,31973,31299,2094,33393,255
2022-02-05,Mariposa,043,17540,2276,2222,165,2387,6
2022-02-05,Mendocino,045,87422,12423,12066,2631,14697,107
2022-02-05,Merced,047,269075,59865,58908,7818,66726,744
2022-02-05,Modoc,049,8938,693,664,231,895,6
2022-02-05,Mono,051,14174,2931,2904,116,3020,5
2022-02-05,Monterey,053,433212,75818,67342,12287,79629,666
2022-02-05,Napa,055,140530,24343,22973,884,23857,118
2022-02-05,Nevada,057,99092,15371,15002,1114,16116,113
2022-02-05,Orange,059,3164182,532811,527516,39850,567366,6134
2022-02-05,Placer,061,380077,60689,59043,7118,66161,533
2022-02-05,Plumas,063,18699,2846,2550,306,2856,13
2022-02-05,Riverside,065,2383286,577241,563991,26957,590948,5827
2022-02-05,Sacramento,067,1510023,270503,259437,25476,284913,2610
2022-02-05,San Benito,069,59416,12391,12142,490,12632,90
2022-02-05,San Bernardino,071,2135413,554948,539312,24196,563508,6322
2022-02-05,San Diego,073,3302833,726428,703957,49837,753794,4735
2022-02-05,San Francisco,075,870044,117678,112481,7899,120380,720
2022-02-05,San Joaquin,077,732212,160579,157420,9317,166737,1989
2022-02-05,San Luis Obispo,079,281455,49919,48361,3478,51839,404
2022-02-05,San Mateo,081,765935,116594,104810,6553,111363,587
2022-02-05,Santa Barbara,083,443738,82477,80478,4528,85006,617
2022-02-05,Santa Clara,085,1922200,295644,289262,11601,300863,2067
2022-02-05,Santa Cruz,087,273765,44403,42553,2037,44590,239
2022-02-05,Shasta,089,179085,29186,28604,5784,34388,466
2022-02-05,Sierra,091,2930,268,262,44,306,0
2022-02-05,Siskiyou,093,43540,4229,4106,2546,6652,67
2022-02-05,Solano,095,438530,77699,73112,5262,78374,415
2022-02-05,Sonoma,097,501317,79677,77213,2391,79604,431
2022-02-05,Stanislaus,099,539301,113372,111783,16192,127975,1406
2022-02-05,Sutter,101,95872,19762,19406,1869,21275,203
2022-02-05,Tehama,103,63373,11564,11259,2537,13796,146
2022-02-05,Trinity,105,12862,1129,1085,274,1359,20
2022-02-05,Tulare,107,460477,102521,97414,26907,124321,1254
2022-02-05,Tuolumne,109,53932,12070,11409,498,11907,91
2022-02-05,Ventura,111,848112,168229,165532,9047,174579,1308
2022-02-05,Yolo,113,214977,35106,33614,2958,36572,281
2022-02-05,Yuba,115,75493,15169,14801,1085,15886,105
2022-02-04,Alameda,001,1643700,243614,235698,13031,248729,1638
2022-02-04,Alpine,003,1148,120,124,1,125,0
2022-02-04,Amador,005,37829,8101,7855,581,8436,71
2022-02-04,Butte,007,227075,31523,30733,6260,36993,355
2022-02-04,Calaveras,009,45235,6974,6789,315,7104,99
2022-02-04,Colusa,011,21464,3328,3234,1036,4270,21
2022-02-04,Contra Costa,013,1133247,180375,175871,12192,188063,1115
2022-02-04,Del Norte,015,27424,5140,4978,151,5129,44
2022-02-04,El Dorado,017,186661,25818,24813,3063,27876,185
2022-02-04,Fresno,019,978130,220524,213539,22497,236036,2477
2022-02-04,Glenn,021,27897,4811,4691,1546,6237,39
2022-02-04,Humboldt,023,135768,15829,15514,2632,18146,127
2022-02-04,Imperial,025,180216,53528,52153,10236,62389,853
2022-02-04,Inyo,027,18085,3987,3948,435,4383,51
2022-02-04,Kern,029,883053,185537,180296,44069,224365,1987
2022-02-04,Kings,031,150075,49134,47538,3417,50955,402
2022-02-04,Lake,033,64148,9873,9289,793,10082,124
2022-02-04,Lassen,035,31185,8477,8288,845,9133,55
2022-02-04,Los Angeles,037,10098052,2636436,2572702,121082,2693784,28947
2022-02-04,Madera,039,155013,35546,34471,5571,40042,329
2022-02-04,Marin,041,260295,31908,31299,2085,33384,255
2022-02-04,Mariposa,043,17540,2274,2222,163,2385,6
2022-02-04,Mendocino,045,87422,12392,12066,2629,14695,107
2022-02-04,Merced,047,269075,59786,58908,7808,66716,744
2022-02-04,Modoc,049,8938,693,664,231,895,6
2022-02-04,Mono,051,14174,2929,2904,116,3020,5
2022-02-04,Monterey,053,433212,75627,67342,12244,79586,666
2022-02-04,Napa,055,140530,24296,22973,880,23853,118
2022-02-04,Nevada,057,99092,15337,15002,1110,16112,113
2022-02-04,Orange,059,3164182,532261,527516,39792,567308,6134
2022-02-04,Placer,061,380077,60587,59043,7107,66150,533
2022-02-04,Plumas,063,18699,2840,2550,305,2855,13
2022-02-04,Riverside,065,2383286,576536,563991,26944,590935,5827
2022-02-04,Sacramento,067,1510023,270004,259437,25453,284890,2610
2022-02-04,San Benito,069,59416,12372,12142,488,12630,90
2022-02-04,San Bernardino,071,2135413,554374,539312,24174,563486,6322
2022-02-04,San Diego,073,3302833,725294,703957,49763,753720,4735
2022-02-04,San Francisco,075,870044,117435,112481,7874,120355,720
2022-02-04,San Joaquin,077,732212,160350,157420,9305,166725,1989
2022-02-04,San Luis Obispo,079,281455,49858,48361,3471,51832,404
2022-02-04,San Mateo,081,765935,116366,104810,6539,111349,587
2022-02-04,Santa Barbara,083,443738,82327,80478,4527,85005,617
2022-02-04,Santa Clara,085,1922200,294971,289262,11580,300842,2067
2022-02-04,Santa Cruz,087,273765,44198,42553,2033,44586,239
2022-02-04,Shasta,089,179085,29137,28604,5773,34377,466
2022-02-04,Sierra,091,2930,268,262,44,306,0
2022-02-04,Siskiyou,093,43540,4221,4106,2539,6645,67
2022-02-04,Solano,095,438530,77507,73112,5226,78338,415
2022-02-04,Sonoma,097,501317,79521,77213,2310,79523,431
2022-02-04,Stanislaus,099,539301,113190,111783,16165,127948,1406
2022-02-04,Sutter,101,95872,19738,19406,1862,21268,203
2022-02-04,Tehama,103,63373,11549,11259,2536,13795,146
2022-02-04,Trinity,105,12862,1128,1085,273,1358,20
2022-02-04,Tulare,107,460477,102335,97414,26824,124238,1254
2022-02-04,Tuolumne,109,53932,12057,11409,497,11906,91
2022-02-04,Ventura,111,848112,167960,165532,9039,174571,1308
2022-02-04,Yolo,113,214977,35015,33614,2951,36565,281
2022-02-04,Yuba,115,75493,15151,14801,1085,15886,105
2022-02-03,Alameda,001,1643700,242846,235698,12969,248667,1638
2022-02-03,Alpine,003,1148,120,124,1,125,0
2022-02-03,Amador,005,37829,8081,7855,576,8431,71
2022-02-03,Butte,007,227075,31414,30733,6232,36965,355
2022-02-03,Calaveras,009,45235,6943,6789,311,7100,99
2022-02-03,Colusa,011,21464,3315,3234,1034,4268,21
2022-02-03,Contra Costa,013,1133247,179780,175871,12091,187962,1115
2022-02-03,Del Norte,015,27424,5099,4978,148,5126,44
2022-02-03,El Dorado,017,186661,25745,24813,3057,27870,185
2022-02-03,Fresno,019,978130,219590,213539,22324,235863,2477
2022-02-03,Glenn,021,27897,4794,4691,1528,6219,39
2022-02-03,Humboldt,023,135768,15752,15514,2596,18110,127
2022-02-03,Imperial,025,180216,53386,52153,10185,62338,853
2022-02-03,Inyo,027,18085,3984,3948,431,4379,51
2022-02-03,Kern,029,883053,185073,180296,43852,224148,1987
2022-02-03,Kings,031,150075,48974,47538,3409,50947,402
2022-02-03,Lake,033,64148,9820,9289,787,10076,124
2022-02-03,Lassen,035,31185,8450,8288,844,9132,55
2022-02-03,Los Angeles,037,10098052,2631013,2572702,120813,2693515,28947
2022-02-03,Madera,039,155013,35407,34471,5525,39996,329
2022-02-03,Marin,041,260295,31812,31299,2080,33379,255
2022-02-03,Mariposa,043,17540,2262,2222,160,2382,6
2022-02-03,Mendocino,045,87422,12348,12066,2605,14671,107
2022-02-03,Merced,047,269075,59637,58908,7712,66620,744
2022-02-03,Modoc,049,8938,690,664,231,895,6
2022-02-03,Mono,051,14174,2924,2904,115,3019,5
2022-02-03,Monterey,053,433212,75340,67342,12044,79386,666
2022-02-03,Napa,055,140530,24163,22973,880,23853,118
2022-02-03,Nevada,057,99092,15296,15002,1099,16101,113
2022-02-03,Orange,059,3164182,531337,527516,39699,567215,6134
2022-02-03,Placer,061,380077,60385,59043,7084,66127,533
2022-02-03,Plumas,063,18699,2826,2550,301,2851,13
2022-02-03,Riverside,065,2383286,575340,563991,26873,590864,5827
2022-02-03,Sacramento,067,1510023,269051,259437,25259,284696,2610
2022-02-03,San Benito,069,59416,12345,12142,485,12627,90
2022-02-03,San Bernardino,071,2135413,553361,539312,24136,563448,6322
2022-02-03,San Diego,073,3302833,723282,703957,49601,753558,4735
2022-02-03,San Francisco,075,870044,117100,112481,7843,120324,720
2022-02-03,San Joaquin,077,732212,159868,157420,9276,166696,1989
2022-02-03,San Luis Obispo,079,281455,49659,48361,3454,51815,404
2022-02-03,San Mateo,081,765935,116015,104810,6505,111315,587
2022-02-03,Santa Barbara,083,443738,81969,80478,4498,84976,617
2022-02-03,Santa Clara,085,1922200,293802,289262,11469,300731,2067
2022-02-03,Santa Cruz,087,273765,43857,42553,2026,44579,239
2022-02-03,Shasta,089,179085,29030,28604,5745,34349,466
2022-02-03,Sierra,091,2930,268,262,44,306,0
2022-02-03,Siskiyou,093,43540,4206,4106,2522,6628,67
2022-02-03,Solano,095,438530,77178,73112,5208,78320,415
2022-02-03,Sonoma,097,501317,79224,77213,2303,79516,431
2022-02-03,Stanislaus,099,539301,112819,111783,16082,127865,1406
2022-02-03,Sutter,101,95872,19686,19406,1843,21249,203
2022-02-03,Tehama,103,63373,11518,11259,2528,13787,146
2022-02-03,Trinity,105,12862,1126,1085,272,1357,20
2022-02-03,Tulare,107,460477,101922,97414,26676,124090,1254
2022-02-03,Tuolumne,109,53932,12016,11409,486,11895,91
2022-02-03,Ventura,111,848112,167575,165532,9029,174561,1308
2022-02-03,Yolo,113,214977,34910,33614,2938,36552,281
2022-02-03,Yuba,115,75493,15100,14801,1069,15870,105
2022-02-02,Alameda,001,1643700,241904,234300,12865,247165,1632
2022-02-02,Alpine,003,1148,120,123,1,124,0
2022-02-02,Amador,005,37829,8051,7781,566,8347,71
2022-02-02,Butte,007,227075,31305,30550,6201,36751,355
2022-02-02,Calaveras,009,45235,6914,6753,307,7060,99
2022-02-02,Colusa,011,21464,3300,3211,1033,4244,21
2022-02-02,Contra Costa,013,1133247,179191,174876,11993,186869,1113
2022-02-02,Del Norte,015,27424,5059,4924,143,5067,44
2022-02-02,El Dorado,017,186661,25678,24690,3038,27728,185
2022-02-02,Fresno,019,978130,218572,211976,22192,234168,2463
2022-02-02,Glenn,021,27897,4770,4667,1518,6185,39
2022-02-02,Humboldt,023,135768,15691,15392,2557,17949,127
2022-02-02,Imperial,025,180216,53187,51875,10057,61932,853
2022-02-02,Inyo,027,18085,3978,3944,430,4374,51
2022-02-02,Kern,029,883053,184477,179386,43633,223019,1974
2022-02-02,Kings,031,150075,48785,47061,3383,50444,401
2022-02-02,Lake,033,64148,9761,9235,780,10015,120
2022-02-02,Lassen,035,31185,8432,8258,835,9093,55
2022-02-02,Los Angeles,037,10098052,2624803,2561902,120424,2682326,28850
2022-02-02,Madera,039,155013,35236,34265,5451,39716,329
2022-02-02,Marin,041,260295,31712,31149,2070,33219,255
2022-02-02,Mariposa,043,17540,2251,2215,156,2371,6
2022-02-02,Mendocino,045,87422,12295,11996,2566,14562,105
2022-02-02,Merced,047,269075,59463,58532,7626,66158,744
2022-02-02,Modoc,049,8938,684,662,231,893,6
2022-02-02,Mono,051,14174,2913,2887,115,3002,5
2022-02-02,Monterey,053,433212,74948,66852,11856,78708,666
2022-02-02,Napa,055,140530,24042,22859,866,23725,117
2022-02-02,Nevada,057,99092,15239,14895,1075,15970,112
2022-02-02,Orange,059,3164182,530281,524418,39605,564023,6127
2022-02-02,Placer,061,380077,60191,58654,7053,65707,533
2022-02-02,Plumas,063,18699,2810,2540,297,2837,12
2022-02-02,Riverside,065,2383286,574057,561220,26825,588045,5827
2022-02-02,Sacramento,067,1510023,268044,258078,25044,283122,2602
2022-02-02,San Benito,069,59416,12306,12058,481,12539,90
2022-02-02,San Bernardino,071,2135413,552351,537485,24071,561556,6317
2022-02-02,San Diego,073,3302833,721042,703957,49421,753378,4735
2022-02-02,San Francisco,075,870044,116731,112008,7827,119835,714
2022-02-02,San Joaquin,077,732212,159294,156537,9252,165789,1986
2022-02-02,San Luis Obispo,079,281455,49460,48119,3441,51560,403
2022-02-02,San Mateo,081,765935,115643,104201,6437,110638,587
2022-02-02,Santa Barbara,083,443738,81626,79979,4467,84446,612
2022-02-02,Santa Clara,085,1922200,292650,287443,11354,298797,2051
2022-02-02,Santa Cruz,087,273765,43568,42127,2014,44141,239
2022-02-02,Shasta,089,179085,28930,28429,5700,34129,465
2022-02-02,Sierra,091,2930,268,262,44,306,0
2022-02-02,Siskiyou,093,43540,4196,4078,2495,6573,67
2022-02-02,Solano,095,438530,76824,72711,5185,77896,414
2022-02-02,Sonoma,097,501317,78913,76681,2290,78971,431
2022-02-02,Stanislaus,099,539301,112422,111167,15950,127117,1403
2022-02-02,Sutter,101,95872,19623,19290,1814,21104,203
2022-02-02,Tehama,103,63373,11463,11193,2509,13702,146
2022-02-02,Trinity,105,12862,1123,1074,270,1344,20
2022-02-02,Tulare,107,460477,101528,96820,26498,123318,1249
2022-02-02,Tuolumne,109,53932,11940,11342,483,11825,91
2022-02-02,Ventura,111,848112,167177,164905,9010,173915,1292
2022-02-02,Yolo,113,214977,34792,33332,2916,36248,281
2022-02-02,Yuba,115,75493,15035,14720,1061,15781,104
2022-02-01,Alameda,001,1643700,240827,233782,12759,246541,1620
2022-02-01,Alpine,003,1148,120,123,1,124,0
2022-02-01,Amador,005,37829,8005,7783,560,8343,73
2022-02-01,Butte,007,227075,31167,30496,6162,36658,355
2022-02-01,Calaveras,009,45235,6877,6749,303,7052,98
2022-02-01,Colusa,011,21464,3282,3202,1011,4213,21
2022-02-01,Contra Costa,013,1133247,178461,174379,11852,186231,1115
2022-02-01,Del Norte,015,27424,5012,4907,140,5047,44
2022-02-01,El Dorado,017,186661,25619,24664,3021,27685,184
2022-02-01,Fresno,019,978130,217405,211352,22025,233377,2464
2022-02-01,Glenn,021,27897,4756,4649,1508,6157,39
2022-02-01,Humboldt,023,135768,15610,15354,2527,17881,127
2022-02-01,Imperial,025,180216,52971,51675,9990,61665,846
2022-02-01,Inyo,027,18085,3968,3928,427,4355,51
2022-02-01,Kern,029,883053,183838,178987,43386,222373,1967
2022-02-01,Kings,031,150075,48527,46959,3359,50318,400
2022-02-01,Lake,033,64148,9704,9211,773,9984,119
2022-02-01,Lassen,035,31185,8413,8231,830,9061,55
2022-02-01,Los Angeles,037,10098052,2617638,2548794,120043,2668837,28752
2022-02-01,Madera,039,155013,35013,34124,5371,39495,329
2022-02-01,Marin,041,260295,31591,31099,2054,33153,255
2022-02-01,Mariposa,043,17540,2244,2210,155,2365,6
2022-02-01,Mendocino,045,87422,12233,11978,2529,14507,105
2022-02-01,Merced,047,269075,59278,58362,7501,65863,743
2022-02-01,Modoc,049,8938,677,664,231,895,6
2022-02-01,Mono,051,14174,2907,2888,115,3003,5
2022-02-01,Monterey,053,433212,74527,66553,11655,78208,665
2022-02-01,Napa,055,140530,23944,22795,849,23644,116
2022-02-01,Nevada,057,99092,15176,14863,1062,15925,112
2022-02-01,Orange,059,3164182,529133,523741,39462,563203,6108
2022-02-01,Placer,061,380077,59947,58486,7013,65499,532
2022-02-01,Plumas,063,18699,2795,2526,294,2820,12
2022-02-01,Riverside,065,2383286,572681,560010,26776,586786,5825
2022-02-01,Sacramento,067,1510023,266998,257504,24765,282269,2593
2022-02-01,San Benito,069,59416,12240,12053,478,12531,90
2022-02-01,San Bernardino,071,2135413,551104,536591,24008,560599,6311
2022-02-01,San Diego,073,3302833,718523,701009,49205,750214,4710
2022-02-01,San Francisco,075,870044,116264,111606,7808,119414,713
2022-02-01,San Joaquin,077,732212,158766,156300,9229,165529,1987
2022-02-01,San Luis Obispo,079,281455,49230,47842,3379,51221,403
2022-02-01,San Mateo,081,765935,115174,103868,6395,110263,589
2022-02-01,Santa Barbara,083,443738,81182,79659,4431,84090,608
2022-02-01,Santa Clara,085,1922200,291119,286109,11250,297359,2070
2022-02-01,Santa Cruz,087,273765,43270,41782,1998,43780,239
2022-02-01,Shasta,089,179085,28805,28382,5647,34029,465
2022-02-01,Sierra,091,2930,266,262,44,306,0
2022-02-01,Siskiyou,093,43540,4182,4072,2468,6540,66
2022-02-01,Solano,095,438530,76551,72494,5169,77663,415
2022-02-01,Sonoma,097,501317,78554,76379,2266,78645,431
2022-02-01,Stanislaus,099,539301,112008,110925,15848,126773,1403
2022-02-01,Sutter,101,95872,19555,19256,1781,21037,202
2022-02-01,Tehama,103,63373,11406,11165,2495,13660,146
2022-02-01,Trinity,105,12862,1119,1073,270,1343,19
2022-02-01,Tulare,107,460477,101033,96467,26277,122744,1247
2022-02-01,Tuolumne,109,53932,11891,11318,474,11792,91
2022-02-01,Ventura,111,848112,166674,164721,8987,173708,1293
2022-02-01,Yolo,113,214977,34656,33257,2887,36144,275
2022-02-01,Yuba,115,75493,14974,14693,1054,15747,103
2022-01-31,Alameda,001,1643700,239482,232743,12641,245384,1607
2022-01-31,Alpine,003,1148,119,123,1,124,0
2022-01-31,Amador,005,37829,7951,7682,543,8225,73
2022-01-31,Butte,007,227075,31003,30371,6123,36494,354
2022-01-31,Calaveras,009,45235,6845,6700,292,6992,96
2022-01-31,Colusa,011,21464,3271,3187,1002,4189,21
2022-01-31,Contra Costa,013,1133247,177662,173466,11724,185190,1115
2022-01-31,Del Norte,015,27424,4979,4879,136,5015,43
2022-01-31,El Dorado,017,186661,25516,24545,2991,27536,184
2022-01-31,Fresno,019,978130,215919,210589,21818,232407,2464
2022-01-31,Glenn,021,27897,4720,4641,1496,6137,39
2022-01-31,Humboldt,023,135768,15522,15308,2494,17802,126
2022-01-31,Imperial,025,180216,52757,51472,9873,61345,846
2022-01-31,Inyo,027,18085,3957,3922,421,4343,50
2022-01-31,Kern,029,883053,183059,178375,43059,221434,1967
2022-01-31,Kings,031,150075,48169,46845,3325,50170,398
2022-01-31,Lake,033,64148,9632,9141,761,9902,119
2022-01-31,Lassen,035,31185,8384,8162,824,8986,55
2022-01-31,Los Angeles,037,10098052,2609394,2541189,119633,2660822,28718
2022-01-31,Madera,039,155013,34802,33886,5275,39161,329
2022-01-31,Marin,041,260295,31468,31023,2037,33060,253
2022-01-31,Mariposa,043,17540,2234,2203,146,2349,6
2022-01-31,Mendocino,045,87422,12167,11896,2486,14382,104
2022-01-31,Merced,047,269075,59000,58198,7308,65506,740
2022-01-31,Modoc,049,8938,674,661,231,892,6
2022-01-31,Mono,051,14174,2893,2889,115,3004,5
2022-01-31,Monterey,053,433212,74077,66117,11433,77550,661
2022-01-31,Napa,055,140530,23777,22707,833,23540,113
2022-01-31,Nevada,057,99092,15099,14813,1049,15862,112
2022-01-31,Orange,059,3164182,527809,522358,39326,561684,6098
2022-01-31,Placer,061,380077,59700,58252,6980,65232,523
2022-01-31,Plumas,063,18699,2782,2513,292,2805,12
2022-01-31,Riverside,065,2383286,570869,558166,26709,584875,5785
2022-01-31,Sacramento,067,1510023,265706,256594,24505,281099,2571
2022-01-31,San Benito,069,59416,12181,11976,477,12453,90
2022-01-31,San Bernardino,071,2135413,549477,535276,23922,559198,6302
2022-01-31,San Diego,073,3302833,715599,698571,48946,747517,4686
2022-01-31,San Francisco,075,870044,115854,111119,7774,118893,712
2022-01-31,San Joaquin,077,732212,158012,155736,9195,164931,1985
2022-01-31,San Luis Obispo,079,281455,48977,47656,3320,50976,395
2022-01-31,San Mateo,081,765935,114661,103313,6335,109648,589
2022-01-31,Santa Barbara,083,443738,80675,79267,4389,83656,606
2022-01-31,Santa Clara,085,1922200,289439,284562,11143,295705,2041
2022-01-31,Santa Cruz,087,273765,42892,41630,1991,43621,239
2022-01-31,Shasta,089,179085,28676,28190,5606,33796,462
2022-01-31,Sierra,091,2930,266,261,44,305,0
2022-01-31,Siskiyou,093,43540,4166,4054,2452,6506,66
2022-01-31,Solano,095,438530,75845,72258,5123,77381,414
2022-01-31,Sonoma,097,501317,78097,76199,2236,78435,431
2022-01-31,Stanislaus,099,539301,111479,110493,15678,126171,1403
2022-01-31,Sutter,101,95872,19475,19189,1728,20917,202
2022-01-31,Tehama,103,63373,11344,11112,2465,13577,145
2022-01-31,Trinity,105,12862,1114,1071,267,1338,19
2022-01-31,Tulare,107,460477,100388,96053,26016,122069,1245
2022-01-31,Tuolumne,109,53932,11799,11278,467,11745,91
2022-01-31,Ventura,111,848112,166138,164060,8963,173023,1286
2022-01-31,Yolo,113,214977,34503,33175,2862,36037,274
2022-01-31,Yuba,115,75493,14912,14652,1034,15686,103
2022-01-30,Alameda,001,1643700,237947,231838,12489,244327,1607
2022-01-30,Alpine,003,1148,119,123,1,124,0
2022-01-30,Amador,005,37829,7900,7644,519,8163,73
2022-01-30,Butte,007,227075,30805,30255,6058,36313,354
2022-01-30,Calaveras,009,45235,6791,6676,278,6954,96
2022-01-30,Colusa,011,21464,3250,3168,990,4158,21
2022-01-30,Contra Costa,013,1133247,176710,172902,11520,184422,1102
2022-01-30,Del Norte,015,27424,4938,4833,133,4966,43
2022-01-30,El Dorado,017,186661,25396,24491,2964,27455,184
2022-01-30,Fresno,019,978130,214354,209645,21556,231201,2463
2022-01-30,Glenn,021,27897,4689,4619,1486,6105,39
2022-01-30,Humboldt,023,135768,15409,15247,2437,17684,126
2022-01-30,Imperial,025,180216,52433,51415,9697,61112,846
2022-01-30,Inyo,027,18085,3940,3921,418,4339,50
2022-01-30,Kern,029,883053,182198,177924,42734,220658,1967
2022-01-30,Kings,031,150075,47817,46654,3266,49920,398
2022-01-30,Lake,033,64148,9545,9080,740,9820,119
2022-01-30,Lassen,035,31185,8362,8158,816,8974,55
2022-01-30,Los Angeles,037,10098052,2599266,2530739,119152,2649891,28678
2022-01-30,Madera,039,155013,34507,33752,5087,38839,329
2022-01-30,Marin,041,260295,31321,30875,2023,32898,253
2022-01-30,Mariposa,043,17540,2222,2177,140,2317,6
2022-01-30,Mendocino,045,87422,12094,11860,2380,14240,104
2022-01-30,Merced,047,269075,58638,58006,7014,65020,740
2022-01-30,Modoc,049,8938,671,661,231,892,6
2022-01-30,Mono,051,14174,2887,2888,115,3003,5
2022-01-30,Monterey,053,433212,73491,65996,11147,77143,661
2022-01-30,Napa,055,140530,23609,22588,816,23404,114
2022-01-30,Nevada,057,99092,15011,14741,1033,15774,112
2022-01-30,Orange,059,3164182,526176,521334,39178,560512,6098
2022-01-30,Placer,061,380077,59364,58030,6939,64969,523
2022-01-30,Plumas,063,18699,2757,2510,278,2788,12
2022-01-30,Riverside,065,2383286,568819,557088,26607,583695,5767
2022-01-30,Sacramento,067,1510023,264250,255715,23998,279713,2572
2022-01-30,San Benito,069,59416,12116,11945,472,12417,90
2022-01-30,San Bernardino,071,2135413,547756,534050,23812,557862,6302
2022-01-30,San Diego,073,3302833,712013,687145,48523,735668,4665
2022-01-30,San Francisco,075,870044,115307,110772,7739,118511,712
2022-01-30,San Joaquin,077,732212,157030,155165,9160,164325,1985
2022-01-30,San Luis Obispo,079,281455,48579,47599,3282,50881,394
2022-01-30,San Mateo,081,765935,114088,102979,6288,109267,589
2022-01-30,Santa Barbara,083,443738,79996,79072,4328,83400,606
2022-01-30,Santa Clara,085,1922200,287448,282846,11012,293858,2035
2022-01-30,Santa Cruz,087,273765,42436,41330,1981,43311,239
2022-01-30,Shasta,089,179085,28513,28105,5520,33625,462
2022-01-30,Sierra,091,2930,266,261,44,305,0
2022-01-30,Siskiyou,093,43540,4136,4039,2405,6444,66
2022-01-30,Solano,095,438530,75321,71857,5076,76933,414
2022-01-30,Sonoma,097,501317,77581,75890,2208,78098,431
2022-01-30,Stanislaus,099,539301,110822,110111,15478,125589,1403
2022-01-30,Sutter,101,95872,19382,19108,1631,20739,202
2022-01-30,Tehama,103,63373,11271,11071,2435,13506,145
2022-01-30,Trinity,105,12862,1108,1068,267,1335,19
2022-01-30,Tulare,107,460477,99641,95676,25720,121396,1245
2022-01-30,Tuolumne,109,53932,11691,11242,430,11672,91
2022-01-30,Ventura,111,848112,165556,163521,8933,172454,1286
2022-01-30,Yolo,113,214977,34300,33043,2828,35871,274
2022-01-30,Yuba,115,75493,14822,14584,1014,15598,103
2022-01-29,Alameda,001,1643700,237273,225602,12472,238074,1605
2022-01-29,Alpine,003,1148,119,123,1,124,0
2022-01-29,Amador,005,37829,7878,7505,516,8021,73
2022-01-29,Butte,007,227075,30720,29557,6034,35591,353
2022-01-29,Calaveras,009,45235,6772,6484,278,6762,96
2022-01-29,Colusa,011,21464,3244,3107,986,4093,21
2022-01-29,Contra Costa,013,1133247,176188,168003,11490,179493,1101
2022-01-29,Del Norte,015,27424,4920,4589,130,4719,43
2022-01-29,El Dorado,017,186661,25353,24008,2957,26965,184
2022-01-29,Fresno,019,978130,213896,202691,21515,224206,2457
2022-01-29,Glenn,021,27897,4682,4516,1479,5995,39
2022-01-29,Humboldt,023,135768,15362,14812,2430,17242,126
2022-01-29,Imperial,025,180216,52318,50153,9641,59794,845
2022-01-29,Inyo,027,18085,3938,3895,410,4305,50
2022-01-29,Kern,029,883053,181858,174456,42567,217023,1962
2022-01-29,Kings,031,150075,47701,45047,3259,48306,397
2022-01-29,Lake,033,64148,9512,8747,736,9483,119
2022-01-29,Lassen,035,31185,8344,7961,813,8774,55
2022-01-29,Los Angeles,037,10098052,2595370,2473332,118883,2592215,28467
2022-01-29,Madera,039,155013,34398,32753,5056,37809,329
2022-01-29,Marin,041,260295,31255,30137,2021,32158,253
2022-01-29,Mariposa,043,17540,2220,2117,138,2255,6
2022-01-29,Mendocino,045,87422,12070,11591,2364,13955,104
2022-01-29,Merced,047,269075,58532,56472,7009,63481,735
2022-01-29,Modoc,049,8938,671,654,231,885,6
2022-01-29,Mono,051,14174,2885,2860,115,2975,5
2022-01-29,Monterey,053,433212,73337,64090,11082,75172,658
2022-01-29,Napa,055,140530,23552,22121,814,22935,113
2022-01-29,Nevada,057,99092,14977,14337,1030,15367,112
2022-01-29,Orange,059,3164182,525472,511255,39071,550326,6038
2022-01-29,Placer,061,380077,59170,56562,6923,63485,523
2022-01-29,Plumas,063,18699,2747,2463,274,2737,12
2022-01-29,Riverside,065,2383286,567800,548121,26565,574686,5726
2022-01-29,Sacramento,067,1510023,263609,249130,23951,273081,2558
2022-01-29,San Benito,069,59416,12059,11670,471,12141,90
2022-01-29,San Bernardino,071,2135413,547011,525249,23767,549016,6297
2022-01-29,San Diego,073,3302833,710681,683027,48425,731452,4643
2022-01-29,San Francisco,075,870044,115032,108265,7691,115956,712
2022-01-29,San Joaquin,077,732212,156785,150849,9138,159987,1971
2022-01-29,San Luis Obispo,079,281455,48490,46374,3278,49652,391
2022-01-29,San Mateo,081,765935,113751,100306,6265,106571,586
2022-01-29,Santa Barbara,083,443738,79774,76546,4321,80867,604
2022-01-29,Santa Clara,085,1922200,286504,273879,10984,284863,2019
2022-01-29,Santa Cruz,087,273765,42307,39228,1979,41207,240
2022-01-29,Shasta,089,179085,28456,27504,5506,33010,452
2022-01-29,Sierra,091,2930,266,260,43,303,0
2022-01-29,Siskiyou,093,43540,4126,3987,2398,6385,66
2022-01-29,Solano,095,438530,75178,69862,5064,74926,407
2022-01-29,Sonoma,097,501317,77367,73439,2203,75642,427
2022-01-29,Stanislaus,099,539301,110573,107668,15431,123099,1403
2022-01-29,Sutter,101,95872,19333,18797,1614,20411,202
2022-01-29,Tehama,103,63373,11237,10880,2426,13306,145
2022-01-29,Trinity,105,12862,1105,1033,266,1299,19
2022-01-29,Tulare,107,460477,99386,93154,25642,118796,1237
2022-01-29,Tuolumne,109,53932,11666,10806,422,11228,91
2022-01-29,Ventura,111,848112,165226,160466,8915,169381,1271
2022-01-29,Yolo,113,214977,34190,32123,2812,34935,275
2022-01-29,Yuba,115,75493,14781,14295,1012,15307,103
2022-01-28,Alameda,001,1643700,236330,225602,12454,238056,1605
2022-01-28,Alpine,003,1148,119,123,1,124,0
2022-01-28,Amador,005,37829,7852,7505,515,8020,73
2022-01-28,Butte,007,227075,30644,29557,6015,35572,353
2022-01-28,Calaveras,009,45235,6755,6484,277,6761,96
2022-01-28,Colusa,011,21464,3239,3107,984,4091,21
2022-01-28,Contra Costa,013,1133247,175664,168003,11453,179456,1101
2022-01-28,Del Norte,015,27424,4896,4589,129,4718,43
2022-01-28,El Dorado,017,186661,25308,24008,2951,26959,184
2022-01-28,Fresno,019,978130,213025,202691,21457,224148,2457
2022-01-28,Glenn,021,27897,4669,4516,1477,5993,39
2022-01-28,Humboldt,023,135768,15326,14812,2420,17232,126
2022-01-28,Imperial,025,180216,52189,50153,9609,59762,845
2022-01-28,Inyo,027,18085,3934,3895,407,4302,50
2022-01-28,Kern,029,883053,181448,174456,42408,216864,1962
2022-01-28,Kings,031,150075,47570,45047,3249,48296,397
2022-01-28,Lake,033,64148,9480,8747,734,9481,119
2022-01-28,Lassen,035,31185,8275,7961,811,8772,55
2022-01-28,Los Angeles,037,10098052,2589632,2473332,118669,2592001,28467
2022-01-28,Madera,039,155013,34270,32753,5039,37792,329
2022-01-28,Marin,041,260295,31163,30137,1999,32136,253
2022-01-28,Mariposa,043,17540,2210,2117,136,2253,6
2022-01-28,Mendocino,045,87422,12026,11591,2362,13953,104
2022-01-28,Merced,047,269075,58434,56472,6994,63466,735
2022-01-28,Modoc,049,8938,670,654,231,885,6
2022-01-28,Mono,051,14174,2880,2860,114,2974,5
2022-01-28,Monterey,053,433212,73135,64090,11033,75123,658
2022-01-28,Napa,055,140530,23474,22121,812,22933,113
2022-01-28,Nevada,057,99092,14940,14337,1028,15365,112
2022-01-28,Orange,059,3164182,524401,511255,38981,550236,6038
2022-01-28,Placer,061,380077,58965,56562,6900,63462,523
2022-01-28,Plumas,063,18699,2739,2463,272,2735,12
2022-01-28,Riverside,065,2383286,566472,548121,26524,574645,5726
2022-01-28,Sacramento,067,1510023,262828,249130,23897,273027,2558
2022-01-28,San Benito,069,59416,12037,11670,466,12136,90
2022-01-28,San Bernardino,071,2135413,545973,525249,23731,548980,6297
2022-01-28,San Diego,073,3302833,708848,683027,48349,731376,4643
2022-01-28,San Francisco,075,870044,114677,108265,7642,115907,712
2022-01-28,San Joaquin,077,732212,156497,150849,9124,159973,1971
2022-01-28,San Luis Obispo,079,281455,48406,46374,3270,49644,391
2022-01-28,San Mateo,081,765935,113399,100306,6243,106549,586
2022-01-28,Santa Barbara,083,443738,79526,76546,4319,80865,604
2022-01-28,Santa Clara,085,1922200,285305,273879,10935,284814,2019
2022-01-28,Santa Cruz,087,273765,42125,39228,1966,41194,240
2022-01-28,Shasta,089,179085,28399,27504,5492,32996,452
2022-01-28,Sierra,091,2930,266,260,43,303,0
2022-01-28,Siskiyou,093,43540,4116,3987,2394,6381,66
2022-01-28,Solano,095,438530,74626,69862,4997,74859,407
2022-01-28,Sonoma,097,501317,77164,73439,2194,75633,427
2022-01-28,Stanislaus,099,539301,110300,107668,15389,123057,1403
2022-01-28,Sutter,101,95872,19289,18797,1612,20409,202
2022-01-28,Tehama,103,63373,11205,10880,2419,13299,145
2022-01-28,Trinity,105,12862,1096,1033,266,1299,19
2022-01-28,Tulare,107,460477,99107,93154,25532,118686,1237
2022-01-28,Tuolumne,109,53932,11633,10806,418,11224,91
2022-01-28,Ventura,111,848112,164772,160466,8896,169362,1271
2022-01-28,Yolo,113,214977,34086,32123,2805,34928,275
2022-01-28,Yuba,115,75493,14741,14295,1007,15302,103
2022-01-27,Alameda,001,1643700,234752,225602,12318,237920,1605
2022-01-27,Alpine,003,1148,119,123,1,124,0
2022-01-27,Amador,005,37829,7805,7505,503,8008,73
2022-01-27,Butte,007,227075,30493,29557,5963,35520,353
2022-01-27,Calaveras,009,45235,6730,6484,261,6745,96
2022-01-27,Colusa,011,21464,3224,3107,980,4087,21
2022-01-27,Contra Costa,013,1133247,174658,168003,11277,179280,1101
2022-01-27,Del Norte,015,27424,4852,4589,125,4714,43
2022-01-27,El Dorado,017,186661,25197,24008,2931,26939,184
2022-01-27,Fresno,019,978130,211394,202691,21240,223931,2457
2022-01-27,Glenn,021,27897,4637,4516,1469,5985,39
2022-01-27,Humboldt,023,135768,15237,14812,2383,17195,126
2022-01-27,Imperial,025,180216,51918,50153,9494,59647,845
2022-01-27,Inyo,027,18085,3927,3895,397,4292,50
2022-01-27,Kern,029,883053,180671,174456,42043,216499,1962
2022-01-27,Kings,031,150075,47225,45047,3210,48257,397
2022-01-27,Lake,033,64148,9427,8747,717,9464,119
2022-01-27,Lassen,035,31185,8232,7961,805,8766,55
2022-01-27,Los Angeles,037,10098052,2578485,2473332,118153,2591485,28467
2022-01-27,Madera,039,155013,34061,32753,4932,37685,329
2022-01-27,Marin,041,260295,31001,30137,1984,32121,253
2022-01-27,Mariposa,043,17540,2187,2117,133,2250,6
2022-01-27,Mendocino,045,87422,11975,11591,2313,13904,104
2022-01-27,Merced,047,269075,58175,56472,6829,63301,735
2022-01-27,Modoc,049,8938,668,654,230,884,6
2022-01-27,Mono,051,14174,2875,2860,114,2974,5
2022-01-27,Monterey,053,433212,72513,64090,10778,74868,658
2022-01-27,Napa,055,140530,23315,22121,784,22905,113
2022-01-27,Nevada,057,99092,14867,14337,1000,15337,112
2022-01-27,Orange,059,3164182,522674,511255,38845,550100,6038
2022-01-27,Placer,061,380077,58647,56562,6846,63408,523
2022-01-27,Plumas,063,18699,2728,2463,260,2723,12
2022-01-27,Riverside,065,2383286,564307,548121,26454,574575,5726
2022-01-27,Sacramento,067,1510023,261553,249130,23565,272695,2558
2022-01-27,San Benito,069,59416,11981,11670,461,12131,90
2022-01-27,San Bernardino,071,2135413,544092,525249,23631,548880,6297
2022-01-27,San Diego,073,3302833,705475,683027,47998,731025,4643
2022-01-27,San Francisco,075,870044,114173,108265,7581,115846,712
2022-01-27,San Joaquin,077,732212,155642,150849,9056,159905,1971
2022-01-27,San Luis Obispo,079,281455,48134,46374,3232,49606,391
2022-01-27,San Mateo,081,765935,112816,100306,6174,106480,586
2022-01-27,Santa Barbara,083,443738,79046,76546,4263,80809,604
2022-01-27,Santa Clara,085,1922200,283221,273879,10787,284666,2019
2022-01-27,Santa Cruz,087,273765,41464,39228,1947,41175,240
2022-01-27,Shasta,089,179085,28266,27504,5443,32947,452
2022-01-27,Sierra,091,2930,265,260,42,302,0
2022-01-27,Siskiyou,093,43540,4095,3987,2357,6344,66
2022-01-27,Solano,095,438530,73988,69862,4948,74810,407
2022-01-27,Sonoma,097,501317,76698,73439,2180,75619,427
2022-01-27,Stanislaus,099,539301,109773,107668,15247,122915,1403
2022-01-27,Sutter,101,95872,19184,18797,1586,20383,202
2022-01-27,Tehama,103,63373,11153,10880,2403,13283,145
2022-01-27,Trinity,105,12862,1092,1033,265,1298,19
2022-01-27,Tulare,107,460477,98438,93154,25245,118399,1237
2022-01-27,Tuolumne,109,53932,11581,10806,409,11215,91
2022-01-27,Ventura,111,848112,164121,160466,8864,169330,1271
2022-01-27,Yolo,113,214977,33944,32123,2788,34911,275
2022-01-27,Yuba,115,75493,14662,14295,991,15286,103
2022-01-26,Alameda,001,1643700,232871,222680,12145,234825,1596
2022-01-26,Alpine,003,1148,119,123,1,124,0
2022-01-26,Amador,005,37829,7729,7427,488,7915,73
2022-01-26,Butte,007,227075,30296,29229,5908,35137,353
2022-01-26,Calaveras,009,45235,6692,6387,254,6641,96
2022-01-26,Colusa,011,21464,3208,3094,973,4067,21
2022-01-26,Contra Costa,013,1133247,173531,165972,11114,177086,1095
2022-01-26,Del Norte,015,27424,4795,4542,124,4666,43
2022-01-26,El Dorado,017,186661,25076,23819,2908,26727,181
2022-01-26,Fresno,019,978130,209543,199689,21021,220710,2452
2022-01-26,Glenn,021,27897,4604,4472,1464,5936,39
2022-01-26,Humboldt,023,135768,15138,14715,2338,17053,126
2022-01-26,Imperial,025,180216,51561,49477,9346,58823,839
2022-01-26,Inyo,027,18085,3924,3889,366,4255,50
2022-01-26,Kern,029,883053,179752,173052,41698,214750,1953
2022-01-26,Kings,031,150075,46821,44367,3180,47547,396
2022-01-26,Lake,033,64148,9346,8645,707,9352,119
2022-01-26,Lassen,035,31185,8196,7888,805,8693,55
2022-01-26,Los Angeles,037,10098052,2566272,2450620,117702,2568322,28382
2022-01-26,Madera,039,155013,33821,32323,4795,37118,329
2022-01-26,Marin,041,260295,30819,29813,1967,31780,253
2022-01-26,Mariposa,043,17540,2170,2108,126,2234,6
2022-01-26,Mendocino,045,87422,11928,11453,2262,13715,103
2022-01-26,Merced,047,269075,57809,56060,6652,62712,733
2022-01-26,Modoc,049,8938,667,652,229,881,6
2022-01-26,Mono,051,14174,2872,2852,114,2966,4
2022-01-26,Monterey,053,433212,71956,63264,10482,73746,659
2022-01-26,Napa,055,140530,23159,21864,774,22638,112
2022-01-26,Nevada,057,99092,14774,14128,989,15117,112
2022-01-26,Orange,059,3164182,520688,506419,38681,545100,6007
2022-01-26,Placer,061,380077,58311,55892,6782,62674,524
2022-01-26,Plumas,063,18699,2701,2425,258,2683,12
2022-01-26,Riverside,065,2383286,561789,543788,26335,570123,5701
2022-01-26,Sacramento,067,1510023,259856,246416,23223,269639,2559
2022-01-26,San Benito,069,59416,11910,11563,449,12012,90
2022-01-26,San Bernardino,071,2135413,541877,521699,23522,545221,6291
2022-01-26,San Diego,073,3302833,701261,676392,47639,724031,4622
2022-01-26,San Francisco,075,870044,113536,107174,7547,114721,704
2022-01-26,San Joaquin,077,732212,154657,148770,9006,157776,1971
2022-01-26,San Luis Obispo,079,281455,47831,45716,3205,48921,391
2022-01-26,San Mateo,081,765935,112149,99016,6045,105061,586
2022-01-26,Santa Barbara,083,443738,78517,75548,4202,79750,600
2022-01-26,Santa Clara,085,1922200,281105,270470,10611,281081,2015
2022-01-26,Santa Cruz,087,273765,40946,38298,1932,40230,239
2022-01-26,Shasta,089,179085,28118,27255,5396,32651,452
2022-01-26,Sierra,091,2930,264,260,41,301,0
2022-01-26,Siskiyou,093,43540,4079,3971,2332,6303,66
2022-01-26,Solano,095,438530,73293,69150,4886,74036,401
2022-01-26,Sonoma,097,501317,76139,72509,2145,74654,423
2022-01-26,Stanislaus,099,539301,109216,106582,15030,121612,1396
2022-01-26,Sutter,101,95872,19073,18670,1540,20210,202
2022-01-26,Tehama,103,63373,11099,10749,2386,13135,145
2022-01-26,Trinity,105,12862,1087,1008,265,1273,19
2022-01-26,Tulare,107,460477,97625,91904,24994,116898,1234
2022-01-26,Tuolumne,109,53932,11398,10699,398,11097,91
2022-01-26,Ventura,111,848112,163408,159077,8824,167901,1263
2022-01-26,Yolo,113,214977,33728,31913,2749,34662,275
2022-01-26,Yuba,115,75493,14577,14171,969,15140,103
2022-01-25,Alameda,001,1643700,230982,219753,11963,231716,1589
2022-01-25,Alpine,003,1148,119,122,1,123,0
2022-01-25,Amador,005,37829,7652,7352,477,7829,73
2022-01-25,Butte,007,227075,30088,28887,5835,34722,351
2022-01-25,Calaveras,009,45235,6634,6266,240,6506,95
2022-01-25,Colusa,011,21464,3188,3074,971,4045,21
2022-01-25,Contra Costa,013,1133247,172214,163792,10894,174686,1092
2022-01-25,Del Norte,015,27424,4725,4514,118,4632,43
2022-01-25,El Dorado,017,186661,24940,23339,2882,26221,179
2022-01-25,Fresno,019,978130,207401,198262,20733,218995,2434
2022-01-25,Glenn,021,27897,4572,4418,1448,5866,39
2022-01-25,Humboldt,023,135768,15046,14574,2312,16886,126
2022-01-25,Imperial,025,180216,51103,48913,9116,58029,832
2022-01-25,Inyo,027,18085,3909,3857,321,4178,50
2022-01-25,Kern,029,883053,178742,171695,41238,212933,1947
2022-01-25,Kings,031,150075,46347,43853,3134,46987,396
2022-01-25,Lake,033,64148,9267,8543,695,9238,118
2022-01-25,Lassen,035,31185,8165,7834,794,8628,55
2022-01-25,Los Angeles,037,10098052,2551345,2433516,117062,2550578,28293
2022-01-25,Madera,039,155013,33498,31794,4659,36453,329
2022-01-25,Marin,041,260295,30640,29589,1954,31543,253
2022-01-25,Mariposa,043,17540,2158,2069,120,2189,6
2022-01-25,Mendocino,045,87422,11808,11280,2159,13439,103
2022-01-25,Merced,047,269075,57433,55555,6508,62063,733
2022-01-25,Modoc,049,8938,665,652,229,881,6
2022-01-25,Mono,051,14174,2862,2826,113,2939,4
2022-01-25,Monterey,053,433212,71383,62498,10074,72572,654
2022-01-25,Napa,055,140530,22964,21668,738,22406,111
2022-01-25,Nevada,057,99092,14659,13944,965,14909,112
2022-01-25,Orange,059,3164182,518413,504274,38488,542762,5980
2022-01-25,Placer,061,380077,57910,55465,6709,62174,518
2022-01-25,Plumas,063,18699,2674,2397,254,2651,12
2022-01-25,Riverside,065,2383286,558703,540723,26167,566890,5686
2022-01-25,Sacramento,067,1510023,257912,244468,22678,267146,2545
2022-01-25,San Benito,069,59416,11811,11446,445,11891,88
2022-01-25,San Bernardino,071,2135413,539333,519150,23406,542556,6288
2022-01-25,San Diego,073,3302833,696248,670110,47187,717297,4604
2022-01-25,San Francisco,075,870044,112774,106254,7503,113757,703
2022-01-25,San Joaquin,077,732212,153672,147271,8943,156214,1972
2022-01-25,San Luis Obispo,079,281455,47469,45130,3157,48287,391
2022-01-25,San Mateo,081,765935,111317,98010,5934,103944,586
2022-01-25,Santa Barbara,083,443738,77848,74686,4120,78806,594
2022-01-25,Santa Clara,085,1922200,278471,268031,10406,278437,2006
2022-01-25,Santa Cruz,087,273765,40274,37850,1916,39766,237
2022-01-25,Shasta,089,179085,27955,27090,5329,32419,452
2022-01-25,Sierra,091,2930,264,260,37,297,0
2022-01-25,Siskiyou,093,43540,4055,3958,2297,6255,65
2022-01-25,Solano,095,438530,72726,68657,4829,73486,399
2022-01-25,Sonoma,097,501317,75446,71633,2105,73738,423
2022-01-25,Stanislaus,099,539301,108550,105965,14804,120769,1396
2022-01-25,Sutter,101,95872,18971,18508,1498,20006,200
2022-01-25,Tehama,103,63373,11036,10669,2360,13029,145
2022-01-25,Trinity,105,12862,1080,999,263,1262,19
2022-01-25,Tulare,107,460477,96751,91237,24642,115879,1229
2022-01-25,Tuolumne,109,53932,11218,10516,374,10890,91
2022-01-25,Ventura,111,848112,162554,157971,8780,166751,1263
2022-01-25,Yolo,113,214977,33468,31677,2702,34379,274
2022-01-25,Yuba,115,75493,14493,14038,941,14979,103
2022-01-24,Alameda,001,1643700,228538,216252,11689,227941,1581
2022-01-24,Alpine,003,1148,119,120,1,121,0
2022-01-24,Amador,005,37829,7601,7166,439,7605,73
2022-01-24,Butte,007,227075,29857,28607,5772,34379,350
2022-01-24,Calaveras,009,45235,6586,6172,226,6398,95
2022-01-24,Colusa,011,21464,3169,3052,955,4007,21
2022-01-24,Contra Costa,013,1133247,170728,162161,10674,172835,1092
2022-01-24,Del Norte,015,27424,4665,4460,118,4578,43
2022-01-24,El Dorado,017,186661,24774,23128,2852,25980,179
2022-01-24,Fresno,019,978130,205094,196092,20427,216519,2430
2022-01-24,Glenn,021,27897,4530,4367,1438,5805,39
2022-01-24,Humboldt,023,135768,14934,14416,2266,16682,126
2022-01-24,Imperial,025,180216,50562,48228,8827,57055,824
2022-01-24,Inyo,027,18085,3903,3805,296,4101,50
2022-01-24,Kern,029,883053,177434,169892,40760,210652,1946
2022-01-24,Kings,031,150075,45769,43260,3061,46321,396
2022-01-24,Lake,033,64148,9158,8423,680,9103,118
2022-01-24,Lassen,035,31185,8081,7732,775,8507,55
2022-01-24,Los Angeles,037,10098052,2534831,2391045,116283,2507328,28230
2022-01-24,Madera,039,155013,33059,31339,4473,35812,329
2022-01-24,Marin,041,260295,30411,29301,1917,31218,253
2022-01-24,Mariposa,043,17540,2133,2033,116,2149,6
2022-01-24,Mendocino,045,87422,11704,11002,2078,13080,103
2022-01-24,Merced,047,269075,56940,54970,6225,61195,730
2022-01-24,Modoc,049,8938,662,648,228,876,6
2022-01-24,Mono,051,14174,2852,2802,112,2914,4
2022-01-24,Monterey,053,433212,70521,61975,9711,71686,654
2022-01-24,Napa,055,140530,22784,21494,725,22219,111
2022-01-24,Nevada,057,99092,14531,13774,942,14716,112
2022-01-24,Orange,059,3164182,515839,501634,38226,539860,5969
2022-01-24,Placer,061,380077,57429,54933,6658,61591,518
2022-01-24,Plumas,063,18699,2643,2370,240,2610,12
2022-01-24,Riverside,065,2383286,554985,535962,25958,561920,5661
2022-01-24,Sacramento,067,1510023,255550,241522,22095,263617,2526
2022-01-24,San Benito,069,59416,11714,11331,432,11763,88
2022-01-24,San Bernardino,071,2135413,536421,515604,23245,538849,6285
2022-01-24,San Diego,073,3302833,690573,663580,46637,710217,4586
2022-01-24,San Francisco,075,870044,111812,105418,7407,112825,703
2022-01-24,San Joaquin,077,732212,152361,145984,8870,154854,1959
2022-01-24,San Luis Obispo,079,281455,46996,44616,3102,47718,387
2022-01-24,San Mateo,081,765935,110353,96968,5816,102784,586
2022-01-24,Santa Barbara,083,443738,77036,73866,4024,77890,591
2022-01-24,Santa Clara,085,1922200,275587,265341,10196,275537,2006
2022-01-24,Santa Cruz,087,273765,39478,37188,1894,39082,237
2022-01-24,Shasta,089,179085,27766,26871,5241,32112,452
2022-01-24,Sierra,091,2930,264,258,37,295,0
2022-01-24,Siskiyou,093,43540,4045,3934,2258,6192,64
2022-01-24,Solano,095,438530,72043,68094,4750,72844,400
2022-01-24,Sonoma,097,501317,74531,70733,2073,72806,423
2022-01-24,Stanislaus,099,539301,107797,104933,14530,119463,1395
2022-01-24,Sutter,101,95872,18856,18336,1409,19745,200
2022-01-24,Tehama,103,63373,10965,10567,2340,12907,145
2022-01-24,Trinity,105,12862,1071,978,261,1239,19
2022-01-24,Tulare,107,460477,95673,90089,24241,114330,1219
2022-01-24,Tuolumne,109,53932,11098,10374,365,10739,91
2022-01-24,Ventura,111,848112,161530,156551,8735,165286,1261
2022-01-24,Yolo,113,214977,33177,31480,2667,34147,273
2022-01-24,Yuba,115,75493,14386,13862,900,14762,103
2022-01-23,Alameda,001,1643700,225859,214003,11348,225351,1583
2022-01-23,Alpine,003,1148,119,120,1,121,0
2022-01-23,Amador,005,37829,7546,7090,399,7489,73
2022-01-23,Butte,007,227075,29565,28340,5665,34005,350
2022-01-23,Calaveras,009,45235,6521,6095,203,6298,95
2022-01-23,Colusa,011,21464,3143,3040,948,3988,21
2022-01-23,Contra Costa,013,1133247,168880,160798,10304,171102,1092
2022-01-23,Del Norte,015,27424,4599,4419,112,4531,43
2022-01-23,El Dorado,017,186661,24583,22925,2803,25728,179
2022-01-23,Fresno,019,978130,202621,193642,19955,213597,2430
2022-01-23,Glenn,021,27897,4479,4340,1414,5754,39
2022-01-23,Humboldt,023,135768,14815,14296,2184,16480,126
2022-01-23,Imperial,025,180216,49962,47935,8538,56473,824
2022-01-23,Inyo,027,18085,3876,3781,282,4063,50
2022-01-23,Kern,029,883053,176072,168585,40230,208815,1946
2022-01-23,Kings,031,150075,45132,42622,2957,45579,397
2022-01-23,Lake,033,64148,8988,8363,653,9016,118
2022-01-23,Lassen,035,31185,8030,7710,751,8461,55
2022-01-23,Los Angeles,037,10098052,2514524,2390590,115122,2505712,28231
2022-01-23,Madera,039,155013,32698,30962,4231,35193,329
2022-01-23,Marin,041,260295,30158,29025,1879,30904,253
2022-01-23,Mariposa,043,17540,2118,2011,113,2124,6
2022-01-23,Mendocino,045,87422,11579,10889,1951,12840,103
2022-01-23,Merced,047,269075,56390,54644,5777,60421,730
2022-01-23,Modoc,049,8938,660,645,225,870,6
2022-01-23,Mono,051,14174,2844,2788,110,2898,4
2022-01-23,Monterey,053,433212,69682,61522,9266,70788,654
2022-01-23,Napa,055,140530,22521,21281,712,21993,111
2022-01-23,Nevada,057,99092,14368,13629,914,14543,112
2022-01-23,Orange,059,3164182,512742,498968,37933,536901,5970
2022-01-23,Placer,061,380077,56857,54568,6568,61136,518
2022-01-23,Plumas,063,18699,2610,2368,211,2579,12
2022-01-23,Riverside,065,2383286,550553,532273,25651,557924,5661
2022-01-23,Sacramento,067,1510023,252909,239589,21125,260714,2530
2022-01-23,San Benito,069,59416,11591,11225,421,11646,88
2022-01-23,San Bernardino,071,2135413,532999,512657,22987,535644,6281
2022-01-23,San Diego,073,3302833,683919,640215,45836,686051,4566
2022-01-23,San Francisco,075,870044,110743,104485,7299,111784,704
2022-01-23,San Joaquin,077,732212,150763,144621,8794,153415,1959
2022-01-23,San Luis Obispo,079,281455,46304,44183,3023,47206,386
2022-01-23,San Mateo,081,765935,109234,95940,5668,101608,586
2022-01-23,Santa Barbara,083,443738,75910,73041,3898,76939,590
2022-01-23,Santa Clara,085,1922200,272278,261991,9869,271860,2005
2022-01-23,Santa Cruz,087,273765,38946,36547,1862,38409,237
2022-01-23,Shasta,089,179085,27468,26732,5119,31851,452
2022-01-23,Sierra,091,2930,263,252,37,289,0
2022-01-23,Siskiyou,093,43540,4019,3916,2200,6116,64
2022-01-23,Solano,095,438530,71247,67457,4654,72111,400
2022-01-23,Sonoma,097,501317,73573,69791,2018,71809,423
2022-01-23,Stanislaus,099,539301,106935,104067,14253,118320,1395
2022-01-23,Sutter,101,95872,18699,18175,1294,19469,200
2022-01-23,Tehama,103,63373,10866,10481,2308,12789,145
2022-01-23,Trinity,105,12862,1068,961,259,1220,19
2022-01-23,Tulare,107,460477,94410,89120,23795,112915,1219
2022-01-23,Tuolumne,109,53932,10907,10243,347,10590,91
2022-01-23,Ventura,111,848112,160347,155052,8661,163713,1261
2022-01-23,Yolo,113,214977,32800,30908,2625,33533,273
2022-01-23,Yuba,115,75493,14260,13762,845,14607,103
2022-01-22,Alameda,001,1643700,224765,203927,11314,215241,1575
2022-01-22,Alpine,003,1148,118,119,1,120,0
2022-01-22,Amador,005,37829,7513,6845,394,7239,73
2022-01-22,Butte,007,227075,29447,27232,5641,32873,350
2022-01-22,Calaveras,009,45235,6491,5835,202,6037,95
2022-01-22,Colusa,011,21464,3126,2954,945,3899,21
2022-01-22,Contra Costa,013,1133247,167954,154111,10274,164385,1091
2022-01-22,Del Norte,015,27424,4563,4269,108,4377,43
2022-01-22,El Dorado,017,186661,24513,22273,2793,25066,179
2022-01-22,Fresno,019,978130,201807,185292,19891,205183,2429
2022-01-22,Glenn,021,27897,4473,4174,1411,5585,39
2022-01-22,Humboldt,023,135768,14748,13628,2171,15799,125
2022-01-22,Imperial,025,180216,49770,45741,8477,54218,820
2022-01-22,Inyo,027,18085,3872,3706,258,3964,50
2022-01-22,Kern,029,883053,175447,162902,39925,202827,1946
2022-01-22,Kings,031,150075,44925,40580,2945,43525,396
2022-01-22,Lake,033,64148,8954,8056,645,8701,118
2022-01-22,Lassen,035,31185,7997,7545,744,8289,55
2022-01-22,Los Angeles,037,10098052,2507123,2286280,114613,2400893,28038
2022-01-22,Madera,039,155013,32580,29595,4216,33811,329
2022-01-22,Marin,041,260295,30032,27893,1874,29767,253
2022-01-22,Mariposa,043,17540,2114,1920,113,2033,6
2022-01-22,Mendocino,045,87422,11529,10395,1929,12324,103
2022-01-22,Merced,047,269075,56241,53025,5768,58793,727
2022-01-22,Modoc,049,8938,659,639,225,864,6
2022-01-22,Mono,051,14174,2843,2723,106,2829,4
2022-01-22,Monterey,053,433212,69475,59038,9223,68261,651
2022-01-22,Napa,055,140530,22426,20402,702,21104,111
2022-01-22,Nevada,057,99092,14300,12957,906,13863,112
2022-01-22,Orange,059,3164182,511146,480329,37684,518013,5946
2022-01-22,Placer,061,380077,56590,52557,6529,59086,512
2022-01-22,Plumas,063,18699,2593,2289,207,2496,12
2022-01-22,Riverside,065,2383286,548638,513567,25578,539145,5623
2022-01-22,Sacramento,067,1510023,251864,230206,21019,251225,2510
2022-01-22,San Benito,069,59416,11532,10743,416,11159,88
2022-01-22,San Bernardino,071,2135413,531514,495209,22902,518111,6267
2022-01-22,San Diego,073,3302833,681430,628904,45619,674523,4559
2022-01-22,San Francisco,075,870044,110087,100238,7150,107388,702
2022-01-22,San Joaquin,077,732212,150328,138264,8751,147015,1960
2022-01-22,San Luis Obispo,079,281455,46186,42154,3016,45170,385
2022-01-22,San Mateo,081,765935,108650,91440,5605,97045,585
2022-01-22,Santa Barbara,083,443738,75489,69555,3892,73447,589
2022-01-22,Santa Clara,085,1922200,270599,249205,9802,259007,1993
2022-01-22,Santa Cruz,087,273765,38765,33741,1855,35596,237
2022-01-22,Shasta,089,179085,27375,25919,5097,31016,450
2022-01-22,Sierra,091,2930,263,248,36,284,0
2022-01-22,Siskiyou,093,43540,4001,3845,2179,6024,62
2022-01-22,Solano,095,438530,71024,63882,4615,68497,391
2022-01-22,Sonoma,097,501317,73148,66013,2008,68021,422
2022-01-22,Stanislaus,099,539301,106480,100092,14162,114254,1393
2022-01-22,Sutter,101,95872,18631,17616,1281,18897,199
2022-01-22,Tehama,103,63373,10831,10171,2298,12469,142
2022-01-22,Trinity,105,12862,1066,925,259,1184,19
2022-01-22,Tulare,107,460477,94027,85223,23665,108888,1211
2022-01-22,Tuolumne,109,53932,10839,9731,341,10072,91
2022-01-22,Ventura,111,848112,159655,148742,8630,157372,1250
2022-01-22,Yolo,113,214977,32623,30061,2608,32669,273
2022-01-22,Yuba,115,75493,14170,13288,840,14128,103
2022-01-21,Alameda,001,1643700,223191,203927,11283,215210,1575
2022-01-21,Alpine,003,1148,118,119,1,120,0
2022-01-21,Amador,005,37829,7456,6845,391,7236,73
2022-01-21,Butte,007,227075,29318,27232,5599,32831,350
2022-01-21,Calaveras,009,45235,6446,5835,202,6037,95
2022-01-21,Colusa,011,21464,3119,2954,940,3894,21
2022-01-21,Contra Costa,013,1133247,166904,154111,10194,164305,1091
2022-01-21,Del Norte,015,27424,4522,4269,108,4377,43
2022-01-21,El Dorado,017,186661,24431,22273,2776,25049,179
2022-01-21,Fresno,019,978130,200564,185292,19795,205087,2429
2022-01-21,Glenn,021,27897,4455,4174,1406,5580,39
2022-01-21,Humboldt,023,135768,14679,13628,2152,15780,125
2022-01-21,Imperial,025,180216,49579,45741,8398,54139,820
2022-01-21,Inyo,027,18085,3859,3706,252,3958,50
2022-01-21,Kern,029,883053,174727,162902,39550,202452,1946
2022-01-21,Kings,031,150075,44728,40580,2937,43517,396
2022-01-21,Lake,033,64148,8897,8056,632,8688,118
2022-01-21,Lassen,035,31185,7945,7545,740,8285,55
2022-01-21,Los Angeles,037,10098052,2495825,2286280,114153,2400433,28038
2022-01-21,Madera,039,155013,32289,29595,4188,33783,329
2022-01-21,Marin,041,260295,29855,27893,1853,29746,253
2022-01-21,Mariposa,043,17540,2102,1920,112,2032,6
2022-01-21,Mendocino,045,87422,11448,10395,1926,12321,103
2022-01-21,Merced,047,269075,56082,53025,5764,58789,727
2022-01-21,Modoc,049,8938,658,639,225,864,6
2022-01-21,Mono,051,14174,2829,2723,103,2826,4
2022-01-21,Monterey,053,433212,69004,59038,9091,68129,651
2022-01-21,Napa,055,140530,22306,20402,694,21096,111
2022-01-21,Nevada,057,99092,14203,12957,902,13859,112
2022-01-21,Orange,059,3164182,508905,480329,37439,517768,5946
2022-01-21,Placer,061,380077,56197,52557,6466,59023,512
2022-01-21,Plumas,063,18699,2581,2289,202,2491,12
2022-01-21,Riverside,065,2383286,545986,513567,25499,539066,5623
2022-01-21,Sacramento,067,1510023,250419,230206,20916,251122,2510
2022-01-21,San Benito,069,59416,11497,10743,413,11156,88
2022-01-21,San Bernardino,071,2135413,529503,495209,22831,518040,6267
2022-01-21,San Diego,073,3302833,677231,628904,45445,674349,4559
2022-01-21,San Francisco,075,870044,109327,100238,7062,107300,702
2022-01-21,San Joaquin,077,732212,149742,138264,8704,146968,1960
2022-01-21,San Luis Obispo,079,281455,46060,42154,3013,45167,385
2022-01-21,San Mateo,081,765935,107977,91440,5564,97004,585
2022-01-21,Santa Barbara,083,443738,74988,69555,3882,73437,589
2022-01-21,Santa Clara,085,1922200,268772,249205,9694,258899,1993
2022-01-21,Santa Cruz,087,273765,38049,33741,1842,35583,237
2022-01-21,Shasta,089,179085,27287,25919,5050,30969,450
2022-01-21,Sierra,091,2930,261,248,35,283,0
2022-01-21,Siskiyou,093,43540,3993,3845,2161,6006,62
2022-01-21,Solano,095,438530,70613,63882,4533,68415,391
2022-01-21,Sonoma,097,501317,72623,66013,1998,68011,422
2022-01-21,Stanislaus,099,539301,105976,100092,14101,114193,1393
2022-01-21,Sutter,101,95872,18544,17616,1267,18883,199
2022-01-21,Tehama,103,63373,10795,10171,2296,12467,142
2022-01-21,Trinity,105,12862,1060,925,258,1183,19
2022-01-21,Tulare,107,460477,93548,85223,23500,108723,1211
2022-01-21,Tuolumne,109,53932,10756,9731,334,10065,91
2022-01-21,Ventura,111,848112,158846,148742,8601,157343,1250
2022-01-21,Yolo,113,214977,32458,30061,2585,32646,273
2022-01-21,Yuba,115,75493,14098,13288,833,14121,103
2022-01-20,Alameda,001,1643700,220125,203927,11038,214965,1575
2022-01-20,Alpine,003,1148,118,119,1,120,0
2022-01-20,Amador,005,37829,7391,6845,373,7218,73
2022-01-20,Butte,007,227075,29058,27232,5521,32753,350
2022-01-20,Calaveras,009,45235,6341,5835,193,6028,95
2022-01-20,Colusa,011,21464,3088,2954,928,3882,21
2022-01-20,Contra Costa,013,1133247,164941,154111,9926,164037,1091
2022-01-20,Del Norte,015,27424,4482,4269,105,4374,43
2022-01-20,El Dorado,017,186661,24228,22273,2733,25006,179
2022-01-20,Fresno,019,978130,197958,185292,19423,204715,2429
2022-01-20,Glenn,021,27897,4420,4174,1397,5571,39
2022-01-20,Humboldt,023,135768,14550,13628,2100,15728,125
2022-01-20,Imperial,025,180216,49059,45741,8217,53958,820
2022-01-20,Inyo,027,18085,3847,3706,241,3947,50
2022-01-20,Kern,029,883053,173197,162902,39003,201905,1946
2022-01-20,Kings,031,150075,44173,40580,2894,43474,396
2022-01-20,Lake,033,64148,8802,8056,604,8660,118
2022-01-20,Lassen,035,31185,7894,7545,725,8270,55
2022-01-20,Los Angeles,037,10098052,2471094,2286280,113168,2399448,28038
2022-01-20,Madera,039,155013,31900,29595,4062,33657,329
2022-01-20,Marin,041,260295,29560,27893,1816,29709,253
2022-01-20,Mariposa,043,17540,2075,1920,109,2029,6
2022-01-20,Mendocino,045,87422,11351,10395,1848,12243,103
2022-01-20,Merced,047,269075,55652,53025,5535,58560,727
2022-01-20,Modoc,049,8938,656,639,225,864,6
2022-01-20,Mono,051,14174,2821,2723,102,2825,4
2022-01-20,Monterey,053,433212,68238,59038,8672,67710,651
2022-01-20,Napa,055,140530,22040,20402,655,21057,111
2022-01-20,Nevada,057,99092,14056,12957,879,13836,112
2022-01-20,Orange,059,3164182,504962,480329,37066,517395,5946
2022-01-20,Placer,061,380077,55706,52557,6405,58962,512
2022-01-20,Plumas,063,18699,2554,2289,198,2487,12
2022-01-20,Riverside,065,2383286,541416,513567,25261,538828,5623
2022-01-20,Sacramento,067,1510023,248117,230206,20265,250471,2510
2022-01-20,San Benito,069,59416,11386,10743,400,11143,88
2022-01-20,San Bernardino,071,2135413,525380,495209,22549,517758,6267
2022-01-20,San Diego,073,3302833,670137,628904,44747,673651,4559
2022-01-20,San Francisco,075,870044,108174,100238,6921,107159,702
2022-01-20,San Joaquin,077,732212,148100,138264,8583,146847,1960
2022-01-20,San Luis Obispo,079,281455,45550,42154,2979,45133,385
2022-01-20,San Mateo,081,765935,106749,91440,5358,96798,585
2022-01-20,Santa Barbara,083,443738,74091,69555,3769,73324,589
2022-01-20,Santa Clara,085,1922200,265458,249205,9365,258570,1993
2022-01-20,Santa Cruz,087,273765,37162,33741,1819,35560,237
2022-01-20,Shasta,089,179085,27097,25919,4983,30902,450
2022-01-20,Sierra,091,2930,261,248,33,281,0
2022-01-20,Siskiyou,093,43540,3981,3845,2128,5973,62
2022-01-20,Solano,095,438530,69666,63882,4444,68326,391
2022-01-20,Sonoma,097,501317,71591,66013,1948,67961,422
2022-01-20,Stanislaus,099,539301,105024,100092,13896,113988,1393
2022-01-20,Sutter,101,95872,18379,17616,1238,18854,199
2022-01-20,Tehama,103,63373,10720,10171,2278,12449,142
2022-01-20,Trinity,105,12862,1046,925,257,1182,19
2022-01-20,Tulare,107,460477,92487,85223,23185,108408,1211
2022-01-20,Tuolumne,109,53932,10614,9731,322,10053,91
2022-01-20,Ventura,111,848112,157459,148742,8528,157270,1250
2022-01-20,Yolo,113,214977,32173,30061,2552,32613,273
2022-01-20,Yuba,115,75493,13991,13288,800,14088,103
2022-01-19,Alameda,001,1643700,216760,199739,10698,210437,1571
2022-01-19,Alpine,003,1148,117,119,1,120,0
2022-01-19,Amador,005,37829,7310,6789,331,7120,73
2022-01-19,Butte,007,227075,28754,26839,5446,32285,351
2022-01-19,Calaveras,009,45235,6250,5765,184,5949,95
2022-01-19,Colusa,011,21464,3063,2938,920,3858,21
2022-01-19,Contra Costa,013,1133247,162632,151543,9681,161224,1091
2022-01-19,Del Norte,015,27424,4443,4240,104,4344,43
2022-01-19,El Dorado,017,186661,23975,21953,2691,24644,177
2022-01-19,Fresno,019,978130,195052,181526,19092,200618,2430
2022-01-19,Glenn,021,27897,4369,4127,1387,5514,39
2022-01-19,Humboldt,023,135768,14391,13391,2047,15438,125
2022-01-19,Imperial,025,180216,48329,45156,8010,53166,820
2022-01-19,Inyo,027,18085,3824,3680,202,3882,49
2022-01-19,Kern,029,883053,171437,160747,38318,199065,1946
2022-01-19,Kings,031,150075,43475,40027,2815,42842,395
2022-01-19,Lake,033,64148,8676,7972,591,8563,118
2022-01-19,Lassen,035,31185,7836,7507,703,8210,55
2022-01-19,Los Angeles,037,10098052,2442700,2251718,111731,2363449,27934
2022-01-19,Madera,039,155013,31519,29021,3888,32909,329
2022-01-19,Marin,041,260295,29264,27375,1773,29148,251
2022-01-19,Mariposa,043,17540,2050,1896,103,1999,6
2022-01-19,Mendocino,045,87422,11179,10252,1754,12006,103
2022-01-19,Merced,047,269075,55109,52355,5179,57534,724
2022-01-19,Modoc,049,8938,654,635,224,859,6
2022-01-19,Mono,051,14174,2799,2677,100,2777,4
2022-01-19,Monterey,053,433212,67328,58426,8209,66635,651
2022-01-19,Napa,055,140530,21787,20090,628,20718,110
2022-01-19,Nevada,057,99092,13902,12703,849,13552,112
2022-01-19,Orange,059,3164182,500477,468460,36693,505153,5943
2022-01-19,Placer,061,380077,55137,51545,6334,57879,511
2022-01-19,Plumas,063,18699,2514,2239,191,2430,12
2022-01-19,Riverside,065,2383286,535887,503575,25020,528595,5604
2022-01-19,Sacramento,067,1510023,245233,226035,19513,245548,2512
2022-01-19,San Benito,069,59416,11245,10639,388,11027,88
2022-01-19,San Bernardino,071,2135413,520767,487846,22176,510022,6265
2022-01-19,San Diego,073,3302833,661360,614709,44022,658731,4553
2022-01-19,San Francisco,075,870044,106803,98652,6842,105494,694
2022-01-19,San Joaquin,077,732212,146205,135953,8453,144406,1959
2022-01-19,San Luis Obispo,079,281455,44952,41374,2913,44287,382
2022-01-19,San Mateo,081,765935,105329,89715,5091,94806,585
2022-01-19,Santa Barbara,083,443738,73091,68531,3668,72199,586
2022-01-19,Santa Clara,085,1922200,261724,244922,9003,253925,1991
2022-01-19,Santa Cruz,087,273765,35857,33026,1794,34820,237
2022-01-19,Shasta,089,179085,26831,25355,4911,30266,450
2022-01-19,Sierra,091,2930,261,245,32,277,0
2022-01-19,Siskiyou,093,43540,3957,3821,2072,5893,62
2022-01-19,Solano,095,438530,68824,63003,4316,67319,392
2022-01-19,Sonoma,097,501317,70485,64689,1903,66592,420
2022-01-19,Stanislaus,099,539301,103976,98952,13606,112558,1381
2022-01-19,Sutter,101,95872,18211,17436,1146,18582,199
2022-01-19,Tehama,103,63373,10607,10064,2229,12293,142
2022-01-19,Trinity,105,12862,1034,916,256,1172,19
2022-01-19,Tulare,107,460477,91187,83743,22696,106439,1200
2022-01-19,Tuolumne,109,53932,10457,9613,298,9911,91
2022-01-19,Ventura,111,848112,155945,144738,8457,153195,1234
2022-01-19,Yolo,113,214977,31806,29392,2516,31908,273
2022-01-19,Yuba,115,75493,13827,13114,787,13901,104
2022-01-18,Alameda,001,1643700,213402,195728,10381,206109,1566
2022-01-18,Alpine,003,1148,117,118,1,119,0
2022-01-18,Amador,005,37829,7172,6691,294,6985,73
2022-01-18,Butte,007,227075,28362,26514,5369,31883,347
2022-01-18,Calaveras,009,45235,6162,5684,169,5853,94
2022-01-18,Colusa,011,21464,3019,2903,915,3818,21
2022-01-18,Contra Costa,013,1133247,160625,149446,9308,158754,1085
2022-01-18,Del Norte,015,27424,4373,4229,99,4328,43
2022-01-18,El Dorado,017,186661,23593,21707,2645,24352,175
2022-01-18,Fresno,019,978130,191559,178922,18658,197580,2425
2022-01-18,Glenn,021,27897,4336,4070,1375,5445,39
2022-01-18,Humboldt,023,135768,14223,13218,1975,15193,125
2022-01-18,Imperial,025,180216,47633,44742,7823,52565,819
2022-01-18,Inyo,027,18085,3783,3654,191,3845,49
2022-01-18,Kern,029,883053,169416,158864,37554,196418,1943
2022-01-18,Kings,031,150075,42596,39440,2732,42172,392
2022-01-18,Lake,033,64148,8563,7919,571,8490,117
2022-01-18,Lassen,035,31185,7752,7461,664,8125,55
2022-01-18,Los Angeles,037,10098052,2409277,2227360,110292,2337652,27871
2022-01-18,Madera,039,155013,30997,28717,3698,32415,329
2022-01-18,Marin,041,260295,28962,27036,1730,28766,251
2022-01-18,Mariposa,043,17540,2025,1872,99,1971,6
2022-01-18,Mendocino,045,87422,11009,10114,1666,11780,103
2022-01-18,Merced,047,269075,54497,51746,4897,56643,718
2022-01-18,Modoc,049,8938,652,633,219,852,6
2022-01-18,Mono,051,14174,2778,2643,99,2742,4
2022-01-18,Monterey,053,433212,66552,57846,7726,65572,650
2022-01-18,Napa,055,140530,21454,19911,611,20522,109
2022-01-18,Nevada,057,99092,13719,12584,806,13390,111
2022-01-18,Orange,059,3164182,495131,461324,36181,497505,5938
2022-01-18,Placer,061,380077,54495,50983,6258,57241,508
2022-01-18,Plumas,063,18699,2476,2218,185,2403,12
2022-01-18,Riverside,065,2383286,529909,497278,24711,521989,5599
2022-01-18,Sacramento,067,1510023,242146,223745,18490,242235,2496
2022-01-18,San Benito,069,59416,11103,10520,374,10894,88
2022-01-18,San Bernardino,071,2135413,515451,483753,21746,505499,6258
2022-01-18,San Diego,073,3302833,651143,605137,42986,648123,4547
2022-01-18,San Francisco,075,870044,105339,96505,6726,103231,694
2022-01-18,San Joaquin,077,732212,144268,134365,8259,142624,1957
2022-01-18,San Luis Obispo,079,281455,44267,40848,2826,43674,381
2022-01-18,San Mateo,081,765935,103811,88225,4893,93118,585
2022-01-18,Santa Barbara,083,443738,71870,67216,3495,70711,581
2022-01-18,Santa Clara,085,1922200,257600,240281,8602,248883,1986
2022-01-18,Santa Cruz,087,273765,35207,32203,1759,33962,237
2022-01-18,Shasta,089,179085,26548,25162,4817,29979,448
2022-01-18,Sierra,091,2930,257,244,32,276,0
2022-01-18,Siskiyou,093,43540,3923,3799,2018,5817,62
2022-01-18,Solano,095,438530,67974,62204,4207,66411,391
2022-01-18,Sonoma,097,501317,69101,63714,1847,65561,419
2022-01-18,Stanislaus,099,539301,102757,98000,13257,111257,1379
2022-01-18,Sutter,101,95872,18020,17295,1073,18368,198
2022-01-18,Tehama,103,63373,10508,9975,2176,12151,142
2022-01-18,Trinity,105,12862,1021,907,255,1162,19
2022-01-18,Tulare,107,460477,89716,82667,22262,104929,1196
2022-01-18,Tuolumne,109,53932,10288,9528,286,9814,91
2022-01-18,Ventura,111,848112,154236,143384,8383,151767,1233
2022-01-18,Yolo,113,214977,31409,28786,2465,31251,270
2022-01-18,Yuba,115,75493,13666,12971,761,13732,101
2022-01-17,Alameda,001,1643700,208725,193276,9773,203049,1565
2022-01-17,Alpine,003,1148,116,118,0,118,0
2022-01-17,Amador,005,37829,7058,6640,236,6876,73
2022-01-17,Butte,007,227075,27984,26303,5264,31567,348
2022-01-17,Calaveras,009,45235,6030,5584,141,5725,94
2022-01-17,Colusa,011,21464,2996,2905,908,3813,21
2022-01-17,Contra Costa,013,1133247,157866,147993,8819,156812,1086
2022-01-17,Del Norte,015,27424,4322,4209,92,4301,43
2022-01-17,El Dorado,017,186661,23341,21540,2563,24103,175
2022-01-17,Fresno,019,978130,187852,176959,18149,195108,2426
2022-01-17,Glenn,021,27897,4283,4055,1361,5416,39
2022-01-17,Humboldt,023,135768,14017,13120,1808,14928,125
2022-01-17,Imperial,025,180216,46946,44412,7650,52062,821
2022-01-17,Inyo,027,18085,3761,3650,165,3815,49
2022-01-17,Kern,029,883053,166867,157645,36669,194314,1944
2022-01-17,Kings,031,150075,41463,39143,2609,41752,392
2022-01-17,Lake,033,64148,8414,7864,531,8395,117
2022-01-17,Lassen,035,31185,7649,7417,626,8043,55
2022-01-17,Los Angeles,037,10098052,2370075,2205740,108324,2314064,27832
2022-01-17,Madera,039,155013,30341,28568,3512,32080,329
2022-01-17,Marin,041,260295,28555,26633,1674,28307,251
2022-01-17,Mariposa,043,17540,1999,1862,93,1955,6
2022-01-17,Mendocino,045,87422,10785,10030,1524,11554,103
2022-01-17,Merced,047,269075,53818,51227,4334,55561,718
2022-01-17,Modoc,049,8938,648,630,219,849,6
2022-01-17,Mono,051,14174,2755,2642,98,2740,4
2022-01-17,Monterey,053,433212,65431,57318,7301,64619,647
2022-01-17,Napa,055,140530,21110,19647,588,20235,109
2022-01-17,Nevada,057,99092,13531,12414,768,13182,111
2022-01-17,Orange,059,3164182,489171,457418,35711,493129,5933
2022-01-17,Placer,061,380077,53760,50511,6112,56623,508
2022-01-17,Plumas,063,18699,2430,2205,153,2358,12
2022-01-17,Riverside,065,2383286,523104,491322,24254,515576,5600
2022-01-17,Sacramento,067,1510023,238073,221143,17100,238243,2497
2022-01-17,San Benito,069,59416,10936,10432,346,10778,88
2022-01-17,San Bernardino,071,2135413,509147,480243,21202,501445,6259
2022-01-17,San Diego,073,3302833,638942,569241,41785,611026,4545
2022-01-17,San Francisco,075,870044,103714,95292,6532,101824,694
2022-01-17,San Joaquin,077,732212,141428,133414,8082,141496,1958
2022-01-17,San Luis Obispo,079,281455,43437,40425,2724,43149,379
2022-01-17,San Mateo,081,765935,101841,87013,4635,91648,585
2022-01-17,Santa Barbara,083,443738,70547,66704,3294,69998,581
2022-01-17,Santa Clara,085,1922200,253106,237934,8161,246095,1985
2022-01-17,Santa Cruz,087,273765,34437,31714,1720,33434,237
2022-01-17,Shasta,089,179085,26260,25025,4695,29720,448
2022-01-17,Sierra,091,2930,256,242,32,274,0
2022-01-17,Siskiyou,093,43540,3884,3764,1938,5702,62
2022-01-17,Solano,095,438530,66936,61497,3945,65442,391
2022-01-17,Sonoma,097,501317,67591,62763,1783,64546,419
2022-01-17,Stanislaus,099,539301,101441,96951,12783,109734,1379
2022-01-17,Sutter,101,95872,17813,17159,934,18093,198
2022-01-17,Tehama,103,63373,10386,9912,2116,12028,142
2022-01-17,Trinity,105,12862,1008,906,251,1157,19
2022-01-17,Tulare,107,460477,87951,81741,21691,103432,1199
2022-01-17,Tuolumne,109,53932,10154,9416,252,9668,91
2022-01-17,Ventura,111,848112,152118,142070,8271,150341,1234
2022-01-17,Yolo,113,214977,30881,28638,2400,31038,270
2022-01-17,Yuba,115,75493,13468,12871,705,13576,101
2022-01-16,Alameda,001,1643700,205667,190691,9510,200201,1564
2022-01-16,Alpine,003,1148,116,118,0,118,0
2022-01-16,Amador,005,37829,6984,6618,228,6846,73
2022-01-16,Butte,007,227075,27647,26139,5215,31354,348
2022-01-16,Calaveras,009,45235,5929,5537,137,5674,94
2022-01-16,Colusa,011,21464,2979,2886,896,3782,21
2022-01-16,Contra Costa,013,1133247,155957,146307,8616,154923,1086
2022-01-16,Del Norte,015,27424,4279,4177,90,4267,43
2022-01-16,El Dorado,017,186661,23066,21303,2524,23827,175
2022-01-16,Fresno,019,978130,185141,174818,17790,192608,2425
2022-01-16,Glenn,021,27897,4228,4049,1339,5388,39
2022-01-16,Humboldt,023,135768,13870,13075,1789,14864,125
2022-01-16,Imperial,025,180216,46369,44035,7480,51515,821
2022-01-16,Inyo,027,18085,3724,3602,143,3745,49
2022-01-16,Kern,029,883053,165594,156655,35877,192532,1944
2022-01-16,Kings,031,150075,41091,38861,2582,41443,392
2022-01-16,Lake,033,64148,8310,7823,496,8319,117
2022-01-16,Lassen,035,31185,7606,7391,612,8003,55
2022-01-16,Los Angeles,037,10098052,2346906,2174403,106787,2281190,27805
2022-01-16,Madera,039,155013,29970,28313,3461,31774,329
2022-01-16,Marin,041,260295,28261,26292,1660,27952,251
2022-01-16,Mariposa,043,17540,1972,1851,88,1939,6
2022-01-16,Mendocino,045,87422,10639,9992,1407,11399,102
2022-01-16,Merced,047,269075,53230,50882,4312,55194,718
2022-01-16,Modoc,049,8938,645,629,219,848,6
2022-01-16,Mono,051,14174,2751,2614,96,2710,4
2022-01-16,Monterey,053,433212,64663,57012,7152,64164,647
2022-01-16,Napa,055,140530,20843,19521,577,20098,109
2022-01-16,Nevada,057,99092,13314,12307,749,13056,111
2022-01-16,Orange,059,3164182,483774,451962,35157,487119,5932
2022-01-16,Placer,061,380077,53047,50076,5998,56074,508
2022-01-16,Plumas,063,18699,2395,2204,143,2347,12
2022-01-16,Riverside,065,2383286,517616,485191,24026,509217,5600
2022-01-16,Sacramento,067,1510023,235102,218819,16358,235177,2491
2022-01-16,San Benito,069,59416,10778,10377,344,10721,88
2022-01-16,San Bernardino,071,2135413,505308,474425,20958,495383,6259
2022-01-16,San Diego,073,3302833,631346,569241,41348,610589,4545
2022-01-16,San Francisco,075,870044,102198,94139,6393,100532,694
2022-01-16,San Joaquin,077,732212,139648,132214,7975,140189,1958
2022-01-16,San Luis Obispo,079,281455,42780,40113,2684,42797,379
2022-01-16,San Mateo,081,765935,100315,85966,4540,90506,585
2022-01-16,Santa Barbara,083,443738,69520,66111,3254,69365,582
2022-01-16,Santa Clara,085,1922200,249436,234293,8008,242301,1984
2022-01-16,Santa Cruz,087,273765,33807,31469,1697,33166,237
2022-01-16,Shasta,089,179085,26015,24980,4627,29607,449
2022-01-16,Sierra,091,2930,252,238,31,269,0
2022-01-16,Siskiyou,093,43540,3857,3748,1898,5646,62
2022-01-16,Solano,095,438530,66262,60885,3813,64698,391
2022-01-16,Sonoma,097,501317,66516,61842,1763,63605,419
2022-01-16,Stanislaus,099,539301,100375,96370,12643,109013,1379
2022-01-16,Sutter,101,95872,17612,16996,911,17907,198
2022-01-16,Tehama,103,63373,10303,9868,2094,11962,142
2022-01-16,Trinity,105,12862,1003,889,249,1138,19
2022-01-16,Tulare,107,460477,86623,80867,21417,102284,1199
2022-01-16,Tuolumne,109,53932,10049,9369,243,9612,91
2022-01-16,Ventura,111,848112,150543,140715,8198,148913,1234
2022-01-16,Yolo,113,214977,30490,28481,2345,30826,270
2022-01-16,Yuba,115,75493,13292,12760,699,13459,101
2022-01-15,Alameda,001,1643700,204308,177768,9458,187226,1561
2022-01-15,Alpine,003,1148,116,117,0,117,0
2022-01-15,Amador,005,37829,6952,6434,214,6648,72
2022-01-15,Butte,007,227075,27494,25032,5166,30198,348
2022-01-15,Calaveras,009,45235,5897,5258,137,5395,93
2022-01-15,Colusa,011,21464,2966,2796,888,3684,21
2022-01-15,Contra Costa,013,1133247,154748,137643,8563,146206,1082
2022-01-15,Del Norte,015,27424,4265,4065,88,4153,43
2022-01-15,El Dorado,017,186661,22968,20434,2507,22941,175
2022-01-15,Fresno,019,978130,184211,167361,17703,185064,2415
2022-01-15,Glenn,021,27897,4221,3906,1332,5238,39
2022-01-15,Humboldt,023,135768,13767,12419,1773,14192,123
2022-01-15,Imperial,025,180216,46228,42508,7368,49876,817
2022-01-15,Inyo,027,18085,3714,3395,143,3538,49
2022-01-15,Kern,029,883053,164753,150085,35485,185570,1938
2022-01-15,Kings,031,150075,40842,37221,2570,39791,391
2022-01-15,Lake,033,64148,8271,7641,483,8124,117
2022-01-15,Lassen,035,31185,7565,7274,606,7880,55
2022-01-15,Los Angeles,037,10098052,2335368,2047927,105832,2153759,27641
2022-01-15,Madera,039,155013,29823,27294,3438,30732,329
2022-01-15,Marin,041,260295,28074,25248,1653,26901,251
2022-01-15,Mariposa,043,17540,1965,1762,88,1850,6
2022-01-15,Mendocino,045,87422,10566,9534,1402,10936,102
2022-01-15,Merced,047,269075,53065,48904,4301,53205,715
2022-01-15,Modoc,049,8938,643,628,219,847,6
2022-01-15,Mono,051,14174,2746,2508,95,2603,4
2022-01-15,Monterey,053,433212,64149,55315,7083,62398,647
2022-01-15,Napa,055,140530,20722,17648,572,18220,109
2022-01-15,Nevada,057,99092,13256,11773,735,12508,111
2022-01-15,Orange,059,3164182,481179,433141,34882,468023,5914
2022-01-15,Placer,061,380077,52763,47780,5964,53744,501
2022-01-15,Plumas,063,18699,2374,2158,137,2295,12
2022-01-15,Riverside,065,2383286,514937,466381,23891,490272,5578
2022-01-15,Sacramento,067,1510023,233944,208156,16255,224411,2491
2022-01-15,San Benito,069,59416,10679,9868,338,10206,87
2022-01-15,San Bernardino,071,2135413,503029,454395,20810,475205,6233
2022-01-15,San Diego,073,3302833,627554,559385,41092,600477,4540
2022-01-15,San Francisco,075,870044,101208,88004,6257,94261,692
2022-01-15,San Joaquin,077,732212,139087,125136,7882,133018,1954
2022-01-15,San Luis Obispo,079,281455,42591,38231,2671,40902,374
2022-01-15,San Mateo,081,765935,99359,80494,4499,84993,582
2022-01-15,Santa Barbara,083,443738,68921,62312,3243,65555,579
2022-01-15,Santa Clara,085,1922200,247231,218986,7889,226875,1974
2022-01-15,Santa Cruz,087,273765,33451,29414,1689,31103,235
2022-01-15,Shasta,089,179085,25926,24482,4595,29077,445
2022-01-15,Sierra,091,2930,251,232,30,262,0
2022-01-15,Siskiyou,093,43540,3845,3661,1887,5548,62
2022-01-15,Solano,095,438530,65983,58061,3762,61823,389
2022-01-15,Sonoma,097,501317,65932,58181,1757,59938,418
2022-01-15,Stanislaus,099,539301,99792,92986,12544,105530,1379
2022-01-15,Sutter,101,95872,17522,16345,901,17246,197
2022-01-15,Tehama,103,63373,10254,9572,2075,11647,141
2022-01-15,Trinity,105,12862,1000,872,249,1121,19
2022-01-15,Tulare,107,460477,86177,77769,21292,99061,1192
2022-01-15,Tuolumne,109,53932,9950,9042,238,9280,91
2022-01-15,Ventura,111,848112,149770,134736,8162,142898,1227
2022-01-15,Yolo,113,214977,30311,27311,2325,29636,270
2022-01-15,Yuba,115,75493,13230,12200,695,12895,101
2022-01-14,Alameda,001,1643700,202265,177768,9405,187173,1561
2022-01-14,Alpine,003,1148,116,117,0,117,0
2022-01-14,Amador,005,37829,6876,6434,205,6639,72
2022-01-14,Butte,007,227075,27310,25032,5138,30170,348
2022-01-14,Calaveras,009,45235,5860,5258,136,5394,93
2022-01-14,Colusa,011,21464,2957,2796,878,3674,21
2022-01-14,Contra Costa,013,1133247,153305,137643,8462,146105,1082
2022-01-14,Del Norte,015,27424,4240,4065,87,4152,43
2022-01-14,El Dorado,017,186661,22813,20434,2489,22923,175
2022-01-14,Fresno,019,978130,182558,167361,17626,184987,2415
2022-01-14,Glenn,021,27897,4199,3906,1323,5229,39
2022-01-14,Humboldt,023,135768,13662,12419,1740,14159,123
2022-01-14,Imperial,025,180216,46057,42508,7348,49856,817
2022-01-14,Inyo,027,18085,3689,3395,139,3534,49
2022-01-14,Kern,029,883053,163757,150085,35048,185133,1938
2022-01-14,Kings,031,150075,40592,37221,2561,39782,391
2022-01-14,Lake,033,64148,8215,7641,470,8111,117
2022-01-14,Lassen,035,31185,7535,7274,594,7868,55
2022-01-14,Los Angeles,037,10098052,2316045,2047927,104792,2152719,27641
2022-01-14,Madera,039,155013,29586,27294,3413,30707,329
2022-01-14,Marin,041,260295,27813,25248,1617,26865,251
2022-01-14,Mariposa,043,17540,1950,1762,88,1850,6
2022-01-14,Mendocino,045,87422,10455,9534,1389,10923,102
2022-01-14,Merced,047,269075,52885,48904,4281,53185,715
2022-01-14,Modoc,049,8938,642,628,219,847,6
2022-01-14,Mono,051,14174,2725,2508,93,2601,4
2022-01-14,Monterey,053,433212,63454,55315,6992,62307,647
2022-01-14,Napa,055,140530,20552,17648,566,18214,109
2022-01-14,Nevada,057,99092,13133,11773,722,12495,111
2022-01-14,Orange,059,3164182,477446,433141,34561,467702,5914
2022-01-14,Placer,061,380077,52328,47780,5879,53659,501
2022-01-14,Plumas,063,18699,2366,2158,130,2288,12
2022-01-14,Riverside,065,2383286,511416,466381,23748,490129,5578
2022-01-14,Sacramento,067,1510023,232001,208156,16099,224255,2491
2022-01-14,San Benito,069,59416,10627,9868,337,10205,87
2022-01-14,San Bernardino,071,2135413,499925,454395,20624,475019,6233
2022-01-14,San Diego,073,3302833,621903,559385,40787,600172,4540
2022-01-14,San Francisco,075,870044,100037,88004,6080,94084,692
2022-01-14,San Joaquin,077,732212,138244,125136,7819,132955,1954
2022-01-14,San Luis Obispo,079,281455,42425,38231,2648,40879,374
2022-01-14,San Mateo,081,765935,98132,80494,4470,84964,582
2022-01-14,Santa Barbara,083,443738,68404,62312,3233,65545,579
2022-01-14,Santa Clara,085,1922200,244656,218986,7782,226768,1974
2022-01-14,Santa Cruz,087,273765,33075,29414,1679,31093,235
2022-01-14,Shasta,089,179085,25811,24482,4561,29043,445
2022-01-14,Sierra,091,2930,249,232,28,260,0
2022-01-14,Siskiyou,093,43540,3834,3661,1874,5535,62
2022-01-14,Solano,095,438530,65140,58061,3672,61733,389
2022-01-14,Sonoma,097,501317,65398,58181,1730,59911,418
2022-01-14,Stanislaus,099,539301,99186,92986,12443,105429,1379
2022-01-14,Sutter,101,95872,17396,16345,892,17237,197
2022-01-14,Tehama,103,63373,10201,9572,2063,11635,141
2022-01-14,Trinity,105,12862,995,872,247,1119,19
2022-01-14,Tulare,107,460477,85645,77769,21118,98887,1192
2022-01-14,Tuolumne,109,53932,9827,9042,233,9275,91
2022-01-14,Ventura,111,848112,148665,134736,8104,142840,1227
2022-01-14,Yolo,113,214977,30075,27311,2292,29603,270
2022-01-14,Yuba,115,75493,13127,12200,690,12890,101
2022-01-13,Alameda,001,1643700,197949,177768,9045,186813,1561
2022-01-13,Alpine,003,1148,115,117,0,117,0
2022-01-13,Amador,005,37829,6816,6434,184,6618,72
2022-01-13,Butte,007,227075,27011,25032,5026,30058,348
2022-01-13,Calaveras,009,45235,5769,5258,132,5390,93
2022-01-13,Colusa,011,21464,2926,2796,868,3664,21
2022-01-13,Contra Costa,013,1133247,150779,137643,8001,145644,1082
2022-01-13,Del Norte,015,27424,4204,4065,86,4151,43
2022-01-13,El Dorado,017,186661,22566,20434,2444,22878,175
2022-01-13,Fresno,019,978130,179756,167361,17257,184618,2415
2022-01-13,Glenn,021,27897,4151,3906,1297,5203,39
2022-01-13,Humboldt,023,135768,13509,12419,1678,14097,123
2022-01-13,Imperial,025,180216,45509,42508,7126,49634,817
2022-01-13,Inyo,027,18085,3633,3395,122,3517,49
2022-01-13,Kern,029,883053,162166,150085,34450,184535,1938
2022-01-13,Kings,031,150075,40111,37221,2516,39737,391
2022-01-13,Lake,033,64148,8115,7641,449,8090,117
2022-01-13,Lassen,035,31185,7506,7274,578,7852,55
2022-01-13,Los Angeles,037,10098052,2279572,2047927,103001,2150928,27641
2022-01-13,Madera,039,155013,29126,27294,3319,30613,329
2022-01-13,Marin,041,260295,27467,25248,1573,26821,251
2022-01-13,Mariposa,043,17540,1927,1762,85,1847,6
2022-01-13,Mendocino,045,87422,10364,9534,1321,10855,102
2022-01-13,Merced,047,269075,52228,48904,4018,52922,715
2022-01-13,Modoc,049,8938,639,628,219,847,6
2022-01-13,Mono,051,14174,2702,2508,90,2598,4
2022-01-13,Monterey,053,433212,62516,55315,6704,62019,647
2022-01-13,Napa,055,140530,20255,17648,556,18204,109
2022-01-13,Nevada,057,99092,12945,11773,692,12465,111
2022-01-13,Orange,059,3164182,470994,433141,34105,467246,5914
2022-01-13,Placer,061,380077,51695,47780,5764,53544,501
2022-01-13,Plumas,063,18699,2346,2158,120,2278,12
2022-01-13,Riverside,065,2383286,505128,466381,23417,489798,5578
2022-01-13,Sacramento,067,1510023,228910,208156,15288,223444,2491
2022-01-13,San Benito,069,59416,10524,9868,329,10197,87
2022-01-13,San Bernardino,071,2135413,494237,454395,20153,474548,6233
2022-01-13,San Diego,073,3302833,613378,559385,39915,599300,4540
2022-01-13,San Francisco,075,870044,98301,88004,5882,93886,692
2022-01-13,San Joaquin,077,732212,136177,125136,7671,132807,1954
2022-01-13,San Luis Obispo,079,281455,41822,38231,2543,40774,374
2022-01-13,San Mateo,081,765935,96344,80494,4229,84723,582
2022-01-13,Santa Barbara,083,443738,67407,62312,3047,65359,579
2022-01-13,Santa Clara,085,1922200,240397,218986,7445,226431,1974
2022-01-13,Santa Cruz,087,273765,32260,29414,1657,31071,235
2022-01-13,Shasta,089,179085,25604,24482,4488,28970,445
2022-01-13,Sierra,091,2930,248,232,28,260,0
2022-01-13,Siskiyou,093,43540,3812,3661,1833,5494,62
2022-01-13,Solano,095,438530,64009,58061,3560,61621,389
2022-01-13,Sonoma,097,501317,64332,58181,1671,59852,418
2022-01-13,Stanislaus,099,539301,98072,92986,12174,105160,1379
2022-01-13,Sutter,101,95872,17200,16345,827,17172,197
2022-01-13,Tehama,103,63373,10102,9572,2014,11586,141
2022-01-13,Trinity,105,12862,987,872,247,1119,19
2022-01-13,Tulare,107,460477,84361,77769,20800,98569,1192
2022-01-13,Tuolumne,109,53932,9687,9042,215,9257,91
2022-01-13,Ventura,111,848112,146879,134736,8016,142752,1227
2022-01-13,Yolo,113,214977,29673,27311,2245,29556,270
2022-01-13,Yuba,115,75493,12991,12200,661,12861,101
2022-01-12,Alameda,001,1643700,193317,173001,8576,181577,1563
2022-01-12,Alpine,003,1148,115,117,0,117,0
2022-01-12,Amador,005,37829,6768,6354,170,6524,71
2022-01-12,Butte,007,227075,26686,24631,4938,29569,348
2022-01-12,Calaveras,009,45235,5690,5151,126,5277,93
2022-01-12,Colusa,011,21464,2886,2772,855,3627,21
2022-01-12,Contra Costa,013,1133247,148238,134579,7637,142216,1077
2022-01-12,Del Norte,015,27424,4177,4019,84,4103,43
2022-01-12,El Dorado,017,186661,22243,20092,2403,22495,175
2022-01-12,Fresno,019,978130,177018,165316,16834,182150,2413
2022-01-12,Glenn,021,27897,4099,3859,1275,5134,39
2022-01-12,Humboldt,023,135768,13337,12081,1596,13677,122
2022-01-12,Imperial,025,180216,44848,41985,6812,48797,814
2022-01-12,Inyo,027,18085,3587,3334,106,3440,49
2022-01-12,Kern,029,883053,160028,148435,33712,182147,1933
2022-01-12,Kings,031,150075,39476,36780,2474,39254,391
2022-01-12,Lake,033,64148,7999,7535,405,7940,117
2022-01-12,Lassen,035,31185,7463,7223,551,7774,55
2022-01-12,Los Angeles,037,10098052,2239868,2005065,100752,2105817,27601
2022-01-12,Madera,039,155013,28811,26952,3228,30180,329
2022-01-12,Marin,041,260295,26977,24704,1522,26226,251
2022-01-12,Mariposa,043,17540,1898,1725,83,1808,6
2022-01-12,Mendocino,045,87422,10200,9379,1221,10600,103
2022-01-12,Merced,047,269075,51528,48441,3743,52184,710
2022-01-12,Modoc,049,8938,637,627,219,846,6
2022-01-12,Mono,051,14174,2666,2466,86,2552,4
2022-01-12,Monterey,053,433212,61531,54524,6339,60863,647
2022-01-12,Napa,055,140530,19997,17347,533,17880,109
2022-01-12,Nevada,057,99092,12729,11552,643,12195,111
2022-01-12,Orange,059,3164182,464209,425737,33514,459251,5912
2022-01-12,Placer,061,380077,51039,47004,5651,52655,501
2022-01-12,Plumas,063,18699,2307,2135,109,2244,12
2022-01-12,Riverside,065,2383286,497920,458881,23072,481953,5565
2022-01-12,Sacramento,067,1510023,225326,204696,14379,219075,2479
2022-01-12,San Benito,069,59416,10393,9737,317,10054,87
2022-01-12,San Bernardino,071,2135413,487951,447869,19532,467401,6222
2022-01-12,San Diego,073,3302833,602873,551669,39057,590726,4529
2022-01-12,San Francisco,075,870044,96464,85700,5769,91469,691
2022-01-12,San Joaquin,077,732212,133892,122850,7545,130395,1948
2022-01-12,San Luis Obispo,079,281455,41091,37727,2460,40187,373
2022-01-12,San Mateo,081,765935,94310,78476,3851,82327,582
2022-01-12,Santa Barbara,083,443738,66263,60815,2942,63757,578
2022-01-12,Santa Clara,085,1922200,235906,213177,7063,220240,1971
2022-01-12,Santa Cruz,087,273765,31606,28463,1608,30071,235
2022-01-12,Shasta,089,179085,25387,24324,4422,28746,446
2022-01-12,Sierra,091,2930,247,228,28,256,0
2022-01-12,Siskiyou,093,43540,3785,3639,1786,5425,62
2022-01-12,Solano,095,438530,62963,57052,3438,60490,386
2022-01-12,Sonoma,097,501317,63046,56394,1587,57981,417
2022-01-12,Stanislaus,099,539301,96839,91738,11851,103589,1373
2022-01-12,Sutter,101,95872,17004,16135,794,16929,197
2022-01-12,Tehama,103,63373,10013,9475,1953,11428,141
2022-01-12,Trinity,105,12862,983,868,246,1114,19
2022-01-12,Tulare,107,460477,83223,76943,20388,97331,1192
2022-01-12,Tuolumne,109,53932,9556,8870,197,9067,91
2022-01-12,Ventura,111,848112,144968,132180,7937,140117,1220
2022-01-12,Yolo,113,214977,29274,26888,2171,29059,270
2022-01-12,Yuba,115,75493,12832,12015,634,12649,101
2022-01-11,Alameda,001,1643700,188796,169181,8178,177359,1561
2022-01-11,Alpine,003,1148,115,116,0,116,0
2022-01-11,Amador,005,37829,6684,6317,155,6472,71
2022-01-11,Butte,007,227075,26291,24479,4848,29327,347
2022-01-11,Calaveras,009,45235,5560,5083,112,5195,93
2022-01-11,Colusa,011,21464,2864,2766,841,3607,21
2022-01-11,Contra Costa,013,1133247,145267,132410,7153,139563,1077
2022-01-11,Del Norte,015,27424,4143,4006,82,4088,43
2022-01-11,El Dorado,017,186661,21896,19842,2331,22173,174
2022-01-11,Fresno,019,978130,173976,163509,16484,179993,2404
2022-01-11,Glenn,021,27897,4037,3844,1230,5074,39
2022-01-11,Humboldt,023,135768,13116,11960,1503,13463,122
2022-01-11,Imperial,025,180216,44241,41444,6604,48048,813
2022-01-11,Inyo,027,18085,3489,3278,99,3377,49
2022-01-11,Kern,029,883053,157742,146942,32880,179822,1929
2022-01-11,Kings,031,150075,38888,36524,2443,38967,389
2022-01-11,Lake,033,64148,7922,7494,389,7883,117
2022-01-11,Lassen,035,31185,7414,7210,537,7747,55
2022-01-11,Los Angeles,037,10098052,2197438,1966319,98523,2064842,27563
2022-01-11,Madera,039,155013,28397,26688,3149,29837,329
2022-01-11,Marin,041,260295,26621,24387,1477,25864,251
2022-01-11,Mariposa,043,17540,1876,1718,79,1797,6
2022-01-11,Mendocino,045,87422,10039,9301,1123,10424,102
2022-01-11,Merced,047,269075,50764,48068,3560,51628,708
2022-01-11,Modoc,049,8938,636,626,218,844,6
2022-01-11,Mono,051,14174,2623,2425,85,2510,4
2022-01-11,Monterey,053,433212,60487,53911,5984,59895,646
2022-01-11,Napa,055,140530,19556,17020,485,17505,109
2022-01-11,Nevada,057,99092,12503,11467,608,12075,110
2022-01-11,Orange,059,3164182,456530,417703,32876,450579,5909
2022-01-11,Placer,061,380077,50290,46459,5507,51966,500
2022-01-11,Plumas,063,18699,2272,2099,101,2200,12
2022-01-11,Riverside,065,2383286,490198,453766,22754,476520,5551
2022-01-11,Sacramento,067,1510023,221148,201058,13318,214376,2489
2022-01-11,San Benito,069,59416,10256,9624,304,9928,83
2022-01-11,San Bernardino,071,2135413,480299,442960,18925,461885,6198
2022-01-11,San Diego,073,3302833,590855,536954,37951,574905,4520
2022-01-11,San Francisco,075,870044,94264,83678,5608,89286,691
2022-01-11,San Joaquin,077,732212,131518,121139,7381,128520,1944
2022-01-11,San Luis Obispo,079,281455,40313,37183,2341,39524,372
2022-01-11,San Mateo,081,765935,92013,76756,3629,80385,582
2022-01-11,Santa Barbara,083,443738,64961,59758,2803,62561,578
2022-01-11,Santa Clara,085,1922200,230525,208425,6606,215031,1971
2022-01-11,Santa Cruz,087,273765,31098,27709,1557,29266,232
2022-01-11,Shasta,089,179085,25132,24132,4327,28459,446
2022-01-11,Sierra,091,2930,245,228,28,256,0
2022-01-11,Siskiyou,093,43540,3760,3621,1736,5357,62
2022-01-11,Solano,095,438530,61567,56349,3282,59631,388
2022-01-11,Sonoma,097,501317,61527,55411,1506,56917,416
2022-01-11,Stanislaus,099,539301,95476,90998,11502,102500,1372
2022-01-11,Sutter,101,95872,16803,15993,738,16731,197
2022-01-11,Tehama,103,63373,9882,9406,1905,11311,140
2022-01-11,Trinity,105,12862,971,858,244,1102,19
2022-01-11,Tulare,107,460477,81910,76267,19976,96243,1188
2022-01-11,Tuolumne,109,53932,9398,8811,190,9001,91
2022-01-11,Ventura,111,848112,142736,129548,7801,137349,1220
2022-01-11,Yolo,113,214977,28721,26482,2109,28591,270
2022-01-11,Yuba,115,75493,12658,11912,613,12525,101
2022-01-10,Alameda,001,1643700,183693,165657,7651,173308,1559
2022-01-10,Alpine,003,1148,115,116,0,116,0
2022-01-10,Amador,005,37829,6580,6279,138,6417,71
2022-01-10,Butte,007,227075,25949,24217,4758,28975,347
2022-01-10,Calaveras,009,45235,5461,5025,106,5131,93
2022-01-10,Colusa,011,21464,2836,2758,831,3589,21
2022-01-10,Contra Costa,013,1133247,142543,129951,6636,136587,1077
2022-01-10,Del Norte,015,27424,4120,3970,82,4052,43
2022-01-10,El Dorado,017,186661,21332,19606,2274,21880,172
2022-01-10,Fresno,019,978130,170927,161593,16086,177679,2404
2022-01-10,Glenn,021,27897,3978,3807,1216,5023,39
2022-01-10,Humboldt,023,135768,12872,11778,1369,13147,121
2022-01-10,Imperial,025,180216,43516,41080,6378,47458,811
2022-01-10,Inyo,027,18085,3434,3227,87,3314,49
2022-01-10,Kern,029,883053,155169,145744,32126,177870,1929
2022-01-10,Kings,031,150075,38265,36286,2407,38693,389
2022-01-10,Lake,033,64148,7833,7416,365,7781,117
2022-01-10,Lassen,035,31185,7377,7192,514,7706,55
2022-01-10,Los Angeles,037,10098052,2151910,1932475,96030,2028505,27546
2022-01-10,Madera,039,155013,27945,26501,3047,29548,328
2022-01-10,Marin,041,260295,26134,24023,1403,25426,251
2022-01-10,Mariposa,043,17540,1836,1684,73,1757,6
2022-01-10,Mendocino,045,87422,9866,9163,1035,10198,101
2022-01-10,Merced,047,269075,49964,47632,3269,50901,707
2022-01-10,Modoc,049,8938,635,622,216,838,6
2022-01-10,Mono,051,14174,2557,2415,80,2495,4
2022-01-10,Monterey,053,433212,59531,53485,5667,59152,645
2022-01-10,Napa,055,140530,19178,16775,470,17245,109
2022-01-10,Nevada,057,99092,12280,11300,570,11870,110
2022-01-10,Orange,059,3164182,447843,406170,32022,438192,5906
2022-01-10,Placer,061,380077,49439,45642,5345,50987,498
2022-01-10,Plumas,063,18699,2237,2086,99,2185,12
2022-01-10,Riverside,065,2383286,481946,445536,22301,467837,5546
2022-01-10,Sacramento,067,1510023,216632,198023,12242,210265,2474
2022-01-10,San Benito,069,59416,10084,9467,294,9761,83
2022-01-10,San Bernardino,071,2135413,472145,437207,18207,455414,6184
2022-01-10,San Diego,073,3302833,578145,530506,36812,567318,4500
2022-01-10,San Francisco,075,870044,92470,82209,5347,87556,690
2022-01-10,San Joaquin,077,732212,128848,119587,7110,126697,1927
2022-01-10,San Luis Obispo,079,281455,39499,36618,2243,38861,371
2022-01-10,San Mateo,081,765935,89369,75210,3371,78581,582
2022-01-10,Santa Barbara,083,443738,63701,58957,2613,61570,578
2022-01-10,Santa Clara,085,1922200,224745,203540,6123,209663,1971
2022-01-10,Santa Cruz,087,273765,30258,26906,1518,28424,232
2022-01-10,Shasta,089,179085,24933,23983,4250,28233,446
2022-01-10,Sierra,091,2930,242,223,28,251,0
2022-01-10,Siskiyou,093,43540,3727,3592,1692,5284,62
2022-01-10,Solano,095,438530,60528,55663,3073,58736,385
2022-01-10,Sonoma,097,501317,59981,54478,1459,55937,412
2022-01-10,Stanislaus,099,539301,94147,89997,11185,101182,1372
2022-01-10,Sutter,101,95872,16558,15823,691,16514,196
2022-01-10,Tehama,103,63373,9770,9360,1849,11209,140
2022-01-10,Trinity,105,12862,967,849,242,1091,19
2022-01-10,Tulare,107,460477,80409,75498,19560,95058,1186
2022-01-10,Tuolumne,109,53932,9272,8685,178,8863,91
2022-01-10,Ventura,111,848112,140133,126240,7659,133899,1217
2022-01-10,Yolo,113,214977,28126,26065,2057,28122,270
2022-01-10,Yuba,115,75493,12409,11776,578,12354,101
2022-01-09,Alameda,001,1643700,179204,162701,6971,169672,1561
2022-01-09,Alpine,003,1148,115,116,0,116,0
2022-01-09,Amador,005,37829,6493,6215,126,6341,71
2022-01-09,Butte,007,227075,25560,24018,4643,28661,347
2022-01-09,Calaveras,009,45235,5331,4976,97,5073,93
2022-01-09,Colusa,011,21464,2809,2750,809,3559,21
2022-01-09,Contra Costa,013,1133247,139692,128050,5979,134029,1077
2022-01-09,Del Norte,015,27424,4081,3950,78,4028,43
2022-01-09,El Dorado,017,186661,20971,19430,2208,21638,172
2022-01-09,Fresno,019,978130,168340,159989,15702,175691,2405
2022-01-09,Glenn,021,27897,3923,3797,1195,4992,39
2022-01-09,Humboldt,023,135768,12628,11582,1246,12828,121
2022-01-09,Imperial,025,180216,42673,40608,6107,46715,811
2022-01-09,Inyo,027,18085,3331,3149,78,3227,49
2022-01-09,Kern,029,883053,152708,144819,31377,176196,1927
2022-01-09,Kings,031,150075,37588,36041,2368,38409,389
2022-01-09,Lake,033,64148,7722,7393,320,7713,117
2022-01-09,Lassen,035,31185,7312,7172,485,7657,55
2022-01-09,Los Angeles,037,10098052,2103864,1887830,93020,1980850,27532
2022-01-09,Madera,039,155013,27563,26325,2947,29272,328
2022-01-09,Marin,041,260295,25682,23708,1311,25019,251
2022-01-09,Mariposa,043,17540,1786,1660,72,1732,6
2022-01-09,Mendocino,045,87422,9657,9097,923,10020,101
2022-01-09,Merced,047,269075,49095,47294,2998,50292,706
2022-01-09,Modoc,049,8938,633,619,216,835,6
2022-01-09,Mono,051,14174,2522,2390,73,2463,4
2022-01-09,Monterey,053,433212,58471,53251,5391,58642,645
2022-01-09,Napa,055,140530,18683,16614,454,17068,109
2022-01-09,Nevada,057,99092,12019,11152,508,11660,110
2022-01-09,Orange,059,3164182,437854,400563,31065,431628,5905
2022-01-09,Placer,061,380077,48459,45081,5194,50275,498
2022-01-09,Plumas,063,18699,2198,2081,79,2160,12
2022-01-09,Riverside,065,2383286,472975,440413,21753,462166,5546
2022-01-09,Sacramento,067,1510023,211823,195444,11092,206536,2475
2022-01-09,San Benito,069,59416,9898,9363,266,9629,83
2022-01-09,San Bernardino,071,2135413,464097,430257,17390,447647,6180
2022-01-09,San Diego,073,3302833,564980,478206,34959,513165,4500
2022-01-09,San Francisco,075,870044,90605,80463,5098,85561,690
2022-01-09,San Joaquin,077,732212,125771,118422,6944,125366,1927
2022-01-09,San Luis Obispo,079,281455,38691,36291,2135,38426,371
2022-01-09,San Mateo,081,765935,86858,73867,3040,76907,582
2022-01-09,Santa Barbara,083,443738,62014,58280,2350,60630,578
2022-01-09,Santa Clara,085,1922200,218693,199889,5578,205467,1976
2022-01-09,Santa Cruz,087,273765,29507,26513,1486,27999,232
2022-01-09,Shasta,089,179085,24698,23926,4162,28088,446
2022-01-09,Sierra,091,2930,239,223,26,249,0
2022-01-09,Siskiyou,093,43540,3699,3580,1631,5211,62
2022-01-09,Solano,095,438530,59371,54985,2786,57771,384
2022-01-09,Sonoma,097,501317,58305,53543,1420,54963,412
2022-01-09,Stanislaus,099,539301,92783,89248,10926,100174,1372
2022-01-09,Sutter,101,95872,16270,15695,609,16304,196
2022-01-09,Tehama,103,63373,9651,9306,1797,11103,140
2022-01-09,Trinity,105,12862,963,848,240,1088,19
2022-01-09,Tulare,107,460477,78988,75085,19165,94250,1186
2022-01-09,Tuolumne,109,53932,9117,8595,159,8754,91
2022-01-09,Ventura,111,848112,137076,124269,7425,131694,1217
2022-01-09,Yolo,113,214977,27517,25632,2011,27643,270
2022-01-09,Yuba,115,75493,12212,11666,547,12213,101
2022-01-08,Alameda,001,1643700,177316,148560,6825,155385,1558
2022-01-08,Alpine,003,1148,115,114,0,114,0
2022-01-08,Amador,005,37829,6460,6091,121,6212,71
2022-01-08,Butte,007,227075,25379,23429,4605,28034,347
2022-01-08,Calaveras,009,45235,5285,4823,93,4916,93
2022-01-08,Colusa,011,21464,2801,2713,806,3519,21
2022-01-08,Contra Costa,013,1133247,138188,119907,5900,125807,1077
2022-01-08,Del Norte,015,27424,4064,3902,78,3980,43
2022-01-08,El Dorado,017,186661,20790,18599,2174,20773,172
2022-01-08,Fresno,019,978130,167456,155394,15569,170963,2393
2022-01-08,Glenn,021,27897,3915,3732,1190,4922,39
2022-01-08,Humboldt,023,135768,12508,11149,1220,12369,121
2022-01-08,Imperial,025,180216,42486,39429,5960,45389,800
2022-01-08,Inyo,027,18085,3317,3020,75,3095,49
2022-01-08,Kern,029,883053,151572,140410,30942,171352,1921
2022-01-08,Kings,031,150075,37346,35275,2350,37625,390
2022-01-08,Lake,033,64148,7682,7209,312,7521,117
2022-01-08,Lassen,035,31185,7286,7127,469,7596,55
2022-01-08,Los Angeles,037,10098052,2085485,1765787,91268,1857055,27476
2022-01-08,Madera,039,155013,27395,25767,2910,28677,328
2022-01-08,Marin,041,260295,25397,22377,1300,23677,251
2022-01-08,Mariposa,043,17540,1776,1588,72,1660,6
2022-01-08,Mendocino,045,87422,9583,8792,921,9713,101
2022-01-08,Merced,047,269075,48923,46094,2977,49071,703
2022-01-08,Modoc,049,8938,633,610,216,826,6
2022-01-08,Mono,051,14174,2511,2240,68,2308,4
2022-01-08,Monterey,053,433212,58083,51721,5298,57019,644
2022-01-08,Napa,055,140530,18529,15819,428,16247,109
2022-01-08,Nevada,057,99092,11937,10765,495,11260,110
2022-01-08,Orange,059,3164182,434057,375124,30210,405334,5903
2022-01-08,Placer,061,380077,48019,43172,5152,48324,495
2022-01-08,Plumas,063,18699,2188,2053,74,2127,12
2022-01-08,Riverside,065,2383286,469459,422591,21479,444070,5535
2022-01-08,Sacramento,067,1510023,210388,185118,10927,196045,2470
2022-01-08,San Benito,069,59416,9735,9016,263,9279,83
2022-01-08,San Bernardino,071,2135413,460790,411724,16992,428716,6122
2022-01-08,San Diego,073,3302833,560080,472273,34417,506690,4495
2022-01-08,San Francisco,075,870044,89408,73660,4817,78477,690
2022-01-08,San Joaquin,077,732212,124806,112514,6848,119362,1916
2022-01-08,San Luis Obispo,079,281455,38490,34489,2092,36581,369
2022-01-08,San Mateo,081,765935,85476,67918,2953,70871,582
2022-01-08,Santa Barbara,083,443738,61319,54617,2316,56933,575
2022-01-08,Santa Clara,085,1922200,215659,183842,5370,189212,1966
2022-01-08,Santa Cruz,087,273765,29082,24678,1465,26143,230
2022-01-08,Shasta,089,179085,24611,23585,4130,27715,445
2022-01-08,Sierra,091,2930,235,215,25,240,0
2022-01-08,Siskiyou,093,43540,3687,3545,1617,5162,62
2022-01-08,Solano,095,438530,58963,52452,2717,55169,383
2022-01-08,Sonoma,097,501317,57783,50130,1386,51516,411
2022-01-08,Stanislaus,099,539301,92143,87049,10818,97867,1372
2022-01-08,Sutter,101,95872,16152,15261,596,15857,195
2022-01-08,Tehama,103,63373,9620,9109,1789,10898,140
2022-01-08,Trinity,105,12862,957,836,240,1076,19
2022-01-08,Tulare,107,460477,78594,73600,19027,92627,1185
2022-01-08,Tuolumne,109,53932,9010,8360,156,8516,91
2022-01-08,Ventura,111,848112,135908,117229,7293,124522,1216
2022-01-08,Yolo,113,214977,27225,24006,1982,25988,270
2022-01-08,Yuba,115,75493,12125,11277,544,11821,101
2022-01-07,Alameda,001,1643700,174628,148560,6713,155273,1558
2022-01-07,Alpine,003,1148,115,114,0,114,0
2022-01-07,Amador,005,37829,6411,6091,119,6210,71
2022-01-07,Butte,007,227075,25174,23429,4573,28002,347
2022-01-07,Calaveras,009,45235,5247,4823,93,4916,93
2022-01-07,Colusa,011,21464,2792,2713,795,3508,21
2022-01-07,Contra Costa,013,1133247,136321,119907,5778,125685,1077
2022-01-07,Del Norte,015,27424,4048,3902,77,3979,43
2022-01-07,El Dorado,017,186661,20628,18599,2160,20759,172
2022-01-07,Fresno,019,978130,166095,155394,15471,170865,2393
2022-01-07,Glenn,021,27897,3895,3732,1187,4919,39
2022-01-07,Humboldt,023,135768,12366,11149,1192,12341,121
2022-01-07,Imperial,025,180216,42326,39429,5875,45304,800
2022-01-07,Inyo,027,18085,3298,3020,73,3093,49
2022-01-07,Kern,029,883053,150602,140410,30497,170907,1921
2022-01-07,Kings,031,150075,37169,35275,2336,37611,390
2022-01-07,Lake,033,64148,7635,7209,286,7495,117
2022-01-07,Lassen,035,31185,7272,7127,466,7593,55
2022-01-07,Los Angeles,037,10098052,2054306,1765787,89799,1855586,27476
2022-01-07,Madera,039,155013,27214,25767,2875,28642,328
2022-01-07,Marin,041,260295,25017,22377,1282,23659,251
2022-01-07,Mariposa,043,17540,1760,1588,72,1660,6
2022-01-07,Mendocino,045,87422,9490,8792,920,9712,101
2022-01-07,Merced,047,269075,48758,46094,2953,49047,703
2022-01-07,Modoc,049,8938,632,610,216,826,6
2022-01-07,Mono,051,14174,2473,2240,62,2302,4
2022-01-07,Monterey,053,433212,57664,51721,5205,56926,644
2022-01-07,Napa,055,140530,18302,15819,407,16226,109
2022-01-07,Nevada,057,99092,11810,10765,474,11239,110
2022-01-07,Orange,059,3164182,429247,375124,29589,404713,5903
2022-01-07,Placer,061,380077,47514,43172,5104,48276,495
2022-01-07,Plumas,063,18699,2179,2053,73,2126,12
2022-01-07,Riverside,065,2383286,465641,422591,21249,443840,5535
2022-01-07,Sacramento,067,1510023,208111,185118,10767,195885,2470
2022-01-07,San Benito,069,59416,9690,9016,262,9278,83
2022-01-07,San Bernardino,071,2135413,456910,411724,16762,428486,6122
2022-01-07,San Diego,073,3302833,552944,472273,33869,506142,4495
2022-01-07,San Francisco,075,870044,87971,73660,4557,78217,690
2022-01-07,San Joaquin,077,732212,123852,112514,6788,119302,1916
2022-01-07,San Luis Obispo,079,281455,38275,34489,2037,36526,369
2022-01-07,San Mateo,081,765935,84010,67918,2894,70812,582
2022-01-07,Santa Barbara,083,443738,60619,54617,2294,56911,575
2022-01-07,Santa Clara,085,1922200,212414,183842,5260,189102,1966
2022-01-07,Santa Cruz,087,273765,28602,24678,1449,26127,230
2022-01-07,Shasta,089,179085,24517,23585,4096,27681,445
2022-01-07,Sierra,091,2930,232,215,25,240,0
2022-01-07,Siskiyou,093,43540,3677,3545,1605,5150,62
2022-01-07,Solano,095,438530,58282,52452,2676,55128,383
2022-01-07,Sonoma,097,501317,57180,50130,1298,51428,411
2022-01-07,Stanislaus,099,539301,91620,87049,10731,97780,1372
2022-01-07,Sutter,101,95872,16001,15261,583,15844,195
2022-01-07,Tehama,103,63373,9584,9109,1776,10885,140
2022-01-07,Trinity,105,12862,950,836,239,1075,19
2022-01-07,Tulare,107,460477,78161,73600,18880,92480,1185
2022-01-07,Tuolumne,109,53932,8922,8360,152,8512,91
2022-01-07,Ventura,111,848112,134283,117229,7165,124394,1216
2022-01-07,Yolo,113,214977,26852,24006,1963,25969,270
2022-01-07,Yuba,115,75493,12021,11277,539,11816,101
2022-01-06,Alameda,001,1643700,169265,148560,6300,154860,1558
2022-01-06,Alpine,003,1148,114,114,0,114,0
2022-01-06,Amador,005,37829,6359,6091,113,6204,71
2022-01-06,Butte,007,227075,24883,23429,4488,27917,347
2022-01-06,Calaveras,009,45235,5126,4823,91,4914,93
2022-01-06,Colusa,011,21464,2772,2713,786,3499,21
2022-01-06,Contra Costa,013,1133247,133456,119907,5362,125269,1077
2022-01-06,Del Norte,015,27424,4014,3902,75,3977,43
2022-01-06,El Dorado,017,186661,20295,18599,2119,20718,172
2022-01-06,Fresno,019,978130,163968,155394,15202,170596,2393
2022-01-06,Glenn,021,27897,3868,3732,1161,4893,39
2022-01-06,Humboldt,023,135768,12140,11149,1151,12300,121
2022-01-06,Imperial,025,180216,41740,39429,5670,45099,800
2022-01-06,Inyo,027,18085,3260,3020,73,3093,49
2022-01-06,Kern,029,883053,148930,140410,29820,170230,1921
2022-01-06,Kings,031,150075,36846,35275,2311,37586,390
2022-01-06,Lake,033,64148,7561,7209,274,7483,117
2022-01-06,Lassen,035,31185,7250,7127,460,7587,55
2022-01-06,Los Angeles,037,10098052,2000176,1765787,87428,1853215,27476
2022-01-06,Madera,039,155013,26908,25767,2818,28585,328
2022-01-06,Marin,041,260295,24616,22377,1249,23626,251
2022-01-06,Mariposa,043,17540,1741,1588,70,1658,6
2022-01-06,Mendocino,045,87422,9394,8792,879,9671,101
2022-01-06,Merced,047,269075,48209,46094,2817,48911,703
2022-01-06,Modoc,049,8938,631,610,216,826,6
2022-01-06,Mono,051,14174,2450,2240,59,2299,4
2022-01-06,Monterey,053,433212,56942,51721,4949,56670,644
2022-01-06,Napa,055,140530,17903,15819,398,16217,109
2022-01-06,Nevada,057,99092,11610,10765,462,11227,110
2022-01-06,Orange,059,3164182,419799,375124,28841,403965,5903
2022-01-06,Placer,061,380077,46770,43172,5016,48188,495
2022-01-06,Plumas,063,18699,2161,2053,65,2118,12
2022-01-06,Riverside,065,2383286,458169,422591,20954,443545,5535
2022-01-06,Sacramento,067,1510023,204043,185118,10004,195122,2470
2022-01-06,San Benito,069,59416,9590,9016,255,9271,83
2022-01-06,San Bernardino,071,2135413,449596,411724,16274,427998,6122
2022-01-06,San Diego,073,3302833,541293,472273,32872,505145,4495
2022-01-06,San Francisco,075,870044,85659,73660,4303,77963,690
2022-01-06,San Joaquin,077,732212,121692,112514,6706,119220,1916
2022-01-06,San Luis Obispo,079,281455,37575,34489,1966,36455,369
2022-01-06,San Mateo,081,765935,81592,67918,2713,70631,582
2022-01-06,Santa Barbara,083,443738,59452,54617,2232,56849,575
2022-01-06,Santa Clara,085,1922200,207517,183842,4873,188715,1966
2022-01-06,Santa Cruz,087,273765,28042,24678,1426,26104,230
2022-01-06,Shasta,089,179085,24373,23585,4046,27631,445
2022-01-06,Sierra,091,2930,229,215,25,240,0
2022-01-06,Siskiyou,093,43540,3661,3545,1559,5104,62
2022-01-06,Solano,095,438530,57268,52452,2501,54953,383
2022-01-06,Sonoma,097,501317,55791,50130,1265,51395,411
2022-01-06,Stanislaus,099,539301,90472,87049,10567,97616,1372
2022-01-06,Sutter,101,95872,15824,15261,554,15815,195
2022-01-06,Tehama,103,63373,9506,9109,1749,10858,140
2022-01-06,Trinity,105,12862,943,836,238,1074,19
2022-01-06,Tulare,107,460477,77453,73600,18705,92305,1185
2022-01-06,Tuolumne,109,53932,8813,8360,146,8506,91
2022-01-06,Ventura,111,848112,131589,117229,7008,124237,1216
2022-01-06,Yolo,113,214977,26297,24006,1919,25925,270
2022-01-06,Yuba,115,75493,11886,11277,522,11799,101
2022-01-05,Alameda,001,1643700,164103,144824,5867,150691,1548
2022-01-05,Alpine,003,1148,114,112,0,112,0
2022-01-05,Amador,005,37829,6315,6012,110,6122,70
2022-01-05,Butte,007,227075,24580,23134,4430,27564,343
2022-01-05,Calaveras,009,45235,5070,4758,89,4847,90
2022-01-05,Colusa,011,21464,2759,2704,775,3479,21
2022-01-05,Contra Costa,013,1133247,130450,117188,4914,122102,1071
2022-01-05,Del Norte,015,27424,3993,3862,73,3935,43
2022-01-05,El Dorado,017,186661,19910,18367,2089,20456,171
2022-01-05,Fresno,019,978130,161953,153033,14936,167969,2377
2022-01-05,Glenn,021,27897,3820,3700,1151,4851,39
2022-01-05,Humboldt,023,135768,11936,10938,1103,12041,120
2022-01-05,Imperial,025,180216,41107,38789,5515,44304,800
2022-01-05,Inyo,027,18085,3177,2939,69,3008,49
2022-01-05,Kern,029,883053,147152,138186,29243,167429,1913
2022-01-05,Kings,031,150075,36504,34893,2292,37185,387
2022-01-05,Lake,033,64148,7480,7129,258,7387,117
2022-01-05,Lassen,035,31185,7230,7077,452,7529,55
2022-01-05,Los Angeles,037,10098052,1943912,1729640,85027,1814667,27443
2022-01-05,Madera,039,155013,26668,25392,2727,28119,327
2022-01-05,Marin,041,260295,24271,21829,1197,23026,251
2022-01-05,Mariposa,043,17540,1715,1564,69,1633,6
2022-01-05,Mendocino,045,87422,9263,8625,844,9469,101
2022-01-05,Merced,047,269075,47633,45721,2685,48406,700
2022-01-05,Modoc,049,8938,628,603,216,819,6
2022-01-05,Mono,051,14174,2430,2201,55,2256,4
2022-01-05,Monterey,053,433212,56115,51241,4749,55990,639
2022-01-05,Napa,055,140530,17540,15494,366,15860,108
2022-01-05,Nevada,057,99092,11410,10624,445,11069,110
2022-01-05,Orange,059,3164182,409764,366139,27788,393927,5869
2022-01-05,Placer,061,380077,45888,42456,4920,47376,492
2022-01-05,Plumas,063,18699,2141,2020,63,2083,12
2022-01-05,Riverside,065,2383286,450718,415253,20598,435851,5502
2022-01-05,Sacramento,067,1510023,199267,181488,9016,190504,2455
2022-01-05,San Benito,069,59416,9397,8829,243,9072,83
2022-01-05,San Bernardino,071,2135413,441319,405323,15719,421042,6085
2022-01-05,San Diego,073,3302833,527698,466602,31891,498493,4495
2022-01-05,San Francisco,075,870044,83100,71405,4166,75571,686
2022-01-05,San Joaquin,077,732212,119161,110497,6627,117124,1903
2022-01-05,San Luis Obispo,079,281455,36778,34066,1889,35955,369
2022-01-05,San Mateo,081,765935,79430,66018,2514,68532,578
2022-01-05,Santa Barbara,083,443738,58147,53082,2152,55234,570
2022-01-05,Santa Clara,085,1922200,201757,178629,4456,183085,1961
2022-01-05,Santa Cruz,087,273765,27289,24394,1403,25797,229
2022-01-05,Shasta,089,179085,24215,23361,4017,27378,441
2022-01-05,Sierra,091,2930,226,210,23,233,0
2022-01-05,Siskiyou,093,43540,3651,3513,1530,5043,60
2022-01-05,Solano,095,438530,56222,51505,2365,53870,380
2022-01-05,Sonoma,097,501317,54528,49120,1103,50223,412
2022-01-05,Stanislaus,099,539301,89489,86248,10412,96660,1360
2022-01-05,Sutter,101,95872,15622,15117,514,15631,193
2022-01-05,Tehama,103,63373,9409,9011,1718,10729,140
2022-01-05,Trinity,105,12862,940,822,236,1058,19
2022-01-05,Tulare,107,460477,76673,72718,18528,91246,1173
2022-01-05,Tuolumne,109,53932,8720,8223,139,8362,90
2022-01-05,Ventura,111,848112,128835,114752,6802,121554,1211
2022-01-05,Yolo,113,214977,25687,23401,1876,25277,269
2022-01-05,Yuba,115,75493,11703,11138,496,11634,100
2022-01-04,Alameda,001,1643700,158537,143360,5454,148814,1532
2022-01-04,Alpine,003,1148,114,113,0,113,0
2022-01-04,Amador,005,37829,6248,6025,105,6130,71
2022-01-04,Butte,007,227075,24282,23094,4363,27457,346
2022-01-04,Calaveras,009,45235,4995,4767,86,4853,93
2022-01-04,Colusa,011,21464,2741,2689,768,3457,21
2022-01-04,Contra Costa,013,1133247,127395,116005,4554,120559,1075
2022-01-04,Del Norte,015,27424,3961,3882,70,3952,43
2022-01-04,El Dorado,017,186661,19550,18339,2067,20406,172
2022-01-04,Fresno,019,978130,159795,153244,14685,167929,2380
2022-01-04,Glenn,021,27897,3790,3705,1137,4842,39
2022-01-04,Humboldt,023,135768,11684,10865,1052,11917,120
2022-01-04,Imperial,025,180216,40504,38596,5250,43846,800
2022-01-04,Inyo,027,18085,3093,2870,68,2938,49
2022-01-04,Kern,029,883053,145222,138245,28656,166901,1916
2022-01-04,Kings,031,150075,36181,34931,2276,37207,388
2022-01-04,Lake,033,64148,7439,7152,248,7400,117
2022-01-04,Lassen,035,31185,7207,7111,448,7559,55
2022-01-04,Los Angeles,037,10098052,1883979,1705253,82684,1787937,27419
2022-01-04,Madera,039,155013,26325,25425,2658,28083,328
2022-01-04,Marin,041,260295,23787,21675,1138,22813,251
2022-01-04,Mariposa,043,17540,1679,1564,68,1632,6
2022-01-04,Mendocino,045,87422,9140,8636,820,9456,101
2022-01-04,Merced,047,269075,47022,45583,2556,48139,700
2022-01-04,Modoc,049,8938,625,611,216,827,6
2022-01-04,Mono,051,14174,2381,2190,45,2235,4
2022-01-04,Monterey,053,433212,55379,51176,4554,55730,643
2022-01-04,Napa,055,140530,17038,15370,336,15706,107
2022-01-04,Nevada,057,99092,11254,10608,433,11041,110
2022-01-04,Orange,059,3164182,399002,362051,26646,388697,5897
2022-01-04,Placer,061,380077,45054,42285,4802,47087,494
2022-01-04,Plumas,063,18699,2115,2014,61,2075,12
2022-01-04,Riverside,065,2383286,442200,413366,20248,433614,5504
2022-01-04,Sacramento,067,1510023,194315,181271,8262,189533,2453
2022-01-04,San Benito,069,59416,9209,8763,235,8998,79
2022-01-04,San Bernardino,071,2135413,432636,404409,15182,419591,6060
2022-01-04,San Diego,073,3302833,511295,458499,30931,489430,4487
2022-01-04,San Francisco,075,870044,80258,70666,4020,74686,688
2022-01-04,San Joaquin,077,732212,116751,110374,6495,116869,1911
2022-01-04,San Luis Obispo,079,281455,35969,33788,1801,35589,371
2022-01-04,San Mateo,081,765935,77117,65157,2324,67481,582
2022-01-04,Santa Barbara,083,443738,56623,52449,2074,54523,574
2022-01-04,Santa Clara,085,1922200,195792,176854,3991,180845,1964
2022-01-04,Santa Cruz,087,273765,26528,23904,1367,25271,228
2022-01-04,Shasta,089,179085,24072,23366,3963,27329,442
2022-01-04,Sierra,091,2930,225,214,22,236,0
2022-01-04,Siskiyou,093,43540,3635,3509,1511,5020,61
2022-01-04,Solano,095,438530,54921,51300,2168,53468,383
2022-01-04,Sonoma,097,501317,52818,48653,980,49633,410
2022-01-04,Stanislaus,099,539301,88434,86107,10256,96363,1361
2022-01-04,Sutter,101,95872,15468,15032,490,15522,193
2022-01-04,Tehama,103,63373,9332,9020,1695,10715,140
2022-01-04,Trinity,105,12862,935,833,232,1065,18
2022-01-04,Tulare,107,460477,75878,72893,18323,91216,1172
2022-01-04,Tuolumne,109,53932,8611,8235,134,8369,91
2022-01-04,Ventura,111,848112,125764,114079,6571,120650,1213
2022-01-04,Yolo,113,214977,25037,22938,1834,24772,270
2022-01-04,Yuba,115,75493,11523,11104,481,11585,101
2022-01-03,Alameda,001,1643700,152499,142090,5015,147105,1529
2022-01-03,Alpine,003,1148,113,113,0,113,0
2022-01-03,Amador,005,37829,6187,6004,100,6104,71
2022-01-03,Butte,007,227075,23987,22924,4311,27235,345
2022-01-03,Calaveras,009,45235,4936,4742,81,4823,93
2022-01-03,Colusa,011,21464,2732,2683,761,3444,21
2022-01-03,Contra Costa,013,1133247,124196,114966,3967,118933,1073
2022-01-03,Del Norte,015,27424,3941,3873,66,3939,43
2022-01-03,El Dorado,017,186661,19157,18183,2041,20224,172
2022-01-03,Fresno,019,978130,157812,152674,14481,167155,2379
2022-01-03,Glenn,021,27897,3761,3703,1102,4805,39
2022-01-03,Humboldt,023,135768,11473,10784,1004,11788,119
2022-01-03,Imperial,025,180216,39866,38411,5070,43481,800
2022-01-03,Inyo,027,18085,3024,2845,64,2909,49
2022-01-03,Kern,029,883053,143225,137773,28058,165831,1916
2022-01-03,Kings,031,150075,35860,34817,2247,37064,387
2022-01-03,Lake,033,64148,7337,7134,230,7364,117
2022-01-03,Lassen,035,31185,7189,7103,445,7548,55
2022-01-03,Los Angeles,037,10098052,1823231,1686203,79903,1766106,27394
2022-01-03,Madera,039,155013,26032,25323,2614,27937,320
2022-01-03,Marin,041,260295,23196,21532,1099,22631,251
2022-01-03,Mariposa,043,17540,1637,1559,68,1627,6
2022-01-03,Mendocino,045,87422,8992,8573,770,9343,101
2022-01-03,Merced,047,269075,46430,45459,2449,47908,696
2022-01-03,Modoc,049,8938,622,602,216,818,6
2022-01-03,Mono,051,14174,2302,2172,40,2212,4
2022-01-03,Monterey,053,433212,54551,51047,4351,55398,644
2022-01-03,Napa,055,140530,16530,15260,303,15563,107
2022-01-03,Nevada,057,99092,11089,10572,423,10995,110
2022-01-03,Orange,059,3164182,387832,358052,25447,383499,5894
2022-01-03,Placer,061,380077,44231,42054,4738,46792,489
2022-01-03,Plumas,063,18699,2095,2005,61,2066,12
2022-01-03,Riverside,065,2383286,433727,410155,19750,429905,5504
2022-01-03,Sacramento,067,1510023,189160,179992,7693,187685,2452
2022-01-03,San Benito,069,59416,9044,8688,228,8916,79
2022-01-03,San Bernardino,071,2135413,424197,401938,14722,416660,6056
2022-01-03,San Diego,073,3302833,495145,451154,29967,481121,4476
2022-01-03,San Francisco,075,870044,77464,69315,3771,73086,686
2022-01-03,San Joaquin,077,732212,114450,109757,6414,116171,1903
2022-01-03,San Luis Obispo,079,281455,35155,33667,1708,35375,367
2022-01-03,San Mateo,081,765935,74408,64470,2167,66637,582
2022-01-03,Santa Barbara,083,443738,55161,51912,1979,53891,571
2022-01-03,Santa Clara,085,1922200,189846,174215,3514,177729,1963
2022-01-03,Santa Cruz,087,273765,25717,23765,1334,25099,228
2022-01-03,Shasta,089,179085,23891,23301,3936,27237,440
2022-01-03,Sierra,091,2930,218,213,21,234,0
2022-01-03,Siskiyou,093,43540,3609,3500,1489,4989,61
2022-01-03,Solano,095,438530,53625,51030,1976,53006,380
2022-01-03,Sonoma,097,501317,51120,48391,882,49273,410
2022-01-03,Stanislaus,099,539301,87442,85793,10089,95882,1332
2022-01-03,Sutter,101,95872,15312,14973,469,15442,193
2022-01-03,Tehama,103,63373,9257,9005,1669,10674,140
2022-01-03,Trinity,105,12862,930,833,231,1064,18
2022-01-03,Tulare,107,460477,75176,72664,18100,90764,1167
2022-01-03,Tuolumne,109,53932,8473,8179,130,8309,91
2022-01-03,Ventura,111,848112,122590,112762,6339,119101,1211
2022-01-03,Yolo,113,214977,24355,22563,1771,24334,270
2022-01-03,Yuba,115,75493,11387,11037,462,11499,99
2022-01-02,Alameda,001,1643700,148072,133486,4527,138013,1528
2022-01-02,Alpine,003,1148,111,113,0,113,0
2022-01-02,Amador,005,37829,6121,5913,95,6008,70
2022-01-02,Butte,007,227075,23648,22469,4252,26721,341
2022-01-02,Calaveras,009,45235,4867,4668,73,4741,93
2022-01-02,Colusa,011,21464,2727,2659,750,3409,21
2022-01-02,Contra Costa,013,1133247,120627,109593,3524,113117,1073
2022-01-02,Del Norte,015,27424,3909,3841,64,3905,43
2022-01-02,El Dorado,017,186661,18821,17621,1989,19610,172
2022-01-02,Fresno,019,978130,156091,149927,14251,164178,2379
2022-01-02,Glenn,021,27897,3741,3663,1093,4756,39
2022-01-02,Humboldt,023,135768,11232,10381,926,11307,119
2022-01-02,Imperial,025,180216,39208,37672,4859,42531,800
2022-01-02,Inyo,027,18085,2954,2726,53,2779,49
2022-01-02,Kern,029,883053,141299,136123,27459,163582,1917
2022-01-02,Kings,031,150075,35537,34318,2212,36530,386
2022-01-02,Lake,033,64148,7266,7060,216,7276,117
2022-01-02,Lassen,035,31185,7173,7089,443,7532,55
2022-01-02,Los Angeles,037,10098052,1772119,1596123,77009,1673132,27371
2022-01-02,Madera,039,155013,25777,25002,2555,27557,320
2022-01-02,Marin,041,260295,22633,20475,1028,21503,249
2022-01-02,Mariposa,043,17540,1606,1509,66,1575,6
2022-01-02,Mendocino,045,87422,8868,8422,752,9174,101
2022-01-02,Merced,047,269075,45896,44769,2353,47122,694
2022-01-02,Modoc,049,8938,620,601,215,816,6
2022-01-02,Mono,051,14174,2274,2101,35,2136,4
2022-01-02,Monterey,053,433212,53927,50251,4141,54392,643
2022-01-02,Napa,055,140530,15988,14439,292,14731,107
2022-01-02,Nevada,057,99092,10905,10299,409,10708,110
2022-01-02,Orange,059,3164182,376830,339526,24293,363819,5890
2022-01-02,Placer,061,380077,43504,40857,4651,45508,489
2022-01-02,Plumas,063,18699,2080,1994,57,2051,12
2022-01-02,Riverside,065,2383286,425399,397124,19228,416352,5501
2022-01-02,Sacramento,067,1510023,185086,173562,6832,180394,2448
2022-01-02,San Benito,069,59416,8861,8320,213,8533,79
2022-01-02,San Bernardino,071,2135413,416518,386278,14170,400448,6051
2022-01-02,San Diego,073,3302833,480066,427087,28783,455870,4469
2022-01-02,San Francisco,075,870044,74533,64498,3532,68030,682
2022-01-02,San Joaquin,077,732212,112580,106640,6307,112947,1902
2022-01-02,San Luis Obispo,079,281455,34422,32342,1625,33967,365
2022-01-02,San Mateo,081,765935,71837,60504,1925,62429,581
2022-01-02,Santa Barbara,083,443738,53725,49555,1916,51471,568
2022-01-02,Santa Clara,085,1922200,183705,164547,3113,167660,1969
2022-01-02,Santa Cruz,087,273765,25045,22980,1302,24282,228
2022-01-02,Shasta,089,179085,23702,23161,3887,27048,435
2022-01-02,Sierra,091,2930,217,206,21,227,0
2022-01-02,Siskiyou,093,43540,3584,3474,1466,4940,61
2022-01-02,Solano,095,438530,52684,48957,1811,50768,379
2022-01-02,Sonoma,097,501317,49800,46040,844,46884,410
2022-01-02,Stanislaus,099,539301,86590,84367,9973,94340,1332
2022-01-02,Sutter,101,95872,15139,14741,450,15191,193
2022-01-02,Tehama,103,63373,9192,8944,1646,10590,139
2022-01-02,Trinity,105,12862,928,832,230,1062,17
2022-01-02,Tulare,107,460477,74516,71941,17905,89846,1160
2022-01-02,Tuolumne,109,53932,8367,8044,125,8169,91
2022-01-02,Ventura,111,848112,119667,107992,6120,114112,1211
2022-01-02,Yolo,113,214977,23682,21747,1701,23448,270
2022-01-02,Yuba,115,75493,11265,10844,445,11289,99
2022-01-01,Alameda,001,1643700,146277,133486,4274,137760,1528
2022-01-01,Alpine,003,1148,111,113,0,113,0
2022-01-01,Amador,005,37829,6086,5913,90,6003,70
2022-01-01,Butte,007,227075,23452,22469,4222,26691,341
2022-01-01,Calaveras,009,45235,4831,4668,71,4739,93
2022-01-01,Colusa,011,21464,2723,2659,740,3399,21
2022-01-01,Contra Costa,013,1133247,119262,109593,3396,112989,1073
2022-01-01,Del Norte,015,27424,3903,3841,64,3905,43
2022-01-01,El Dorado,017,186661,18674,17621,1974,19595,172
2022-01-01,Fresno,019,978130,155427,149927,14172,164099,2379
2022-01-01,Glenn,021,27897,3734,3663,1093,4756,39
2022-01-01,Humboldt,023,135768,11096,10381,905,11286,119
2022-01-01,Imperial,025,180216,39061,37672,4811,42483,800
2022-01-01,Inyo,027,18085,2925,2726,51,2777,49
2022-01-01,Kern,029,883053,140608,136123,27148,163271,1917
2022-01-01,Kings,031,150075,35397,34318,2185,36503,386
2022-01-01,Lake,033,64148,7227,7060,211,7271,117
2022-01-01,Lassen,035,31185,7167,7089,438,7527,55
2022-01-01,Los Angeles,037,10098052,1752022,1596123,75041,1671164,27371
2022-01-01,Madera,039,155013,25693,25002,2541,27543,320
2022-01-01,Marin,041,260295,22320,20475,987,21462,249
2022-01-01,Mariposa,043,17540,1595,1509,66,1575,6
2022-01-01,Mendocino,045,87422,8776,8422,746,9168,101
2022-01-01,Merced,047,269075,45764,44769,2343,47112,694
2022-01-01,Modoc,049,8938,617,601,215,816,6
2022-01-01,Mono,051,14174,2250,2101,30,2131,4
2022-01-01,Monterey,053,433212,53619,50251,4057,54308,643
2022-01-01,Napa,055,140530,15837,14439,277,14716,107
2022-01-01,Nevada,057,99092,10833,10299,402,10701,110
2022-01-01,Orange,059,3164182,372617,339526,23582,363108,5890
2022-01-01,Placer,061,380077,43206,40857,4586,45443,489
2022-01-01,Plumas,063,18699,2068,1994,57,2051,12
2022-01-01,Riverside,065,2383286,421914,397124,19024,416148,5501
2022-01-01,Sacramento,067,1510023,183816,173562,6563,180125,2448
2022-01-01,San Benito,069,59416,8771,8320,213,8533,79
2022-01-01,San Bernardino,071,2135413,413413,386278,13888,400166,6051
2022-01-01,San Diego,073,3302833,474132,427087,28267,455354,4469
2022-01-01,San Francisco,075,870044,73139,64498,3320,67818,682
2022-01-01,San Joaquin,077,732212,111882,106640,6254,112894,1902
2022-01-01,San Luis Obispo,079,281455,34221,32342,1615,33957,365
2022-01-01,San Mateo,081,765935,70372,60504,1774,62278,581
2022-01-01,Santa Barbara,083,443738,52988,49555,1880,51435,568
2022-01-01,Santa Clara,085,1922200,180674,164547,2915,167462,1969
2022-01-01,Santa Cruz,087,273765,24725,22980,1284,24264,228
2022-01-01,Shasta,089,179085,23621,23161,3869,27030,435
2022-01-01,Sierra,091,2930,216,206,21,227,0
2022-01-01,Siskiyou,093,43540,3581,3474,1456,4930,61
2022-01-01,Solano,095,438530,52418,48957,1754,50711,379
2022-01-01,Sonoma,097,501317,49407,46040,812,46852,410
2022-01-01,Stanislaus,099,539301,86188,84367,9911,94278,1332
2022-01-01,Sutter,101,95872,15063,14741,448,15189,193
2022-01-01,Tehama,103,63373,9160,8944,1634,10578,139
2022-01-01,Trinity,105,12862,925,832,230,1062,17
2022-01-01,Tulare,107,460477,74272,71941,17799,89740,1160
2022-01-01,Tuolumne,109,53932,8308,8044,122,8166,91
2022-01-01,Ventura,111,848112,118281,107992,5990,113982,1211
2022-01-01,Yolo,113,214977,23265,21747,1663,23410,270
2022-01-01,Yuba,115,75493,11200,10844,439,11283,99
2021-12-31,Alameda,001,1643700,145538,133486,4178,137664,1528
2021-12-31,Alpine,003,1148,111,113,0,113,0
2021-12-31,Amador,005,37829,6063,5913,89,6002,70
2021-12-31,Butte,007,227075,23348,22469,4192,26661,341
2021-12-31,Calaveras,009,45235,4800,4668,71,4739,93
2021-12-31,Colusa,011,21464,2714,2659,734,3393,21
2021-12-31,Contra Costa,013,1133247,118381,109593,3316,112909,1073
2021-12-31,Del Norte,015,27424,3894,3841,62,3903,43
2021-12-31,El Dorado,017,186661,18595,17621,1956,19577,172
2021-12-31,Fresno,019,978130,155122,149927,14152,164079,2379
2021-12-31,Glenn,021,27897,3733,3663,1091,4754,39
2021-12-31,Humboldt,023,135768,11010,10381,886,11267,119
2021-12-31,Imperial,025,180216,38931,37672,4795,42467,800
2021-12-31,Inyo,027,18085,2899,2726,51,2777,49
2021-12-31,Kern,029,883053,140103,136123,27010,163133,1917
2021-12-31,Kings,031,150075,35287,34318,2175,36493,386
2021-12-31,Lake,033,64148,7204,7060,206,7266,117
2021-12-31,Lassen,035,31185,7154,7089,438,7527,55
2021-12-31,Los Angeles,037,10098052,1741274,1596123,74280,1670403,27371
2021-12-31,Madera,039,155013,25626,25002,2524,27526,320
2021-12-31,Marin,041,260295,22165,20475,956,21431,249
2021-12-31,Mariposa,043,17540,1588,1509,65,1574,6
2021-12-31,Mendocino,045,87422,8743,8422,743,9165,101
2021-12-31,Merced,047,269075,45680,44769,2326,47095,694
2021-12-31,Modoc,049,8938,613,601,213,814,6
2021-12-31,Mono,051,14174,2237,2101,29,2130,4
2021-12-31,Monterey,053,433212,53493,50251,3992,54243,643
2021-12-31,Napa,055,140530,15725,14439,267,14706,107
2021-12-31,Nevada,057,99092,10767,10299,396,10695,110
2021-12-31,Orange,059,3164182,370108,339526,23157,362683,5890
2021-12-31,Placer,061,380077,42969,40857,4520,45377,489
2021-12-31,Plumas,063,18699,2063,1994,57,2051,12
2021-12-31,Riverside,065,2383286,420234,397124,18867,415991,5501
2021-12-31,Sacramento,067,1510023,182960,173562,6457,180019,2448
2021-12-31,San Benito,069,59416,8757,8320,212,8532,79
2021-12-31,San Bernardino,071,2135413,411228,386278,13700,399978,6051
2021-12-31,San Diego,073,3302833,470929,427087,27952,455039,4469
2021-12-31,San Francisco,075,870044,72219,64498,3264,67762,682
2021-12-31,San Joaquin,077,732212,111262,106640,6193,112833,1902
2021-12-31,San Luis Obispo,079,281455,34113,32342,1602,33944,365
2021-12-31,San Mateo,081,765935,69498,60504,1720,62224,581
2021-12-31,Santa Barbara,083,443738,52594,49555,1866,51421,568
2021-12-31,Santa Clara,085,1922200,178731,164547,2773,167320,1969
2021-12-31,Santa Cruz,087,273765,24490,22980,1262,24242,228
2021-12-31,Shasta,089,179085,23557,23161,3848,27009,435
2021-12-31,Sierra,091,2930,216,206,21,227,0
2021-12-31,Siskiyou,093,43540,3574,3474,1445,4919,61
2021-12-31,Solano,095,438530,52259,48957,1728,50685,379
2021-12-31,Sonoma,097,501317,49160,46040,799,46839,410
2021-12-31,Stanislaus,099,539301,85862,84367,9867,94234,1332
2021-12-31,Sutter,101,95872,15002,14741,442,15183,193
2021-12-31,Tehama,103,63373,9128,8944,1625,10569,139
2021-12-31,Trinity,105,12862,924,832,230,1062,17
2021-12-31,Tulare,107,460477,74072,71941,17711,89652,1160
2021-12-31,Tuolumne,109,53932,8264,8044,121,8165,91
2021-12-31,Ventura,111,848112,117308,107992,5908,113900,1211
2021-12-31,Yolo,113,214977,23045,21747,1640,23387,270
2021-12-31,Yuba,115,75493,11143,10844,433,11277,99
2021-12-30,Alameda,001,1643700,144296,133486,4046,137532,1528
2021-12-30,Alpine,003,1148,110,113,0,113,0
2021-12-30,Amador,005,37829,6044,5913,88,6001,70
2021-12-30,Butte,007,227075,23225,22469,4170,26639,341
2021-12-30,Calaveras,009,45235,4781,4668,71,4739,93
2021-12-30,Colusa,011,21464,2713,2659,732,3391,21
2021-12-30,Contra Costa,013,1133247,117289,109593,3204,112797,1073
2021-12-30,Del Norte,015,27424,3883,3841,61,3902,43
2021-12-30,El Dorado,017,186661,18490,17621,1935,19556,172
2021-12-30,Fresno,019,978130,154593,149927,14078,164005,2379
2021-12-30,Glenn,021,27897,3728,3663,1088,4751,39
2021-12-30,Humboldt,023,135768,10941,10381,874,11255,119
2021-12-30,Imperial,025,180216,38763,37672,4680,42352,800
2021-12-30,Inyo,027,18085,2881,2726,49,2775,49
2021-12-30,Kern,029,883053,139571,136123,26708,162831,1917
2021-12-30,Kings,031,150075,35168,34318,2160,36478,386
2021-12-30,Lake,033,64148,7190,7060,201,7261,117
2021-12-30,Lassen,035,31185,7148,7089,438,7527,55
2021-12-30,Los Angeles,037,10098052,1717978,1596123,73019,1669142,27371
2021-12-30,Madera,039,155013,25544,25002,2504,27506,320
2021-12-30,Marin,041,260295,21987,20475,932,21407,249
2021-12-30,Mariposa,043,17540,1582,1509,65,1574,6
2021-12-30,Mendocino,045,87422,8726,8422,732,9154,101
2021-12-30,Merced,047,269075,45578,44769,2312,47081,694
2021-12-30,Modoc,049,8938,612,601,213,814,6
2021-12-30,Mono,051,14174,2233,2101,28,2129,4
2021-12-30,Monterey,053,433212,53183,50251,3931,54182,643
2021-12-30,Napa,055,140530,15581,14439,258,14697,107
2021-12-30,Nevada,057,99092,10705,10299,388,10687,110
2021-12-30,Orange,059,3164182,365021,339526,22600,362126,5890
2021-12-30,Placer,061,380077,42692,40857,4472,45329,489
2021-12-30,Plumas,063,18699,2059,1994,56,2050,12
2021-12-30,Riverside,065,2383286,416964,397124,18711,415835,5501
2021-12-30,Sacramento,067,1510023,181705,173562,6310,179872,2448
2021-12-30,San Benito,069,59416,8712,8320,208,8528,79
2021-12-30,San Bernardino,071,2135413,408730,386278,13552,399830,6051
2021-12-30,San Diego,073,3302833,465770,427087,27447,454534,4469
2021-12-30,San Francisco,075,870044,71131,64498,3191,67689,682
2021-12-30,San Joaquin,077,732212,110669,106640,6150,112790,1902
2021-12-30,San Luis Obispo,079,281455,33993,32342,1588,33930,365
2021-12-30,San Mateo,081,765935,68451,60504,1588,62092,581
2021-12-30,Santa Barbara,083,443738,52114,49555,1846,51401,568
2021-12-30,Santa Clara,085,1922200,176455,164547,2649,167196,1969
2021-12-30,Santa Cruz,087,273765,24251,22980,1227,24207,228
2021-12-30,Shasta,089,179085,23507,23161,3842,27003,435
2021-12-30,Sierra,091,2930,216,206,21,227,0
2021-12-30,Siskiyou,093,43540,3565,3474,1443,4917,61
2021-12-30,Solano,095,438530,51910,48957,1681,50638,379
2021-12-30,Sonoma,097,501317,48826,46040,789,46829,410
2021-12-30,Stanislaus,099,539301,85548,84367,9818,94185,1332
2021-12-30,Sutter,101,95872,14940,14741,441,15182,193
2021-12-30,Tehama,103,63373,9100,8944,1619,10563,139
2021-12-30,Trinity,105,12862,921,832,230,1062,17
2021-12-30,Tulare,107,460477,73892,71941,17629,89570,1160
2021-12-30,Tuolumne,109,53932,8225,8044,120,8164,91
2021-12-30,Ventura,111,848112,116051,107992,5808,113800,1211
2021-12-30,Yolo,113,214977,22907,21747,1615,23362,270
2021-12-30,Yuba,115,75493,11096,10844,431,11275,99
2021-12-29,Alameda,001,1643700,141152,131586,3892,135478,1529
2021-12-29,Alpine,003,1148,110,113,0,113,0
2021-12-29,Amador,005,37829,6021,5905,85,5990,70
2021-12-29,Butte,007,227075,23083,22353,4134,26487,338
2021-12-29,Calaveras,009,45235,4753,4646,69,4715,93
2021-12-29,Colusa,011,21464,2703,2657,727,3384,21
2021-12-29,Contra Costa,013,1133247,115195,108165,3078,111243,1072
2021-12-29,Del Norte,015,27424,3869,3826,59,3885,43
2021-12-29,El Dorado,017,186661,18265,17489,1917,19406,172
2021-12-29,Fresno,019,978130,153461,149318,13964,163282,2364
2021-12-29,Glenn,021,27897,3718,3653,1086,4739,39
2021-12-29,Humboldt,023,135768,10833,10249,852,11101,119
2021-12-29,Imperial,025,180216,38528,37460,4611,42071,800
2021-12-29,Inyo,027,18085,2849,2703,49,2752,49
2021-12-29,Kern,029,883053,138769,135648,26319,161967,1913
2021-12-29,Kings,031,150075,35053,34216,2154,36370,386
2021-12-29,Lake,033,64148,7159,7048,199,7247,117
2021-12-29,Lassen,035,31185,7144,7085,437,7522,55
2021-12-29,Los Angeles,037,10098052,1688035,1576414,71295,1647709,27349
2021-12-29,Madera,039,155013,25440,24923,2493,27416,320
2021-12-29,Marin,041,260295,21631,20025,911,20936,249
2021-12-29,Mariposa,043,17540,1560,1507,65,1572,6
2021-12-29,Mendocino,045,87422,8667,8386,728,9114,99
2021-12-29,Merced,047,269075,45362,44548,2298,46846,693
2021-12-29,Modoc,049,8938,609,600,213,813,6
2021-12-29,Mono,051,14174,2209,2056,27,2083,4
2021-12-29,Monterey,053,433212,52771,50097,3826,53923,641
2021-12-29,Napa,055,140530,15256,14247,239,14486,107
2021-12-29,Nevada,057,99092,10613,10274,387,10661,110
2021-12-29,Orange,059,3164182,357511,334557,21922,356479,5887
2021-12-29,Placer,061,380077,42207,40545,4397,44942,489
2021-12-29,Plumas,063,18699,2047,1990,56,2046,12
2021-12-29,Riverside,065,2383286,411549,392989,18502,411491,5486
2021-12-29,Sacramento,067,1510023,179363,172145,6144,178289,2437
2021-12-29,San Benito,069,59416,8567,8239,207,8446,79
2021-12-29,San Bernardino,071,2135413,403448,382872,13341,396213,6049
2021-12-29,San Diego,073,3302833,454884,421045,26731,447776,4461
2021-12-29,San Francisco,075,870044,69433,63117,3119,66236,684
2021-12-29,San Joaquin,077,732212,109489,106063,6082,112145,1891
2021-12-29,San Luis Obispo,079,281455,33599,31936,1539,33475,365
2021-12-29,San Mateo,081,765935,66838,59478,1478,60956,581
2021-12-29,Santa Barbara,083,443738,51274,49003,1821,50824,568
2021-12-29,Santa Clara,085,1922200,173310,162008,2516,164524,1962
2021-12-29,Santa Cruz,087,273765,23973,22669,1195,23864,228
2021-12-29,Shasta,089,179085,23431,23083,3830,26913,435
2021-12-29,Sierra,091,2930,215,206,21,227,0
2021-12-29,Siskiyou,093,43540,3553,3472,1432,4904,61
2021-12-29,Solano,095,438530,51205,48562,1625,50187,379
2021-12-29,Sonoma,097,501317,48030,45479,766,46245,410
2021-12-29,Stanislaus,099,539301,85067,84083,9766,93849,1332
2021-12-29,Sutter,101,95872,14872,14688,439,15127,193
2021-12-29,Tehama,103,63373,9076,8914,1606,10520,138
2021-12-29,Trinity,105,12862,919,832,230,1062,17
2021-12-29,Tulare,107,460477,73600,71752,17512,89264,1160
2021-12-29,Tuolumne,109,53932,8172,8012,119,8131,91
2021-12-29,Ventura,111,848112,114111,106974,5628,112602,1207
2021-12-29,Yolo,113,214977,22668,21564,1584,23148,270
2021-12-29,Yuba,115,75493,11035,10808,427,11235,99
2021-12-28,Alameda,001,1643700,138064,130427,3731,134158,1522
2021-12-28,Alpine,003,1148,110,113,0,113,0
2021-12-28,Amador,005,37829,6001,5900,84,5984,70
2021-12-28,Butte,007,227075,22942,22285,4117,26402,338
2021-12-28,Calaveras,009,45235,4736,4641,68,4709,91
2021-12-28,Colusa,011,21464,2697,2653,725,3378,21
2021-12-28,Contra Costa,013,1133247,112897,107160,2960,110120,1072
2021-12-28,Del Norte,015,27424,3863,3815,59,3874,43
2021-12-28,El Dorado,017,186661,18040,17419,1906,19325,172
2021-12-28,Fresno,019,978130,152378,148987,13880,162867,2365
2021-12-28,Glenn,021,27897,3692,3639,1082,4721,39
2021-12-28,Humboldt,023,135768,10712,10198,827,11025,119
2021-12-28,Imperial,025,180216,38230,37223,4506,41729,800
2021-12-28,Inyo,027,18085,2791,2676,48,2724,48
2021-12-28,Kern,029,883053,138053,135346,25964,161310,1909
2021-12-28,Kings,031,150075,34916,34165,2139,36304,386
2021-12-28,Lake,033,64148,7140,7044,194,7238,116
2021-12-28,Lassen,035,31185,7136,7083,437,7520,55
2021-12-28,Los Angeles,037,10098052,1655823,1561791,69620,1631411,27323
2021-12-28,Madera,039,155013,25315,24865,2473,27338,320
2021-12-28,Marin,041,260295,21217,19739,881,20620,249
2021-12-28,Mariposa,043,17540,1549,1499,64,1563,6
2021-12-28,Mendocino,045,87422,8607,8366,720,9086,98
2021-12-28,Merced,047,269075,45123,44434,2288,46722,691
2021-12-28,Modoc,049,8938,609,599,212,811,6
2021-12-28,Mono,051,14174,2186,2045,25,2070,4
2021-12-28,Monterey,053,433212,52395,49973,3753,53726,639
2021-12-28,Napa,055,140530,14939,14131,212,14343,107
2021-12-28,Nevada,057,99092,10523,10250,384,10634,110
2021-12-28,Orange,059,3164182,349856,331279,21179,352458,5882
2021-12-28,Placer,061,380077,41735,40410,4327,44737,489
2021-12-28,Plumas,063,18699,2044,1989,56,2045,12
2021-12-28,Riverside,065,2383286,406313,390343,18255,408598,5470
2021-12-28,Sacramento,067,1510023,177080,171290,6010,177300,2426
2021-12-28,San Benito,069,59416,8424,8170,205,8375,79
2021-12-28,San Bernardino,071,2135413,397896,381316,13128,394444,6047
2021-12-28,San Diego,073,3302833,444137,417383,26185,443568,4450
2021-12-28,San Francisco,075,870044,67817,61745,3060,64805,682
2021-12-28,San Joaquin,077,732212,108435,105572,6037,111609,1884
2021-12-28,San Luis Obispo,079,281455,33140,31759,1523,33282,365
2021-12-28,San Mateo,081,765935,65328,58712,1389,60101,582
2021-12-28,Santa Barbara,083,443738,50628,48493,1801,50294,568
2021-12-28,Santa Clara,085,1922200,170173,160811,2419,163230,1962
2021-12-28,Santa Cruz,087,273765,23601,22513,1156,23669,228
2021-12-28,Shasta,089,179085,23359,23035,3825,26860,434
2021-12-28,Sierra,091,2930,212,206,21,227,0
2021-12-28,Siskiyou,093,43540,3544,3468,1427,4895,60
2021-12-28,Solano,095,438530,50288,48318,1571,49889,378
2021-12-28,Sonoma,097,501317,47169,45086,740,45826,410
2021-12-28,Stanislaus,099,539301,84587,83946,9716,93662,1331
2021-12-28,Sutter,101,95872,14822,14662,436,15098,193
2021-12-28,Tehama,103,63373,9059,8893,1604,10497,138
2021-12-28,Trinity,105,12862,917,831,229,1060,17
2021-12-28,Tulare,107,460477,73317,71630,17387,89017,1156
2021-12-28,Tuolumne,109,53932,8129,8006,119,8125,91
2021-12-28,Ventura,111,848112,111999,105883,5497,111380,1207
2021-12-28,Yolo,113,214977,22333,21320,1532,22852,270
2021-12-28,Yuba,115,75493,10980,10778,424,11202,99
2021-12-27,Alameda,001,1643700,135481,129910,3590,133500,1530
2021-12-27,Alpine,003,1148,110,113,0,113,0
2021-12-27,Amador,005,37829,5973,5891,84,5975,70
2021-12-27,Butte,007,227075,22809,22234,4094,26328,335
2021-12-27,Calaveras,009,45235,4712,4630,67,4697,91
2021-12-27,Colusa,011,21464,2686,2652,719,3371,21
2021-12-27,Contra Costa,013,1133247,110732,106692,2879,109571,1071
2021-12-27,Del Norte,015,27424,3854,3802,58,3860,43
2021-12-27,El Dorado,017,186661,17881,17361,1893,19254,172
2021-12-27,Fresno,019,978130,151416,148826,13800,162626,2364
2021-12-27,Glenn,021,27897,3684,3634,1076,4710,39
2021-12-27,Humboldt,023,135768,10597,10164,805,10969,119
2021-12-27,Imperial,025,180216,37988,37180,4406,41586,800
2021-12-27,Inyo,027,18085,2762,2662,46,2708,48
2021-12-27,Kern,029,883053,137405,135119,25661,160780,1907
2021-12-27,Kings,031,150075,34767,34126,2126,36252,382
2021-12-27,Lake,033,64148,7117,7037,184,7221,116
2021-12-27,Lassen,035,31185,7130,7080,437,7517,55
2021-12-27,Los Angeles,037,10098052,1619544,1554074,67856,1621930,27300
2021-12-27,Madera,039,155013,25199,24840,2454,27294,320
2021-12-27,Marin,041,260295,20829,19601,854,20455,249
2021-12-27,Mariposa,043,17540,1534,1495,64,1559,6
2021-12-27,Mendocino,045,87422,8540,8351,715,9066,98
2021-12-27,Merced,047,269075,44892,44383,2271,46654,690
2021-12-27,Modoc,049,8938,607,599,212,811,6
2021-12-27,Mono,051,14174,2123,2026,25,2051,4
2021-12-27,Monterey,053,433212,52092,49918,3701,53619,639
2021-12-27,Napa,055,140530,14670,14083,203,14286,107
2021-12-27,Nevada,057,99092,10454,10239,376,10615,110
2021-12-27,Orange,059,3164182,342405,329222,20372,349594,5875
2021-12-27,Placer,061,380077,41352,40263,4278,44541,489
2021-12-27,Plumas,063,18699,2042,1988,54,2042,12
2021-12-27,Riverside,065,2383286,401737,389096,17996,407092,5470
2021-12-27,Sacramento,067,1510023,175062,170858,5837,176695,2422
2021-12-27,San Benito,069,59416,8307,8133,201,8334,79
2021-12-27,San Bernardino,071,2135413,392196,380526,12930,393456,6047
2021-12-27,San Diego,073,3302833,433937,414968,25696,440664,4445
2021-12-27,San Francisco,075,870044,66078,60920,2995,63915,682
2021-12-27,San Joaquin,077,732212,107517,105413,5976,111389,1876
2021-12-27,San Luis Obispo,079,281455,32697,31671,1501,33172,365
2021-12-27,San Mateo,081,765935,63811,58397,1289,59686,581
2021-12-27,Santa Barbara,083,443738,49844,48209,1780,49989,568
2021-12-27,Santa Clara,085,1922200,167206,159904,2293,162197,1961
2021-12-27,Santa Cruz,087,273765,23312,22456,1138,23594,228
2021-12-27,Shasta,089,179085,23296,23015,3814,26829,432
2021-12-27,Sierra,091,2930,212,206,21,227,0
2021-12-27,Siskiyou,093,43540,3535,3466,1422,4888,60
2021-12-27,Solano,095,438530,49555,48172,1523,49695,378
2021-12-27,Sonoma,097,501317,46592,44990,721,45711,410
2021-12-27,Stanislaus,099,539301,84140,83833,9680,93513,1331
2021-12-27,Sutter,101,95872,14766,14642,431,15073,191
2021-12-27,Tehama,103,63373,9044,8887,1597,10484,136
2021-12-27,Trinity,105,12862,917,827,229,1056,17
2021-12-27,Tulare,107,460477,73052,71562,17290,88852,1146
2021-12-27,Tuolumne,109,53932,8092,7978,118,8096,91
2021-12-27,Ventura,111,848112,109910,105212,5361,110573,1206
2021-12-27,Yolo,113,214977,22038,21300,1497,22797,270
2021-12-27,Yuba,115,75493,10919,10759,423,11182,98
2021-12-26,Alameda,001,1643700,133446,127221,3517,130738,1525
2021-12-26,Alpine,003,1148,110,113,0,113,0
2021-12-26,Amador,005,37829,5957,5861,82,5943,70
2021-12-26,Butte,007,227075,22654,22087,4071,26158,330
2021-12-26,Calaveras,009,45235,4690,4591,67,4658,91
2021-12-26,Colusa,011,21464,2675,2647,713,3360,21
2021-12-26,Contra Costa,013,1133247,108973,105022,2780,107802,1071
2021-12-26,Del Norte,015,27424,3849,3795,58,3853,43
2021-12-26,El Dorado,017,186661,17725,17188,1884,19072,172
2021-12-26,Fresno,019,978130,150708,148027,13722,161749,2358
2021-12-26,Glenn,021,27897,3676,3611,1065,4676,39
2021-12-26,Humboldt,023,135768,10453,10052,782,10834,119
2021-12-26,Imperial,025,180216,37682,36878,4313,41191,800
2021-12-26,Inyo,027,18085,2738,2636,43,2679,47
2021-12-26,Kern,029,883053,136686,134591,25405,159996,1908
2021-12-26,Kings,031,150075,34615,34009,2120,36129,379
2021-12-26,Lake,033,64148,7095,7019,181,7200,116
2021-12-26,Lassen,035,31185,7124,7072,436,7508,55
2021-12-26,Los Angeles,037,10098052,1589713,1515469,66046,1581515,27257
2021-12-26,Madera,039,155013,25081,24741,2438,27179,320
2021-12-26,Marin,041,260295,20448,19085,793,19878,249
2021-12-26,Mariposa,043,17540,1528,1480,64,1544,6
2021-12-26,Mendocino,045,87422,8489,8314,713,9027,98
2021-12-26,Merced,047,269075,44641,44208,2260,46468,690
2021-12-26,Modoc,049,8938,606,597,210,807,6
2021-12-26,Mono,051,14174,2097,2000,25,2025,4
2021-12-26,Monterey,053,433212,51813,49709,3652,53361,638
2021-12-26,Napa,055,140530,14434,13809,198,14007,107
2021-12-26,Nevada,057,99092,10394,10153,369,10522,110
2021-12-26,Orange,059,3164182,336088,322991,19568,342559,5863
2021-12-26,Placer,061,380077,41007,39852,4207,44059,489
2021-12-26,Plumas,063,18699,2034,1987,53,2040,12
2021-12-26,Riverside,065,2383286,397565,384567,17826,402393,5470
2021-12-26,Sacramento,067,1510023,173339,169144,5688,174832,2418
2021-12-26,San Benito,069,59416,8218,7991,197,8188,79
2021-12-26,San Bernardino,071,2135413,387607,376052,12753,388805,6043
2021-12-26,San Diego,073,3302833,424974,406616,25208,431824,4442
2021-12-26,San Francisco,075,870044,64509,58229,2933,61162,682
2021-12-26,San Joaquin,077,732212,106702,104590,5924,110514,1872
2021-12-26,San Luis Obispo,079,281455,32258,31290,1483,32773,365
2021-12-26,San Mateo,081,765935,62410,56973,1241,58214,581
2021-12-26,Santa Barbara,083,443738,49169,47553,1750,49303,567
2021-12-26,Santa Clara,085,1922200,164513,156872,2160,159032,1967
2021-12-26,Santa Cruz,087,273765,23027,22176,1124,23300,228
2021-12-26,Shasta,089,179085,23213,22959,3802,26761,432
2021-12-26,Sierra,091,2930,212,202,21,223,0
2021-12-26,Siskiyou,093,43540,3527,3460,1413,4873,60
2021-12-26,Solano,095,438530,49052,47646,1485,49131,377
2021-12-26,Sonoma,097,501317,46096,44358,688,45046,408
2021-12-26,Stanislaus,099,539301,83769,83368,9644,93012,1331
2021-12-26,Sutter,101,95872,14702,14533,428,14961,191
2021-12-26,Tehama,103,63373,9011,8861,1594,10455,136
2021-12-26,Trinity,105,12862,917,826,228,1054,17
2021-12-26,Tulare,107,460477,72804,71292,17179,88471,1137
2021-12-26,Tuolumne,109,53932,8055,7919,118,8037,91
2021-12-26,Ventura,111,848112,108077,103498,5211,108709,1206
2021-12-26,Yolo,113,214977,21756,21084,1457,22541,270
2021-12-26,Yuba,115,75493,10868,10694,421,11115,98
2021-12-25,Alameda,001,1643700,132396,127221,3454,130675,1525
2021-12-25,Alpine,003,1148,110,113,0,113,0
2021-12-25,Amador,005,37829,5938,5861,82,5943,70
2021-12-25,Butte,007,227075,22558,22087,4055,26142,330
2021-12-25,Calaveras,009,45235,4661,4591,66,4657,91
2021-12-25,Colusa,011,21464,2670,2647,707,3354,21
2021-12-25,Contra Costa,013,1133247,108151,105022,2727,107749,1071
2021-12-25,Del Norte,015,27424,3842,3795,57,3852,43
2021-12-25,El Dorado,017,186661,17672,17188,1873,19061,172
2021-12-25,Fresno,019,978130,150397,148027,13675,161702,2358
2021-12-25,Glenn,021,27897,3666,3611,1060,4671,39
2021-12-25,Humboldt,023,135768,10375,10052,775,10827,119
2021-12-25,Imperial,025,180216,37563,36878,4290,41168,800
2021-12-25,Inyo,027,18085,2718,2636,43,2679,47
2021-12-25,Kern,029,883053,136339,134591,25280,159871,1908
2021-12-25,Kings,031,150075,34525,34009,2113,36122,379
2021-12-25,Lake,033,64148,7083,7019,179,7198,116
2021-12-25,Lassen,035,31185,7122,7072,436,7508,55
2021-12-25,Los Angeles,037,10098052,1576920,1515469,64713,1580182,27257
2021-12-25,Madera,039,155013,25033,24741,2432,27173,320
2021-12-25,Marin,041,260295,20108,19085,744,19829,249
2021-12-25,Mariposa,043,17540,1522,1480,64,1544,6
2021-12-25,Mendocino,045,87422,8451,8314,713,9027,98
2021-12-25,Merced,047,269075,44541,44208,2258,46466,690
2021-12-25,Modoc,049,8938,606,597,210,807,6
2021-12-25,Mono,051,14174,2080,2000,25,2025,4
2021-12-25,Monterey,053,433212,51644,49709,3617,53326,638
2021-12-25,Napa,055,140530,14319,13809,190,13999,107
2021-12-25,Nevada,057,99092,10365,10153,369,10522,110
2021-12-25,Orange,059,3164182,333229,322991,18993,341984,5863
2021-12-25,Placer,061,380077,40827,39852,4171,44023,489
2021-12-25,Plumas,063,18699,2032,1987,53,2040,12
2021-12-25,Riverside,065,2383286,395286,384567,17706,402273,5470
2021-12-25,Sacramento,067,1510023,172526,169144,5579,174723,2418
2021-12-25,San Benito,069,59416,8153,7991,197,8188,79
2021-12-25,San Bernardino,071,2135413,385458,376052,12613,388665,6043
2021-12-25,San Diego,073,3302833,420923,406616,24938,431554,4442
2021-12-25,San Francisco,075,870044,63487,58229,2897,61126,682
2021-12-25,San Joaquin,077,732212,106367,104590,5892,110482,1872
2021-12-25,San Luis Obispo,079,281455,32103,31290,1474,32764,365
2021-12-25,San Mateo,081,765935,61379,56973,1198,58171,581
2021-12-25,Santa Barbara,083,443738,48806,47553,1738,49291,567
2021-12-25,Santa Clara,085,1922200,163031,156872,2093,158965,1967
2021-12-25,Santa Cruz,087,273765,22868,22176,1118,23294,228
2021-12-25,Shasta,089,179085,23183,22959,3796,26755,432
2021-12-25,Sierra,091,2930,212,202,21,223,0
2021-12-25,Siskiyou,093,43540,3524,3460,1407,4867,60
2021-12-25,Solano,095,438530,48928,47646,1467,49113,377
2021-12-25,Sonoma,097,501317,45712,44358,662,45020,408
2021-12-25,Stanislaus,099,539301,83556,83368,9623,92991,1331
2021-12-25,Sutter,101,95872,14661,14533,426,14959,191
2021-12-25,Tehama,103,63373,8991,8861,1590,10451,136
2021-12-25,Trinity,105,12862,916,826,228,1054,17
2021-12-25,Tulare,107,460477,72668,71292,17099,88391,1137
2021-12-25,Tuolumne,109,53932,8024,7919,118,8037,91
2021-12-25,Ventura,111,848112,106907,103498,5102,108600,1206
2021-12-25,Yolo,113,214977,21644,21084,1435,22519,270
2021-12-25,Yuba,115,75493,10842,10694,420,11114,98
2021-12-24,Alameda,001,1643700,131789,127221,3436,130657,1525
2021-12-24,Alpine,003,1148,110,113,0,113,0
2021-12-24,Amador,005,37829,5930,5861,81,5942,70
2021-12-24,Butte,007,227075,22503,22087,4042,26129,330
2021-12-24,Calaveras,009,45235,4655,4591,66,4657,91
2021-12-24,Colusa,011,21464,2668,2647,706,3353,21
2021-12-24,Contra Costa,013,1133247,107833,105022,2695,107717,1071
2021-12-24,Del Norte,015,27424,3835,3795,57,3852,43
2021-12-24,El Dorado,017,186661,17620,17188,1868,19056,172
2021-12-24,Fresno,019,978130,150232,148027,13662,161689,2358
2021-12-24,Glenn,021,27897,3665,3611,1060,4671,39
2021-12-24,Humboldt,023,135768,10319,10052,769,10821,119
2021-12-24,Imperial,025,180216,37480,36878,4286,41164,800
2021-12-24,Inyo,027,18085,2698,2636,43,2679,47
2021-12-24,Kern,029,883053,136216,134591,25238,159829,1908
2021-12-24,Kings,031,150075,34458,34009,2112,36121,379
2021-12-24,Lake,033,64148,7079,7019,179,7198,116
2021-12-24,Lassen,035,31185,7119,7072,436,7508,55
2021-12-24,Los Angeles,037,10098052,1572079,1515469,64183,1579652,27257
2021-12-24,Madera,039,155013,25000,24741,2427,27168,320
2021-12-24,Marin,041,260295,19964,19085,713,19798,249
2021-12-24,Mariposa,043,17540,1520,1480,64,1544,6
2021-12-24,Mendocino,045,87422,8434,8314,713,9027,98
2021-12-24,Merced,047,269075,44491,44208,2256,46464,690
2021-12-24,Modoc,049,8938,606,597,210,807,6
2021-12-24,Mono,051,14174,2067,2000,25,2025,4
2021-12-24,Monterey,053,433212,51546,49709,3592,53301,638
2021-12-24,Napa,055,140530,14253,13809,186,13995,107
2021-12-24,Nevada,057,99092,10338,10153,367,10520,110
2021-12-24,Orange,059,3164182,332181,322991,18834,341825,5863
2021-12-24,Placer,061,380077,40709,39852,4155,44007,489
2021-12-24,Plumas,063,18699,2031,1987,53,2040,12
2021-12-24,Riverside,065,2383286,394298,384567,17616,402183,5470
2021-12-24,Sacramento,067,1510023,172216,169144,5543,174687,2418
2021-12-24,San Benito,069,59416,8144,7991,196,8187,79
2021-12-24,San Bernardino,071,2135413,384369,376052,12542,388594,6043
2021-12-24,San Diego,073,3302833,419821,406616,24810,431426,4442
2021-12-24,San Francisco,075,870044,62978,58229,2879,61108,682
2021-12-24,San Joaquin,077,732212,106174,104590,5885,110475,1872
2021-12-24,San Luis Obispo,079,281455,32041,31290,1464,32754,365
2021-12-24,San Mateo,081,765935,60947,56973,1175,58148,581
2021-12-24,Santa Barbara,083,443738,48601,47553,1731,49284,567
2021-12-24,Santa Clara,085,1922200,162210,156872,2059,158931,1967
2021-12-24,Santa Cruz,087,273765,22785,22176,1115,23291,228
2021-12-24,Shasta,089,179085,23151,22959,3792,26751,432
2021-12-24,Sierra,091,2930,211,202,21,223,0
2021-12-24,Siskiyou,093,43540,3519,3460,1403,4863,60
2021-12-24,Solano,095,438530,48876,47646,1465,49111,377
2021-12-24,Sonoma,097,501317,45548,44358,654,45012,408
2021-12-24,Stanislaus,099,539301,83444,83368,9610,92978,1331
2021-12-24,Sutter,101,95872,14641,14533,423,14956,191
2021-12-24,Tehama,103,63373,8982,8861,1587,10448,136
2021-12-24,Trinity,105,12862,914,826,228,1054,17
2021-12-24,Tulare,107,460477,72602,71292,17055,88347,1137
2021-12-24,Tuolumne,109,53932,7999,7919,118,8037,91
2021-12-24,Ventura,111,848112,106459,103498,5046,108544,1206
2021-12-24,Yolo,113,214977,21571,21084,1417,22501,270
2021-12-24,Yuba,115,75493,10819,10694,419,11113,98
2021-12-23,Alameda,001,1643700,131096,127221,3401,130622,1525
2021-12-23,Alpine,003,1148,110,113,0,113,0
2021-12-23,Amador,005,37829,5918,5861,79,5940,70
2021-12-23,Butte,007,227075,22453,22087,4030,26117,330
2021-12-23,Calaveras,009,45235,4644,4591,66,4657,91
2021-12-23,Colusa,011,21464,2662,2647,702,3349,21
2021-12-23,Contra Costa,013,1133247,107405,105022,2650,107672,1071
2021-12-23,Del Norte,015,27424,3832,3795,57,3852,43
2021-12-23,El Dorado,017,186661,17558,17188,1862,19050,172
2021-12-23,Fresno,019,978130,150027,148027,13640,161667,2358
2021-12-23,Glenn,021,27897,3661,3611,1060,4671,39
2021-12-23,Humboldt,023,135768,10266,10052,766,10818,119
2021-12-23,Imperial,025,180216,37407,36878,4257,41135,800
2021-12-23,Inyo,027,18085,2685,2636,43,2679,47
2021-12-23,Kern,029,883053,136065,134591,25140,159731,1908
2021-12-23,Kings,031,150075,34417,34009,2111,36120,379
2021-12-23,Lake,033,64148,7067,7019,177,7196,116
2021-12-23,Lassen,035,31185,7118,7072,436,7508,55
2021-12-23,Los Angeles,037,10098052,1562567,1515469,63076,1578545,27257
2021-12-23,Madera,039,155013,24968,24741,2422,27163,320
2021-12-23,Marin,041,260295,19830,19085,696,19781,249
2021-12-23,Mariposa,043,17540,1515,1480,64,1544,6
2021-12-23,Mendocino,045,87422,8425,8314,713,9027,98
2021-12-23,Merced,047,269075,44442,44208,2254,46462,690
2021-12-23,Modoc,049,8938,606,597,210,807,6
2021-12-23,Mono,051,14174,2046,2000,24,2024,4
2021-12-23,Monterey,053,433212,51428,49709,3571,53280,638
2021-12-23,Napa,055,140530,14172,13809,181,13990,107
2021-12-23,Nevada,057,99092,10315,10153,366,10519,110
2021-12-23,Orange,059,3164182,330505,322991,18501,341492,5863
2021-12-23,Placer,061,380077,40585,39852,4139,43991,489
2021-12-23,Plumas,063,18699,2031,1987,53,2040,12
2021-12-23,Riverside,065,2383286,393093,384567,17547,402114,5470
2021-12-23,Sacramento,067,1510023,171761,169144,5495,174639,2418
2021-12-23,San Benito,069,59416,8125,7991,194,8185,79
2021-12-23,San Bernardino,071,2135413,383229,376052,12438,388490,6043
2021-12-23,San Diego,073,3302833,417988,406616,24610,431226,4442
2021-12-23,San Francisco,075,870044,62252,58229,2851,61080,682
2021-12-23,San Joaquin,077,732212,105956,104590,5872,110462,1872
2021-12-23,San Luis Obispo,079,281455,31969,31290,1460,32750,365
2021-12-23,San Mateo,081,765935,60386,56973,1154,58127,581
2021-12-23,Santa Barbara,083,443738,48402,47553,1729,49282,567
2021-12-23,Santa Clara,085,1922200,161303,156872,2000,158872,1967
2021-12-23,Santa Cruz,087,273765,22669,22176,1103,23279,228
2021-12-23,Shasta,089,179085,23122,22959,3789,26748,432
2021-12-23,Sierra,091,2930,208,202,21,223,0
2021-12-23,Siskiyou,093,43540,3519,3460,1401,4861,60
2021-12-23,Solano,095,438530,48771,47646,1449,49095,377
2021-12-23,Sonoma,097,501317,45371,44358,651,45009,408
2021-12-23,Stanislaus,099,539301,83316,83368,9596,92964,1331
2021-12-23,Sutter,101,95872,14623,14533,422,14955,191
2021-12-23,Tehama,103,63373,8970,8861,1583,10444,136
2021-12-23,Trinity,105,12862,914,826,228,1054,17
2021-12-23,Tulare,107,460477,72526,71292,17010,88302,1137
2021-12-23,Tuolumne,109,53932,7981,7919,117,8036,91
2021-12-23,Ventura,111,848112,105924,103498,4979,108477,1206
2021-12-23,Yolo,113,214977,21499,21084,1399,22483,270
2021-12-23,Yuba,115,75493,10806,10694,419,11113,98
2021-12-22,Alameda,001,1643700,130180,126533,3317,129850,1522
2021-12-22,Alpine,003,1148,110,112,0,112,0
2021-12-22,Amador,005,37829,5905,5850,78,5928,70
2021-12-22,Butte,007,227075,22403,22070,4019,26089,330
2021-12-22,Calaveras,009,45235,4635,4580,66,4646,91
2021-12-22,Colusa,011,21464,2662,2645,699,3344,21
2021-12-22,Contra Costa,013,1133247,106766,104559,2607,107166,1070
2021-12-22,Del Norte,015,27424,3832,3794,57,3851,43
2021-12-22,El Dorado,017,186661,17497,17140,1853,18993,172
2021-12-22,Fresno,019,978130,149745,147838,13606,161444,2349
2021-12-22,Glenn,021,27897,3656,3604,1060,4664,39
2021-12-22,Humboldt,023,135768,10206,10022,761,10783,119
2021-12-22,Imperial,025,180216,37321,36755,4220,40975,798
2021-12-22,Inyo,027,18085,2667,2632,43,2675,47
2021-12-22,Kern,029,883053,135830,134433,25055,159488,1900
2021-12-22,Kings,031,150075,34367,33953,2104,36057,376
2021-12-22,Lake,033,64148,7060,7008,175,7183,116
2021-12-22,Lassen,035,31185,7113,7069,435,7504,55
2021-12-22,Los Angeles,037,10098052,1549058,1507110,61898,1569008,27234
2021-12-22,Madera,039,155013,24929,24702,2418,27120,320
2021-12-22,Marin,041,260295,19609,18927,673,19600,249
2021-12-22,Mariposa,043,17540,1508,1480,64,1544,6
2021-12-22,Mendocino,045,87422,8416,8299,713,9012,99
2021-12-22,Merced,047,269075,44371,44137,2252,46389,689
2021-12-22,Modoc,049,8938,606,595,210,805,6
2021-12-22,Mono,051,14174,2042,1979,24,2003,4
2021-12-22,Monterey,053,433212,51270,49650,3554,53204,639
2021-12-22,Napa,055,140530,14044,13746,171,13917,107
2021-12-22,Nevada,057,99092,10288,10101,361,10462,110
2021-12-22,Orange,059,3164182,328228,321765,18068,339833,5858
2021-12-22,Placer,061,380077,40403,39758,4102,43860,489
2021-12-22,Plumas,063,18699,2027,1986,53,2039,12
2021-12-22,Riverside,065,2383286,391280,383319,17432,400751,5472
2021-12-22,Sacramento,067,1510023,171104,168695,5425,174120,2422
2021-12-22,San Benito,069,59416,8073,7971,192,8163,79
2021-12-22,San Bernardino,071,2135413,381598,375044,12354,387398,6039
2021-12-22,San Diego,073,3302833,413881,404269,24282,428551,4434
2021-12-22,San Francisco,075,870044,61264,57520,2806,60326,682
2021-12-22,San Joaquin,077,732212,105685,104385,5858,110243,1870
2021-12-22,San Luis Obispo,079,281455,31828,31175,1440,32615,365
2021-12-22,San Mateo,081,765935,59703,56604,1125,57729,581
2021-12-22,Santa Barbara,083,443738,48146,47372,1713,49085,566
2021-12-22,Santa Clara,085,1922200,160186,156258,1958,158216,1954
2021-12-22,Santa Cruz,087,273765,22563,22075,1097,23172,228
2021-12-22,Shasta,089,179085,23094,22937,3784,26721,432
2021-12-22,Sierra,091,2930,208,202,21,223,0
2021-12-22,Siskiyou,093,43540,3516,3458,1398,4856,59
2021-12-22,Solano,095,438530,48542,47531,1435,48966,375
2021-12-22,Sonoma,097,501317,45095,44201,640,44841,408
2021-12-22,Stanislaus,099,539301,83174,83245,9581,92826,1331
2021-12-22,Sutter,101,95872,14588,14513,419,14932,191
2021-12-22,Tehama,103,63373,8957,8853,1580,10433,136
2021-12-22,Trinity,105,12862,914,826,228,1054,17
2021-12-22,Tulare,107,460477,72425,71226,16957,88183,1137
2021-12-22,Tuolumne,109,53932,7960,7903,117,8020,91
2021-12-22,Ventura,111,848112,105318,103089,4872,107961,1206
2021-12-22,Yolo,113,214977,21423,21012,1384,22396,270
2021-12-22,Yuba,115,75493,10789,10681,419,11100,98
2021-12-21,Alameda,001,1643700,129193,126007,3261,129268,1518
2021-12-21,Alpine,003,1148,110,112,0,112,0
2021-12-21,Amador,005,37829,5895,5845,78,5923,70
2021-12-21,Butte,007,227075,22341,22041,4006,26047,330
2021-12-21,Calaveras,009,45235,4622,4575,66,4641,91
2021-12-21,Colusa,011,21464,2660,2643,698,3341,21
2021-12-21,Contra Costa,013,1133247,106133,104255,2541,106796,1068
2021-12-21,Del Norte,015,27424,3831,3793,57,3850,43
2021-12-21,El Dorado,017,186661,17434,17098,1841,18939,172
2021-12-21,Fresno,019,978130,149459,147707,13571,161278,2341
2021-12-21,Glenn,021,27897,3642,3602,1060,4662,39
2021-12-21,Humboldt,023,135768,10141,9989,756,10745,118
2021-12-21,Imperial,025,180216,37223,36580,4178,40758,792
2021-12-21,Inyo,027,18085,2655,2627,43,2670,47
2021-12-21,Kern,029,883053,135622,134321,24949,159270,1892
2021-12-21,Kings,031,150075,34307,33914,2103,36017,376
2021-12-21,Lake,033,64148,7055,7004,173,7177,116
2021-12-21,Lassen,035,31185,7111,7069,435,7504,55
2021-12-21,Los Angeles,037,10098052,1535174,1501169,60861,1562030,27220
2021-12-21,Madera,039,155013,24893,24688,2411,27099,320
2021-12-21,Marin,041,260295,19439,18828,638,19466,249
2021-12-21,Mariposa,043,17540,1507,1480,63,1543,6
2021-12-21,Mendocino,045,87422,8400,8282,711,8993,97
2021-12-21,Merced,047,269075,44299,44096,2249,46345,688
2021-12-21,Modoc,049,8938,604,595,208,803,6
2021-12-21,Mono,051,14174,2022,1979,24,2003,4
2021-12-21,Monterey,053,433212,51179,49586,3537,53123,638
2021-12-21,Napa,055,140530,13943,13703,160,13863,107
2021-12-21,Nevada,057,99092,10259,10095,361,10456,110
2021-12-21,Orange,059,3164182,326117,320705,17614,338319,5855
2021-12-21,Placer,061,380077,40263,39649,4073,43722,487
2021-12-21,Plumas,063,18699,2027,1975,53,2028,12
2021-12-21,Riverside,065,2383286,389560,382415,17312,399727,5465
2021-12-21,Sacramento,067,1510023,170455,168422,5369,173791,2419
2021-12-21,San Benito,069,59416,8034,7950,190,8140,79
2021-12-21,San Bernardino,071,2135413,380003,374219,12246,386465,6026
2021-12-21,San Diego,073,3302833,410161,402386,23945,426331,4424
2021-12-21,San Francisco,075,870044,60315,56950,2772,59722,681
2021-12-21,San Joaquin,077,732212,105398,104238,5839,110077,1870
2021-12-21,San Luis Obispo,079,281455,31664,31103,1428,32531,365
2021-12-21,San Mateo,081,765935,59087,56381,1101,57482,581
2021-12-21,Santa Barbara,083,443738,47917,47194,1698,48892,564
2021-12-21,Santa Clara,085,1922200,159164,155769,1915,157684,1951
2021-12-21,Santa Cruz,087,273765,22446,22028,1086,23114,228
2021-12-21,Shasta,089,179085,23063,22920,3780,26700,429
2021-12-21,Sierra,091,2930,206,201,21,222,0
2021-12-21,Siskiyou,093,43540,3515,3455,1398,4853,59
2021-12-21,Solano,095,438530,48387,47474,1428,48902,372
2021-12-21,Sonoma,097,501317,44872,44051,630,44681,408
2021-12-21,Stanislaus,099,539301,83019,83167,9555,92722,1331
2021-12-21,Sutter,101,95872,14565,14492,418,14910,190
2021-12-21,Tehama,103,63373,8949,8849,1575,10424,136
2021-12-21,Trinity,105,12862,913,826,228,1054,17
2021-12-21,Tulare,107,460477,72333,71166,16915,88081,1137
2021-12-21,Tuolumne,109,53932,7936,7893,117,8010,91
2021-12-21,Ventura,111,848112,104701,102631,4759,107390,1205
2021-12-21,Yolo,113,214977,21314,20944,1380,22324,267
2021-12-21,Yuba,115,75493,10772,10668,419,11087,98
2021-12-20,Alameda,001,1643700,128269,125762,3193,128955,1515
2021-12-20,Alpine,003,1148,110,112,0,112,0
2021-12-20,Amador,005,37829,5881,5838,78,5916,70
2021-12-20,Butte,007,227075,22280,22030,3997,26027,329
2021-12-20,Calaveras,009,45235,4612,4569,66,4635,91
2021-12-20,Colusa,011,21464,2658,2644,698,3342,21
2021-12-20,Contra Costa,013,1133247,105596,104051,2494,106545,1068
2021-12-20,Del Norte,015,27424,3829,3792,57,3849,43
2021-12-20,El Dorado,017,186661,17372,17083,1832,18915,172
2021-12-20,Fresno,019,978130,149216,147605,13542,161147,2341
2021-12-20,Glenn,021,27897,3636,3597,1060,4657,39
2021-12-20,Humboldt,023,135768,10098,9973,752,10725,118
2021-12-20,Imperial,025,180216,37106,36532,4148,40680,792
2021-12-20,Inyo,027,18085,2652,2615,43,2658,47
2021-12-20,Kern,029,883053,135425,134203,24889,159092,1883
2021-12-20,Kings,031,150075,34265,33898,2102,36000,376
2021-12-20,Lake,033,64148,7050,6999,173,7172,116
2021-12-20,Lassen,035,31185,7109,7065,434,7499,55
2021-12-20,Los Angeles,037,10098052,1523708,1495251,60125,1555376,27188
2021-12-20,Madera,039,155013,24864,24668,2407,27075,313
2021-12-20,Marin,041,260295,19225,18747,620,19367,249
2021-12-20,Mariposa,043,17540,1498,1479,63,1542,6
2021-12-20,Mendocino,045,87422,8388,8264,709,8973,96
2021-12-20,Merced,047,269075,44242,44071,2244,46315,687
2021-12-20,Modoc,049,8938,604,595,205,800,6
2021-12-20,Mono,051,14174,2000,1973,24,1997,4
2021-12-20,Monterey,053,433212,51082,49556,3517,53073,636
2021-12-20,Napa,055,140530,13859,13672,150,13822,107
2021-12-20,Nevada,057,99092,10219,10079,360,10439,109
2021-12-20,Orange,059,3164182,324521,320235,17293,337528,5852
2021-12-20,Placer,061,380077,40135,39579,4043,43622,485
2021-12-20,Plumas,063,18699,2024,1971,51,2022,12
2021-12-20,Riverside,065,2383286,388120,381841,17222,399063,5452
2021-12-20,Sacramento,067,1510023,169884,168153,5326,173479,2414
2021-12-20,San Benito,069,59416,7990,7934,188,8122,79
2021-12-20,San Bernardino,071,2135413,378539,373881,12162,386043,6023
2021-12-20,San Diego,073,3302833,406926,401483,23703,425186,4412
2021-12-20,San Francisco,075,870044,59256,56661,2711,59372,681
2021-12-20,San Joaquin,077,732212,105156,104188,5830,110018,1865
2021-12-20,San Luis Obispo,079,281455,31551,31075,1420,32495,365
2021-12-20,San Mateo,081,765935,58540,56247,1082,57329,581
2021-12-20,Santa Barbara,083,443738,47708,47131,1693,48824,562
2021-12-20,Santa Clara,085,1922200,158205,155427,1866,157293,1950
2021-12-20,Santa Cruz,087,273765,22365,21989,1081,23070,227
2021-12-20,Shasta,089,179085,23043,22888,3775,26663,429
2021-12-20,Sierra,091,2930,205,201,21,222,0
2021-12-20,Siskiyou,093,43540,3514,3453,1396,4849,59
2021-12-20,Solano,095,438530,48258,47394,1420,48814,370
2021-12-20,Sonoma,097,501317,44682,43982,622,44604,408
2021-12-20,Stanislaus,099,539301,82895,83110,9529,92639,1331
2021-12-20,Sutter,101,95872,14542,14480,418,14898,190
2021-12-20,Tehama,103,63373,8941,8840,1572,10412,136
2021-12-20,Trinity,105,12862,913,826,228,1054,17
2021-12-20,Tulare,107,460477,72239,71124,16855,87979,1129
2021-12-20,Tuolumne,109,53932,7922,7867,113,7980,91
2021-12-20,Ventura,111,848112,104194,102452,4681,107133,1203
2021-12-20,Yolo,113,214977,21221,20903,1368,22271,267
2021-12-20,Yuba,115,75493,10756,10656,416,11072,97
2021-12-19,Alameda,001,1643700,127393,125464,3148,128612,1519
2021-12-19,Alpine,003,1148,110,112,0,112,0
2021-12-19,Amador,005,37829,5869,5832,77,5909,70
2021-12-19,Butte,007,227075,22228,22022,3991,26013,329
2021-12-19,Calaveras,009,45235,4596,4563,65,4628,91
2021-12-19,Colusa,011,21464,2658,2643,695,3338,21
2021-12-19,Contra Costa,013,1133247,105105,103906,2459,106365,1068
2021-12-19,Del Norte,015,27424,3825,3797,57,3854,43
2021-12-19,El Dorado,017,186661,17316,17067,1830,18897,172
2021-12-19,Fresno,019,978130,148975,147505,13516,161021,2341
2021-12-19,Glenn,021,27897,3632,3596,1059,4655,39
2021-12-19,Humboldt,023,135768,10057,9957,747,10704,118
2021-12-19,Imperial,025,180216,36977,36501,4104,40605,792
2021-12-19,Inyo,027,18085,2643,2613,43,2656,47
2021-12-19,Kern,029,883053,135228,134136,24818,158954,1883
2021-12-19,Kings,031,150075,34205,33874,2098,35972,378
2021-12-19,Lake,033,64148,7041,6999,170,7169,116
2021-12-19,Lassen,035,31185,7105,7065,434,7499,55
2021-12-19,Los Angeles,037,10098052,1514752,1495082,59512,1554594,27189
2021-12-19,Madera,039,155013,24839,24642,2401,27043,313
2021-12-19,Marin,041,260295,19049,18707,597,19304,249
2021-12-19,Mariposa,043,17540,1492,1475,63,1538,6
2021-12-19,Mendocino,045,87422,8371,8257,706,8963,96
2021-12-19,Merced,047,269075,44147,44045,2237,46282,687
2021-12-19,Modoc,049,8938,603,595,205,800,6
2021-12-19,Mono,051,14174,1989,1968,23,1991,4
2021-12-19,Monterey,053,433212,50980,49516,3495,53011,636
2021-12-19,Napa,055,140530,13786,13659,141,13800,107
2021-12-19,Nevada,057,99092,10183,10057,357,10414,109
2021-12-19,Orange,059,3164182,323134,319615,17064,336679,5852
2021-12-19,Placer,061,380077,40016,39525,4026,43551,485
2021-12-19,Plumas,063,18699,2021,1971,51,2022,12
2021-12-19,Riverside,065,2383286,386693,381305,17146,398451,5452
2021-12-19,Sacramento,067,1510023,169387,167933,5297,173230,2415
2021-12-19,San Benito,069,59416,7964,7929,187,8116,79
2021-12-19,San Bernardino,071,2135413,377259,373480,12121,385601,6023
2021-12-19,San Diego,073,3302833,404420,398197,23506,421703,4406
2021-12-19,San Francisco,075,870044,58386,56358,2655,59013,681
2021-12-19,San Joaquin,077,732212,104898,104125,5816,109941,1865
2021-12-19,San Luis Obispo,079,281455,31428,31035,1408,32443,366
2021-12-19,San Mateo,081,765935,58074,56132,1067,57199,581
2021-12-19,Santa Barbara,083,443738,47485,47070,1686,48756,562
2021-12-19,Santa Clara,085,1922200,157317,155049,1838,156887,1950
2021-12-19,Santa Cruz,087,273765,22266,21960,1076,23036,227
2021-12-19,Shasta,089,179085,23007,22875,3771,26646,429
2021-12-19,Sierra,091,2930,204,201,21,222,0
2021-12-19,Siskiyou,093,43540,3511,3452,1396,4848,59
2021-12-19,Solano,095,438530,48139,47341,1414,48755,370
2021-12-19,Sonoma,097,501317,44498,43944,620,44564,408
2021-12-19,Stanislaus,099,539301,82756,83040,9498,92538,1331
2021-12-19,Sutter,101,95872,14502,14475,417,14892,190
2021-12-19,Tehama,103,63373,8933,8840,1572,10412,136
2021-12-19,Trinity,105,12862,913,826,228,1054,17
2021-12-19,Tulare,107,460477,72145,71085,16813,87898,1129
2021-12-19,Tuolumne,109,53932,7905,7865,112,7977,91
2021-12-19,Ventura,111,848112,103614,102170,4616,106786,1203
2021-12-19,Yolo,113,214977,21142,20887,1348,22235,267
2021-12-19,Yuba,115,75493,10739,10646,414,11060,97
2021-12-18,Alameda,001,1643700,126990,124583,3123,127706,1512
2021-12-18,Alpine,003,1148,110,110,0,110,0
2021-12-18,Amador,005,37829,5863,5821,77,5898,69
2021-12-18,Butte,007,227075,22211,21956,3986,25942,328
2021-12-18,Calaveras,009,45235,4589,4534,65,4599,91
2021-12-18,Colusa,011,21464,2655,2635,693,3328,21
2021-12-18,Contra Costa,013,1133247,104892,103380,2445,105825,1065
2021-12-18,Del Norte,015,27424,3822,3791,57,3848,43
2021-12-18,El Dorado,017,186661,17288,16968,1827,18795,171
2021-12-18,Fresno,019,978130,148872,147038,13504,160542,2335
2021-12-18,Glenn,021,27897,3629,3590,1059,4649,39
2021-12-18,Humboldt,023,135768,10041,9889,747,10636,118
2021-12-18,Imperial,025,180216,36905,36280,4092,40372,790
2021-12-18,Inyo,027,18085,2637,2607,43,2650,47
2021-12-18,Kern,029,883053,135138,133754,24771,158525,1873
2021-12-18,Kings,031,150075,34173,33783,2094,35877,374
2021-12-18,Lake,033,64148,7040,6976,170,7146,115
2021-12-18,Lassen,035,31185,7103,7061,433,7494,55
2021-12-18,Los Angeles,037,10098052,1510674,1484840,59195,1544035,27135
2021-12-18,Madera,039,155013,24824,24575,2399,26974,313
2021-12-18,Marin,041,260295,18949,18537,585,19122,249
2021-12-18,Mariposa,043,17540,1491,1468,63,1531,6
2021-12-18,Mendocino,045,87422,8365,8219,706,8925,95
2021-12-18,Merced,047,269075,44113,43929,2236,46165,686
2021-12-18,Modoc,049,8938,601,595,205,800,6
2021-12-18,Mono,051,14174,1987,1956,23,1979,4
2021-12-18,Monterey,053,433212,50921,49343,3490,52833,635
2021-12-18,Napa,055,140530,13760,13581,139,13720,107
2021-12-18,Nevada,057,99092,10161,9991,355,10346,108
2021-12-18,Orange,059,3164182,322471,318149,16925,335074,5844
2021-12-18,Placer,061,380077,39916,39336,4012,43348,485
2021-12-18,Plumas,063,18699,2021,1964,51,2015,13
2021-12-18,Riverside,065,2383286,386001,379354,17104,396458,5439
2021-12-18,Sacramento,067,1510023,169151,167046,5276,172322,2404
2021-12-18,San Benito,069,59416,7949,7894,187,8081,79
2021-12-18,San Bernardino,071,2135413,376611,371658,12093,383751,6017
2021-12-18,San Diego,073,3302833,403465,397130,23454,420584,4399
2021-12-18,San Francisco,075,870044,57894,55562,2625,58187,679
2021-12-18,San Joaquin,077,732212,104811,103698,5806,109504,1858
2021-12-18,San Luis Obispo,079,281455,31385,30873,1402,32275,365
2021-12-18,San Mateo,081,765935,57834,55730,1062,56792,580
2021-12-18,Santa Barbara,083,443738,47389,46776,1684,48460,562
2021-12-18,Santa Clara,085,1922200,156867,154243,1825,156068,1946
2021-12-18,Santa Cruz,087,273765,22214,21805,1074,22879,225
2021-12-18,Shasta,089,179085,22986,22811,3771,26582,429
2021-12-18,Sierra,091,2930,204,199,21,220,0
2021-12-18,Siskiyou,093,43540,3509,3441,1395,4836,58
2021-12-18,Solano,095,438530,48093,47174,1412,48586,369
2021-12-18,Sonoma,097,501317,44387,43658,616,44274,407
2021-12-18,Stanislaus,099,539301,82674,82736,9487,92223,1330
2021-12-18,Sutter,101,95872,14484,14435,417,14852,190
2021-12-18,Tehama,103,63373,8927,8814,1571,10385,136
2021-12-18,Trinity,105,12862,913,823,228,1051,17
2021-12-18,Tulare,107,460477,72107,70922,16788,87710,1120
2021-12-18,Tuolumne,109,53932,7891,7834,112,7946,91
2021-12-18,Ventura,111,848112,103329,101612,4592,106204,1201
2021-12-18,Yolo,113,214977,21102,20793,1342,22135,267
2021-12-18,Yuba,115,75493,10726,10599,414,11013,96
2021-12-17,Alameda,001,1643700,126658,124583,3104,127687,1512
2021-12-17,Alpine,003,1148,110,110,0,110,0
2021-12-17,Amador,005,37829,5856,5821,77,5898,69
2021-12-17,Butte,007,227075,22191,21956,3980,25936,328
2021-12-17,Calaveras,009,45235,4585,4534,65,4599,91
2021-12-17,Colusa,011,21464,2654,2635,692,3327,21
2021-12-17,Contra Costa,013,1133247,104690,103380,2441,105821,1065
2021-12-17,Del Norte,015,27424,3821,3791,57,3848,43
2021-12-17,El Dorado,017,186661,17259,16968,1824,18792,171
2021-12-17,Fresno,019,978130,148768,147038,13504,160542,2335
2021-12-17,Glenn,021,27897,3622,3590,1059,4649,39
2021-12-17,Humboldt,023,135768,10021,9889,745,10634,118
2021-12-17,Imperial,025,180216,36842,36280,4074,40354,790
2021-12-17,Inyo,027,18085,2632,2607,43,2650,47
2021-12-17,Kern,029,883053,135048,133754,24729,158483,1873
2021-12-17,Kings,031,150075,34154,33783,2094,35877,374
2021-12-17,Lake,033,64148,7036,6976,170,7146,115
2021-12-17,Lassen,035,31185,7103,7061,432,7493,55
2021-12-17,Los Angeles,037,10098052,1506732,1484840,58950,1543790,27135
2021-12-17,Madera,039,155013,24808,24575,2394,26969,313
2021-12-17,Marin,041,260295,18873,18537,581,19118,249
2021-12-17,Mariposa,043,17540,1487,1468,63,1531,6
2021-12-17,Mendocino,045,87422,8354,8219,706,8925,95
2021-12-17,Merced,047,269075,44086,43929,2235,46164,686
2021-12-17,Modoc,049,8938,601,595,205,800,6
2021-12-17,Mono,051,14174,1984,1956,23,1979,4
2021-12-17,Monterey,053,433212,50863,49343,3485,52828,635
2021-12-17,Napa,055,140530,13733,13581,138,13719,107
2021-12-17,Nevada,057,99092,10150,9991,355,10346,108
2021-12-17,Orange,059,3164182,321913,318149,16857,335006,5844
2021-12-17,Placer,061,380077,39862,39336,4006,43342,485
2021-12-17,Plumas,063,18699,2020,1964,51,2015,13
2021-12-17,Riverside,065,2383286,385355,379354,17093,396447,5439
2021-12-17,Sacramento,067,1510023,168921,167046,5263,172309,2404
2021-12-17,San Benito,069,59416,7947,7894,187,8081,79
2021-12-17,San Bernardino,071,2135413,376072,371658,12076,383734,6017
2021-12-17,San Diego,073,3302833,402526,397130,23406,420536,4399
2021-12-17,San Francisco,075,870044,57568,55562,2595,58157,679
2021-12-17,San Joaquin,077,732212,104737,103698,5788,109486,1858
2021-12-17,San Luis Obispo,079,281455,31357,30873,1398,32271,365
2021-12-17,San Mateo,081,765935,57646,55730,1055,56785,580
2021-12-17,Santa Barbara,083,443738,47312,46776,1678,48454,562
2021-12-17,Santa Clara,085,1922200,156494,154243,1810,156053,1946
2021-12-17,Santa Cruz,087,273765,22168,21805,1071,22876,225
2021-12-17,Shasta,089,179085,22973,22811,3769,26580,429
2021-12-17,Sierra,091,2930,203,199,21,220,0
2021-12-17,Siskiyou,093,43540,3505,3441,1393,4834,58
2021-12-17,Solano,095,438530,48025,47174,1408,48582,369
2021-12-17,Sonoma,097,501317,44290,43658,613,44271,407
2021-12-17,Stanislaus,099,539301,82623,82736,9481,92217,1330
2021-12-17,Sutter,101,95872,14472,14435,415,14850,190
2021-12-17,Tehama,103,63373,8920,8814,1570,10384,136
2021-12-17,Trinity,105,12862,913,823,228,1051,17
2021-12-17,Tulare,107,460477,72065,70922,16757,87679,1120
2021-12-17,Tuolumne,109,53932,7879,7834,112,7946,91
2021-12-17,Ventura,111,848112,103079,101612,4580,106192,1201
2021-12-17,Yolo,113,214977,21069,20793,1336,22129,267
2021-12-17,Yuba,115,75493,10715,10599,411,11010,96
2021-12-16,Alameda,001,1643700,126286,124583,3090,127673,1512
2021-12-16,Alpine,003,1148,108,110,0,110,0
2021-12-16,Amador,005,37829,5848,5821,77,5898,69
2021-12-16,Butte,007,227075,22172,21956,3977,25933,328
2021-12-16,Calaveras,009,45235,4577,4534,65,4599,91
2021-12-16,Colusa,011,21464,2654,2635,692,3327,21
2021-12-16,Contra Costa,013,1133247,104466,103380,2428,105808,1065
2021-12-16,Del Norte,015,27424,3818,3791,57,3848,43
2021-12-16,El Dorado,017,186661,17224,16968,1819,18787,171
2021-12-16,Fresno,019,978130,148608,147038,13497,160535,2335
2021-12-16,Glenn,021,27897,3621,3590,1056,4646,39
2021-12-16,Humboldt,023,135768,9997,9889,735,10624,118
2021-12-16,Imperial,025,180216,36757,36280,4044,40324,790
2021-12-16,Inyo,027,18085,2628,2607,42,2649,47
2021-12-16,Kern,029,883053,134906,133754,24678,158432,1873
2021-12-16,Kings,031,150075,34130,33783,2093,35876,374
2021-12-16,Lake,033,64148,7032,6976,170,7146,115
2021-12-16,Lassen,035,31185,7100,7061,431,7492,55
2021-12-16,Los Angeles,037,10098052,1502518,1484840,58677,1543517,27135
2021-12-16,Madera,039,155013,24780,24575,2390,26965,313
2021-12-16,Marin,041,260295,18826,18537,573,19110,249
2021-12-16,Mariposa,043,17540,1485,1468,63,1531,6
2021-12-16,Mendocino,045,87422,8343,8219,701,8920,95
2021-12-16,Merced,047,269075,44047,43929,2234,46163,686
2021-12-16,Modoc,049,8938,601,595,205,800,6
2021-12-16,Mono,051,14174,1981,1956,23,1979,4
2021-12-16,Monterey,053,433212,50792,49343,3468,52811,635
2021-12-16,Napa,055,140530,13701,13581,138,13719,107
2021-12-16,Nevada,057,99092,10124,9991,355,10346,108
2021-12-16,Orange,059,3164182,321306,318149,16777,334926,5844
2021-12-16,Placer,061,380077,39785,39336,4001,43337,485
2021-12-16,Plumas,063,18699,2020,1964,51,2015,13
2021-12-16,Riverside,065,2383286,384555,379354,17079,396433,5439
2021-12-16,Sacramento,067,1510023,168635,167046,5238,172284,2404
2021-12-16,San Benito,069,59416,7940,7894,187,8081,79
2021-12-16,San Bernardino,071,2135413,375422,371658,12058,383716,6017
2021-12-16,San Diego,073,3302833,401344,397130,23340,420470,4399
2021-12-16,San Francisco,075,870044,57193,55562,2573,58135,679
2021-12-16,San Joaquin,077,732212,104616,103698,5781,109479,1858
2021-12-16,San Luis Obispo,079,281455,31288,30873,1392,32265,365
2021-12-16,San Mateo,081,765935,57446,55730,1052,56782,580
2021-12-16,Santa Barbara,083,443738,47190,46776,1674,48450,562
2021-12-16,Santa Clara,085,1922200,156163,154243,1800,156043,1946
2021-12-16,Santa Cruz,087,273765,22122,21805,1070,22875,225
2021-12-16,Shasta,089,179085,22943,22811,3767,26578,429
2021-12-16,Sierra,091,2930,203,199,21,220,0
2021-12-16,Siskiyou,093,43540,3504,3441,1389,4830,58
2021-12-16,Solano,095,438530,47957,47174,1401,48575,369
2021-12-16,Sonoma,097,501317,44192,43658,611,44269,407
2021-12-16,Stanislaus,099,539301,82536,82736,9467,92203,1330
2021-12-16,Sutter,101,95872,14458,14435,414,14849,190
2021-12-16,Tehama,103,63373,8913,8814,1569,10383,136
2021-12-16,Trinity,105,12862,913,823,228,1051,17
2021-12-16,Tulare,107,460477,72016,70922,16731,87653,1120
2021-12-16,Tuolumne,109,53932,7860,7834,112,7946,91
2021-12-16,Ventura,111,848112,102811,101612,4573,106185,1201
2021-12-16,Yolo,113,214977,21019,20793,1331,22124,267
2021-12-16,Yuba,115,75493,10700,10599,410,11009,96
2021-12-15,Alameda,001,1643700,125962,124342,3078,127420,1509
2021-12-15,Alpine,003,1148,108,109,0,109,0
2021-12-15,Amador,005,37829,5842,5810,77,5887,69
2021-12-15,Butte,007,227075,22150,21922,3976,25898,327
2021-12-15,Calaveras,009,45235,4571,4523,65,4588,89
2021-12-15,Colusa,011,21464,2653,2632,691,3323,21
2021-12-15,Contra Costa,013,1133247,104247,103236,2425,105661,1064
2021-12-15,Del Norte,015,27424,3817,3789,56,3845,43
2021-12-15,El Dorado,017,186661,17192,16936,1813,18749,171
2021-12-15,Fresno,019,978130,148480,146859,13482,160341,2319
2021-12-15,Glenn,021,27897,3621,3589,1056,4645,39
2021-12-15,Humboldt,023,135768,9977,9854,734,10588,118
2021-12-15,Imperial,025,180216,36678,36187,4000,40187,789
2021-12-15,Inyo,027,18085,2623,2606,42,2648,47
2021-12-15,Kern,029,883053,134767,133590,24631,158221,1866
2021-12-15,Kings,031,150075,34101,33716,2089,35805,374
2021-12-15,Lake,033,64148,7023,6968,169,7137,115
2021-12-15,Lassen,035,31185,7100,7062,431,7493,55
2021-12-15,Los Angeles,037,10098052,1498628,1482735,58480,1541215,27116
2021-12-15,Madera,039,155013,24762,24549,2384,26933,313
2021-12-15,Marin,041,260295,18768,18514,568,19082,249
2021-12-15,Mariposa,043,17540,1482,1463,63,1526,6
2021-12-15,Mendocino,045,87422,8338,8209,698,8907,95
2021-12-15,Merced,047,269075,44005,43890,2222,46112,685
2021-12-15,Modoc,049,8938,601,595,205,800,6
2021-12-15,Mono,051,14174,1977,1955,23,1978,4
2021-12-15,Monterey,053,433212,50737,49279,3450,52729,635
2021-12-15,Napa,055,140530,13672,13557,136,13693,107
2021-12-15,Nevada,057,99092,10103,9958,355,10313,107
2021-12-15,Orange,059,3164182,320731,317808,16735,334543,5838
2021-12-15,Placer,061,380077,39730,39264,3991,43255,485
2021-12-15,Plumas,063,18699,2016,1957,51,2008,12
2021-12-15,Riverside,065,2383286,383838,378769,17067,395836,5438
2021-12-15,Sacramento,067,1510023,168327,166793,5216,172009,2401
2021-12-15,San Benito,069,59416,7925,7877,187,8064,79
2021-12-15,San Bernardino,071,2135413,374884,371122,12027,383149,6013
2021-12-15,San Diego,073,3302833,400156,396546,23271,419817,4395
2021-12-15,San Francisco,075,870044,56875,55414,2555,57969,679
2021-12-15,San Joaquin,077,732212,104459,103579,5771,109350,1853
2021-12-15,San Luis Obispo,079,281455,31240,30784,1385,32169,365
2021-12-15,San Mateo,081,765935,57305,55657,1041,56698,580
2021-12-15,Santa Barbara,083,443738,47109,46681,1672,48353,562
2021-12-15,Santa Clara,085,1922200,155851,153928,1779,155707,1944
2021-12-15,Santa Cruz,087,273765,22082,21753,1063,22816,225
2021-12-15,Shasta,089,179085,22928,22778,3763,26541,427
2021-12-15,Sierra,091,2930,203,199,21,220,0
2021-12-15,Siskiyou,093,43540,3503,3434,1388,4822,58
2021-12-15,Solano,095,438530,47886,47098,1394,48492,367
2021-12-15,Sonoma,097,501317,44108,43580,606,44186,407
2021-12-15,Stanislaus,099,539301,82430,82628,9459,92087,1298
2021-12-15,Sutter,101,95872,14438,14428,413,14841,189
2021-12-15,Tehama,103,63373,8906,8806,1568,10374,136
2021-12-15,Trinity,105,12862,912,822,228,1050,17
2021-12-15,Tulare,107,460477,71964,70846,16702,87548,1120
2021-12-15,Tuolumne,109,53932,7851,7818,111,7929,91
2021-12-15,Ventura,111,848112,102596,101447,4567,106014,1199
2021-12-15,Yolo,113,214977,20991,20749,1326,22075,267
2021-12-15,Yuba,115,75493,10689,10587,409,10996,96
2021-12-14,Alameda,001,1643700,125634,124272,3066,127338,1506
2021-12-14,Alpine,003,1148,107,109,0,109,0
2021-12-14,Amador,005,37829,5836,5808,76,5884,69
2021-12-14,Butte,007,227075,22117,21901,3974,25875,326
2021-12-14,Calaveras,009,45235,4559,4517,65,4582,89
2021-12-14,Colusa,011,21464,2651,2628,691,3319,21
2021-12-14,Contra Costa,013,1133247,104063,103135,2421,105556,1064
2021-12-14,Del Norte,015,27424,3814,3788,56,3844,43
2021-12-14,El Dorado,017,186661,17158,16915,1811,18726,170
2021-12-14,Fresno,019,978130,148310,146756,13474,160230,2316
2021-12-14,Glenn,021,27897,3620,3589,1056,4645,39
2021-12-14,Humboldt,023,135768,9965,9836,726,10562,118
2021-12-14,Imperial,025,180216,36605,36049,3958,40007,789
2021-12-14,Inyo,027,18085,2623,2601,42,2643,46
2021-12-14,Kern,029,883053,134631,133498,24582,158080,1863
2021-12-14,Kings,031,150075,34064,33693,2086,35779,373
2021-12-14,Lake,033,64148,7014,6961,169,7130,115
2021-12-14,Lassen,035,31185,7099,7061,431,7492,55
2021-12-14,Los Angeles,037,10098052,1494983,1481131,58298,1539429,27099
2021-12-14,Madera,039,155013,24736,24535,2376,26911,313
2021-12-14,Marin,041,260295,18720,18491,566,19057,249
2021-12-14,Mariposa,043,17540,1479,1463,62,1525,6
2021-12-14,Mendocino,045,87422,8310,8206,696,8902,95
2021-12-14,Merced,047,269075,43959,43870,2220,46090,684
2021-12-14,Modoc,049,8938,600,595,205,800,6
2021-12-14,Mono,051,14174,1970,1955,23,1978,4
2021-12-14,Monterey,053,433212,50654,49237,3439,52676,635
2021-12-14,Napa,055,140530,13643,13528,136,13664,107
2021-12-14,Nevada,057,99092,10077,9956,354,10310,106
2021-12-14,Orange,059,3164182,320181,317465,16681,334146,5827
2021-12-14,Placer,061,380077,39653,39221,3986,43207,482
2021-12-14,Plumas,063,18699,2012,1950,49,1999,12
2021-12-14,Riverside,065,2383286,383167,378227,17050,395277,5427
2021-12-14,Sacramento,067,1510023,168018,166605,5193,171798,2394
2021-12-14,San Benito,069,59416,7906,7871,187,8058,79
2021-12-14,San Bernardino,071,2135413,374268,370604,11997,382601,6013
2021-12-14,San Diego,073,3302833,399018,395876,23220,419096,4393
2021-12-14,San Francisco,075,870044,56562,55278,2543,57821,679
2021-12-14,San Joaquin,077,732212,104314,103488,5753,109241,1848
2021-12-14,San Luis Obispo,079,281455,31180,30753,1381,32134,363
2021-12-14,San Mateo,081,765935,57142,55601,1034,56635,580
2021-12-14,Santa Barbara,083,443738,47009,46648,1667,48315,560
2021-12-14,Santa Clara,085,1922200,155530,153814,1766,155580,1945
2021-12-14,Santa Cruz,087,273765,22017,21737,1058,22795,225
2021-12-14,Shasta,089,179085,22901,22756,3762,26518,427
2021-12-14,Sierra,091,2930,201,199,21,220,0
2021-12-14,Siskiyou,093,43540,3498,3430,1387,4817,58
2021-12-14,Solano,095,438530,47839,47065,1388,48453,367
2021-12-14,Sonoma,097,501317,44026,43538,604,44142,407
2021-12-14,Stanislaus,099,539301,82345,82581,9445,92026,1293
2021-12-14,Sutter,101,95872,14426,14421,412,14833,189
2021-12-14,Tehama,103,63373,8902,8805,1568,10373,134
2021-12-14,Trinity,105,12862,912,821,228,1049,17
2021-12-14,Tulare,107,460477,71893,70803,16671,87474,1120
2021-12-14,Tuolumne,109,53932,7838,7815,111,7926,91
2021-12-14,Ventura,111,848112,102372,101343,4560,105903,1199
2021-12-14,Yolo,113,214977,20957,20734,1312,22046,267
2021-12-14,Yuba,115,75493,10672,10574,409,10983,92
2021-12-13,Alameda,001,1643700,125348,124174,3050,127224,1501
2021-12-13,Alpine,003,1148,107,109,0,109,0
2021-12-13,Amador,005,37829,5832,5797,76,5873,69
2021-12-13,Butte,007,227075,22093,21889,3970,25859,326
2021-12-13,Calaveras,009,45235,4552,4507,64,4571,89
2021-12-13,Colusa,011,21464,2649,2627,691,3318,21
2021-12-13,Contra Costa,013,1133247,103912,103041,2410,105451,1064
2021-12-13,Del Norte,015,27424,3810,3787,56,3843,42
2021-12-13,El Dorado,017,186661,17135,16896,1809,18705,170
2021-12-13,Fresno,019,978130,148158,146641,13464,160105,2312
2021-12-13,Glenn,021,27897,3615,3589,1054,4643,37
2021-12-13,Humboldt,023,135768,9936,9821,722,10543,118
2021-12-13,Imperial,025,180216,36521,35974,3937,39911,787
2021-12-13,Inyo,027,18085,2622,2592,42,2634,46
2021-12-13,Kern,029,883053,134504,133381,24529,157910,1863
2021-12-13,Kings,031,150075,34021,33680,2081,35761,372
2021-12-13,Lake,033,64148,7012,6958,167,7125,115
2021-12-13,Lassen,035,31185,7098,7057,431,7488,55
2021-12-13,Los Angeles,037,10098052,1492200,1480195,58131,1538326,27085
2021-12-13,Madera,039,155013,24708,24527,2371,26898,311
2021-12-13,Marin,041,260295,18660,18471,563,19034,249
2021-12-13,Mariposa,043,17540,1477,1462,62,1524,6
2021-12-13,Mendocino,045,87422,8297,8196,694,8890,95
2021-12-13,Merced,047,269075,43920,43848,2216,46064,682
2021-12-13,Modoc,049,8938,599,595,205,800,6
2021-12-13,Mono,051,14174,1963,1952,23,1975,4
2021-12-13,Monterey,053,433212,50602,49222,3419,52641,631
2021-12-13,Napa,055,140530,13630,13518,136,13654,107
2021-12-13,Nevada,057,99092,10058,9946,353,10299,106
2021-12-13,Orange,059,3164182,319714,317112,16627,333739,5824
2021-12-13,Placer,061,380077,39592,39168,3975,43143,481
2021-12-13,Plumas,063,18699,2008,1943,49,1992,12
2021-12-13,Riverside,065,2383286,382587,377728,17035,394763,5414
2021-12-13,Sacramento,067,1510023,167738,166439,5159,171598,2392
2021-12-13,San Benito,069,59416,7897,7856,187,8043,79
2021-12-13,San Bernardino,071,2135413,373700,370274,11990,382264,6011
2021-12-13,San Diego,073,3302833,398207,395266,23167,418433,4389
2021-12-13,San Francisco,075,870044,56291,55245,2530,57775,678
2021-12-13,San Joaquin,077,732212,104198,103449,5744,109193,1846
2021-12-13,San Luis Obispo,079,281455,31131,30746,1377,32123,363
2021-12-13,San Mateo,081,765935,56982,55569,1025,56594,580
2021-12-13,Santa Barbara,083,443738,46922,46608,1662,48270,560
2021-12-13,Santa Clara,085,1922200,155265,153672,1755,155427,1944
2021-12-13,Santa Cruz,087,273765,21962,21698,1055,22753,225
2021-12-13,Shasta,089,179085,22880,22731,3760,26491,426
2021-12-13,Sierra,091,2930,201,199,21,220,0
2021-12-13,Siskiyou,093,43540,3494,3426,1384,4810,57
2021-12-13,Solano,095,438530,47765,47045,1383,48428,365
2021-12-13,Sonoma,097,501317,43931,43492,602,44094,407
2021-12-13,Stanislaus,099,539301,82231,82507,9425,91932,1282
2021-12-13,Sutter,101,95872,14419,14408,412,14820,188
2021-12-13,Tehama,103,63373,8889,8800,1568,10368,134
2021-12-13,Trinity,105,12862,912,820,228,1048,17
2021-12-13,Tulare,107,460477,71836,70758,16647,87405,1114
2021-12-13,Tuolumne,109,53932,7827,7804,111,7915,91
2021-12-13,Ventura,111,848112,102148,101180,4549,105729,1197
2021-12-13,Yolo,113,214977,20907,20706,1307,22013,267
2021-12-13,Yuba,115,75493,10655,10570,409,10979,92
2021-12-12,Alameda,001,1643700,125063,124075,3037,127112,1503
2021-12-12,Alpine,003,1148,107,109,0,109,0
2021-12-12,Amador,005,37829,5824,5797,75,5872,69
2021-12-12,Butte,007,227075,22069,21874,3967,25841,326
2021-12-12,Calaveras,009,45235,4542,4501,64,4565,89
2021-12-12,Colusa,011,21464,2644,2627,688,3315,21
2021-12-12,Contra Costa,013,1133247,103724,102976,2408,105384,1065
2021-12-12,Del Norte,015,27424,3807,3793,56,3849,42
2021-12-12,El Dorado,017,186661,17099,16890,1801,18691,170
2021-12-12,Fresno,019,978130,147995,146518,13448,159966,2310
2021-12-12,Glenn,021,27897,3612,3589,1054,4643,37
2021-12-12,Humboldt,023,135768,9912,9804,715,10519,118
2021-12-12,Imperial,025,180216,36386,35926,3905,39831,787
2021-12-12,Inyo,027,18085,2617,2592,42,2634,46
2021-12-12,Kern,029,883053,134339,133314,24488,157802,1861
2021-12-12,Kings,031,150075,33970,33661,2079,35740,372
2021-12-12,Lake,033,64148,7005,6955,165,7120,115
2021-12-12,Lassen,035,31185,7097,7057,431,7488,55
2021-12-12,Los Angeles,037,10098052,1489292,1479054,57945,1536999,27074
2021-12-12,Madera,039,155013,24678,24493,2363,26856,311
2021-12-12,Marin,041,260295,18607,18451,559,19010,249
2021-12-12,Mariposa,043,17540,1476,1461,62,1523,6
2021-12-12,Mendocino,045,87422,8284,8190,693,8883,95
2021-12-12,Merced,047,269075,43886,43821,2209,46030,682
2021-12-12,Modoc,049,8938,599,595,204,799,6
2021-12-12,Mono,051,14174,1959,1947,23,1970,4
2021-12-12,Monterey,053,433212,50549,49192,3393,52585,631
2021-12-12,Napa,055,140530,13587,13508,134,13642,107
2021-12-12,Nevada,057,99092,10031,9938,352,10290,106
2021-12-12,Orange,059,3164182,319210,316918,16563,333481,5825
2021-12-12,Placer,061,380077,39527,39139,3969,43108,481
2021-12-12,Plumas,063,18699,2004,1942,47,1989,12
2021-12-12,Riverside,065,2383286,381915,377467,17009,394476,5414
2021-12-12,Sacramento,067,1510023,167472,166291,5138,171429,2392
2021-12-12,San Benito,069,59416,7877,7853,187,8040,79
2021-12-12,San Bernardino,071,2135413,373067,369977,11966,381943,6011
2021-12-12,San Diego,073,3302833,397307,393307,23129,416436,4378
2021-12-12,San Francisco,075,870044,56037,55180,2518,57698,678
2021-12-12,San Joaquin,077,732212,104059,103405,5734,109139,1846
2021-12-12,San Luis Obispo,079,281455,31078,30719,1375,32094,363
2021-12-12,San Mateo,081,765935,56867,55505,1021,56526,580
2021-12-12,Santa Barbara,083,443738,46847,46586,1660,48246,560
2021-12-12,Santa Clara,085,1922200,154986,153452,1741,155193,1945
2021-12-12,Santa Cruz,087,273765,21913,21671,1053,22724,225
2021-12-12,Shasta,089,179085,22852,22732,3759,26491,426
2021-12-12,Sierra,091,2930,201,199,21,220,0
2021-12-12,Siskiyou,093,43540,3494,3424,1384,4808,57
2021-12-12,Solano,095,438530,47699,47021,1378,48399,365
2021-12-12,Sonoma,097,501317,43838,43424,599,44023,407
2021-12-12,Stanislaus,099,539301,82133,82460,9414,91874,1282
2021-12-12,Sutter,101,95872,14408,14396,412,14808,189
2021-12-12,Tehama,103,63373,8878,8796,1566,10362,134
2021-12-12,Trinity,105,12862,910,820,228,1048,17
2021-12-12,Tulare,107,460477,71758,70733,16605,87338,1115
2021-12-12,Tuolumne,109,53932,7810,7794,111,7905,91
2021-12-12,Ventura,111,848112,101954,101105,4535,105640,1197
2021-12-12,Yolo,113,214977,20857,20685,1296,21981,267
2021-12-12,Yuba,115,75493,10641,10565,406,10971,92
2021-12-11,Alameda,001,1643700,124926,123572,3035,126607,1496
2021-12-11,Alpine,003,1148,107,109,0,109,0
2021-12-11,Amador,005,37829,5819,5787,75,5862,69
2021-12-11,Butte,007,227075,22055,21819,3966,25785,326
2021-12-11,Calaveras,009,45235,4534,4469,63,4532,89
2021-12-11,Colusa,011,21464,2640,2619,687,3306,21
2021-12-11,Contra Costa,013,1133247,103638,102618,2406,105024,1061
2021-12-11,Del Norte,015,27424,3807,3778,56,3834,42
2021-12-11,El Dorado,017,186661,17078,16796,1800,18596,170
2021-12-11,Fresno,019,978130,147908,145988,13440,159428,2294
2021-12-11,Glenn,021,27897,3611,3585,1054,4639,37
2021-12-11,Humboldt,023,135768,9895,9721,712,10433,118
2021-12-11,Imperial,025,180216,36327,35635,3895,39530,782
2021-12-11,Inyo,027,18085,2612,2576,42,2618,46
2021-12-11,Kern,029,883053,134270,132852,24453,157305,1854
2021-12-11,Kings,031,150075,33957,33530,2077,35607,371
2021-12-11,Lake,033,64148,7004,6932,163,7095,114
2021-12-11,Lassen,035,31185,7096,7049,431,7480,55
2021-12-11,Los Angeles,037,10098052,1488074,1474030,57853,1531883,27031
2021-12-11,Madera,039,155013,24672,24417,2362,26779,311
2021-12-11,Marin,041,260295,18573,18339,556,18895,249
2021-12-11,Mariposa,043,17540,1475,1450,62,1512,6
2021-12-11,Mendocino,045,87422,8277,8130,693,8823,95
2021-12-11,Merced,047,269075,43867,43690,2208,45898,681
2021-12-11,Modoc,049,8938,599,594,204,798,6
2021-12-11,Mono,051,14174,1955,1926,23,1949,4
2021-12-11,Monterey,053,433212,50521,49008,3390,52398,631
2021-12-11,Napa,055,140530,13570,13459,134,13593,107
2021-12-11,Nevada,057,99092,10017,9880,352,10232,106
2021-12-11,Orange,059,3164182,318958,315759,16535,332294,5805
2021-12-11,Placer,061,380077,39469,38959,3962,42921,481
2021-12-11,Plumas,063,18699,1998,1934,47,1981,12
2021-12-11,Riverside,065,2383286,381498,375649,16995,392644,5408
2021-12-11,Sacramento,067,1510023,167342,165530,5128,170658,2386
2021-12-11,San Benito,069,59416,7863,7808,187,7995,79
2021-12-11,San Bernardino,071,2135413,372708,368145,11957,380102,6007
2021-12-11,San Diego,073,3302833,396883,392274,23091,415365,4374
2021-12-11,San Francisco,075,870044,55884,54869,2513,57382,678
2021-12-11,San Joaquin,077,732212,103998,103013,5730,108743,1842
2021-12-11,San Luis Obispo,079,281455,31056,30567,1371,31938,362
2021-12-11,San Mateo,081,765935,56789,55284,1019,56303,580
2021-12-11,Santa Barbara,083,443738,46812,46309,1660,47969,559
2021-12-11,Santa Clara,085,1922200,154788,152846,1729,154575,1941
2021-12-11,Santa Cruz,087,273765,21889,21557,1053,22610,225
2021-12-11,Shasta,089,179085,22837,22660,3755,26415,419
2021-12-11,Sierra,091,2930,201,199,21,220,0
2021-12-11,Siskiyou,093,43540,3488,3418,1381,4799,57
2021-12-11,Solano,095,438530,47670,46891,1373,48264,365
2021-12-11,Sonoma,097,501317,43790,43227,599,43826,407
2021-12-11,Stanislaus,099,539301,82083,82133,9405,91538,1264
2021-12-11,Sutter,101,95872,14399,14354,412,14766,187
2021-12-11,Tehama,103,63373,8875,8776,1564,10340,134
2021-12-11,Trinity,105,12862,910,819,228,1047,17
2021-12-11,Tulare,107,460477,71715,70523,16595,87118,1103
2021-12-11,Tuolumne,109,53932,7801,7760,111,7871,91
2021-12-11,Ventura,111,848112,101879,100711,4528,105239,1195
2021-12-11,Yolo,113,214977,20838,20608,1292,21900,267
2021-12-11,Yuba,115,75493,10629,10519,405,10924,92
2021-12-10,Alameda,001,1643700,124800,123572,3028,126600,1496
2021-12-10,Alpine,003,1148,106,109,0,109,0
2021-12-10,Amador,005,37829,5812,5787,75,5862,69
2021-12-10,Butte,007,227075,22042,21819,3964,25783,326
2021-12-10,Calaveras,009,45235,4531,4469,63,4532,89
2021-12-10,Colusa,011,21464,2639,2619,687,3306,21
2021-12-10,Contra Costa,013,1133247,103542,102618,2405,105023,1061
2021-12-10,Del Norte,015,27424,3807,3778,56,3834,42
2021-12-10,El Dorado,017,186661,17065,16796,1800,18596,170
2021-12-10,Fresno,019,978130,147820,145988,13429,159417,2294
2021-12-10,Glenn,021,27897,3611,3585,1054,4639,37
2021-12-10,Humboldt,023,135768,9878,9721,710,10431,118
2021-12-10,Imperial,025,180216,36272,35635,3880,39515,782
2021-12-10,Inyo,027,18085,2609,2576,42,2618,46
2021-12-10,Kern,029,883053,134181,132852,24429,157281,1854
2021-12-10,Kings,031,150075,33942,33530,2075,35605,371
2021-12-10,Lake,033,64148,6997,6932,163,7095,114
2021-12-10,Lassen,035,31185,7095,7049,431,7480,55
2021-12-10,Los Angeles,037,10098052,1486981,1474030,57765,1531795,27031
2021-12-10,Madera,039,155013,24654,24417,2360,26777,311
2021-12-10,Marin,041,260295,18551,18339,556,18895,249
2021-12-10,Mariposa,043,17540,1472,1450,62,1512,6
2021-12-10,Mendocino,045,87422,8270,8130,692,8822,95
2021-12-10,Merced,047,269075,43849,43690,2206,45896,681
2021-12-10,Modoc,049,8938,599,594,204,798,6
2021-12-10,Mono,051,14174,1952,1926,23,1949,4
2021-12-10,Monterey,053,433212,50484,49008,3384,52392,631
2021-12-10,Napa,055,140530,13558,13459,133,13592,107
2021-12-10,Nevada,057,99092,10008,9880,352,10232,106
2021-12-10,Orange,059,3164182,318687,315759,16503,332262,5805
2021-12-10,Placer,061,380077,39426,38959,3959,42918,481
2021-12-10,Plumas,063,18699,1996,1934,47,1981,12
2021-12-10,Riverside,065,2383286,381091,375649,16984,392633,5408
2021-12-10,Sacramento,067,1510023,167188,165530,5126,170656,2386
2021-12-10,San Benito,069,59416,7859,7808,187,7995,79
2021-12-10,San Bernardino,071,2135413,372335,368145,11934,380079,6007
2021-12-10,San Diego,073,3302833,396404,392274,23077,415351,4374
2021-12-10,San Francisco,075,870044,55799,54869,2507,57376,678
2021-12-10,San Joaquin,077,732212,103943,103013,5726,108739,1842
2021-12-10,San Luis Obispo,079,281455,31046,30567,1368,31935,362
2021-12-10,San Mateo,081,765935,56732,55284,1016,56300,580
2021-12-10,Santa Barbara,083,443738,46776,46309,1659,47968,559
2021-12-10,Santa Clara,085,1922200,154617,152846,1716,154562,1941
2021-12-10,Santa Cruz,087,273765,21869,21557,1052,22609,225
2021-12-10,Shasta,089,179085,22826,22660,3752,26412,419
2021-12-10,Sierra,091,2930,201,199,21,220,0
2021-12-10,Siskiyou,093,43540,3481,3418,1381,4799,57
2021-12-10,Solano,095,438530,47628,46891,1369,48260,365
2021-12-10,Sonoma,097,501317,43756,43227,598,43825,407
2021-12-10,Stanislaus,099,539301,82017,82133,9399,91532,1264
2021-12-10,Sutter,101,95872,14391,14354,412,14766,187
2021-12-10,Tehama,103,63373,8873,8776,1562,10338,134
2021-12-10,Trinity,105,12862,910,819,228,1047,17
2021-12-10,Tulare,107,460477,71686,70523,16570,87093,1103
2021-12-10,Tuolumne,109,53932,7795,7760,111,7871,91
2021-12-10,Ventura,111,848112,101775,100711,4525,105236,1195
2021-12-10,Yolo,113,214977,20824,20608,1290,21898,267
2021-12-10,Yuba,115,75493,10617,10519,404,10923,92
2021-12-09,Alameda,001,1643700,124656,123572,3023,126595,1496
2021-12-09,Alpine,003,1148,106,109,0,109,0
2021-12-09,Amador,005,37829,5809,5787,74,5861,69
2021-12-09,Butte,007,227075,22021,21819,3961,25780,326
2021-12-09,Calaveras,009,45235,4522,4469,63,4532,89
2021-12-09,Colusa,011,21464,2637,2619,687,3306,21
2021-12-09,Contra Costa,013,1133247,103423,102618,2399,105017,1061
2021-12-09,Del Norte,015,27424,3806,3778,56,3834,42
2021-12-09,El Dorado,017,186661,17036,16796,1795,18591,170
2021-12-09,Fresno,019,978130,147672,145988,13418,159406,2294
2021-12-09,Glenn,021,27897,3611,3585,1054,4639,37
2021-12-09,Humboldt,023,135768,9855,9721,709,10430,118
2021-12-09,Imperial,025,180216,36202,35635,3850,39485,782
2021-12-09,Inyo,027,18085,2607,2576,42,2618,46
2021-12-09,Kern,029,883053,134055,132852,24396,157248,1854
2021-12-09,Kings,031,150075,33916,33530,2072,35602,371
2021-12-09,Lake,033,64148,6989,6932,163,7095,114
2021-12-09,Lassen,035,31185,7093,7049,431,7480,55
2021-12-09,Los Angeles,037,10098052,1485441,1474030,57678,1531708,27031
2021-12-09,Madera,039,155013,24629,24417,2357,26774,311
2021-12-09,Marin,041,260295,18538,18339,554,18893,249
2021-12-09,Mariposa,043,17540,1471,1450,62,1512,6
2021-12-09,Mendocino,045,87422,8257,8130,689,8819,95
2021-12-09,Merced,047,269075,43811,43690,2194,45884,681
2021-12-09,Modoc,049,8938,599,594,204,798,6
2021-12-09,Mono,051,14174,1948,1926,23,1949,4
2021-12-09,Monterey,053,433212,50437,49008,3373,52381,631
2021-12-09,Napa,055,140530,13538,13459,129,13588,107
2021-12-09,Nevada,057,99092,9989,9880,352,10232,106
2021-12-09,Orange,059,3164182,318356,315759,16464,332223,5805
2021-12-09,Placer,061,380077,39383,38959,3946,42905,481
2021-12-09,Plumas,063,18699,1988,1934,47,1981,12
2021-12-09,Riverside,065,2383286,380542,375649,16968,392617,5408
2021-12-09,Sacramento,067,1510023,166971,165530,5111,170641,2386
2021-12-09,San Benito,069,59416,7847,7808,186,7994,79
2021-12-09,San Bernardino,071,2135413,371832,368145,11913,380058,6007
2021-12-09,San Diego,073,3302833,395758,392274,23047,415321,4374
2021-12-09,San Francisco,075,870044,55714,54869,2500,57369,678
2021-12-09,San Joaquin,077,732212,103851,103013,5720,108733,1842
2021-12-09,San Luis Obispo,079,281455,31018,30567,1366,31933,362
2021-12-09,San Mateo,081,765935,56644,55284,1014,56298,580
2021-12-09,Santa Barbara,083,443738,46696,46309,1652,47961,559
2021-12-09,Santa Clara,085,1922200,154403,152846,1705,154551,1941
2021-12-09,Santa Cruz,087,273765,21841,21557,1052,22609,225
2021-12-09,Shasta,089,179085,22810,22660,3751,26411,419
2021-12-09,Sierra,091,2930,201,199,21,220,0
2021-12-09,Siskiyou,093,43540,3477,3418,1380,4798,57
2021-12-09,Solano,095,438530,47591,46891,1367,48258,365
2021-12-09,Sonoma,097,501317,43699,43227,597,43824,407
2021-12-09,Stanislaus,099,539301,81947,82133,9386,91519,1264
2021-12-09,Sutter,101,95872,14376,14354,412,14766,187
2021-12-09,Tehama,103,63373,8866,8776,1560,10336,134
2021-12-09,Trinity,105,12862,910,819,228,1047,17
2021-12-09,Tulare,107,460477,71629,70523,16541,87064,1103
2021-12-09,Tuolumne,109,53932,7784,7760,111,7871,91
2021-12-09,Ventura,111,848112,101630,100711,4513,105224,1195
2021-12-09,Yolo,113,214977,20801,20608,1282,21890,267
2021-12-09,Yuba,115,75493,10609,10519,401,10920,92
2021-12-08,Alameda,001,1643700,124508,123438,3013,126451,1496
2021-12-08,Alpine,003,1148,106,108,0,108,0
2021-12-08,Amador,005,37829,5804,5781,74,5855,69
2021-12-08,Butte,007,227075,22005,21780,3958,25738,326
2021-12-08,Calaveras,009,45235,4513,4455,63,4518,89
2021-12-08,Colusa,011,21464,2634,2619,686,3305,21
2021-12-08,Contra Costa,013,1133247,103293,102506,2398,104904,1058
2021-12-08,Del Norte,015,27424,3805,3767,56,3823,42
2021-12-08,El Dorado,017,186661,17004,16757,1795,18552,170
2021-12-08,Fresno,019,978130,147513,145830,13403,159233,2293
2021-12-08,Glenn,021,27897,3611,3584,1050,4634,37
2021-12-08,Humboldt,023,135768,9833,9704,707,10411,117
2021-12-08,Imperial,025,180216,36122,35537,3820,39357,782
2021-12-08,Inyo,027,18085,2604,2570,42,2612,46
2021-12-08,Kern,029,883053,133932,132709,24348,157057,1846
2021-12-08,Kings,031,150075,33881,33468,2071,35539,371
2021-12-08,Lake,033,64148,6983,6927,162,7089,114
2021-12-08,Lassen,035,31185,7091,7041,429,7470,55
2021-12-08,Los Angeles,037,10098052,1483902,1472410,57567,1529977,27018
2021-12-08,Madera,039,155013,24608,24396,2350,26746,311
2021-12-08,Marin,041,260295,18517,18305,551,18856,249
2021-12-08,Mariposa,043,17540,1469,1447,62,1509,6
2021-12-08,Mendocino,045,87422,8244,8118,688,8806,95
2021-12-08,Merced,047,269075,43779,43631,2186,45817,680
2021-12-08,Modoc,049,8938,599,594,204,798,6
2021-12-08,Mono,051,14174,1942,1924,23,1947,4
2021-12-08,Monterey,053,433212,50372,48957,3358,52315,631
2021-12-08,Napa,055,140530,13524,13421,129,13550,107
2021-12-08,Nevada,057,99092,9973,9862,352,10214,106
2021-12-08,Orange,059,3164182,318009,315421,16426,331847,5795
2021-12-08,Placer,061,380077,39331,38934,3941,42875,478
2021-12-08,Plumas,063,18699,1986,1924,47,1971,12
2021-12-08,Riverside,065,2383286,380031,375099,16945,392044,5404
2021-12-08,Sacramento,067,1510023,166717,165278,5083,170361,2373
2021-12-08,San Benito,069,59416,7838,7793,186,7979,79
2021-12-08,San Bernardino,071,2135413,371358,367516,11888,379404,6006
2021-12-08,San Diego,073,3302833,395104,391676,23015,414691,4369
2021-12-08,San Francisco,075,870044,55627,54792,2492,57284,677
2021-12-08,San Joaquin,077,732212,103750,102877,5710,108587,1841
2021-12-08,San Luis Obispo,079,281455,30970,30519,1361,31880,361
2021-12-08,San Mateo,081,765935,56576,55220,1008,56228,580
2021-12-08,Santa Barbara,083,443738,46641,46250,1649,47899,558
2021-12-08,Santa Clara,085,1922200,154241,152674,1694,154368,1937
2021-12-08,Santa Cruz,087,273765,21794,21505,1050,22555,224
2021-12-08,Shasta,089,179085,22790,22616,3745,26361,419
2021-12-08,Sierra,091,2930,201,199,21,220,0
2021-12-08,Siskiyou,093,43540,3476,3415,1378,4793,57
2021-12-08,Solano,095,438530,47561,46837,1366,48203,365
2021-12-08,Sonoma,097,501317,43636,43179,596,43775,405
2021-12-08,Stanislaus,099,539301,81864,82038,9375,91413,1264
2021-12-08,Sutter,101,95872,14360,14336,410,14746,187
2021-12-08,Tehama,103,63373,8857,8768,1560,10328,133
2021-12-08,Trinity,105,12862,910,818,228,1046,17
2021-12-08,Tulare,107,460477,71566,70472,16516,86988,1102
2021-12-08,Tuolumne,109,53932,7771,7749,111,7860,91
2021-12-08,Ventura,111,848112,101502,100647,4510,105157,1194
2021-12-08,Yolo,113,214977,20775,20575,1276,21851,267
2021-12-08,Yuba,115,75493,10595,10499,398,10897,92
2021-12-07,Alameda,001,1643700,124334,123325,3004,126329,1497
2021-12-07,Alpine,003,1148,106,108,0,108,0
2021-12-07,Amador,005,37829,5801,5778,73,5851,69
2021-12-07,Butte,007,227075,21981,21761,3953,25714,324
2021-12-07,Calaveras,009,45235,4497,4445,63,4508,88
2021-12-07,Colusa,011,21464,2632,2619,686,3305,21
2021-12-07,Contra Costa,013,1133247,103171,102421,2389,104810,1058
2021-12-07,Del Norte,015,27424,3804,3766,56,3822,42
2021-12-07,El Dorado,017,186661,16980,16742,1792,18534,170
2021-12-07,Fresno,019,978130,147366,145715,13387,159102,2289
2021-12-07,Glenn,021,27897,3610,3579,1050,4629,36
2021-12-07,Humboldt,023,135768,9809,9693,702,10395,117
2021-12-07,Imperial,025,180216,36044,35502,3799,39301,778
2021-12-07,Inyo,027,18085,2601,2567,42,2609,46
2021-12-07,Kern,029,883053,133773,132564,24295,156859,1838
2021-12-07,Kings,031,150075,33849,33441,2068,35509,372
2021-12-07,Lake,033,64148,6978,6925,162,7087,113
2021-12-07,Lassen,035,31185,7090,7040,428,7468,55
2021-12-07,Los Angeles,037,10098052,1482120,1470904,57463,1528367,27007
2021-12-07,Madera,039,155013,24585,24367,2343,26710,311
2021-12-07,Marin,041,260295,18483,18284,545,18829,249
2021-12-07,Mariposa,043,17540,1467,1446,62,1508,6
2021-12-07,Mendocino,045,87422,8226,8107,688,8795,95
2021-12-07,Merced,047,269075,43738,43600,2179,45779,675
2021-12-07,Modoc,049,8938,599,594,203,797,6
2021-12-07,Mono,051,14174,1940,1921,23,1944,4
2021-12-07,Monterey,053,433212,50289,48880,3341,52221,631
2021-12-07,Napa,055,140530,13506,13409,129,13538,107
2021-12-07,Nevada,057,99092,9959,9858,351,10209,105
2021-12-07,Orange,059,3164182,317676,315138,16377,331515,5784
2021-12-07,Placer,061,380077,39254,38860,3937,42797,474
2021-12-07,Plumas,063,18699,1982,1915,47,1962,12
2021-12-07,Riverside,065,2383286,379501,374552,16929,391481,5397
2021-12-07,Sacramento,067,1510023,166471,165148,5069,170217,2375
2021-12-07,San Benito,069,59416,7822,7776,186,7962,78
2021-12-07,San Bernardino,071,2135413,370790,366981,11870,378851,6007
2021-12-07,San Diego,073,3302833,394256,391110,22977,414087,4357
2021-12-07,San Francisco,075,870044,55517,54729,2487,57216,676
2021-12-07,San Joaquin,077,732212,103631,102797,5698,108495,1839
2021-12-07,San Luis Obispo,079,281455,30931,30495,1359,31854,361
2021-12-07,San Mateo,081,765935,56484,55163,1002,56165,580
2021-12-07,Santa Barbara,083,443738,46569,46205,1647,47852,556
2021-12-07,Santa Clara,085,1922200,154055,152465,1685,154150,1941
2021-12-07,Santa Cruz,087,273765,21747,21493,1050,22543,224
2021-12-07,Shasta,089,179085,22768,22594,3742,26336,418
2021-12-07,Sierra,091,2930,201,199,21,220,0
2021-12-07,Siskiyou,093,43540,3474,3412,1378,4790,57
2021-12-07,Solano,095,438530,47521,46812,1364,48176,365
2021-12-07,Sonoma,097,501317,43562,43154,595,43749,405
2021-12-07,Stanislaus,099,539301,81787,81980,9363,91343,1258
2021-12-07,Sutter,101,95872,14352,14322,409,14731,186
2021-12-07,Tehama,103,63373,8849,8765,1559,10324,133
2021-12-07,Trinity,105,12862,910,818,228,1046,17
2021-12-07,Tulare,107,460477,71510,70411,16487,86898,1103
2021-12-07,Tuolumne,109,53932,7763,7743,111,7854,91
2021-12-07,Ventura,111,848112,101405,100569,4500,105069,1194
2021-12-07,Yolo,113,214977,20749,20560,1273,21833,263
2021-12-07,Yuba,115,75493,10578,10491,397,10888,91
2021-12-06,Alameda,001,1643700,124168,123227,3001,126228,1496
2021-12-06,Alpine,003,1148,106,108,0,108,0
2021-12-06,Amador,005,37829,5794,5769,72,5841,67
2021-12-06,Butte,007,227075,21964,21732,3950,25682,321
2021-12-06,Calaveras,009,45235,4490,4443,63,4506,88
2021-12-06,Colusa,011,21464,2631,2615,682,3297,21
2021-12-06,Contra Costa,013,1133247,103051,102327,2385,104712,1058
2021-12-06,Del Norte,015,27424,3802,3744,56,3800,42
2021-12-06,El Dorado,017,186661,16955,16726,1790,18516,168
2021-12-06,Fresno,019,978130,147167,145539,13377,158916,2285
2021-12-06,Glenn,021,27897,3607,3577,1049,4626,36
2021-12-06,Humboldt,023,135768,9789,9671,695,10366,117
2021-12-06,Imperial,025,180216,35963,35453,3781,39234,778
2021-12-06,Inyo,027,18085,2595,2562,41,2603,46
2021-12-06,Kern,029,883053,133587,132366,24237,156603,1835
2021-12-06,Kings,031,150075,33816,33399,2063,35462,368
2021-12-06,Lake,033,64148,6974,6922,162,7084,113
2021-12-06,Lassen,035,31185,7085,7032,426,7458,51
2021-12-06,Los Angeles,037,10098052,1480450,1470059,57370,1527429,26993
2021-12-06,Madera,039,155013,24558,24334,2339,26673,307
2021-12-06,Marin,041,260295,18455,18252,543,18795,249
2021-12-06,Mariposa,043,17540,1464,1443,62,1505,6
2021-12-06,Mendocino,045,87422,8213,8079,684,8763,95
2021-12-06,Merced,047,269075,43698,43549,2169,45718,672
2021-12-06,Modoc,049,8938,599,593,203,796,6
2021-12-06,Mono,051,14174,1935,1913,23,1936,4
2021-12-06,Monterey,053,433212,50210,48831,3322,52153,626
2021-12-06,Napa,055,140530,13483,13387,127,13514,107
2021-12-06,Nevada,057,99092,9931,9847,350,10197,105
2021-12-06,Orange,059,3164182,317298,314859,16334,331193,5771
2021-12-06,Placer,061,380077,39196,38785,3932,42717,473
2021-12-06,Plumas,063,18699,1974,1913,47,1960,10
2021-12-06,Riverside,065,2383286,378982,374116,16915,391031,5388
2021-12-06,Sacramento,067,1510023,166194,164926,5048,169974,2367
2021-12-06,San Benito,069,59416,7806,7755,186,7941,78
2021-12-06,San Bernardino,071,2135413,370238,366606,11843,378449,5998
2021-12-06,San Diego,073,3302833,393406,390389,22932,413321,4352
2021-12-06,San Francisco,075,870044,55410,54659,2482,57141,674
2021-12-06,San Joaquin,077,732212,103504,102728,5691,108419,1837
2021-12-06,San Luis Obispo,079,281455,30893,30464,1357,31821,361
2021-12-06,San Mateo,081,765935,56410,55112,999,56111,580
2021-12-06,Santa Barbara,083,443738,46477,46146,1646,47792,556
2021-12-06,Santa Clara,085,1922200,153845,152310,1669,153979,1937
2021-12-06,Santa Cruz,087,273765,21712,21450,1047,22497,224
2021-12-06,Shasta,089,179085,22745,22556,3734,26290,416
2021-12-06,Sierra,091,2930,200,198,21,219,0
2021-12-06,Siskiyou,093,43540,3472,3409,1373,4782,57
2021-12-06,Solano,095,438530,47476,46748,1363,48111,360
2021-12-06,Sonoma,097,501317,43493,43114,587,43701,405
2021-12-06,Stanislaus,099,539301,81693,81889,9329,91218,1241
2021-12-06,Sutter,101,95872,14340,14319,409,14728,186
2021-12-06,Tehama,103,63373,8841,8760,1559,10319,133
2021-12-06,Trinity,105,12862,910,815,227,1042,17
2021-12-06,Tulare,107,460477,71433,70285,16448,86733,1101
2021-12-06,Tuolumne,109,53932,7749,7726,111,7837,91
2021-12-06,Ventura,111,848112,101303,100426,4492,104918,1194
2021-12-06,Yolo,113,214977,20725,20548,1272,21820,263
2021-12-06,Yuba,115,75493,10563,10480,392,10872,91
2021-12-05,Alameda,001,1643700,123984,123104,2993,126097,1496
2021-12-05,Alpine,003,1148,105,108,0,108,0
2021-12-05,Amador,005,37829,5791,5761,72,5833,67
2021-12-05,Butte,007,227075,21930,21720,3944,25664,320
2021-12-05,Calaveras,009,45235,4473,4434,63,4497,88
2021-12-05,Colusa,011,21464,2630,2615,681,3296,21
2021-12-05,Contra Costa,013,1133247,102920,102251,2375,104626,1058
2021-12-05,Del Norte,015,27424,3800,3751,56,3807,42
2021-12-05,El Dorado,017,186661,16918,16717,1784,18501,168
2021-12-05,Fresno,019,978130,146993,145452,13356,158808,2284
2021-12-05,Glenn,021,27897,3605,3577,1048,4625,36
2021-12-05,Humboldt,023,135768,9759,9662,692,10354,117
2021-12-05,Imperial,025,180216,35869,35422,3752,39174,778
2021-12-05,Inyo,027,18085,2588,2559,41,2600,46
2021-12-05,Kern,029,883053,133422,132286,24185,156471,1833
2021-12-05,Kings,031,150075,33752,33360,2063,35423,369
2021-12-05,Lake,033,64148,6969,6919,161,7080,113
2021-12-05,Lassen,035,31185,7083,7031,426,7457,51
2021-12-05,Los Angeles,037,10098052,1478597,1468937,57229,1526166,26991
2021-12-05,Madera,039,155013,24517,24311,2336,26647,307
2021-12-05,Marin,041,260295,18408,18216,535,18751,249
2021-12-05,Mariposa,043,17540,1461,1440,61,1501,6
2021-12-05,Mendocino,045,87422,8194,8069,678,8747,95
2021-12-05,Merced,047,269075,43653,43534,2160,45694,672
2021-12-05,Modoc,049,8938,599,593,203,796,6
2021-12-05,Mono,051,14174,1928,1907,23,1930,4
2021-12-05,Monterey,053,433212,50139,48813,3290,52103,626
2021-12-05,Napa,055,140530,13457,13382,124,13506,107
2021-12-05,Nevada,057,99092,9910,9827,350,10177,105
2021-12-05,Orange,059,3164182,316863,314560,16291,330851,5771
2021-12-05,Placer,061,380077,39138,38738,3923,42661,473
2021-12-05,Plumas,063,18699,1970,1913,46,1959,9
2021-12-05,Riverside,065,2383286,378326,373827,16885,390712,5388
2021-12-05,Sacramento,067,1510023,165887,164721,5030,169751,2367
2021-12-05,San Benito,069,59416,7789,7748,185,7933,78
2021-12-05,San Bernardino,071,2135413,369537,366282,11796,378078,5998
2021-12-05,San Diego,073,3302833,392607,387979,22883,410862,4351
2021-12-05,San Francisco,075,870044,55309,54603,2480,57083,674
2021-12-05,San Joaquin,077,732212,103363,102698,5686,108384,1837
2021-12-05,San Luis Obispo,079,281455,30823,30454,1354,31808,360
2021-12-05,San Mateo,081,765935,56321,55050,989,56039,580
2021-12-05,Santa Barbara,083,443738,46394,46097,1638,47735,555
2021-12-05,Santa Clara,085,1922200,153590,152114,1649,153763,1933
2021-12-05,Santa Cruz,087,273765,21662,21424,1047,22471,224
2021-12-05,Shasta,089,179085,22688,22550,3733,26283,416
2021-12-05,Sierra,091,2930,200,198,21,219,0
2021-12-05,Siskiyou,093,43540,3470,3409,1371,4780,57
2021-12-05,Solano,095,438530,47413,46715,1361,48076,360
2021-12-05,Sonoma,097,501317,43416,43038,582,43620,405
2021-12-05,Stanislaus,099,539301,81559,81847,9319,91166,1241
2021-12-05,Sutter,101,95872,14316,14303,404,14707,186
2021-12-05,Tehama,103,63373,8833,8755,1558,10313,133
2021-12-05,Trinity,105,12862,909,815,227,1042,17
2021-12-05,Tulare,107,460477,71352,70254,16400,86654,1102
2021-12-05,Tuolumne,109,53932,7736,7718,111,7829,91
2021-12-05,Ventura,111,848112,101167,100367,4479,104846,1194
2021-12-05,Yolo,113,214977,20683,20512,1270,21782,263
2021-12-05,Yuba,115,75493,10550,10467,385,10852,91
2021-12-04,Alameda,001,1643700,123871,122508,2989,125497,1494
2021-12-04,Alpine,003,1148,105,108,0,108,0
2021-12-04,Amador,005,37829,5788,5729,72,5801,67
2021-12-04,Butte,007,227075,21911,21638,3940,25578,318
2021-12-04,Calaveras,009,45235,4465,4392,62,4454,88
2021-12-04,Colusa,011,21464,2630,2600,679,3279,21
2021-12-04,Contra Costa,013,1133247,102848,101824,2369,104193,1056
2021-12-04,Del Norte,015,27424,3797,3726,56,3782,42
2021-12-04,El Dorado,017,186661,16909,16621,1783,18404,168
2021-12-04,Fresno,019,978130,146905,144734,13347,158081,2270
2021-12-04,Glenn,021,27897,3605,3559,1048,4607,36
2021-12-04,Humboldt,023,135768,9744,9596,688,10284,117
2021-12-04,Imperial,025,180216,35814,35206,3739,38945,776
2021-12-04,Inyo,027,18085,2583,2538,41,2579,46
2021-12-04,Kern,029,883053,133341,131771,24162,155933,1817
2021-12-04,Kings,031,150075,33728,33183,2062,35245,367
2021-12-04,Lake,033,64148,6960,6903,161,7064,113
2021-12-04,Lassen,035,31185,7082,7014,424,7438,51
2021-12-04,Los Angeles,037,10098052,1477722,1463270,57151,1520421,26952
2021-12-04,Madera,039,155013,24503,24188,2332,26520,307
2021-12-04,Marin,041,260295,18386,18075,534,18609,249
2021-12-04,Mariposa,043,17540,1457,1421,61,1482,6
2021-12-04,Mendocino,045,87422,8189,7981,678,8659,91
2021-12-04,Merced,047,269075,43626,43337,2158,45495,671
2021-12-04,Modoc,049,8938,599,591,203,794,6
2021-12-04,Mono,051,14174,1928,1883,23,1906,4
2021-12-04,Monterey,053,433212,50107,48682,3283,51965,626
2021-12-04,Napa,055,140530,13447,13327,123,13450,106
2021-12-04,Nevada,057,99092,9902,9752,350,10102,105
2021-12-04,Orange,059,3164182,316633,313112,16265,329377,5748
2021-12-04,Placer,061,380077,39098,38460,3917,42377,473
2021-12-04,Plumas,063,18699,1967,1903,46,1949,7
2021-12-04,Riverside,065,2383286,377967,371768,16879,388647,5381
2021-12-04,Sacramento,067,1510023,165745,163900,5022,168922,2365
2021-12-04,San Benito,069,59416,7763,7688,185,7873,78
2021-12-04,San Bernardino,071,2135413,369151,364154,11782,375936,5983
2021-12-04,San Diego,073,3302833,392129,386710,22853,409563,4350
2021-12-04,San Francisco,075,870044,55241,54286,2477,56763,674
2021-12-04,San Joaquin,077,732212,103309,102286,5684,107970,1835
2021-12-04,San Luis Obispo,079,281455,30802,30318,1350,31668,360
2021-12-04,San Mateo,081,765935,56271,54774,986,55760,579
2021-12-04,Santa Barbara,083,443738,46349,45774,1638,47412,555
2021-12-04,Santa Clara,085,1922200,153436,151275,1635,152910,1928
2021-12-04,Santa Cruz,087,273765,21636,21286,1046,22332,224
2021-12-04,Shasta,089,179085,22671,22418,3731,26149,414
2021-12-04,Sierra,091,2930,200,196,21,217,0
2021-12-04,Siskiyou,093,43540,3468,3398,1371,4769,57
2021-12-04,Solano,095,438530,47393,46529,1360,47889,360
2021-12-04,Sonoma,097,501317,43371,42778,579,43357,405
2021-12-04,Stanislaus,099,539301,81487,81462,9312,90774,1231
2021-12-04,Sutter,101,95872,14308,14258,403,14661,186
2021-12-04,Tehama,103,63373,8831,8742,1558,10300,131
2021-12-04,Trinity,105,12862,908,801,227,1028,17
2021-12-04,Tulare,107,460477,71315,70014,16372,86386,1100
2021-12-04,Tuolumne,109,53932,7731,7676,111,7787,91
2021-12-04,Ventura,111,848112,101076,99751,4475,104226,1192
2021-12-04,Yolo,113,214977,20660,20442,1267,21709,261
2021-12-04,Yuba,115,75493,10539,10418,384,10802,91
2021-12-03,Alameda,001,1643700,123778,122508,2979,125487,1494
2021-12-03,Alpine,003,1148,105,108,0,108,0
2021-12-03,Amador,005,37829,5783,5729,71,5800,67
2021-12-03,Butte,007,227075,21898,21638,3935,25573,318
2021-12-03,Calaveras,009,45235,4456,4392,62,4454,88
2021-12-03,Colusa,011,21464,2628,2600,679,3279,21
2021-12-03,Contra Costa,013,1133247,102775,101824,2364,104188,1056
2021-12-03,Del Norte,015,27424,3795,3726,56,3782,42
2021-12-03,El Dorado,017,186661,16880,16621,1781,18402,168
2021-12-03,Fresno,019,978130,146791,144734,13344,158078,2270
2021-12-03,Glenn,021,27897,3604,3559,1047,4606,36
2021-12-03,Humboldt,023,135768,9727,9596,686,10282,117
2021-12-03,Imperial,025,180216,35770,35206,3709,38915,776
2021-12-03,Inyo,027,18085,2576,2538,41,2579,46
2021-12-03,Kern,029,883053,133270,131771,24126,155897,1817
2021-12-03,Kings,031,150075,33700,33183,2062,35245,367
2021-12-03,Lake,033,64148,6960,6903,161,7064,113
2021-12-03,Lassen,035,31185,7080,7014,423,7437,51
2021-12-03,Los Angeles,037,10098052,1476778,1463270,57070,1520340,26952
2021-12-03,Madera,039,155013,24477,24188,2328,26516,307
2021-12-03,Marin,041,260295,18354,18075,530,18605,249
2021-12-03,Mariposa,043,17540,1455,1421,61,1482,6
2021-12-03,Mendocino,045,87422,8182,7981,678,8659,91
2021-12-03,Merced,047,269075,43603,43337,2155,45492,671
2021-12-03,Modoc,049,8938,599,591,203,794,6
2021-12-03,Mono,051,14174,1922,1883,23,1906,4
2021-12-03,Monterey,053,433212,50068,48682,3272,51954,626
2021-12-03,Napa,055,140530,13435,13327,123,13450,106
2021-12-03,Nevada,057,99092,9891,9752,350,10102,105
2021-12-03,Orange,059,3164182,316364,313112,16233,329345,5748
2021-12-03,Placer,061,380077,39061,38460,3910,42370,473
2021-12-03,Plumas,063,18699,1964,1903,46,1949,7
2021-12-03,Riverside,065,2383286,377576,371768,16873,388641,5381
2021-12-03,Sacramento,067,1510023,165565,163900,5008,168908,2365
2021-12-03,San Benito,069,59416,7756,7688,185,7873,78
2021-12-03,San Bernardino,071,2135413,368708,364154,11772,375926,5983
2021-12-03,San Diego,073,3302833,391654,386710,22829,409539,4350
2021-12-03,San Francisco,075,870044,55171,54286,2473,56759,674
2021-12-03,San Joaquin,077,732212,103252,102286,5683,107969,1835
2021-12-03,San Luis Obispo,079,281455,30776,30318,1347,31665,360
2021-12-03,San Mateo,081,765935,56207,54774,983,55757,579
2021-12-03,Santa Barbara,083,443738,46313,45774,1638,47412,555
2021-12-03,Santa Clara,085,1922200,153254,151275,1620,152895,1928
2021-12-03,Santa Cruz,087,273765,21609,21286,1046,22332,224
2021-12-03,Shasta,089,179085,22656,22418,3731,26149,414
2021-12-03,Sierra,091,2930,200,196,21,217,0
2021-12-03,Siskiyou,093,43540,3465,3398,1369,4767,57
2021-12-03,Solano,095,438530,47351,46529,1359,47888,360
2021-12-03,Sonoma,097,501317,43335,42778,577,43355,405
2021-12-03,Stanislaus,099,539301,81430,81462,9303,90765,1231
2021-12-03,Sutter,101,95872,14295,14258,401,14659,186
2021-12-03,Tehama,103,63373,8830,8742,1557,10299,131
2021-12-03,Trinity,105,12862,908,801,227,1028,17
2021-12-03,Tulare,107,460477,71276,70014,16339,86353,1100
2021-12-03,Tuolumne,109,53932,7722,7676,111,7787,91
2021-12-03,Ventura,111,848112,100988,99751,4468,104219,1192
2021-12-03,Yolo,113,214977,20643,20442,1266,21708,261
2021-12-03,Yuba,115,75493,10531,10418,384,10802,91
2021-12-02,Alameda,001,1643700,123623,122508,2971,125479,1494
2021-12-02,Alpine,003,1148,105,108,0,108,0
2021-12-02,Amador,005,37829,5778,5729,70,5799,67
2021-12-02,Butte,007,227075,21873,21638,3932,25570,318
2021-12-02,Calaveras,009,45235,4446,4392,61,4453,88
2021-12-02,Colusa,011,21464,2627,2600,679,3279,21
2021-12-02,Contra Costa,013,1133247,102660,101824,2360,104184,1056
2021-12-02,Del Norte,015,27424,3787,3726,56,3782,42
2021-12-02,El Dorado,017,186661,16859,16621,1779,18400,168
2021-12-02,Fresno,019,978130,146624,144734,13332,158066,2270
2021-12-02,Glenn,021,27897,3604,3559,1044,4603,36
2021-12-02,Humboldt,023,135768,9708,9596,684,10280,117
2021-12-02,Imperial,025,180216,35703,35206,3686,38892,776
2021-12-02,Inyo,027,18085,2571,2538,41,2579,46
2021-12-02,Kern,029,883053,133099,131771,24073,155844,1817
2021-12-02,Kings,031,150075,33645,33183,2060,35243,367
2021-12-02,Lake,033,64148,6956,6903,161,7064,113
2021-12-02,Lassen,035,31185,7076,7014,423,7437,51
2021-12-02,Los Angeles,037,10098052,1475256,1463270,56985,1520255,26952
2021-12-02,Madera,039,155013,24440,24188,2319,26507,307
2021-12-02,Marin,041,260295,18324,18075,526,18601,249
2021-12-02,Mariposa,043,17540,1453,1421,61,1482,6
2021-12-02,Mendocino,045,87422,8166,7981,677,8658,91
2021-12-02,Merced,047,269075,43557,43337,2150,45487,671
2021-12-02,Modoc,049,8938,598,591,203,794,6
2021-12-02,Mono,051,14174,1916,1883,23,1906,4
2021-12-02,Monterey,053,433212,49993,48682,3250,51932,626
2021-12-02,Napa,055,140530,13422,13327,123,13450,106
2021-12-02,Nevada,057,99092,9873,9752,349,10101,105
2021-12-02,Orange,059,3164182,316021,313112,16196,329308,5748
2021-12-02,Placer,061,380077,38996,38460,3905,42365,473
2021-12-02,Plumas,063,18699,1961,1903,46,1949,7
2021-12-02,Riverside,065,2383286,377049,371768,16863,388631,5381
2021-12-02,Sacramento,067,1510023,165337,163900,4998,168898,2365
2021-12-02,San Benito,069,59416,7736,7688,185,7873,78
2021-12-02,San Bernardino,071,2135413,368161,364154,11752,375906,5983
2021-12-02,San Diego,073,3302833,391009,386710,22774,409484,4350
2021-12-02,San Francisco,075,870044,55076,54286,2468,56754,674
2021-12-02,San Joaquin,077,732212,103138,102286,5678,107964,1835
2021-12-02,San Luis Obispo,079,281455,30743,30318,1340,31658,360
2021-12-02,San Mateo,081,765935,56126,54774,975,55749,579
2021-12-02,Santa Barbara,083,443738,46232,45774,1635,47409,555
2021-12-02,Santa Clara,085,1922200,153008,151275,1603,152878,1928
2021-12-02,Santa Cruz,087,273765,21558,21286,1045,22331,224
2021-12-02,Shasta,089,179085,22623,22418,3730,26148,414
2021-12-02,Sierra,091,2930,200,196,21,217,0
2021-12-02,Siskiyou,093,43540,3464,3398,1362,4760,57
2021-12-02,Solano,095,438530,47300,46529,1357,47886,360
2021-12-02,Sonoma,097,501317,43262,42778,577,43355,405
2021-12-02,Stanislaus,099,539301,81338,81462,9295,90757,1231
2021-12-02,Sutter,101,95872,14282,14258,398,14656,186
2021-12-02,Tehama,103,63373,8823,8742,1555,10297,131
2021-12-02,Trinity,105,12862,908,801,227,1028,17
2021-12-02,Tulare,107,460477,71189,70014,16287,86301,1100
2021-12-02,Tuolumne,109,53932,7707,7676,110,7786,91
2021-12-02,Ventura,111,848112,100863,99751,4466,104217,1192
2021-12-02,Yolo,113,214977,20619,20442,1262,21704,261
2021-12-02,Yuba,115,75493,10515,10418,381,10799,91
2021-12-01,Alameda,001,1643700,123473,122298,2961,125259,1492
2021-12-01,Alpine,003,1148,105,108,0,108,0
2021-12-01,Amador,005,37829,5771,5723,70,5793,67
2021-12-01,Butte,007,227075,21854,21600,3927,25527,318
2021-12-01,Calaveras,009,45235,4441,4371,61,4432,88
2021-12-01,Colusa,011,21464,2620,2595,676,3271,20
2021-12-01,Contra Costa,013,1133247,102552,101651,2349,104000,1048
2021-12-01,Del Norte,015,27424,3785,3722,56,3778,42
2021-12-01,El Dorado,017,186661,16838,16575,1777,18352,166
2021-12-01,Fresno,019,978130,146415,144507,13324,157831,2264
2021-12-01,Glenn,021,27897,3597,3556,1043,4599,36
2021-12-01,Humboldt,023,135768,9684,9573,679,10252,117
2021-12-01,Imperial,025,180216,35623,35085,3659,38744,776
2021-12-01,Inyo,027,18085,2567,2533,41,2574,46
2021-12-01,Kern,029,883053,132952,131580,24018,155598,1804
2021-12-01,Kings,031,150075,33596,33112,2059,35171,364
2021-12-01,Lake,033,64148,6948,6896,160,7056,112
2021-12-01,Lassen,035,31185,7070,7008,421,7429,51
2021-12-01,Los Angeles,037,10098052,1473659,1461394,56890,1518284,26928
2021-12-01,Madera,039,155013,24408,24134,2310,26444,307
2021-12-01,Marin,041,260295,18287,18038,520,18558,249
2021-12-01,Mariposa,043,17540,1449,1415,61,1476,6
2021-12-01,Mendocino,045,87422,8152,7966,672,8638,90
2021-12-01,Merced,047,269075,43501,43259,2129,45388,670
2021-12-01,Modoc,049,8938,598,576,203,779,5
2021-12-01,Mono,051,14174,1911,1876,23,1899,4
2021-12-01,Monterey,053,433212,49943,48611,3241,51852,626
2021-12-01,Napa,055,140530,13405,13319,120,13439,107
2021-12-01,Nevada,057,99092,9860,9706,349,10055,105
2021-12-01,Orange,059,3164182,315657,312772,16158,328930,5735
2021-12-01,Placer,061,380077,38940,38373,3899,42272,472
2021-12-01,Plumas,063,18699,1957,1893,46,1939,7
2021-12-01,Riverside,065,2383286,376525,371189,16846,388035,5369
2021-12-01,Sacramento,067,1510023,165124,163616,4979,168595,2360
2021-12-01,San Benito,069,59416,7722,7669,185,7854,78
2021-12-01,San Bernardino,071,2135413,367580,363368,11726,375094,5973
2021-12-01,San Diego,073,3302833,390212,386056,22719,408775,4346
2021-12-01,San Francisco,075,870044,54994,54199,2461,56660,672
2021-12-01,San Joaquin,077,732212,103030,102109,5677,107786,1834
2021-12-01,San Luis Obispo,079,281455,30701,30238,1336,31574,360
2021-12-01,San Mateo,081,765935,56045,54711,972,55683,579
2021-12-01,Santa Barbara,083,443738,46162,45681,1633,47314,554
2021-12-01,Santa Clara,085,1922200,152789,150961,1586,152547,1925
2021-12-01,Santa Cruz,087,273765,21528,21191,1044,22235,224
2021-12-01,Shasta,089,179085,22591,22375,3724,26099,410
2021-12-01,Sierra,091,2930,200,195,21,216,0
2021-12-01,Siskiyou,093,43540,3461,3391,1362,4753,55
2021-12-01,Solano,095,438530,47256,46485,1357,47842,360
2021-12-01,Sonoma,097,501317,43187,42713,576,43289,405
2021-12-01,Stanislaus,099,539301,81245,81330,9283,90613,1231
2021-12-01,Sutter,101,95872,14267,14229,397,14626,186
2021-12-01,Tehama,103,63373,8813,8728,1555,10283,130
2021-12-01,Trinity,105,12862,903,801,227,1028,17
2021-12-01,Tulare,107,460477,71113,69953,16247,86200,1098
2021-12-01,Tuolumne,109,53932,7699,7655,110,7765,91
2021-12-01,Ventura,111,848112,100757,99680,4455,104135,1191
2021-12-01,Yolo,113,214977,20591,20393,1262,21655,260
2021-12-01,Yuba,115,75493,10504,10401,380,10781,89
2021-11-30,Alameda,001,1643700,123302,122196,2952,125148,1489
2021-11-30,Alpine,003,1148,105,108,0,108,0
2021-11-30,Amador,005,37829,5763,5716,70,5786,66
2021-11-30,Butte,007,227075,21825,21565,3918,25483,318
2021-11-30,Calaveras,009,45235,4423,4360,61,4421,88
2021-11-30,Colusa,011,21464,2619,2592,676,3268,21
2021-11-30,Contra Costa,013,1133247,102414,101538,2342,103880,1046
2021-11-30,Del Norte,015,27424,3779,3718,56,3774,42
2021-11-30,El Dorado,017,186661,16810,16558,1771,18329,166
2021-11-30,Fresno,019,978130,146215,144384,13316,157700,2259
2021-11-30,Glenn,021,27897,3592,3555,1042,4597,36
2021-11-30,Humboldt,023,135768,9653,9539,673,10212,116
2021-11-30,Imperial,025,180216,35515,34999,3631,38630,773
2021-11-30,Inyo,027,18085,2558,2530,41,2571,46
2021-11-30,Kern,029,883053,132778,131451,23961,155412,1799
2021-11-30,Kings,031,150075,33544,33074,2055,35129,362
2021-11-30,Lake,033,64148,6943,6892,158,7050,110
2021-11-30,Lassen,035,31185,7066,7003,420,7423,51
2021-11-30,Los Angeles,037,10098052,1471864,1460177,56784,1516961,26913
2021-11-30,Madera,039,155013,24374,24108,2305,26413,307
2021-11-30,Marin,041,260295,18243,18010,518,18528,249
2021-11-30,Mariposa,043,17540,1443,1412,61,1473,6
2021-11-30,Mendocino,045,87422,8123,7960,666,8626,89
2021-11-30,Merced,047,269075,43431,43200,2121,45321,668
2021-11-30,Modoc,049,8938,597,576,203,779,5
2021-11-30,Mono,051,14174,1908,1873,23,1896,4
2021-11-30,Monterey,053,433212,49879,48581,3231,51812,626
2021-11-30,Napa,055,140530,13385,13308,120,13428,105
2021-11-30,Nevada,057,99092,9844,9699,348,10047,105
2021-11-30,Orange,059,3164182,315237,312451,16116,328567,5724
2021-11-30,Placer,061,380077,38837,38324,3891,42215,470
2021-11-30,Plumas,063,18699,1952,1887,45,1932,7
2021-11-30,Riverside,065,2383286,375839,370739,16821,387560,5358
2021-11-30,Sacramento,067,1510023,164843,163420,4957,168377,2353
2021-11-30,San Benito,069,59416,7700,7645,184,7829,78
2021-11-30,San Bernardino,071,2135413,366909,363006,11704,374710,5967
2021-11-30,San Diego,073,3302833,389286,385405,22672,408077,4340
2021-11-30,San Francisco,075,870044,54887,54147,2452,56599,672
2021-11-30,San Joaquin,077,732212,102904,101972,5669,107641,1834
2021-11-30,San Luis Obispo,079,281455,30676,30200,1333,31533,360
2021-11-30,San Mateo,081,765935,55940,54656,962,55618,579
2021-11-30,Santa Barbara,083,443738,46066,45628,1627,47255,553
2021-11-30,Santa Clara,085,1922200,152528,150799,1568,152367,1929
2021-11-30,Santa Cruz,087,273765,21470,21169,1040,22209,224
2021-11-30,Shasta,089,179085,22561,22347,3721,26068,401
2021-11-30,Sierra,091,2930,197,195,21,216,0
2021-11-30,Siskiyou,093,43540,3457,3385,1359,4744,55
2021-11-30,Solano,095,438530,47193,46434,1351,47785,358
2021-11-30,Sonoma,097,501317,43108,42663,574,43237,405
2021-11-30,Stanislaus,099,539301,81145,81276,9256,90532,1227
2021-11-30,Sutter,101,95872,14256,14210,394,14604,186
2021-11-30,Tehama,103,63373,8806,8727,1554,10281,130
2021-11-30,Trinity,105,12862,902,799,227,1026,17
2021-11-30,Tulare,107,460477,71027,69900,16197,86097,1099
2021-11-30,Tuolumne,109,53932,7684,7643,110,7753,91
2021-11-30,Ventura,111,848112,100604,99601,4443,104044,1191
2021-11-30,Yolo,113,214977,20549,20376,1256,21632,260
2021-11-30,Yuba,115,75493,10485,10398,375,10773,89
2021-11-29,Alameda,001,1643700,123145,122136,2943,125079,1489
2021-11-29,Alpine,003,1148,105,108,0,108,0
2021-11-29,Amador,005,37829,5756,5706,70,5776,66
2021-11-29,Butte,007,227075,21800,21544,3912,25456,314
2021-11-29,Calaveras,009,45235,4407,4353,61,4414,88
2021-11-29,Colusa,011,21464,2617,2585,673,3258,20
2021-11-29,Contra Costa,013,1133247,102266,101441,2334,103775,1046
2021-11-29,Del Norte,015,27424,3776,3704,56,3760,42
2021-11-29,El Dorado,017,186661,16792,16534,1766,18300,166
2021-11-29,Fresno,019,978130,146009,144282,13293,157575,2254
2021-11-29,Glenn,021,27897,3589,3555,1041,4596,36
2021-11-29,Humboldt,023,135768,9636,9514,666,10180,115
2021-11-29,Imperial,025,180216,35451,34960,3610,38570,773
2021-11-29,Inyo,027,18085,2553,2529,41,2570,46
2021-11-29,Kern,029,883053,132594,131362,23919,155281,1789
2021-11-29,Kings,031,150075,33492,33059,2051,35110,363
2021-11-29,Lake,033,64148,6931,6889,158,7047,110
2021-11-29,Lassen,035,31185,7063,7003,418,7421,51
2021-11-29,Los Angeles,037,10098052,1470006,1459446,56697,1516143,26889
2021-11-29,Madera,039,155013,24338,24069,2297,26366,307
2021-11-29,Marin,041,260295,18196,17980,513,18493,249
2021-11-29,Mariposa,043,17540,1435,1409,61,1470,6
2021-11-29,Mendocino,045,87422,8106,7954,662,8616,89
2021-11-29,Merced,047,269075,43357,43167,2113,45280,667
2021-11-29,Modoc,049,8938,596,569,203,772,5
2021-11-29,Mono,051,14174,1891,1859,23,1882,4
2021-11-29,Monterey,053,433212,49818,48548,3215,51763,626
2021-11-29,Napa,055,140530,13375,13304,120,13424,104
2021-11-29,Nevada,057,99092,9830,9689,348,10037,105
2021-11-29,Orange,059,3164182,314835,312203,16070,328273,5709
2021-11-29,Placer,061,380077,38772,38261,3886,42147,470
2021-11-29,Plumas,063,18699,1949,1884,45,1929,7
2021-11-29,Riverside,065,2383286,375303,370334,16810,387144,5358
2021-11-29,Sacramento,067,1510023,164594,163282,4924,168206,2342
2021-11-29,San Benito,069,59416,7681,7631,183,7814,77
2021-11-29,San Bernardino,071,2135413,366309,362694,11672,374366,5962
2021-11-29,San Diego,073,3302833,388396,384853,22638,407491,4335
2021-11-29,San Francisco,075,870044,54789,54125,2448,56573,669
2021-11-29,San Joaquin,077,732212,102765,101927,5662,107589,1834
2021-11-29,San Luis Obispo,079,281455,30642,30165,1329,31494,359
2021-11-29,San Mateo,081,765935,55837,54622,958,55580,579
2021-11-29,Santa Barbara,083,443738,45969,45576,1623,47199,549
2021-11-29,Santa Clara,085,1922200,152256,150620,1562,152182,1925
2021-11-29,Santa Cruz,087,273765,21433,21149,1039,22188,224
2021-11-29,Shasta,089,179085,22527,22315,3717,26032,399
2021-11-29,Sierra,091,2930,197,195,21,216,0
2021-11-29,Siskiyou,093,43540,3454,3374,1352,4726,55
2021-11-29,Solano,095,438530,47141,46412,1349,47761,357
2021-11-29,Sonoma,097,501317,43032,42624,571,43195,405
2021-11-29,Stanislaus,099,539301,81065,81227,9238,90465,1223
2021-11-29,Sutter,101,95872,14240,14204,391,14595,186
2021-11-29,Tehama,103,63373,8801,8720,1549,10269,130
2021-11-29,Trinity,105,12862,897,798,227,1025,17
2021-11-29,Tulare,107,460477,70948,69850,16163,86013,1096
2021-11-29,Tuolumne,109,53932,7671,7627,110,7737,90
2021-11-29,Ventura,111,848112,100484,99520,4433,103953,1190
2021-11-29,Yolo,113,214977,20505,20344,1253,21597,257
2021-11-29,Yuba,115,75493,10468,10395,374,10769,89
2021-11-28,Alameda,001,1643700,122925,122082,2937,125019,1491
2021-11-28,Alpine,003,1148,105,108,0,108,0
2021-11-28,Amador,005,37829,5746,5703,70,5773,66
2021-11-28,Butte,007,227075,21761,21530,3910,25440,313
2021-11-28,Calaveras,009,45235,4385,4350,61,4411,88
2021-11-28,Colusa,011,21464,2613,2586,672,3258,19
2021-11-28,Contra Costa,013,1133247,102093,101355,2324,103679,1046
2021-11-28,Del Norte,015,27424,3771,3703,56,3759,42
2021-11-28,El Dorado,017,186661,16751,16527,1765,18292,166
2021-11-28,Fresno,019,978130,145764,144164,13268,157432,2252
2021-11-28,Glenn,021,27897,3586,3547,1039,4586,36
2021-11-28,Humboldt,023,135768,9604,9499,662,10161,115
2021-11-28,Imperial,025,180216,35343,34929,3586,38515,773
2021-11-28,Inyo,027,18085,2546,2531,41,2572,46
2021-11-28,Kern,029,883053,132387,131279,23862,155141,1789
2021-11-28,Kings,031,150075,33418,33057,2044,35101,364
2021-11-28,Lake,033,64148,6921,6885,157,7042,110
2021-11-28,Lassen,035,31185,7055,7002,414,7416,51
2021-11-28,Los Angeles,037,10098052,1467834,1458646,56609,1515255,26878
2021-11-28,Madera,039,155013,24290,24055,2290,26345,307
2021-11-28,Marin,041,260295,18147,17962,509,18471,249
2021-11-28,Mariposa,043,17540,1431,1406,61,1467,6
2021-11-28,Mendocino,045,87422,8076,7943,657,8600,89
2021-11-28,Merced,047,269075,43291,43166,2098,45264,667
2021-11-28,Modoc,049,8938,595,569,203,772,5
2021-11-28,Mono,051,14174,1885,1841,23,1864,4
2021-11-28,Monterey,053,433212,49753,48537,3196,51733,626
2021-11-28,Napa,055,140530,13362,13303,120,13423,104
2021-11-28,Nevada,057,99092,9803,9684,347,10031,105
2021-11-28,Orange,059,3164182,314451,312028,16027,328055,5693
2021-11-28,Placer,061,380077,38691,38240,3867,42107,470
2021-11-28,Plumas,063,18699,1943,1884,44,1928,7
2021-11-28,Riverside,065,2383286,374645,370051,16788,386839,5358
2021-11-28,Sacramento,067,1510023,164238,163170,4901,168071,2335
2021-11-28,San Benito,069,59416,7662,7623,182,7805,77
2021-11-28,San Bernardino,071,2135413,365588,362407,11644,374051,5958
2021-11-28,San Diego,073,3302833,387505,383025,22574,405599,4325
2021-11-28,San Francisco,075,870044,54713,54082,2443,56525,669
2021-11-28,San Joaquin,077,732212,102584,101895,5645,107540,1834
2021-11-28,San Luis Obispo,079,281455,30578,30152,1325,31477,358
2021-11-28,San Mateo,081,765935,55743,54567,954,55521,579
2021-11-28,Santa Barbara,083,443738,45890,45551,1612,47163,549
2021-11-28,Santa Clara,085,1922200,151955,150436,1547,151983,1920
2021-11-28,Santa Cruz,087,273765,21361,21110,1038,22148,224
2021-11-28,Shasta,089,179085,22487,22316,3715,26031,400
2021-11-28,Sierra,091,2930,197,195,21,216,0
2021-11-28,Siskiyou,093,43540,3448,3372,1348,4720,55
2021-11-28,Solano,095,438530,47079,46385,1348,47733,356
2021-11-28,Sonoma,097,501317,42946,42583,568,43151,405
2021-11-28,Stanislaus,099,539301,80947,81181,9218,90399,1223
2021-11-28,Sutter,101,95872,14218,14192,385,14577,186
2021-11-28,Tehama,103,63373,8793,8720,1545,10265,130
2021-11-28,Trinity,105,12862,896,797,227,1024,17
2021-11-28,Tulare,107,460477,70851,69833,16110,85943,1095
2021-11-28,Tuolumne,109,53932,7650,7620,110,7730,90
2021-11-28,Ventura,111,848112,100328,99486,4422,103908,1190
2021-11-28,Yolo,113,214977,20462,20333,1252,21585,257
2021-11-28,Yuba,115,75493,10450,10391,372,10763,89
2021-11-27,Alameda,001,1643700,122828,121618,2934,124552,1477
2021-11-27,Alpine,003,1148,105,106,0,106,0
2021-11-27,Amador,005,37829,5745,5670,70,5740,66
2021-11-27,Butte,007,227075,21738,21384,3905,25289,309
2021-11-27,Calaveras,009,45235,4379,4294,61,4355,85
2021-11-27,Colusa,011,21464,2612,2568,670,3238,19
2021-11-27,Contra Costa,013,1133247,102008,100961,2323,103284,1045
2021-11-27,Del Norte,015,27424,3764,3661,56,3717,42
2021-11-27,El Dorado,017,186661,16716,16399,1764,18163,161
2021-11-27,Fresno,019,978130,145652,143386,13262,156648,2246
2021-11-27,Glenn,021,27897,3582,3532,1038,4570,36
2021-11-27,Humboldt,023,135768,9576,9399,660,10059,115
2021-11-27,Imperial,025,180216,35260,34611,3570,38181,769
2021-11-27,Inyo,027,18085,2543,2506,41,2547,45
2021-11-27,Kern,029,883053,132303,130245,23833,154078,1773
2021-11-27,Kings,031,150075,33395,32891,2041,34932,358
2021-11-27,Lake,033,64148,6918,6836,156,6992,110
2021-11-27,Lassen,035,31185,7053,6959,413,7372,47
2021-11-27,Los Angeles,037,10098052,1466825,1454495,56539,1511034,26817
2021-11-27,Madera,039,155013,24270,23880,2285,26165,296
2021-11-27,Marin,041,260295,18109,17857,504,18361,248
2021-11-27,Mariposa,043,17540,1429,1374,61,1435,6
2021-11-27,Mendocino,045,87422,8057,7871,657,8528,89
2021-11-27,Merced,047,269075,43256,42921,2095,45016,664
2021-11-27,Modoc,049,8938,593,551,203,754,5
2021-11-27,Mono,051,14174,1883,1810,23,1833,4
2021-11-27,Monterey,053,433212,49720,48400,3182,51582,625
2021-11-27,Napa,055,140530,13348,13256,120,13376,104
2021-11-27,Nevada,057,99092,9781,9584,346,9930,103
2021-11-27,Orange,059,3164182,314199,310809,15990,326799,5665
2021-11-27,Placer,061,380077,38630,38001,3861,41862,468
2021-11-27,Plumas,063,18699,1939,1860,44,1904,7
2021-11-27,Riverside,065,2383286,374287,367601,16781,384382,5306
2021-11-27,Sacramento,067,1510023,164081,162328,4898,167226,2335
2021-11-27,San Benito,069,59416,7645,7575,182,7757,77
2021-11-27,San Bernardino,071,2135413,365155,360033,11635,371668,5932
2021-11-27,San Diego,073,3302833,387003,382634,22548,405182,4319
2021-11-27,San Francisco,075,870044,54663,53830,2440,56270,669
2021-11-27,San Joaquin,077,732212,102517,101368,5642,107010,1833
2021-11-27,San Luis Obispo,079,281455,30543,29983,1321,31304,358
2021-11-27,San Mateo,081,765935,55686,54360,951,55311,577
2021-11-27,Santa Barbara,083,443738,45836,45318,1610,46928,548
2021-11-27,Santa Clara,085,1922200,151748,149700,1540,151240,1922
2021-11-27,Santa Cruz,087,273765,21321,20929,1035,21964,222
2021-11-27,Shasta,089,179085,22464,22151,3714,25865,396
2021-11-27,Sierra,091,2930,196,194,21,215,0
2021-11-27,Siskiyou,093,43540,3445,3336,1346,4682,54
2021-11-27,Solano,095,438530,47043,46163,1345,47508,356
2021-11-27,Sonoma,097,501317,42883,42368,568,42936,405
2021-11-27,Stanislaus,099,539301,80879,80782,9200,89982,1220
2021-11-27,Sutter,101,95872,14210,14127,384,14511,181
2021-11-27,Tehama,103,63373,8791,8675,1544,10219,129
2021-11-27,Trinity,105,12862,896,789,227,1016,17
2021-11-27,Tulare,107,460477,70799,69377,16094,85471,1082
2021-11-27,Tuolumne,109,53932,7637,7574,110,7684,90
2021-11-27,Ventura,111,848112,100255,99163,4415,103578,1188
2021-11-27,Yolo,113,214977,20441,20237,1243,21480,257
2021-11-27,Yuba,115,75493,10439,10335,372,10707,88
2021-11-26,Alameda,001,1643700,122716,121618,2932,124550,1477
2021-11-26,Alpine,003,1148,105,106,0,106,0
2021-11-26,Amador,005,37829,5741,5670,70,5740,66
2021-11-26,Butte,007,227075,21715,21384,3900,25284,309
2021-11-26,Calaveras,009,45235,4370,4294,61,4355,85
2021-11-26,Colusa,011,21464,2610,2568,669,3237,19
2021-11-26,Contra Costa,013,1133247,101921,100961,2319,103280,1045
2021-11-26,Del Norte,015,27424,3761,3661,56,3717,42
2021-11-26,El Dorado,017,186661,16699,16399,1761,18160,161
2021-11-26,Fresno,019,978130,145519,143386,13252,156638,2246
2021-11-26,Glenn,021,27897,3580,3532,1038,4570,36
2021-11-26,Humboldt,023,135768,9557,9399,656,10055,115
2021-11-26,Imperial,025,180216,35203,34611,3557,38168,769
2021-11-26,Inyo,027,18085,2543,2506,41,2547,45
2021-11-26,Kern,029,883053,132220,130245,23789,154034,1773
2021-11-26,Kings,031,150075,33371,32891,2039,34930,358
2021-11-26,Lake,033,64148,6916,6836,156,6992,110
2021-11-26,Lassen,035,31185,7047,6959,413,7372,47
2021-11-26,Los Angeles,037,10098052,1465973,1454495,56476,1510971,26817
2021-11-26,Madera,039,155013,24243,23880,2283,26163,296
2021-11-26,Marin,041,260295,18080,17857,504,18361,248
2021-11-26,Mariposa,043,17540,1423,1374,60,1434,6
2021-11-26,Mendocino,045,87422,8047,7871,657,8528,89
2021-11-26,Merced,047,269075,43226,42921,2090,45011,664
2021-11-26,Modoc,049,8938,591,551,203,754,5
2021-11-26,Mono,051,14174,1872,1810,23,1833,4
2021-11-26,Monterey,053,433212,49676,48400,3175,51575,625
2021-11-26,Napa,055,140530,13332,13256,120,13376,104
2021-11-26,Nevada,057,99092,9770,9584,346,9930,103
2021-11-26,Orange,059,3164182,313929,310809,15958,326767,5665
2021-11-26,Placer,061,380077,38585,38001,3853,41854,468
2021-11-26,Plumas,063,18699,1934,1860,44,1904,7
2021-11-26,Riverside,065,2383286,373886,367601,16774,384375,5306
2021-11-26,Sacramento,067,1510023,163969,162328,4893,167221,2335
2021-11-26,San Benito,069,59416,7637,7575,182,7757,77
2021-11-26,San Bernardino,071,2135413,364726,360033,11628,371661,5932
2021-11-26,San Diego,073,3302833,386446,382634,22536,405170,4319
2021-11-26,San Francisco,075,870044,54616,53830,2438,56268,669
2021-11-26,San Joaquin,077,732212,102460,101368,5641,107009,1833
2021-11-26,San Luis Obispo,079,281455,30501,29983,1318,31301,358
2021-11-26,San Mateo,081,765935,55623,54360,950,55310,577
2021-11-26,Santa Barbara,083,443738,45789,45318,1609,46927,548
2021-11-26,Santa Clara,085,1922200,151580,149700,1532,151232,1922
2021-11-26,Santa Cruz,087,273765,21281,20929,1035,21964,222
2021-11-26,Shasta,089,179085,22445,22151,3712,25863,396
2021-11-26,Sierra,091,2930,196,194,21,215,0
2021-11-26,Siskiyou,093,43540,3442,3336,1345,4681,54
2021-11-26,Solano,095,438530,47002,46163,1344,47507,356
2021-11-26,Sonoma,097,501317,42832,42368,566,42934,405
2021-11-26,Stanislaus,099,539301,80806,80782,9189,89971,1220
2021-11-26,Sutter,101,95872,14197,14127,383,14510,181
2021-11-26,Tehama,103,63373,8789,8675,1543,10218,129
2021-11-26,Trinity,105,12862,895,789,227,1016,17
2021-11-26,Tulare,107,460477,70753,69377,16062,85439,1082
2021-11-26,Tuolumne,109,53932,7627,7574,110,7684,90
2021-11-26,Ventura,111,848112,100175,99163,4410,103573,1188
2021-11-26,Yolo,113,214977,20422,20237,1235,21472,257
2021-11-26,Yuba,115,75493,10433,10335,372,10707,88
2021-11-25,Alameda,001,1643700,122608,121618,2927,124545,1477
2021-11-25,Alpine,003,1148,105,106,0,106,0
2021-11-25,Amador,005,37829,5733,5670,70,5740,66
2021-11-25,Butte,007,227075,21697,21384,3898,25282,309
2021-11-25,Calaveras,009,45235,4365,4294,61,4355,85
2021-11-25,Colusa,011,21464,2607,2568,667,3235,19
2021-11-25,Contra Costa,013,1133247,101817,100961,2315,103276,1045
2021-11-25,Del Norte,015,27424,3756,3661,56,3717,42
2021-11-25,El Dorado,017,186661,16680,16399,1760,18159,161
2021-11-25,Fresno,019,978130,145384,143386,13243,156629,2246
2021-11-25,Glenn,021,27897,3579,3532,1037,4569,36
2021-11-25,Humboldt,023,135768,9538,9399,653,10052,115
2021-11-25,Imperial,025,180216,35158,34611,3545,38156,769
2021-11-25,Inyo,027,18085,2541,2506,41,2547,45
2021-11-25,Kern,029,883053,132122,130245,23743,153988,1773
2021-11-25,Kings,031,150075,33343,32891,2038,34929,358
2021-11-25,Lake,033,64148,6909,6836,156,6992,110
2021-11-25,Lassen,035,31185,7045,6959,412,7371,47
2021-11-25,Los Angeles,037,10098052,1464990,1454495,56418,1510913,26817
2021-11-25,Madera,039,155013,24208,23880,2282,26162,296
2021-11-25,Marin,041,260295,18053,17857,499,18356,248
2021-11-25,Mariposa,043,17540,1420,1374,60,1434,6
2021-11-25,Mendocino,045,87422,8029,7871,657,8528,89
2021-11-25,Merced,047,269075,43187,42921,2084,45005,664
2021-11-25,Modoc,049,8938,590,551,203,754,5
2021-11-25,Mono,051,14174,1861,1810,23,1833,4
2021-11-25,Monterey,053,433212,49632,48400,3166,51566,625
2021-11-25,Napa,055,140530,13324,13256,120,13376,104
2021-11-25,Nevada,057,99092,9751,9584,343,9927,103
2021-11-25,Orange,059,3164182,313667,310809,15926,326735,5665
2021-11-25,Placer,061,380077,38539,38001,3847,41848,468
2021-11-25,Plumas,063,18699,1932,1860,44,1904,7
2021-11-25,Riverside,065,2383286,373472,367601,16767,384368,5306
2021-11-25,Sacramento,067,1510023,163790,162328,4887,167215,2335
2021-11-25,San Benito,069,59416,7630,7575,182,7757,77
2021-11-25,San Bernardino,071,2135413,364333,360033,11611,371644,5932
2021-11-25,San Diego,073,3302833,385999,382634,22517,405151,4319
2021-11-25,San Francisco,075,870044,54566,53830,2435,56265,669
2021-11-25,San Joaquin,077,732212,102376,101368,5637,107005,1833
2021-11-25,San Luis Obispo,079,281455,30471,29983,1316,31299,358
2021-11-25,San Mateo,081,765935,55574,54360,948,55308,577
2021-11-25,Santa Barbara,083,443738,45750,45318,1607,46925,548
2021-11-25,Santa Clara,085,1922200,151423,149700,1527,151227,1922
2021-11-25,Santa Cruz,087,273765,21248,20929,1035,21964,222
2021-11-25,Shasta,089,179085,22419,22151,3712,25863,396
2021-11-25,Sierra,091,2930,196,194,21,215,0
2021-11-25,Siskiyou,093,43540,3439,3336,1345,4681,54
2021-11-25,Solano,095,438530,46965,46163,1343,47506,356
2021-11-25,Sonoma,097,501317,42775,42368,562,42930,405
2021-11-25,Stanislaus,099,539301,80742,80782,9175,89957,1220
2021-11-25,Sutter,101,95872,14181,14127,382,14509,181
2021-11-25,Tehama,103,63373,8781,8675,1543,10218,129
2021-11-25,Trinity,105,12862,895,789,227,1016,17
2021-11-25,Tulare,107,460477,70686,69377,16035,85412,1082
2021-11-25,Tuolumne,109,53932,7615,7574,110,7684,90
2021-11-25,Ventura,111,848112,100108,99163,4407,103570,1188
2021-11-25,Yolo,113,214977,20392,20237,1230,21467,257
2021-11-25,Yuba,115,75493,10424,10335,371,10706,88
2021-11-24,Alameda,001,1643700,122544,121618,2923,124541,1477
2021-11-24,Alpine,003,1148,105,106,0,106,0
2021-11-24,Amador,005,37829,5723,5670,70,5740,66
2021-11-24,Butte,007,227075,21681,21384,3897,25281,309
2021-11-24,Calaveras,009,45235,4358,4294,61,4355,85
2021-11-24,Colusa,011,21464,2607,2568,666,3234,19
2021-11-24,Contra Costa,013,1133247,101780,100961,2312,103273,1045
2021-11-24,Del Norte,015,27424,3753,3661,56,3717,42
2021-11-24,El Dorado,017,186661,16668,16399,1759,18158,161
2021-11-24,Fresno,019,978130,145330,143386,13242,156628,2246
2021-11-24,Glenn,021,27897,3574,3532,1036,4568,36
2021-11-24,Humboldt,023,135768,9523,9399,653,10052,115
2021-11-24,Imperial,025,180216,35130,34611,3539,38150,769
2021-11-24,Inyo,027,18085,2538,2506,41,2547,45
2021-11-24,Kern,029,883053,132060,130245,23731,153976,1773
2021-11-24,Kings,031,150075,33329,32891,2037,34928,358
2021-11-24,Lake,033,64148,6905,6836,156,6992,110
2021-11-24,Lassen,035,31185,7045,6959,412,7371,47
2021-11-24,Los Angeles,037,10098052,1464499,1454495,56374,1510869,26817
2021-11-24,Madera,039,155013,24185,23880,2276,26156,296
2021-11-24,Marin,041,260295,18041,17857,497,18354,248
2021-11-24,Mariposa,043,17540,1420,1374,60,1434,6
2021-11-24,Mendocino,045,87422,8017,7871,657,8528,89
2021-11-24,Merced,047,269075,43155,42921,2081,45002,664
2021-11-24,Modoc,049,8938,590,551,203,754,5
2021-11-24,Mono,051,14174,1858,1810,23,1833,4
2021-11-24,Monterey,053,433212,49619,48400,3164,51564,625
2021-11-24,Napa,055,140530,13320,13256,120,13376,104
2021-11-24,Nevada,057,99092,9736,9584,343,9927,103
2021-11-24,Orange,059,3164182,313511,310809,15911,326720,5665
2021-11-24,Placer,061,380077,38506,38001,3845,41846,468
2021-11-24,Plumas,063,18699,1930,1860,44,1904,7
2021-11-24,Riverside,065,2383286,373292,367601,16761,384362,5306
2021-11-24,Sacramento,067,1510023,163717,162328,4887,167215,2335
2021-11-24,San Benito,069,59416,7628,7575,182,7757,77
2021-11-24,San Bernardino,071,2135413,364123,360033,11600,371633,5932
2021-11-24,San Diego,073,3302833,385742,382634,22504,405138,4319
2021-11-24,San Francisco,075,870044,54535,53830,2433,56263,669
2021-11-24,San Joaquin,077,732212,102335,101368,5634,107002,1833
2021-11-24,San Luis Obispo,079,281455,30452,29983,1316,31299,358
2021-11-24,San Mateo,081,765935,55544,54360,947,55307,577
2021-11-24,Santa Barbara,083,443738,45723,45318,1607,46925,548
2021-11-24,Santa Clara,085,1922200,151327,149700,1526,151226,1922
2021-11-24,Santa Cruz,087,273765,21225,20929,1034,21963,222
2021-11-24,Shasta,089,179085,22408,22151,3709,25860,396
2021-11-24,Sierra,091,2930,196,194,21,215,0
2021-11-24,Siskiyou,093,43540,3436,3336,1345,4681,54
2021-11-24,Solano,095,438530,46937,46163,1341,47504,356
2021-11-24,Sonoma,097,501317,42743,42368,560,42928,405
2021-11-24,Stanislaus,099,539301,80705,80782,9170,89952,1220
2021-11-24,Sutter,101,95872,14168,14127,380,14507,181
2021-11-24,Tehama,103,63373,8778,8675,1542,10217,129
2021-11-24,Trinity,105,12862,895,789,227,1016,17
2021-11-24,Tulare,107,460477,70662,69377,16016,85393,1082
2021-11-24,Tuolumne,109,53932,7611,7574,110,7684,90
2021-11-24,Ventura,111,848112,100073,99163,4403,103566,1188
2021-11-24,Yolo,113,214977,20384,20237,1229,21466,257
2021-11-24,Yuba,115,75493,10420,10335,370,10705,88
2021-11-23,Alameda,001,1643700,122425,121618,2916,124534,1477
2021-11-23,Alpine,003,1148,105,106,0,106,0
2021-11-23,Amador,005,37829,5716,5670,70,5740,66
2021-11-23,Butte,007,227075,21652,21384,3893,25277,309
2021-11-23,Calaveras,009,45235,4352,4294,60,4354,85
2021-11-23,Colusa,011,21464,2603,2568,664,3232,19
2021-11-23,Contra Costa,013,1133247,101673,100961,2310,103271,1045
2021-11-23,Del Norte,015,27424,3750,3661,56,3717,42
2021-11-23,El Dorado,017,186661,16636,16399,1756,18155,161
2021-11-23,Fresno,019,978130,145193,143386,13233,156619,2246
2021-11-23,Glenn,021,27897,3569,3532,1036,4568,36
2021-11-23,Humboldt,023,135768,9501,9399,650,10049,115
2021-11-23,Imperial,025,180216,35061,34611,3520,38131,769
2021-11-23,Inyo,027,18085,2534,2506,41,2547,45
2021-11-23,Kern,029,883053,131952,130245,23682,153927,1773
2021-11-23,Kings,031,150075,33288,32891,2036,34927,358
2021-11-23,Lake,033,64148,6900,6836,156,6992,110
2021-11-23,Lassen,035,31185,7041,6959,409,7368,47
2021-11-23,Los Angeles,037,10098052,1463477,1454495,56306,1510801,26817
2021-11-23,Madera,039,155013,24159,23880,2274,26154,296
2021-11-23,Marin,041,260295,18010,17857,493,18350,248
2021-11-23,Mariposa,043,17540,1417,1374,60,1434,6
2021-11-23,Mendocino,045,87422,7996,7871,654,8525,89
2021-11-23,Merced,047,269075,43117,42921,2080,45001,664
2021-11-23,Modoc,049,8938,588,551,203,754,5
2021-11-23,Mono,051,14174,1844,1810,23,1833,4
2021-11-23,Monterey,053,433212,49583,48400,3158,51558,625
2021-11-23,Napa,055,140530,13311,13256,120,13376,104
2021-11-23,Nevada,057,99092,9707,9584,342,9926,103
2021-11-23,Orange,059,3164182,313261,310809,15875,326684,5665
2021-11-23,Placer,061,380077,38447,38001,3828,41829,468
2021-11-23,Plumas,063,18699,1926,1860,44,1904,7
2021-11-23,Riverside,065,2383286,372909,367601,16748,384349,5306
2021-11-23,Sacramento,067,1510023,163530,162328,4876,167204,2335
2021-11-23,San Benito,069,59416,7619,7575,180,7755,77
2021-11-23,San Bernardino,071,2135413,363709,360033,11585,371618,5932
2021-11-23,San Diego,073,3302833,385251,382634,22481,405115,4319
2021-11-23,San Francisco,075,870044,54476,53830,2430,56260,669
2021-11-23,San Joaquin,077,732212,102226,101368,5623,106991,1833
2021-11-23,San Luis Obispo,079,281455,30417,29983,1313,31296,358
2021-11-23,San Mateo,081,765935,55495,54360,946,55306,577
2021-11-23,Santa Barbara,083,443738,45670,45318,1607,46925,548
2021-11-23,Santa Clara,085,1922200,151116,149700,1514,151214,1922
2021-11-23,Santa Cruz,087,273765,21187,20929,1034,21963,222
2021-11-23,Shasta,089,179085,22372,22151,3707,25858,396
2021-11-23,Sierra,091,2930,196,194,21,215,0
2021-11-23,Siskiyou,093,43540,3431,3336,1344,4680,54
2021-11-23,Solano,095,438530,46883,46163,1337,47500,356
2021-11-23,Sonoma,097,501317,42692,42368,557,42925,405
2021-11-23,Stanislaus,099,539301,80636,80782,9157,89939,1220
2021-11-23,Sutter,101,95872,14152,14127,379,14506,181
2021-11-23,Tehama,103,63373,8765,8675,1541,10216,129
2021-11-23,Trinity,105,12862,894,789,227,1016,17
2021-11-23,Tulare,107,460477,70615,69377,15986,85363,1082
2021-11-23,Tuolumne,109,53932,7599,7574,110,7684,90
2021-11-23,Ventura,111,848112,99990,99163,4397,103560,1188
2021-11-23,Yolo,113,214977,20363,20237,1221,21458,257
2021-11-23,Yuba,115,75493,10408,10335,370,10705,88
2021-11-22,Alameda,001,1643700,122313,121566,2913,124479,1475
2021-11-22,Alpine,003,1148,105,106,0,106,0
2021-11-22,Amador,005,37829,5703,5670,70,5740,66
2021-11-22,Butte,007,227075,21613,21363,3887,25250,305
2021-11-22,Calaveras,009,45235,4340,4294,60,4354,84
2021-11-22,Colusa,011,21464,2600,2565,664,3229,19
2021-11-22,Contra Costa,013,1133247,101585,100877,2305,103182,1045
2021-11-22,Del Norte,015,27424,3747,3659,56,3715,42
2021-11-22,El Dorado,017,186661,16613,16378,1753,18131,161
2021-11-22,Fresno,019,978130,145059,143290,13226,156516,2243
2021-11-22,Glenn,021,27897,3564,3530,1035,4565,36
2021-11-22,Humboldt,023,135768,9475,9389,645,10034,115
2021-11-22,Imperial,025,180216,35000,34562,3506,38068,766
2021-11-22,Inyo,027,18085,2528,2501,41,2542,44
2021-11-22,Kern,029,883053,131791,130091,23631,153722,1762
2021-11-22,Kings,031,150075,33252,32867,2031,34898,358
2021-11-22,Lake,033,64148,6895,6837,156,6993,110
2021-11-22,Lassen,035,31185,7039,6954,408,7362,47
2021-11-22,Los Angeles,037,10098052,1462406,1453945,56224,1510169,26800
2021-11-22,Madera,039,155013,24125,23872,2266,26138,296
2021-11-22,Marin,041,260295,17979,17842,491,18333,248
2021-11-22,Mariposa,043,17540,1413,1372,60,1432,6
2021-11-22,Mendocino,045,87422,7980,7859,653,8512,89
2021-11-22,Merced,047,269075,43066,42898,2069,44967,660
2021-11-22,Modoc,049,8938,587,551,203,754,5
2021-11-22,Mono,051,14174,1837,1809,23,1832,4
2021-11-22,Monterey,053,433212,49556,48374,3154,51528,611
2021-11-22,Napa,055,140530,13303,13255,119,13374,104
2021-11-22,Nevada,057,99092,9690,9575,340,9915,96
2021-11-22,Orange,059,3164182,313021,310654,15849,326503,5663
2021-11-22,Placer,061,380077,38402,37956,3820,41776,465
2021-11-22,Plumas,063,18699,1923,1858,44,1902,7
2021-11-22,Riverside,065,2383286,372472,367301,16739,384040,5283
2021-11-22,Sacramento,067,1510023,163338,162222,4867,167089,2328
2021-11-22,San Benito,069,59416,7599,7567,180,7747,77
2021-11-22,San Bernardino,071,2135413,363297,359851,11575,371426,5916
2021-11-22,San Diego,073,3302833,384755,382132,22457,404589,4317
2021-11-22,San Francisco,075,870044,54384,53778,2424,56202,669
2021-11-22,San Joaquin,077,732212,102101,101299,5618,106917,1833
2021-11-22,San Luis Obispo,079,281455,30391,29963,1310,31273,358
2021-11-22,San Mateo,081,765935,55438,54330,944,55274,577
2021-11-22,Santa Barbara,083,443738,45594,45279,1607,46886,546
2021-11-22,Santa Clara,085,1922200,150931,149541,1504,151045,1919
2021-11-22,Santa Cruz,087,273765,21146,20891,1034,21925,222
2021-11-22,Shasta,089,179085,22358,22116,3702,25818,393
2021-11-22,Sierra,091,2930,196,193,21,214,0
2021-11-22,Siskiyou,093,43540,3426,3336,1342,4678,54
2021-11-22,Solano,095,438530,46834,46153,1335,47488,356
2021-11-22,Sonoma,097,501317,42631,42344,556,42900,404
2021-11-22,Stanislaus,099,539301,80548,80718,9147,89865,1209
2021-11-22,Sutter,101,95872,14136,14125,377,14502,181
2021-11-22,Tehama,103,63373,8758,8669,1536,10205,127
2021-11-22,Trinity,105,12862,893,785,227,1012,17
2021-11-22,Tulare,107,460477,70553,69314,15949,85263,1075
2021-11-22,Tuolumne,109,53932,7584,7567,110,7677,90
2021-11-22,Ventura,111,848112,99924,99114,4394,103508,1186
2021-11-22,Yolo,113,214977,20340,20227,1219,21446,257
2021-11-22,Yuba,115,75493,10399,10332,369,10701,88
2021-11-21,Alameda,001,1643700,122182,121443,2909,124352,1475
2021-11-21,Alpine,003,1148,103,106,0,106,0
2021-11-21,Amador,005,37829,5698,5662,69,5731,66
2021-11-21,Butte,007,227075,21571,21342,3882,25224,306
2021-11-21,Calaveras,009,45235,4331,4287,60,4347,84
2021-11-21,Colusa,011,21464,2596,2562,663,3225,19
2021-11-21,Contra Costa,013,1133247,101483,100807,2299,103106,1045
2021-11-21,Del Norte,015,27424,3743,3659,56,3715,42
2021-11-21,El Dorado,017,186661,16586,16370,1747,18117,161
2021-11-21,Fresno,019,978130,144887,143203,13206,156409,2242
2021-11-21,Glenn,021,27897,3560,3529,1035,4564,36
2021-11-21,Humboldt,023,135768,9452,9378,644,10022,115
2021-11-21,Imperial,025,180216,34911,34527,3496,38023,766
2021-11-21,Inyo,027,18085,2521,2501,41,2542,44
2021-11-21,Kern,029,883053,131627,130020,23585,153605,1762
2021-11-21,Kings,031,150075,33214,32843,2027,34870,356
2021-11-21,Lake,033,64148,6888,6834,156,6990,110
2021-11-21,Lassen,035,31185,7030,6953,408,7361,47
2021-11-21,Los Angeles,037,10098052,1461337,1453181,56167,1509348,26793
2021-11-21,Madera,039,155013,24099,23856,2261,26117,296
2021-11-21,Marin,041,260295,17950,17829,488,18317,248
2021-11-21,Mariposa,043,17540,1412,1371,59,1430,6
2021-11-21,Mendocino,045,87422,7974,7846,650,8496,89
2021-11-21,Merced,047,269075,43011,42881,2065,44946,660
2021-11-21,Modoc,049,8938,583,551,203,754,5
2021-11-21,Mono,051,14174,1827,1799,22,1821,4
2021-11-21,Monterey,053,433212,49510,48358,3145,51503,611
2021-11-21,Napa,055,140530,13290,13250,119,13369,104
2021-11-21,Nevada,057,99092,9664,9556,339,9895,96
2021-11-21,Orange,059,3164182,312765,310477,15816,326293,5663
2021-11-21,Placer,061,380077,38320,37929,3819,41748,465
2021-11-21,Plumas,063,18699,1918,1858,44,1902,7
2021-11-21,Riverside,065,2383286,371980,367093,16731,383824,5283
2021-11-21,Sacramento,067,1510023,163122,162087,4857,166944,2327
2021-11-21,San Benito,069,59416,7585,7563,179,7742,77
2021-11-21,San Bernardino,071,2135413,362811,359621,11540,371161,5912
2021-11-21,San Diego,073,3302833,384217,380747,22432,403179,4317
2021-11-21,San Francisco,075,870044,54315,53741,2419,56160,669
2021-11-21,San Joaquin,077,732212,101996,101264,5605,106869,1833
2021-11-21,San Luis Obispo,079,281455,30353,29948,1310,31258,358
2021-11-21,San Mateo,081,765935,55386,54290,942,55232,577
2021-11-21,Santa Barbara,083,443738,45533,45237,1604,46841,546
2021-11-21,Santa Clara,085,1922200,150726,149387,1484,150871,1918
2021-11-21,Santa Cruz,087,273765,21102,20866,1032,21898,222
2021-11-21,Shasta,089,179085,22327,22112,3700,25812,393
2021-11-21,Sierra,091,2930,196,193,21,214,0
2021-11-21,Siskiyou,093,43540,3421,3333,1341,4674,54
2021-11-21,Solano,095,438530,46778,46122,1328,47450,356
2021-11-21,Sonoma,097,501317,42571,42298,555,42853,404
2021-11-21,Stanislaus,099,539301,80453,80687,9133,89820,1209
2021-11-21,Sutter,101,95872,14122,14111,377,14488,181
2021-11-21,Tehama,103,63373,8752,8669,1535,10204,127
2021-11-21,Trinity,105,12862,891,784,225,1009,17
2021-11-21,Tulare,107,460477,70469,69285,15910,85195,1075
2021-11-21,Tuolumne,109,53932,7576,7560,109,7669,90
2021-11-21,Ventura,111,848112,99833,99081,4390,103471,1186
2021-11-21,Yolo,113,214977,20312,20209,1216,21425,257
2021-11-21,Yuba,115,75493,10390,10326,369,10695,88
2021-11-20,Alameda,001,1643700,122089,121059,2903,123962,1473
2021-11-20,Alpine,003,1148,103,105,0,105,0
2021-11-20,Amador,005,37829,5692,5652,68,5720,66
2021-11-20,Butte,007,227075,21556,21265,3878,25143,300
2021-11-20,Calaveras,009,45235,4322,4268,60,4328,84
2021-11-20,Colusa,011,21464,2595,2549,662,3211,19
2021-11-20,Contra Costa,013,1133247,101406,100491,2295,102786,1043
2021-11-20,Del Norte,015,27424,3740,3637,56,3693,42
2021-11-20,El Dorado,017,186661,16564,16308,1745,18053,161
2021-11-20,Fresno,019,978130,144817,142579,13197,155776,2233
2021-11-20,Glenn,021,27897,3559,3526,1034,4560,35
2021-11-20,Humboldt,023,135768,9439,9302,642,9944,115
2021-11-20,Imperial,025,180216,34859,34312,3490,37802,766
2021-11-20,Inyo,027,18085,2520,2467,41,2508,44
2021-11-20,Kern,029,883053,131527,129488,23548,153036,1750
2021-11-20,Kings,031,150075,33204,32720,2027,34747,354
2021-11-20,Lake,033,64148,6885,6808,156,6964,110
2021-11-20,Lassen,035,31185,7029,6931,408,7339,47
2021-11-20,Los Angeles,037,10098052,1460718,1448963,56119,1505082,26741
2021-11-20,Madera,039,155013,24087,23720,2257,25977,296
2021-11-20,Marin,041,260295,17935,17774,488,18262,248
2021-11-20,Mariposa,043,17540,1411,1354,59,1413,6
2021-11-20,Mendocino,045,87422,7966,7773,650,8423,89
2021-11-20,Merced,047,269075,42985,42692,2065,44757,656
2021-11-20,Modoc,049,8938,582,550,203,753,5
2021-11-20,Mono,051,14174,1821,1767,22,1789,4
2021-11-20,Monterey,053,433212,49497,48260,3137,51397,609
2021-11-20,Napa,055,140530,13287,13184,119,13303,103
2021-11-20,Nevada,057,99092,9648,9480,339,9819,92
2021-11-20,Orange,059,3164182,312566,309672,15799,325471,5658
2021-11-20,Placer,061,380077,38280,37800,3814,41614,462
2021-11-20,Plumas,063,18699,1914,1841,44,1885,7
2021-11-20,Riverside,065,2383286,371707,365809,16719,382528,5265
2021-11-20,Sacramento,067,1510023,163017,161533,4853,166386,2316
2021-11-20,San Benito,069,59416,7581,7533,179,7712,77
2021-11-20,San Bernardino,071,2135413,362540,358322,11529,369851,5897
2021-11-20,San Diego,073,3302833,383884,380147,22406,402553,4311
2021-11-20,San Francisco,075,870044,54276,53525,2418,55943,669
2021-11-20,San Joaquin,077,732212,101946,100922,5600,106522,1832
2021-11-20,San Luis Obispo,079,281455,30339,29815,1309,31124,355
2021-11-20,San Mateo,081,765935,55352,54132,941,55073,577
2021-11-20,Santa Barbara,083,443738,45501,45074,1604,46678,544
2021-11-20,Santa Clara,085,1922200,150619,148829,1483,150312,1917
2021-11-20,Santa Cruz,087,273765,21084,20756,1032,21788,222
2021-11-20,Shasta,089,179085,22303,21968,3699,25667,383
2021-11-20,Sierra,091,2930,196,191,21,212,0
2021-11-20,Siskiyou,093,43540,3418,3313,1341,4654,54
2021-11-20,Solano,095,438530,46757,46006,1328,47334,356
2021-11-20,Sonoma,097,501317,42540,42151,555,42706,403
2021-11-20,Stanislaus,099,539301,80407,80412,9129,89541,1205
2021-11-20,Sutter,101,95872,14114,14074,377,14451,181
2021-11-20,Tehama,103,63373,8747,8648,1535,10183,125
2021-11-20,Trinity,105,12862,887,771,225,996,17
2021-11-20,Tulare,107,460477,70430,69074,15889,84963,1054
2021-11-20,Tuolumne,109,53932,7567,7511,109,7620,90
2021-11-20,Ventura,111,848112,99784,98893,4383,103276,1186
2021-11-20,Yolo,113,214977,20304,20139,1212,21351,257
2021-11-20,Yuba,115,75493,10384,10290,368,10658,88
2021-11-19,Alameda,001,1643700,122013,121059,2900,123959,1473
2021-11-19,Alpine,003,1148,103,105,0,105,0
2021-11-19,Amador,005,37829,5682,5652,68,5720,66
2021-11-19,Butte,007,227075,21533,21265,3871,25136,300
2021-11-19,Calaveras,009,45235,4315,4268,60,4328,84
2021-11-19,Colusa,011,21464,2593,2549,661,3210,19
2021-11-19,Contra Costa,013,1133247,101348,100491,2290,102781,1043
2021-11-19,Del Norte,015,27424,3735,3637,56,3693,42
2021-11-19,El Dorado,017,186661,16543,16308,1743,18051,161
2021-11-19,Fresno,019,978130,144699,142579,13188,155767,2233
2021-11-19,Glenn,021,27897,3558,3526,1033,4559,35
2021-11-19,Humboldt,023,135768,9426,9302,639,9941,115
2021-11-19,Imperial,025,180216,34822,34312,3483,37795,766
2021-11-19,Inyo,027,18085,2516,2467,41,2508,44
2021-11-19,Kern,029,883053,131423,129488,23505,152993,1750
2021-11-19,Kings,031,150075,33178,32720,2025,34745,354
2021-11-19,Lake,033,64148,6882,6808,156,6964,110
2021-11-19,Lassen,035,31185,7025,6931,407,7338,47
2021-11-19,Los Angeles,037,10098052,1460036,1448963,56063,1505026,26741
2021-11-19,Madera,039,155013,24066,23720,2252,25972,296
2021-11-19,Marin,041,260295,17916,17774,486,18260,248
2021-11-19,Mariposa,043,17540,1409,1354,59,1413,6
2021-11-19,Mendocino,045,87422,7946,7773,650,8423,89
2021-11-19,Merced,047,269075,42959,42692,2064,44756,656
2021-11-19,Modoc,049,8938,581,550,203,753,5
2021-11-19,Mono,051,14174,1810,1767,22,1789,4
2021-11-19,Monterey,053,433212,49475,48260,3137,51397,609
2021-11-19,Napa,055,140530,13277,13184,118,13302,103
2021-11-19,Nevada,057,99092,9635,9480,339,9819,92
2021-11-19,Orange,059,3164182,312413,309672,15774,325446,5658
2021-11-19,Placer,061,380077,38243,37800,3810,41610,462
2021-11-19,Plumas,063,18699,1910,1841,44,1885,7
2021-11-19,Riverside,065,2383286,371433,365809,16715,382524,5265
2021-11-19,Sacramento,067,1510023,162893,161533,4849,166382,2316
2021-11-19,San Benito,069,59416,7575,7533,177,7710,77
2021-11-19,San Bernardino,071,2135413,362218,358322,11520,369842,5897
2021-11-19,San Diego,073,3302833,383483,380147,22380,402527,4311
2021-11-19,San Francisco,075,870044,54238,53525,2418,55943,669
2021-11-19,San Joaquin,077,732212,101889,100922,5596,106518,1832
2021-11-19,San Luis Obispo,079,281455,30321,29815,1307,31122,355
2021-11-19,San Mateo,081,765935,55304,54132,937,55069,577
2021-11-19,Santa Barbara,083,443738,45464,45074,1604,46678,544
2021-11-19,Santa Clara,085,1922200,150470,148829,1480,150309,1917
2021-11-19,Santa Cruz,087,273765,21057,20756,1029,21785,222
2021-11-19,Shasta,089,179085,22291,21968,3698,25666,383
2021-11-19,Sierra,091,2930,196,191,21,212,0
2021-11-19,Siskiyou,093,43540,3415,3313,1341,4654,54
2021-11-19,Solano,095,438530,46727,46006,1324,47330,356
2021-11-19,Sonoma,097,501317,42507,42151,552,42703,403
2021-11-19,Stanislaus,099,539301,80350,80412,9119,89531,1205
2021-11-19,Sutter,101,95872,14112,14074,377,14451,181
2021-11-19,Tehama,103,63373,8744,8648,1535,10183,125
2021-11-19,Trinity,105,12862,885,771,225,996,17
2021-11-19,Tulare,107,460477,70389,69074,15862,84936,1054
2021-11-19,Tuolumne,109,53932,7556,7511,109,7620,90
2021-11-19,Ventura,111,848112,99719,98893,4379,103272,1186
2021-11-19,Yolo,113,214977,20293,20139,1210,21349,257
2021-11-19,Yuba,115,75493,10381,10290,368,10658,88
2021-11-18,Alameda,001,1643700,121889,121059,2893,123952,1473
2021-11-18,Alpine,003,1148,103,105,0,105,0
2021-11-18,Amador,005,37829,5680,5652,68,5720,66
2021-11-18,Butte,007,227075,21516,21265,3864,25129,300
2021-11-18,Calaveras,009,45235,4308,4268,59,4327,84
2021-11-18,Colusa,011,21464,2585,2549,661,3210,19
2021-11-18,Contra Costa,013,1133247,101246,100491,2282,102773,1043
2021-11-18,Del Norte,015,27424,3732,3637,56,3693,42
2021-11-18,El Dorado,017,186661,16524,16308,1740,18048,161
2021-11-18,Fresno,019,978130,144559,142579,13178,155757,2233
2021-11-18,Glenn,021,27897,3557,3526,1032,4558,35
2021-11-18,Humboldt,023,135768,9410,9302,634,9936,115
2021-11-18,Imperial,025,180216,34768,34312,3467,37779,766
2021-11-18,Inyo,027,18085,2508,2467,41,2508,44
2021-11-18,Kern,029,883053,131279,129488,23457,152945,1750
2021-11-18,Kings,031,150075,33141,32720,2022,34742,354
2021-11-18,Lake,033,64148,6877,6808,156,6964,110
2021-11-18,Lassen,035,31185,7022,6931,402,7333,47
2021-11-18,Los Angeles,037,10098052,1459045,1448963,55999,1504962,26741
2021-11-18,Madera,039,155013,24041,23720,2248,25968,296
2021-11-18,Marin,041,260295,17900,17774,482,18256,248
2021-11-18,Mariposa,043,17540,1406,1354,59,1413,6
2021-11-18,Mendocino,045,87422,7924,7773,641,8414,89
2021-11-18,Merced,047,269075,42903,42692,2062,44754,656
2021-11-18,Modoc,049,8938,569,550,203,753,5
2021-11-18,Mono,051,14174,1802,1767,22,1789,4
2021-11-18,Monterey,053,433212,49450,48260,3132,51392,609
2021-11-18,Napa,055,140530,13265,13184,117,13301,103
2021-11-18,Nevada,057,99092,9611,9480,339,9819,92
2021-11-18,Orange,059,3164182,312177,309672,15755,325427,5658
2021-11-18,Placer,061,380077,38200,37800,3799,41599,462
2021-11-18,Plumas,063,18699,1909,1841,44,1885,7
2021-11-18,Riverside,065,2383286,371061,365809,16702,382511,5265
2021-11-18,Sacramento,067,1510023,162666,161533,4834,166367,2316
2021-11-18,San Benito,069,59416,7565,7533,177,7710,77
2021-11-18,San Bernardino,071,2135413,361784,358322,11501,369823,5897
2021-11-18,San Diego,073,3302833,382977,380147,22364,402511,4311
2021-11-18,San Francisco,075,870044,54186,53525,2414,55939,669
2021-11-18,San Joaquin,077,732212,101796,100922,5587,106509,1832
2021-11-18,San Luis Obispo,079,281455,30291,29815,1306,31121,355
2021-11-18,San Mateo,081,765935,55245,54132,934,55066,577
2021-11-18,Santa Barbara,083,443738,45418,45074,1597,46671,544
2021-11-18,Santa Clara,085,1922200,150283,148829,1472,150301,1917
2021-11-18,Santa Cruz,087,273765,21006,20756,1028,21784,222
2021-11-18,Shasta,089,179085,22255,21968,3693,25661,383
2021-11-18,Sierra,091,2930,195,191,21,212,0
2021-11-18,Siskiyou,093,43540,3415,3313,1337,4650,54
2021-11-18,Solano,095,438530,46685,46006,1321,47327,356
2021-11-18,Sonoma,097,501317,42458,42151,550,42701,403
2021-11-18,Stanislaus,099,539301,80283,80412,9111,89523,1205
2021-11-18,Sutter,101,95872,14101,14074,376,14450,181
2021-11-18,Tehama,103,63373,8739,8648,1535,10183,125
2021-11-18,Trinity,105,12862,884,771,225,996,17
2021-11-18,Tulare,107,460477,70316,69074,15814,84888,1054
2021-11-18,Tuolumne,109,53932,7546,7511,109,7620,90
2021-11-18,Ventura,111,848112,99642,98893,4375,103268,1186
2021-11-18,Yolo,113,214977,20276,20139,1205,21344,257
2021-11-18,Yuba,115,75493,10375,10290,368,10658,88
2021-11-17,Alameda,001,1643700,121767,120913,2892,123805,1472
2021-11-17,Alpine,003,1148,103,105,0,105,0
2021-11-17,Amador,005,37829,5673,5646,68,5714,66
2021-11-17,Butte,007,227075,21490,21230,3861,25091,300
2021-11-17,Calaveras,009,45235,4301,4259,59,4318,84
2021-11-17,Colusa,011,21464,2582,2546,660,3206,19
2021-11-17,Contra Costa,013,1133247,101154,100387,2278,102665,1039
2021-11-17,Del Norte,015,27424,3729,3630,56,3686,42
2021-11-17,El Dorado,017,186661,16505,16269,1739,18008,161
2021-11-17,Fresno,019,978130,144376,142366,13165,155531,2230
2021-11-17,Glenn,021,27897,3555,3527,1031,4558,34
2021-11-17,Humboldt,023,135768,9399,9270,631,9901,115
2021-11-17,Imperial,025,180216,34712,34256,3445,37701,766
2021-11-17,Inyo,027,18085,2502,2457,41,2498,44
2021-11-17,Kern,029,883053,131106,129307,23415,152722,1743
2021-11-17,Kings,031,150075,33113,32669,2018,34687,352
2021-11-17,Lake,033,64148,6873,6795,155,6950,110
2021-11-17,Lassen,035,31185,7020,6918,402,7320,47
2021-11-17,Los Angeles,037,10098052,1457943,1447947,55933,1503880,26721
2021-11-17,Madera,039,155013,24007,23673,2246,25919,287
2021-11-17,Marin,041,260295,17880,17757,480,18237,248
2021-11-17,Mariposa,043,17540,1402,1353,59,1412,6
2021-11-17,Mendocino,045,87422,7916,7735,640,8375,89
2021-11-17,Merced,047,269075,42844,42612,2057,44669,654
2021-11-17,Modoc,049,8938,565,540,203,743,5
2021-11-17,Mono,051,14174,1798,1765,22,1787,5
2021-11-17,Monterey,053,433212,49402,48221,3121,51342,609
2021-11-17,Napa,055,140530,13241,13167,117,13284,103
2021-11-17,Nevada,057,99092,9598,9447,339,9786,92
2021-11-17,Orange,059,3164182,311929,309396,15721,325117,5651
2021-11-17,Placer,061,380077,38152,37725,3790,41515,460
2021-11-17,Plumas,063,18699,1904,1833,44,1877,7
2021-11-17,Riverside,065,2383286,370650,365406,16689,382095,5229
2021-11-17,Sacramento,067,1510023,162497,161269,4826,166095,2302
2021-11-17,San Benito,069,59416,7558,7524,177,7701,77
2021-11-17,San Bernardino,071,2135413,361422,357947,11485,369432,5893
2021-11-17,San Diego,073,3302833,382479,379769,22338,402107,4301
2021-11-17,San Francisco,075,870044,54131,53469,2411,55880,667
2021-11-17,San Joaquin,077,732212,101694,100764,5582,106346,1828
2021-11-17,San Luis Obispo,079,281455,30265,29731,1303,31034,354
2021-11-17,San Mateo,081,765935,55177,54092,931,55023,577
2021-11-17,Santa Barbara,083,443738,45380,45000,1597,46597,542
2021-11-17,Santa Clara,085,1922200,150119,148626,1464,150090,1915
2021-11-17,Santa Cruz,087,273765,20971,20700,1028,21728,222
2021-11-17,Shasta,089,179085,22222,21883,3691,25574,382
2021-11-17,Sierra,091,2930,194,189,21,210,0
2021-11-17,Siskiyou,093,43540,3411,3307,1334,4641,54
2021-11-17,Solano,095,438530,46652,45948,1320,47268,353
2021-11-17,Sonoma,097,501317,42412,42093,547,42640,403
2021-11-17,Stanislaus,099,539301,80195,80276,9101,89377,1199
2021-11-17,Sutter,101,95872,14087,14064,374,14438,181
2021-11-17,Tehama,103,63373,8729,8633,1532,10165,125
2021-11-17,Trinity,105,12862,883,765,225,990,17
2021-11-17,Tulare,107,460477,70243,68977,15787,84764,1047
2021-11-17,Tuolumne,109,53932,7529,7485,109,7594,90
2021-11-17,Ventura,111,848112,99580,98812,4369,103181,1183
2021-11-17,Yolo,113,214977,20257,20100,1201,21301,257
2021-11-17,Yuba,115,75493,10363,10275,364,10639,88
2021-11-16,Alameda,001,1643700,121655,120809,2888,123697,1467
2021-11-16,Alpine,003,1148,103,105,0,105,0
2021-11-16,Amador,005,37829,5667,5644,68,5712,66
2021-11-16,Butte,007,227075,21465,21208,3856,25064,297
2021-11-16,Calaveras,009,45235,4292,4249,59,4308,83
2021-11-16,Colusa,011,21464,2576,2538,660,3198,19
2021-11-16,Contra Costa,013,1133247,101032,100320,2275,102595,1038
2021-11-16,Del Norte,015,27424,3723,3630,56,3686,42
2021-11-16,El Dorado,017,186661,16480,16248,1737,17985,159
2021-11-16,Fresno,019,978130,144189,142200,13144,155344,2218
2021-11-16,Glenn,021,27897,3554,3527,1028,4555,34
2021-11-16,Humboldt,023,135768,9378,9252,627,9879,115
2021-11-16,Imperial,025,180216,34628,34177,3431,37608,766
2021-11-16,Inyo,027,18085,2495,2449,41,2490,42
2021-11-16,Kern,029,883053,130947,129136,23354,152490,1735
2021-11-16,Kings,031,150075,33063,32614,2011,34625,350
2021-11-16,Lake,033,64148,6868,6789,155,6944,110
2021-11-16,Lassen,035,31185,7010,6915,402,7317,47
2021-11-16,Los Angeles,037,10098052,1456771,1446815,55861,1502676,26703
2021-11-16,Madera,039,155013,23969,23642,2240,25882,287
2021-11-16,Marin,041,260295,17861,17736,479,18215,248
2021-11-16,Mariposa,043,17540,1394,1349,58,1407,6
2021-11-16,Mendocino,045,87422,7874,7723,636,8359,89
2021-11-16,Merced,047,269075,42807,42578,2050,44628,653
2021-11-16,Modoc,049,8938,564,539,202,741,5
2021-11-16,Mono,051,14174,1789,1767,22,1789,4
2021-11-16,Monterey,053,433212,49372,48195,3107,51302,609
2021-11-16,Napa,055,140530,13230,13151,117,13268,103
2021-11-16,Nevada,057,99092,9581,9435,338,9773,92
2021-11-16,Orange,059,3164182,311662,309170,15686,324856,5651
2021-11-16,Placer,061,380077,38110,37676,3784,41460,459
2021-11-16,Plumas,063,18699,1895,1832,44,1876,7
2021-11-16,Riverside,065,2383286,370228,365078,16667,381745,5208
2021-11-16,Sacramento,067,1510023,162318,161102,4813,165915,2299
2021-11-16,San Benito,069,59416,7544,7513,177,7690,77
2021-11-16,San Bernardino,071,2135413,361010,357528,11433,368961,5901
2021-11-16,San Diego,073,3302833,381922,379435,22311,401746,4287
2021-11-16,San Francisco,075,870044,54058,53415,2403,55818,667
2021-11-16,San Joaquin,077,732212,101554,100637,5566,106203,1807
2021-11-16,San Luis Obispo,079,281455,30234,29703,1300,31003,356
2021-11-16,San Mateo,081,765935,55115,54034,929,54963,577
2021-11-16,Santa Barbara,083,443738,45312,44932,1594,46526,539
2021-11-16,Santa Clara,085,1922200,149939,148452,1452,149904,1916
2021-11-16,Santa Cruz,087,273765,20926,20684,1026,21710,222
2021-11-16,Shasta,089,179085,22183,21853,3687,25540,379
2021-11-16,Sierra,091,2930,194,189,21,210,0
2021-11-16,Siskiyou,093,43540,3408,3304,1332,4636,54
2021-11-16,Solano,095,438530,46612,45908,1319,47227,351
2021-11-16,Sonoma,097,501317,42363,42056,546,42602,401
2021-11-16,Stanislaus,099,539301,80100,80214,9077,89291,1196
2021-11-16,Sutter,101,95872,14075,14058,373,14431,181
2021-11-16,Tehama,103,63373,8722,8621,1525,10146,125
2021-11-16,Trinity,105,12862,883,762,224,986,17
2021-11-16,Tulare,107,460477,70163,68881,15750,84631,1039
2021-11-16,Tuolumne,109,53932,7519,7478,109,7587,90
2021-11-16,Ventura,111,848112,99505,98731,4366,103097,1183
2021-11-16,Yolo,113,214977,20218,20077,1199,21276,257
2021-11-16,Yuba,115,75493,10355,10262,362,10624,85
2021-11-15,Alameda,001,1643700,121501,120731,2883,123614,1464
2021-11-15,Alpine,003,1148,103,105,0,105,0
2021-11-15,Amador,005,37829,5663,5637,68,5705,66
2021-11-15,Butte,007,227075,21440,21182,3852,25034,296
2021-11-15,Calaveras,009,45235,4278,4237,59,4296,83
2021-11-15,Colusa,011,21464,2569,2535,657,3192,19
2021-11-15,Contra Costa,013,1133247,100925,100251,2272,102523,1038
2021-11-15,Del Norte,015,27424,3718,3630,55,3685,42
2021-11-15,El Dorado,017,186661,16456,16236,1733,17969,159
2021-11-15,Fresno,019,978130,143965,142015,13123,155138,2210
2021-11-15,Glenn,021,27897,3552,3526,1028,4554,34
2021-11-15,Humboldt,023,135768,9355,9230,619,9849,115
2021-11-15,Imperial,025,180216,34555,34130,3415,37545,766
2021-11-15,Inyo,027,18085,2490,2442,41,2483,42
2021-11-15,Kern,029,883053,130738,128928,23283,152211,1730
2021-11-15,Kings,031,150075,33029,32584,2006,34590,348
2021-11-15,Lake,033,64148,6864,6784,155,6939,109
2021-11-15,Lassen,035,31185,6999,6915,400,7315,47
2021-11-15,Los Angeles,037,10098052,1455577,1446114,55795,1501909,26677
2021-11-15,Madera,039,155013,23930,23605,2229,25834,287
2021-11-15,Marin,041,260295,17844,17723,478,18201,248
2021-11-15,Mariposa,043,17540,1393,1347,56,1403,6
2021-11-15,Mendocino,045,87422,7854,7694,630,8324,89
2021-11-15,Merced,047,269075,42749,42552,2039,44591,648
2021-11-15,Modoc,049,8938,563,538,201,739,5
2021-11-15,Mono,051,14174,1784,1763,22,1785,4
2021-11-15,Monterey,053,433212,49340,48154,3101,51255,609
2021-11-15,Napa,055,140530,13222,13143,117,13260,103
2021-11-15,Nevada,057,99092,9552,9420,337,9757,92
2021-11-15,Orange,059,3164182,311385,308859,15662,324521,5646
2021-11-15,Placer,061,380077,38046,37610,3780,41390,452
2021-11-15,Plumas,063,18699,1888,1829,44,1873,7
2021-11-15,Riverside,065,2383286,369782,364750,16648,381398,5199
2021-11-15,Sacramento,067,1510023,162098,160937,4800,165737,2293
2021-11-15,San Benito,069,59416,7539,7511,176,7687,77
2021-11-15,San Bernardino,071,2135413,360593,357306,11413,368719,5898
2021-11-15,San Diego,073,3302833,381372,378845,22286,401131,4284
2021-11-15,San Francisco,075,870044,53990,53374,2400,55774,667
2021-11-15,San Joaquin,077,732212,101400,100587,5555,106142,1799
2021-11-15,San Luis Obispo,079,281455,30191,29669,1288,30957,351
2021-11-15,San Mateo,081,765935,55062,54010,926,54936,576
2021-11-15,Santa Barbara,083,443738,45256,44879,1588,46467,539
2021-11-15,Santa Clara,085,1922200,149721,148313,1445,149758,1914
2021-11-15,Santa Cruz,087,273765,20884,20630,1025,21655,223
2021-11-15,Shasta,089,179085,22137,21779,3682,25461,374
2021-11-15,Sierra,091,2930,194,189,21,210,0
2021-11-15,Siskiyou,093,43540,3401,3302,1330,4632,54
2021-11-15,Solano,095,438530,46573,45885,1314,47199,351
2021-11-15,Sonoma,097,501317,42312,42021,545,42566,401
2021-11-15,Stanislaus,099,539301,80015,80129,9063,89192,1174
2021-11-15,Sutter,101,95872,14062,14043,372,14415,181
2021-11-15,Tehama,103,63373,8716,8615,1524,10139,125
2021-11-15,Trinity,105,12862,881,757,222,979,17
2021-11-15,Tulare,107,460477,70076,68826,15704,84530,1039
2021-11-15,Tuolumne,109,53932,7508,7461,109,7570,90
2021-11-15,Ventura,111,848112,99421,98605,4361,102966,1183
2021-11-15,Yolo,113,214977,20188,20065,1194,21259,255
2021-11-15,Yuba,115,75493,10336,10254,358,10612,85
2021-11-14,Alameda,001,1643700,121326,120629,2879,123508,1461
2021-11-14,Alpine,003,1148,102,105,0,105,0
2021-11-14,Amador,005,37829,5656,5632,67,5699,66
2021-11-14,Butte,007,227075,21409,21146,3843,24989,296
2021-11-14,Calaveras,009,45235,4267,4222,59,4281,83
2021-11-14,Colusa,011,21464,2567,2532,654,3186,19
2021-11-14,Contra Costa,013,1133247,100817,100188,2270,102458,1038
2021-11-14,Del Norte,015,27424,3715,3629,55,3684,42
2021-11-14,El Dorado,017,186661,16415,16212,1728,17940,159
2021-11-14,Fresno,019,978130,143682,141869,13090,154959,2209
2021-11-14,Glenn,021,27897,3550,3521,1028,4549,34
2021-11-14,Humboldt,023,135768,9325,9215,609,9824,115
2021-11-14,Imperial,025,180216,34452,34078,3400,37478,766
2021-11-14,Inyo,027,18085,2478,2441,41,2482,42
2021-11-14,Kern,029,883053,130498,128842,23213,152055,1730
2021-11-14,Kings,031,150075,32972,32545,1999,34544,349
2021-11-14,Lake,033,64148,6856,6777,155,6932,109
2021-11-14,Lassen,035,31185,6989,6911,399,7310,47
2021-11-14,Los Angeles,037,10098052,1454215,1445284,55718,1501002,26667
2021-11-14,Madera,039,155013,23880,23566,2220,25786,287
2021-11-14,Marin,041,260295,17829,17712,478,18190,247
2021-11-14,Mariposa,043,17540,1383,1337,52,1389,6
2021-11-14,Mendocino,045,87422,7821,7684,625,8309,89
2021-11-14,Merced,047,269075,42659,42513,2033,44546,648
2021-11-14,Modoc,049,8938,561,538,201,739,5
2021-11-14,Mono,051,14174,1772,1760,22,1782,4
2021-11-14,Monterey,053,433212,49285,48135,3083,51218,609
2021-11-14,Napa,055,140530,13204,13132,117,13249,103
2021-11-14,Nevada,057,99092,9524,9408,337,9745,92
2021-11-14,Orange,059,3164182,311066,308699,15641,324340,5646
2021-11-14,Placer,061,380077,37965,37569,3770,41339,452
2021-11-14,Plumas,063,18699,1885,1829,43,1872,7
2021-11-14,Riverside,065,2383286,369284,364490,16631,381121,5199
2021-11-14,Sacramento,067,1510023,161860,160761,4783,165544,2295
2021-11-14,San Benito,069,59416,7528,7507,175,7682,77
2021-11-14,San Bernardino,071,2135413,360014,357014,11396,368410,5897
2021-11-14,San Diego,073,3302833,380766,377633,22255,399888,4280
2021-11-14,San Francisco,075,870044,53915,53338,2395,55733,667
2021-11-14,San Joaquin,077,732212,101272,100518,5550,106068,1799
2021-11-14,San Luis Obispo,079,281455,30109,29645,1284,30929,352
2021-11-14,San Mateo,081,765935,55009,53978,924,54902,576
2021-11-14,Santa Barbara,083,443738,45177,44842,1585,46427,539
2021-11-14,Santa Clara,085,1922200,149522,148152,1437,149589,1913
2021-11-14,Santa Cruz,087,273765,20830,20609,1023,21632,223
2021-11-14,Shasta,089,179085,22085,21771,3669,25440,373
2021-11-14,Sierra,091,2930,194,189,21,210,0
2021-11-14,Siskiyou,093,43540,3392,3302,1329,4631,54
2021-11-14,Solano,095,438530,46517,45860,1307,47167,351
2021-11-14,Sonoma,097,501317,42246,41974,543,42517,401
2021-11-14,Stanislaus,099,539301,79880,80076,9048,89124,1174
2021-11-14,Sutter,101,95872,14045,14031,367,14398,181
2021-11-14,Tehama,103,63373,8706,8607,1522,10129,125
2021-11-14,Trinity,105,12862,878,754,220,974,17
2021-11-14,Tulare,107,460477,69958,68772,15645,84417,1037
2021-11-14,Tuolumne,109,53932,7490,7439,108,7547,90
2021-11-14,Ventura,111,848112,99306,98550,4360,102910,1183
2021-11-14,Yolo,113,214977,20161,20040,1188,21228,255
2021-11-14,Yuba,115,75493,10329,10238,357,10595,85
2021-11-13,Alameda,001,1643700,121253,120407,2877,123284,1454
2021-11-13,Alpine,003,1148,102,105,0,105,0
2021-11-13,Amador,005,37829,5655,5614,67,5681,66
2021-11-13,Butte,007,227075,21389,21104,3840,24944,296
2021-11-13,Calaveras,009,45235,4256,4203,59,4262,83
2021-11-13,Colusa,011,21464,2565,2522,654,3176,19
2021-11-13,Contra Costa,013,1133247,100745,100004,2264,102268,1028
2021-11-13,Del Norte,015,27424,3715,3629,55,3684,42
2021-11-13,El Dorado,017,186661,16403,16163,1725,17888,159
2021-11-13,Fresno,019,978130,143575,141452,13076,154528,2205
2021-11-13,Glenn,021,27897,3550,3514,1027,4541,34
2021-11-13,Humboldt,023,135768,9310,9177,604,9781,115
2021-11-13,Imperial,025,180216,34401,33990,3383,37373,766
2021-11-13,Inyo,027,18085,2472,2436,41,2477,42
2021-11-13,Kern,029,883053,130397,128472,23169,151641,1719
2021-11-13,Kings,031,150075,32955,32452,1998,34450,347
2021-11-13,Lake,033,64148,6851,6769,155,6924,109
2021-11-13,Lassen,035,31185,6984,6897,399,7296,47
2021-11-13,Los Angeles,037,10098052,1453554,1443088,55676,1498764,26649
2021-11-13,Madera,039,155013,23850,23462,2215,25677,287
2021-11-13,Marin,041,260295,17816,17684,476,18160,247
2021-11-13,Mariposa,043,17540,1380,1323,52,1375,6
2021-11-13,Mendocino,045,87422,7802,7652,624,8276,89
2021-11-13,Merced,047,269075,42621,42411,2030,44441,644
2021-11-13,Modoc,049,8938,560,536,201,737,5
2021-11-13,Mono,051,14174,1768,1750,22,1772,4
2021-11-13,Monterey,053,433212,49259,48087,3081,51168,609
2021-11-13,Napa,055,140530,13196,13110,117,13227,103
2021-11-13,Nevada,057,99092,9504,9369,335,9704,92
2021-11-13,Orange,059,3164182,310900,308211,15613,323824,5641
2021-11-13,Placer,061,380077,37915,37453,3767,41220,445
2021-11-13,Plumas,063,18699,1882,1828,43,1871,8
2021-11-13,Riverside,065,2383286,368978,363801,16624,380425,5187
2021-11-13,Sacramento,067,1510023,161724,160397,4770,165167,2291
2021-11-13,San Benito,069,59416,7515,7491,174,7665,77
2021-11-13,San Bernardino,071,2135413,359762,356325,11389,367714,5873
2021-11-13,San Diego,073,3302833,380429,377633,22227,399860,4280
2021-11-13,San Francisco,075,870044,53883,53195,2394,55589,667
2021-11-13,San Joaquin,077,732212,101216,100263,5541,105804,1799
2021-11-13,San Luis Obispo,079,281455,30079,29589,1282,30871,351
2021-11-13,San Mateo,081,765935,54971,53853,923,54776,574
2021-11-13,Santa Barbara,083,443738,45144,44734,1585,46319,537
2021-11-13,Santa Clara,085,1922200,149404,147821,1432,149253,1905
2021-11-13,Santa Cruz,087,273765,20815,20565,1022,21587,223
2021-11-13,Shasta,089,179085,22054,21713,3665,25378,366
2021-11-13,Sierra,091,2930,193,188,21,209,0
2021-11-13,Siskiyou,093,43540,3383,3299,1328,4627,54
2021-11-13,Solano,095,438530,46488,45774,1303,47077,350
2021-11-13,Sonoma,097,501317,42212,41882,542,42424,399
2021-11-13,Stanislaus,099,539301,79804,79872,9034,88906,1174
2021-11-13,Sutter,101,95872,14035,14017,366,14383,181
2021-11-13,Tehama,103,63373,8700,8592,1518,10110,125
2021-11-13,Trinity,105,12862,877,749,220,969,17
2021-11-13,Tulare,107,460477,69892,68619,15622,84241,1033
2021-11-13,Tuolumne,109,53932,7473,7392,108,7500,90
2021-11-13,Ventura,111,848112,99248,98452,4357,102809,1183
2021-11-13,Yolo,113,214977,20147,20009,1183,21192,255
2021-11-13,Yuba,115,75493,10319,10218,355,10573,85
2021-11-12,Alameda,001,1643700,121170,120407,2874,123281,1454
2021-11-12,Alpine,003,1148,102,105,0,105,0
2021-11-12,Amador,005,37829,5649,5614,66,5680,66
2021-11-12,Butte,007,227075,21372,21104,3836,24940,296
2021-11-12,Calaveras,009,45235,4245,4203,59,4262,83
2021-11-12,Colusa,011,21464,2561,2522,653,3175,19
2021-11-12,Contra Costa,013,1133247,100690,100004,2263,102267,1028
2021-11-12,Del Norte,015,27424,3715,3629,55,3684,42
2021-11-12,El Dorado,017,186661,16384,16163,1724,17887,159
2021-11-12,Fresno,019,978130,143432,141452,13062,154514,2205
2021-11-12,Glenn,021,27897,3547,3514,1026,4540,34
2021-11-12,Humboldt,023,135768,9303,9177,602,9779,115
2021-11-12,Imperial,025,180216,34375,33990,3373,37363,766
2021-11-12,Inyo,027,18085,2468,2436,41,2477,42
2021-11-12,Kern,029,883053,130260,128472,23137,151609,1719
2021-11-12,Kings,031,150075,32929,32452,1996,34448,347
2021-11-12,Lake,033,64148,6847,6769,155,6924,109
2021-11-12,Lassen,035,31185,6980,6897,398,7295,47
2021-11-12,Los Angeles,037,10098052,1452826,1443088,55631,1498719,26649
2021-11-12,Madera,039,155013,23821,23462,2210,25672,287
2021-11-12,Marin,041,260295,17800,17684,475,18159,247
2021-11-12,Mariposa,043,17540,1373,1323,52,1375,6
2021-11-12,Mendocino,045,87422,7790,7652,621,8273,89
2021-11-12,Merced,047,269075,42592,42411,2028,44439,644
2021-11-12,Modoc,049,8938,559,536,201,737,5
2021-11-12,Mono,051,14174,1766,1750,22,1772,4
2021-11-12,Monterey,053,433212,49227,48087,3075,51162,609
2021-11-12,Napa,055,140530,13187,13110,117,13227,103
2021-11-12,Nevada,057,99092,9490,9369,334,9703,92
2021-11-12,Orange,059,3164182,310712,308211,15595,323806,5641
2021-11-12,Placer,061,380077,37875,37453,3764,41217,445
2021-11-12,Plumas,063,18699,1876,1828,43,1871,8
2021-11-12,Riverside,065,2383286,368711,363801,16620,380421,5187
2021-11-12,Sacramento,067,1510023,161565,160397,4765,165162,2291
2021-11-12,San Benito,069,59416,7515,7491,174,7665,77
2021-11-12,San Bernardino,071,2135413,359453,356325,11378,367703,5873
2021-11-12,San Diego,073,3302833,380054,377633,22205,399838,4280
2021-11-12,San Francisco,075,870044,53848,53195,2390,55585,667
2021-11-12,San Joaquin,077,732212,101171,100263,5535,105798,1799
2021-11-12,San Luis Obispo,079,281455,30050,29589,1281,30870,351
2021-11-12,San Mateo,081,765935,54921,53853,920,54773,574
2021-11-12,Santa Barbara,083,443738,45089,44734,1584,46318,537
2021-11-12,Santa Clara,085,1922200,149262,147821,1427,149248,1905
2021-11-12,Santa Cruz,087,273765,20788,20565,1020,21585,223
2021-11-12,Shasta,089,179085,22022,21713,3662,25375,366
2021-11-12,Sierra,091,2930,192,188,21,209,0
2021-11-12,Siskiyou,093,43540,3382,3299,1326,4625,54
2021-11-12,Solano,095,438530,46461,45774,1299,47073,350
2021-11-12,Sonoma,097,501317,42172,41882,542,42424,399
2021-11-12,Stanislaus,099,539301,79752,79872,9026,88898,1174
2021-11-12,Sutter,101,95872,14028,14017,366,14383,181
2021-11-12,Tehama,103,63373,8696,8592,1517,10109,125
2021-11-12,Trinity,105,12862,870,749,220,969,17
2021-11-12,Tulare,107,460477,69850,68619,15587,84206,1033
2021-11-12,Tuolumne,109,53932,7460,7392,107,7499,90
2021-11-12,Ventura,111,848112,99183,98452,4356,102808,1183
2021-11-12,Yolo,113,214977,20133,20009,1177,21186,255
2021-11-12,Yuba,115,75493,10310,10218,354,10572,85
2021-11-11,Alameda,001,1643700,121054,120147,2866,123013,1453
2021-11-11,Alpine,003,1148,102,105,0,105,0
2021-11-11,Amador,005,37829,5646,5603,65,5668,66
2021-11-11,Butte,007,227075,21329,21047,3831,24878,293
2021-11-11,Calaveras,009,45235,4227,4179,59,4238,83
2021-11-11,Colusa,011,21464,2553,2518,651,3169,19
2021-11-11,Contra Costa,013,1133247,100585,99808,2258,102066,1028
2021-11-11,Del Norte,015,27424,3713,3622,55,3677,42
2021-11-11,El Dorado,017,186661,16350,16085,1721,17806,159
2021-11-11,Fresno,019,978130,143227,140833,13028,153861,2202
2021-11-11,Glenn,021,27897,3545,3503,1026,4529,34
2021-11-11,Humboldt,023,135768,9280,9125,599,9724,115
2021-11-11,Imperial,025,180216,34306,33844,3351,37195,766
2021-11-11,Inyo,027,18085,2463,2428,41,2469,42
2021-11-11,Kern,029,883053,130076,128023,23073,151096,1709
2021-11-11,Kings,031,150075,32878,32318,1994,34312,345
2021-11-11,Lake,033,64148,6840,6745,155,6900,107
2021-11-11,Lassen,035,31185,6974,6875,398,7273,47
2021-11-11,Los Angeles,037,10098052,1451736,1440436,55572,1496008,26614
2021-11-11,Madera,039,155013,23774,23316,2202,25518,287
2021-11-11,Marin,041,260295,17790,17639,475,18114,247
2021-11-11,Mariposa,043,17540,1363,1317,52,1369,6
2021-11-11,Mendocino,045,87422,7775,7612,612,8224,89
2021-11-11,Merced,047,269075,42536,42292,2025,44317,643
2021-11-11,Modoc,049,8938,557,536,201,737,5
2021-11-11,Mono,051,14174,1762,1743,22,1765,4
2021-11-11,Monterey,053,433212,49192,48008,3063,51071,609
2021-11-11,Napa,055,140530,13179,13075,117,13192,103
2021-11-11,Nevada,057,99092,9468,9308,334,9642,92
2021-11-11,Orange,059,3164182,310438,307674,15557,323231,5633
2021-11-11,Placer,061,380077,37824,37333,3756,41089,440
2021-11-11,Plumas,063,18699,1872,1814,43,1857,7
2021-11-11,Riverside,065,2383286,368278,362930,16602,379532,5175
2021-11-11,Sacramento,067,1510023,161352,159962,4746,164708,2289
2021-11-11,San Benito,069,59416,7507,7473,174,7647,76
2021-11-11,San Bernardino,071,2135413,359025,355413,11365,366778,5849
2021-11-11,San Diego,073,3302833,379539,376428,22182,398610,4272
2021-11-11,San Francisco,075,870044,53789,53063,2388,55451,666
2021-11-11,San Joaquin,077,732212,101076,99937,5520,105457,1799
2021-11-11,San Luis Obispo,079,281455,29999,29532,1279,30811,351
2021-11-11,San Mateo,081,765935,54872,53722,915,54637,574
2021-11-11,Santa Barbara,083,443738,45031,44603,1581,46184,534
2021-11-11,Santa Clara,085,1922200,149080,147458,1421,148879,1901
2021-11-11,Santa Cruz,087,273765,20743,20479,1020,21499,222
2021-11-11,Shasta,089,179085,21975,21600,3660,25260,364
2021-11-11,Sierra,091,2930,191,186,21,207,0
2021-11-11,Siskiyou,093,43540,3376,3297,1325,4622,53
2021-11-11,Solano,095,438530,46424,45679,1298,46977,350
2021-11-11,Sonoma,097,501317,42135,41774,542,42316,395
2021-11-11,Stanislaus,099,539301,79669,79570,9012,88582,1166
2021-11-11,Sutter,101,95872,14014,13993,365,14358,181
2021-11-11,Tehama,103,63373,8684,8565,1515,10080,125
2021-11-11,Trinity,105,12862,869,748,220,968,17
2021-11-11,Tulare,107,460477,69757,68367,15551,83918,1028
2021-11-11,Tuolumne,109,53932,7447,7354,107,7461,90
2021-11-11,Ventura,111,848112,99105,98297,4349,102646,1182
2021-11-11,Yolo,113,214977,20106,19946,1175,21121,255
2021-11-11,Yuba,115,75493,10294,10191,354,10545,85
2021-11-10,Alameda,001,1643700,120945,120147,2856,123003,1453
2021-11-10,Alpine,003,1148,102,105,0,105,0
2021-11-10,Amador,005,37829,5640,5603,65,5668,66
2021-11-10,Butte,007,227075,21303,21047,3827,24874,293
2021-11-10,Calaveras,009,45235,4216,4179,59,4238,83
2021-11-10,Colusa,011,21464,2547,2518,651,3169,19
2021-11-10,Contra Costa,013,1133247,100502,99808,2254,102062,1028
2021-11-10,Del Norte,015,27424,3712,3622,55,3677,42
2021-11-10,El Dorado,017,186661,16334,16085,1720,17805,159
2021-11-10,Fresno,019,978130,143047,140833,13014,153847,2202
2021-11-10,Glenn,021,27897,3545,3503,1025,4528,34
2021-11-10,Humboldt,023,135768,9262,9125,599,9724,115
2021-11-10,Imperial,025,180216,34257,33844,3332,37176,766
2021-11-10,Inyo,027,18085,2456,2428,41,2469,42
2021-11-10,Kern,029,883053,129927,128023,23017,151040,1709
2021-11-10,Kings,031,150075,32845,32318,1992,34310,345
2021-11-10,Lake,033,64148,6830,6745,155,6900,107
2021-11-10,Lassen,035,31185,6969,6875,398,7273,47
2021-11-10,Los Angeles,037,10098052,1450785,1440436,55513,1495949,26614
2021-11-10,Madera,039,155013,23725,23316,2196,25512,287
2021-11-10,Marin,041,260295,17777,17639,473,18112,247
2021-11-10,Mariposa,043,17540,1357,1317,52,1369,6
2021-11-10,Mendocino,045,87422,7763,7612,611,8223,89
2021-11-10,Merced,047,269075,42501,42292,2023,44315,643
2021-11-10,Modoc,049,8938,556,536,200,736,5
2021-11-10,Mono,051,14174,1760,1743,22,1765,4
2021-11-10,Monterey,053,433212,49158,48008,3051,51059,609
2021-11-10,Napa,055,140530,13165,13075,116,13191,103
2021-11-10,Nevada,057,99092,9461,9308,332,9640,92
2021-11-10,Orange,059,3164182,310175,307674,15525,323199,5633
2021-11-10,Placer,061,380077,37779,37333,3749,41082,440
2021-11-10,Plumas,063,18699,1866,1814,42,1856,7
2021-11-10,Riverside,065,2383286,367897,362930,16596,379526,5175
2021-11-10,Sacramento,067,1510023,161197,159962,4736,164698,2289
2021-11-10,San Benito,069,59416,7499,7473,174,7647,76
2021-11-10,San Bernardino,071,2135413,358687,355413,11357,366770,5849
2021-11-10,San Diego,073,3302833,379123,376428,22160,398588,4272
2021-11-10,San Francisco,075,870044,53728,53063,2385,55448,666
2021-11-10,San Joaquin,077,732212,100969,99937,5514,105451,1799
2021-11-10,San Luis Obispo,079,281455,29968,29532,1278,30810,351
2021-11-10,San Mateo,081,765935,54818,53722,914,54636,574
2021-11-10,Santa Barbara,083,443738,44993,44603,1580,46183,534
2021-11-10,Santa Clara,085,1922200,148932,147458,1415,148873,1901
2021-11-10,Santa Cruz,087,273765,20716,20479,1019,21498,222
2021-11-10,Shasta,089,179085,21939,21600,3658,25258,364
2021-11-10,Sierra,091,2930,190,186,21,207,0
2021-11-10,Siskiyou,093,43540,3374,3297,1325,4622,53
2021-11-10,Solano,095,438530,46394,45679,1296,46975,350
2021-11-10,Sonoma,097,501317,42084,41774,542,42316,395
2021-11-10,Stanislaus,099,539301,79568,79570,8996,88566,1166
2021-11-10,Sutter,101,95872,14006,13993,365,14358,181
2021-11-10,Tehama,103,63373,8672,8565,1509,10074,125
2021-11-10,Trinity,105,12862,865,748,219,967,17
2021-11-10,Tulare,107,460477,69697,68367,15510,83877,1028
2021-11-10,Tuolumne,109,53932,7423,7354,107,7461,90
2021-11-10,Ventura,111,848112,99034,98297,4349,102646,1182
2021-11-10,Yolo,113,214977,20087,19946,1174,21120,255
2021-11-10,Yuba,115,75493,10285,10191,354,10545,85
2021-11-09,Alameda,001,1643700,120808,120051,2846,122897,1450
2021-11-09,Alpine,003,1148,102,105,0,105,0
2021-11-09,Amador,005,37829,5636,5596,65,5661,66
2021-11-09,Butte,007,227075,21282,21022,3824,24846,291
2021-11-09,Calaveras,009,45235,4212,4174,59,4233,84
2021-11-09,Colusa,011,21464,2542,2517,650,3167,19
2021-11-09,Contra Costa,013,1133247,100407,99732,2246,101978,1028
2021-11-09,Del Norte,015,27424,3711,3620,55,3675,42
2021-11-09,El Dorado,017,186661,16296,16073,1715,17788,160
2021-11-09,Fresno,019,978130,142804,140666,12999,153665,2188
2021-11-09,Glenn,021,27897,3540,3499,1025,4524,34
2021-11-09,Humboldt,023,135768,9241,9112,594,9706,115
2021-11-09,Imperial,025,180216,34205,33751,3318,37069,766
2021-11-09,Inyo,027,18085,2452,2404,41,2445,42
2021-11-09,Kern,029,883053,129683,127901,22954,150855,1694
2021-11-09,Kings,031,150075,32778,32279,1988,34267,344
2021-11-09,Lake,033,64148,6821,6743,155,6898,106
2021-11-09,Lassen,035,31185,6957,6846,398,7244,47
2021-11-09,Los Angeles,037,10098052,1449538,1439125,55450,1494575,26581
2021-11-09,Madera,039,155013,23675,23285,2187,25472,287
2021-11-09,Marin,041,260295,17758,17630,471,18101,247
2021-11-09,Mariposa,043,17540,1349,1317,51,1368,5
2021-11-09,Mendocino,045,87422,7740,7598,605,8203,85
2021-11-09,Merced,047,269075,42460,42251,2017,44268,613
2021-11-09,Modoc,049,8938,555,536,198,734,5
2021-11-09,Mono,051,14174,1755,1738,22,1760,4
2021-11-09,Monterey,053,433212,49122,47975,3027,51002,609
2021-11-09,Napa,055,140530,13147,13051,116,13167,103
2021-11-09,Nevada,057,99092,9442,9288,332,9620,92
2021-11-09,Orange,059,3164182,309890,307412,15497,322909,5621
2021-11-09,Placer,061,380077,37725,37291,3732,41023,440
2021-11-09,Plumas,063,18699,1864,1802,42,1844,7
2021-11-09,Riverside,065,2383286,367432,362557,16581,379138,5160
2021-11-09,Sacramento,067,1510023,160956,159856,4726,164582,2286
2021-11-09,San Benito,069,59416,7489,7471,173,7644,76
2021-11-09,San Bernardino,071,2135413,358240,354972,11340,366312,5839
2021-11-09,San Diego,073,3302833,378616,375997,22134,398131,4272
2021-11-09,San Francisco,075,870044,53655,52996,2379,55375,666
2021-11-09,San Joaquin,077,732212,100793,99848,5501,105349,1794
2021-11-09,San Luis Obispo,079,281455,29925,29488,1277,30765,350
2021-11-09,San Mateo,081,765935,54771,53697,904,54601,574
2021-11-09,Santa Barbara,083,443738,44926,44579,1573,46152,533
2021-11-09,Santa Clara,085,1922200,148725,147281,1408,148689,1901
2021-11-09,Santa Cruz,087,273765,20682,20463,1018,21481,222
2021-11-09,Shasta,089,179085,21884,21558,3653,25211,364
2021-11-09,Sierra,091,2930,190,186,21,207,0
2021-11-09,Siskiyou,093,43540,3372,3295,1323,4618,52
2021-11-09,Solano,095,438530,46339,45639,1295,46934,350
2021-11-09,Sonoma,097,501317,42027,41727,540,42267,395
2021-11-09,Stanislaus,099,539301,79462,79505,8979,88484,1165
2021-11-09,Sutter,101,95872,13991,13988,363,14351,180
2021-11-09,Tehama,103,63373,8654,8555,1507,10062,125
2021-11-09,Trinity,105,12862,864,746,219,965,17
2021-11-09,Tulare,107,460477,69591,68298,15470,83768,1024
2021-11-09,Tuolumne,109,53932,7403,7347,107,7454,90
2021-11-09,Ventura,111,848112,98955,98202,4344,102546,1182
2021-11-09,Yolo,113,214977,20063,19931,1170,21101,255
2021-11-09,Yuba,115,75493,10268,10175,348,10523,85
2021-11-08,Alameda,001,1643700,120665,119983,2840,122823,1447
2021-11-08,Alpine,003,1148,102,105,0,105,0
2021-11-08,Amador,005,37829,5630,5590,65,5655,66
2021-11-08,Butte,007,227075,21254,21000,3816,24816,288
2021-11-08,Calaveras,009,45235,4204,4166,59,4225,82
2021-11-08,Colusa,011,21464,2541,2514,649,3163,19
2021-11-08,Contra Costa,013,1133247,100304,99669,2242,101911,1028
2021-11-08,Del Norte,015,27424,3707,3619,55,3674,42
2021-11-08,El Dorado,017,186661,16277,16055,1710,17765,156
2021-11-08,Fresno,019,978130,142503,140466,12977,153443,2179
2021-11-08,Glenn,021,27897,3537,3496,1021,4517,34
2021-11-08,Humboldt,023,135768,9214,9095,584,9679,109
2021-11-08,Imperial,025,180216,34125,33690,3300,36990,766
2021-11-08,Inyo,027,18085,2445,2398,41,2439,41
2021-11-08,Kern,029,883053,129447,127722,22871,150593,1692
2021-11-08,Kings,031,150075,32732,32248,1987,34235,344
2021-11-08,Lake,033,64148,6815,6737,155,6892,106
2021-11-08,Lassen,035,31185,6950,6830,396,7226,46
2021-11-08,Los Angeles,037,10098052,1448197,1438322,55390,1493712,26575
2021-11-08,Madera,039,155013,23626,23253,2176,25429,287
2021-11-08,Marin,041,260295,17741,17617,468,18085,247
2021-11-08,Mariposa,043,17540,1341,1316,50,1366,5
2021-11-08,Mendocino,045,87422,7727,7581,599,8180,85
2021-11-08,Merced,047,269075,42391,42224,2007,44231,607
2021-11-08,Modoc,049,8938,554,529,198,727,5
2021-11-08,Mono,051,14174,1751,1739,22,1761,4
2021-11-08,Monterey,053,433212,49081,47942,3006,50948,602
2021-11-08,Napa,055,140530,13133,13045,116,13161,103
2021-11-08,Nevada,057,99092,9423,9278,330,9608,92
2021-11-08,Orange,059,3164182,309617,307156,15466,322622,5616
2021-11-08,Placer,061,380077,37673,37250,3729,40979,439
2021-11-08,Plumas,063,18699,1863,1788,41,1829,7
2021-11-08,Riverside,065,2383286,366977,362201,16567,378768,5152
2021-11-08,Sacramento,067,1510023,160740,159735,4706,164441,2275
2021-11-08,San Benito,069,59416,7487,7461,173,7634,75
2021-11-08,San Bernardino,071,2135413,357733,354741,11322,366063,5836
2021-11-08,San Diego,073,3302833,378027,375557,22087,397644,4259
2021-11-08,San Francisco,075,870044,53602,52942,2373,55315,666
2021-11-08,San Joaquin,077,732212,100679,99736,5499,105235,1794
2021-11-08,San Luis Obispo,079,281455,29873,29464,1272,30736,350
2021-11-08,San Mateo,081,765935,54697,53658,899,54557,574
2021-11-08,Santa Barbara,083,443738,44872,44548,1572,46120,532
2021-11-08,Santa Clara,085,1922200,148497,147183,1402,148585,1899
2021-11-08,Santa Cruz,087,273765,20653,20435,1018,21453,222
2021-11-08,Shasta,089,179085,21837,21504,3647,25151,354
2021-11-08,Sierra,091,2930,190,183,21,204,0
2021-11-08,Siskiyou,093,43540,3368,3290,1312,4602,50
2021-11-08,Solano,095,438530,46298,45613,1291,46904,350
2021-11-08,Sonoma,097,501317,41959,41669,538,42207,395
2021-11-08,Stanislaus,099,539301,79310,79417,8965,88382,1150
2021-11-08,Sutter,101,95872,13983,13976,359,14335,180
2021-11-08,Tehama,103,63373,8645,8534,1507,10041,123
2021-11-08,Trinity,105,12862,864,743,218,961,13
2021-11-08,Tulare,107,460477,69474,68199,15432,83631,1020
2021-11-08,Tuolumne,109,53932,7384,7328,106,7434,90
2021-11-08,Ventura,111,848112,98862,98144,4342,102486,1182
2021-11-08,Yolo,113,214977,20025,19916,1165,21081,255
2021-11-08,Yuba,115,75493,10257,10172,345,10517,83
2021-11-07,Alameda,001,1643700,120508,119902,2834,122736,1444
2021-11-07,Alpine,003,1148,102,105,0,105,0
2021-11-07,Amador,005,37829,5622,5580,63,5643,66
2021-11-07,Butte,007,227075,21215,20969,3807,24776,288
2021-11-07,Calaveras,009,45235,4177,4158,58,4216,82
2021-11-07,Colusa,011,21464,2535,2511,647,3158,19
2021-11-07,Contra Costa,013,1133247,100192,99596,2233,101829,1028
2021-11-07,Del Norte,015,27424,3705,3617,55,3672,42
2021-11-07,El Dorado,017,186661,16240,16040,1707,17747,156
2021-11-07,Fresno,019,978130,142160,140263,12949,153212,2179
2021-11-07,Glenn,021,27897,3530,3493,1020,4513,34
2021-11-07,Humboldt,023,135768,9189,9074,580,9654,109
2021-11-07,Imperial,025,180216,34052,33674,3281,36955,766
2021-11-07,Inyo,027,18085,2432,2394,41,2435,41
2021-11-07,Kern,029,883053,129174,127583,22779,150362,1692
2021-11-07,Kings,031,150075,32642,32221,1984,34205,343
2021-11-07,Lake,033,64148,6799,6734,154,6888,106
2021-11-07,Lassen,035,31185,6941,6819,392,7211,46
2021-11-07,Los Angeles,037,10098052,1446707,1437314,55313,1492627,26573
2021-11-07,Madera,039,155013,23581,23225,2168,25393,287
2021-11-07,Marin,041,260295,17721,17594,467,18061,247
2021-11-07,Mariposa,043,17540,1339,1306,50,1356,5
2021-11-07,Mendocino,045,87422,7699,7567,595,8162,85
2021-11-07,Merced,047,269075,42312,42186,1976,44162,607
2021-11-07,Modoc,049,8938,551,528,197,725,5
2021-11-07,Mono,051,14174,1745,1739,22,1761,4
2021-11-07,Monterey,053,433212,49029,47924,3001,50925,602
2021-11-07,Napa,055,140530,13112,13041,116,13157,103
2021-11-07,Nevada,057,99092,9375,9254,330,9584,92
2021-11-07,Orange,059,3164182,309292,306954,15427,322381,5616
2021-11-07,Placer,061,380077,37597,37202,3714,40916,439
2021-11-07,Plumas,063,18699,1856,1787,40,1827,7
2021-11-07,Riverside,065,2383286,366442,361960,16547,378507,5152
2021-11-07,Sacramento,067,1510023,160508,159549,4689,164238,2277
2021-11-07,San Benito,069,59416,7474,7460,173,7633,75
2021-11-07,San Bernardino,071,2135413,357225,354488,11299,365787,5832
2021-11-07,San Diego,073,3302833,377439,375165,22054,397219,4250
2021-11-07,San Francisco,075,870044,53518,52868,2367,55235,666
2021-11-07,San Joaquin,077,732212,100494,99696,5493,105189,1794
2021-11-07,San Luis Obispo,079,281455,29822,29454,1268,30722,350
2021-11-07,San Mateo,081,765935,54638,53600,897,54497,574
2021-11-07,Santa Barbara,083,443738,44809,44501,1571,46072,532
2021-11-07,Santa Clara,085,1922200,148293,147054,1389,148443,1898
2021-11-07,Santa Cruz,087,273765,20595,20397,1017,21414,222
2021-11-07,Shasta,089,179085,21789,21479,3641,25120,354
2021-11-07,Sierra,091,2930,188,183,21,204,0
2021-11-07,Siskiyou,093,43540,3362,3289,1310,4599,51
2021-11-07,Solano,095,438530,46243,45582,1284,46866,350
2021-11-07,Sonoma,097,501317,41909,41630,537,42167,395
2021-11-07,Stanislaus,099,539301,79155,79351,8945,88296,1150
2021-11-07,Sutter,101,95872,13970,13964,356,14320,180
2021-11-07,Tehama,103,63373,8621,8528,1505,10033,121
2021-11-07,Trinity,105,12862,863,742,217,959,13
2021-11-07,Tulare,107,460477,69321,68145,15389,83534,1020
2021-11-07,Tuolumne,109,53932,7366,7300,104,7404,90
2021-11-07,Ventura,111,848112,98770,98085,4340,102425,1182
2021-11-07,Yolo,113,214977,20004,19899,1160,21059,255
2021-11-07,Yuba,115,75493,10240,10162,340,10502,83
2021-11-06,Alameda,001,1643700,120445,119499,2831,122330,1436
2021-11-06,Alpine,003,1148,102,105,0,105,0
2021-11-06,Amador,005,37829,5616,5557,63,5620,66
2021-11-06,Butte,007,227075,21195,20796,3803,24599,288
2021-11-06,Calaveras,009,45235,4169,4105,58,4163,82
2021-11-06,Colusa,011,21464,2534,2501,646,3147,19
2021-11-06,Contra Costa,013,1133247,100137,99282,2231,101513,1025
2021-11-06,Del Norte,015,27424,3702,3607,55,3662,42
2021-11-06,El Dorado,017,186661,16223,15958,1707,17665,156
2021-11-06,Fresno,019,978130,142041,139249,12944,152193,2170
2021-11-06,Glenn,021,27897,3527,3479,1020,4499,33
2021-11-06,Humboldt,023,135768,9177,8972,576,9548,109
2021-11-06,Imperial,025,180216,34006,33471,3275,36746,766
2021-11-06,Inyo,027,18085,2426,2353,41,2394,41
2021-11-06,Kern,029,883053,129041,126848,22726,149574,1684
2021-11-06,Kings,031,150075,32609,32018,1979,33997,342
2021-11-06,Lake,033,64148,6797,6695,154,6849,106
2021-11-06,Lassen,035,31185,6936,6796,391,7187,46
2021-11-06,Los Angeles,037,10098052,1445932,1433081,55270,1488351,26533
2021-11-06,Madera,039,155013,23545,22994,2158,25152,287
2021-11-06,Marin,041,260295,17702,17520,464,17984,247
2021-11-06,Mariposa,043,17540,1337,1282,50,1332,5
2021-11-06,Mendocino,045,87422,7677,7486,595,8081,85
2021-11-06,Merced,047,269075,42288,41958,1968,43926,604
2021-11-06,Modoc,049,8938,550,523,197,720,5
2021-11-06,Mono,051,14174,1743,1725,22,1747,4
2021-11-06,Monterey,053,433212,48997,47830,2991,50821,602
2021-11-06,Napa,055,140530,13102,12950,116,13066,103
2021-11-06,Nevada,057,99092,9353,9169,329,9498,91
2021-11-06,Orange,059,3164182,309085,306049,15401,321450,5611
2021-11-06,Placer,061,380077,37556,36967,3711,40678,438
2021-11-06,Plumas,063,18699,1852,1755,39,1794,7
2021-11-06,Riverside,065,2383286,366124,360584,16538,377122,5138
2021-11-06,Sacramento,067,1510023,160415,158766,4684,163450,2263
2021-11-06,San Benito,069,59416,7467,7429,173,7602,75
2021-11-06,San Bernardino,071,2135413,356954,353142,11295,364437,5813
2021-11-06,San Diego,073,3302833,377091,373423,22036,395459,4246
2021-11-06,San Francisco,075,870044,53465,52556,2364,54920,666
2021-11-06,San Joaquin,077,732212,100437,99372,5492,104864,1782
2021-11-06,San Luis Obispo,079,281455,29794,29335,1264,30599,350
2021-11-06,San Mateo,081,765935,54604,53442,896,54338,574
2021-11-06,Santa Barbara,083,443738,44773,44301,1570,45871,532
2021-11-06,Santa Clara,085,1922200,148148,146519,1384,147903,1894
2021-11-06,Santa Cruz,087,273765,20576,20311,1015,21326,222
2021-11-06,Shasta,089,179085,21770,21281,3636,24917,349
2021-11-06,Sierra,091,2930,188,181,21,202,0
2021-11-06,Siskiyou,093,43540,3362,3279,1308,4587,48
2021-11-06,Solano,095,438530,46213,45465,1283,46748,350
2021-11-06,Sonoma,097,501317,41859,41398,536,41934,395
2021-11-06,Stanislaus,099,539301,79087,78902,8937,87839,1193
2021-11-06,Sutter,101,95872,13966,13908,355,14263,180
2021-11-06,Tehama,103,63373,8610,8474,1503,9977,120
2021-11-06,Trinity,105,12862,860,732,217,949,11
2021-11-06,Tulare,107,460477,69271,67767,15360,83127,1010
2021-11-06,Tuolumne,109,53932,7353,7245,104,7349,90
2021-11-06,Ventura,111,848112,98704,97770,4335,102105,1180
2021-11-06,Yolo,113,214977,19987,19827,1156,20983,255
2021-11-06,Yuba,115,75493,10226,10107,340,10447,83
2021-11-05,Alameda,001,1643700,120362,119499,2829,122328,1436
2021-11-05,Alpine,003,1148,102,105,0,105,0
2021-11-05,Amador,005,37829,5611,5557,63,5620,66
2021-11-05,Butte,007,227075,21182,20796,3802,24598,288
2021-11-05,Calaveras,009,45235,4164,4105,58,4163,82
2021-11-05,Colusa,011,21464,2534,2501,645,3146,19
2021-11-05,Contra Costa,013,1133247,100072,99282,2229,101511,1025
2021-11-05,Del Norte,015,27424,3700,3607,55,3662,42
2021-11-05,El Dorado,017,186661,16205,15958,1701,17659,156
2021-11-05,Fresno,019,978130,141863,139249,12934,152183,2170
2021-11-05,Glenn,021,27897,3527,3479,1019,4498,33
2021-11-05,Humboldt,023,135768,9163,8972,576,9548,109
2021-11-05,Imperial,025,180216,33971,33471,3272,36743,766
2021-11-05,Inyo,027,18085,2418,2353,41,2394,41
2021-11-05,Kern,029,883053,128914,126848,22670,149518,1684
2021-11-05,Kings,031,150075,32585,32018,1978,33996,342
2021-11-05,Lake,033,64148,6791,6695,154,6849,106
2021-11-05,Lassen,035,31185,6932,6796,390,7186,46
2021-11-05,Los Angeles,037,10098052,1445113,1433081,55232,1488313,26533
2021-11-05,Madera,039,155013,23507,22994,2157,25151,287
2021-11-05,Marin,041,260295,17680,17520,463,17983,247
2021-11-05,Mariposa,043,17540,1334,1282,49,1331,5
2021-11-05,Mendocino,045,87422,7666,7486,594,8080,85
2021-11-05,Merced,047,269075,42262,41958,1959,43917,604
2021-11-05,Modoc,049,8938,550,523,197,720,5
2021-11-05,Mono,051,14174,1742,1725,22,1747,4
2021-11-05,Monterey,053,433212,48967,47830,2989,50819,602
2021-11-05,Napa,055,140530,13080,12950,116,13066,103
2021-11-05,Nevada,057,99092,9340,9169,329,9498,91
2021-11-05,Orange,059,3164182,308887,306049,15379,321428,5611
2021-11-05,Placer,061,380077,37529,36967,3701,40668,438
2021-11-05,Plumas,063,18699,1844,1755,39,1794,7
2021-11-05,Riverside,065,2383286,365783,360584,16528,377112,5138
2021-11-05,Sacramento,067,1510023,160293,158766,4678,163444,2263
2021-11-05,San Benito,069,59416,7465,7429,172,7601,75
2021-11-05,San Bernardino,071,2135413,356623,353142,11284,364426,5813
2021-11-05,San Diego,073,3302833,376726,373423,22024,395447,4246
2021-11-05,San Francisco,075,870044,53414,52556,2361,54917,666
2021-11-05,San Joaquin,077,732212,100384,99372,5483,104855,1782
2021-11-05,San Luis Obispo,079,281455,29771,29335,1264,30599,350
2021-11-05,San Mateo,081,765935,54562,53442,894,54336,574
2021-11-05,Santa Barbara,083,443738,44728,44301,1569,45870,532
2021-11-05,Santa Clara,085,1922200,148010,146519,1383,147902,1894
2021-11-05,Santa Cruz,087,273765,20552,20311,1014,21325,222
2021-11-05,Shasta,089,179085,21738,21281,3631,24912,349
2021-11-05,Sierra,091,2930,188,181,21,202,0
2021-11-05,Siskiyou,093,43540,3357,3279,1307,4586,48
2021-11-05,Solano,095,438530,46168,45465,1280,46745,350
2021-11-05,Sonoma,097,501317,41819,41398,536,41934,395
2021-11-05,Stanislaus,099,539301,79029,78902,8925,87827,1193
2021-11-05,Sutter,101,95872,13958,13908,354,14262,180
2021-11-05,Tehama,103,63373,8603,8474,1502,9976,120
2021-11-05,Trinity,105,12862,860,732,217,949,11
2021-11-05,Tulare,107,460477,69198,67767,15324,83091,1010
2021-11-05,Tuolumne,109,53932,7336,7245,103,7348,90
2021-11-05,Ventura,111,848112,98664,97770,4332,102102,1180
2021-11-05,Yolo,113,214977,19976,19827,1155,20982,255
2021-11-05,Yuba,115,75493,10213,10107,338,10445,83
2021-11-04,Alameda,001,1643700,120245,119499,2823,122322,1436
2021-11-04,Alpine,003,1148,102,105,0,105,0
2021-11-04,Amador,005,37829,5603,5557,63,5620,66
2021-11-04,Butte,007,227075,21140,20796,3792,24588,288
2021-11-04,Calaveras,009,45235,4150,4105,56,4161,82
2021-11-04,Colusa,011,21464,2528,2501,644,3145,19
2021-11-04,Contra Costa,013,1133247,99980,99282,2224,101506,1025
2021-11-04,Del Norte,015,27424,3697,3607,55,3662,42
2021-11-04,El Dorado,017,186661,16179,15958,1697,17655,156
2021-11-04,Fresno,019,978130,141581,139249,12925,152174,2170
2021-11-04,Glenn,021,27897,3522,3479,1018,4497,33
2021-11-04,Humboldt,023,135768,9138,8972,573,9545,109
2021-11-04,Imperial,025,180216,33913,33471,3263,36734,766
2021-11-04,Inyo,027,18085,2410,2353,41,2394,41
2021-11-04,Kern,029,883053,128682,126848,22602,149450,1684
2021-11-04,Kings,031,150075,32506,32018,1968,33986,342
2021-11-04,Lake,033,64148,6781,6695,152,6847,106
2021-11-04,Lassen,035,31185,6922,6796,385,7181,46
2021-11-04,Los Angeles,037,10098052,1443816,1433081,55148,1488229,26533
2021-11-04,Madera,039,155013,23452,22994,2146,25140,287
2021-11-04,Marin,041,260295,17668,17520,461,17981,247
2021-11-04,Mariposa,043,17540,1327,1282,49,1331,5
2021-11-04,Mendocino,045,87422,7653,7486,588,8074,85
2021-11-04,Merced,047,269075,42207,41958,1955,43913,604
2021-11-04,Modoc,049,8938,549,523,197,720,5
2021-11-04,Mono,051,14174,1737,1725,22,1747,4
2021-11-04,Monterey,053,433212,48922,47830,2973,50803,602
2021-11-04,Napa,055,140530,13059,12950,116,13066,103
2021-11-04,Nevada,057,99092,9309,9169,328,9497,91
2021-11-04,Orange,059,3164182,308639,306049,15360,321409,5611
2021-11-04,Placer,061,380077,37458,36967,3692,40659,438
2021-11-04,Plumas,063,18699,1836,1755,35,1790,7
2021-11-04,Riverside,065,2383286,365387,360584,16519,377103,5138
2021-11-04,Sacramento,067,1510023,160059,158766,4657,163423,2263
2021-11-04,San Benito,069,59416,7459,7429,172,7601,75
2021-11-04,San Bernardino,071,2135413,356188,353142,11276,364418,5813
2021-11-04,San Diego,073,3302833,376245,373423,22003,395426,4246
2021-11-04,San Francisco,075,870044,53333,52556,2357,54913,666
2021-11-04,San Joaquin,077,732212,100276,99372,5471,104843,1782
2021-11-04,San Luis Obispo,079,281455,29747,29335,1258,30593,350
2021-11-04,San Mateo,081,765935,54503,53442,888,54330,574
2021-11-04,Santa Barbara,083,443738,44672,44301,1569,45870,532
2021-11-04,Santa Clara,085,1922200,147856,146519,1379,147898,1894
2021-11-04,Santa Cruz,087,273765,20517,20311,1014,21325,222
2021-11-04,Shasta,089,179085,21680,21281,3625,24906,349
2021-11-04,Sierra,091,2930,186,181,21,202,0
2021-11-04,Siskiyou,093,43540,3354,3279,1300,4579,48
2021-11-04,Solano,095,438530,46126,45465,1279,46744,350
2021-11-04,Sonoma,097,501317,41759,41398,536,41934,395
2021-11-04,Stanislaus,099,539301,78891,78902,8919,87821,1193
2021-11-04,Sutter,101,95872,13947,13908,352,14260,180
2021-11-04,Tehama,103,63373,8594,8474,1498,9972,120
2021-11-04,Trinity,105,12862,859,732,217,949,11
2021-11-04,Tulare,107,460477,69082,67767,15278,83045,1010
2021-11-04,Tuolumne,109,53932,7314,7245,101,7346,90
2021-11-04,Ventura,111,848112,98576,97770,4329,102099,1180
2021-11-04,Yolo,113,214977,19951,19827,1149,20976,255
2021-11-04,Yuba,115,75493,10199,10107,336,10443,83
2021-11-03,Alameda,001,1643700,120104,119356,2819,122175,1428
2021-11-03,Alpine,003,1148,102,105,0,105,0
2021-11-03,Amador,005,37829,5597,5545,62,5607,66
2021-11-03,Butte,007,227075,21095,20769,3783,24552,284
2021-11-03,Calaveras,009,45235,4132,4087,55,4142,82
2021-11-03,Colusa,011,21464,2522,2499,644,3143,20
2021-11-03,Contra Costa,013,1133247,99880,99168,2219,101387,1025
2021-11-03,Del Norte,015,27424,3695,3600,54,3654,42
2021-11-03,El Dorado,017,186661,16153,15915,1694,17609,156
2021-11-03,Fresno,019,978130,141217,138873,12901,151774,2166
2021-11-03,Glenn,021,27897,3518,3470,1018,4488,33
2021-11-03,Humboldt,023,135768,9121,8949,568,9517,109
2021-11-03,Imperial,025,180216,33842,33402,3253,36655,766
2021-11-03,Inyo,027,18085,2389,2344,41,2385,41
2021-11-03,Kern,029,883053,128422,126523,22500,149023,1681
2021-11-03,Kings,031,150075,32451,31923,1961,33884,341
2021-11-03,Lake,033,64148,6765,6685,152,6837,106
2021-11-03,Lassen,035,31185,6906,6782,380,7162,46
2021-11-03,Los Angeles,037,10098052,1442467,1431209,55063,1486272,26517
2021-11-03,Madera,039,155013,23385,22893,2137,25030,287
2021-11-03,Marin,041,260295,17647,17491,457,17948,247
2021-11-03,Mariposa,043,17540,1317,1276,49,1325,5
2021-11-03,Mendocino,045,87422,7637,7457,580,8037,84
2021-11-03,Merced,047,269075,42146,41849,1945,43794,597
2021-11-03,Modoc,049,8938,549,521,195,716,5
2021-11-03,Mono,051,14174,1733,1719,22,1741,4
2021-11-03,Monterey,053,433212,48873,47794,2960,50754,601
2021-11-03,Napa,055,140530,13047,12937,115,13052,103
2021-11-03,Nevada,057,99092,9282,9131,327,9458,91
2021-11-03,Orange,059,3164182,308328,305661,15327,320988,5607
2021-11-03,Placer,061,380077,37388,36868,3687,40555,438
2021-11-03,Plumas,063,18699,1825,1739,34,1773,7
2021-11-03,Riverside,065,2383286,364929,360060,16515,376575,5131
2021-11-03,Sacramento,067,1510023,159835,158311,4646,162957,2259
2021-11-03,San Benito,069,59416,7451,7419,172,7591,75
2021-11-03,San Bernardino,071,2135413,355712,352225,11256,363481,5813
2021-11-03,San Diego,073,3302833,375734,372951,21980,394931,4241
2021-11-03,San Francisco,075,870044,53240,52493,2352,54845,663
2021-11-03,San Joaquin,077,732212,100164,99188,5460,104648,1776
2021-11-03,San Luis Obispo,079,281455,29705,29276,1252,30528,348
2021-11-03,San Mateo,081,765935,54439,53396,882,54278,571
2021-11-03,Santa Barbara,083,443738,44615,44220,1566,45786,531
2021-11-03,Santa Clara,085,1922200,147686,146259,1372,147631,1897
2021-11-03,Santa Cruz,087,273765,20482,20275,1014,21289,222
2021-11-03,Shasta,089,179085,21622,21215,3618,24833,346
2021-11-03,Sierra,091,2930,184,180,21,201,0
2021-11-03,Siskiyou,093,43540,3350,3276,1298,4574,46
2021-11-03,Solano,095,438530,46099,45411,1277,46688,351
2021-11-03,Sonoma,097,501317,41682,41326,534,41860,395
2021-11-03,Stanislaus,099,539301,78760,78736,8903,87639,1193
2021-11-03,Sutter,101,95872,13934,13876,350,14226,179
2021-11-03,Tehama,103,63373,8582,8438,1498,9936,118
2021-11-03,Trinity,105,12862,858,730,217,947,11
2021-11-03,Tulare,107,460477,68954,67588,15235,82823,1007
2021-11-03,Tuolumne,109,53932,7297,7218,99,7317,90
2021-11-03,Ventura,111,848112,98467,97682,4325,102007,1178
2021-11-03,Yolo,113,214977,19933,19758,1141,20899,250
2021-11-03,Yuba,115,75493,10187,10092,336,10428,83
2021-11-02,Alameda,001,1643700,119958,119241,2813,122054,1425
2021-11-02,Alpine,003,1148,101,105,0,105,0
2021-11-02,Amador,005,37829,5592,5535,62,5597,66
2021-11-02,Butte,007,227075,21051,20744,3772,24516,282
2021-11-02,Calaveras,009,45235,4109,4075,55,4130,82
2021-11-02,Colusa,011,21464,2517,2497,643,3140,19
2021-11-02,Contra Costa,013,1133247,99777,99080,2207,101287,1025
2021-11-02,Del Norte,015,27424,3693,3596,54,3650,42
2021-11-02,El Dorado,017,186661,16124,15883,1694,17577,154
2021-11-02,Fresno,019,978130,140896,138644,12870,151514,2158
2021-11-02,Glenn,021,27897,3510,3469,1015,4484,33
2021-11-02,Humboldt,023,135768,9079,8937,567,9504,109
2021-11-02,Imperial,025,180216,33769,33371,3241,36612,766
2021-11-02,Inyo,027,18085,2382,2324,41,2365,41
2021-11-02,Kern,029,883053,128167,126311,22378,148689,1665
2021-11-02,Kings,031,150075,32392,31896,1956,33852,339
2021-11-02,Lake,033,64148,6760,6681,151,6832,106
2021-11-02,Lassen,035,31185,6894,6777,377,7154,45
2021-11-02,Los Angeles,037,10098052,1441013,1429601,54987,1484588,26496
2021-11-02,Madera,039,155013,23304,22837,2126,24963,287
2021-11-02,Marin,041,260295,17619,17482,457,17939,247
2021-11-02,Mariposa,043,17540,1306,1270,48,1318,5
2021-11-02,Mendocino,045,87422,7613,7447,568,8015,84
2021-11-02,Merced,047,269075,42079,41785,1937,43722,596
2021-11-02,Modoc,049,8938,546,520,194,714,5
2021-11-02,Mono,051,14174,1729,1718,22,1740,4
2021-11-02,Monterey,053,433212,48822,47775,2942,50717,599
2021-11-02,Napa,055,140530,13029,12930,115,13045,104
2021-11-02,Nevada,057,99092,9252,9122,326,9448,91
2021-11-02,Orange,059,3164182,308012,305369,15280,320649,5600
2021-11-02,Placer,061,380077,37316,36817,3672,40489,438
2021-11-02,Plumas,063,18699,1814,1721,34,1755,7
2021-11-02,Riverside,065,2383286,364477,359586,16495,376081,5116
2021-11-02,Sacramento,067,1510023,159580,158112,4623,162735,2250
2021-11-02,San Benito,069,59416,7435,7407,172,7579,75
2021-11-02,San Bernardino,071,2135413,355238,351832,11203,363035,5813
2021-11-02,San Diego,073,3302833,375139,372440,21950,394390,4232
2021-11-02,San Francisco,075,870044,53121,52450,2348,54798,663
2021-11-02,San Joaquin,077,732212,100029,99076,5449,104525,1772
2021-11-02,San Luis Obispo,079,281455,29672,29224,1248,30472,348
2021-11-02,San Mateo,081,765935,54367,53351,879,54230,571
2021-11-02,Santa Barbara,083,443738,44559,44177,1563,45740,531
2021-11-02,Santa Clara,085,1922200,147492,146115,1365,147480,1896
2021-11-02,Santa Cruz,087,273765,20449,20266,1013,21279,222
2021-11-02,Shasta,089,179085,21548,21127,3608,24735,344
2021-11-02,Sierra,091,2930,184,180,20,200,0
2021-11-02,Siskiyou,093,43540,3348,3272,1295,4567,46
2021-11-02,Solano,095,438530,46059,45378,1271,46649,350
2021-11-02,Sonoma,097,501317,41601,41288,533,41821,395
2021-11-02,Stanislaus,099,539301,78605,78629,8883,87512,1193
2021-11-02,Sutter,101,95872,13913,13868,350,14218,179
2021-11-02,Tehama,103,63373,8566,8422,1495,9917,116
2021-11-02,Trinity,105,12862,858,729,217,946,11
2021-11-02,Tulare,107,460477,68829,67502,15186,82688,1002
2021-11-02,Tuolumne,109,53932,7276,7204,97,7301,90
2021-11-02,Ventura,111,848112,98362,97574,4321,101895,1178
2021-11-02,Yolo,113,214977,19902,19736,1139,20875,250
2021-11-02,Yuba,115,75493,10164,10080,334,10414,83
2021-11-01,Alameda,001,1643700,119818,119159,2810,121969,1421
2021-11-01,Alpine,003,1148,101,105,0,105,0
2021-11-01,Amador,005,37829,5590,5532,62,5594,64
2021-11-01,Butte,007,227075,21001,20710,3767,24477,281
2021-11-01,Calaveras,009,45235,4099,4059,54,4113,82
2021-11-01,Colusa,011,21464,2515,2494,640,3134,19
2021-11-01,Contra Costa,013,1133247,99652,99011,2199,101210,1025
2021-11-01,Del Norte,015,27424,3691,3594,54,3648,42
2021-11-01,El Dorado,017,186661,16100,15858,1688,17546,154
2021-11-01,Fresno,019,978130,140520,138421,12833,151254,2149
2021-11-01,Glenn,021,27897,3503,3461,1013,4474,33
2021-11-01,Humboldt,023,135768,9051,8929,563,9492,108
2021-11-01,Imperial,025,180216,33718,33342,3232,36574,766
2021-11-01,Inyo,027,18085,2370,2307,41,2348,41
2021-11-01,Kern,029,883053,127867,126092,22263,148355,1660
2021-11-01,Kings,031,150075,32339,31866,1953,33819,337
2021-11-01,Lake,033,64148,6749,6676,150,6826,106
2021-11-01,Lassen,035,31185,6879,6775,374,7149,42
2021-11-01,Los Angeles,037,10098052,1439624,1428891,54895,1483786,26483
2021-11-01,Madera,039,155013,23225,22801,2121,24922,283
2021-11-01,Marin,041,260295,17599,17460,456,17916,247
2021-11-01,Mariposa,043,17540,1298,1266,47,1313,5
2021-11-01,Mendocino,045,87422,7580,7422,550,7972,84
2021-11-01,Merced,047,269075,41989,41740,1935,43675,594
2021-11-01,Modoc,049,8938,541,520,192,712,5
2021-11-01,Mono,051,14174,1725,1714,22,1736,3
2021-11-01,Monterey,053,433212,48779,47756,2930,50686,597
2021-11-01,Napa,055,140530,13002,12916,114,13030,101
2021-11-01,Nevada,057,99092,9229,9108,325,9433,91
2021-11-01,Orange,059,3164182,307670,305192,15238,320430,5596
2021-11-01,Placer,061,380077,37233,36747,3660,40407,435
2021-11-01,Plumas,063,18699,1795,1719,34,1753,7
2021-11-01,Riverside,065,2383286,363975,359263,16473,375736,5115
2021-11-01,Sacramento,067,1510023,159308,157893,4599,162492,2239
2021-11-01,San Benito,069,59416,7425,7406,171,7577,73
2021-11-01,San Bernardino,071,2135413,354751,351620,11182,362802,5815
2021-11-01,San Diego,073,3302833,374554,372043,21932,393975,4232
2021-11-01,San Francisco,075,870044,53036,52418,2341,54759,661
2021-11-01,San Joaquin,077,732212,99866,98969,5442,104411,1772
2021-11-01,San Luis Obispo,079,281455,29628,29199,1243,30442,343
2021-11-01,San Mateo,081,765935,54300,53314,875,54189,571
2021-11-01,Santa Barbara,083,443738,44492,44146,1559,45705,529
2021-11-01,Santa Clara,085,1922200,147295,145978,1360,147338,1907
2021-11-01,Santa Cruz,087,273765,20414,20238,1013,21251,221
2021-11-01,Shasta,089,179085,21495,21104,3601,24705,338
2021-11-01,Sierra,091,2930,184,180,20,200,0
2021-11-01,Siskiyou,093,43540,3341,3272,1290,4562,46
2021-11-01,Solano,095,438530,46005,45358,1271,46629,350
2021-11-01,Sonoma,097,501317,41528,41234,532,41766,395
2021-11-01,Stanislaus,099,539301,78476,78534,8868,87402,1193
2021-11-01,Sutter,101,95872,13889,13852,348,14200,179
2021-11-01,Tehama,103,63373,8538,8412,1492,9904,116
2021-11-01,Trinity,105,12862,856,727,217,944,11
2021-11-01,Tulare,107,460477,68685,67388,15133,82521,1002
2021-11-01,Tuolumne,109,53932,7260,7175,96,7271,90
2021-11-01,Ventura,111,848112,98272,97507,4319,101826,1178
2021-11-01,Yolo,113,214977,19882,19708,1132,20840,250
2021-11-01,Yuba,115,75493,10146,10066,332,10398,83
2021-10-31,Alameda,001,1643700,119673,119071,2807,121878,1419
2021-10-31,Alpine,003,1148,101,105,0,105,0
2021-10-31,Amador,005,37829,5579,5518,62,5580,64
2021-10-31,Butte,007,227075,20940,20689,3758,24447,281
2021-10-31,Calaveras,009,45235,4081,4052,53,4105,82
2021-10-31,Colusa,011,21464,2513,2493,637,3130,18
2021-10-31,Contra Costa,013,1133247,99524,98936,2196,101132,1025
2021-10-31,Del Norte,015,27424,3685,3591,54,3645,42
2021-10-31,El Dorado,017,186661,16054,15841,1685,17526,154
2021-10-31,Fresno,019,978130,140113,138165,12796,150961,2147
2021-10-31,Glenn,021,27897,3498,3459,1013,4472,33
2021-10-31,Humboldt,023,135768,9003,8919,557,9476,108
2021-10-31,Imperial,025,180216,33643,33334,3220,36554,766
2021-10-31,Inyo,027,18085,2351,2309,41,2350,41
2021-10-31,Kern,029,883053,127498,125917,22138,148055,1666
2021-10-31,Kings,031,150075,32253,31814,1941,33755,338
2021-10-31,Lake,033,64148,6738,6665,148,6813,106
2021-10-31,Lassen,035,31185,6864,6768,369,7137,42
2021-10-31,Los Angeles,037,10098052,1438077,1427933,54810,1482743,26474
2021-10-31,Madera,039,155013,23130,22744,2108,24852,283
2021-10-31,Marin,041,260295,17571,17443,455,17898,247
2021-10-31,Mariposa,043,17540,1292,1257,46,1303,5
2021-10-31,Mendocino,045,87422,7539,7403,533,7936,84
2021-10-31,Merced,047,269075,41895,41699,1915,43614,589
2021-10-31,Modoc,049,8938,535,517,189,706,5
2021-10-31,Mono,051,14174,1721,1711,22,1733,3
2021-10-31,Monterey,053,433212,48738,47744,2912,50656,596
2021-10-31,Napa,055,140530,12985,12906,112,13018,101
2021-10-31,Nevada,057,99092,9192,9084,320,9404,91
2021-10-31,Orange,059,3164182,307321,305032,15155,320187,5596
2021-10-31,Placer,061,380077,37136,36698,3646,40344,435
2021-10-31,Plumas,063,18699,1777,1716,34,1750,7
2021-10-31,Riverside,065,2383286,363396,359005,16459,375464,5104
2021-10-31,Sacramento,067,1510023,158956,157667,4584,162251,2243
2021-10-31,San Benito,069,59416,7416,7397,169,7566,73
2021-10-31,San Bernardino,071,2135413,354219,351411,11168,362579,5810
2021-10-31,San Diego,073,3302833,373980,371603,21901,393504,4218
2021-10-31,San Francisco,075,870044,52928,52370,2335,54705,661
2021-10-31,San Joaquin,077,732212,99702,98893,5428,104321,1772
2021-10-31,San Luis Obispo,079,281455,29574,29176,1242,30418,343
2021-10-31,San Mateo,081,765935,54241,53284,873,54157,571
2021-10-31,Santa Barbara,083,443738,44422,44113,1554,45667,529
2021-10-31,Santa Clara,085,1922200,147080,145829,1346,147175,1908
2021-10-31,Santa Cruz,087,273765,20379,20218,1012,21230,221
2021-10-31,Shasta,089,179085,21412,21086,3589,24675,338
2021-10-31,Sierra,091,2930,184,180,20,200,0
2021-10-31,Siskiyou,093,43540,3335,3271,1289,4560,46
2021-10-31,Solano,095,438530,45957,45310,1264,46574,350
2021-10-31,Sonoma,097,501317,41458,41183,529,41712,395
2021-10-31,Stanislaus,099,539301,78286,78426,8853,87279,1193
2021-10-31,Sutter,101,95872,13870,13838,345,14183,179
2021-10-31,Tehama,103,63373,8507,8391,1488,9879,116
2021-10-31,Trinity,105,12862,856,724,217,941,11
2021-10-31,Tulare,107,460477,68491,67310,15042,82352,1002
2021-10-31,Tuolumne,109,53932,7231,7141,95,7236,90
2021-10-31,Ventura,111,848112,98151,97460,4314,101774,1178
2021-10-31,Yolo,113,214977,19838,19662,1126,20788,250
2021-10-31,Yuba,115,75493,10128,10051,322,10373,83
2021-10-30,Alameda,001,1643700,119613,118632,2804,121436,1419
2021-10-30,Alpine,003,1148,101,105,0,105,0
2021-10-30,Amador,005,37829,5570,5480,61,5541,64
2021-10-30,Butte,007,227075,20925,20516,3752,24268,277
2021-10-30,Calaveras,009,45235,4074,3992,53,4045,82
2021-10-30,Colusa,011,21464,2513,2484,636,3120,19
2021-10-30,Contra Costa,013,1133247,99461,98562,2195,100757,1024
2021-10-30,Del Norte,015,27424,3682,3574,54,3628,42
2021-10-30,El Dorado,017,186661,16038,15752,1680,17432,154
2021-10-30,Fresno,019,978130,139968,136901,12784,149685,2131
2021-10-30,Glenn,021,27897,3494,3442,1013,4455,33
2021-10-30,Humboldt,023,135768,8988,8871,555,9426,105
2021-10-30,Imperial,025,180216,33598,33156,3216,36372,766
2021-10-30,Inyo,027,18085,2348,2249,41,2290,41
2021-10-30,Kern,029,883053,127344,124892,22067,146959,1653
2021-10-30,Kings,031,150075,32219,31578,1937,33515,337
2021-10-30,Lake,033,64148,6733,6610,148,6758,106
2021-10-30,Lassen,035,31185,6858,6719,367,7086,42
2021-10-30,Los Angeles,037,10098052,1437352,1424257,54757,1479014,26625
2021-10-30,Madera,039,155013,23086,22524,2103,24627,283
2021-10-30,Marin,041,260295,17556,17380,453,17833,247
2021-10-30,Mariposa,043,17540,1289,1228,46,1274,5
2021-10-30,Mendocino,045,87422,7516,7338,531,7869,84
2021-10-30,Merced,047,269075,41856,41428,1913,43341,586
2021-10-30,Modoc,049,8938,533,513,188,701,5
2021-10-30,Mono,051,14174,1721,1684,22,1706,3
2021-10-30,Monterey,053,433212,48721,47649,2906,50555,588
2021-10-30,Napa,055,140530,12971,12863,111,12974,101
2021-10-30,Nevada,057,99092,9173,9015,320,9335,91
2021-10-30,Orange,059,3164182,307142,304120,15133,319253,5588
2021-10-30,Placer,061,380077,37090,36400,3640,40040,434
2021-10-30,Plumas,063,18699,1772,1695,34,1729,7
2021-10-30,Riverside,065,2383286,363096,357645,16450,374095,5088
2021-10-30,Sacramento,067,1510023,158797,157125,4575,161700,2233
2021-10-30,San Benito,069,59416,7409,7362,169,7531,71
2021-10-30,San Bernardino,071,2135413,353942,350076,11154,361230,5777
2021-10-30,San Diego,073,3302833,373606,370006,21879,391885,4213
2021-10-30,San Francisco,075,870044,52899,52161,2333,54494,661
2021-10-30,San Joaquin,077,732212,99646,98314,5427,103741,1768
2021-10-30,San Luis Obispo,079,281455,29542,29053,1239,30292,341
2021-10-30,San Mateo,081,765935,54202,53083,873,53956,571
2021-10-30,Santa Barbara,083,443738,44387,43972,1553,45525,528
2021-10-30,Santa Clara,085,1922200,146975,145262,1342,146604,1903
2021-10-30,Santa Cruz,087,273765,20361,20134,1010,21144,221
2021-10-30,Shasta,089,179085,21368,20878,3583,24461,332
2021-10-30,Sierra,091,2930,184,175,20,195,0
2021-10-30,Siskiyou,093,43540,3334,3257,1286,4543,46
2021-10-30,Solano,095,438530,45936,45146,1262,46408,346
2021-10-30,Sonoma,097,501317,41419,40924,529,41453,393
2021-10-30,Stanislaus,099,539301,78216,77871,8846,86717,1191
2021-10-30,Sutter,101,95872,13857,13773,345,14118,178
2021-10-30,Tehama,103,63373,8496,8307,1483,9790,114
2021-10-30,Trinity,105,12862,854,708,216,924,11
2021-10-30,Tulare,107,460477,68420,66745,14995,81740,995
2021-10-30,Tuolumne,109,53932,7207,7050,94,7144,90
2021-10-30,Ventura,111,848112,98102,97182,4311,101493,1174
2021-10-30,Yolo,113,214977,19819,19568,1124,20692,250
2021-10-30,Yuba,115,75493,10117,9969,322,10291,82
2021-10-29,Alameda,001,1643700,119534,118632,2799,121431,1419
2021-10-29,Alpine,003,1148,101,105,0,105,0
2021-10-29,Amador,005,37829,5559,5480,61,5541,64
2021-10-29,Butte,007,227075,20901,20516,3742,24258,277
2021-10-29,Calaveras,009,45235,4067,3992,53,4045,82
2021-10-29,Colusa,011,21464,2513,2484,634,3118,19
2021-10-29,Contra Costa,013,1133247,99394,98562,2193,100755,1024
2021-10-29,Del Norte,015,27424,3675,3574,54,3628,42
2021-10-29,El Dorado,017,186661,16024,15752,1680,17432,154
2021-10-29,Fresno,019,978130,139753,136901,12769,149670,2131
2021-10-29,Glenn,021,27897,3493,3442,1012,4454,33
2021-10-29,Humboldt,023,135768,8983,8871,554,9425,105
2021-10-29,Imperial,025,180216,33571,33156,3213,36369,766
2021-10-29,Inyo,027,18085,2345,2249,41,2290,41
2021-10-29,Kern,029,883053,127167,124892,21977,146869,1653
2021-10-29,Kings,031,150075,32185,31578,1935,33513,337
2021-10-29,Lake,033,64148,6724,6610,145,6755,106
2021-10-29,Lassen,035,31185,6849,6719,364,7083,42
2021-10-29,Los Angeles,037,10098052,1436506,1424257,54713,1478970,26625
2021-10-29,Madera,039,155013,23034,22524,2098,24622,283
2021-10-29,Marin,041,260295,17540,17380,452,17832,247
2021-10-29,Mariposa,043,17540,1285,1228,46,1274,5
2021-10-29,Mendocino,045,87422,7508,7338,531,7869,84
2021-10-29,Merced,047,269075,41806,41428,1907,43335,586
2021-10-29,Modoc,049,8938,531,513,187,700,5
2021-10-29,Mono,051,14174,1719,1684,22,1706,3
2021-10-29,Monterey,053,433212,48698,47649,2906,50555,588
2021-10-29,Napa,055,140530,12950,12863,111,12974,101
2021-10-29,Nevada,057,99092,9161,9015,320,9335,91
2021-10-29,Orange,059,3164182,306917,304120,15113,319233,5588
2021-10-29,Placer,061,380077,37054,36400,3629,40029,434
2021-10-29,Plumas,063,18699,1766,1695,34,1729,7
2021-10-29,Riverside,065,2383286,362762,357645,16445,374090,5088
2021-10-29,Sacramento,067,1510023,158608,157125,4566,161691,2233
2021-10-29,San Benito,069,59416,7406,7362,169,7531,71
2021-10-29,San Bernardino,071,2135413,353644,350076,11145,361221,5777
2021-10-29,San Diego,073,3302833,373230,370006,21851,391857,4213
2021-10-29,San Francisco,075,870044,52839,52161,2327,54488,661
2021-10-29,San Joaquin,077,732212,99589,98314,5422,103736,1768
2021-10-29,San Luis Obispo,079,281455,29516,29053,1237,30290,341
2021-10-29,San Mateo,081,765935,54159,53083,871,53954,571
2021-10-29,Santa Barbara,083,443738,44347,43972,1550,45522,528
2021-10-29,Santa Clara,085,1922200,146860,145262,1335,146597,1903
2021-10-29,Santa Cruz,087,273765,20354,20134,1009,21143,221
2021-10-29,Shasta,089,179085,21329,20878,3577,24455,332
2021-10-29,Sierra,091,2930,182,175,20,195,0
2021-10-29,Siskiyou,093,43540,3334,3257,1285,4542,46
2021-10-29,Solano,095,438530,45899,45146,1261,46407,346
2021-10-29,Sonoma,097,501317,41398,40924,529,41453,393
2021-10-29,Stanislaus,099,539301,78130,77871,8835,86706,1191
2021-10-29,Sutter,101,95872,13838,13773,345,14118,178
2021-10-29,Tehama,103,63373,8483,8307,1482,9789,114
2021-10-29,Trinity,105,12862,853,708,216,924,11
2021-10-29,Tulare,107,460477,68315,66745,14950,81695,995
2021-10-29,Tuolumne,109,53932,7194,7050,94,7144,90
2021-10-29,Ventura,111,848112,98047,97182,4307,101489,1174
2021-10-29,Yolo,113,214977,19801,19568,1119,20687,250
2021-10-29,Yuba,115,75493,10109,9969,318,10287,82
2021-10-28,Alameda,001,1643700,119410,118632,2792,121424,1419
2021-10-28,Alpine,003,1148,101,105,0,105,0
2021-10-28,Amador,005,37829,5546,5480,61,5541,64
2021-10-28,Butte,007,227075,20858,20516,3733,24249,277
2021-10-28,Calaveras,009,45235,4054,3992,53,4045,82
2021-10-28,Colusa,011,21464,2510,2484,633,3117,19
2021-10-28,Contra Costa,013,1133247,99264,98562,2188,100750,1024
2021-10-28,Del Norte,015,27424,3674,3574,54,3628,42
2021-10-28,El Dorado,017,186661,15998,15752,1677,17429,154
2021-10-28,Fresno,019,978130,139419,136901,12736,149637,2131
2021-10-28,Glenn,021,27897,3490,3442,1010,4452,33
2021-10-28,Humboldt,023,135768,8967,8871,549,9420,105
2021-10-28,Imperial,025,180216,33506,33156,3207,36363,766
2021-10-28,Inyo,027,18085,2328,2249,41,2290,41
2021-10-28,Kern,029,883053,126920,124892,21863,146755,1653
2021-10-28,Kings,031,150075,32116,31578,1930,33508,337
2021-10-28,Lake,033,64148,6714,6610,145,6755,106
2021-10-28,Lassen,035,31185,6839,6719,360,7079,42
2021-10-28,Los Angeles,037,10098052,1435364,1424257,54640,1478897,26625
2021-10-28,Madera,039,155013,22980,22524,2087,24611,283
2021-10-28,Marin,041,260295,17522,17380,451,17831,247
2021-10-28,Mariposa,043,17540,1281,1228,46,1274,5
2021-10-28,Mendocino,045,87422,7495,7338,520,7858,84
2021-10-28,Merced,047,269075,41721,41428,1895,43323,586
2021-10-28,Modoc,049,8938,530,513,187,700,5
2021-10-28,Mono,051,14174,1713,1684,22,1706,3
2021-10-28,Monterey,053,433212,48667,47649,2889,50538,588
2021-10-28,Napa,055,140530,12941,12863,110,12973,101
2021-10-28,Nevada,057,99092,9143,9015,320,9335,91
2021-10-28,Orange,059,3164182,306630,304120,15048,319168,5588
2021-10-28,Placer,061,380077,36975,36400,3620,40020,434
2021-10-28,Plumas,063,18699,1758,1695,34,1729,7
2021-10-28,Riverside,065,2383286,362324,357645,16421,374066,5088
2021-10-28,Sacramento,067,1510023,158342,157125,4554,161679,2233
2021-10-28,San Benito,069,59416,7398,7362,169,7531,71
2021-10-28,San Bernardino,071,2135413,353227,350076,11123,361199,5777
2021-10-28,San Diego,073,3302833,372757,370006,21828,391834,4213
2021-10-28,San Francisco,075,870044,52793,52161,2320,54481,661
2021-10-28,San Joaquin,077,732212,99461,98314,5421,103735,1768
2021-10-28,San Luis Obispo,079,281455,29487,29053,1234,30287,341
2021-10-28,San Mateo,081,765935,54114,53083,869,53952,571
2021-10-28,Santa Barbara,083,443738,44308,43972,1548,45520,528
2021-10-28,Santa Clara,085,1922200,146702,145262,1330,146592,1903
2021-10-28,Santa Cruz,087,273765,20330,20134,1009,21143,221
2021-10-28,Shasta,089,179085,21254,20878,3570,24448,332
2021-10-28,Sierra,091,2930,181,175,20,195,0
2021-10-28,Siskiyou,093,43540,3333,3257,1285,4542,46
2021-10-28,Solano,095,438530,45860,45146,1260,46406,346
2021-10-28,Sonoma,097,501317,41330,40924,528,41452,393
2021-10-28,Stanislaus,099,539301,77978,77871,8819,86690,1191
2021-10-28,Sutter,101,95872,13825,13773,341,14114,178
2021-10-28,Tehama,103,63373,8446,8307,1479,9786,114
2021-10-28,Trinity,105,12862,850,708,216,924,11
2021-10-28,Tulare,107,460477,68175,66745,14893,81638,995
2021-10-28,Tuolumne,109,53932,7163,7050,94,7144,90
2021-10-28,Ventura,111,848112,97962,97182,4304,101486,1174
2021-10-28,Yolo,113,214977,19763,19568,1114,20682,250
2021-10-28,Yuba,115,75493,10080,9969,315,10284,82
2021-10-27,Alameda,001,1643700,119288,118487,2790,121277,1414
2021-10-27,Alpine,003,1148,101,105,0,105,0
2021-10-27,Amador,005,37829,5534,5470,60,5530,64
2021-10-27,Butte,007,227075,20814,20446,3719,24165,274
2021-10-27,Calaveras,009,45235,4036,3970,52,4022,82
2021-10-27,Colusa,011,21464,2509,2480,632,3112,18
2021-10-27,Contra Costa,013,1133247,99156,98442,2176,100618,1018
2021-10-27,Del Norte,015,27424,3667,3571,53,3624,42
2021-10-27,El Dorado,017,186661,15967,15723,1672,17395,154
2021-10-27,Fresno,019,978130,139037,136447,12702,149149,2128
2021-10-27,Glenn,021,27897,3488,3435,1009,4444,33
2021-10-27,Humboldt,023,135768,8947,8851,547,9398,105
2021-10-27,Imperial,025,180216,33467,33068,3202,36270,766
2021-10-27,Inyo,027,18085,2308,2236,41,2277,41
2021-10-27,Kern,029,883053,126651,124557,21763,146320,1647
2021-10-27,Kings,031,150075,32050,31437,1924,33361,335
2021-10-27,Lake,033,64148,6688,6589,145,6734,105
2021-10-27,Lassen,035,31185,6825,6706,358,7064,42
2021-10-27,Los Angeles,037,10098052,1434133,1422615,54581,1477196,26604
2021-10-27,Madera,039,155013,22894,22413,2063,24476,283
2021-10-27,Marin,041,260295,17507,17362,451,17813,247
2021-10-27,Mariposa,043,17540,1268,1228,46,1274,5
2021-10-27,Mendocino,045,87422,7481,7321,513,7834,84
2021-10-27,Merced,047,269075,41623,41310,1881,43191,583
2021-10-27,Modoc,049,8938,526,513,187,700,5
2021-10-27,Mono,051,14174,1710,1682,22,1704,3
2021-10-27,Monterey,053,433212,48630,47610,2867,50477,588
2021-10-27,Napa,055,140530,12926,12856,109,12965,101
2021-10-27,Nevada,057,99092,9126,8987,319,9306,90
2021-10-27,Orange,059,3164182,306309,303825,14997,318822,5584
2021-10-27,Placer,061,380077,36909,36296,3613,39909,434
2021-10-27,Plumas,063,18699,1750,1686,34,1720,7
2021-10-27,Riverside,065,2383286,361894,357152,16413,373565,5081
2021-10-27,Sacramento,067,1510023,158074,156830,4533,161363,2230
2021-10-27,San Benito,069,59416,7392,7337,169,7506,71
2021-10-27,San Bernardino,071,2135413,352804,349624,11101,360725,5770
2021-10-27,San Diego,073,3302833,372181,369579,21804,391383,4207
2021-10-27,San Francisco,075,870044,52742,52108,2316,54424,655
2021-10-27,San Joaquin,077,732212,99303,98168,5406,103574,1753
2021-10-27,San Luis Obispo,079,281455,29448,29002,1232,30234,341
2021-10-27,San Mateo,081,765935,54059,53032,861,53893,571
2021-10-27,Santa Barbara,083,443738,44255,43901,1545,45446,527
2021-10-27,Santa Clara,085,1922200,146525,145081,1322,146403,1902
2021-10-27,Santa Cruz,087,273765,20303,20091,1007,21098,221
2021-10-27,Shasta,089,179085,21178,20813,3562,24375,331
2021-10-27,Sierra,091,2930,180,176,20,196,0
2021-10-27,Siskiyou,093,43540,3330,3256,1281,4537,46
2021-10-27,Solano,095,438530,45815,45089,1252,46341,346
2021-10-27,Sonoma,097,501317,41254,40829,526,41355,393
2021-10-27,Stanislaus,099,539301,77818,77687,8805,86492,1191
2021-10-27,Sutter,101,95872,13811,13754,341,14095,177
2021-10-27,Tehama,103,63373,8424,8265,1477,9742,113
2021-10-27,Trinity,105,12862,850,706,215,921,11
2021-10-27,Tulare,107,460477,68021,66568,14835,81403,991
2021-10-27,Tuolumne,109,53932,7136,7009,93,7102,90
2021-10-27,Ventura,111,848112,97870,97108,4299,101407,1172
2021-10-27,Yolo,113,214977,19734,19517,1107,20624,250
2021-10-27,Yuba,115,75493,10059,9945,313,10258,82
2021-10-26,Alameda,001,1643700,119153,118360,2788,121148,1407
2021-10-26,Alpine,003,1148,101,105,0,105,0
2021-10-26,Amador,005,37829,5526,5465,59,5524,64
2021-10-26,Butte,007,227075,20755,20387,3702,24089,274
2021-10-26,Calaveras,009,45235,4025,3966,52,4018,81
2021-10-26,Colusa,011,21464,2507,2478,631,3109,18
2021-10-26,Contra Costa,013,1133247,99034,98352,2165,100517,1017
2021-10-26,Del Norte,015,27424,3662,3563,53,3616,42
2021-10-26,El Dorado,017,186661,15939,15690,1663,17353,153
2021-10-26,Fresno,019,978130,138588,136211,12658,148869,2122
2021-10-26,Glenn,021,27897,3473,3431,1006,4437,33
2021-10-26,Humboldt,023,135768,8929,8830,541,9371,105
2021-10-26,Imperial,025,180216,33402,33012,3197,36209,766
2021-10-26,Inyo,027,18085,2293,2200,41,2241,41
2021-10-26,Kern,029,883053,126308,124351,21643,145994,1645
2021-10-26,Kings,031,150075,31983,31382,1917,33299,336
2021-10-26,Lake,033,64148,6678,6584,143,6727,105
2021-10-26,Lassen,035,31185,6805,6689,356,7045,42
2021-10-26,Los Angeles,037,10098052,1432785,1421795,54511,1476306,26599
2021-10-26,Madera,039,155013,22804,22363,2052,24415,283
2021-10-26,Marin,041,260295,17490,17354,450,17804,244
2021-10-26,Mariposa,043,17540,1263,1225,45,1270,5
2021-10-26,Mendocino,045,87422,7452,7308,496,7804,83
2021-10-26,Merced,047,269075,41545,41267,1873,43140,583
2021-10-26,Modoc,049,8938,526,513,187,700,5
2021-10-26,Mono,051,14174,1705,1680,22,1702,3
2021-10-26,Monterey,053,433212,48591,47572,2856,50428,588
2021-10-26,Napa,055,140530,12914,12849,109,12958,101
2021-10-26,Nevada,057,99092,9095,8971,318,9289,90
2021-10-26,Orange,059,3164182,306039,303533,14958,318491,5580
2021-10-26,Placer,061,380077,36811,36245,3607,39852,434
2021-10-26,Plumas,063,18699,1741,1645,34,1679,7
2021-10-26,Riverside,065,2383286,361404,356775,16403,373178,5068
2021-10-26,Sacramento,067,1510023,157773,156643,4516,161159,2228
2021-10-26,San Benito,069,59416,7369,7325,169,7494,71
2021-10-26,San Bernardino,071,2135413,352382,349346,11086,360432,5764
2021-10-26,San Diego,073,3302833,371662,369043,21774,390817,4198
2021-10-26,San Francisco,075,870044,52667,52063,2313,54376,655
2021-10-26,San Joaquin,077,732212,99124,98036,5391,103427,1748
2021-10-26,San Luis Obispo,079,281455,29409,28928,1226,30154,337
2021-10-26,San Mateo,081,765935,53987,52974,858,53832,571
2021-10-26,Santa Barbara,083,443738,44209,43835,1544,45379,525
2021-10-26,Santa Clara,085,1922200,146326,144932,1316,146248,1903
2021-10-26,Santa Cruz,087,273765,20272,20067,1006,21073,221
2021-10-26,Shasta,089,179085,21118,20725,3544,24269,330
2021-10-26,Sierra,091,2930,180,169,20,189,0
2021-10-26,Siskiyou,093,43540,3324,3254,1279,4533,46
2021-10-26,Solano,095,438530,45759,45044,1251,46295,344
2021-10-26,Sonoma,097,501317,41172,40794,524,41318,393
2021-10-26,Stanislaus,099,539301,77644,77552,8780,86332,1157
2021-10-26,Sutter,101,95872,13782,13739,340,14079,176
2021-10-26,Tehama,103,63373,8396,8247,1471,9718,112
2021-10-26,Trinity,105,12862,846,705,215,920,11
2021-10-26,Tulare,107,460477,67861,66476,14773,81249,991
2021-10-26,Tuolumne,109,53932,7110,6995,91,7086,90
2021-10-26,Ventura,111,848112,97761,97014,4295,101309,1170
2021-10-26,Yolo,113,214977,19706,19490,1104,20594,248
2021-10-26,Yuba,115,75493,10041,9927,308,10235,82
2021-10-25,Alameda,001,1643700,119008,118319,2786,121105,1404
2021-10-25,Alpine,003,1148,101,105,0,105,0
2021-10-25,Amador,005,37829,5512,5455,59,5514,64
2021-10-25,Butte,007,227075,20681,20331,3694,24025,273
2021-10-25,Calaveras,009,45235,3995,3942,51,3993,82
2021-10-25,Colusa,011,21464,2505,2471,629,3100,18
2021-10-25,Contra Costa,013,1133247,98917,98267,2160,100427,1017
2021-10-25,Del Norte,015,27424,3655,3562,53,3615,42
2021-10-25,El Dorado,017,186661,15904,15663,1661,17324,149
2021-10-25,Fresno,019,978130,138153,135974,12619,148593,2112
2021-10-25,Glenn,021,27897,3470,3421,1005,4426,33
2021-10-25,Humboldt,023,135768,8906,8825,536,9361,105
2021-10-25,Imperial,025,180216,33341,32968,3186,36154,766
2021-10-25,Inyo,027,18085,2275,2183,41,2224,41
2021-10-25,Kern,029,883053,125955,124078,21504,145582,1649
2021-10-25,Kings,031,150075,31894,31329,1908,33237,335
2021-10-25,Lake,033,64148,6665,6571,143,6714,105
2021-10-25,Lassen,035,31185,6794,6688,354,7042,42
2021-10-25,Los Angeles,037,10098052,1431413,1421061,54444,1475505,26579
2021-10-25,Madera,039,155013,22750,22325,2045,24370,281
2021-10-25,Marin,041,260295,17468,17334,448,17782,244
2021-10-25,Mariposa,043,17540,1249,1220,45,1265,5
2021-10-25,Mendocino,045,87422,7422,7296,492,7788,82
2021-10-25,Merced,047,269075,41477,41207,1846,43053,583
2021-10-25,Modoc,049,8938,524,512,185,697,5
2021-10-25,Mono,051,14174,1697,1677,22,1699,3
2021-10-25,Monterey,053,433212,48558,47547,2854,50401,587
2021-10-25,Napa,055,140530,12901,12841,109,12950,100
2021-10-25,Nevada,057,99092,9069,8958,318,9276,90
2021-10-25,Orange,059,3164182,305741,303279,14920,318199,5574
2021-10-25,Placer,061,380077,36704,36153,3597,39750,431
2021-10-25,Plumas,063,18699,1729,1641,34,1675,7
2021-10-25,Riverside,065,2383286,360977,356381,16388,372769,5056
2021-10-25,Sacramento,067,1510023,157468,156516,4490,161006,2235
2021-10-25,San Benito,069,59416,7355,7314,168,7482,71
2021-10-25,San Bernardino,071,2135413,351886,349075,11074,360149,5748
2021-10-25,San Diego,073,3302833,371075,368386,21746,390132,4196
2021-10-25,San Francisco,075,870044,52594,52041,2306,54347,649
2021-10-25,San Joaquin,077,732212,98922,97980,5382,103362,1740
2021-10-25,San Luis Obispo,079,281455,29361,28907,1221,30128,336
2021-10-25,San Mateo,081,765935,53927,52927,854,53781,571
2021-10-25,Santa Barbara,083,443738,44150,43775,1544,45319,525
2021-10-25,Santa Clara,085,1922200,146136,144895,1311,146206,1901
2021-10-25,Santa Cruz,087,273765,20243,20053,1005,21058,221
2021-10-25,Shasta,089,179085,21046,20666,3537,24203,326
2021-10-25,Sierra,091,2930,180,168,20,188,0
2021-10-25,Siskiyou,093,43540,3320,3248,1274,4522,46
2021-10-25,Solano,095,438530,45698,45022,1249,46271,344
2021-10-25,Sonoma,097,501317,41099,40746,522,41268,393
2021-10-25,Stanislaus,099,539301,77451,77452,8751,86203,1145
2021-10-25,Sutter,101,95872,13769,13721,337,14058,176
2021-10-25,Tehama,103,63373,8369,8224,1467,9691,111
2021-10-25,Trinity,105,12862,841,699,214,913,11
2021-10-25,Tulare,107,460477,67667,66357,14711,81068,986
2021-10-25,Tuolumne,109,53932,7076,6952,89,7041,90
2021-10-25,Ventura,111,848112,97670,96932,4292,101224,1167
2021-10-25,Yolo,113,214977,19657,19457,1100,20557,248
2021-10-25,Yuba,115,75493,10025,9924,304,10228,82
2021-10-24,Alameda,001,1643700,118876,117816,2781,120597,1397
2021-10-24,Alpine,003,1148,101,105,0,105,0
2021-10-24,Amador,005,37829,5507,5412,59,5471,64
2021-10-24,Butte,007,227075,20610,20101,3682,23783,273
2021-10-24,Calaveras,009,45235,3976,3865,50,3915,81
2021-10-24,Colusa,011,21464,2501,2458,626,3084,18
2021-10-24,Contra Costa,013,1133247,98799,97855,2151,100006,1008
2021-10-24,Del Norte,015,27424,3651,3540,53,3593,42
2021-10-24,El Dorado,017,186661,15868,15540,1657,17197,149
2021-10-24,Fresno,019,978130,137718,134466,12570,147036,2094
2021-10-24,Glenn,021,27897,3463,3399,1003,4402,33
2021-10-24,Humboldt,023,135768,8893,8753,530,9283,105
2021-10-24,Imperial,025,180216,33263,32777,3179,35956,766
2021-10-24,Inyo,027,18085,2243,2108,41,2149,41
2021-10-24,Kern,029,883053,125621,122939,21386,144325,1636
2021-10-24,Kings,031,150075,31765,30942,1892,32834,325
2021-10-24,Lake,033,64148,6642,6501,142,6643,105
2021-10-24,Lassen,035,31185,6777,6632,353,6985,27
2021-10-24,Los Angeles,037,10098052,1429966,1415919,54376,1470295,26527
2021-10-24,Madera,039,155013,22673,22062,2032,24094,281
2021-10-24,Marin,041,260295,17452,17264,447,17711,244
2021-10-24,Mariposa,043,17540,1246,1184,45,1229,5
2021-10-24,Mendocino,045,87422,7398,7220,481,7701,82
2021-10-24,Merced,047,269075,41356,40808,1840,42648,581
2021-10-24,Modoc,049,8938,523,507,185,692,5
2021-10-24,Mono,051,14174,1692,1655,22,1677,3
2021-10-24,Monterey,053,433212,48510,47456,2843,50299,586
2021-10-24,Napa,055,140530,12890,12789,109,12898,100
2021-10-24,Nevada,057,99092,9046,8861,315,9176,90
2021-10-24,Orange,059,3164182,305391,302237,14882,317119,5546
2021-10-24,Placer,061,380077,36600,35822,3583,39405,426
2021-10-24,Plumas,063,18699,1719,1623,33,1656,7
2021-10-24,Riverside,065,2383286,360502,354688,16368,371056,5041
2021-10-24,Sacramento,067,1510023,157125,155125,4467,159592,2232
2021-10-24,San Benito,069,59416,7335,7280,168,7448,71
2021-10-24,San Bernardino,071,2135413,351337,347681,11063,358744,5688
2021-10-24,San Diego,073,3302833,370472,366085,21715,387800,4183
2021-10-24,San Francisco,075,870044,52531,51820,2300,54120,649
2021-10-24,San Joaquin,077,732212,98749,97440,5376,102816,1721
2021-10-24,San Luis Obispo,079,281455,29300,28755,1214,29969,333
2021-10-24,San Mateo,081,765935,53855,52719,854,53573,571
2021-10-24,Santa Barbara,083,443738,44083,43552,1542,45094,523
2021-10-24,Santa Clara,085,1922200,145945,144276,1301,145577,1897
2021-10-24,Santa Cruz,087,273765,20205,19967,1004,20971,221
2021-10-24,Shasta,089,179085,20946,20386,3531,23917,321
2021-10-24,Sierra,091,2930,180,168,20,188,0
2021-10-24,Siskiyou,093,43540,3313,3231,1270,4501,46
2021-10-24,Solano,095,438530,45648,44861,1244,46105,341
2021-10-24,Sonoma,097,501317,41016,40476,522,40998,393
2021-10-24,Stanislaus,099,539301,77258,76812,8739,85551,1145
2021-10-24,Sutter,101,95872,13742,13616,329,13945,175
2021-10-24,Tehama,103,63373,8321,8105,1455,9560,110
2021-10-24,Trinity,105,12862,837,696,211,907,11
2021-10-24,Tulare,107,460477,67495,65585,14637,80222,978
2021-10-24,Tuolumne,109,53932,7036,6840,87,6927,90
2021-10-24,Ventura,111,848112,97563,96664,4291,100955,1167
2021-10-24,Yolo,113,214977,19610,19280,1097,20377,248
2021-10-24,Yuba,115,75493,10000,9838,303,10141,82
2021-10-23,Alameda,001,1643700,118787,117816,2776,120592,1397
2021-10-23,Alpine,003,1148,101,105,0,105,0
2021-10-23,Amador,005,37829,5500,5412,59,5471,64
2021-10-23,Butte,007,227075,20575,20101,3673,23774,273
2021-10-23,Calaveras,009,45235,3969,3865,49,3914,81
2021-10-23,Colusa,011,21464,2499,2458,625,3083,18
2021-10-23,Contra Costa,013,1133247,98747,97855,2147,100002,1008
2021-10-23,Del Norte,015,27424,3649,3540,53,3593,42
2021-10-23,El Dorado,017,186661,15842,15540,1655,17195,149
2021-10-23,Fresno,019,978130,137540,134466,12556,147022,2094
2021-10-23,Glenn,021,27897,3461,3399,1002,4401,33
2021-10-23,Humboldt,023,135768,8879,8753,525,9278,105
2021-10-23,Imperial,025,180216,33216,32777,3175,35952,766
2021-10-23,Inyo,027,18085,2232,2108,41,2149,41
2021-10-23,Kern,029,883053,125461,122939,21298,144237,1636
2021-10-23,Kings,031,150075,31719,30942,1890,32832,325
2021-10-23,Lake,033,64148,6637,6501,142,6643,105
2021-10-23,Lassen,035,31185,6774,6632,351,6983,27
2021-10-23,Los Angeles,037,10098052,1429290,1415919,54321,1470240,26527
2021-10-23,Madera,039,155013,22624,22062,2024,24086,281
2021-10-23,Marin,041,260295,17435,17264,446,17710,244
2021-10-23,Mariposa,043,17540,1243,1184,44,1228,5
2021-10-23,Mendocino,045,87422,7391,7220,480,7700,82
2021-10-23,Merced,047,269075,41315,40808,1835,42643,581
2021-10-23,Modoc,049,8938,521,507,185,692,5
2021-10-23,Mono,051,14174,1686,1655,22,1677,3
2021-10-23,Monterey,053,433212,48493,47456,2839,50295,586
2021-10-23,Napa,055,140530,12885,12789,109,12898,100
2021-10-23,Nevada,057,99092,9035,8861,313,9174,90
2021-10-23,Orange,059,3164182,305204,302237,14866,317103,5546
2021-10-23,Placer,061,380077,36538,35822,3577,39399,426
2021-10-23,Plumas,063,18699,1718,1623,33,1656,7
2021-10-23,Riverside,065,2383286,360181,354688,16361,371049,5041
2021-10-23,Sacramento,067,1510023,156996,155125,4458,159583,2232
2021-10-23,San Benito,069,59416,7325,7280,168,7448,71
2021-10-23,San Bernardino,071,2135413,351069,347681,11056,358737,5688
2021-10-23,San Diego,073,3302833,370114,366085,21684,387769,4183
2021-10-23,San Francisco,075,870044,52496,51820,2299,54119,649
2021-10-23,San Joaquin,077,732212,98681,97440,5367,102807,1721
2021-10-23,San Luis Obispo,079,281455,29263,28755,1212,29967,333
2021-10-23,San Mateo,081,765935,53817,52719,853,53572,571
2021-10-23,Santa Barbara,083,443738,44052,43552,1540,45092,523
2021-10-23,Santa Clara,085,1922200,145837,144276,1297,145573,1897
2021-10-23,Santa Cruz,087,273765,20193,19967,1004,20971,221
2021-10-23,Shasta,089,179085,20910,20386,3519,23905,321
2021-10-23,Sierra,091,2930,179,168,20,188,0
2021-10-23,Siskiyou,093,43540,3311,3231,1270,4501,46
2021-10-23,Solano,095,438530,45623,44861,1241,46102,341
2021-10-23,Sonoma,097,501317,40976,40476,522,40998,393
2021-10-23,Stanislaus,099,539301,77169,76812,8719,85531,1145
2021-10-23,Sutter,101,95872,13736,13616,328,13944,175
2021-10-23,Tehama,103,63373,8309,8105,1454,9559,110
2021-10-23,Trinity,105,12862,836,696,211,907,11
2021-10-23,Tulare,107,460477,67407,65585,14577,80162,978
2021-10-23,Tuolumne,109,53932,7015,6840,87,6927,90
2021-10-23,Ventura,111,848112,97502,96664,4291,100955,1167
2021-10-23,Yolo,113,214977,19593,19280,1094,20374,248
2021-10-23,Yuba,115,75493,9992,9838,303,10141,82
2021-10-22,Alameda,001,1643700,118703,117816,2773,120589,1397
2021-10-22,Alpine,003,1148,101,105,0,105,0
2021-10-22,Amador,005,37829,5489,5412,59,5471,64
2021-10-22,Butte,007,227075,20543,20101,3669,23770,273
2021-10-22,Calaveras,009,45235,3961,3865,49,3914,81
2021-10-22,Colusa,011,21464,2496,2458,625,3083,18
2021-10-22,Contra Costa,013,1133247,98656,97855,2145,100000,1008
2021-10-22,Del Norte,015,27424,3645,3540,53,3593,42
2021-10-22,El Dorado,017,186661,15829,15540,1653,17193,149
2021-10-22,Fresno,019,978130,137325,134466,12534,147000,2094
2021-10-22,Glenn,021,27897,3451,3399,1002,4401,33
2021-10-22,Humboldt,023,135768,8865,8753,524,9277,105
2021-10-22,Imperial,025,180216,33173,32777,3175,35952,766
2021-10-22,Inyo,027,18085,2219,2108,41,2149,41
2021-10-22,Kern,029,883053,125274,122939,21225,144164,1636
2021-10-22,Kings,031,150075,31684,30942,1889,32831,325
2021-10-22,Lake,033,64148,6627,6501,142,6643,105
2021-10-22,Lassen,035,31185,6767,6632,348,6980,27
2021-10-22,Los Angeles,037,10098052,1428536,1415919,54261,1470180,26527
2021-10-22,Madera,039,155013,22575,22062,2011,24073,281
2021-10-22,Marin,041,260295,17423,17264,446,17710,244
2021-10-22,Mariposa,043,17540,1240,1184,44,1228,5
2021-10-22,Mendocino,045,87422,7377,7220,479,7699,82
2021-10-22,Merced,047,269075,41278,40808,1828,42636,581
2021-10-22,Modoc,049,8938,521,507,185,692,5
2021-10-22,Mono,051,14174,1684,1655,22,1677,3
2021-10-22,Monterey,053,433212,48460,47456,2837,50293,586
2021-10-22,Napa,055,140530,12879,12789,109,12898,100
2021-10-22,Nevada,057,99092,9018,8861,312,9173,90
2021-10-22,Orange,059,3164182,304988,302237,14835,317072,5546
2021-10-22,Placer,061,380077,36510,35822,3568,39390,426
2021-10-22,Plumas,063,18699,1712,1623,33,1656,7
2021-10-22,Riverside,065,2383286,359870,354688,16356,371044,5041
2021-10-22,Sacramento,067,1510023,156810,155125,4448,159573,2232
2021-10-22,San Benito,069,59416,7320,7280,168,7448,71
2021-10-22,San Bernardino,071,2135413,350739,347681,11042,358723,5688
2021-10-22,San Diego,073,3302833,369701,366085,21666,387751,4183
2021-10-22,San Francisco,075,870044,52461,51820,2292,54112,649
2021-10-22,San Joaquin,077,732212,98622,97440,5364,102804,1721
2021-10-22,San Luis Obispo,079,281455,29233,28755,1212,29967,333
2021-10-22,San Mateo,081,765935,53767,52719,846,53565,571
2021-10-22,Santa Barbara,083,443738,44011,43552,1540,45092,523
2021-10-22,Santa Clara,085,1922200,145681,144276,1290,145566,1897
2021-10-22,Santa Cruz,087,273765,20171,19967,1004,20971,221
2021-10-22,Shasta,089,179085,20878,20386,3516,23902,321
2021-10-22,Sierra,091,2930,178,168,19,187,0
2021-10-22,Siskiyou,093,43540,3309,3231,1267,4498,46
2021-10-22,Solano,095,438530,45588,44861,1237,46098,341
2021-10-22,Sonoma,097,501317,40919,40476,522,40998,393
2021-10-22,Stanislaus,099,539301,77066,76812,8701,85513,1145
2021-10-22,Sutter,101,95872,13721,13616,328,13944,175
2021-10-22,Tehama,103,63373,8287,8105,1449,9554,110
2021-10-22,Trinity,105,12862,835,696,211,907,11
2021-10-22,Tulare,107,460477,67321,65585,14523,80108,978
2021-10-22,Tuolumne,109,53932,6980,6840,87,6927,90
2021-10-22,Ventura,111,848112,97449,96664,4285,100949,1167
2021-10-22,Yolo,113,214977,19566,19280,1092,20372,248
2021-10-22,Yuba,115,75493,9978,9838,301,10139,82
2021-10-21,Alameda,001,1643700,118587,117816,2768,120584,1397
2021-10-21,Alpine,003,1148,101,105,0,105,0
2021-10-21,Amador,005,37829,5481,5412,59,5471,64
2021-10-21,Butte,007,227075,20459,20101,3656,23757,273
2021-10-21,Calaveras,009,45235,3942,3865,49,3914,81
2021-10-21,Colusa,011,21464,2492,2458,621,3079,18
2021-10-21,Contra Costa,013,1133247,98541,97855,2139,99994,1008
2021-10-21,Del Norte,015,27424,3639,3540,52,3592,42
2021-10-21,El Dorado,017,186661,15801,15540,1646,17186,149
2021-10-21,Fresno,019,978130,136975,134466,12491,146957,2094
2021-10-21,Glenn,021,27897,3447,3399,999,4398,33
2021-10-21,Humboldt,023,135768,8851,8753,520,9273,105
2021-10-21,Imperial,025,180216,33118,32777,3171,35948,766
2021-10-21,Inyo,027,18085,2197,2108,41,2149,41
2021-10-21,Kern,029,883053,125027,122939,21114,144053,1636
2021-10-21,Kings,031,150075,31586,30942,1883,32825,325
2021-10-21,Lake,033,64148,6613,6501,141,6642,105
2021-10-21,Lassen,035,31185,6754,6632,344,6976,27
2021-10-21,Los Angeles,037,10098052,1427419,1415919,54210,1470129,26527
2021-10-21,Madera,039,155013,22517,22062,2001,24063,281
2021-10-21,Marin,041,260295,17405,17264,446,17710,244
2021-10-21,Mariposa,043,17540,1234,1184,43,1227,5
2021-10-21,Mendocino,045,87422,7359,7220,471,7691,82
2021-10-21,Merced,047,269075,41180,40808,1817,42625,581
2021-10-21,Modoc,049,8938,521,507,185,692,5
2021-10-21,Mono,051,14174,1675,1655,22,1677,3
2021-10-21,Monterey,053,433212,48426,47456,2825,50281,586
2021-10-21,Napa,055,140530,12867,12789,109,12898,100
2021-10-21,Nevada,057,99092,8993,8861,312,9173,90
2021-10-21,Orange,059,3164182,304715,302237,14799,317036,5546
2021-10-21,Placer,061,380077,36421,35822,3555,39377,426
2021-10-21,Plumas,063,18699,1698,1623,33,1656,7
2021-10-21,Riverside,065,2383286,359425,354688,16345,371033,5041
2021-10-21,Sacramento,067,1510023,156491,155125,4423,159548,2232
2021-10-21,San Benito,069,59416,7313,7280,166,7446,71
2021-10-21,San Bernardino,071,2135413,350360,347681,11007,358688,5688
2021-10-21,San Diego,073,3302833,369176,366085,21636,387721,4183
2021-10-21,San Francisco,075,870044,52406,51820,2291,54111,649
2021-10-21,San Joaquin,077,732212,98483,97440,5357,102797,1721
2021-10-21,San Luis Obispo,079,281455,29191,28755,1210,29965,333
2021-10-21,San Mateo,081,765935,53720,52719,845,53564,571
2021-10-21,Santa Barbara,083,443738,43945,43552,1538,45090,523
2021-10-21,Santa Clara,085,1922200,145509,144276,1286,145562,1897
2021-10-21,Santa Cruz,087,273765,20147,19967,1002,20969,221
2021-10-21,Shasta,089,179085,20816,20386,3501,23887,321
2021-10-21,Sierra,091,2930,177,168,18,186,0
2021-10-21,Siskiyou,093,43540,3304,3231,1265,4496,46
2021-10-21,Solano,095,438530,45536,44861,1235,46096,341
2021-10-21,Sonoma,097,501317,40850,40476,520,40996,393
2021-10-21,Stanislaus,099,539301,76897,76812,8690,85502,1145
2021-10-21,Sutter,101,95872,13693,13616,324,13940,175
2021-10-21,Tehama,103,63373,8260,8105,1442,9547,110
2021-10-21,Trinity,105,12862,833,696,211,907,11
2021-10-21,Tulare,107,460477,67131,65585,14452,80037,978
2021-10-21,Tuolumne,109,53932,6942,6840,86,6926,90
2021-10-21,Ventura,111,848112,97358,96664,4283,100947,1167
2021-10-21,Yolo,113,214977,19519,19280,1090,20370,248
2021-10-21,Yuba,115,75493,9954,9838,300,10138,82
2021-10-20,Alameda,001,1643700,118465,117654,2767,120421,1390
2021-10-20,Alpine,003,1148,101,103,0,103,0
2021-10-20,Amador,005,37829,5473,5379,59,5438,64
2021-10-20,Butte,007,227075,20405,20021,3641,23662,270
2021-10-20,Calaveras,009,45235,3922,3844,48,3892,81
2021-10-20,Colusa,011,21464,2488,2454,619,3073,18
2021-10-20,Contra Costa,013,1133247,98425,97721,2135,99856,1008
2021-10-20,Del Norte,015,27424,3635,3536,52,3588,42
2021-10-20,El Dorado,017,186661,15771,15502,1643,17145,149
2021-10-20,Fresno,019,978130,136573,134025,12454,146479,2084
2021-10-20,Glenn,021,27897,3439,3382,998,4380,33
2021-10-20,Humboldt,023,135768,8829,8727,518,9245,105
2021-10-20,Imperial,025,180216,33044,32705,3163,35868,766
2021-10-20,Inyo,027,18085,2177,2077,40,2117,40
2021-10-20,Kern,029,883053,124733,122630,20993,143623,1623
2021-10-20,Kings,031,150075,31509,30805,1873,32678,322
2021-10-20,Lake,033,64148,6591,6475,140,6615,104
2021-10-20,Lassen,035,31185,6739,6622,344,6966,27
2021-10-20,Los Angeles,037,10098052,1426300,1414931,54137,1469068,26506
2021-10-20,Madera,039,155013,22447,21983,1992,23975,281
2021-10-20,Marin,041,260295,17384,17250,444,17694,244
2021-10-20,Mariposa,043,17540,1227,1174,43,1217,5
2021-10-20,Mendocino,045,87422,7331,7189,468,7657,82
2021-10-20,Merced,047,269075,41099,40685,1800,42485,581
2021-10-20,Modoc,049,8938,521,504,185,689,5
2021-10-20,Mono,051,14174,1675,1653,22,1675,3
2021-10-20,Monterey,053,433212,48394,47430,2816,50246,587
2021-10-20,Napa,055,140530,12853,12773,108,12881,100
2021-10-20,Nevada,057,99092,8965,8836,312,9148,90
2021-10-20,Orange,059,3164182,304430,301957,14777,316734,5534
2021-10-20,Placer,061,380077,36331,35729,3546,39275,425
2021-10-20,Plumas,063,18699,1691,1604,33,1637,7
2021-10-20,Riverside,065,2383286,358981,354311,16328,370639,5030
2021-10-20,Sacramento,067,1510023,156190,154822,4399,159221,2222
2021-10-20,San Benito,069,59416,7310,7275,164,7439,71
2021-10-20,San Bernardino,071,2135413,349956,347217,10975,358192,5663
2021-10-20,San Diego,073,3302833,368660,365698,21617,387315,4178
2021-10-20,San Francisco,075,870044,52357,51755,2290,54045,646
2021-10-20,San Joaquin,077,732212,98338,97246,5349,102595,1721
2021-10-20,San Luis Obispo,079,281455,29146,28727,1206,29933,332
2021-10-20,San Mateo,081,765935,53649,52663,837,53500,571
2021-10-20,Santa Barbara,083,443738,43882,43489,1537,45026,523
2021-10-20,Santa Clara,085,1922200,145373,144124,1281,145405,1896
2021-10-20,Santa Cruz,087,273765,20134,19951,1002,20953,219
2021-10-20,Shasta,089,179085,20755,20313,3474,23787,320
2021-10-20,Sierra,091,2930,177,168,18,186,0
2021-10-20,Siskiyou,093,43540,3304,3224,1259,4483,46
2021-10-20,Solano,095,438530,45504,44819,1233,46052,341
2021-10-20,Sonoma,097,501317,40803,40404,520,40924,393
2021-10-20,Stanislaus,099,539301,76747,76631,8671,85302,1145
2021-10-20,Sutter,101,95872,13669,13592,318,13910,175
2021-10-20,Tehama,103,63373,8229,8081,1431,9512,110
2021-10-20,Trinity,105,12862,833,693,210,903,11
2021-10-20,Tulare,107,460477,66957,65413,14406,79819,967
2021-10-20,Tuolumne,109,53932,6919,6803,86,6889,89
2021-10-20,Ventura,111,848112,97276,96610,4279,100889,1166
2021-10-20,Yolo,113,214977,19475,19236,1087,20323,248
2021-10-20,Yuba,115,75493,9937,9808,297,10105,82
2021-10-19,Alameda,001,1643700,118343,117542,2761,120303,1383
2021-10-19,Alpine,003,1148,101,103,0,103,0
2021-10-19,Amador,005,37829,5457,5367,59,5426,64
2021-10-19,Butte,007,227075,20352,19974,3633,23607,268
2021-10-19,Calaveras,009,45235,3905,3826,47,3873,80
2021-10-19,Colusa,011,21464,2485,2447,617,3064,18
2021-10-19,Contra Costa,013,1133247,98334,97613,2130,99743,1004
2021-10-19,Del Norte,015,27424,3628,3531,52,3583,42
2021-10-19,El Dorado,017,186661,15746,15478,1638,17116,149
2021-10-19,Fresno,019,978130,136208,133813,12405,146218,2073
2021-10-19,Glenn,021,27897,3436,3380,996,4376,33
2021-10-19,Humboldt,023,135768,8805,8714,512,9226,105
2021-10-19,Imperial,025,180216,32978,32632,3159,35791,764
2021-10-19,Inyo,027,18085,2146,2045,40,2085,40
2021-10-19,Kern,029,883053,124416,122391,20869,143260,1613
2021-10-19,Kings,031,150075,31415,30757,1866,32623,322
2021-10-19,Lake,033,64148,6587,6465,140,6605,104
2021-10-19,Lassen,035,31185,6733,6612,340,6952,27
2021-10-19,Los Angeles,037,10098052,1425057,1413882,54060,1467942,26473
2021-10-19,Madera,039,155013,22384,21950,1984,23934,281
2021-10-19,Marin,041,260295,17370,17241,441,17682,244
2021-10-19,Mariposa,043,17540,1221,1171,41,1212,5
2021-10-19,Mendocino,045,87422,7316,7172,465,7637,82
2021-10-19,Merced,047,269075,40984,40628,1779,42407,580
2021-10-19,Modoc,049,8938,519,502,185,687,5
2021-10-19,Mono,051,14174,1671,1651,22,1673,3
2021-10-19,Monterey,053,433212,48357,47412,2805,50217,583
2021-10-19,Napa,055,140530,12846,12769,108,12877,100
2021-10-19,Nevada,057,99092,8944,8829,311,9140,90
2021-10-19,Orange,059,3164182,304173,301700,14744,316444,5527
2021-10-19,Placer,061,380077,36210,35663,3531,39194,422
2021-10-19,Plumas,063,18699,1673,1586,33,1619,8
2021-10-19,Riverside,065,2383286,358559,353891,16320,370211,5020
2021-10-19,Sacramento,067,1510023,155884,154570,4373,158943,2227
2021-10-19,San Benito,069,59416,7294,7264,164,7428,71
2021-10-19,San Bernardino,071,2135413,349556,346814,10945,357759,5627
2021-10-19,San Diego,073,3302833,368066,365285,21586,386871,4170
2021-10-19,San Francisco,075,870044,52294,51704,2288,53992,645
2021-10-19,San Joaquin,077,732212,98171,97105,5338,102443,1721
2021-10-19,San Luis Obispo,079,281455,29098,28670,1203,29873,332
2021-10-19,San Mateo,081,765935,53591,52617,835,53452,571
2021-10-19,Santa Barbara,083,443738,43815,43413,1535,44948,522
2021-10-19,Santa Clara,085,1922200,145200,143989,1273,145262,1898
2021-10-19,Santa Cruz,087,273765,20110,19895,1000,20895,218
2021-10-19,Shasta,089,179085,20678,20209,3466,23675,319
2021-10-19,Sierra,091,2930,174,168,18,186,0
2021-10-19,Siskiyou,093,43540,3300,3216,1254,4470,46
2021-10-19,Solano,095,438530,45462,44782,1227,46009,341
2021-10-19,Sonoma,097,501317,40729,40379,519,40898,392
2021-10-19,Stanislaus,099,539301,76605,76526,8659,85185,1145
2021-10-19,Sutter,101,95872,13645,13569,317,13886,174
2021-10-19,Tehama,103,63373,8199,8057,1415,9472,108
2021-10-19,Trinity,105,12862,826,691,210,901,11
2021-10-19,Tulare,107,460477,66770,65253,14337,79590,958
2021-10-19,Tuolumne,109,53932,6890,6782,85,6867,89
2021-10-19,Ventura,111,848112,97200,96539,4274,100813,1166
2021-10-19,Yolo,113,214977,19430,19206,1082,20288,248
2021-10-19,Yuba,115,75493,9919,9796,296,10092,82
2021-10-18,Alameda,001,1643700,118206,117506,2752,120258,1381
2021-10-18,Alpine,003,1148,101,103,0,103,0
2021-10-18,Amador,005,37829,5446,5345,59,5404,64
2021-10-18,Butte,007,227075,20301,19921,3625,23546,265
2021-10-18,Calaveras,009,45235,3880,3819,46,3865,80
2021-10-18,Colusa,011,21464,2484,2444,615,3059,18
2021-10-18,Contra Costa,013,1133247,98222,97585,2126,99711,995
2021-10-18,Del Norte,015,27424,3621,3529,52,3581,41
2021-10-18,El Dorado,017,186661,15715,15452,1636,17088,149
2021-10-18,Fresno,019,978130,135805,133688,12362,146050,2063
2021-10-18,Glenn,021,27897,3432,3370,992,4362,32
2021-10-18,Humboldt,023,135768,8786,8699,504,9203,104
2021-10-18,Imperial,025,180216,32887,32558,3159,35717,764
2021-10-18,Inyo,027,18085,2128,2020,40,2060,40
2021-10-18,Kern,029,883053,124117,122231,20774,143005,1605
2021-10-18,Kings,031,150075,31300,30698,1853,32551,320
2021-10-18,Lake,033,64148,6568,6455,136,6591,104
2021-10-18,Lassen,035,31185,6713,6607,337,6944,26
2021-10-18,Los Angeles,037,10098052,1423815,1413291,53982,1467273,26446
2021-10-18,Madera,039,155013,22330,21909,1971,23880,277
2021-10-18,Marin,041,260295,17350,17232,438,17670,244
2021-10-18,Mariposa,043,17540,1213,1160,41,1201,5
2021-10-18,Mendocino,045,87422,7297,7156,457,7613,82
2021-10-18,Merced,047,269075,40861,40573,1768,42341,579
2021-10-18,Modoc,049,8938,519,498,185,683,5
2021-10-18,Mono,051,14174,1665,1648,21,1669,3
2021-10-18,Monterey,053,433212,48335,47389,2800,50189,583
2021-10-18,Napa,055,140530,12831,12762,108,12870,100
2021-10-18,Nevada,057,99092,8925,8816,311,9127,90
2021-10-18,Orange,059,3164182,303834,301573,14710,316283,5524
2021-10-18,Placer,061,380077,36133,35598,3527,39125,420
2021-10-18,Plumas,063,18699,1665,1579,33,1612,6
2021-10-18,Riverside,065,2383286,358144,353699,16306,370005,5008
2021-10-18,Sacramento,067,1510023,155579,154428,4340,158768,2203
2021-10-18,San Benito,069,59416,7282,7253,164,7417,71
2021-10-18,San Bernardino,071,2135413,349134,346742,10931,357673,5606
2021-10-18,San Diego,073,3302833,367500,364948,21548,386496,4169
2021-10-18,San Francisco,075,870044,52231,51671,2282,53953,644
2021-10-18,San Joaquin,077,732212,98006,97041,5328,102369,1721
2021-10-18,San Luis Obispo,079,281455,29059,28644,1200,29844,331
2021-10-18,San Mateo,081,765935,53526,52594,834,53428,571
2021-10-18,Santa Barbara,083,443738,43756,43386,1533,44919,522
2021-10-18,Santa Clara,085,1922200,145045,143891,1264,145155,1895
2021-10-18,Santa Cruz,087,273765,20096,19876,998,20874,218
2021-10-18,Shasta,089,179085,20598,20146,3455,23601,313
2021-10-18,Sierra,091,2930,174,166,18,184,0
2021-10-18,Siskiyou,093,43540,3297,3210,1246,4456,42
2021-10-18,Solano,095,438530,45418,44758,1224,45982,339
2021-10-18,Sonoma,097,501317,40665,40349,516,40865,392
2021-10-18,Stanislaus,099,539301,76441,76466,8646,85112,1145
2021-10-18,Sutter,101,95872,13611,13557,315,13872,172
2021-10-18,Tehama,103,63373,8164,8042,1403,9445,107
2021-10-18,Trinity,105,12862,825,688,210,898,11
2021-10-18,Tulare,107,460477,66594,65171,14271,79442,958
2021-10-18,Tuolumne,109,53932,6860,6755,85,6840,89
2021-10-18,Ventura,111,848112,97105,96506,4271,100777,1165
2021-10-18,Yolo,113,214977,19392,19197,1079,20276,248
2021-10-18,Yuba,115,75493,9892,9782,294,10076,82
2021-10-17,Alameda,001,1643700,118054,117423,2747,120170,1376
2021-10-17,Alpine,003,1148,101,103,0,103,0
2021-10-17,Amador,005,37829,5423,5341,58,5399,64
2021-10-17,Butte,007,227075,20216,19897,3616,23513,265
2021-10-17,Calaveras,009,45235,3864,3805,46,3851,80
2021-10-17,Colusa,011,21464,2479,2442,608,3050,18
2021-10-17,Contra Costa,013,1133247,98099,97485,2115,99600,995
2021-10-17,Del Norte,015,27424,3616,3526,52,3578,41
2021-10-17,El Dorado,017,186661,15657,15438,1629,17067,149
2021-10-17,Fresno,019,978130,135337,133429,12321,145750,2063
2021-10-17,Glenn,021,27897,3422,3364,987,4351,32
2021-10-17,Humboldt,023,135768,8766,8690,501,9191,104
2021-10-17,Imperial,025,180216,32804,32520,3152,35672,764
2021-10-17,Inyo,027,18085,2100,2000,40,2040,40
2021-10-17,Kern,029,883053,123767,122085,20674,142759,1603
2021-10-17,Kings,031,150075,31187,30636,1844,32480,315
2021-10-17,Lake,033,64148,6552,6437,136,6573,104
2021-10-17,Lassen,035,31185,6701,6605,333,6938,26
2021-10-17,Los Angeles,037,10098052,1422478,1412371,53906,1466277,26443
2021-10-17,Madera,039,155013,22268,21869,1960,23829,277
2021-10-17,Marin,041,260295,17328,17211,438,17649,243
2021-10-17,Mariposa,043,17540,1206,1150,41,1191,5
2021-10-17,Mendocino,045,87422,7268,7148,451,7599,82
2021-10-17,Merced,047,269075,40735,40531,1752,42283,579
2021-10-17,Modoc,049,8938,516,498,183,681,5
2021-10-17,Mono,051,14174,1663,1640,20,1660,3
2021-10-17,Monterey,053,433212,48294,47369,2790,50159,583
2021-10-17,Napa,055,140530,12816,12753,105,12858,100
2021-10-17,Nevada,057,99092,8908,8794,310,9104,90
2021-10-17,Orange,059,3164182,303519,301414,14677,316091,5524
2021-10-17,Placer,061,380077,36034,35559,3512,39071,420
2021-10-17,Plumas,063,18699,1641,1571,32,1603,6
2021-10-17,Riverside,065,2383286,357660,353500,16292,369792,5008
2021-10-17,Sacramento,067,1510023,155177,154080,4322,158402,2213
2021-10-17,San Benito,069,59416,7273,7250,163,7413,71
2021-10-17,San Bernardino,071,2135413,348705,346524,10911,357435,5597
2021-10-17,San Diego,073,3302833,366892,364675,21520,386195,4163
2021-10-17,San Francisco,075,870044,52159,51625,2272,53897,644
2021-10-17,San Joaquin,077,732212,97833,96950,5319,102269,1721
2021-10-17,San Luis Obispo,079,281455,29007,28604,1192,29796,331
2021-10-17,San Mateo,081,765935,53474,52541,830,53371,571
2021-10-17,Santa Barbara,083,443738,43693,43344,1532,44876,522
2021-10-17,Santa Clara,085,1922200,144869,143768,1255,145023,1895
2021-10-17,Santa Cruz,087,273765,20068,19861,996,20857,218
2021-10-17,Shasta,089,179085,20508,20116,3445,23561,312
2021-10-17,Sierra,091,2930,172,165,18,183,0
2021-10-17,Siskiyou,093,43540,3289,3204,1243,4447,42
2021-10-17,Solano,095,438530,45361,44722,1223,45945,340
2021-10-17,Sonoma,097,501317,40589,40306,515,40821,392
2021-10-17,Stanislaus,099,539301,76243,76354,8631,84985,1145
2021-10-17,Sutter,101,95872,13594,13543,313,13856,172
2021-10-17,Tehama,103,63373,8132,8015,1386,9401,107
2021-10-17,Trinity,105,12862,822,686,209,895,11
2021-10-17,Tulare,107,460477,66409,65057,14197,79254,958
2021-10-17,Tuolumne,109,53932,6826,6735,84,6819,89
2021-10-17,Ventura,111,848112,97005,96458,4268,100726,1165
2021-10-17,Yolo,113,214977,19350,19171,1070,20241,248
2021-10-17,Yuba,115,75493,9866,9771,292,10063,82
2021-10-16,Alameda,001,1643700,117963,117027,2746,119773,1365
2021-10-16,Alpine,003,1148,100,102,0,102,0
2021-10-16,Amador,005,37829,5416,5310,58,5368,64
2021-10-16,Butte,007,227075,20185,19612,3609,23221,260
2021-10-16,Calaveras,009,45235,3857,3771,46,3817,80
2021-10-16,Colusa,011,21464,2475,2431,605,3036,18
2021-10-16,Contra Costa,013,1133247,98008,97107,2108,99215,982
2021-10-16,Del Norte,015,27424,3613,3516,52,3568,41
2021-10-16,El Dorado,017,186661,15636,15315,1627,16942,149
2021-10-16,Fresno,019,978130,135184,132433,12304,144737,2051
2021-10-16,Glenn,021,27897,3416,3331,987,4318,26
2021-10-16,Humboldt,023,135768,8754,8621,496,9117,104
2021-10-16,Imperial,025,180216,32789,32368,3150,35518,764
2021-10-16,Inyo,027,18085,2086,1932,40,1972,39
2021-10-16,Kern,029,883053,123612,121354,20591,141945,1590
2021-10-16,Kings,031,150075,31141,30418,1841,32259,314
2021-10-16,Lake,033,64148,6541,6378,136,6514,104
2021-10-16,Lassen,035,31185,6692,6559,328,6887,26
2021-10-16,Los Angeles,037,10098052,1421828,1409418,53851,1463269,26398
2021-10-16,Madera,039,155013,22224,21707,1956,23663,277
2021-10-16,Marin,041,260295,17318,17148,438,17586,243
2021-10-16,Mariposa,043,17540,1203,1096,41,1137,5
2021-10-16,Mendocino,045,87422,7257,7099,451,7550,82
2021-10-16,Merced,047,269075,40703,40265,1750,42015,577
2021-10-16,Modoc,049,8938,513,492,183,675,5
2021-10-16,Mono,051,14174,1659,1628,20,1648,3
2021-10-16,Monterey,053,433212,48277,47293,2782,50075,582
2021-10-16,Napa,055,140530,12805,12706,105,12811,100
2021-10-16,Nevada,057,99092,8888,8739,310,9049,90
2021-10-16,Orange,059,3164182,303343,300722,14652,315374,5509
2021-10-16,Placer,061,380077,35950,35343,3506,38849,412
2021-10-16,Plumas,063,18699,1636,1542,31,1573,6
2021-10-16,Riverside,065,2383286,357391,352435,16280,368715,4990
2021-10-16,Sacramento,067,1510023,154978,153264,4318,157582,2192
2021-10-16,San Benito,069,59416,7260,7210,162,7372,71
2021-10-16,San Bernardino,071,2135413,348498,345418,10903,356321,5566
2021-10-16,San Diego,073,3302833,366569,363109,21504,384613,4151
2021-10-16,San Francisco,075,870044,52112,51436,2268,53704,645
2021-10-16,San Joaquin,077,732212,97761,96507,5316,101823,1708
2021-10-16,San Luis Obispo,079,281455,28981,28460,1191,29651,329
2021-10-16,San Mateo,081,765935,53425,52399,829,53228,569
2021-10-16,Santa Barbara,083,443738,43657,43175,1531,44706,521
2021-10-16,Santa Clara,085,1922200,144769,143282,1247,144529,1890
2021-10-16,Santa Cruz,087,273765,20053,19794,995,20789,218
2021-10-16,Shasta,089,179085,20458,19932,3434,23366,309
2021-10-16,Sierra,091,2930,170,160,18,178,0
2021-10-16,Siskiyou,093,43540,3287,3173,1236,4409,42
2021-10-16,Solano,095,438530,45335,44585,1219,45804,334
2021-10-16,Sonoma,097,501317,40549,40195,515,40710,390
2021-10-16,Stanislaus,099,539301,76157,75868,8621,84489,1142
2021-10-16,Sutter,101,95872,13575,13471,312,13783,169
2021-10-16,Tehama,103,63373,8119,7907,1381,9288,104
2021-10-16,Trinity,105,12862,822,679,209,888,11
2021-10-16,Tulare,107,460477,66271,64489,14164,78653,951
2021-10-16,Tuolumne,109,53932,6794,6666,84,6750,89
2021-10-16,Ventura,111,848112,96973,96181,4263,100444,1164
2021-10-16,Yolo,113,214977,19323,19078,1064,20142,247
2021-10-16,Yuba,115,75493,9842,9705,289,9994,82
2021-10-15,Alameda,001,1643700,117890,117027,2742,119769,1365
2021-10-15,Alpine,003,1148,100,102,0,102,0
2021-10-15,Amador,005,37829,5392,5310,58,5368,64
2021-10-15,Butte,007,227075,20148,19612,3602,23214,260
2021-10-15,Calaveras,009,45235,3851,3771,46,3817,80
2021-10-15,Colusa,011,21464,2473,2431,602,3033,18
2021-10-15,Contra Costa,013,1133247,97926,97107,2104,99211,982
2021-10-15,Del Norte,015,27424,3611,3516,52,3568,41
2021-10-15,El Dorado,017,186661,15616,15315,1622,16937,149
2021-10-15,Fresno,019,978130,134930,132433,12295,144728,2051
2021-10-15,Glenn,021,27897,3410,3331,986,4317,26
2021-10-15,Humboldt,023,135768,8745,8621,494,9115,104
2021-10-15,Imperial,025,180216,32742,32368,3146,35514,764
2021-10-15,Inyo,027,18085,2068,1932,40,1972,39
2021-10-15,Kern,029,883053,123476,121354,20516,141870,1590
2021-10-15,Kings,031,150075,31086,30418,1837,32255,314
2021-10-15,Lake,033,64148,6532,6378,136,6514,104
2021-10-15,Lassen,035,31185,6680,6559,327,6886,26
2021-10-15,Los Angeles,037,10098052,1421137,1409418,53802,1463220,26398
2021-10-15,Madera,039,155013,22180,21707,1948,23655,277
2021-10-15,Marin,041,260295,17307,17148,438,17586,243
2021-10-15,Mariposa,043,17540,1195,1096,41,1137,5
2021-10-15,Mendocino,045,87422,7242,7099,451,7550,82
2021-10-15,Merced,047,269075,40673,40265,1747,42012,577
2021-10-15,Modoc,049,8938,512,492,183,675,5
2021-10-15,Mono,051,14174,1656,1628,20,1648,3
2021-10-15,Monterey,053,433212,48255,47293,2780,50073,582
2021-10-15,Napa,055,140530,12801,12706,105,12811,100
2021-10-15,Nevada,057,99092,8873,8739,310,9049,90
2021-10-15,Orange,059,3164182,303175,300722,14633,315355,5509
2021-10-15,Placer,061,380077,35896,35343,3500,38843,412
2021-10-15,Plumas,063,18699,1628,1542,31,1573,6
2021-10-15,Riverside,065,2383286,357149,352435,16275,368710,4990
2021-10-15,Sacramento,067,1510023,154793,153264,4308,157572,2192
2021-10-15,San Benito,069,59416,7257,7210,162,7372,71
2021-10-15,San Bernardino,071,2135413,348262,345418,10901,356319,5566
2021-10-15,San Diego,073,3302833,366205,363109,21479,384588,4151
2021-10-15,San Francisco,075,870044,52072,51436,2261,53697,645
2021-10-15,San Joaquin,077,732212,97683,96507,5309,101816,1708
2021-10-15,San Luis Obispo,079,281455,28960,28460,1189,29649,329
2021-10-15,San Mateo,081,765935,53381,52399,828,53227,569
2021-10-15,Santa Barbara,083,443738,43619,43175,1531,44706,521
2021-10-15,Santa Clara,085,1922200,144647,143282,1239,144521,1890
2021-10-15,Santa Cruz,087,273765,20042,19794,995,20789,218
2021-10-15,Shasta,089,179085,20401,19932,3426,23358,309
2021-10-15,Sierra,091,2930,170,160,18,178,0
2021-10-15,Siskiyou,093,43540,3286,3173,1233,4406,42
2021-10-15,Solano,095,438530,45309,44585,1219,45804,334
2021-10-15,Sonoma,097,501317,40515,40195,514,40709,390
2021-10-15,Stanislaus,099,539301,76077,75868,8605,84473,1142
2021-10-15,Sutter,101,95872,13558,13471,310,13781,169
2021-10-15,Tehama,103,63373,8098,7907,1375,9282,104
2021-10-15,Trinity,105,12862,822,679,209,888,11
2021-10-15,Tulare,107,460477,66192,64489,14127,78616,951
2021-10-15,Tuolumne,109,53932,6771,6666,82,6748,89
2021-10-15,Ventura,111,848112,96931,96181,4260,100441,1164
2021-10-15,Yolo,113,214977,19308,19078,1060,20138,247
2021-10-15,Yuba,115,75493,9832,9705,288,9993,82
2021-10-14,Alameda,001,1643700,117779,117027,2737,119764,1365
2021-10-14,Alpine,003,1148,100,102,0,102,0
2021-10-14,Amador,005,37829,5381,5310,58,5368,64
2021-10-14,Butte,007,227075,20096,19612,3597,23209,260
2021-10-14,Calaveras,009,45235,3838,3771,45,3816,80
2021-10-14,Colusa,011,21464,2471,2431,600,3031,18
2021-10-14,Contra Costa,013,1133247,97791,97107,2096,99203,982
2021-10-14,Del Norte,015,27424,3605,3516,52,3568,41
2021-10-14,El Dorado,017,186661,15577,15315,1619,16934,149
2021-10-14,Fresno,019,978130,134634,132433,12263,144696,2051
2021-10-14,Glenn,021,27897,3405,3331,985,4316,26
2021-10-14,Humboldt,023,135768,8728,8621,491,9112,104
2021-10-14,Imperial,025,180216,32679,32368,3139,35507,764
2021-10-14,Inyo,027,18085,2049,1932,40,1972,39
2021-10-14,Kern,029,883053,123206,121354,20416,141770,1590
2021-10-14,Kings,031,150075,31021,30418,1829,32247,314
2021-10-14,Lake,033,64148,6511,6378,135,6513,104
2021-10-14,Lassen,035,31185,6674,6559,326,6885,26
2021-10-14,Los Angeles,037,10098052,1420155,1409418,53750,1463168,26398
2021-10-14,Madera,039,155013,22115,21707,1942,23649,277
2021-10-14,Marin,041,260295,17302,17148,436,17584,243
2021-10-14,Mariposa,043,17540,1182,1096,40,1136,5
2021-10-14,Mendocino,045,87422,7228,7099,449,7548,82
2021-10-14,Merced,047,269075,40585,40265,1733,41998,577
2021-10-14,Modoc,049,8938,512,492,183,675,5
2021-10-14,Mono,051,14174,1649,1628,20,1648,3
2021-10-14,Monterey,053,433212,48229,47293,2775,50068,582
2021-10-14,Napa,055,140530,12786,12706,105,12811,100
2021-10-14,Nevada,057,99092,8846,8739,308,9047,90
2021-10-14,Orange,059,3164182,302966,300722,14616,315338,5509
2021-10-14,Placer,061,380077,35829,35343,3486,38829,412
2021-10-14,Plumas,063,18699,1613,1542,31,1573,6
2021-10-14,Riverside,065,2383286,356752,352435,16264,368699,4990
2021-10-14,Sacramento,067,1510023,154542,153264,4286,157550,2192
2021-10-14,San Benito,069,59416,7246,7210,162,7372,71
2021-10-14,San Bernardino,071,2135413,347905,345418,10895,356313,5566
2021-10-14,San Diego,073,3302833,365757,363109,21452,384561,4151
2021-10-14,San Francisco,075,870044,52016,51436,2257,53693,645
2021-10-14,San Joaquin,077,732212,97554,96507,5300,101807,1708
2021-10-14,San Luis Obispo,079,281455,28916,28460,1185,29645,329
2021-10-14,San Mateo,081,765935,53333,52399,827,53226,569
2021-10-14,Santa Barbara,083,443738,43563,43175,1526,44701,521
2021-10-14,Santa Clara,085,1922200,144506,143282,1233,144515,1890
2021-10-14,Santa Cruz,087,273765,20019,19794,995,20789,218
2021-10-14,Shasta,089,179085,20344,19932,3414,23346,309
2021-10-14,Sierra,091,2930,169,160,18,178,0
2021-10-14,Siskiyou,093,43540,3283,3173,1225,4398,42
2021-10-14,Solano,095,438530,45259,44585,1211,45796,334
2021-10-14,Sonoma,097,501317,40464,40195,511,40706,390
2021-10-14,Stanislaus,099,539301,75931,75868,8592,84460,1142
2021-10-14,Sutter,101,95872,13538,13471,309,13780,169
2021-10-14,Tehama,103,63373,8067,7907,1368,9275,104
2021-10-14,Trinity,105,12862,821,679,208,887,11
2021-10-14,Tulare,107,460477,66008,64489,14079,78568,951
2021-10-14,Tuolumne,109,53932,6740,6666,81,6747,89
2021-10-14,Ventura,111,848112,96863,96181,4254,100435,1164
2021-10-14,Yolo,113,214977,19275,19078,1053,20131,247
2021-10-14,Yuba,115,75493,9818,9705,279,9984,82
2021-10-13,Alameda,001,1643700,117672,116914,2732,119646,1360
2021-10-13,Alpine,003,1148,100,102,0,102,0
2021-10-13,Amador,005,37829,5367,5305,58,5363,63
2021-10-13,Butte,007,227075,20022,19546,3593,23139,257
2021-10-13,Calaveras,009,45235,3817,3756,43,3799,79
2021-10-13,Colusa,011,21464,2464,2430,596,3026,18
2021-10-13,Contra Costa,013,1133247,97675,96975,2095,99070,969
2021-10-13,Del Norte,015,27424,3600,3512,52,3564,39
2021-10-13,El Dorado,017,186661,15553,15302,1614,16916,149
2021-10-13,Fresno,019,978130,134300,132055,12230,144285,2048
2021-10-13,Glenn,021,27897,3400,3327,981,4308,26
2021-10-13,Humboldt,023,135768,8717,8604,487,9091,102
2021-10-13,Imperial,025,180216,32619,32317,3135,35452,762
2021-10-13,Inyo,027,18085,2012,1907,40,1947,39
2021-10-13,Kern,029,883053,122962,120956,20321,141277,1586
2021-10-13,Kings,031,150075,30940,30246,1822,32068,312
2021-10-13,Lake,033,64148,6491,6371,135,6506,103
2021-10-13,Lassen,035,31185,6663,6535,320,6855,25
2021-10-13,Los Angeles,037,10098052,1419099,1408384,53693,1462077,26379
2021-10-13,Madera,039,155013,22062,21609,1928,23537,277
2021-10-13,Marin,041,260295,17278,17137,435,17572,243
2021-10-13,Mariposa,043,17540,1168,1090,40,1130,5
2021-10-13,Mendocino,045,87422,7212,7088,441,7529,82
2021-10-13,Merced,047,269075,40500,40164,1722,41886,577
2021-10-13,Modoc,049,8938,510,490,181,671,5
2021-10-13,Mono,051,14174,1649,1612,20,1632,3
2021-10-13,Monterey,053,433212,48210,47273,2768,50041,582
2021-10-13,Napa,055,140530,12775,12695,103,12798,100
2021-10-13,Nevada,057,99092,8824,8725,308,9033,90
2021-10-13,Orange,059,3164182,302758,300468,14600,315068,5503
2021-10-13,Placer,061,380077,35762,35254,3477,38731,412
2021-10-13,Plumas,063,18699,1599,1514,31,1545,6
2021-10-13,Riverside,065,2383286,356422,352044,16251,368295,4978
2021-10-13,Sacramento,067,1510023,154292,153141,4264,157405,2182
2021-10-13,San Benito,069,59416,7240,7196,161,7357,71
2021-10-13,San Bernardino,071,2135413,347580,344951,10879,355830,5562
2021-10-13,San Diego,073,3302833,365321,362564,21430,383994,4141
2021-10-13,San Francisco,075,870044,51974,51379,2253,53632,644
2021-10-13,San Joaquin,077,732212,97411,96343,5295,101638,1696
2021-10-13,San Luis Obispo,079,281455,28878,28397,1182,29579,330
2021-10-13,San Mateo,081,765935,53281,52352,823,53175,569
2021-10-13,Santa Barbara,083,443738,43511,43109,1526,44635,518
2021-10-13,Santa Clara,085,1922200,144368,143064,1232,144296,1886
2021-10-13,Santa Cruz,087,273765,19993,19763,994,20757,217
2021-10-13,Shasta,089,179085,20274,19802,3393,23195,307
2021-10-13,Sierra,091,2930,169,155,18,173,0
2021-10-13,Siskiyou,093,43540,3275,3173,1224,4397,42
2021-10-13,Solano,095,438530,45220,44558,1208,45766,334
2021-10-13,Sonoma,097,501317,40408,40122,511,40633,390
2021-10-13,Stanislaus,099,539301,75790,75698,8582,84280,1136
2021-10-13,Sutter,101,95872,13508,13458,307,13765,169
2021-10-13,Tehama,103,63373,8029,7849,1362,9211,103
2021-10-13,Trinity,105,12862,818,677,208,885,11
2021-10-13,Tulare,107,460477,65828,64297,14023,78320,945
2021-10-13,Tuolumne,109,53932,6726,6644,80,6724,89
2021-10-13,Ventura,111,848112,96789,96099,4248,100347,1162
2021-10-13,Yolo,113,214977,19246,19023,1051,20074,247
2021-10-13,Yuba,115,75493,9793,9690,265,9955,80
2021-10-12,Alameda,001,1643700,117567,116813,2727,119540,1357
2021-10-12,Alpine,003,1148,100,102,0,102,0
2021-10-12,Amador,005,37829,5356,5301,58,5359,63
2021-10-12,Butte,007,227075,19952,19506,3581,23087,256
2021-10-12,Calaveras,009,45235,3802,3750,43,3793,75
2021-10-12,Colusa,011,21464,2461,2428,594,3022,18
2021-10-12,Contra Costa,013,1133247,97560,96894,2086,98980,960
2021-10-12,Del Norte,015,27424,3594,3511,52,3563,39
2021-10-12,El Dorado,017,186661,15519,15287,1612,16899,148
2021-10-12,Fresno,019,978130,133937,131848,12199,144047,2042
2021-10-12,Glenn,021,27897,3385,3321,980,4301,26
2021-10-12,Humboldt,023,135768,8690,8587,481,9068,102
2021-10-12,Imperial,025,180216,32567,32267,3133,35400,762
2021-10-12,Inyo,027,18085,1980,1889,40,1929,39
2021-10-12,Kern,029,883053,122675,120826,20210,141036,1580
2021-10-12,Kings,031,150075,30866,30200,1811,32011,312
2021-10-12,Lake,033,64148,6476,6372,133,6505,97
2021-10-12,Lassen,035,31185,6653,6526,319,6845,25
2021-10-12,Los Angeles,037,10098052,1418032,1407462,53645,1461107,26362
2021-10-12,Madera,039,155013,21991,21574,1915,23489,277
2021-10-12,Marin,041,260295,17255,17126,435,17561,242
2021-10-12,Mariposa,043,17540,1154,1088,40,1128,5
2021-10-12,Mendocino,045,87422,7183,7077,438,7515,82
2021-10-12,Merced,047,269075,40421,40113,1716,41829,567
2021-10-12,Modoc,049,8938,505,485,180,665,5
2021-10-12,Mono,051,14174,1647,1608,20,1628,3
2021-10-12,Monterey,053,433212,48179,47254,2760,50014,582
2021-10-12,Napa,055,140530,12761,12671,103,12774,97
2021-10-12,Nevada,057,99092,8812,8720,307,9027,89
2021-10-12,Orange,059,3164182,302504,300256,14574,314830,5499
2021-10-12,Placer,061,380077,35699,35214,3469,38683,404
2021-10-12,Plumas,063,18699,1585,1488,30,1518,6
2021-10-12,Riverside,065,2383286,356095,351771,16237,368008,4973
2021-10-12,Sacramento,067,1510023,153988,152935,4239,157174,2170
2021-10-12,San Benito,069,59416,7226,7193,161,7354,71
2021-10-12,San Bernardino,071,2135413,347266,344788,10870,355658,5563
2021-10-12,San Diego,073,3302833,364798,362256,21401,383657,4137
2021-10-12,San Francisco,075,870044,51911,51301,2252,53553,643
2021-10-12,San Joaquin,077,732212,97274,96237,5290,101527,1690
2021-10-12,San Luis Obispo,079,281455,28831,28379,1181,29560,327
2021-10-12,San Mateo,081,765935,53231,52328,822,53150,569
2021-10-12,Santa Barbara,083,443738,43450,43076,1526,44602,515
2021-10-12,Santa Clara,085,1922200,144214,142954,1230,144184,1882
2021-10-12,Santa Cruz,087,273765,19968,19757,994,20751,218
2021-10-12,Shasta,089,179085,20200,19731,3372,23103,304
2021-10-12,Sierra,091,2930,169,153,18,171,0
2021-10-12,Siskiyou,093,43540,3264,3166,1218,4384,42
2021-10-12,Solano,095,438530,45178,44516,1203,45719,329
2021-10-12,Sonoma,097,501317,40367,40105,510,40615,390
2021-10-12,Stanislaus,099,539301,75638,75589,8569,84158,1126
2021-10-12,Sutter,101,95872,13485,13436,303,13739,168
2021-10-12,Tehama,103,63373,7996,7820,1358,9178,103
2021-10-12,Trinity,105,12862,815,676,208,884,11
2021-10-12,Tulare,107,460477,65643,64216,13966,78182,944
2021-10-12,Tuolumne,109,53932,6709,6637,79,6716,89
2021-10-12,Ventura,111,848112,96688,96022,4243,100265,1160
2021-10-12,Yolo,113,214977,19219,18987,1043,20030,247
2021-10-12,Yuba,115,75493,9778,9676,261,9937,70
2021-10-11,Alameda,001,1643700,117425,116759,2726,119485,1358
2021-10-11,Alpine,003,1148,100,102,0,102,0
2021-10-11,Amador,005,37829,5344,5286,58,5344,62
2021-10-11,Butte,007,227075,19893,19452,3576,23028,253
2021-10-11,Calaveras,009,45235,3781,3750,43,3793,75
2021-10-11,Colusa,011,21464,2457,2427,586,3013,18
2021-10-11,Contra Costa,013,1133247,97424,96832,2081,98913,960
2021-10-11,Del Norte,015,27424,3591,3510,48,3558,39
2021-10-11,El Dorado,017,186661,15489,15273,1608,16881,146
2021-10-11,Fresno,019,978130,133607,131703,12164,143867,2036
2021-10-11,Glenn,021,27897,3368,3308,977,4285,26
2021-10-11,Humboldt,023,135768,8665,8571,474,9045,101
2021-10-11,Imperial,025,180216,32517,32207,3127,35334,762
2021-10-11,Inyo,027,18085,1957,1862,39,1901,39
2021-10-11,Kern,029,883053,122439,120684,20114,140798,1575
2021-10-11,Kings,031,150075,30777,30180,1801,31981,309
2021-10-11,Lake,033,64148,6460,6361,129,6490,97
2021-10-11,Lassen,035,31185,6633,6499,316,6815,25
2021-10-11,Los Angeles,037,10098052,1416984,1406826,53594,1460420,26346
2021-10-11,Madera,039,155013,21934,21555,1898,23453,272
2021-10-11,Marin,041,260295,17237,17121,431,17552,242
2021-10-11,Mariposa,043,17540,1124,1083,39,1122,5
2021-10-11,Mendocino,045,87422,7167,7064,434,7498,82
2021-10-11,Merced,047,269075,40305,40064,1691,41755,566
2021-10-11,Modoc,049,8938,502,482,177,659,5
2021-10-11,Mono,051,14174,1637,1604,20,1624,3
2021-10-11,Monterey,053,433212,48150,47241,2753,49994,580
2021-10-11,Napa,055,140530,12738,12654,101,12755,96
2021-10-11,Nevada,057,99092,8792,8716,306,9022,90
2021-10-11,Orange,059,3164182,302276,299941,14544,314485,5499
2021-10-11,Placer,061,380077,35630,35173,3452,38625,404
2021-10-11,Plumas,063,18699,1567,1469,28,1497,6
2021-10-11,Riverside,065,2383286,355751,351444,16232,367676,4973
2021-10-11,Sacramento,067,1510023,153698,152681,4208,156889,2169
2021-10-11,San Benito,069,59416,7205,7184,159,7343,71
2021-10-11,San Bernardino,071,2135413,346878,344594,10862,355456,5549
2021-10-11,San Diego,073,3302833,364277,361712,21369,383081,4124
2021-10-11,San Francisco,075,870044,51840,51275,2248,53523,643
2021-10-11,San Joaquin,077,732212,97120,96152,5279,101431,1681
2021-10-11,San Luis Obispo,079,281455,28784,28355,1176,29531,327
2021-10-11,San Mateo,081,765935,53183,52298,821,53119,569
2021-10-11,Santa Barbara,083,443738,43403,43018,1525,44543,515
2021-10-11,Santa Clara,085,1922200,144052,142836,1226,144062,1882
2021-10-11,Santa Cruz,087,273765,19944,19745,993,20738,217
2021-10-11,Shasta,089,179085,20121,19662,3356,23018,295
2021-10-11,Sierra,091,2930,166,147,17,164,0
2021-10-11,Siskiyou,093,43540,3257,3159,1214,4373,42
2021-10-11,Solano,095,438530,45129,44474,1200,45674,329
2021-10-11,Sonoma,097,501317,40322,40067,510,40577,390
2021-10-11,Stanislaus,099,539301,75466,75478,8548,84026,1118
2021-10-11,Sutter,101,95872,13466,13427,301,13728,165
2021-10-11,Tehama,103,63373,7955,7795,1349,9144,102
2021-10-11,Trinity,105,12862,809,675,207,882,11
2021-10-11,Tulare,107,460477,65463,64094,13899,77993,942
2021-10-11,Tuolumne,109,53932,6671,6602,79,6681,89
2021-10-11,Ventura,111,848112,96591,95876,4236,100112,1160
2021-10-11,Yolo,113,214977,19173,18977,1040,20017,247
2021-10-11,Yuba,115,75493,9761,9657,249,9906,69
2021-10-10,Alameda,001,1643700,117305,116679,2722,119401,1358
2021-10-10,Alpine,003,1148,100,102,0,102,0
2021-10-10,Amador,005,37829,5330,5278,58,5336,62
2021-10-10,Butte,007,227075,19829,19430,3562,22992,253
2021-10-10,Calaveras,009,45235,3769,3747,43,3790,75
2021-10-10,Colusa,011,21464,2456,2425,585,3010,18
2021-10-10,Contra Costa,013,1133247,97325,96760,2075,98835,960
2021-10-10,Del Norte,015,27424,3587,3507,48,3555,39
2021-10-10,El Dorado,017,186661,15459,15250,1602,16852,146
2021-10-10,Fresno,019,978130,133277,131434,12133,143567,2035
2021-10-10,Glenn,021,27897,3364,3297,975,4272,26
2021-10-10,Humboldt,023,135768,8643,8554,470,9024,101
2021-10-10,Imperial,025,180216,32443,32167,3126,35293,762
2021-10-10,Inyo,027,18085,1936,1857,39,1896,39
2021-10-10,Kern,029,883053,122113,120552,20010,140562,1573
2021-10-10,Kings,031,150075,30688,30122,1791,31913,308
2021-10-10,Lake,033,64148,6444,6349,128,6477,97
2021-10-10,Lassen,035,31185,6613,6495,315,6810,26
2021-10-10,Los Angeles,037,10098052,1415796,1406034,53519,1459553,26338
2021-10-10,Madera,039,155013,21888,21486,1889,23375,272
2021-10-10,Marin,041,260295,17220,17112,431,17543,242
2021-10-10,Mariposa,043,17540,1121,1074,39,1113,5
2021-10-10,Mendocino,045,87422,7152,7060,426,7486,81
2021-10-10,Merced,047,269075,40220,40036,1673,41709,566
2021-10-10,Modoc,049,8938,502,482,177,659,5
2021-10-10,Mono,051,14174,1636,1596,20,1616,3
2021-10-10,Monterey,053,433212,48120,47228,2752,49980,580
2021-10-10,Napa,055,140530,12715,12641,101,12742,96
2021-10-10,Nevada,057,99092,8780,8689,306,8995,90
2021-10-10,Orange,059,3164182,302014,299787,14516,314303,5499
2021-10-10,Placer,061,380077,35537,35128,3440,38568,404
2021-10-10,Plumas,063,18699,1551,1468,26,1494,6
2021-10-10,Riverside,065,2383286,355378,351248,16213,367461,4973
2021-10-10,Sacramento,067,1510023,153433,152405,4191,156596,2178
2021-10-10,San Benito,069,59416,7200,7180,158,7338,71
2021-10-10,San Bernardino,071,2135413,346572,344423,10854,355277,5551
2021-10-10,San Diego,073,3302833,363751,361038,21322,382360,4113
2021-10-10,San Francisco,075,870044,51793,51216,2245,53461,643
2021-10-10,San Joaquin,077,732212,96949,96084,5262,101346,1681
2021-10-10,San Luis Obispo,079,281455,28740,28343,1176,29519,326
2021-10-10,San Mateo,081,765935,53141,52273,820,53093,569
2021-10-10,Santa Barbara,083,443738,43356,42987,1524,44511,515
2021-10-10,Santa Clara,085,1922200,143887,142768,1219,143987,1881
2021-10-10,Santa Cruz,087,273765,19924,19727,993,20720,217
2021-10-10,Shasta,089,179085,20033,19635,3347,22982,296
2021-10-10,Sierra,091,2930,164,147,17,164,0
2021-10-10,Siskiyou,093,43540,3243,3155,1207,4362,42
2021-10-10,Solano,095,438530,45073,44431,1200,45631,329
2021-10-10,Sonoma,097,501317,40270,40027,510,40537,390
2021-10-10,Stanislaus,099,539301,75289,75403,8534,83937,1118
2021-10-10,Sutter,101,95872,13442,13412,296,13708,165
2021-10-10,Tehama,103,63373,7917,7764,1340,9104,102
2021-10-10,Trinity,105,12862,808,669,206,875,11
2021-10-10,Tulare,107,460477,65291,63930,13848,77778,940
2021-10-10,Tuolumne,109,53932,6647,6580,78,6658,89
2021-10-10,Ventura,111,848112,96502,95829,4236,100065,1160
2021-10-10,Yolo,113,214977,19141,18952,1035,19987,247
2021-10-10,Yuba,115,75493,9745,9641,244,9885,69
2021-10-09,Alameda,001,1643700,117206,116253,2720,118973,1356
2021-10-09,Alpine,003,1148,99,102,0,102,0
2021-10-09,Amador,005,37829,5328,5237,57,5294,62
2021-10-09,Butte,007,227075,19798,19277,3559,22836,250
2021-10-09,Calaveras,009,45235,3765,3716,43,3759,75
2021-10-09,Colusa,011,21464,2452,2419,584,3003,18
2021-10-09,Contra Costa,013,1133247,97254,96378,2069,98447,958
2021-10-09,Del Norte,015,27424,3586,3495,48,3543,39
2021-10-09,El Dorado,017,186661,15441,15153,1599,16752,144
2021-10-09,Fresno,019,978130,133145,130508,12114,142622,2018
2021-10-09,Glenn,021,27897,3360,3277,973,4250,26
2021-10-09,Humboldt,023,135768,8629,8448,468,8916,97
2021-10-09,Imperial,025,180216,32409,31989,3124,35113,760
2021-10-09,Inyo,027,18085,1927,1808,39,1847,39
2021-10-09,Kern,029,883053,121974,119795,19983,139778,1559
2021-10-09,Kings,031,150075,30639,29894,1789,31683,308
2021-10-09,Lake,033,64148,6425,6283,127,6410,97
2021-10-09,Lassen,035,31185,6608,6442,314,6756,25
2021-10-09,Los Angeles,037,10098052,1415207,1402810,53480,1456290,26280
2021-10-09,Madera,039,155013,21855,21313,1875,23188,271
2021-10-09,Marin,041,260295,17215,17049,429,17478,242
2021-10-09,Mariposa,043,17540,1114,1042,38,1080,5
2021-10-09,Mendocino,045,87422,7145,7011,425,7436,82
2021-10-09,Merced,047,269075,40178,39784,1673,41457,565
2021-10-09,Modoc,049,8938,500,477,176,653,5
2021-10-09,Mono,051,14174,1633,1577,20,1597,3
2021-10-09,Monterey,053,433212,48108,47168,2749,49917,577
2021-10-09,Napa,055,140530,12711,12586,101,12687,96
2021-10-09,Nevada,057,99092,8769,8613,305,8918,90
2021-10-09,Orange,059,3164182,301833,299089,14497,313586,5457
2021-10-09,Placer,061,380077,35499,34877,3433,38310,393
2021-10-09,Plumas,063,18699,1540,1418,26,1444,6
2021-10-09,Riverside,065,2383286,355127,350082,16196,366278,4965
2021-10-09,Sacramento,067,1510023,153223,151566,4178,155744,2160
2021-10-09,San Benito,069,59416,7192,7123,158,7281,71
2021-10-09,San Bernardino,071,2135413,346388,343452,10850,354302,5556
2021-10-09,San Diego,073,3302833,363436,359909,21317,381226,4111
2021-10-09,San Francisco,075,870044,51745,50960,2238,53198,643
2021-10-09,San Joaquin,077,732212,96883,95606,5257,100863,1669
2021-10-09,San Luis Obispo,079,281455,28723,28197,1174,29371,324
2021-10-09,San Mateo,081,765935,53110,52121,819,52940,569
2021-10-09,Santa Barbara,083,443738,43329,42735,1524,44259,514
2021-10-09,Santa Clara,085,1922200,143764,142298,1213,143511,1873
2021-10-09,Santa Cruz,087,273765,19914,19635,992,20627,217
2021-10-09,Shasta,089,179085,19983,19437,3342,22779,290
2021-10-09,Sierra,091,2930,161,141,17,158,0
2021-10-09,Siskiyou,093,43540,3242,3124,1206,4330,42
2021-10-09,Solano,095,438530,45056,44265,1199,45464,329
2021-10-09,Sonoma,097,501317,40226,39848,509,40357,387
2021-10-09,Stanislaus,099,539301,75199,74899,8524,83423,1114
2021-10-09,Sutter,101,95872,13433,13314,294,13608,165
2021-10-09,Tehama,103,63373,7906,7670,1335,9005,99
2021-10-09,Trinity,105,12862,807,660,206,866,11
2021-10-09,Tulare,107,460477,65183,63398,13826,77224,932
2021-10-09,Tuolumne,109,53932,6628,6521,78,6599,89
2021-10-09,Ventura,111,848112,96448,95542,4233,99775,1158
2021-10-09,Yolo,113,214977,19120,18850,1032,19882,247
2021-10-09,Yuba,115,75493,9733,9551,242,9793,69
2021-10-08,Alameda,001,1643700,117125,116253,2717,118970,1356
2021-10-08,Alpine,003,1148,99,102,0,102,0
2021-10-08,Amador,005,37829,5315,5237,57,5294,62
2021-10-08,Butte,007,227075,19769,19277,3555,22832,250
2021-10-08,Calaveras,009,45235,3760,3716,43,3759,75
2021-10-08,Colusa,011,21464,2450,2419,584,3003,18
2021-10-08,Contra Costa,013,1133247,97210,96378,2064,98442,958
2021-10-08,Del Norte,015,27424,3585,3495,48,3543,39
2021-10-08,El Dorado,017,186661,15421,15153,1595,16748,144
2021-10-08,Fresno,019,978130,132948,130508,12091,142599,2018
2021-10-08,Glenn,021,27897,3352,3277,971,4248,26
2021-10-08,Humboldt,023,135768,8618,8448,465,8913,97
2021-10-08,Imperial,025,180216,32379,31989,3120,35109,760
2021-10-08,Inyo,027,18085,1909,1808,39,1847,39
2021-10-08,Kern,029,883053,121837,119795,19941,139736,1559
2021-10-08,Kings,031,150075,30545,29894,1788,31682,308
2021-10-08,Lake,033,64148,6417,6283,127,6410,97
2021-10-08,Lassen,035,31185,6594,6442,311,6753,25
2021-10-08,Los Angeles,037,10098052,1414546,1402810,53443,1456253,26280
2021-10-08,Madera,039,155013,21796,21313,1868,23181,271
2021-10-08,Marin,041,260295,17204,17049,428,17477,242
2021-10-08,Mariposa,043,17540,1107,1042,36,1078,5
2021-10-08,Mendocino,045,87422,7132,7011,425,7436,82
2021-10-08,Merced,047,269075,40146,39784,1670,41454,565
2021-10-08,Modoc,049,8938,498,477,176,653,5
2021-10-08,Mono,051,14174,1630,1577,20,1597,3
2021-10-08,Monterey,053,433212,48081,47168,2747,49915,577
2021-10-08,Napa,055,140530,12695,12586,101,12687,96
2021-10-08,Nevada,057,99092,8756,8613,305,8918,90
2021-10-08,Orange,059,3164182,301686,299089,14477,313566,5457
2021-10-08,Placer,061,380077,35461,34877,3425,38302,393
2021-10-08,Plumas,063,18699,1528,1418,26,1444,6
2021-10-08,Riverside,065,2383286,354858,350082,16185,366267,4965
2021-10-08,Sacramento,067,1510023,153058,151566,4164,155730,2160
2021-10-08,San Benito,069,59416,7188,7123,156,7279,71
2021-10-08,San Bernardino,071,2135413,346180,343452,10842,354294,5556
2021-10-08,San Diego,073,3302833,363101,359909,21299,381208,4111
2021-10-08,San Francisco,075,870044,51698,50960,2229,53189,643
2021-10-08,San Joaquin,077,732212,96815,95606,5251,100857,1669
2021-10-08,San Luis Obispo,079,281455,28696,28197,1173,29370,324
2021-10-08,San Mateo,081,765935,53082,52121,819,52940,569
2021-10-08,Santa Barbara,083,443738,43294,42735,1523,44258,514
2021-10-08,Santa Clara,085,1922200,143651,142298,1208,143506,1873
2021-10-08,Santa Cruz,087,273765,19899,19635,992,20627,217
2021-10-08,Shasta,089,179085,19941,19437,3336,22773,290
2021-10-08,Sierra,091,2930,159,141,15,156,0
2021-10-08,Siskiyou,093,43540,3234,3124,1205,4329,42
2021-10-08,Solano,095,438530,45017,44265,1198,45463,329
2021-10-08,Sonoma,097,501317,40190,39848,509,40357,387
2021-10-08,Stanislaus,099,539301,75130,74899,8515,83414,1114
2021-10-08,Sutter,101,95872,13419,13314,292,13606,165
2021-10-08,Tehama,103,63373,7889,7670,1333,9003,99
2021-10-08,Trinity,105,12862,806,660,206,866,11
2021-10-08,Tulare,107,460477,65065,63398,13794,77192,932
2021-10-08,Tuolumne,109,53932,6605,6521,78,6599,89
2021-10-08,Ventura,111,848112,96397,95542,4227,99769,1158
2021-10-08,Yolo,113,214977,19107,18850,1028,19878,247
2021-10-08,Yuba,115,75493,9713,9551,241,9792,69
2021-10-07,Alameda,001,1643700,117004,116253,2716,118969,1356
2021-10-07,Alpine,003,1148,99,102,0,102,0
2021-10-07,Amador,005,37829,5308,5237,57,5294,62
2021-10-07,Butte,007,227075,19720,19277,3544,22821,250
2021-10-07,Calaveras,009,45235,3748,3716,43,3759,75
2021-10-07,Colusa,011,21464,2447,2419,578,2997,18
2021-10-07,Contra Costa,013,1133247,97087,96378,2060,98438,958
2021-10-07,Del Norte,015,27424,3582,3495,48,3543,39
2021-10-07,El Dorado,017,186661,15385,15153,1591,16744,144
2021-10-07,Fresno,019,978130,132673,130508,12067,142575,2018
2021-10-07,Glenn,021,27897,3345,3277,969,4246,26
2021-10-07,Humboldt,023,135768,8592,8448,462,8910,97
2021-10-07,Imperial,025,180216,32307,31989,3107,35096,760
2021-10-07,Inyo,027,18085,1890,1808,39,1847,39
2021-10-07,Kern,029,883053,121606,119795,19875,139670,1559
2021-10-07,Kings,031,150075,30480,29894,1782,31676,308
2021-10-07,Lake,033,64148,6406,6283,127,6410,97
2021-10-07,Lassen,035,31185,6576,6442,309,6751,25
2021-10-07,Los Angeles,037,10098052,1413588,1402810,53398,1456208,26280
2021-10-07,Madera,039,155013,21723,21313,1854,23167,271
2021-10-07,Marin,041,260295,17186,17049,428,17477,242
2021-10-07,Mariposa,043,17540,1099,1042,36,1078,5
2021-10-07,Mendocino,045,87422,7122,7011,421,7432,82
2021-10-07,Merced,047,269075,40079,39784,1653,41437,565
2021-10-07,Modoc,049,8938,495,477,175,652,5
2021-10-07,Mono,051,14174,1621,1577,20,1597,3
2021-10-07,Monterey,053,433212,48056,47168,2738,49906,577
2021-10-07,Napa,055,140530,12680,12586,101,12687,96
2021-10-07,Nevada,057,99092,8728,8613,305,8918,90
2021-10-07,Orange,059,3164182,301460,299089,14463,313552,5457
2021-10-07,Placer,061,380077,35399,34877,3418,38295,393
2021-10-07,Plumas,063,18699,1511,1418,26,1444,6
2021-10-07,Riverside,065,2383286,354525,350082,16173,366255,4965
2021-10-07,Sacramento,067,1510023,152776,151566,4137,155703,2160
2021-10-07,San Benito,069,59416,7172,7123,154,7277,71
2021-10-07,San Bernardino,071,2135413,345909,343452,10835,354287,5556
2021-10-07,San Diego,073,3302833,362689,359909,21278,381187,4111
2021-10-07,San Francisco,075,870044,51628,50960,2226,53186,643
2021-10-07,San Joaquin,077,732212,96661,95606,5243,100849,1669
2021-10-07,San Luis Obispo,079,281455,28645,28197,1171,29368,324
2021-10-07,San Mateo,081,765935,53042,52121,817,52938,569
2021-10-07,Santa Barbara,083,443738,43226,42735,1517,44252,514
2021-10-07,Santa Clara,085,1922200,143500,142298,1202,143500,1873
2021-10-07,Santa Cruz,087,273765,19879,19635,991,20626,217
2021-10-07,Shasta,089,179085,19852,19437,3321,22758,290
2021-10-07,Sierra,091,2930,158,141,15,156,0
2021-10-07,Siskiyou,093,43540,3230,3124,1200,4324,42
2021-10-07,Solano,095,438530,44972,44265,1194,45459,329
2021-10-07,Sonoma,097,501317,40153,39848,507,40355,387
2021-10-07,Stanislaus,099,539301,74967,74899,8490,83389,1114
2021-10-07,Sutter,101,95872,13397,13314,289,13603,165
2021-10-07,Tehama,103,63373,7856,7670,1327,8997,99
2021-10-07,Trinity,105,12862,804,660,206,866,11
2021-10-07,Tulare,107,460477,64899,63398,13756,77154,932
2021-10-07,Tuolumne,109,53932,6583,6521,78,6599,89
2021-10-07,Ventura,111,848112,96324,95542,4224,99766,1158
2021-10-07,Yolo,113,214977,19074,18850,1023,19873,247
2021-10-07,Yuba,115,75493,9687,9551,234,9785,69
2021-10-06,Alameda,001,1643700,116868,116058,2710,118768,1353
2021-10-06,Alpine,003,1148,99,102,0,102,0
2021-10-06,Amador,005,37829,5305,5205,57,5262,62
2021-10-06,Butte,007,227075,19657,19208,3537,22745,247
2021-10-06,Calaveras,009,45235,3739,3669,43,3712,75
2021-10-06,Colusa,011,21464,2445,2414,571,2985,18
2021-10-06,Contra Costa,013,1133247,96960,96184,2056,98240,953
2021-10-06,Del Norte,015,27424,3579,3490,45,3535,39
2021-10-06,El Dorado,017,186661,15360,15078,1588,16666,140
2021-10-06,Fresno,019,978130,132383,130074,12042,142116,2008
2021-10-06,Glenn,021,27897,3336,3270,967,4237,26
2021-10-06,Humboldt,023,135768,8577,8416,455,8871,94
2021-10-06,Imperial,025,180216,32254,31930,3096,35026,760
2021-10-06,Inyo,027,18085,1875,1806,39,1845,39
2021-10-06,Kern,029,883053,121349,119491,19782,139273,1552
2021-10-06,Kings,031,150075,30414,29785,1774,31559,308
2021-10-06,Lake,033,64148,6392,6271,127,6398,97
2021-10-06,Lassen,035,31185,6559,6429,308,6737,25
2021-10-06,Los Angeles,037,10098052,1412629,1401675,53349,1455024,26252
2021-10-06,Madera,039,155013,21668,21230,1844,23074,269
2021-10-06,Marin,041,260295,17177,17042,425,17467,242
2021-10-06,Mariposa,043,17540,1092,1036,36,1072,5
2021-10-06,Mendocino,045,87422,7113,6986,419,7405,81
2021-10-06,Merced,047,269075,40004,39666,1641,41307,563
2021-10-06,Modoc,049,8938,495,477,173,650,5
2021-10-06,Mono,051,14174,1609,1568,20,1588,3
2021-10-06,Monterey,053,433212,48023,47136,2733,49869,577
2021-10-06,Napa,055,140530,12656,12552,100,12652,96
2021-10-06,Nevada,057,99092,8712,8582,304,8886,90
2021-10-06,Orange,059,3164182,301222,298785,14450,313235,5448
2021-10-06,Placer,061,380077,35348,34764,3412,38176,390
2021-10-06,Plumas,063,18699,1488,1383,26,1409,6
2021-10-06,Riverside,065,2383286,354169,349645,16152,365797,4953
2021-10-06,Sacramento,067,1510023,152523,151164,4106,155270,2141
2021-10-06,San Benito,069,59416,7157,7108,154,7262,69
2021-10-06,San Bernardino,071,2135413,345617,343022,10828,353850,5551
2021-10-06,San Diego,073,3302833,362190,359564,21250,380814,4104
2021-10-06,San Francisco,075,870044,51565,50894,2223,53117,641
2021-10-06,San Joaquin,077,732212,96527,95418,5231,100649,1658
2021-10-06,San Luis Obispo,079,281455,28595,28170,1165,29335,323
2021-10-06,San Mateo,081,765935,52992,52056,812,52868,569
2021-10-06,Santa Barbara,083,443738,43143,42687,1515,44202,513
2021-10-06,Santa Clara,085,1922200,143349,142124,1197,143321,1872
2021-10-06,Santa Cruz,087,273765,19850,19604,989,20593,217
2021-10-06,Shasta,089,179085,19778,19325,3308,22633,287
2021-10-06,Sierra,091,2930,156,138,15,153,0
2021-10-06,Siskiyou,093,43540,3220,3116,1193,4309,42
2021-10-06,Solano,095,438530,44938,44185,1193,45378,328
2021-10-06,Sonoma,097,501317,40103,39787,506,40293,383
2021-10-06,Stanislaus,099,539301,74825,74699,8477,83176,1114
2021-10-06,Sutter,101,95872,13376,13284,287,13571,164
2021-10-06,Tehama,103,63373,7820,7629,1320,8949,99
2021-10-06,Trinity,105,12862,801,656,206,862,11
2021-10-06,Tulare,107,460477,64719,63198,13696,76894,926
2021-10-06,Tuolumne,109,53932,6558,6486,78,6564,89
2021-10-06,Ventura,111,848112,96233,95449,4216,99665,1158
2021-10-06,Yolo,113,214977,19042,18815,1018,19833,247
2021-10-06,Yuba,115,75493,9663,9520,233,9753,69
2021-10-05,Alameda,001,1643700,116721,115968,2705,118673,1350
2021-10-05,Alpine,003,1148,99,102,0,102,0
2021-10-05,Amador,005,37829,5284,5194,56,5250,61
2021-10-05,Butte,007,227075,19609,19137,3527,22664,246
2021-10-05,Calaveras,009,45235,3723,3657,43,3700,73
2021-10-05,Colusa,011,21464,2438,2414,570,2984,18
2021-10-05,Contra Costa,013,1133247,96844,96108,2050,98158,941
2021-10-05,Del Norte,015,27424,3577,3485,44,3529,39
2021-10-05,El Dorado,017,186661,15321,15052,1585,16637,140
2021-10-05,Fresno,019,978130,132043,129957,12005,141962,1987
2021-10-05,Glenn,021,27897,3326,3270,964,4234,26
2021-10-05,Humboldt,023,135768,8546,8398,451,8849,94
2021-10-05,Imperial,025,180216,32206,31909,3091,35000,759
2021-10-05,Inyo,027,18085,1858,1800,39,1839,39
2021-10-05,Kern,029,883053,121084,119260,19680,138940,1540
2021-10-05,Kings,031,150075,30339,29749,1768,31517,301
2021-10-05,Lake,033,64148,6371,6264,126,6390,97
2021-10-05,Lassen,035,31185,6540,6417,306,6723,25
2021-10-05,Los Angeles,037,10098052,1411485,1400300,53296,1453596,26223
2021-10-05,Madera,039,155013,21610,21183,1831,23014,269
2021-10-05,Marin,041,260295,17165,17024,425,17449,242
2021-10-05,Mariposa,043,17540,1073,1033,33,1066,5
2021-10-05,Mendocino,045,87422,7097,6972,412,7384,79
2021-10-05,Merced,047,269075,39938,39608,1633,41241,562
2021-10-05,Modoc,049,8938,491,475,172,647,5
2021-10-05,Mono,051,14174,1601,1565,20,1585,3
2021-10-05,Monterey,053,433212,48006,47087,2723,49810,573
2021-10-05,Napa,055,140530,12632,12533,100,12633,96
2021-10-05,Nevada,057,99092,8682,8576,304,8880,90
2021-10-05,Orange,059,3164182,300945,298589,14418,313007,5441
2021-10-05,Placer,061,380077,35268,34728,3405,38133,382
2021-10-05,Plumas,063,18699,1463,1357,26,1383,6
2021-10-05,Riverside,065,2383286,353809,349365,16137,365502,4942
2021-10-05,Sacramento,067,1510023,152250,151111,4077,155188,2126
2021-10-05,San Benito,069,59416,7139,7103,152,7255,69
2021-10-05,San Bernardino,071,2135413,345288,342711,10821,353532,5557
2021-10-05,San Diego,073,3302833,361606,359194,21223,380417,4092
2021-10-05,San Francisco,075,870044,51468,50826,2220,53046,641
2021-10-05,San Joaquin,077,732212,96374,95276,5204,100480,1651
2021-10-05,San Luis Obispo,079,281455,28551,28113,1163,29276,324
2021-10-05,San Mateo,081,765935,52946,52008,812,52820,569
2021-10-05,Santa Barbara,083,443738,43065,42595,1511,44106,511
2021-10-05,Santa Clara,085,1922200,143191,141971,1190,143161,1873
2021-10-05,Santa Cruz,087,273765,19808,19582,989,20571,216
2021-10-05,Shasta,089,179085,19704,19285,3295,22580,286
2021-10-05,Sierra,091,2930,152,136,15,151,0
2021-10-05,Siskiyou,093,43540,3206,3107,1193,4300,42
2021-10-05,Solano,095,438530,44867,44149,1191,45340,325
2021-10-05,Sonoma,097,501317,40048,39756,501,40257,383
2021-10-05,Stanislaus,099,539301,74663,74599,8460,83059,1114
2021-10-05,Sutter,101,95872,13348,13270,286,13556,164
2021-10-05,Tehama,103,63373,7790,7607,1311,8918,98
2021-10-05,Trinity,105,12862,798,655,206,861,11
2021-10-05,Tulare,107,460477,64512,63093,13642,76735,920
2021-10-05,Tuolumne,109,53932,6543,6473,77,6550,89
2021-10-05,Ventura,111,848112,96127,95351,4215,99566,1155
2021-10-05,Yolo,113,214977,19006,18782,1012,19794,245
2021-10-05,Yuba,115,75493,9631,9504,230,9734,69
2021-10-04,Alameda,001,1643700,116557,115845,2702,118547,1347
2021-10-04,Alpine,003,1148,99,102,0,102,0
2021-10-04,Amador,005,37829,5274,5163,55,5218,61
2021-10-04,Butte,007,227075,19532,19081,3515,22596,245
2021-10-04,Calaveras,009,45235,3714,3641,43,3684,73
2021-10-04,Colusa,011,21464,2437,2414,568,2982,18
2021-10-04,Contra Costa,013,1133247,96703,95958,2045,98003,937
2021-10-04,Del Norte,015,27424,3575,3485,40,3525,39
2021-10-04,El Dorado,017,186661,15274,15031,1578,16609,138
2021-10-04,Fresno,019,978130,131733,129665,11975,141640,1978
2021-10-04,Glenn,021,27897,3319,3270,961,4231,26
2021-10-04,Humboldt,023,135768,8514,8355,443,8798,94
2021-10-04,Imperial,025,180216,32157,31866,3084,34950,757
2021-10-04,Inyo,027,18085,1846,1792,36,1828,39
2021-10-04,Kern,029,883053,120793,118984,19559,138543,1531
2021-10-04,Kings,031,150075,30246,29702,1765,31467,303
2021-10-04,Lake,033,64148,6358,6248,126,6374,97
2021-10-04,Lassen,035,31185,6523,6405,306,6711,25
2021-10-04,Los Angeles,037,10098052,1410370,1399604,53236,1452840,26186
2021-10-04,Madera,039,155013,21546,21126,1819,22945,266
2021-10-04,Marin,041,260295,17149,17008,424,17432,242
2021-10-04,Mariposa,043,17540,1061,1024,33,1057,5
2021-10-04,Mendocino,045,87422,7079,6947,409,7356,79
2021-10-04,Merced,047,269075,39823,39565,1617,41182,558
2021-10-04,Modoc,049,8938,488,473,172,645,5
2021-10-04,Mono,051,14174,1594,1561,20,1581,3
2021-10-04,Monterey,053,433212,47985,47058,2716,49774,571
2021-10-04,Napa,055,140530,12608,12506,100,12606,96
2021-10-04,Nevada,057,99092,8662,8563,304,8867,90
2021-10-04,Orange,059,3164182,300649,298165,14386,312551,5438
2021-10-04,Placer,061,380077,35185,34630,3377,38007,379
2021-10-04,Plumas,063,18699,1441,1329,26,1355,6
2021-10-04,Riverside,065,2383286,353429,348828,16127,364955,4923
2021-10-04,Sacramento,067,1510023,151926,150887,4050,154937,2115
2021-10-04,San Benito,069,59416,7126,7099,152,7251,69
2021-10-04,San Bernardino,071,2135413,344928,342418,10809,353227,5551
2021-10-04,San Diego,073,3302833,361027,358525,21192,379717,4090
2021-10-04,San Francisco,075,870044,51373,50798,2216,53014,638
2021-10-04,San Joaquin,077,732212,96177,95198,5184,100382,1649
2021-10-04,San Luis Obispo,079,281455,28506,28090,1157,29247,323
2021-10-04,San Mateo,081,765935,52886,51958,811,52769,569
2021-10-04,Santa Barbara,083,443738,42980,42585,1510,44095,511
2021-10-04,Santa Clara,085,1922200,143047,141840,1184,143024,1869
2021-10-04,Santa Cruz,087,273765,19779,19559,988,20547,216
2021-10-04,Shasta,089,179085,19597,19170,3281,22451,279
2021-10-04,Sierra,091,2930,145,136,14,150,0
2021-10-04,Siskiyou,093,43540,3197,3103,1178,4281,42
2021-10-04,Solano,095,438530,44808,44092,1187,45279,322
2021-10-04,Sonoma,097,501317,39982,39720,501,40221,381
2021-10-04,Stanislaus,099,539301,74511,74444,8441,82885,1106
2021-10-04,Sutter,101,95872,13319,13261,285,13546,164
2021-10-04,Tehama,103,63373,7749,7585,1305,8890,95
2021-10-04,Trinity,105,12862,797,649,205,854,11
2021-10-04,Tulare,107,460477,64321,62957,13574,76531,920
2021-10-04,Tuolumne,109,53932,6517,6442,77,6519,89
2021-10-04,Ventura,111,848112,96035,95170,4209,99379,1153
2021-10-04,Yolo,113,214977,18962,18761,1007,19768,242
2021-10-04,Yuba,115,75493,9592,9481,228,9709,68
2021-10-03,Alameda,001,1643700,116417,115751,2692,118443,1349
2021-10-03,Alpine,003,1148,99,102,0,102,0
2021-10-03,Amador,005,37829,5256,5160,53,5213,61
2021-10-03,Butte,007,227075,19459,19066,3499,22565,245
2021-10-03,Calaveras,009,45235,3697,3632,43,3675,73
2021-10-03,Colusa,011,21464,2436,2413,565,2978,18
2021-10-03,Contra Costa,013,1133247,96571,95890,2038,97928,937
2021-10-03,Del Norte,015,27424,3569,3483,39,3522,39
2021-10-03,El Dorado,017,186661,15216,15014,1571,16585,139
2021-10-03,Fresno,019,978130,131352,129365,11934,141299,1978
2021-10-03,Glenn,021,27897,3312,3266,953,4219,26
2021-10-03,Humboldt,023,135768,8469,8352,439,8791,94
2021-10-03,Imperial,025,180216,32090,31844,3076,34920,757
2021-10-03,Inyo,027,18085,1825,1788,36,1824,39
2021-10-03,Kern,029,883053,120489,118851,19437,138288,1535
2021-10-03,Kings,031,150075,30145,29623,1758,31381,300
2021-10-03,Lake,033,64148,6332,6239,126,6365,97
2021-10-03,Lassen,035,31185,6501,6400,304,6704,25
2021-10-03,Los Angeles,037,10098052,1409100,1398790,53181,1451971,26179
2021-10-03,Madera,039,155013,21474,21066,1809,22875,266
2021-10-03,Marin,041,260295,17126,16995,419,17414,242
2021-10-03,Mariposa,043,17540,1054,1011,33,1044,5
2021-10-03,Mendocino,045,87422,7059,6939,400,7339,79
2021-10-03,Merced,047,269075,39716,39516,1597,41113,558
2021-10-03,Modoc,049,8938,487,472,171,643,5
2021-10-03,Mono,051,14174,1590,1554,20,1574,3
2021-10-03,Monterey,053,433212,47960,47049,2705,49754,571
2021-10-03,Napa,055,140530,12580,12489,98,12587,96
2021-10-03,Nevada,057,99092,8627,8545,304,8849,90
2021-10-03,Orange,059,3164182,300367,298027,14366,312393,5447
2021-10-03,Placer,061,380077,35046,34596,3360,37956,379
2021-10-03,Plumas,063,18699,1413,1328,26,1354,6
2021-10-03,Riverside,065,2383286,352998,348593,16107,364700,4924
2021-10-03,Sacramento,067,1510023,151636,150664,4022,154686,2120
2021-10-03,San Benito,069,59416,7117,7095,152,7247,69
2021-10-03,San Bernardino,071,2135413,344519,342302,10802,353104,5555
2021-10-03,San Diego,073,3302833,360431,358153,21160,379313,4081
2021-10-03,San Francisco,075,870044,51285,50733,2213,52946,638
2021-10-03,San Joaquin,077,732212,95988,95133,5176,100309,1649
2021-10-03,San Luis Obispo,079,281455,28439,28065,1152,29217,325
2021-10-03,San Mateo,081,765935,52819,51923,810,52733,569
2021-10-03,Santa Barbara,083,443738,42884,42550,1502,44052,511
2021-10-03,Santa Clara,085,1922200,142877,141737,1176,142913,1869
2021-10-03,Santa Cruz,087,273765,19739,19548,986,20534,216
2021-10-03,Shasta,089,179085,19492,19132,3252,22384,279
2021-10-03,Sierra,091,2930,142,136,14,150,0
2021-10-03,Siskiyou,093,43540,3184,3096,1167,4263,42
2021-10-03,Solano,095,438530,44744,44051,1184,45235,322
2021-10-03,Sonoma,097,501317,39916,39679,501,40180,381
2021-10-03,Stanislaus,099,539301,74324,74366,8423,82789,1106
2021-10-03,Sutter,101,95872,13304,13248,281,13529,164
2021-10-03,Tehama,103,63373,7706,7564,1300,8864,94
2021-10-03,Trinity,105,12862,793,647,203,850,11
2021-10-03,Tulare,107,460477,64119,62860,13499,76359,924
2021-10-03,Tuolumne,109,53932,6488,6430,75,6505,89
2021-10-03,Ventura,111,848112,95930,95108,4206,99314,1153
2021-10-03,Yolo,113,214977,18933,18720,1000,19720,242
2021-10-03,Yuba,115,75493,9573,9462,227,9689,68
2021-10-02,Alameda,001,1643700,116310,115185,2688,117873,1343
2021-10-02,Alpine,003,1148,99,102,0,102,0
2021-10-02,Amador,005,37829,5247,5105,53,5158,61
2021-10-02,Butte,007,227075,19428,18911,3492,22403,243
2021-10-02,Calaveras,009,45235,3690,3585,43,3628,72
2021-10-02,Colusa,011,21464,2435,2403,563,2966,18
2021-10-02,Contra Costa,013,1133247,96500,95369,2034,97403,933
2021-10-02,Del Norte,015,27424,3564,3468,39,3507,39
2021-10-02,El Dorado,017,186661,15190,14887,1570,16457,136
2021-10-02,Fresno,019,978130,131181,128450,11921,140371,1964
2021-10-02,Glenn,021,27897,3307,3234,953,4187,26
2021-10-02,Humboldt,023,135768,8450,8244,439,8683,94
2021-10-02,Imperial,025,180216,32055,31674,3073,34747,757
2021-10-02,Inyo,027,18085,1816,1746,36,1782,39
2021-10-02,Kern,029,883053,120356,117962,19355,137317,1524
2021-10-02,Kings,031,150075,30096,29339,1754,31093,301
2021-10-02,Lake,033,64148,6323,6191,126,6317,97
2021-10-02,Lassen,035,31185,6496,6360,304,6664,25
2021-10-02,Los Angeles,037,10098052,1408493,1395070,53144,1448214,26126
2021-10-02,Madera,039,155013,21449,20931,1800,22731,266
2021-10-02,Marin,041,260295,17121,16936,416,17352,242
2021-10-02,Mariposa,043,17540,1052,967,33,1000,5
2021-10-02,Mendocino,045,87422,7049,6869,400,7269,78
2021-10-02,Merced,047,269075,39689,39196,1593,40789,552
2021-10-02,Modoc,049,8938,485,468,171,639,5
2021-10-02,Mono,051,14174,1588,1540,20,1560,3
2021-10-02,Monterey,053,433212,47905,46964,2704,49668,571
2021-10-02,Napa,055,140530,12569,12433,98,12531,96
2021-10-02,Nevada,057,99092,8616,8474,303,8777,87
2021-10-02,Orange,059,3164182,300202,297307,14346,311653,5435
2021-10-02,Placer,061,380077,34980,34377,3351,37728,381
2021-10-02,Plumas,063,18699,1402,1298,26,1324,6
2021-10-02,Riverside,065,2383286,352757,347227,16096,363323,4895
2021-10-02,Sacramento,067,1510023,151462,149897,4014,153911,2099
2021-10-02,San Benito,069,59416,7110,7055,152,7207,69
2021-10-02,San Bernardino,071,2135413,344336,341212,10752,351964,5540
2021-10-02,San Diego,073,3302833,360109,356454,21138,377592,4078
2021-10-02,San Francisco,075,870044,51236,50393,2208,52601,634
2021-10-02,San Joaquin,077,732212,95923,94599,5170,99769,1646
2021-10-02,San Luis Obispo,079,281455,28415,27915,1152,29067,323
2021-10-02,San Mateo,081,765935,52778,51767,806,52573,573
2021-10-02,Santa Barbara,083,443738,42844,42423,1502,43925,508
2021-10-02,Santa Clara,085,1922200,142763,141231,1172,142403,1862
2021-10-02,Santa Cruz,087,273765,19722,19461,985,20446,214
2021-10-02,Shasta,089,179085,19446,18912,3246,22158,270
2021-10-02,Sierra,091,2930,141,131,14,145,0
2021-10-02,Siskiyou,093,43540,3183,3053,1164,4217,42
2021-10-02,Solano,095,438530,44699,43800,1183,44983,321
2021-10-02,Sonoma,097,501317,39882,39497,500,39997,382
2021-10-02,Stanislaus,099,539301,74238,73859,8410,82269,1099
2021-10-02,Sutter,101,95872,13295,13160,280,13440,160
2021-10-02,Tehama,103,63373,7691,7453,1300,8753,93
2021-10-02,Trinity,105,12862,790,625,203,828,10
2021-10-02,Tulare,107,460477,64045,62247,13472,75719,908
2021-10-02,Tuolumne,109,53932,6474,6369,75,6444,89
2021-10-02,Ventura,111,848112,95858,94854,4201,99055,1148
2021-10-02,Yolo,113,214977,18908,18640,996,19636,242
2021-10-02,Yuba,115,75493,9554,9370,226,9596,66
2021-10-01,Alameda,001,1643700,116233,115185,2682,117867,1343
2021-10-01,Alpine,003,1148,99,102,0,102,0
2021-10-01,Amador,005,37829,5227,5105,53,5158,61
2021-10-01,Butte,007,227075,19387,18911,3486,22397,243
2021-10-01,Calaveras,009,45235,3680,3585,43,3628,72
2021-10-01,Colusa,011,21464,2433,2403,563,2966,18
2021-10-01,Contra Costa,013,1133247,96403,95369,2030,97399,933
2021-10-01,Del Norte,015,27424,3561,3468,38,3506,39
2021-10-01,El Dorado,017,186661,15173,14887,1566,16453,136
2021-10-01,Fresno,019,978130,130993,128450,11911,140361,1964
2021-10-01,Glenn,021,27897,3305,3234,952,4186,26
2021-10-01,Humboldt,023,135768,8433,8244,439,8683,94
2021-10-01,Imperial,025,180216,32037,31674,3064,34738,757
2021-10-01,Inyo,027,18085,1807,1746,36,1782,39
2021-10-01,Kern,029,883053,120203,117962,19297,137259,1524
2021-10-01,Kings,031,150075,30062,29339,1748,31087,301
2021-10-01,Lake,033,64148,6313,6191,126,6317,97
2021-10-01,Lassen,035,31185,6485,6360,303,6663,25
2021-10-01,Los Angeles,037,10098052,1407732,1395070,53099,1448169,26126
2021-10-01,Madera,039,155013,21399,20931,1791,22722,266
2021-10-01,Marin,041,260295,17106,16936,415,17351,242
2021-10-01,Mariposa,043,17540,1045,967,33,1000,5
2021-10-01,Mendocino,045,87422,7037,6869,400,7269,78
2021-10-01,Merced,047,269075,39645,39196,1584,40780,552
2021-10-01,Modoc,049,8938,484,468,171,639,5
2021-10-01,Mono,051,14174,1585,1540,20,1560,3
2021-10-01,Monterey,053,433212,47884,46964,2701,49665,571
2021-10-01,Napa,055,140530,12559,12433,97,12530,96
2021-10-01,Nevada,057,99092,8602,8474,302,8776,87
2021-10-01,Orange,059,3164182,300018,297307,14326,311633,5435
2021-10-01,Placer,061,380077,34946,34377,3347,37724,381
2021-10-01,Plumas,063,18699,1393,1298,26,1324,6
2021-10-01,Riverside,065,2383286,352464,347227,16088,363315,4895
2021-10-01,Sacramento,067,1510023,151309,149897,4003,153900,2099
2021-10-01,San Benito,069,59416,7108,7055,150,7205,69
2021-10-01,San Bernardino,071,2135413,344136,341212,10749,351961,5540
2021-10-01,San Diego,073,3302833,359742,356454,21117,377571,4078
2021-10-01,San Francisco,075,870044,51195,50393,2206,52599,634
2021-10-01,San Joaquin,077,732212,95853,94599,5166,99765,1646
2021-10-01,San Luis Obispo,079,281455,28391,27915,1149,29064,323
2021-10-01,San Mateo,081,765935,52738,51767,803,52570,573
2021-10-01,Santa Barbara,083,443738,42808,42423,1502,43925,508
2021-10-01,Santa Clara,085,1922200,142670,141231,1167,142398,1862
2021-10-01,Santa Cruz,087,273765,19702,19461,984,20445,214
2021-10-01,Shasta,089,179085,19392,18912,3238,22150,270
2021-10-01,Sierra,091,2930,141,131,14,145,0
2021-10-01,Siskiyou,093,43540,3182,3053,1161,4214,42
2021-10-01,Solano,095,438530,44647,43800,1177,44977,321
2021-10-01,Sonoma,097,501317,39850,39497,499,39996,382
2021-10-01,Stanislaus,099,539301,74154,73859,8399,82258,1099
2021-10-01,Sutter,101,95872,13279,13160,278,13438,160
2021-10-01,Tehama,103,63373,7679,7453,1298,8751,93
2021-10-01,Trinity,105,12862,788,625,203,828,10
2021-10-01,Tulare,107,460477,63942,62247,13437,75684,908
2021-10-01,Tuolumne,109,53932,6457,6369,75,6444,89
2021-10-01,Ventura,111,848112,95791,94854,4196,99050,1148
2021-10-01,Yolo,113,214977,18884,18640,992,19632,242
2021-10-01,Yuba,115,75493,9532,9370,226,9596,66
2021-09-30,Alameda,001,1643700,116086,115185,2679,117864,1343
2021-09-30,Alpine,003,1148,99,102,0,102,0
2021-09-30,Amador,005,37829,5215,5105,53,5158,61
2021-09-30,Butte,007,227075,19338,18911,3477,22388,243
2021-09-30,Calaveras,009,45235,3666,3585,43,3628,72
2021-09-30,Colusa,011,21464,2430,2403,562,2965,18
2021-09-30,Contra Costa,013,1133247,96298,95369,2024,97393,933
2021-09-30,Del Norte,015,27424,3557,3468,35,3503,39
2021-09-30,El Dorado,017,186661,15147,14887,1558,16445,136
2021-09-30,Fresno,019,978130,130717,128450,11877,140327,1964
2021-09-30,Glenn,021,27897,3295,3234,950,4184,26
2021-09-30,Humboldt,023,135768,8401,8244,433,8677,94
2021-09-30,Imperial,025,180216,31985,31674,3062,34736,757
2021-09-30,Inyo,027,18085,1797,1746,36,1782,39
2021-09-30,Kern,029,883053,119959,117962,19215,137177,1524
2021-09-30,Kings,031,150075,29972,29339,1744,31083,301
2021-09-30,Lake,033,64148,6295,6191,126,6317,97
2021-09-30,Lassen,035,31185,6471,6360,303,6663,25
2021-09-30,Los Angeles,037,10098052,1406526,1395070,53039,1448109,26126
2021-09-30,Madera,039,155013,21316,20931,1776,22707,266
2021-09-30,Marin,041,260295,17086,16936,414,17350,242
2021-09-30,Mariposa,043,17540,1023,967,33,1000,5
2021-09-30,Mendocino,045,87422,7028,6869,391,7260,78
2021-09-30,Merced,047,269075,39548,39196,1580,40776,552
2021-09-30,Modoc,049,8938,484,468,170,638,5
2021-09-30,Mono,051,14174,1577,1540,20,1560,3
2021-09-30,Monterey,053,433212,47854,46964,2689,49653,571
2021-09-30,Napa,055,140530,12539,12433,97,12530,96
2021-09-30,Nevada,057,99092,8585,8474,301,8775,87
2021-09-30,Orange,059,3164182,299746,297307,14287,311594,5435
2021-09-30,Placer,061,380077,34893,34377,3327,37704,381
2021-09-30,Plumas,063,18699,1375,1298,26,1324,6
2021-09-30,Riverside,065,2383286,352031,347227,16067,363294,4895
2021-09-30,Sacramento,067,1510023,151049,149897,3977,153874,2099
2021-09-30,San Benito,069,59416,7102,7055,150,7205,69
2021-09-30,San Bernardino,071,2135413,343825,341212,10735,351947,5540
2021-09-30,San Diego,073,3302833,359248,356454,21091,377545,4078
2021-09-30,San Francisco,075,870044,51118,50393,2202,52595,634
2021-09-30,San Joaquin,077,732212,95723,94599,5158,99757,1646
2021-09-30,San Luis Obispo,079,281455,28343,27915,1145,29060,323
2021-09-30,San Mateo,081,765935,52689,51767,800,52567,573
2021-09-30,Santa Barbara,083,443738,42751,42423,1501,43924,508
2021-09-30,Santa Clara,085,1922200,142519,141231,1164,142395,1862
2021-09-30,Santa Cruz,087,273765,19662,19461,983,20444,214
2021-09-30,Shasta,089,179085,19330,18912,3223,22135,270
2021-09-30,Sierra,091,2930,140,131,14,145,0
2021-09-30,Siskiyou,093,43540,3174,3053,1156,4209,42
2021-09-30,Solano,095,438530,44593,43800,1174,44974,321
2021-09-30,Sonoma,097,501317,39801,39497,499,39996,382
2021-09-30,Stanislaus,099,539301,73994,73859,8380,82239,1099
2021-09-30,Sutter,101,95872,13258,13160,278,13438,160
2021-09-30,Tehama,103,63373,7642,7453,1286,8739,93
2021-09-30,Trinity,105,12862,784,625,203,828,10
2021-09-30,Tulare,107,460477,63766,62247,13379,75626,908
2021-09-30,Tuolumne,109,53932,6434,6369,75,6444,89
2021-09-30,Ventura,111,848112,95686,94854,4189,99043,1148
2021-09-30,Yolo,113,214977,18845,18640,989,19629,242
2021-09-30,Yuba,115,75493,9509,9370,225,9595,66
2021-09-29,Alameda,001,1643700,115940,114998,2676,117674,1339
2021-09-29,Alpine,003,1148,99,101,0,101,0
2021-09-29,Amador,005,37829,5193,5058,53,5111,61
2021-09-29,Butte,007,227075,19284,18835,3470,22305,242
2021-09-29,Calaveras,009,45235,3649,3553,42,3595,72
2021-09-29,Colusa,011,21464,2428,2401,562,2963,18
2021-09-29,Contra Costa,013,1133247,96184,95213,2016,97229,929
2021-09-29,Del Norte,015,27424,3551,3467,35,3502,39
2021-09-29,El Dorado,017,186661,15113,14834,1551,16385,136
2021-09-29,Fresno,019,978130,130417,128068,11856,139924,1957
2021-09-29,Glenn,021,27897,3290,3213,948,4161,26
2021-09-29,Humboldt,023,135768,8377,8203,432,8635,94
2021-09-29,Imperial,025,180216,31918,31600,3057,34657,757
2021-09-29,Inyo,027,18085,1787,1740,35,1775,39
2021-09-29,Kern,029,883053,119724,117605,19139,136744,1513
2021-09-29,Kings,031,150075,29890,29195,1729,30924,299
2021-09-29,Lake,033,64148,6275,6164,126,6290,97
2021-09-29,Lassen,035,31185,6457,6347,303,6650,25
2021-09-29,Los Angeles,037,10098052,1405314,1393617,52967,1446584,26098
2021-09-29,Madera,039,155013,21271,20818,1760,22578,266
2021-09-29,Marin,041,260295,17068,16921,412,17333,242
2021-09-29,Mariposa,043,17540,1008,963,33,996,5
2021-09-29,Mendocino,045,87422,7016,6821,383,7204,78
2021-09-29,Merced,047,269075,39454,39026,1569,40595,552
2021-09-29,Modoc,049,8938,482,468,170,638,5
2021-09-29,Mono,051,14174,1575,1527,20,1547,3
2021-09-29,Monterey,053,433212,47816,46917,2675,49592,571
2021-09-29,Napa,055,140530,12519,12416,93,12509,96
2021-09-29,Nevada,057,99092,8572,8434,301,8735,87
2021-09-29,Orange,059,3164182,299477,296936,14251,311187,5429
2021-09-29,Placer,061,380077,34829,34271,3304,37575,379
2021-09-29,Plumas,063,18699,1356,1289,26,1315,6
2021-09-29,Riverside,065,2383286,351597,346558,16054,362612,4886
2021-09-29,Sacramento,067,1510023,150798,149686,3967,153653,2099
2021-09-29,San Benito,069,59416,7091,7039,150,7189,69
2021-09-29,San Bernardino,071,2135413,343504,340672,10721,351393,5539
2021-09-29,San Diego,073,3302833,358746,355899,21061,376960,4066
2021-09-29,San Francisco,075,870044,51033,50286,2198,52484,629
2021-09-29,San Joaquin,077,732212,95565,94356,5136,99492,1645
2021-09-29,San Luis Obispo,079,281455,28297,27800,1139,28939,323
2021-09-29,San Mateo,081,765935,52629,51673,798,52471,573
2021-09-29,Santa Barbara,083,443738,42679,42328,1498,43826,507
2021-09-29,Santa Clara,085,1922200,142384,141036,1158,142194,1861
2021-09-29,Santa Cruz,087,273765,19644,19425,982,20407,214
2021-09-29,Shasta,089,179085,19264,18805,3211,22016,271
2021-09-29,Sierra,091,2930,136,130,14,144,0
2021-09-29,Siskiyou,093,43540,3161,3043,1149,4192,42
2021-09-29,Solano,095,438530,44537,43724,1167,44891,321
2021-09-29,Sonoma,097,501317,39740,39426,497,39923,370
2021-09-29,Stanislaus,099,539301,73862,73634,8369,82003,1096
2021-09-29,Sutter,101,95872,13231,13135,275,13410,155
2021-09-29,Tehama,103,63373,7612,7409,1271,8680,88
2021-09-29,Trinity,105,12862,780,616,203,819,10
2021-09-29,Tulare,107,460477,63594,62046,13320,75366,908
2021-09-29,Tuolumne,109,53932,6417,6336,75,6411,89
2021-09-29,Ventura,111,848112,95596,94753,4185,98938,1144
2021-09-29,Yolo,113,214977,18812,18587,984,19571,239
2021-09-29,Yuba,115,75493,9478,9351,221,9572,66
2021-09-28,Alameda,001,1643700,115783,114869,2670,117539,1333
2021-09-28,Alpine,003,1148,99,101,0,101,0
2021-09-28,Amador,005,37829,5171,5049,53,5102,61
2021-09-28,Butte,007,227075,19233,18764,3457,22221,241
2021-09-28,Calaveras,009,45235,3629,3530,42,3572,72
2021-09-28,Colusa,011,21464,2425,2399,560,2959,18
2021-09-28,Contra Costa,013,1133247,96043,95115,2011,97126,929
2021-09-28,Del Norte,015,27424,3548,3462,35,3497,39
2021-09-28,El Dorado,017,186661,15066,14793,1547,16340,133
2021-09-28,Fresno,019,978130,130072,127877,11821,139698,1948
2021-09-28,Glenn,021,27897,3285,3205,947,4152,26
2021-09-28,Humboldt,023,135768,8336,8159,429,8588,91
2021-09-28,Imperial,025,180216,31873,31543,3053,34596,757
2021-09-28,Inyo,027,18085,1773,1708,34,1742,39
2021-09-28,Kern,029,883053,119455,117420,19044,136464,1506
2021-09-28,Kings,031,150075,29788,29141,1721,30862,295
2021-09-28,Lake,033,64148,6260,6155,126,6281,95
2021-09-28,Lassen,035,31185,6451,6340,299,6639,25
2021-09-28,Los Angeles,037,10098052,1404018,1392445,52898,1445343,26068
2021-09-28,Madera,039,155013,21217,20764,1744,22508,266
2021-09-28,Marin,041,260295,17049,16887,410,17297,242
2021-09-28,Mariposa,043,17540,1003,952,33,985,5
2021-09-28,Mendocino,045,87422,6994,6804,381,7185,78
2021-09-28,Merced,047,269075,39366,38953,1556,40509,551
2021-09-28,Modoc,049,8938,481,467,170,637,5
2021-09-28,Mono,051,14174,1565,1527,20,1547,3
2021-09-28,Monterey,053,433212,47779,46859,2666,49525,571
2021-09-28,Napa,055,140530,12502,12388,92,12480,96
2021-09-28,Nevada,057,99092,8549,8409,300,8709,84
2021-09-28,Orange,059,3164182,299225,296596,14223,310819,5421
2021-09-28,Placer,061,380077,34764,34187,3286,37473,370
2021-09-28,Plumas,063,18699,1347,1276,26,1302,6
2021-09-28,Riverside,065,2383286,351138,346096,16033,362129,4874
2021-09-28,Sacramento,067,1510023,150507,149310,3945,153255,2086
2021-09-28,San Benito,069,59416,7074,7028,149,7177,69
2021-09-28,San Bernardino,071,2135413,343156,340342,10704,351046,5540
2021-09-28,San Diego,073,3302833,358186,355373,21029,376402,4054
2021-09-28,San Francisco,075,870044,50932,50234,2197,52431,627
2021-09-28,San Joaquin,077,732212,95411,94194,5123,99317,1639
2021-09-28,San Luis Obispo,079,281455,28263,27755,1134,28889,321
2021-09-28,San Mateo,081,765935,52584,51620,797,52417,571
2021-09-28,Santa Barbara,083,443738,42606,42226,1497,43723,506
2021-09-28,Santa Clara,085,1922200,142223,140886,1149,142035,1858
2021-09-28,Santa Cruz,087,273765,19603,19324,981,20305,214
2021-09-28,Shasta,089,179085,19203,18701,3197,21898,267
2021-09-28,Sierra,091,2930,135,130,13,143,0
2021-09-28,Siskiyou,093,43540,3149,3032,1146,4178,42
2021-09-28,Solano,095,438530,44464,43652,1164,44816,316
2021-09-28,Sonoma,097,501317,39693,39395,496,39891,370
2021-09-28,Stanislaus,099,539301,73690,73528,8357,81885,1094
2021-09-28,Sutter,101,95872,13212,13102,271,13373,155
2021-09-28,Tehama,103,63373,7594,7382,1256,8638,88
2021-09-28,Trinity,105,12862,777,613,203,816,10
2021-09-28,Tulare,107,460477,63435,61916,13261,75177,905
2021-09-28,Tuolumne,109,53932,6391,6308,75,6383,89
2021-09-28,Ventura,111,848112,95470,94632,4182,98814,1143
2021-09-28,Yolo,113,214977,18786,18564,981,19545,239
2021-09-28,Yuba,115,75493,9459,9323,220,9543,66
2021-09-27,Alameda,001,1643700,115590,114731,2661,117392,1327
2021-09-27,Alpine,003,1148,99,101,0,101,0
2021-09-27,Amador,005,37829,5157,5017,53,5070,59
2021-09-27,Butte,007,227075,19176,18687,3441,22128,239
2021-09-27,Calaveras,009,45235,3609,3514,41,3555,70
2021-09-27,Colusa,011,21464,2424,2393,559,2952,18
2021-09-27,Contra Costa,013,1133247,95912,94979,2002,96981,924
2021-09-27,Del Norte,015,27424,3546,3468,33,3501,37
2021-09-27,El Dorado,017,186661,15027,14764,1540,16304,132
2021-09-27,Fresno,019,978130,129751,127475,11787,139262,1942
2021-09-27,Glenn,021,27897,3272,3189,943,4132,26
2021-09-27,Humboldt,023,135768,8296,8118,429,8547,91
2021-09-27,Imperial,025,180216,31810,31491,3046,34537,756
2021-09-27,Inyo,027,18085,1761,1698,34,1732,39
2021-09-27,Kern,029,883053,119180,117064,18946,136010,1503
2021-09-27,Kings,031,150075,29690,28998,1709,30707,297
2021-09-27,Lake,033,64148,6240,6126,124,6250,95
2021-09-27,Lassen,035,31185,6436,6327,295,6622,25
2021-09-27,Los Angeles,037,10098052,1402681,1391538,52829,1444367,26040
2021-09-27,Madera,039,155013,21152,20691,1736,22427,262
2021-09-27,Marin,041,260295,17027,16861,409,17270,242
2021-09-27,Mariposa,043,17540,993,931,33,964,5
2021-09-27,Mendocino,045,87422,6968,6761,374,7135,74
2021-09-27,Merced,047,269075,39267,38840,1550,40390,548
2021-09-27,Modoc,049,8938,480,465,168,633,5
2021-09-27,Mono,051,14174,1553,1525,20,1545,3
2021-09-27,Monterey,053,433212,47735,46811,2654,49465,571
2021-09-27,Napa,055,140530,12478,12354,91,12445,95
2021-09-27,Nevada,057,99092,8525,8379,297,8676,84
2021-09-27,Orange,059,3164182,298920,296334,14192,310526,5409
2021-09-27,Placer,061,380077,34677,34087,3281,37368,370
2021-09-27,Plumas,063,18699,1337,1269,26,1295,6
2021-09-27,Riverside,065,2383286,350696,345529,16023,361552,4864
2021-09-27,Sacramento,067,1510023,150189,149096,3923,153019,2076
2021-09-27,San Benito,069,59416,7057,7017,149,7166,67
2021-09-27,San Bernardino,071,2135413,342741,339952,10679,350631,5544
2021-09-27,San Diego,073,3302833,357528,354755,21004,375759,4054
2021-09-27,San Francisco,075,870044,50848,50157,2193,52350,622
2021-09-27,San Joaquin,077,732212,95227,94085,5120,99205,1633
2021-09-27,San Luis Obispo,079,281455,28208,27674,1131,28805,320
2021-09-27,San Mateo,081,765935,52508,51552,797,52349,571
2021-09-27,Santa Barbara,083,443738,42539,42012,1493,43505,505
2021-09-27,Santa Clara,085,1922200,142041,140802,1139,141941,1853
2021-09-27,Santa Cruz,087,273765,19579,19292,980,20272,214
2021-09-27,Shasta,089,179085,19122,18599,3170,21769,267
2021-09-27,Sierra,091,2930,135,128,13,141,0
2021-09-27,Siskiyou,093,43540,3137,3015,1141,4156,42
2021-09-27,Solano,095,438530,44389,43582,1158,44740,314
2021-09-27,Sonoma,097,501317,39640,39347,496,39843,370
2021-09-27,Stanislaus,099,539301,73536,73370,8337,81707,1091
2021-09-27,Sutter,101,95872,13181,13082,268,13350,155
2021-09-27,Tehama,103,63373,7553,7345,1247,8592,88
2021-09-27,Trinity,105,12862,766,605,202,807,9
2021-09-27,Tulare,107,460477,63234,61708,13190,74898,904
2021-09-27,Tuolumne,109,53932,6370,6264,75,6339,89
2021-09-27,Ventura,111,848112,95345,94477,4178,98655,1138
2021-09-27,Yolo,113,214977,18754,18524,980,19504,239
2021-09-27,Yuba,115,75493,9422,9292,216,9508,64
2021-09-26,Alameda,001,1643700,115394,114601,2654,117255,1326
2021-09-26,Alpine,003,1148,99,101,0,101,0
2021-09-26,Amador,005,37829,5125,5001,52,5053,59
2021-09-26,Butte,007,227075,19100,18634,3424,22058,238
2021-09-26,Calaveras,009,45235,3587,3505,41,3546,70
2021-09-26,Colusa,011,21464,2419,2392,557,2949,18
2021-09-26,Contra Costa,013,1133247,95737,94877,1989,96866,924
2021-09-26,Del Norte,015,27424,3541,3466,32,3498,37
2021-09-26,El Dorado,017,186661,14985,14738,1532,16270,132
2021-09-26,Fresno,019,978130,129393,127235,11741,138976,1939
2021-09-26,Glenn,021,27897,3264,3182,939,4121,26
2021-09-26,Humboldt,023,135768,8261,8098,428,8526,91
2021-09-26,Imperial,025,180216,31749,31462,3045,34507,756
2021-09-26,Inyo,027,18085,1746,1685,34,1719,39
2021-09-26,Kern,029,883053,118842,116927,18836,135763,1502
2021-09-26,Kings,031,150075,29589,28930,1698,30628,293
2021-09-26,Lake,033,64148,6223,6113,124,6237,95
2021-09-26,Lassen,035,31185,6426,6319,290,6609,25
2021-09-26,Los Angeles,037,10098052,1401194,1390577,52758,1443335,26035
2021-09-26,Madera,039,155013,21078,20629,1717,22346,262
2021-09-26,Marin,041,260295,17004,16860,409,17269,242
2021-09-26,Mariposa,043,17540,987,929,33,962,5
2021-09-26,Mendocino,045,87422,6934,6744,359,7103,74
2021-09-26,Merced,047,269075,39106,38717,1542,40259,548
2021-09-26,Modoc,049,8938,480,465,167,632,5
2021-09-26,Mono,051,14174,1549,1516,20,1536,3
2021-09-26,Monterey,053,433212,47687,46792,2640,49432,571
2021-09-26,Napa,055,140530,12454,12340,90,12430,95
2021-09-26,Nevada,057,99092,8494,8356,292,8648,84
2021-09-26,Orange,059,3164182,298581,296085,14160,310245,5409
2021-09-26,Placer,061,380077,34583,34043,3271,37314,370
2021-09-26,Plumas,063,18699,1319,1268,26,1294,6
2021-09-26,Riverside,065,2383286,350164,345257,16009,361266,4864
2021-09-26,Sacramento,067,1510023,149785,148745,3904,152649,2071
2021-09-26,San Benito,069,59416,7040,7012,148,7160,67
2021-09-26,San Bernardino,071,2135413,342284,339771,10664,350435,5545
2021-09-26,San Diego,073,3302833,356885,354414,20963,375377,4051
2021-09-26,San Francisco,075,870044,50722,50092,2184,52276,622
2021-09-26,San Joaquin,077,732212,95024,93935,5106,99041,1633
2021-09-26,San Luis Obispo,079,281455,28134,27624,1126,28750,319
2021-09-26,San Mateo,081,765935,52439,51496,795,52291,571
2021-09-26,Santa Barbara,083,443738,42452,41946,1490,43436,505
2021-09-26,Santa Clara,085,1922200,141841,140667,1135,141802,1852
2021-09-26,Santa Cruz,087,273765,19554,19279,980,20259,214
2021-09-26,Shasta,089,179085,19013,18566,3147,21713,266
2021-09-26,Sierra,091,2930,135,128,13,141,0
2021-09-26,Siskiyou,093,43540,3123,2998,1131,4129,42
2021-09-26,Solano,095,438530,44322,43537,1157,44694,314
2021-09-26,Sonoma,097,501317,39581,39302,496,39798,370
2021-09-26,Stanislaus,099,539301,73336,73243,8309,81552,1091
2021-09-26,Sutter,101,95872,13144,13045,267,13312,155
2021-09-26,Tehama,103,63373,7495,7323,1236,8559,88
2021-09-26,Trinity,105,12862,763,591,202,793,9
2021-09-26,Tulare,107,460477,63013,61560,13112,74672,904
2021-09-26,Tuolumne,109,53932,6342,6236,73,6309,89
2021-09-26,Ventura,111,848112,95231,94391,4171,98562,1138
2021-09-26,Yolo,113,214977,18718,18496,972,19468,239
2021-09-26,Yuba,115,75493,9395,9275,216,9491,64
2021-09-25,Alameda,001,1643700,115314,114014,2651,116665,1324
2021-09-25,Alpine,003,1148,99,101,0,101,0
2021-09-25,Amador,005,37829,5111,4934,52,4986,59
2021-09-25,Butte,007,227075,19071,18396,3415,21811,236
2021-09-25,Calaveras,009,45235,3584,3461,41,3502,70
2021-09-25,Colusa,011,21464,2416,2387,555,2942,16
2021-09-25,Contra Costa,013,1133247,95666,94337,1985,96322,924
2021-09-25,Del Norte,015,27424,3540,3404,32,3436,35
2021-09-25,El Dorado,017,186661,14962,14641,1528,16169,130
2021-09-25,Fresno,019,978130,129248,126299,11725,138024,1927
2021-09-25,Glenn,021,27897,3259,3144,938,4082,25
2021-09-25,Humboldt,023,135768,8242,8014,426,8440,88
2021-09-25,Imperial,025,180216,31722,31280,3045,34325,755
2021-09-25,Inyo,027,18085,1738,1657,34,1691,39
2021-09-25,Kern,029,883053,118687,116021,18768,134789,1485
2021-09-25,Kings,031,150075,29538,28636,1695,30331,293
2021-09-25,Lake,033,64148,6218,6046,122,6168,92
2021-09-25,Lassen,035,31185,6414,6248,289,6537,25
2021-09-25,Los Angeles,037,10098052,1400479,1386417,52717,1439134,25964
2021-09-25,Madera,039,155013,21053,20432,1711,22143,262
2021-09-25,Marin,041,260295,16995,16802,407,17209,242
2021-09-25,Mariposa,043,17540,982,906,33,939,5
2021-09-25,Mendocino,045,87422,6915,6657,358,7015,74
2021-09-25,Merced,047,269075,39060,38393,1540,39933,546
2021-09-25,Modoc,049,8938,480,460,167,627,5
2021-09-25,Mono,051,14174,1546,1501,20,1521,3
2021-09-25,Monterey,053,433212,47657,46653,2638,49291,567
2021-09-25,Napa,055,140530,12434,12266,90,12356,95
2021-09-25,Nevada,057,99092,8477,8285,292,8577,84
2021-09-25,Orange,059,3164182,298408,294514,14142,308656,5374
2021-09-25,Placer,061,380077,34519,33764,3268,37032,367
2021-09-25,Plumas,063,18699,1315,1238,26,1264,6
2021-09-25,Riverside,065,2383286,349841,343463,16001,359464,4843
2021-09-25,Sacramento,067,1510023,149609,147728,3895,151623,2049
2021-09-25,San Benito,069,59416,7035,6965,148,7113,67
2021-09-25,San Bernardino,071,2135413,342050,338413,10650,349063,5540
2021-09-25,San Diego,073,3302833,356535,352017,20937,372954,4039
2021-09-25,San Francisco,075,870044,50678,49840,2183,52023,615
2021-09-25,San Joaquin,077,732212,94938,93273,5104,98377,1628
2021-09-25,San Luis Obispo,079,281455,28096,27447,1122,28569,318
2021-09-25,San Mateo,081,765935,52375,51266,793,52059,568
2021-09-25,Santa Barbara,083,443738,42394,41728,1490,43218,505
2021-09-25,Santa Clara,085,1922200,141735,140023,1133,141156,1844
2021-09-25,Santa Cruz,087,273765,19538,19200,978,20178,214
2021-09-25,Shasta,089,179085,18962,18256,3138,21394,262
2021-09-25,Sierra,091,2930,134,127,13,140,0
2021-09-25,Siskiyou,093,43540,3116,2956,1121,4077,41
2021-09-25,Solano,095,438530,44281,43331,1154,44485,312
2021-09-25,Sonoma,097,501317,39540,39112,496,39608,369
2021-09-25,Stanislaus,099,539301,73226,72628,8295,80923,1091
2021-09-25,Sutter,101,95872,13126,12976,264,13240,154
2021-09-25,Tehama,103,63373,7480,7200,1234,8434,86
2021-09-25,Trinity,105,12862,763,576,202,778,9
2021-09-25,Tulare,107,460477,62931,60909,13068,73977,898
2021-09-25,Tuolumne,109,53932,6330,6168,73,6241,89
2021-09-25,Ventura,111,848112,95164,94059,4167,98226,1129
2021-09-25,Yolo,113,214977,18696,18393,971,19364,239
2021-09-25,Yuba,115,75493,9375,9191,216,9407,61
2021-09-24,Alameda,001,1643700,115210,114014,2647,116661,1324
2021-09-24,Alpine,003,1148,99,101,0,101,0
2021-09-24,Amador,005,37829,5081,4934,52,4986,59
2021-09-24,Butte,007,227075,19019,18396,3406,21802,236
2021-09-24,Calaveras,009,45235,3577,3461,40,3501,70
2021-09-24,Colusa,011,21464,2413,2387,554,2941,16
2021-09-24,Contra Costa,013,1133247,95556,94337,1981,96318,924
2021-09-24,Del Norte,015,27424,3537,3404,32,3436,35
2021-09-24,El Dorado,017,186661,14944,14641,1524,16165,130
2021-09-24,Fresno,019,978130,129050,126299,11713,138012,1927
2021-09-24,Glenn,021,27897,3251,3144,938,4082,25
2021-09-24,Humboldt,023,135768,8223,8014,423,8437,88
2021-09-24,Imperial,025,180216,31684,31280,3043,34323,755
2021-09-24,Inyo,027,18085,1729,1657,34,1691,39
2021-09-24,Kern,029,883053,118551,116021,18702,134723,1485
2021-09-24,Kings,031,150075,29497,28636,1690,30326,293
2021-09-24,Lake,033,64148,6210,6046,122,6168,92
2021-09-24,Lassen,035,31185,6406,6248,288,6536,25
2021-09-24,Los Angeles,037,10098052,1399597,1386417,52675,1439092,25964
2021-09-24,Madera,039,155013,21022,20432,1702,22134,262
2021-09-24,Marin,041,260295,16981,16802,406,17208,242
2021-09-24,Mariposa,043,17540,970,906,33,939,5
2021-09-24,Mendocino,045,87422,6902,6657,358,7015,74
2021-09-24,Merced,047,269075,39016,38393,1540,39933,546
2021-09-24,Modoc,049,8938,480,460,166,626,5
2021-09-24,Mono,051,14174,1541,1501,20,1521,3
2021-09-24,Monterey,053,433212,47636,46653,2630,49283,567
2021-09-24,Napa,055,140530,12415,12266,90,12356,95
2021-09-24,Nevada,057,99092,8463,8285,289,8574,84
2021-09-24,Orange,059,3164182,298200,294514,14124,308638,5374
2021-09-24,Placer,061,380077,34464,33764,3255,37019,367
2021-09-24,Plumas,063,18699,1311,1238,26,1264,6
2021-09-24,Riverside,065,2383286,349507,343463,15992,359455,4843
2021-09-24,Sacramento,067,1510023,149425,147728,3891,151619,2049
2021-09-24,San Benito,069,59416,7029,6965,148,7113,67
2021-09-24,San Bernardino,071,2135413,341783,338413,10640,349053,5540
2021-09-24,San Diego,073,3302833,356181,352017,20922,372939,4039
2021-09-24,San Francisco,075,870044,50614,49840,2175,52015,615
2021-09-24,San Joaquin,077,732212,94825,93273,5102,98375,1628
2021-09-24,San Luis Obispo,079,281455,28065,27447,1117,28564,318
2021-09-24,San Mateo,081,765935,52315,51266,792,52058,568
2021-09-24,Santa Barbara,083,443738,42354,41728,1489,43217,505
2021-09-24,Santa Clara,085,1922200,141623,140023,1132,141155,1844
2021-09-24,Santa Cruz,087,273765,19515,19200,977,20177,214
2021-09-24,Shasta,089,179085,18908,18256,3124,21380,262
2021-09-24,Sierra,091,2930,133,127,13,140,0
2021-09-24,Siskiyou,093,43540,3107,2956,1115,4071,41
2021-09-24,Solano,095,438530,44244,43331,1152,44483,312
2021-09-24,Sonoma,097,501317,39507,39112,496,39608,369
2021-09-24,Stanislaus,099,539301,73111,72628,8280,80908,1091
2021-09-24,Sutter,101,95872,13107,12976,263,13239,154
2021-09-24,Tehama,103,63373,7468,7200,1229,8429,86
2021-09-24,Trinity,105,12862,760,576,202,778,9
2021-09-24,Tulare,107,460477,62840,60909,13026,73935,898
2021-09-24,Tuolumne,109,53932,6301,6168,73,6241,89
2021-09-24,Ventura,111,848112,95086,94059,4160,98219,1129
2021-09-24,Yolo,113,214977,18664,18393,968,19361,239
2021-09-24,Yuba,115,75493,9356,9191,216,9407,61
2021-09-23,Alameda,001,1643700,115051,114014,2641,116655,1324
2021-09-23,Alpine,003,1148,99,101,0,101,0
2021-09-23,Amador,005,37829,5068,4934,52,4986,59
2021-09-23,Butte,007,227075,18957,18396,3382,21778,236
2021-09-23,Calaveras,009,45235,3556,3461,40,3501,70
2021-09-23,Colusa,011,21464,2411,2387,551,2938,16
2021-09-23,Contra Costa,013,1133247,95415,94337,1974,96311,924
2021-09-23,Del Norte,015,27424,3528,3404,31,3435,35
2021-09-23,El Dorado,017,186661,14918,14641,1518,16159,130
2021-09-23,Fresno,019,978130,128753,126299,11694,137993,1927
2021-09-23,Glenn,021,27897,3237,3144,935,4079,25
2021-09-23,Humboldt,023,135768,8198,8014,421,8435,88
2021-09-23,Imperial,025,180216,31648,31280,3043,34323,755
2021-09-23,Inyo,027,18085,1715,1657,34,1691,39
2021-09-23,Kern,029,883053,118293,116021,18621,134642,1485
2021-09-23,Kings,031,150075,29393,28636,1681,30317,293
2021-09-23,Lake,033,64148,6200,6046,122,6168,92
2021-09-23,Lassen,035,31185,6397,6248,283,6531,25
2021-09-23,Los Angeles,037,10098052,1398401,1386417,52610,1439027,25964
2021-09-23,Madera,039,155013,20940,20432,1698,22130,262
2021-09-23,Marin,041,260295,16966,16802,403,17205,242
2021-09-23,Mariposa,043,17540,957,906,33,939,5
2021-09-23,Mendocino,045,87422,6880,6657,353,7010,74
2021-09-23,Merced,047,269075,38913,38393,1533,39926,546
2021-09-23,Modoc,049,8938,479,460,166,626,5
2021-09-23,Mono,051,14174,1538,1501,20,1521,3
2021-09-23,Monterey,053,433212,47587,46653,2618,49271,567
2021-09-23,Napa,055,140530,12398,12266,90,12356,95
2021-09-23,Nevada,057,99092,8436,8285,289,8574,84
2021-09-23,Orange,059,3164182,297903,294514,14100,308614,5374
2021-09-23,Placer,061,380077,34388,33764,3248,37012,367
2021-09-23,Plumas,063,18699,1294,1238,25,1263,6
2021-09-23,Riverside,065,2383286,349054,343463,15985,359448,4843
2021-09-23,Sacramento,067,1510023,149095,147728,3871,151599,2049
2021-09-23,San Benito,069,59416,7018,6965,148,7113,67
2021-09-23,San Bernardino,071,2135413,341420,338413,10625,349038,5540
2021-09-23,San Diego,073,3302833,355717,352017,20883,372900,4039
2021-09-23,San Francisco,075,870044,50541,49840,2173,52013,615
2021-09-23,San Joaquin,077,732212,94652,93273,5087,98360,1628
2021-09-23,San Luis Obispo,079,281455,28022,27447,1115,28562,318
2021-09-23,San Mateo,081,765935,52240,51266,791,52057,568
2021-09-23,Santa Barbara,083,443738,42276,41728,1486,43214,505
2021-09-23,Santa Clara,085,1922200,141473,140023,1125,141148,1844
2021-09-23,Santa Cruz,087,273765,19484,19200,977,20177,214
2021-09-23,Shasta,089,179085,18828,18256,3107,21363,262
2021-09-23,Sierra,091,2930,133,127,13,140,0
2021-09-23,Siskiyou,093,43540,3103,2956,1104,4060,41
2021-09-23,Solano,095,438530,44176,43331,1149,44480,312
2021-09-23,Sonoma,097,501317,39448,39112,493,39605,369
2021-09-23,Stanislaus,099,539301,72955,72628,8248,80876,1091
2021-09-23,Sutter,101,95872,13078,12976,263,13239,154
2021-09-23,Tehama,103,63373,7427,7200,1224,8424,86
2021-09-23,Trinity,105,12862,746,576,201,777,9
2021-09-23,Tulare,107,460477,62663,60909,12972,73881,898
2021-09-23,Tuolumne,109,53932,6276,6168,72,6240,89
2021-09-23,Ventura,111,848112,94983,94059,4153,98212,1129
2021-09-23,Yolo,113,214977,18633,18393,963,19356,239
2021-09-23,Yuba,115,75493,9328,9191,215,9406,61
2021-09-22,Alameda,001,1643700,114893,113862,2637,116499,1322
2021-09-22,Alpine,003,1148,99,100,0,100,0
2021-09-22,Amador,005,37829,5052,4915,52,4967,59
2021-09-22,Butte,007,227075,18897,18337,3367,21704,235
2021-09-22,Calaveras,009,45235,3540,3448,40,3488,70
2021-09-22,Colusa,011,21464,2406,2384,550,2934,16
2021-09-22,Contra Costa,013,1133247,95231,94209,1965,96174,924
2021-09-22,Del Norte,015,27424,3517,3386,30,3416,35
2021-09-22,El Dorado,017,186661,14882,14605,1511,16116,127
2021-09-22,Fresno,019,978130,128496,126006,11679,137685,1908
2021-09-22,Glenn,021,27897,3230,3138,934,4072,25
2021-09-22,Humboldt,023,135768,8176,7998,413,8411,80
2021-09-22,Imperial,025,180216,31596,31243,3036,34279,755
2021-09-22,Inyo,027,18085,1705,1651,34,1685,39
2021-09-22,Kern,029,883053,118052,115757,18499,134256,1477
2021-09-22,Kings,031,150075,29308,28589,1675,30264,292
2021-09-22,Lake,033,64148,6188,6035,122,6157,93
2021-09-22,Lassen,035,31185,6377,6209,279,6488,25
2021-09-22,Los Angeles,037,10098052,1397077,1384719,52554,1437273,25930
2021-09-22,Madera,039,155013,20883,20382,1688,22070,262
2021-09-22,Marin,041,260295,16956,16782,400,17182,242
2021-09-22,Mariposa,043,17540,951,901,33,934,5
2021-09-22,Mendocino,045,87422,6853,6624,347,6971,70
2021-09-22,Merced,047,269075,38780,38305,1531,39836,541
2021-09-22,Modoc,049,8938,476,458,166,624,5
2021-09-22,Mono,051,14174,1529,1496,19,1515,3
2021-09-22,Monterey,053,433212,47536,46615,2611,49226,566
2021-09-22,Napa,055,140530,12375,12248,89,12337,95
2021-09-22,Nevada,057,99092,8413,8273,286,8559,84
2021-09-22,Orange,059,3164182,297627,294214,14083,308297,5366
2021-09-22,Placer,061,380077,34301,33661,3235,36896,367
2021-09-22,Plumas,063,18699,1282,1230,25,1255,6
2021-09-22,Riverside,065,2383286,348519,342946,15960,358906,4830
2021-09-22,Sacramento,067,1510023,148783,147533,3840,151373,2043
2021-09-22,San Benito,069,59416,7007,6961,146,7107,67
2021-09-22,San Bernardino,071,2135413,341026,337938,10616,348554,5528
2021-09-22,San Diego,073,3302833,355258,351132,20859,371991,4027
2021-09-22,San Francisco,075,870044,50456,49734,2168,51902,610
2021-09-22,San Joaquin,077,732212,94420,93010,5061,98071,1626
2021-09-22,San Luis Obispo,079,281455,27974,27398,1112,28510,315
2021-09-22,San Mateo,081,765935,52167,51197,787,51984,568
2021-09-22,Santa Barbara,083,443738,42213,41678,1485,43163,504
2021-09-22,Santa Clara,085,1922200,141309,139803,1118,140921,1844
2021-09-22,Santa Cruz,087,273765,19446,19177,977,20154,214
2021-09-22,Shasta,089,179085,18738,18153,3095,21248,260
2021-09-22,Sierra,091,2930,133,127,13,140,0
2021-09-22,Siskiyou,093,43540,3086,2947,1094,4041,41
2021-09-22,Solano,095,438530,44111,43269,1148,44417,312
2021-09-22,Sonoma,097,501317,39395,39063,492,39555,369
2021-09-22,Stanislaus,099,539301,72790,72355,8229,80584,1091
2021-09-22,Sutter,101,95872,13058,12960,260,13220,153
2021-09-22,Tehama,103,63373,7400,7173,1221,8394,86
2021-09-22,Trinity,105,12862,745,572,201,773,9
2021-09-22,Tulare,107,460477,62454,60776,12902,73678,896
2021-09-22,Tuolumne,109,53932,6255,6155,71,6226,89
2021-09-22,Ventura,111,848112,94878,93978,4147,98125,1122
2021-09-22,Yolo,113,214977,18594,18342,956,19298,239
2021-09-22,Yuba,115,75493,9299,9169,210,9379,61
2021-09-21,Alameda,001,1643700,114739,113765,2637,116402,1321
2021-09-21,Alpine,003,1148,99,100,0,100,0
2021-09-21,Amador,005,37829,5030,4897,52,4949,59
2021-09-21,Butte,007,227075,18801,18229,3330,21559,232
2021-09-21,Calaveras,009,45235,3523,3437,40,3477,70
2021-09-21,Colusa,011,21464,2403,2378,549,2927,16
2021-09-21,Contra Costa,013,1133247,95037,94101,1951,96052,924
2021-09-21,Del Norte,015,27424,3504,3378,30,3408,34
2021-09-21,El Dorado,017,186661,14852,14578,1504,16082,127
2021-09-21,Fresno,019,978130,128145,125789,11653,137442,1892
2021-09-21,Glenn,021,27897,3223,3134,930,4064,25
2021-09-21,Humboldt,023,135768,8144,7955,408,8363,80
2021-09-21,Imperial,025,180216,31539,31185,3034,34219,755
2021-09-21,Inyo,027,18085,1695,1646,34,1680,39
2021-09-21,Kern,029,883053,117760,115534,18385,133919,1467
2021-09-21,Kings,031,150075,29220,28545,1667,30212,291
2021-09-21,Lake,033,64148,6165,6013,122,6135,90
2021-09-21,Lassen,035,31185,6359,6159,275,6434,25
2021-09-21,Los Angeles,037,10098052,1395620,1383277,52497,1435774,25893
2021-09-21,Madera,039,155013,20823,20317,1678,21995,262
2021-09-21,Marin,041,260295,16941,16748,399,17147,242
2021-09-21,Mariposa,043,17540,946,894,32,926,5
2021-09-21,Mendocino,045,87422,6815,6580,336,6916,68
2021-09-21,Merced,047,269075,38658,38225,1527,39752,539
2021-09-21,Modoc,049,8938,473,458,166,624,5
2021-09-21,Mono,051,14174,1527,1495,18,1513,3
2021-09-21,Monterey,053,433212,47467,46583,2599,49182,565
2021-09-21,Napa,055,140530,12354,12238,89,12327,95
2021-09-21,Nevada,057,99092,8386,8259,277,8536,84
2021-09-21,Orange,059,3164182,297296,293898,14053,307951,5357
2021-09-21,Placer,061,380077,34200,33609,3224,36833,365
2021-09-21,Plumas,063,18699,1275,1225,25,1250,5
2021-09-21,Riverside,065,2383286,347959,342460,15936,358396,4817
2021-09-21,Sacramento,067,1510023,148401,147378,3812,151190,2027
2021-09-21,San Benito,069,59416,6996,6950,145,7095,67
2021-09-21,San Bernardino,071,2135413,340588,337387,10599,347986,5520
2021-09-21,San Diego,073,3302833,354642,350265,20833,371098,4021
2021-09-21,San Francisco,075,870044,50360,49653,2164,51817,609
2021-09-21,San Joaquin,077,732212,94186,92762,5050,97812,1621
2021-09-21,San Luis Obispo,079,281455,27915,27318,1108,28426,314
2021-09-21,San Mateo,081,765935,52097,51136,787,51923,568
2021-09-21,Santa Barbara,083,443738,42144,41644,1481,43125,503
2021-09-21,Santa Clara,085,1922200,141092,139657,1114,140771,1843
2021-09-21,Santa Cruz,087,273765,19416,19140,976,20116,212
2021-09-21,Shasta,089,179085,18610,18027,3071,21098,258
2021-09-21,Sierra,091,2930,133,127,13,140,0
2021-09-21,Siskiyou,093,43540,3072,2927,1080,4007,36
2021-09-21,Solano,095,438530,44035,43220,1148,44368,311
2021-09-21,Sonoma,097,501317,39342,39042,492,39534,369
2021-09-21,Stanislaus,099,539301,72606,72211,8207,80418,1091
2021-09-21,Sutter,101,95872,13035,12930,257,13187,153
2021-09-21,Tehama,103,63373,7354,7151,1217,8368,85
2021-09-21,Trinity,105,12862,734,572,199,771,9
2021-09-21,Tulare,107,460477,62240,60607,12841,73448,896
2021-09-21,Tuolumne,109,53932,6223,6139,71,6210,89
2021-09-21,Ventura,111,848112,94773,93818,4139,97957,1120
2021-09-21,Yolo,113,214977,18558,18313,952,19265,239
2021-09-21,Yuba,115,75493,9271,9135,210,9345,61
2021-09-20,Alameda,001,1643700,114556,113637,2633,116270,1320
2021-09-20,Alpine,003,1148,99,100,0,100,0
2021-09-20,Amador,005,37829,5012,4883,51,4934,59
2021-09-20,Butte,007,227075,18719,18135,3314,21449,231
2021-09-20,Calaveras,009,45235,3501,3395,39,3434,66
2021-09-20,Colusa,011,21464,2401,2376,546,2922,16
2021-09-20,Contra Costa,013,1133247,94887,93919,1945,95864,924
2021-09-20,Del Norte,015,27424,3496,3374,29,3403,34
2021-09-20,El Dorado,017,186661,14819,14545,1492,16037,127
2021-09-20,Fresno,019,978130,127732,125287,11625,136912,1889
2021-09-20,Glenn,021,27897,3212,3112,927,4039,25
2021-09-20,Humboldt,023,135768,8108,7938,403,8341,80
2021-09-20,Imperial,025,180216,31456,31146,3033,34179,755
2021-09-20,Inyo,027,18085,1687,1641,33,1674,39
2021-09-20,Kern,029,883053,117421,115271,18253,133524,1459
2021-09-20,Kings,031,150075,29133,28471,1661,30132,285
2021-09-20,Lake,033,64148,6150,5984,121,6105,87
2021-09-20,Lassen,035,31185,6329,6132,275,6407,25
2021-09-20,Los Angeles,037,10098052,1394099,1382206,52416,1434622,25858
2021-09-20,Madera,039,155013,20770,20203,1671,21874,257
2021-09-20,Marin,041,260295,16916,16732,397,17129,242
2021-09-20,Mariposa,043,17540,935,887,32,919,5
2021-09-20,Mendocino,045,87422,6781,6568,330,6898,67
2021-09-20,Merced,047,269075,38547,38144,1516,39660,536
2021-09-20,Modoc,049,8938,472,457,164,621,5
2021-09-20,Mono,051,14174,1521,1480,18,1498,3
2021-09-20,Monterey,053,433212,47425,46506,2581,49087,565
2021-09-20,Napa,055,140530,12329,12209,88,12297,95
2021-09-20,Nevada,057,99092,8366,8228,275,8503,84
2021-09-20,Orange,059,3164182,296953,293642,14026,307668,5354
2021-09-20,Placer,061,380077,34109,33531,3209,36740,364
2021-09-20,Plumas,063,18699,1270,1211,25,1236,5
2021-09-20,Riverside,065,2383286,347459,341961,15923,357884,4802
2021-09-20,Sacramento,067,1510023,148027,147016,3778,150794,2016
2021-09-20,San Benito,069,59416,6987,6947,144,7091,67
2021-09-20,San Bernardino,071,2135413,340191,337059,10583,347642,5507
2021-09-20,San Diego,073,3302833,353965,349579,20796,370375,4009
2021-09-20,San Francisco,075,870044,50253,49559,2163,51722,605
2021-09-20,San Joaquin,077,732212,93943,92614,5037,97651,1615
2021-09-20,San Luis Obispo,079,281455,27839,27259,1100,28359,313
2021-09-20,San Mateo,081,765935,52010,51100,784,51884,567
2021-09-20,Santa Barbara,083,443738,42045,41589,1477,43066,500
2021-09-20,Santa Clara,085,1922200,140891,139578,1112,140690,1841
2021-09-20,Santa Cruz,087,273765,19384,19121,976,20097,211
2021-09-20,Shasta,089,179085,18511,17893,3040,20933,258
2021-09-20,Sierra,091,2930,131,126,13,139,0
2021-09-20,Siskiyou,093,43540,3050,2902,1067,3969,35
2021-09-20,Solano,095,438530,43967,43152,1140,44292,312
2021-09-20,Sonoma,097,501317,39296,38991,492,39483,369
2021-09-20,Stanislaus,099,539301,72407,72031,8188,80219,1091
2021-09-20,Sutter,101,95872,12999,12896,252,13148,153
2021-09-20,Tehama,103,63373,7322,7121,1205,8326,84
2021-09-20,Trinity,105,12862,728,568,198,766,7
2021-09-20,Tulare,107,460477,62038,60302,12785,73087,896
2021-09-20,Tuolumne,109,53932,6197,6113,71,6184,89
2021-09-20,Ventura,111,848112,94660,93700,4132,97832,1120
2021-09-20,Yolo,113,214977,18512,18287,950,19237,239
2021-09-20,Yuba,115,75493,9235,9107,208,9315,61
2021-09-19,Alameda,001,1643700,114339,113446,2628,116074,1320
2021-09-19,Alpine,003,1148,99,100,0,100,0
2021-09-19,Amador,005,37829,4972,4875,50,4925,59
2021-09-19,Butte,007,227075,18626,18063,3287,21350,230
2021-09-19,Calaveras,009,45235,3477,3390,36,3426,66
2021-09-19,Colusa,011,21464,2399,2375,544,2919,16
2021-09-19,Contra Costa,013,1133247,94702,93788,1935,95723,924
2021-09-19,Del Norte,015,27424,3470,3344,28,3372,34
2021-09-19,El Dorado,017,186661,14766,14512,1486,15998,127
2021-09-19,Fresno,019,978130,127326,124985,11580,136565,1888
2021-09-19,Glenn,021,27897,3203,3102,924,4026,25
2021-09-19,Humboldt,023,135768,8063,7914,401,8315,80
2021-09-19,Imperial,025,180216,31387,31122,3030,34152,755
2021-09-19,Inyo,027,18085,1678,1639,33,1672,39
2021-09-19,Kern,029,883053,117109,115074,18147,133221,1459
2021-09-19,Kings,031,150075,29005,28416,1652,30068,284
2021-09-19,Lake,033,64148,6119,5962,121,6083,87
2021-09-19,Lassen,035,31185,6309,6129,269,6398,25
2021-09-19,Los Angeles,037,10098052,1392124,1381200,52317,1433517,25852
2021-09-19,Madera,039,155013,20691,20161,1660,21821,257
2021-09-19,Marin,041,260295,16887,16711,395,17106,242
2021-09-19,Mariposa,043,17540,927,881,32,913,5
2021-09-19,Mendocino,045,87422,6736,6538,324,6862,67
2021-09-19,Merced,047,269075,38390,38068,1507,39575,535
2021-09-19,Modoc,049,8938,469,457,162,619,5
2021-09-19,Mono,051,14174,1516,1480,18,1498,3
2021-09-19,Monterey,053,433212,47370,46486,2578,49064,565
2021-09-19,Napa,055,140530,12308,12190,86,12276,95
2021-09-19,Nevada,057,99092,8338,8203,273,8476,84
2021-09-19,Orange,059,3164182,296585,293258,14004,307262,5354
2021-09-19,Placer,061,380077,33996,33406,3191,36597,364
2021-09-19,Plumas,063,18699,1262,1211,25,1236,5
2021-09-19,Riverside,065,2383286,346866,341566,15914,357480,4804
2021-09-19,Sacramento,067,1510023,147667,146603,3732,150335,2012
2021-09-19,San Benito,069,59416,6968,6942,144,7086,67
2021-09-19,San Bernardino,071,2135413,339697,336688,10572,347260,5506
2021-09-19,San Diego,073,3302833,353251,349225,20759,369984,4006
2021-09-19,San Francisco,075,870044,50145,49458,2154,51612,605
2021-09-19,San Joaquin,077,732212,93646,92467,5026,97493,1615
2021-09-19,San Luis Obispo,079,281455,27738,27208,1091,28299,313
2021-09-19,San Mateo,081,765935,51912,51028,783,51811,567
2021-09-19,Santa Barbara,083,443738,41939,41512,1477,42989,500
2021-09-19,Santa Clara,085,1922200,140705,139410,1107,140517,1841
2021-09-19,Santa Cruz,087,273765,19345,19096,976,20072,211
2021-09-19,Shasta,089,179085,18397,17813,3004,20817,258
2021-09-19,Sierra,091,2930,130,126,13,139,0
2021-09-19,Siskiyou,093,43540,3024,2882,1058,3940,35
2021-09-19,Solano,095,438530,43878,43056,1135,44191,312
2021-09-19,Sonoma,097,501317,39224,38956,488,39444,369
2021-09-19,Stanislaus,099,539301,72163,71830,8163,79993,1091
2021-09-19,Sutter,101,95872,12972,12868,245,13113,153
2021-09-19,Tehama,103,63373,7268,7081,1196,8277,84
2021-09-19,Trinity,105,12862,717,562,196,758,7
2021-09-19,Tulare,107,460477,61777,60160,12691,72851,896
2021-09-19,Tuolumne,109,53932,6155,6097,71,6168,89
2021-09-19,Ventura,111,848112,94498,93491,4123,97614,1120
2021-09-19,Yolo,113,214977,18463,18238,944,19182,239
2021-09-19,Yuba,115,75493,9209,9087,207,9294,61
2021-09-18,Alameda,001,1643700,114239,113300,2627,115927,1320
2021-09-18,Alpine,003,1148,99,100,0,100,0
2021-09-18,Amador,005,37829,4962,4850,50,4900,59
2021-09-18,Butte,007,227075,18589,17961,3273,21234,230
2021-09-18,Calaveras,009,45235,3472,3361,35,3396,66
2021-09-18,Colusa,011,21464,2399,2373,543,2916,16
2021-09-18,Contra Costa,013,1133247,94612,93656,1931,95587,924
2021-09-18,Del Norte,015,27424,3462,3326,26,3352,34
2021-09-18,El Dorado,017,186661,14743,14472,1483,15955,127
2021-09-18,Fresno,019,978130,127184,124771,11562,136333,1889
2021-09-18,Glenn,021,27897,3194,3086,921,4007,25
2021-09-18,Humboldt,023,135768,8049,7881,400,8281,80
2021-09-18,Imperial,025,180216,31363,31096,3029,34125,755
2021-09-18,Inyo,027,18085,1672,1636,33,1669,39
2021-09-18,Kern,029,883053,116954,114781,18083,132864,1459
2021-09-18,Kings,031,150075,28957,28330,1647,29977,285
2021-09-18,Lake,033,64148,6102,5936,121,6057,87
2021-09-18,Lassen,035,31185,6299,6121,267,6388,25
2021-09-18,Los Angeles,037,10098052,1391365,1379880,52266,1432146,25849
2021-09-18,Madera,039,155013,20647,20126,1650,21776,257
2021-09-18,Marin,041,260295,16870,16685,394,17079,242
2021-09-18,Mariposa,043,17540,924,871,32,903,5
2021-09-18,Mendocino,045,87422,6715,6523,324,6847,67
2021-09-18,Merced,047,269075,38353,37977,1501,39478,535
2021-09-18,Modoc,049,8938,469,457,161,618,5
2021-09-18,Mono,051,14174,1513,1480,18,1498,3
2021-09-18,Monterey,053,433212,47332,46466,2575,49041,565
2021-09-18,Napa,055,140530,12296,12168,86,12254,95
2021-09-18,Nevada,057,99092,8321,8183,273,8456,84
2021-09-18,Orange,059,3164182,296391,293005,13990,306995,5354
2021-09-18,Placer,061,380077,33924,33309,3188,36497,364
2021-09-18,Plumas,063,18699,1261,1204,25,1229,5
2021-09-18,Riverside,065,2383286,346481,341136,15899,357035,4802
2021-09-18,Sacramento,067,1510023,147485,146162,3723,149885,2016
2021-09-18,San Benito,069,59416,6963,6937,144,7081,67
2021-09-18,San Bernardino,071,2135413,339424,336380,10559,346939,5501
2021-09-18,San Diego,073,3302833,352853,348848,20746,369594,4006
2021-09-18,San Francisco,075,870044,50082,49359,2149,51508,605
2021-09-18,San Joaquin,077,732212,93536,92242,5014,97256,1615
2021-09-18,San Luis Obispo,079,281455,27701,27181,1088,28269,313
2021-09-18,San Mateo,081,765935,51861,50961,781,51742,567
2021-09-18,Santa Barbara,083,443738,41874,41465,1477,42942,500
2021-09-18,Santa Clara,085,1922200,140585,139233,1104,140337,1841
2021-09-18,Santa Cruz,087,273765,19325,19079,976,20055,211
2021-09-18,Shasta,089,179085,18334,17777,2987,20764,258
2021-09-18,Sierra,091,2930,129,125,13,138,0
2021-09-18,Siskiyou,093,43540,3021,2875,1052,3927,35
2021-09-18,Solano,095,438530,43838,42966,1132,44098,312
2021-09-18,Sonoma,097,501317,39189,38891,486,39377,369
2021-09-18,Stanislaus,099,539301,72017,71587,8138,79725,1091
2021-09-18,Sutter,101,95872,12958,12829,245,13074,153
2021-09-18,Tehama,103,63373,7254,7055,1189,8244,84
2021-09-18,Trinity,105,12862,715,561,196,757,7
2021-09-18,Tulare,107,460477,61701,60003,12639,72642,896
2021-09-18,Tuolumne,109,53932,6140,6069,71,6140,89
2021-09-18,Ventura,111,848112,94430,93424,4118,97542,1120
2021-09-18,Yolo,113,214977,18436,18213,939,19152,239
2021-09-18,Yuba,115,75493,9195,9061,206,9267,61
2021-09-17,Alameda,001,1643700,114114,113070,2625,115695,1320
2021-09-17,Alpine,003,1148,99,99,0,99,0
2021-09-17,Amador,005,37829,4946,4835,49,4884,58
2021-09-17,Butte,007,227075,18537,17870,3264,21134,230
2021-09-17,Calaveras,009,45235,3460,3338,34,3372,66
2021-09-17,Colusa,011,21464,2398,2369,538,2907,16
2021-09-17,Contra Costa,013,1133247,94509,93485,1928,95413,924
2021-09-17,Del Norte,015,27424,3457,3311,24,3335,34
2021-09-17,El Dorado,017,186661,14724,14421,1481,15902,127
2021-09-17,Fresno,019,978130,126965,124296,11546,135842,1882
2021-09-17,Glenn,021,27897,3177,3072,917,3989,25
2021-09-17,Humboldt,023,135768,8028,7850,400,8250,80
2021-09-17,Imperial,025,180216,31337,31031,3028,34059,755
2021-09-17,Inyo,027,18085,1664,1634,33,1667,39
2021-09-17,Kern,029,883053,116763,114303,17986,132289,1456
2021-09-17,Kings,031,150075,28892,28240,1645,29885,281
2021-09-17,Lake,033,64148,6089,5915,121,6036,87
2021-09-17,Lassen,035,31185,6284,6080,265,6345,25
2021-09-17,Los Angeles,037,10098052,1390388,1377905,52199,1430104,25820
2021-09-17,Madera,039,155013,20596,20040,1638,21678,257
2021-09-17,Marin,041,260295,16857,16658,392,17050,242
2021-09-17,Mariposa,043,17540,922,869,32,901,5
2021-09-17,Mendocino,045,87422,6696,6498,324,6822,67
2021-09-17,Merced,047,269075,38306,37803,1499,39302,533
2021-09-17,Modoc,049,8938,469,456,161,617,5
2021-09-17,Mono,051,14174,1509,1457,18,1475,3
2021-09-17,Monterey,053,433212,47309,46421,2574,48995,564
2021-09-17,Napa,055,140530,12275,12153,86,12239,95
2021-09-17,Nevada,057,99092,8306,8157,273,8430,84
2021-09-17,Orange,059,3164182,296171,292685,13972,306657,5346
2021-09-17,Placer,061,380077,33863,33188,3178,36366,362
2021-09-17,Plumas,063,18699,1252,1192,24,1216,5
2021-09-17,Riverside,065,2383286,346081,340445,15888,356333,4792
2021-09-17,Sacramento,067,1510023,147286,145985,3712,149697,1999
2021-09-17,San Benito,069,59416,6960,6929,144,7073,67
2021-09-17,San Bernardino,071,2135413,339068,335810,10552,346362,5488
2021-09-17,San Diego,073,3302833,352418,348098,20729,368827,4002
2021-09-17,San Francisco,075,870044,50030,49249,2144,51393,605
2021-09-17,San Joaquin,077,732212,93398,91977,5003,96980,1610
2021-09-17,San Luis Obispo,079,281455,27667,27102,1077,28179,311
2021-09-17,San Mateo,081,765935,51808,50854,780,51634,564
2021-09-17,Santa Barbara,083,443738,41811,41354,1476,42830,498
2021-09-17,Santa Clara,085,1922200,140436,138939,1102,140041,1838
2021-09-17,Santa Cruz,087,273765,19301,19039,976,20015,211
2021-09-17,Shasta,089,179085,18263,17617,2974,20591,254
2021-09-17,Sierra,091,2930,129,124,13,137,0
2021-09-17,Siskiyou,093,43540,3006,2852,1052,3904,35
2021-09-17,Solano,095,438530,43775,42898,1128,44026,312
2021-09-17,Sonoma,097,501317,39152,38808,485,39293,369
2021-09-17,Stanislaus,099,539301,71910,71408,8120,79528,1091
2021-09-17,Sutter,101,95872,12942,12799,242,13041,153
2021-09-17,Tehama,103,63373,7230,7020,1177,8197,84
2021-09-17,Trinity,105,12862,710,556,195,751,7
2021-09-17,Tulare,107,460477,61586,59689,12605,72294,895
2021-09-17,Tuolumne,109,53932,6121,6047,71,6118,89
2021-09-17,Ventura,111,848112,94318,93273,4116,97389,1116
2021-09-17,Yolo,113,214977,18405,18177,935,19112,239
2021-09-17,Yuba,115,75493,9168,9019,205,9224,61
2021-09-16,Alameda,001,1643700,113936,112770,2622,115392,1318
2021-09-16,Alpine,003,1148,99,99,0,99,0
2021-09-16,Amador,005,37829,4926,4819,49,4868,58
2021-09-16,Butte,007,227075,18463,17750,3248,20998,230
2021-09-16,Calaveras,009,45235,3428,3313,34,3347,66
2021-09-16,Colusa,011,21464,2396,2363,536,2899,16
2021-09-16,Contra Costa,013,1133247,94337,93213,1920,95133,917
2021-09-16,Del Norte,015,27424,3439,3285,24,3309,34
2021-09-16,El Dorado,017,186661,14684,14372,1473,15845,127
2021-09-16,Fresno,019,978130,126608,123853,11503,135356,1868
2021-09-16,Glenn,021,27897,3167,3068,915,3983,24
2021-09-16,Humboldt,023,135768,7994,7809,390,8199,80
2021-09-16,Imperial,025,180216,31294,30966,3020,33986,753
2021-09-16,Inyo,027,18085,1662,1623,33,1656,39
2021-09-16,Kern,029,883053,116492,113828,17918,131746,1448
2021-09-16,Kings,031,150075,28806,28114,1636,29750,280
2021-09-16,Lake,033,64148,6065,5890,118,6008,87
2021-09-16,Lassen,035,31185,6249,6028,260,6288,25
2021-09-16,Los Angeles,037,10098052,1388998,1376277,52133,1428410,25796
2021-09-16,Madera,039,155013,20518,19974,1632,21606,257
2021-09-16,Marin,041,260295,16830,16625,391,17016,242
2021-09-16,Mariposa,043,17540,916,849,32,881,6
2021-09-16,Mendocino,045,87422,6658,6445,313,6758,67
2021-09-16,Merced,047,269075,38199,37675,1496,39171,532
2021-09-16,Modoc,049,8938,467,455,161,616,5
2021-09-16,Mono,051,14174,1503,1449,18,1467,3
2021-09-16,Monterey,053,433212,47255,46342,2568,48910,562
2021-09-16,Napa,055,140530,12250,12115,82,12197,95
2021-09-16,Nevada,057,99092,8279,8121,272,8393,84
2021-09-16,Orange,059,3164182,295825,292183,13952,306135,5340
2021-09-16,Placer,061,380077,33767,33037,3158,36195,354
2021-09-16,Plumas,063,18699,1244,1178,24,1202,5
2021-09-16,Riverside,065,2383286,345550,339770,15874,355644,4786
2021-09-16,Sacramento,067,1510023,146930,145754,3680,149434,1996
2021-09-16,San Benito,069,59416,6947,6913,143,7056,67
2021-09-16,San Bernardino,071,2135413,338640,335129,10545,345674,5474
2021-09-16,San Diego,073,3302833,351794,347472,20690,368162,3994
2021-09-16,San Francisco,075,870044,49945,49133,2135,51268,605
2021-09-16,San Joaquin,077,732212,93160,91650,4958,96608,1608
2021-09-16,San Luis Obispo,079,281455,27594,27044,1073,28117,310
2021-09-16,San Mateo,081,765935,51731,50773,778,51551,564
2021-09-16,Santa Barbara,083,443738,41745,41272,1473,42745,497
2021-09-16,Santa Clara,085,1922200,140280,138685,1098,139783,1835
2021-09-16,Santa Cruz,087,273765,19274,19011,976,19987,211
2021-09-16,Shasta,089,179085,18138,17438,2940,20378,251
2021-09-16,Sierra,091,2930,129,123,13,136,0
2021-09-16,Siskiyou,093,43540,2986,2819,1045,3864,35
2021-09-16,Solano,095,438530,43703,42792,1119,43911,312
2021-09-16,Sonoma,097,501317,39089,38707,484,39191,369
2021-09-16,Stanislaus,099,539301,71677,71105,8103,79208,1091
2021-09-16,Sutter,101,95872,12898,12729,236,12965,152
2021-09-16,Tehama,103,63373,7191,6953,1166,8119,83
2021-09-16,Trinity,105,12862,707,547,194,741,7
2021-09-16,Tulare,107,460477,61364,59459,12530,71989,894
2021-09-16,Tuolumne,109,53932,6101,5999,70,6069,89
2021-09-16,Ventura,111,848112,94178,93087,4112,97199,1110
2021-09-16,Yolo,113,214977,18373,18135,933,19068,239
2021-09-16,Yuba,115,75493,9134,8981,202,9183,61
2021-09-15,Alameda,001,1643700,113770,112498,2614,115112,1317
2021-09-15,Alpine,003,1148,99,99,0,99,0
2021-09-15,Amador,005,37829,4918,4792,49,4841,58
2021-09-15,Butte,007,227075,18364,17664,3230,20894,228
2021-09-15,Calaveras,009,45235,3399,3293,32,3325,66
2021-09-15,Colusa,011,21464,2394,2352,533,2885,16
2021-09-15,Contra Costa,013,1133247,94157,92989,1908,94897,913
2021-09-15,Del Norte,015,27424,3426,3271,22,3293,34
2021-09-15,El Dorado,017,186661,14658,14309,1465,15774,127
2021-09-15,Fresno,019,978130,126228,123370,11446,134816,1867
2021-09-15,Glenn,021,27897,3155,3051,910,3961,20
2021-09-15,Humboldt,023,135768,7959,7754,385,8139,52
2021-09-15,Imperial,025,180216,31239,30891,3015,33906,753
2021-09-15,Inyo,027,18085,1658,1614,33,1647,39
2021-09-15,Kern,029,883053,116145,113546,17819,131365,1434
2021-09-15,Kings,031,150075,28727,27991,1627,29618,279
2021-09-15,Lake,033,64148,6033,5852,117,5969,85
2021-09-15,Lassen,035,31185,6189,6018,255,6273,25
2021-09-15,Los Angeles,037,10098052,1387498,1374307,52064,1426371,25767
2021-09-15,Madera,039,155013,20443,19880,1624,21504,257
2021-09-15,Marin,041,260295,16795,16592,386,16978,242
2021-09-15,Mariposa,043,17540,904,843,32,875,5
2021-09-15,Mendocino,045,87422,6628,6399,308,6707,66
2021-09-15,Merced,047,269075,38091,37508,1494,39002,529
2021-09-15,Modoc,049,8938,467,454,161,615,5
2021-09-15,Mono,051,14174,1497,1445,18,1463,3
2021-09-15,Monterey,053,433212,47184,46317,2556,48873,562
2021-09-15,Napa,055,140530,12229,12082,82,12164,95
2021-09-15,Nevada,057,99092,8257,8081,269,8350,84
2021-09-15,Orange,059,3164182,295503,291834,13933,305767,5328
2021-09-15,Placer,061,380077,33655,32860,3137,35997,352
2021-09-15,Plumas,063,18699,1239,1164,23,1187,5
2021-09-15,Riverside,065,2383286,344967,339077,15850,354927,4769
2021-09-15,Sacramento,067,1510023,146503,145202,3649,148851,1981
2021-09-15,San Benito,069,59416,6944,6902,143,7045,67
2021-09-15,San Bernardino,071,2135413,338179,334556,10531,345087,5470
2021-09-15,San Diego,073,3302833,351167,346933,20662,367595,3983
2021-09-15,San Francisco,075,870044,49834,48999,2130,51129,605
2021-09-15,San Joaquin,077,732212,92884,91322,4916,96238,1607
2021-09-15,San Luis Obispo,079,281455,27511,26943,1067,28010,306
2021-09-15,San Mateo,081,765935,51649,50691,775,51466,564
2021-09-15,Santa Barbara,083,443738,41642,41077,1468,42545,497
2021-09-15,Santa Clara,085,1922200,140107,138410,1093,139503,1833
2021-09-15,Santa Cruz,087,273765,19236,18984,974,19958,210
2021-09-15,Shasta,089,179085,18027,17317,2919,20236,250
2021-09-15,Sierra,091,2930,129,123,13,136,0
2021-09-15,Siskiyou,093,43540,2966,2804,1015,3819,35
2021-09-15,Solano,095,438530,43631,42682,1114,43796,312
2021-09-15,Sonoma,097,501317,39031,38629,483,39112,369
2021-09-15,Stanislaus,099,539301,71453,70852,8081,78933,1091
2021-09-15,Sutter,101,95872,12865,12699,231,12930,151
2021-09-15,Tehama,103,63373,7150,6894,1157,8051,79
2021-09-15,Trinity,105,12862,705,541,192,733,7
2021-09-15,Tulare,107,460477,61105,59149,12469,71618,890
2021-09-15,Tuolumne,109,53932,6075,5969,70,6039,89
2021-09-15,Ventura,111,848112,94035,92960,4105,97065,1109
2021-09-15,Yolo,113,214977,18339,18064,925,18989,239
2021-09-15,Yuba,115,75493,9100,8953,202,9155,61
2021-09-14,Alameda,001,1643700,113563,112329,2608,114937,1316
2021-09-14,Alpine,003,1148,99,98,0,98,0
2021-09-14,Amador,005,37829,4898,4790,49,4839,57
2021-09-14,Butte,007,227075,18229,17516,3207,20723,226
2021-09-14,Calaveras,009,45235,3379,3280,29,3309,66
2021-09-14,Colusa,011,21464,2390,2344,529,2873,16
2021-09-14,Contra Costa,013,1133247,93959,92822,1900,94722,908
2021-09-14,Del Norte,015,27424,3410,3252,21,3273,32
2021-09-14,El Dorado,017,186661,14605,14247,1457,15704,123
2021-09-14,Fresno,019,978130,125753,123151,11393,134544,1856
2021-09-14,Glenn,021,27897,3138,3045,906,3951,20
2021-09-14,Humboldt,023,135768,7925,7717,380,8097,52
2021-09-14,Imperial,025,180216,31189,30845,3012,33857,752
2021-09-14,Inyo,027,18085,1649,1605,32,1637,39
2021-09-14,Kern,029,883053,115762,113250,17693,130943,1428
2021-09-14,Kings,031,150075,28651,27955,1619,29574,278
2021-09-14,Lake,033,64148,6001,5845,117,5962,83
2021-09-14,Lassen,035,31185,6175,5977,250,6227,25
2021-09-14,Los Angeles,037,10098052,1385660,1372831,51980,1424811,25729
2021-09-14,Madera,039,155013,20361,19800,1613,21413,254
2021-09-14,Marin,041,260295,16767,16584,384,16968,242
2021-09-14,Mariposa,043,17540,893,834,31,865,5
2021-09-14,Mendocino,045,87422,6592,6372,296,6668,65
2021-09-14,Merced,047,269075,37941,37430,1490,38920,526
2021-09-14,Modoc,049,8938,466,453,161,614,5
2021-09-14,Mono,051,14174,1493,1440,18,1458,4
2021-09-14,Monterey,053,433212,47143,46224,2544,48768,558
2021-09-14,Napa,055,140530,12196,12070,81,12151,91
2021-09-14,Nevada,057,99092,8223,8056,269,8325,83
2021-09-14,Orange,059,3164182,295110,291423,13909,305332,5319
2021-09-14,Placer,061,380077,33523,32735,3117,35852,350
2021-09-14,Plumas,063,18699,1224,1148,23,1171,5
2021-09-14,Riverside,065,2383286,344327,338534,15819,354353,4748
2021-09-14,Sacramento,067,1510023,146118,145051,3601,148652,1977
2021-09-14,San Benito,069,59416,6934,6887,143,7030,64
2021-09-14,San Bernardino,071,2135413,337683,333968,10505,344473,5465
2021-09-14,San Diego,073,3302833,350501,346204,20611,366815,3966
2021-09-14,San Francisco,075,870044,49700,48998,2128,51126,603
2021-09-14,San Joaquin,077,732212,92645,91128,4906,96034,1596
2021-09-14,San Luis Obispo,079,281455,27438,26845,1062,27907,304
2021-09-14,San Mateo,081,765935,51550,50602,772,51374,564
2021-09-14,Santa Barbara,083,443738,41546,40783,1459,42242,495
2021-09-14,Santa Clara,085,1922200,139872,138321,1090,139411,1828
2021-09-14,Santa Cruz,087,273765,19196,18965,972,19937,210
2021-09-14,Shasta,089,179085,17896,17152,2898,20050,246
2021-09-14,Sierra,091,2930,129,123,13,136,0
2021-09-14,Siskiyou,093,43540,2942,2756,998,3754,35
2021-09-14,Solano,095,438530,43548,42599,1111,43710,307
2021-09-14,Sonoma,097,501317,38962,38595,479,39074,369
2021-09-14,Stanislaus,099,539301,71194,70697,8053,78750,1091
2021-09-14,Sutter,101,95872,12823,12670,224,12894,149
2021-09-14,Tehama,103,63373,7096,6859,1149,8008,80
2021-09-14,Trinity,105,12862,699,538,191,729,7
2021-09-14,Tulare,107,460477,60852,58961,12398,71359,888
2021-09-14,Tuolumne,109,53932,6054,5951,68,6019,89
2021-09-14,Ventura,111,848112,93850,92841,4088,96929,1107
2021-09-14,Yolo,113,214977,18295,18039,920,18959,239
2021-09-14,Yuba,115,75493,9064,8928,202,9130,61
2021-09-13,Alameda,001,1643700,113348,112159,2603,114762,1309
2021-09-13,Alpine,003,1148,98,98,0,98,0
2021-09-13,Amador,005,37829,4880,4761,49,4810,56
2021-09-13,Butte,007,227075,18104,17393,3180,20573,225
2021-09-13,Calaveras,009,45235,3353,3253,28,3281,65
2021-09-13,Colusa,011,21464,2381,2346,525,2871,16
2021-09-13,Contra Costa,013,1133247,93713,92658,1895,94553,908
2021-09-13,Del Norte,015,27424,3374,3232,21,3253,28
2021-09-13,El Dorado,017,186661,14544,14194,1449,15643,119
2021-09-13,Fresno,019,978130,125286,122650,11326,133976,1853
2021-09-13,Glenn,021,27897,3124,3026,899,3925,20
2021-09-13,Humboldt,023,135768,7893,7659,377,8036,52
2021-09-13,Imperial,025,180216,31136,30802,3009,33811,751
2021-09-13,Inyo,027,18085,1642,1602,32,1634,39
2021-09-13,Kern,029,883053,115379,112930,17570,130500,1424
2021-09-13,Kings,031,150075,28541,27858,1607,29465,275
2021-09-13,Lake,033,64148,5979,5809,117,5926,82
2021-09-13,Lassen,035,31185,6140,5953,249,6202,25
2021-09-13,Los Angeles,037,10098052,1383795,1371423,51911,1423334,25703
2021-09-13,Madera,039,155013,20291,19735,1598,21333,252
2021-09-13,Marin,041,260295,16731,16557,383,16940,242
2021-09-13,Mariposa,043,17540,879,825,31,856,5
2021-09-13,Mendocino,045,87422,6557,6323,287,6610,61
2021-09-13,Merced,047,269075,37790,37291,1485,38776,521
2021-09-13,Modoc,049,8938,465,451,161,612,5
2021-09-13,Mono,051,14174,1487,1435,18,1453,3
2021-09-13,Monterey,053,433212,47052,46188,2531,48719,558
2021-09-13,Napa,055,140530,12178,12039,81,12120,91
2021-09-13,Nevada,057,99092,8197,8021,267,8288,83
2021-09-13,Orange,059,3164182,294678,291128,13888,305016,5312
2021-09-13,Placer,061,380077,33358,32617,3100,35717,343
2021-09-13,Plumas,063,18699,1215,1142,23,1165,5
2021-09-13,Riverside,065,2383286,343682,337876,15801,353677,4731
2021-09-13,Sacramento,067,1510023,145631,144537,3567,148104,1956
2021-09-13,San Benito,069,59416,6919,6867,142,7009,64
2021-09-13,San Bernardino,071,2135413,337191,333613,10480,344093,5441
2021-09-13,San Diego,073,3302833,349712,345647,20559,366206,3961
2021-09-13,San Francisco,075,870044,49571,48914,2122,51036,603
2021-09-13,San Joaquin,077,732212,92361,90966,4888,95854,1581
2021-09-13,San Luis Obispo,079,281455,27341,26805,1059,27864,300
2021-09-13,San Mateo,081,765935,51460,50525,767,51292,564
2021-09-13,Santa Barbara,083,443738,41427,40661,1452,42113,494
2021-09-13,Santa Clara,085,1922200,139624,138152,1085,139237,1820
2021-09-13,Santa Cruz,087,273765,19156,18917,971,19888,210
2021-09-13,Shasta,089,179085,17766,17033,2857,19890,243
2021-09-13,Sierra,091,2930,129,123,13,136,0
2021-09-13,Siskiyou,093,43540,2927,2745,986,3731,35
2021-09-13,Solano,095,438530,43444,42501,1108,43609,306
2021-09-13,Sonoma,097,501317,38895,38513,476,38989,368
2021-09-13,Stanislaus,099,539301,70940,70477,8017,78494,1091
2021-09-13,Sutter,101,95872,12765,12624,220,12844,145
2021-09-13,Tehama,103,63373,7033,6803,1137,7940,79
2021-09-13,Trinity,105,12862,697,533,189,722,7
2021-09-13,Tulare,107,460477,60568,58768,12337,71105,887
2021-09-13,Tuolumne,109,53932,6023,5909,68,5977,89
2021-09-13,Ventura,111,848112,93688,92679,4080,96759,1107
2021-09-13,Yolo,113,214977,18251,17974,915,18889,239
2021-09-13,Yuba,115,75493,9019,8884,201,9085,61
2021-09-12,Alameda,001,1643700,113085,111961,2600,114561,1309
2021-09-12,Alpine,003,1148,98,98,0,98,0
2021-09-12,Amador,005,37829,4859,4752,49,4801,56
2021-09-12,Butte,007,227075,17959,17257,3136,20393,221
2021-09-12,Calaveras,009,45235,3323,3236,24,3260,65
2021-09-12,Colusa,011,21464,2378,2344,524,2868,16
2021-09-12,Contra Costa,013,1133247,93445,92498,1883,94381,908
2021-09-12,Del Norte,015,27424,3339,3200,21,3221,28
2021-09-12,El Dorado,017,186661,14471,14167,1433,15600,119
2021-09-12,Fresno,019,978130,124766,122407,11269,133676,1853
2021-09-12,Glenn,021,27897,3107,3016,894,3910,20
2021-09-12,Humboldt,023,135768,7823,7636,366,8002,52
2021-09-12,Imperial,025,180216,31073,30790,3004,33794,751
2021-09-12,Inyo,027,18085,1632,1596,30,1626,39
2021-09-12,Kern,029,883053,114967,112602,17411,130013,1424
2021-09-12,Kings,031,150075,28430,27764,1590,29354,274
2021-09-12,Lake,033,64148,5940,5781,115,5896,82
2021-09-12,Lassen,035,31185,6103,5943,239,6182,25
2021-09-12,Los Angeles,037,10098052,1381735,1365968,51835,1417803,25630
2021-09-12,Madera,039,155013,20204,19691,1585,21276,252
2021-09-12,Marin,041,260295,16708,16526,383,16909,242
2021-09-12,Mariposa,043,17540,868,811,29,840,5
2021-09-12,Mendocino,045,87422,6516,6283,278,6561,61
2021-09-12,Merced,047,269075,37618,37172,1474,38646,521
2021-09-12,Modoc,049,8938,465,451,160,611,5
2021-09-12,Mono,051,14174,1480,1431,18,1449,3
2021-09-12,Monterey,053,433212,46952,46167,2521,48688,558
2021-09-12,Napa,055,140530,12148,12011,81,12092,91
2021-09-12,Nevada,057,99092,8157,7987,265,8252,83
2021-09-12,Orange,059,3164182,294214,290718,13867,304585,5312
2021-09-12,Placer,061,380077,33209,32520,3076,35596,343
2021-09-12,Plumas,063,18699,1196,1138,23,1161,5
2021-09-12,Riverside,065,2383286,342999,337332,15767,353099,4731
2021-09-12,Sacramento,067,1510023,145123,144030,3527,147557,1959
2021-09-12,San Benito,069,59416,6900,6852,141,6993,64
2021-09-12,San Bernardino,071,2135413,336576,333049,10467,343516,5439
2021-09-12,San Diego,073,3302833,348892,345058,20483,365541,3942
2021-09-12,San Francisco,075,870044,49460,48819,2115,50934,603
2021-09-12,San Joaquin,077,732212,92032,90730,4880,95610,1581
2021-09-12,San Luis Obispo,079,281455,27222,26729,1046,27775,299
2021-09-12,San Mateo,081,765935,51352,50432,763,51195,564
2021-09-12,Santa Barbara,083,443738,41315,40600,1445,42045,494
2021-09-12,Santa Clara,085,1922200,139369,137899,1082,138981,1820
2021-09-12,Santa Cruz,087,273765,19123,18892,970,19862,210
2021-09-12,Shasta,089,179085,17601,16957,2798,19755,243
2021-09-12,Sierra,091,2930,129,123,13,136,0
2021-09-12,Siskiyou,093,43540,2899,2730,971,3701,35
2021-09-12,Solano,095,438530,43338,42409,1103,43512,306
2021-09-12,Sonoma,097,501317,38816,38456,474,38930,368
2021-09-12,Stanislaus,099,539301,70640,70184,7978,78162,1091
2021-09-12,Sutter,101,95872,12723,12589,214,12803,145
2021-09-12,Tehama,103,63373,6969,6732,1125,7857,79
2021-09-12,Trinity,105,12862,693,529,187,716,7
2021-09-12,Tulare,107,460477,60214,58582,12277,70859,887
2021-09-12,Tuolumne,109,53932,5990,5888,68,5956,89
2021-09-12,Ventura,111,848112,93561,92496,4074,96570,1107
2021-09-12,Yolo,113,214977,18185,17943,907,18850,239
2021-09-12,Yuba,115,75493,8984,8842,201,9043,61
2021-09-11,Alameda,001,1643700,112960,111715,2598,114313,1309
2021-09-11,Alpine,003,1148,98,98,0,98,0
2021-09-11,Amador,005,37829,4846,4728,48,4776,56
2021-09-11,Butte,007,227075,17877,17218,3109,20327,221
2021-09-11,Calaveras,009,45235,3315,3208,23,3231,65
2021-09-11,Colusa,011,21464,2377,2338,521,2859,16
2021-09-11,Contra Costa,013,1133247,93326,92269,1878,94147,908
2021-09-11,Del Norte,015,27424,3323,3184,21,3205,28
2021-09-11,El Dorado,017,186661,14452,14117,1426,15543,119
2021-09-11,Fresno,019,978130,124586,122224,11244,133468,1853
2021-09-11,Glenn,021,27897,3097,3007,891,3898,20
2021-09-11,Humboldt,023,135768,7801,7615,363,7978,52
2021-09-11,Imperial,025,180216,31048,30760,3000,33760,751
2021-09-11,Inyo,027,18085,1629,1590,30,1620,39
2021-09-11,Kern,029,883053,114717,112205,17295,129500,1424
2021-09-11,Kings,031,150075,28381,27631,1584,29215,275
2021-09-11,Lake,033,64148,5919,5761,115,5876,82
2021-09-11,Lassen,035,31185,6088,5930,235,6165,25
2021-09-11,Los Angeles,037,10098052,1380769,1365831,51770,1417601,25630
2021-09-11,Madera,039,155013,20151,19648,1580,21228,252
2021-09-11,Marin,041,260295,16680,16496,382,16878,242
2021-09-11,Mariposa,043,17540,863,799,29,828,5
2021-09-11,Mendocino,045,87422,6492,6257,278,6535,61
2021-09-11,Merced,047,269075,37564,37042,1471,38513,521
2021-09-11,Modoc,049,8938,465,449,160,609,5
2021-09-11,Mono,051,14174,1474,1431,18,1449,3
2021-09-11,Monterey,053,433212,46915,46140,2518,48658,558
2021-09-11,Napa,055,140530,12125,11991,81,12072,91
2021-09-11,Nevada,057,99092,8142,7967,265,8232,83
2021-09-11,Orange,059,3164182,293912,290429,13850,304279,5306
2021-09-11,Placer,061,380077,33126,32414,3065,35479,344
2021-09-11,Plumas,063,18699,1191,1112,23,1135,5
2021-09-11,Riverside,065,2383286,342560,336585,15753,352338,4731
2021-09-11,Sacramento,067,1510023,144822,143557,3515,147072,1955
2021-09-11,San Benito,069,59416,6887,6844,141,6985,64
2021-09-11,San Bernardino,071,2135413,336234,332512,10453,342965,5430
2021-09-11,San Diego,073,3302833,348402,344355,20459,364814,3942
2021-09-11,San Francisco,075,870044,49405,48660,2110,50770,603
2021-09-11,San Joaquin,077,732212,91887,90482,4873,95355,1581
2021-09-11,San Luis Obispo,079,281455,27176,26651,1045,27696,299
2021-09-11,San Mateo,081,765935,51280,50341,763,51104,564
2021-09-11,Santa Barbara,083,443738,41242,40451,1445,41896,494
2021-09-11,Santa Clara,085,1922200,139219,137659,1079,138738,1820
2021-09-11,Santa Cruz,087,273765,19094,18865,970,19835,210
2021-09-11,Shasta,089,179085,17508,16877,2778,19655,243
2021-09-11,Sierra,091,2930,129,123,13,136,0
2021-09-11,Siskiyou,093,43540,2882,2717,968,3685,35
2021-09-11,Solano,095,438530,43287,42344,1100,43444,306
2021-09-11,Sonoma,097,501317,38769,38399,472,38871,368
2021-09-11,Stanislaus,099,539301,70515,69974,7964,77938,1091
2021-09-11,Sutter,101,95872,12697,12538,211,12749,145
2021-09-11,Tehama,103,63373,6948,6703,1117,7820,79
2021-09-11,Trinity,105,12862,686,526,187,713,7
2021-09-11,Tulare,107,460477,60103,58321,12230,70551,889
2021-09-11,Tuolumne,109,53932,5971,5879,65,5944,89
2021-09-11,Ventura,111,848112,93479,92328,4069,96397,1107
2021-09-11,Yolo,113,214977,18162,17906,902,18808,239
2021-09-11,Yuba,115,75493,8959,8813,201,9014,61
2021-09-10,Alameda,001,1643700,112769,111386,2597,113983,1306
2021-09-10,Alpine,003,1148,97,97,0,97,0
2021-09-10,Amador,005,37829,4834,4706,48,4754,56
2021-09-10,Butte,007,227075,17802,17051,3094,20145,222
2021-09-10,Calaveras,009,45235,3306,3183,23,3206,65
2021-09-10,Colusa,011,21464,2373,2327,518,2845,16
2021-09-10,Contra Costa,013,1133247,93203,92024,1876,93900,908
2021-09-10,Del Norte,015,27424,3308,3128,20,3148,28
2021-09-10,El Dorado,017,186661,14421,14051,1422,15473,119
2021-09-10,Fresno,019,978130,124263,121659,11213,132872,1846
2021-09-10,Glenn,021,27897,3090,2977,890,3867,20
2021-09-10,Humboldt,023,135768,7769,7543,359,7902,52
2021-09-10,Imperial,025,180216,31025,30716,2998,33714,751
2021-09-10,Inyo,027,18085,1625,1590,30,1620,39
2021-09-10,Kern,029,883053,114463,111832,17179,129011,1419
2021-09-10,Kings,031,150075,28307,27473,1575,29048,274
2021-09-10,Lake,033,64148,5903,5713,113,5826,79
2021-09-10,Lassen,035,31185,6080,5914,232,6146,25
2021-09-10,Los Angeles,037,10098052,1379560,1365709,51703,1417412,25630
2021-09-10,Madera,039,155013,20105,19520,1573,21093,252
2021-09-10,Marin,041,260295,16660,16458,379,16837,242
2021-09-10,Mariposa,043,17540,858,795,29,824,5
2021-09-10,Mendocino,045,87422,6460,6184,277,6461,61
2021-09-10,Merced,047,269075,37512,36884,1470,38354,521
2021-09-10,Modoc,049,8938,465,448,160,608,5
2021-09-10,Mono,051,14174,1469,1422,18,1440,3
2021-09-10,Monterey,053,433212,46871,46084,2516,48600,557
2021-09-10,Napa,055,140530,12100,11948,81,12029,90
2021-09-10,Nevada,057,99092,8124,7932,264,8196,83
2021-09-10,Orange,059,3164182,293604,290022,13841,303863,5302
2021-09-10,Placer,061,380077,33024,32264,3052,35316,343
2021-09-10,Plumas,063,18699,1183,1111,23,1134,5
2021-09-10,Riverside,065,2383286,342087,335988,15746,351734,4720
2021-09-10,Sacramento,067,1510023,144479,143244,3507,146751,1950
2021-09-10,San Benito,069,59416,6883,6824,141,6965,64
2021-09-10,San Bernardino,071,2135413,335815,331894,10443,342337,5422
2021-09-10,San Diego,073,3302833,347837,343173,20422,363595,3941
2021-09-10,San Francisco,075,870044,49326,48518,2103,50621,602
2021-09-10,San Joaquin,077,732212,91708,90208,4867,95075,1573
2021-09-10,San Luis Obispo,079,281455,27143,26526,1043,27569,299
2021-09-10,San Mateo,081,765935,51213,50251,762,51013,564
2021-09-10,Santa Barbara,083,443738,41189,40321,1442,41763,492
2021-09-10,Santa Clara,085,1922200,139035,137337,1078,138415,1817
2021-09-10,Santa Cruz,087,273765,19075,18785,969,19754,210
2021-09-10,Shasta,089,179085,17414,16667,2750,19417,242
2021-09-10,Sierra,091,2930,129,117,13,130,0
2021-09-10,Siskiyou,093,43540,2870,2702,964,3666,35
2021-09-10,Solano,095,438530,43213,42230,1093,43323,305
2021-09-10,Sonoma,097,501317,38711,38271,471,38742,368
2021-09-10,Stanislaus,099,539301,70359,69617,7940,77557,1091
2021-09-10,Sutter,101,95872,12663,12468,211,12679,145
2021-09-10,Tehama,103,63373,6915,6652,1111,7763,77
2021-09-10,Trinity,105,12862,682,524,187,711,7
2021-09-10,Tulare,107,460477,59955,57930,12183,70113,883
2021-09-10,Tuolumne,109,53932,5953,5842,64,5906,89
2021-09-10,Ventura,111,848112,93382,92145,4065,96210,1104
2021-09-10,Yolo,113,214977,18137,17825,897,18722,239
2021-09-10,Yuba,115,75493,8940,8760,200,8960,62
2021-09-09,Alameda,001,1643700,112549,111014,2593,113607,1306
2021-09-09,Alpine,003,1148,97,94,0,94,0
2021-09-09,Amador,005,37829,4813,4698,47,4745,56
2021-09-09,Butte,007,227075,17656,16874,3068,19942,221
2021-09-09,Calaveras,009,45235,3272,3165,23,3188,65
2021-09-09,Colusa,011,21464,2366,2321,517,2838,16
2021-09-09,Contra Costa,013,1133247,92993,91687,1871,93558,904
2021-09-09,Del Norte,015,27424,3285,3102,20,3122,28
2021-09-09,El Dorado,017,186661,14364,13970,1412,15382,119
2021-09-09,Fresno,019,978130,123788,121040,11166,132206,1838
2021-09-09,Glenn,021,27897,3078,2947,886,3833,20
2021-09-09,Humboldt,023,135768,7719,7471,353,7824,52
2021-09-09,Imperial,025,180216,30987,30661,2995,33656,751
2021-09-09,Inyo,027,18085,1618,1586,30,1616,39
2021-09-09,Kern,029,883053,114115,111390,17022,128412,1414
2021-09-09,Kings,031,150075,28206,27282,1564,28846,273
2021-09-09,Lake,033,64148,5879,5638,111,5749,79
2021-09-09,Lassen,035,31185,6030,5860,226,6086,25
2021-09-09,Los Angeles,037,10098052,1377695,1363735,51628,1415363,25583
2021-09-09,Madera,039,155013,20032,19401,1560,20961,252
2021-09-09,Marin,041,260295,16637,16416,376,16792,242
2021-09-09,Mariposa,043,17540,845,779,28,807,5
2021-09-09,Mendocino,045,87422,6426,6089,268,6357,61
2021-09-09,Merced,047,269075,37358,36634,1457,38091,516
2021-09-09,Modoc,049,8938,465,448,160,608,5
2021-09-09,Mono,051,14174,1459,1420,18,1438,3
2021-09-09,Monterey,053,433212,46817,45991,2505,48496,556
2021-09-09,Napa,055,140530,12068,11878,81,11959,90
2021-09-09,Nevada,057,99092,8086,7855,264,8119,82
2021-09-09,Orange,059,3164182,293194,289109,13810,302919,5299
2021-09-09,Placer,061,380077,32906,32048,3037,35085,342
2021-09-09,Plumas,063,18699,1173,1098,22,1120,5
2021-09-09,Riverside,065,2383286,341448,334774,15728,350502,4701
2021-09-09,Sacramento,067,1510023,143999,142728,3461,146189,1929
2021-09-09,San Benito,069,59416,6873,6820,140,6960,64
2021-09-09,San Bernardino,071,2135413,335251,331040,10431,341471,5417
2021-09-09,San Diego,073,3302833,347112,342149,20365,362514,3929
2021-09-09,San Francisco,075,870044,49212,48404,2094,50498,597
2021-09-09,San Joaquin,077,732212,91433,89874,4849,94723,1570
2021-09-09,San Luis Obispo,079,281455,27061,26472,1040,27512,296
2021-09-09,San Mateo,081,765935,51091,50143,759,50902,561
2021-09-09,Santa Barbara,083,443738,41083,40180,1438,41618,490
2021-09-09,Santa Clara,085,1922200,138812,137017,1073,138090,1816
2021-09-09,Santa Cruz,087,273765,19029,18728,969,19697,210
2021-09-09,Shasta,089,179085,17268,16401,2708,19109,238
2021-09-09,Sierra,091,2930,129,115,13,128,0
2021-09-09,Siskiyou,093,43540,2847,2683,950,3633,35
2021-09-09,Solano,095,438530,43097,42081,1089,43170,303
2021-09-09,Sonoma,097,501317,38643,38171,470,38641,360
2021-09-09,Stanislaus,099,539301,70080,69178,7907,77085,1074
2021-09-09,Sutter,101,95872,12608,12396,209,12605,144
2021-09-09,Tehama,103,63373,6861,6554,1106,7660,75
2021-09-09,Trinity,105,12862,676,523,185,708,6
2021-09-09,Tulare,107,460477,59713,57564,12123,69687,879
2021-09-09,Tuolumne,109,53932,5925,5802,63,5865,89
2021-09-09,Ventura,111,848112,93237,91610,4056,95666,1098
2021-09-09,Yolo,113,214977,18080,17724,894,18618,239
2021-09-09,Yuba,115,75493,8895,8707,197,8904,55
2021-09-08,Alameda,001,1643700,112301,110781,2590,113371,1305
2021-09-08,Alpine,003,1148,97,94,0,94,0
2021-09-08,Amador,005,37829,4801,4693,47,4740,56
2021-09-08,Butte,007,227075,17522,16775,3050,19825,220
2021-09-08,Calaveras,009,45235,3254,3157,23,3180,63
2021-09-08,Colusa,011,21464,2364,2308,517,2825,16
2021-09-08,Contra Costa,013,1133247,92714,91471,1866,93337,900
2021-09-08,Del Norte,015,27424,3262,3085,20,3105,25
2021-09-08,El Dorado,017,186661,14284,13928,1391,15319,119
2021-09-08,Fresno,019,978130,123290,120644,11100,131744,1831
2021-09-08,Glenn,021,27897,3063,2942,877,3819,20
2021-09-08,Humboldt,023,135768,7675,7438,345,7783,52
2021-09-08,Imperial,025,180216,30954,30609,2982,33591,751
2021-09-08,Inyo,027,18085,1607,1580,30,1610,39
2021-09-08,Kern,029,883053,113717,110933,16882,127815,1409
2021-09-08,Kings,031,150075,28077,27235,1549,28784,267
2021-09-08,Lake,033,64148,5849,5618,109,5727,79
2021-09-08,Lassen,035,31185,6012,5848,219,6067,25
2021-09-08,Los Angeles,037,10098052,1375626,1362029,51540,1413569,25533
2021-09-08,Madera,039,155013,19972,19352,1546,20898,252
2021-09-08,Marin,041,260295,16609,16386,375,16761,242
2021-09-08,Mariposa,043,17540,833,777,27,804,5
2021-09-08,Mendocino,045,87422,6382,6069,259,6328,61
2021-09-08,Merced,047,269075,37197,36500,1445,37945,516
2021-09-08,Modoc,049,8938,465,448,160,608,5
2021-09-08,Mono,051,14174,1453,1418,18,1436,3
2021-09-08,Monterey,053,433212,46768,45959,2499,48458,554
2021-09-08,Napa,055,140530,12033,11842,79,11921,90
2021-09-08,Nevada,057,99092,8051,7843,263,8106,82
2021-09-08,Orange,059,3164182,292786,288511,13786,302297,5290
2021-09-08,Placer,061,380077,32769,31852,3020,34872,337
2021-09-08,Plumas,063,18699,1166,1072,22,1094,5
2021-09-08,Riverside,065,2383286,340689,334037,15703,349740,4683
2021-09-08,Sacramento,067,1510023,143520,142448,3412,145860,1921
2021-09-08,San Benito,069,59416,6855,6800,140,6940,64
2021-09-08,San Bernardino,071,2135413,334647,330279,10415,340694,5411
2021-09-08,San Diego,073,3302833,346187,341437,20314,361751,3926
2021-09-08,San Francisco,075,870044,49074,48263,2090,50353,589
2021-09-08,San Joaquin,077,732212,91154,89631,4825,94456,1561
2021-09-08,San Luis Obispo,079,281455,26967,26303,1035,27338,294
2021-09-08,San Mateo,081,765935,50987,50051,759,50810,561
2021-09-08,Santa Barbara,083,443738,40971,40000,1434,41434,490
2021-09-08,Santa Clara,085,1922200,138579,136836,1069,137905,1810
2021-09-08,Santa Cruz,087,273765,18992,18699,969,19668,210
2021-09-08,Shasta,089,179085,17113,16227,2661,18888,234
2021-09-08,Sierra,091,2930,129,113,13,126,0
2021-09-08,Siskiyou,093,43540,2814,2643,939,3582,35
2021-09-08,Solano,095,438530,43005,41971,1086,43057,302
2021-09-08,Sonoma,097,501317,38559,38075,469,38544,360
2021-09-08,Stanislaus,099,539301,69849,68945,7868,76813,1074
2021-09-08,Sutter,101,95872,12543,12349,206,12555,144
2021-09-08,Tehama,103,63373,6794,6520,1089,7609,75
2021-09-08,Trinity,105,12862,673,520,181,701,6
2021-09-08,Tulare,107,460477,59389,57425,12067,69492,876
2021-09-08,Tuolumne,109,53932,5893,5783,61,5844,89
2021-09-08,Ventura,111,848112,93085,91345,4038,95383,1096
2021-09-08,Yolo,113,214977,17998,17680,889,18569,239
2021-09-08,Yuba,115,75493,8853,8675,195,8870,55
2021-09-07,Alameda,001,1643700,112000,110550,2583,113133,1301
2021-09-07,Alpine,003,1148,96,94,0,94,0
2021-09-07,Amador,005,37829,4774,4679,47,4726,53
2021-09-07,Butte,007,227075,17366,16723,3014,19737,220
2021-09-07,Calaveras,009,45235,3214,3140,21,3161,63
2021-09-07,Colusa,011,21464,2354,2306,515,2821,16
2021-09-07,Contra Costa,013,1133247,92451,91167,1860,93027,891
2021-09-07,Del Norte,015,27424,3248,3081,20,3101,24
2021-09-07,El Dorado,017,186661,14212,13892,1376,15268,119
2021-09-07,Fresno,019,978130,122731,120268,11004,131272,1828
2021-09-07,Glenn,021,27897,3051,2937,871,3808,20
2021-09-07,Humboldt,023,135768,7615,7397,328,7725,52
2021-09-07,Imperial,025,180216,30914,30584,2974,33558,751
2021-09-07,Inyo,027,18085,1601,1579,29,1608,39
2021-09-07,Kern,029,883053,113285,110674,16721,127395,1408
2021-09-07,Kings,031,150075,27953,27169,1531,28700,267
2021-09-07,Lake,033,64148,5806,5597,101,5698,78
2021-09-07,Lassen,035,31185,5994,5842,213,6055,21
2021-09-07,Los Angeles,037,10098052,1373392,1360407,51448,1411855,25486
2021-09-07,Madera,039,155013,19885,19316,1538,20854,249
2021-09-07,Marin,041,260295,16570,16363,375,16738,242
2021-09-07,Mariposa,043,17540,817,771,27,798,5
2021-09-07,Mendocino,045,87422,6322,6036,249,6285,61
2021-09-07,Merced,047,269075,37023,36400,1439,37839,513
2021-09-07,Modoc,049,8938,463,449,160,609,5
2021-09-07,Mono,051,14174,1444,1416,18,1434,3
2021-09-07,Monterey,053,433212,46685,45911,2487,48398,543
2021-09-07,Napa,055,140530,11992,11814,79,11893,90
2021-09-07,Nevada,057,99092,8024,7829,263,8092,82
2021-09-07,Orange,059,3164182,292357,288225,13755,301980,5274
2021-09-07,Placer,061,380077,32616,31710,2992,34702,337
2021-09-07,Plumas,063,18699,1151,1071,22,1093,5
2021-09-07,Riverside,065,2383286,339902,333390,15684,349074,4666
2021-09-07,Sacramento,067,1510023,142980,142364,3366,145730,1905
2021-09-07,San Benito,069,59416,6837,6786,140,6926,64
2021-09-07,San Bernardino,071,2135413,333900,329962,10391,340353,5407
2021-09-07,San Diego,073,3302833,345184,340709,20248,360957,3922
2021-09-07,San Francisco,075,870044,48934,48175,2085,50260,589
2021-09-07,San Joaquin,077,732212,90819,89468,4811,94279,1548
2021-09-07,San Luis Obispo,079,281455,26849,26253,1026,27279,287
2021-09-07,San Mateo,081,765935,50894,49913,758,50671,561
2021-09-07,Santa Barbara,083,443738,40845,39957,1429,41386,489
2021-09-07,Santa Clara,085,1922200,138291,136631,1064,137695,1807
2021-09-07,Santa Cruz,087,273765,18943,18669,967,19636,210
2021-09-07,Shasta,089,179085,16957,16096,2608,18704,226
2021-09-07,Sierra,091,2930,129,111,13,124,0
2021-09-07,Siskiyou,093,43540,2788,2607,922,3529,34
2021-09-07,Solano,095,438530,42875,41862,1082,42944,300
2021-09-07,Sonoma,097,501317,38475,38013,467,38480,358
2021-09-07,Stanislaus,099,539301,69576,68831,7840,76671,1074
2021-09-07,Sutter,101,95872,12469,12310,200,12510,138
2021-09-07,Tehama,103,63373,6742,6482,1069,7551,74
2021-09-07,Trinity,105,12862,667,517,181,698,6
2021-09-07,Tulare,107,460477,59039,57228,11988,69216,874
2021-09-07,Tuolumne,109,53932,5856,5759,61,5820,88
2021-09-07,Ventura,111,848112,92874,91246,4028,95274,1093
2021-09-07,Yolo,113,214977,17929,17653,884,18537,235
2021-09-07,Yuba,115,75493,8810,8642,190,8832,55
2021-09-06,Alameda,001,1643700,111686,110357,2575,112932,1301
2021-09-06,Alpine,003,1148,94,94,0,94,0
2021-09-06,Amador,005,37829,4758,4648,46,4694,53
2021-09-06,Butte,007,227075,17174,16588,2971,19559,218
2021-09-06,Calaveras,009,45235,3192,3122,21,3143,63
2021-09-06,Colusa,011,21464,2347,2306,511,2817,16
2021-09-06,Contra Costa,013,1133247,92156,90971,1850,92821,891
2021-09-06,Del Norte,015,27424,3207,3037,19,3056,24
2021-09-06,El Dorado,017,186661,14143,13848,1360,15208,119
2021-09-06,Fresno,019,978130,122157,119738,10929,130667,1828
2021-09-06,Glenn,021,27897,3022,2912,863,3775,20
2021-09-06,Humboldt,023,135768,7539,7320,310,7630,52
2021-09-06,Imperial,025,180216,30851,30576,2968,33544,751
2021-09-06,Inyo,027,18085,1592,1578,17,1595,39
2021-09-06,Kern,029,883053,112773,110347,16533,126880,1408
2021-09-06,Kings,031,150075,27810,27094,1516,28610,264
2021-09-06,Lake,033,64148,5742,5548,94,5642,78
2021-09-06,Lassen,035,31185,5968,5822,203,6025,21
2021-09-06,Los Angeles,037,10098052,1371014,1359348,51331,1410679,25477
2021-09-06,Madera,039,155013,19782,19191,1515,20706,249
2021-09-06,Marin,041,260295,16530,16356,375,16731,242
2021-09-06,Mariposa,043,17540,805,764,27,791,5
2021-09-06,Mendocino,045,87422,6252,5984,236,6220,61
2021-09-06,Merced,047,269075,36809,36300,1425,37725,513
2021-09-06,Modoc,049,8938,460,449,160,609,5
2021-09-06,Mono,051,14174,1440,1416,18,1434,3
2021-09-06,Monterey,053,433212,46591,45833,2470,48303,541
2021-09-06,Napa,055,140530,11949,11792,78,11870,90
2021-09-06,Nevada,057,99092,7976,7748,261,8009,82
2021-09-06,Orange,059,3164182,291863,287948,13702,301650,5274
2021-09-06,Placer,061,380077,32439,31595,2954,34549,337
2021-09-06,Plumas,063,18699,1130,1068,19,1087,5
2021-09-06,Riverside,065,2383286,339087,333052,15664,348716,4666
2021-09-06,Sacramento,067,1510023,142339,141730,3298,145028,1905
2021-09-06,San Benito,069,59416,6814,6777,137,6914,64
2021-09-06,San Bernardino,071,2135413,333017,329693,10360,340053,5398
2021-09-06,San Diego,073,3302833,344174,340222,20151,360373,3922
2021-09-06,San Francisco,075,870044,48800,48120,2078,50198,589
2021-09-06,San Joaquin,077,732212,90473,89293,4785,94078,1548
2021-09-06,San Luis Obispo,079,281455,26720,26183,1022,27205,286
2021-09-06,San Mateo,081,765935,50765,49859,756,50615,561
2021-09-06,Santa Barbara,083,443738,40715,39876,1420,41296,489
2021-09-06,Santa Clara,085,1922200,138000,136458,1062,137520,1807
2021-09-06,Santa Cruz,087,273765,18894,18615,964,19579,210
2021-09-06,Shasta,089,179085,16776,15985,2553,18538,226
2021-09-06,Sierra,091,2930,129,109,13,122,0
2021-09-06,Siskiyou,093,43540,2744,2595,888,3483,34
2021-09-06,Solano,095,438530,42727,41774,1075,42849,300
2021-09-06,Sonoma,097,501317,38354,37929,466,38395,358
2021-09-06,Stanislaus,099,539301,69235,68596,7796,76392,1074
2021-09-06,Sutter,101,95872,12407,12238,191,12429,138
2021-09-06,Tehama,103,63373,6680,6413,1042,7455,74
2021-09-06,Trinity,105,12862,664,515,179,694,6
2021-09-06,Tulare,107,460477,58680,57068,11908,68976,874
2021-09-06,Tuolumne,109,53932,5820,5697,61,5758,88
2021-09-06,Ventura,111,848112,92697,91132,4016,95148,1093
2021-09-06,Yolo,113,214977,17846,17576,878,18454,235
2021-09-06,Yuba,115,75493,8760,8584,186,8770,55
2021-09-05,Alameda,001,1643700,111496,110173,2572,112745,1301
2021-09-05,Alpine,003,1148,94,94,0,94,0
2021-09-05,Amador,005,37829,4746,4642,46,4688,53
2021-09-05,Butte,007,227075,17084,16504,2943,19447,218
2021-09-05,Calaveras,009,45235,3186,3106,21,3127,63
2021-09-05,Colusa,011,21464,2339,2305,509,2814,16
2021-09-05,Contra Costa,013,1133247,91971,90862,1845,92707,891
2021-09-05,Del Norte,015,27424,3187,3023,19,3042,24
2021-09-05,El Dorado,017,186661,14114,13827,1346,15173,119
2021-09-05,Fresno,019,978130,121858,119384,10887,130271,1828
2021-09-05,Glenn,021,27897,3008,2899,861,3760,20
2021-09-05,Humboldt,023,135768,7506,7312,307,7619,52
2021-09-05,Imperial,025,180216,30822,30548,2966,33514,751
2021-09-05,Inyo,027,18085,1589,1572,17,1589,39
2021-09-05,Kern,029,883053,112473,110073,16374,126447,1408
2021-09-05,Kings,031,150075,27733,26989,1512,28501,264
2021-09-05,Lake,033,64148,5722,5525,94,5619,78
2021-09-05,Lassen,035,31185,5946,5820,199,6019,21
2021-09-05,Los Angeles,037,10098052,1369722,1357748,51259,1409007,25465
2021-09-05,Madera,039,155013,19741,19155,1504,20659,249
2021-09-05,Marin,041,260295,16511,16342,374,16716,242
2021-09-05,Mariposa,043,17540,801,761,27,788,5
2021-09-05,Mendocino,045,87422,6218,5965,236,6201,61
2021-09-05,Merced,047,269075,36734,36243,1423,37666,513
2021-09-05,Modoc,049,8938,460,447,160,607,5
2021-09-05,Mono,051,14174,1440,1416,18,1434,3
2021-09-05,Monterey,053,433212,46562,45795,2461,48256,540
2021-09-05,Napa,055,140530,11924,11770,78,11848,90
2021-09-05,Nevada,057,99092,7954,7722,260,7982,82
2021-09-05,Orange,059,3164182,291575,287614,13685,301299,5274
2021-09-05,Placer,061,380077,32311,31487,2940,34427,337
2021-09-05,Plumas,063,18699,1123,1067,19,1086,5
2021-09-05,Riverside,065,2383286,338632,332604,15652,348256,4654
2021-09-05,Sacramento,067,1510023,141901,141276,3280,144556,1905
2021-09-05,San Benito,069,59416,6813,6764,137,6901,64
2021-09-05,San Bernardino,071,2135413,332636,329062,10345,339407,5392
2021-09-05,San Diego,073,3302833,343620,339427,20110,359537,3914
2021-09-05,San Francisco,075,870044,48722,48035,2073,50108,589
2021-09-05,San Joaquin,077,732212,90307,89121,4768,93889,1548
2021-09-05,San Luis Obispo,079,281455,26671,26098,1021,27119,285
2021-09-05,San Mateo,081,765935,50697,49809,752,50561,561
2021-09-05,Santa Barbara,083,443738,40648,39762,1418,41180,489
2021-09-05,Santa Clara,085,1922200,137790,136146,1060,137206,1807
2021-09-05,Santa Cruz,087,273765,18874,18588,962,19550,210
2021-09-05,Shasta,089,179085,16693,15960,2527,18487,226
2021-09-05,Sierra,091,2930,128,109,13,122,0
2021-09-05,Siskiyou,093,43540,2727,2585,874,3459,34
2021-09-05,Solano,095,438530,42632,41687,1070,42757,300
2021-09-05,Sonoma,097,501317,38269,37881,465,38346,358
2021-09-05,Stanislaus,099,539301,69096,68434,7771,76205,1074
2021-09-05,Sutter,101,95872,12377,12179,185,12364,138
2021-09-05,Tehama,103,63373,6654,6400,1036,7436,74
2021-09-05,Trinity,105,12862,658,505,178,683,6
2021-09-05,Tulare,107,460477,58511,56915,11864,68779,874
2021-09-05,Tuolumne,109,53932,5808,5688,61,5749,88
2021-09-05,Ventura,111,848112,92561,91004,4012,95016,1093
2021-09-05,Yolo,113,214977,17809,17557,872,18429,235
2021-09-05,Yuba,115,75493,8733,8521,184,8705,55
2021-09-04,Alameda,001,1643700,111372,109944,2565,112509,1301
2021-09-04,Alpine,003,1148,94,94,0,94,0
2021-09-04,Amador,005,37829,4728,4637,45,4682,53
2021-09-04,Butte,007,227075,17026,16403,2928,19331,218
2021-09-04,Calaveras,009,45235,3174,3087,20,3107,63
2021-09-04,Colusa,011,21464,2337,2301,509,2810,16
2021-09-04,Contra Costa,013,1133247,91854,90623,1842,92465,891
2021-09-04,Del Norte,015,27424,3176,2984,19,3003,24
2021-09-04,El Dorado,017,186661,14088,13782,1338,15120,119
2021-09-04,Fresno,019,978130,121662,119033,10866,129899,1828
2021-09-04,Glenn,021,27897,2998,2878,855,3733,20
2021-09-04,Humboldt,023,135768,7475,7298,301,7599,52
2021-09-04,Imperial,025,180216,30799,30526,2964,33490,751
2021-09-04,Inyo,027,18085,1587,1571,17,1588,39
2021-09-04,Kern,029,883053,112229,109751,16243,125994,1408
2021-09-04,Kings,031,150075,27646,26896,1506,28402,263
2021-09-04,Lake,033,64148,5704,5507,94,5601,78
2021-09-04,Lassen,035,31185,5931,5814,191,6005,21
2021-09-04,Los Angeles,037,10098052,1368773,1355634,51201,1406835,25454
2021-09-04,Madera,039,155013,19708,19112,1497,20609,249
2021-09-04,Marin,041,260295,16495,16319,373,16692,242
2021-09-04,Mariposa,043,17540,796,759,27,786,5
2021-09-04,Mendocino,045,87422,6182,5933,236,6169,61
2021-09-04,Merced,047,269075,36690,36083,1418,37501,513
2021-09-04,Modoc,049,8938,460,447,160,607,5
2021-09-04,Mono,051,14174,1437,1417,18,1435,3
2021-09-04,Monterey,053,433212,46531,45756,2457,48213,540
2021-09-04,Napa,055,140530,11899,11760,76,11836,90
2021-09-04,Nevada,057,99092,7939,7691,259,7950,82
2021-09-04,Orange,059,3164182,291312,287244,13664,300908,5274
2021-09-04,Placer,061,380077,32207,31374,2923,34297,337
2021-09-04,Plumas,063,18699,1115,1067,19,1086,5
2021-09-04,Riverside,065,2383286,338162,331958,15640,347598,4654
2021-09-04,Sacramento,067,1510023,141608,140735,3272,144007,1896
2021-09-04,San Benito,069,59416,6804,6758,137,6895,64
2021-09-04,San Bernardino,071,2135413,332304,328425,10331,338756,5393
2021-09-04,San Diego,073,3302833,343186,338748,20088,358836,3914
2021-09-04,San Francisco,075,870044,48647,47937,2064,50001,589
2021-09-04,San Joaquin,077,732212,90191,88846,4760,93606,1548
2021-09-04,San Luis Obispo,079,281455,26639,26020,1021,27041,285
2021-09-04,San Mateo,081,765935,50643,49721,752,50473,560
2021-09-04,Santa Barbara,083,443738,40582,39667,1416,41083,489
2021-09-04,Santa Clara,085,1922200,137604,135845,1057,136902,1806
2021-09-04,Santa Cruz,087,273765,18856,18579,958,19537,210
2021-09-04,Shasta,089,179085,16616,15924,2501,18425,226
2021-09-04,Sierra,091,2930,126,108,13,121,0
2021-09-04,Siskiyou,093,43540,2701,2563,863,3426,34
2021-09-04,Solano,095,438530,42559,41614,1068,42682,300
2021-09-04,Sonoma,097,501317,38236,37809,465,38274,358
2021-09-04,Stanislaus,099,539301,68948,68210,7746,75956,1074
2021-09-04,Sutter,101,95872,12336,12137,184,12321,138
2021-09-04,Tehama,103,63373,6629,6367,1018,7385,74
2021-09-04,Trinity,105,12862,656,497,178,675,6
2021-09-04,Tulare,107,460477,58403,56719,11821,68540,874
2021-09-04,Tuolumne,109,53932,5790,5667,59,5726,88
2021-09-04,Ventura,111,848112,92426,90904,4009,94913,1090
2021-09-04,Yolo,113,214977,17775,17522,868,18390,235
2021-09-04,Yuba,115,75493,8704,8475,183,8658,55
2021-09-03,Alameda,001,1643700,111217,109636,2562,112198,1301
2021-09-03,Alpine,003,1148,94,94,0,94,0
2021-09-03,Amador,005,37829,4706,4614,45,4659,53
2021-09-03,Butte,007,227075,16936,16259,2902,19161,215
2021-09-03,Calaveras,009,45235,3164,3069,20,3089,63
2021-09-03,Colusa,011,21464,2332,2295,508,2803,16
2021-09-03,Contra Costa,013,1133247,91702,90299,1839,92138,886
2021-09-03,Del Norte,015,27424,3148,2943,18,2961,24
2021-09-03,El Dorado,017,186661,14055,13710,1334,15044,119
2021-09-03,Fresno,019,978130,121327,118508,10844,129352,1822
2021-09-03,Glenn,021,27897,2989,2867,848,3715,20
2021-09-03,Humboldt,023,135768,7450,7194,296,7490,52
2021-09-03,Imperial,025,180216,30776,30475,2959,33434,751
2021-09-03,Inyo,027,18085,1582,1567,17,1584,39
2021-09-03,Kern,029,883053,112013,109296,16132,125428,1407
2021-09-03,Kings,031,150075,27562,26753,1503,28256,263
2021-09-03,Lake,033,64148,5684,5479,92,5571,78
2021-09-03,Lassen,035,31185,5914,5789,186,5975,21
2021-09-03,Los Angeles,037,10098052,1367441,1351185,51134,1402319,25384
2021-09-03,Madera,039,155013,19623,19021,1491,20512,247
2021-09-03,Marin,041,260295,16473,16293,372,16665,242
2021-09-03,Mariposa,043,17540,789,753,25,778,5
2021-09-03,Mendocino,045,87422,6147,5891,236,6127,61
2021-09-03,Merced,047,269075,36636,35941,1409,37350,512
2021-09-03,Modoc,049,8938,460,445,160,605,5
2021-09-03,Mono,051,14174,1436,1410,18,1428,3
2021-09-03,Monterey,053,433212,46493,45707,2453,48160,540
2021-09-03,Napa,055,140530,11878,11733,76,11809,89
2021-09-03,Nevada,057,99092,7905,7632,259,7891,82
2021-09-03,Orange,059,3164182,290994,286818,13637,300455,5253
2021-09-03,Placer,061,380077,32100,31238,2899,34137,335
2021-09-03,Plumas,063,18699,1104,1057,19,1076,5
2021-09-03,Riverside,065,2383286,337630,331011,15624,346635,4653
2021-09-03,Sacramento,067,1510023,141239,139982,3253,143235,1886
2021-09-03,San Benito,069,59416,6798,6746,137,6883,64
2021-09-03,San Bernardino,071,2135413,331890,327599,10320,337919,5381
2021-09-03,San Diego,073,3302833,342566,337627,20055,357682,3911
2021-09-03,San Francisco,075,870044,48571,47822,2058,49880,589
2021-09-03,San Joaquin,077,732212,90038,88366,4752,93118,1540
2021-09-03,San Luis Obispo,079,281455,26563,25917,1019,26936,283
2021-09-03,San Mateo,081,765935,50548,49617,750,50367,560
2021-09-03,Santa Barbara,083,443738,40515,39507,1413,40920,489
2021-09-03,Santa Clara,085,1922200,137402,135522,1053,136575,1801
2021-09-03,Santa Cruz,087,273765,18831,18532,958,19490,210
2021-09-03,Shasta,089,179085,16541,15778,2477,18255,226
2021-09-03,Sierra,091,2930,124,105,13,118,0
2021-09-03,Siskiyou,093,43540,2689,2529,850,3379,34
2021-09-03,Solano,095,438530,42463,41457,1065,42522,300
2021-09-03,Sonoma,097,501317,38173,37699,465,38164,358
2021-09-03,Stanislaus,099,539301,68774,67887,7720,75607,1074
2021-09-03,Sutter,101,95872,12297,12073,183,12256,139
2021-09-03,Tehama,103,63373,6590,6334,1011,7345,72
2021-09-03,Trinity,105,12862,654,490,173,663,6
2021-09-03,Tulare,107,460477,58276,56401,11768,68169,872
2021-09-03,Tuolumne,109,53932,5748,5630,59,5689,88
2021-09-03,Ventura,111,848112,92292,90742,4005,94747,1088
2021-09-03,Yolo,113,214977,17752,17446,862,18308,235
2021-09-03,Yuba,115,75493,8673,8412,183,8595,55
2021-09-02,Alameda,001,1643700,110959,109377,2559,111936,1301
2021-09-02,Alpine,003,1148,93,92,0,92,0
2021-09-02,Amador,005,37829,4690,4606,45,4651,53
2021-09-02,Butte,007,227075,16810,16154,2883,19037,215
2021-09-02,Calaveras,009,45235,3151,3042,20,3062,62
2021-09-02,Colusa,011,21464,2328,2290,508,2798,16
2021-09-02,Contra Costa,013,1133247,91519,90038,1828,91866,886
2021-09-02,Del Norte,015,27424,3117,2891,18,2909,24
2021-09-02,El Dorado,017,186661,13995,13641,1308,14949,119
2021-09-02,Fresno,019,978130,120839,117974,10789,128763,1804
2021-09-02,Glenn,021,27897,2973,2855,842,3697,20
2021-09-02,Humboldt,023,135768,7403,7141,285,7426,52
2021-09-02,Imperial,025,180216,30732,30449,2954,33403,751
2021-09-02,Inyo,027,18085,1577,1564,16,1580,39
2021-09-02,Kern,029,883053,111601,108930,15988,124918,1404
2021-09-02,Kings,031,150075,27469,26638,1493,28131,263
2021-09-02,Lake,033,64148,5654,5432,88,5520,78
2021-09-02,Lassen,035,31185,5900,5747,179,5926,21
2021-09-02,Los Angeles,037,10098052,1365581,1351105,51037,1402142,25382
2021-09-02,Madera,039,155013,19532,18937,1472,20409,247
2021-09-02,Marin,041,260295,16460,16244,370,16614,242
2021-09-02,Mariposa,043,17540,782,745,22,767,5
2021-09-02,Mendocino,045,87422,6105,5848,233,6081,61
2021-09-02,Merced,047,269075,36473,35820,1402,37222,508
2021-09-02,Modoc,049,8938,460,437,160,597,5
2021-09-02,Mono,051,14174,1436,1409,18,1427,3
2021-09-02,Monterey,053,433212,46427,45648,2438,48086,539
2021-09-02,Napa,055,140530,11849,11684,76,11760,88
2021-09-02,Nevada,057,99092,7853,7575,258,7833,82
2021-09-02,Orange,059,3164182,290533,286326,13603,299929,5240
2021-09-02,Placer,061,380077,31962,31067,2870,33937,330
2021-09-02,Plumas,063,18699,1093,1045,18,1063,5
2021-09-02,Riverside,065,2383286,336915,330190,15599,345789,4644
2021-09-02,Sacramento,067,1510023,140656,139274,3214,142488,1882
2021-09-02,San Benito,069,59416,6793,6734,136,6870,64
2021-09-02,San Bernardino,071,2135413,331284,326940,10247,337187,5369
2021-09-02,San Diego,073,3302833,341600,336382,20002,356384,3909
2021-09-02,San Francisco,075,870044,48463,47674,2054,49728,587
2021-09-02,San Joaquin,077,732212,89754,88056,4728,92784,1540
2021-09-02,San Luis Obispo,079,281455,26478,25851,1014,26865,283
2021-09-02,San Mateo,081,765935,50449,49490,747,50237,558
2021-09-02,Santa Barbara,083,443738,40425,39386,1400,40786,486
2021-09-02,Santa Clara,085,1922200,137101,135216,1047,136263,1799
2021-09-02,Santa Cruz,087,273765,18797,18473,955,19428,210
2021-09-02,Shasta,089,179085,16403,15670,2448,18118,224
2021-09-02,Sierra,091,2930,124,105,13,118,0
2021-09-02,Siskiyou,093,43540,2668,2513,822,3335,34
2021-09-02,Solano,095,438530,42357,41293,1062,42355,294
2021-09-02,Sonoma,097,501317,38092,37558,465,38023,352
2021-09-02,Stanislaus,099,539301,68532,67576,7698,75274,1074
2021-09-02,Sutter,101,95872,12228,11995,179,12174,138
2021-09-02,Tehama,103,63373,6531,6265,992,7257,72
2021-09-02,Trinity,105,12862,650,484,171,655,6
2021-09-02,Tulare,107,460477,58046,56105,11715,67820,872
2021-09-02,Tuolumne,109,53932,5692,5578,59,5637,88
2021-09-02,Ventura,111,848112,92109,90610,4000,94610,1084
2021-09-02,Yolo,113,214977,17683,17357,851,18208,235
2021-09-02,Yuba,115,75493,8613,8363,183,8546,55
2021-09-01,Alameda,001,1643700,110690,109075,2553,111628,1299
2021-09-01,Alpine,003,1148,93,92,0,92,0
2021-09-01,Amador,005,37829,4674,4599,44,4643,53
2021-09-01,Butte,007,227075,16697,16046,2858,18904,215
2021-09-01,Calaveras,009,45235,3139,3023,20,3043,59
2021-09-01,Colusa,011,21464,2323,2281,507,2788,16
2021-09-01,Contra Costa,013,1133247,91283,89834,1821,91655,877
2021-09-01,Del Norte,015,27424,3084,2860,18,2878,24
2021-09-01,El Dorado,017,186661,13939,13577,1281,14858,119
2021-09-01,Fresno,019,978130,120348,117492,10720,128212,1800
2021-09-01,Glenn,021,27897,2948,2846,834,3680,20
2021-09-01,Humboldt,023,135768,7356,7090,278,7368,52
2021-09-01,Imperial,025,180216,30695,30393,2949,33342,750
2021-09-01,Inyo,027,18085,1573,1561,15,1576,39
2021-09-01,Kern,029,883053,111170,108449,15846,124295,1400
2021-09-01,Kings,031,150075,27356,26443,1482,27925,263
2021-09-01,Lake,033,64148,5612,5396,83,5479,77
2021-09-01,Lassen,035,31185,5878,5731,175,5906,21
2021-09-01,Los Angeles,037,10098052,1363318,1348589,50930,1399519,25341
2021-09-01,Madera,039,155013,19454,18852,1457,20309,247
2021-09-01,Marin,041,260295,16438,16224,365,16589,240
2021-09-01,Mariposa,043,17540,774,735,22,757,5
2021-09-01,Mendocino,045,87422,6062,5821,228,6049,59
2021-09-01,Merced,047,269075,36296,35686,1392,37078,500
2021-09-01,Modoc,049,8938,454,436,158,594,5
2021-09-01,Mono,051,14174,1436,1400,18,1418,3
2021-09-01,Monterey,053,433212,46347,45590,2423,48013,539
2021-09-01,Napa,055,140530,11816,11653,76,11729,88
2021-09-01,Nevada,057,99092,7800,7508,257,7765,82
2021-09-01,Orange,059,3164182,290060,285840,13565,299405,5233
2021-09-01,Placer,061,380077,31807,30902,2856,33758,330
2021-09-01,Plumas,063,18699,1085,1033,18,1051,5
2021-09-01,Riverside,065,2383286,336099,329388,15569,344957,4634
2021-09-01,Sacramento,067,1510023,140047,138499,3168,141667,1875
2021-09-01,San Benito,069,59416,6776,6716,136,6852,64
2021-09-01,San Bernardino,071,2135413,330633,326250,10218,336468,5364
2021-09-01,San Diego,073,3302833,340570,335302,19946,355248,3908
2021-09-01,San Francisco,075,870044,48354,47538,2047,49585,584
2021-09-01,San Joaquin,077,732212,89432,87640,4705,92345,1540
2021-09-01,San Luis Obispo,079,281455,26382,25691,1009,26700,283
2021-09-01,San Mateo,081,765935,50329,49394,741,50135,558
2021-09-01,Santa Barbara,083,443738,40308,39263,1384,40647,483
2021-09-01,Santa Clara,085,1922200,136833,134855,1040,135895,1796
2021-09-01,Santa Cruz,087,273765,18750,18453,953,19406,210
2021-09-01,Shasta,089,179085,16271,15552,2407,17959,221
2021-09-01,Sierra,091,2930,123,98,13,111,0
2021-09-01,Siskiyou,093,43540,2638,2482,802,3284,34
2021-09-01,Solano,095,438530,42206,41194,1056,42250,293
2021-09-01,Sonoma,097,501317,37997,37454,464,37918,352
2021-09-01,Stanislaus,099,539301,68245,67287,7667,74954,1075
2021-09-01,Sutter,101,95872,12164,11945,172,12117,136
2021-09-01,Tehama,103,63373,6497,6228,975,7203,72
2021-09-01,Trinity,105,12862,649,482,168,650,5
2021-09-01,Tulare,107,460477,57763,55768,11678,67446,870
2021-09-01,Tuolumne,109,53932,5653,5553,59,5612,88
2021-09-01,Ventura,111,848112,91894,90471,3984,94455,1089
2021-09-01,Yolo,113,214977,17627,17264,845,18109,235
2021-09-01,Yuba,115,75493,8551,8308,183,8491,55
2021-08-31,Alameda,001,1643700,110397,108837,2546,111383,1297
2021-08-31,Alpine,003,1148,91,92,0,92,0
2021-08-31,Amador,005,37829,4653,4555,44,4599,53
2021-08-31,Butte,007,227075,16555,15896,2817,18713,216
2021-08-31,Calaveras,009,45235,3099,3008,20,3028,59
2021-08-31,Colusa,011,21464,2321,2275,505,2780,16
2021-08-31,Contra Costa,013,1133247,90987,89546,1809,91355,871
2021-08-31,Del Norte,015,27424,3048,2830,18,2848,19
2021-08-31,El Dorado,017,186661,13869,13539,1264,14803,119
2021-08-31,Fresno,019,978130,119773,117155,10640,127795,1801
2021-08-31,Glenn,021,27897,2932,2829,823,3652,20
2021-08-31,Humboldt,023,135768,7281,7030,265,7295,52
2021-08-31,Imperial,025,180216,30658,30348,2941,33289,750
2021-08-31,Inyo,027,18085,1569,1550,15,1565,39
2021-08-31,Kern,029,883053,110668,108151,15667,123818,1393
2021-08-31,Kings,031,150075,27214,26405,1468,27873,260
2021-08-31,Lake,033,64148,5568,5359,80,5439,74
2021-08-31,Lassen,035,31185,5852,5702,172,5874,21
2021-08-31,Los Angeles,037,10098052,1360730,1346686,50850,1397536,25303
2021-08-31,Madera,039,155013,19364,18811,1439,20250,247
2021-08-31,Marin,041,260295,16409,16215,362,16577,240
2021-08-31,Mariposa,043,17540,766,732,22,754,5
2021-08-31,Mendocino,045,87422,6020,5777,226,6003,59
2021-08-31,Merced,047,269075,36126,35512,1387,36899,498
2021-08-31,Modoc,049,8938,453,436,158,594,5
2021-08-31,Mono,051,14174,1424,1398,18,1416,3
2021-08-31,Monterey,053,433212,46263,45550,2410,47960,539
2021-08-31,Napa,055,140530,11769,11618,76,11694,88
2021-08-31,Nevada,057,99092,7733,7460,257,7717,82
2021-08-31,Orange,059,3164182,289461,285310,13531,298841,5229
2021-08-31,Placer,061,380077,31618,30745,2818,33563,325
2021-08-31,Plumas,063,18699,1081,1018,17,1035,5
2021-08-31,Riverside,065,2383286,335125,328556,15536,344092,4627
2021-08-31,Sacramento,067,1510023,139362,137879,3136,141015,1863
2021-08-31,San Benito,069,59416,6764,6694,134,6828,64
2021-08-31,San Bernardino,071,2135413,329885,325446,10198,335644,5350
2021-08-31,San Diego,073,3302833,339311,334377,19888,354265,3888
2021-08-31,San Francisco,075,870044,48204,47440,2036,49476,581
2021-08-31,San Joaquin,077,732212,88987,87365,4690,92055,1540
2021-08-31,San Luis Obispo,079,281455,26259,25518,1005,26523,282
2021-08-31,San Mateo,081,765935,50217,49299,741,50040,556
2021-08-31,Santa Barbara,083,443738,40157,39091,1378,40469,481
2021-08-31,Santa Clara,085,1922200,136483,134637,1033,135670,1793
2021-08-31,Santa Cruz,087,273765,18711,18419,950,19369,210
2021-08-31,Shasta,089,179085,16119,15368,2380,17748,220
2021-08-31,Sierra,091,2930,120,95,13,108,0
2021-08-31,Siskiyou,093,43540,2618,2435,786,3221,33
2021-08-31,Solano,095,438530,42067,41067,1049,42116,289
2021-08-31,Sonoma,097,501317,37901,37379,462,37841,352
2021-08-31,Stanislaus,099,539301,67890,67004,7632,74636,1075
2021-08-31,Sutter,101,95872,12099,11901,168,12069,136
2021-08-31,Tehama,103,63373,6437,6169,944,7113,72
2021-08-31,Trinity,105,12862,643,480,168,648,3
2021-08-31,Tulare,107,460477,57430,55567,11606,67173,870
2021-08-31,Tuolumne,109,53932,5617,5516,59,5575,88
2021-08-31,Ventura,111,848112,91675,90292,3972,94264,1081
2021-08-31,Yolo,113,214977,17547,17205,836,18041,234
2021-08-31,Yuba,115,75493,8497,8253,183,8436,54
2021-08-30,Alameda,001,1643700,110073,107734,2535,110269,1296
2021-08-30,Alpine,003,1148,91,92,0,92,0
2021-08-30,Amador,005,37829,4642,4507,44,4551,53
2021-08-30,Butte,007,227075,16404,15719,2784,18503,214
2021-08-30,Calaveras,009,45235,3084,2975,20,2995,59
2021-08-30,Colusa,011,21464,2312,2271,502,2773,16
2021-08-30,Contra Costa,013,1133247,90728,87679,1799,89478,872
2021-08-30,Del Norte,015,27424,3006,2796,17,2813,11
2021-08-30,El Dorado,017,186661,13800,13217,1247,14464,119
2021-08-30,Fresno,019,978130,119200,115867,10568,126435,1790
2021-08-30,Glenn,021,27897,2921,2804,817,3621,20
2021-08-30,Humboldt,023,135768,7227,6930,259,7189,52
2021-08-30,Imperial,025,180216,30620,30311,2936,33247,750
2021-08-30,Inyo,027,18085,1564,1544,15,1559,39
2021-08-30,Kern,029,883053,110189,107615,15502,123117,1389
2021-08-30,Kings,031,150075,27098,26236,1453,27689,259
2021-08-30,Lake,033,64148,5533,5323,77,5400,74
2021-08-30,Lassen,035,31185,5830,5667,166,5833,21
2021-08-30,Los Angeles,037,10098052,1358270,1344949,50764,1395713,25269
2021-08-30,Madera,039,155013,19282,18622,1419,20041,247
2021-08-30,Marin,041,260295,16378,16160,362,16522,240
2021-08-30,Mariposa,043,17540,760,715,21,736,5
2021-08-30,Mendocino,045,87422,5986,5721,222,5943,55
2021-08-30,Merced,047,269075,35998,35335,1383,36718,497
2021-08-30,Modoc,049,8938,451,436,157,593,5
2021-08-30,Mono,051,14174,1423,1390,18,1408,3
2021-08-30,Monterey,053,433212,46201,45463,2393,47856,539
2021-08-30,Napa,055,140530,11720,11579,74,11653,87
2021-08-30,Nevada,057,99092,7674,7356,254,7610,82
2021-08-30,Orange,059,3164182,288879,284750,13482,298232,5223
2021-08-30,Placer,061,380077,31453,29825,2795,32620,319
2021-08-30,Plumas,063,18699,1064,998,17,1015,5
2021-08-30,Riverside,065,2383286,334228,327593,15505,343098,4623
2021-08-30,Sacramento,067,1510023,138705,134571,3090,137661,1847
2021-08-30,San Benito,069,59416,6755,6663,134,6797,64
2021-08-30,San Bernardino,071,2135413,329208,324870,10168,335038,5348
2021-08-30,San Diego,073,3302833,338040,333011,19808,352819,3885
2021-08-30,San Francisco,075,870044,48065,46966,2022,48988,581
2021-08-30,San Joaquin,077,732212,88656,86203,4669,90872,1528
2021-08-30,San Luis Obispo,079,281455,26134,25422,998,26420,280
2021-08-30,San Mateo,081,765935,50091,48839,735,49574,554
2021-08-30,Santa Barbara,083,443738,40006,38998,1373,40371,481
2021-08-30,Santa Clara,085,1922200,136162,133281,1026,134307,1789
2021-08-30,Santa Cruz,087,273765,18657,18326,946,19272,210
2021-08-30,Shasta,089,179085,15990,15238,2338,17576,217
2021-08-30,Sierra,091,2930,118,91,13,104,0
2021-08-30,Siskiyou,093,43540,2605,2411,775,3186,33
2021-08-30,Solano,095,438530,41906,39986,1045,41031,290
2021-08-30,Sonoma,097,501317,37795,36764,462,37226,352
2021-08-30,Stanislaus,099,539301,67551,66173,7601,73774,1074
2021-08-30,Sutter,101,95872,12029,11791,161,11952,136
2021-08-30,Tehama,103,63373,6358,6085,920,7005,71
2021-08-30,Trinity,105,12862,632,468,165,633,3
2021-08-30,Tulare,107,460477,57118,55140,11530,66670,870
2021-08-30,Tuolumne,109,53932,5571,5492,59,5551,74
2021-08-30,Ventura,111,848112,91459,90149,3960,94109,1082
2021-08-30,Yolo,113,214977,17485,17071,832,17903,231
2021-08-30,Yuba,115,75493,8423,8129,182,8311,54
2021-08-29,Alameda,001,1643700,109729,107494,2523,110017,1296
2021-08-29,Alpine,003,1148,91,92,0,92,0
2021-08-29,Amador,005,37829,4628,4501,44,4545,53
2021-08-29,Butte,007,227075,16234,15602,2747,18349,214
2021-08-29,Calaveras,009,45235,3051,2970,20,2990,59
2021-08-29,Colusa,011,21464,2305,2260,496,2756,16
2021-08-29,Contra Costa,013,1133247,90431,87439,1794,89233,872
2021-08-29,Del Norte,015,27424,2963,2752,17,2769,11
2021-08-29,El Dorado,017,186661,13745,13166,1236,14402,119
2021-08-29,Fresno,019,978130,118603,115502,10497,125999,1790
2021-08-29,Glenn,021,27897,2903,2778,810,3588,20
2021-08-29,Humboldt,023,135768,7183,6922,244,7166,52
2021-08-29,Imperial,025,180216,30559,30293,2925,33218,750
2021-08-29,Inyo,027,18085,1554,1543,14,1557,39
2021-08-29,Kern,029,883053,109738,107324,15332,122656,1389
2021-08-29,Kings,031,150075,26945,26143,1438,27581,259
2021-08-29,Lake,033,64148,5493,5293,67,5360,74
2021-08-29,Lassen,035,31185,5807,5666,162,5828,21
2021-08-29,Los Angeles,037,10098052,1355511,1342541,50652,1393193,25263
2021-08-29,Madera,039,155013,19195,18594,1403,19997,247
2021-08-29,Marin,041,260295,16347,16134,360,16494,240
2021-08-29,Mariposa,043,17540,754,709,19,728,5
2021-08-29,Mendocino,045,87422,5928,5689,209,5898,55
2021-08-29,Merced,047,269075,35759,35250,1371,36621,497
2021-08-29,Modoc,049,8938,448,436,157,593,5
2021-08-29,Mono,051,14174,1416,1387,18,1405,3
2021-08-29,Monterey,053,433212,46095,45424,2369,47793,539
2021-08-29,Napa,055,140530,11689,11552,74,11626,87
2021-08-29,Nevada,057,99092,7617,7294,253,7547,82
2021-08-29,Orange,059,3164182,288252,284432,13439,297871,5223
2021-08-29,Placer,061,380077,31280,29674,2754,32428,319
2021-08-29,Plumas,063,18699,1053,996,17,1013,5
2021-08-29,Riverside,065,2383286,333371,326987,15484,342471,4623
2021-08-29,Sacramento,067,1510023,137952,133981,3041,137022,1843
2021-08-29,San Benito,069,59416,6730,6646,134,6780,64
2021-08-29,San Bernardino,071,2135413,328421,324266,10134,334400,5347
2021-08-29,San Diego,073,3302833,336934,332014,19712,351726,3880
2021-08-29,San Francisco,075,870044,47930,46885,2010,48895,581
2021-08-29,San Joaquin,077,732212,88209,85922,4648,90570,1528
2021-08-29,San Luis Obispo,079,281455,25936,25288,990,26278,280
2021-08-29,San Mateo,081,765935,49978,48737,730,49467,554
2021-08-29,Santa Barbara,083,443738,39840,38900,1369,40269,481
2021-08-29,Santa Clara,085,1922200,135809,132979,1020,133999,1789
2021-08-29,Santa Cruz,087,273765,18609,18285,944,19229,210
2021-08-29,Shasta,089,179085,15836,15198,2311,17509,217
2021-08-29,Sierra,091,2930,116,91,13,104,0
2021-08-29,Siskiyou,093,43540,2558,2407,755,3162,33
2021-08-29,Solano,095,438530,41752,39887,1038,40925,290
2021-08-29,Sonoma,097,501317,37659,36650,458,37108,352
2021-08-29,Stanislaus,099,539301,67206,65956,7565,73521,1074
2021-08-29,Sutter,101,95872,11970,11719,154,11873,136
2021-08-29,Tehama,103,63373,6287,6040,897,6937,71
2021-08-29,Trinity,105,12862,629,468,161,629,3
2021-08-29,Tulare,107,460477,56785,54974,11446,66420,870
2021-08-29,Tuolumne,109,53932,5546,5478,58,5536,74
2021-08-29,Ventura,111,848112,91201,90114,3951,94065,1082
2021-08-29,Yolo,113,214977,17386,17015,820,17835,231
2021-08-29,Yuba,115,75493,8359,8042,182,8224,54
2021-08-28,Alameda,001,1643700,109563,107007,2514,109521,1296
2021-08-28,Alpine,003,1148,91,92,0,92,0
2021-08-28,Amador,005,37829,4609,4484,43,4527,53
2021-08-28,Butte,007,227075,16175,15487,2719,18206,214
2021-08-28,Calaveras,009,45235,3041,2926,20,2946,59
2021-08-28,Colusa,011,21464,2301,2252,494,2746,16
2021-08-28,Contra Costa,013,1133247,90219,86938,1791,88729,872
2021-08-28,Del Norte,015,27424,2936,2734,16,2750,11
2021-08-28,El Dorado,017,186661,13705,13089,1230,14319,119
2021-08-28,Fresno,019,978130,118362,115079,10466,125545,1792
2021-08-28,Glenn,021,27897,2894,2773,803,3576,20
2021-08-28,Humboldt,023,135768,7148,6887,239,7126,52
2021-08-28,Imperial,025,180216,30532,30260,2922,33182,750
2021-08-28,Inyo,027,18085,1552,1539,14,1553,39
2021-08-28,Kern,029,883053,109500,107012,15190,122202,1389
2021-08-28,Kings,031,150075,26878,26059,1435,27494,257
2021-08-28,Lake,033,64148,5470,5267,63,5330,74
2021-08-28,Lassen,035,31185,5792,5665,161,5826,21
2021-08-28,Los Angeles,037,10098052,1354302,1337097,50579,1387676,25234
2021-08-28,Madera,039,155013,19144,18553,1389,19942,247
2021-08-28,Marin,041,260295,16332,16106,360,16466,240
2021-08-28,Mariposa,043,17540,752,704,19,723,5
2021-08-28,Mendocino,045,87422,5903,5658,209,5867,55
2021-08-28,Merced,047,269075,35707,35108,1368,36476,497
2021-08-28,Modoc,049,8938,448,436,156,592,5
2021-08-28,Mono,051,14174,1413,1385,18,1403,3
2021-08-28,Monterey,053,433212,46053,45394,2364,47758,539
2021-08-28,Napa,055,140530,11666,11512,73,11585,88
2021-08-28,Nevada,057,99092,7593,7238,251,7489,82
2021-08-28,Orange,059,3164182,287894,283953,13390,297343,5222
2021-08-28,Placer,061,380077,31171,29428,2741,32169,319
2021-08-28,Plumas,063,18699,1046,991,17,1008,5
2021-08-28,Riverside,065,2383286,332783,326222,15474,341696,4623
2021-08-28,Sacramento,067,1510023,137560,132985,3025,136010,1844
2021-08-28,San Benito,069,59416,6723,6636,134,6770,64
2021-08-28,San Bernardino,071,2135413,327973,323672,10126,333798,5348
2021-08-28,San Diego,073,3302833,336350,331330,19676,351006,3880
2021-08-28,San Francisco,075,870044,47858,46654,2003,48657,581
2021-08-28,San Joaquin,077,732212,88040,85481,4639,90120,1527
2021-08-28,San Luis Obispo,079,281455,25869,25138,985,26123,280
2021-08-28,San Mateo,081,765935,49904,48575,726,49301,554
2021-08-28,Santa Barbara,083,443738,39769,38780,1368,40148,481
2021-08-28,Santa Clara,085,1922200,135602,132488,1018,133506,1789
2021-08-28,Santa Cruz,087,273765,18593,18240,941,19181,210
2021-08-28,Shasta,089,179085,15733,15147,2292,17439,217
2021-08-28,Sierra,091,2930,112,91,13,104,0
2021-08-28,Siskiyou,093,43540,2550,2402,744,3146,33
2021-08-28,Solano,095,438530,41703,39610,1037,40647,290
2021-08-28,Sonoma,097,501317,37586,36466,456,36922,352
2021-08-28,Stanislaus,099,539301,67048,65670,7548,73218,1074
2021-08-28,Sutter,101,95872,11949,11669,153,11822,136
2021-08-28,Tehama,103,63373,6262,6004,884,6888,71
2021-08-28,Trinity,105,12862,625,463,160,623,3
2021-08-28,Tulare,107,460477,56655,54746,11404,66150,870
2021-08-28,Tuolumne,109,53932,5530,5469,58,5527,74
2021-08-28,Ventura,111,848112,91083,89934,3949,93883,1081
2021-08-28,Yolo,113,214977,17350,16907,813,17720,231
2021-08-28,Yuba,115,75493,8328,7985,181,8166,55
2021-08-27,Alameda,001,1643700,109355,106622,2511,109133,1296
2021-08-27,Alpine,003,1148,91,92,0,92,0
2021-08-27,Amador,005,37829,4593,4458,42,4500,53
2021-08-27,Butte,007,227075,16095,15277,2700,17977,214
2021-08-27,Calaveras,009,45235,3027,2903,20,2923,59
2021-08-27,Colusa,011,21464,2295,2240,492,2732,16
2021-08-27,Contra Costa,013,1133247,90021,86386,1788,88174,872
2021-08-27,Del Norte,015,27424,2904,2695,16,2711,11
2021-08-27,El Dorado,017,186661,13666,12968,1226,14194,119
2021-08-27,Fresno,019,978130,117928,114481,10442,124923,1774
2021-08-27,Glenn,021,27897,2876,2754,794,3548,20
2021-08-27,Humboldt,023,135768,7115,6782,236,7018,52
2021-08-27,Imperial,025,180216,30512,30201,2919,33120,750
2021-08-27,Inyo,027,18085,1551,1529,14,1543,39
2021-08-27,Kern,029,883053,109206,106570,15080,121650,1385
2021-08-27,Kings,031,150075,26799,25957,1433,27390,257
2021-08-27,Lake,033,64148,5445,5228,62,5290,74
2021-08-27,Lassen,035,31185,5776,5646,156,5802,21
2021-08-27,Los Angeles,037,10098052,1352778,1337006,50512,1387518,25230
2021-08-27,Madera,039,155013,19088,18476,1376,19852,247
2021-08-27,Marin,041,260295,16316,16055,358,16413,240
2021-08-27,Mariposa,043,17540,746,690,19,709,5
2021-08-27,Mendocino,045,87422,5872,5602,208,5810,55
2021-08-27,Merced,047,269075,35653,34906,1359,36265,495
2021-08-27,Modoc,049,8938,448,434,156,590,5
2021-08-27,Mono,051,14174,1408,1385,18,1403,3
2021-08-27,Monterey,053,433212,46004,45337,2356,47693,539
2021-08-27,Napa,055,140530,11632,11460,73,11533,87
2021-08-27,Nevada,057,99092,7553,7169,249,7418,82
2021-08-27,Orange,059,3164182,287533,283407,13351,296758,5206
2021-08-27,Placer,061,380077,31041,29157,2721,31878,320
2021-08-27,Plumas,063,18699,1040,984,17,1001,5
2021-08-27,Riverside,065,2383286,332265,325379,15459,340838,4622
2021-08-27,Sacramento,067,1510023,137125,131921,3012,134933,1838
2021-08-27,San Benito,069,59416,6717,6622,134,6756,64
2021-08-27,San Bernardino,071,2135413,327449,322893,10108,333001,5342
2021-08-27,San Diego,073,3302833,335569,330162,19622,349784,3877
2021-08-27,San Francisco,075,870044,47782,46456,1985,48441,581
2021-08-27,San Joaquin,077,732212,87857,84949,4620,89569,1524
2021-08-27,San Luis Obispo,079,281455,25821,24952,982,25934,280
2021-08-27,San Mateo,081,765935,49829,48424,722,49146,553
2021-08-27,Santa Barbara,083,443738,39677,38675,1366,40041,480
2021-08-27,Santa Clara,085,1922200,135372,132011,1015,133026,1783
2021-08-27,Santa Cruz,087,273765,18554,18163,937,19100,210
2021-08-27,Shasta,089,179085,15653,14996,2276,17272,217
2021-08-27,Sierra,091,2930,111,91,13,104,0
2021-08-27,Siskiyou,093,43540,2535,2358,730,3088,33
2021-08-27,Solano,095,438530,41589,39347,1033,40380,287
2021-08-27,Sonoma,097,501317,37514,36326,455,36781,342
2021-08-27,Stanislaus,099,539301,66838,65167,7510,72677,1061
2021-08-27,Sutter,101,95872,11903,11590,151,11741,135
2021-08-27,Tehama,103,63373,6229,5964,869,6833,71
2021-08-27,Trinity,105,12862,625,458,159,617,3
2021-08-27,Tulare,107,460477,56520,54443,11359,65802,870
2021-08-27,Tuolumne,109,53932,5498,5438,58,5496,74
2021-08-27,Ventura,111,848112,90954,89774,3945,93719,1076
2021-08-27,Yolo,113,214977,17307,16805,808,17613,231
2021-08-27,Yuba,115,75493,8271,7926,181,8107,54
2021-08-26,Alameda,001,1643700,109076,106146,2502,108648,1296
2021-08-26,Alpine,003,1148,91,92,0,92,0
2021-08-26,Amador,005,37829,4578,4442,41,4483,53
2021-08-26,Butte,007,227075,15962,15159,2665,17824,214
2021-08-26,Calaveras,009,45235,3016,2873,20,2893,59
2021-08-26,Colusa,011,21464,2288,2234,488,2722,16
2021-08-26,Contra Costa,013,1133247,89662,85808,1782,87590,866
2021-08-26,Del Norte,015,27424,2868,2625,16,2641,8
2021-08-26,El Dorado,017,186661,13597,12863,1212,14075,118
2021-08-26,Fresno,019,978130,117424,113854,10388,124242,1770
2021-08-26,Glenn,021,27897,2858,2740,785,3525,20
2021-08-26,Humboldt,023,135768,7057,6695,226,6921,53
2021-08-26,Imperial,025,180216,30463,30121,2911,33032,748
2021-08-26,Inyo,027,18085,1541,1521,13,1534,39
2021-08-26,Kern,029,883053,108778,106051,14937,120988,1380
2021-08-26,Kings,031,150075,26676,25838,1425,27263,260
2021-08-26,Lake,033,64148,5399,5196,59,5255,74
2021-08-26,Lassen,035,31185,5764,5626,154,5780,21
2021-08-26,Los Angeles,037,10098052,1350508,1334372,50416,1384788,25199
2021-08-26,Madera,039,155013,19018,18393,1363,19756,247
2021-08-26,Marin,041,260295,16287,15983,355,16338,240
2021-08-26,Mariposa,043,17540,736,677,19,696,5
2021-08-26,Mendocino,045,87422,5834,5533,203,5736,55
2021-08-26,Merced,047,269075,35486,34755,1338,36093,495
2021-08-26,Modoc,049,8938,448,433,156,589,5
2021-08-26,Mono,051,14174,1404,1385,18,1403,3
2021-08-26,Monterey,053,433212,45931,45265,2345,47610,539
2021-08-26,Napa,055,140530,11610,11394,72,11466,87
2021-08-26,Nevada,057,99092,7494,7086,246,7332,80
2021-08-26,Orange,059,3164182,287041,282814,13328,296142,5200
2021-08-26,Placer,061,380077,30872,28898,2695,31593,319
2021-08-26,Plumas,063,18699,1033,971,16,987,5
2021-08-26,Riverside,065,2383286,331473,324486,15438,339924,4615
2021-08-26,Sacramento,067,1510023,136592,130977,2971,133948,1827
2021-08-26,San Benito,069,59416,6707,6604,134,6738,64
2021-08-26,San Bernardino,071,2135413,326790,322100,10084,332184,5339
2021-08-26,San Diego,073,3302833,334543,328276,19556,347832,3869
2021-08-26,San Francisco,075,870044,47655,46288,1980,48268,581
2021-08-26,San Joaquin,077,732212,87479,84429,4597,89026,1513
2021-08-26,San Luis Obispo,079,281455,25672,24831,975,25806,278
2021-08-26,San Mateo,081,765935,49701,48263,720,48983,553
2021-08-26,Santa Barbara,083,443738,39593,38566,1365,39931,479
2021-08-26,Santa Clara,085,1922200,135046,131443,1011,132454,1782
2021-08-26,Santa Cruz,087,273765,18494,18072,935,19007,210
2021-08-26,Shasta,089,179085,15531,14891,2249,17140,217
2021-08-26,Sierra,091,2930,109,90,13,103,0
2021-08-26,Siskiyou,093,43540,2513,2342,716,3058,33
2021-08-26,Solano,095,438530,41440,39027,1025,40052,286
2021-08-26,Sonoma,097,501317,37425,36102,455,36557,337
2021-08-26,Stanislaus,099,539301,66541,64785,7469,72254,1061
2021-08-26,Sutter,101,95872,11843,11499,148,11647,135
2021-08-26,Tehama,103,63373,6171,5913,856,6769,68
2021-08-26,Trinity,105,12862,620,450,157,607,3
2021-08-26,Tulare,107,460477,56263,54157,11313,65470,870
2021-08-26,Tuolumne,109,53932,5478,5387,58,5445,74
2021-08-26,Ventura,111,848112,90768,89595,3936,93531,1080
2021-08-26,Yolo,113,214977,17242,16727,797,17524,231
2021-08-26,Yuba,115,75493,8198,7834,179,8013,54
2021-08-25,Alameda,001,1643700,108754,105636,2495,108131,1296
2021-08-25,Alpine,003,1148,91,92,0,92,0
2021-08-25,Amador,005,37829,4563,4415,41,4456,53
2021-08-25,Butte,007,227075,15856,15039,2623,17662,214
2021-08-25,Calaveras,009,45235,2997,2851,20,2871,59
2021-08-25,Colusa,011,21464,2281,2227,479,2706,16
2021-08-25,Contra Costa,013,1133247,89278,85322,1776,87098,863
2021-08-25,Del Norte,015,27424,2823,2573,16,2589,8
2021-08-25,El Dorado,017,186661,13538,12787,1196,13983,118
2021-08-25,Fresno,019,978130,116883,113384,10346,123730,1761
2021-08-25,Glenn,021,27897,2840,2728,770,3498,20
2021-08-25,Humboldt,023,135768,6988,6653,216,6869,52
2021-08-25,Imperial,025,180216,30426,30085,2905,32990,748
2021-08-25,Inyo,027,18085,1537,1518,13,1531,39
2021-08-25,Kern,029,883053,108347,105687,14781,120468,1379
2021-08-25,Kings,031,150075,26569,25676,1418,27094,258
2021-08-25,Lake,033,64148,5369,5163,56,5219,74
2021-08-25,Lassen,035,31185,5747,5583,153,5736,21
2021-08-25,Los Angeles,037,10098052,1347905,1331400,50318,1381718,25170
2021-08-25,Madera,039,155013,18954,18311,1340,19651,247
2021-08-25,Marin,041,260295,16265,15938,349,16287,240
2021-08-25,Mariposa,043,17540,730,676,19,695,5
2021-08-25,Mendocino,045,87422,5799,5486,197,5683,53
2021-08-25,Merced,047,269075,35354,34600,1325,35925,492
2021-08-25,Modoc,049,8938,448,433,156,589,5
2021-08-25,Mono,051,14174,1400,1382,18,1400,3
2021-08-25,Monterey,053,433212,45857,45196,2330,47526,539
2021-08-25,Napa,055,140530,11576,11348,71,11419,87
2021-08-25,Nevada,057,99092,7428,7000,245,7245,77
2021-08-25,Orange,059,3164182,286515,282061,13294,295355,5193
2021-08-25,Placer,061,380077,30696,28740,2662,31402,319
2021-08-25,Plumas,063,18699,1018,962,16,978,5
2021-08-25,Riverside,065,2383286,330628,323548,15416,338964,4610
2021-08-25,Sacramento,067,1510023,135912,130046,2932,132978,1827
2021-08-25,San Benito,069,59416,6686,6587,133,6720,64
2021-08-25,San Bernardino,071,2135413,326096,321228,10063,331291,5337
2021-08-25,San Diego,073,3302833,333275,327166,19471,346637,3859
2021-08-25,San Francisco,075,870044,47506,46107,1975,48082,578
2021-08-25,San Joaquin,077,732212,87094,84002,4581,88583,1510
2021-08-25,San Luis Obispo,079,281455,25480,24607,971,25578,276
2021-08-25,San Mateo,081,765935,49578,48153,717,48870,553
2021-08-25,Santa Barbara,083,443738,39464,38450,1365,39815,479
2021-08-25,Santa Clara,085,1922200,134677,130995,1008,132003,1783
2021-08-25,Santa Cruz,087,273765,18434,17987,932,18919,210
2021-08-25,Shasta,089,179085,15402,14752,2217,16969,217
2021-08-25,Sierra,091,2930,106,90,13,103,0
2021-08-25,Siskiyou,093,43540,2468,2322,697,3019,33
2021-08-25,Solano,095,438530,41269,38848,1013,39861,286
2021-08-25,Sonoma,097,501317,37301,35986,452,36438,336
2021-08-25,Stanislaus,099,539301,66260,64441,7437,71878,1061
2021-08-25,Sutter,101,95872,11775,11451,144,11595,134
2021-08-25,Tehama,103,63373,6112,5861,839,6700,68
2021-08-25,Trinity,105,12862,614,450,156,606,3
2021-08-25,Tulare,107,460477,55977,53877,11242,65119,866
2021-08-25,Tuolumne,109,53932,5452,5354,58,5412,74
2021-08-25,Ventura,111,848112,90584,89379,3922,93301,1068
2021-08-25,Yolo,113,214977,17177,16667,787,17454,231
2021-08-25,Yuba,115,75493,8132,7771,178,7949,54
2021-08-24,Alameda,001,1643700,108432,105319,2485,107804,1296
2021-08-24,Alpine,003,1148,91,92,0,92,0
2021-08-24,Amador,005,37829,4544,4380,41,4421,50
2021-08-24,Butte,007,227075,15701,14964,2589,17553,214
2021-08-24,Calaveras,009,45235,2958,2811,20,2831,59
2021-08-24,Colusa,011,21464,2273,2221,474,2695,16
2021-08-24,Contra Costa,013,1133247,88915,84963,1770,86733,857
2021-08-24,Del Norte,015,27424,2796,2543,16,2559,8
2021-08-24,El Dorado,017,186661,13461,12732,1180,13912,118
2021-08-24,Fresno,019,978130,116277,113024,10282,123306,1761
2021-08-24,Glenn,021,27897,2824,2717,763,3480,20
2021-08-24,Humboldt,023,135768,6925,6585,203,6788,52
2021-08-24,Imperial,025,180216,30365,30045,2899,32944,748
2021-08-24,Inyo,027,18085,1532,1512,13,1525,39
2021-08-24,Kern,029,883053,107883,105399,14613,120012,1375
2021-08-24,Kings,031,150075,26448,25629,1402,27031,258
2021-08-24,Lake,033,64148,5334,5135,56,5191,72
2021-08-24,Lassen,035,31185,5731,5576,151,5727,21
2021-08-24,Los Angeles,037,10098052,1345040,1328777,50208,1378985,25135
2021-08-24,Madera,039,155013,18878,18251,1323,19574,247
2021-08-24,Marin,041,260295,16229,15900,345,16245,240
2021-08-24,Mariposa,043,17540,723,670,19,689,5
2021-08-24,Mendocino,045,87422,5756,5416,190,5606,52
2021-08-24,Merced,047,269075,35186,34490,1314,35804,491
2021-08-24,Modoc,049,8938,448,432,156,588,5
2021-08-24,Mono,051,14174,1398,1382,18,1400,3
2021-08-24,Monterey,053,433212,45791,45126,2312,47438,539
2021-08-24,Napa,055,140530,11543,11299,70,11369,85
2021-08-24,Nevada,057,99092,7358,6981,243,7224,77
2021-08-24,Orange,059,3164182,285916,281461,13268,294729,5187
2021-08-24,Placer,061,380077,30493,28618,2623,31241,318
2021-08-24,Plumas,063,18699,1008,953,16,969,5
2021-08-24,Riverside,065,2383286,329755,322620,15385,338005,4605
2021-08-24,Sacramento,067,1510023,135228,129542,2884,132426,1812
2021-08-24,San Benito,069,59416,6673,6576,133,6709,64
2021-08-24,San Bernardino,071,2135413,325341,320300,10033,330333,5328
2021-08-24,San Diego,073,3302833,331830,325823,19364,345187,3851
2021-08-24,San Francisco,075,870044,47331,46010,1964,47974,574
2021-08-24,San Joaquin,077,732212,86654,83684,4543,88227,1508
2021-08-24,San Luis Obispo,079,281455,25302,24443,960,25403,274
2021-08-24,San Mateo,081,765935,49429,48050,715,48765,553
2021-08-24,Santa Barbara,083,443738,39333,38307,1364,39671,478
2021-08-24,Santa Clara,085,1922200,134253,130763,1004,131767,1779
2021-08-24,Santa Cruz,087,273765,18359,17928,926,18854,209
2021-08-24,Shasta,089,179085,15294,14664,2185,16849,217
2021-08-24,Sierra,091,2930,103,90,13,103,0
2021-08-24,Siskiyou,093,43540,2446,2294,682,2976,33
2021-08-24,Solano,095,438530,41060,38724,1001,39725,283
2021-08-24,Sonoma,097,501317,37172,35849,450,36299,336
2021-08-24,Stanislaus,099,539301,65933,64195,7383,71578,1058
2021-08-24,Sutter,101,95872,11708,11384,141,11525,134
2021-08-24,Tehama,103,63373,6066,5826,825,6651,67
2021-08-24,Trinity,105,12862,603,446,148,594,3
2021-08-24,Tulare,107,460477,55625,53702,11152,64854,856
2021-08-24,Tuolumne,109,53932,5421,5287,58,5345,74
2021-08-24,Ventura,111,848112,90400,89167,3911,93078,1068
2021-08-24,Yolo,113,214977,17101,16492,774,17266,231
2021-08-24,Yuba,115,75493,8049,7723,176,7899,54
2021-08-23,Alameda,001,1643700,108018,104922,2472,107394,1294
2021-08-23,Alpine,003,1148,91,91,0,91,0
2021-08-23,Amador,005,37829,4530,4369,41,4410,50
2021-08-23,Butte,007,227075,15556,14847,2554,17401,211
2021-08-23,Calaveras,009,45235,2930,2803,20,2823,59
2021-08-23,Colusa,011,21464,2269,2206,471,2677,16
2021-08-23,Contra Costa,013,1133247,88535,84651,1763,86414,857
2021-08-23,Del Norte,015,27424,2750,2499,16,2515,8
2021-08-23,El Dorado,017,186661,13358,12684,1158,13842,118
2021-08-23,Fresno,019,978130,115716,112445,10232,122677,1759
2021-08-23,Glenn,021,27897,2808,2696,753,3449,20
2021-08-23,Humboldt,023,135768,6852,6498,188,6686,52
2021-08-23,Imperial,025,180216,30314,30011,2896,32907,748
2021-08-23,Inyo,027,18085,1525,1509,13,1522,39
2021-08-23,Kern,029,883053,107428,104995,14458,119453,1375
2021-08-23,Kings,031,150075,26317,25465,1396,26861,257
2021-08-23,Lake,033,64148,5294,5099,54,5153,69
2021-08-23,Lassen,035,31185,5719,5562,151,5713,21
2021-08-23,Los Angeles,037,10098052,1342074,1326412,50076,1376488,25096
2021-08-23,Madera,039,155013,18792,18155,1308,19463,246
2021-08-23,Marin,041,260295,16181,15856,341,16197,240
2021-08-23,Mariposa,043,17540,712,645,19,664,5
2021-08-23,Mendocino,045,87422,5689,5374,183,5557,51
2021-08-23,Merced,047,269075,35004,34322,1309,35631,488
2021-08-23,Modoc,049,8938,445,431,155,586,6
2021-08-23,Mono,051,14174,1394,1384,18,1402,3
2021-08-23,Monterey,053,433212,45691,45047,2301,47348,538
2021-08-23,Napa,055,140530,11505,11257,70,11327,85
2021-08-23,Nevada,057,99092,7277,6930,241,7171,77
2021-08-23,Orange,059,3164182,285281,280891,13233,294124,5181
2021-08-23,Placer,061,380077,30293,28540,2585,31125,314
2021-08-23,Plumas,063,18699,1000,934,16,950,5
2021-08-23,Riverside,065,2383286,328842,321650,15359,337009,4598
2021-08-23,Sacramento,067,1510023,134441,128969,2817,131786,1807
2021-08-23,San Benito,069,59416,6655,6562,131,6693,64
2021-08-23,San Bernardino,071,2135413,324538,319577,9994,329571,5324
2021-08-23,San Diego,073,3302833,330389,324536,19248,343784,3848
2021-08-23,San Francisco,075,870044,47176,45945,1955,47900,573
2021-08-23,San Joaquin,077,732212,86221,83466,4509,87975,1499
2021-08-23,San Luis Obispo,079,281455,25120,24317,958,25275,274
2021-08-23,San Mateo,081,765935,49291,47935,712,48647,553
2021-08-23,Santa Barbara,083,443738,39154,38181,1362,39543,478
2021-08-23,Santa Clara,085,1922200,133853,130489,999,131488,1778
2021-08-23,Santa Cruz,087,273765,18302,17871,924,18795,209
2021-08-23,Shasta,089,179085,15168,14537,2146,16683,216
2021-08-23,Sierra,091,2930,103,90,13,103,0
2021-08-23,Siskiyou,093,43540,2425,2274,661,2935,33
2021-08-23,Solano,095,438530,40907,38612,992,39604,283
2021-08-23,Sonoma,097,501317,37052,35769,449,36218,336
2021-08-23,Stanislaus,099,539301,65600,63922,7344,71266,1058
2021-08-23,Sutter,101,95872,11619,11314,133,11447,133
2021-08-23,Tehama,103,63373,6012,5805,807,6612,67
2021-08-23,Trinity,105,12862,600,435,145,580,3
2021-08-23,Tulare,107,460477,55318,53370,11080,64450,856
2021-08-23,Tuolumne,109,53932,5379,5240,58,5298,73
2021-08-23,Ventura,111,848112,90181,88960,3899,92859,1063
2021-08-23,Yolo,113,214977,17013,16445,759,17204,226
2021-08-23,Yuba,115,75493,7978,7653,174,7827,54
2021-08-22,Alameda,001,1643700,107569,104539,2444,106983,1294
2021-08-22,Alpine,003,1148,91,91,0,91,0
2021-08-22,Amador,005,37829,4500,4349,41,4390,50
2021-08-22,Butte,007,227075,15417,14791,2518,17309,211
2021-08-22,Calaveras,009,45235,2893,2771,20,2791,59
2021-08-22,Colusa,011,21464,2262,2201,465,2666,16
2021-08-22,Contra Costa,013,1133247,87994,84371,1750,86121,857
2021-08-22,Del Norte,015,27424,2690,2455,16,2471,8
2021-08-22,El Dorado,017,186661,13254,12629,1138,13767,118
2021-08-22,Fresno,019,978130,115116,112057,10163,122220,1759
2021-08-22,Glenn,021,27897,2780,2678,740,3418,20
2021-08-22,Humboldt,023,135768,6774,6483,170,6653,52
2021-08-22,Imperial,025,180216,30256,29993,2891,32884,748
2021-08-22,Inyo,027,18085,1519,1505,13,1518,39
2021-08-22,Kern,029,883053,106903,104691,14304,118995,1375
2021-08-22,Kings,031,150075,26159,25391,1379,26770,257
2021-08-22,Lake,033,64148,5248,5069,51,5120,69
2021-08-22,Lassen,035,31185,5687,5556,147,5703,21
2021-08-22,Los Angeles,037,10098052,1338766,1324151,49941,1374092,25089
2021-08-22,Madera,039,155013,18673,18120,1293,19413,246
2021-08-22,Marin,041,260295,16129,15822,333,16155,240
2021-08-22,Mariposa,043,17540,702,638,17,655,5
2021-08-22,Mendocino,045,87422,5630,5336,183,5519,51
2021-08-22,Merced,047,269075,34801,34234,1296,35530,488
2021-08-22,Modoc,049,8938,443,431,155,586,6
2021-08-22,Mono,051,14174,1392,1378,18,1396,3
2021-08-22,Monterey,053,433212,45592,45017,2287,47304,538
2021-08-22,Napa,055,140530,11460,11231,70,11301,85
2021-08-22,Nevada,057,99092,7203,6864,239,7103,77
2021-08-22,Orange,059,3164182,284589,280390,13188,293578,5181
2021-08-22,Placer,061,380077,30084,28395,2549,30944,314
2021-08-22,Plumas,063,18699,981,923,15,938,5
2021-08-22,Riverside,065,2383286,327821,320836,15310,336146,4594
2021-08-22,Sacramento,067,1510023,133665,128231,2777,131008,1802
2021-08-22,San Benito,069,59416,6638,6550,131,6681,64
2021-08-22,San Bernardino,071,2135413,323571,318839,9959,328798,5324
2021-08-22,San Diego,073,3302833,329067,323591,19143,342734,3848
2021-08-22,San Francisco,075,870044,47010,45831,1945,47776,573
2021-08-22,San Joaquin,077,732212,85763,83121,4474,87595,1498
2021-08-22,San Luis Obispo,079,281455,24914,24250,951,25201,274
2021-08-22,San Mateo,081,765935,49115,47821,707,48528,553
2021-08-22,Santa Barbara,083,443738,38973,38099,1354,39453,478
2021-08-22,Santa Clara,085,1922200,133436,130189,992,131181,1778
2021-08-22,Santa Cruz,087,273765,18244,17823,919,18742,209
2021-08-22,Shasta,089,179085,15031,14478,2110,16588,216
2021-08-22,Sierra,091,2930,103,87,13,100,0
2021-08-22,Siskiyou,093,43540,2396,2261,643,2904,33
2021-08-22,Solano,095,438530,40708,38489,979,39468,283
2021-08-22,Sonoma,097,501317,36896,35676,446,36122,336
2021-08-22,Stanislaus,099,539301,65249,63683,7254,70937,1058
2021-08-22,Sutter,101,95872,11537,11251,129,11380,133
2021-08-22,Tehama,103,63373,5966,5791,788,6579,67
2021-08-22,Trinity,105,12862,593,433,143,576,3
2021-08-22,Tulare,107,460477,54998,53220,10995,64215,856
2021-08-22,Tuolumne,109,53932,5336,5214,58,5272,73
2021-08-22,Ventura,111,848112,89972,88791,3882,92673,1063
2021-08-22,Yolo,113,214977,16911,16374,750,17124,226
2021-08-22,Yuba,115,75493,7905,7626,173,7799,54
2021-08-21,Alameda,001,1643700,107364,104281,2437,106718,1294
2021-08-21,Alpine,003,1148,91,91,0,91,0
2021-08-21,Amador,005,37829,4490,4338,39,4377,50
2021-08-21,Butte,007,227075,15349,14714,2497,17211,211
2021-08-21,Calaveras,009,45235,2877,2744,20,2764,59
2021-08-21,Colusa,011,21464,2256,2192,461,2653,16
2021-08-21,Contra Costa,013,1133247,87735,84136,1742,85878,857
2021-08-21,Del Norte,015,27424,2667,2409,16,2425,8
2021-08-21,El Dorado,017,186661,13210,12590,1134,13724,118
2021-08-21,Fresno,019,978130,114916,111765,10150,121915,1759
2021-08-21,Glenn,021,27897,2767,2654,732,3386,20
2021-08-21,Humboldt,023,135768,6736,6446,164,6610,52
2021-08-21,Imperial,025,180216,30213,29976,2888,32864,748
2021-08-21,Inyo,027,18085,1516,1500,13,1513,39
2021-08-21,Kern,029,883053,106647,104443,14180,118623,1375
2021-08-21,Kings,031,150075,26088,25313,1374,26687,257
2021-08-21,Lake,033,64148,5228,5055,49,5104,69
2021-08-21,Lassen,035,31185,5673,5553,147,5700,21
2021-08-21,Los Angeles,037,10098052,1337466,1321308,49847,1371155,25080
2021-08-21,Madera,039,155013,18635,18067,1287,19354,246
2021-08-21,Marin,041,260295,16095,15775,331,16106,240
2021-08-21,Mariposa,043,17540,692,634,17,651,5
2021-08-21,Mendocino,045,87422,5584,5307,182,5489,51
2021-08-21,Merced,047,269075,34696,34148,1291,35439,488
2021-08-21,Modoc,049,8938,443,430,155,585,6
2021-08-21,Mono,051,14174,1392,1378,18,1396,3
2021-08-21,Monterey,053,433212,45545,44969,2280,47249,538
2021-08-21,Napa,055,140530,11425,11211,70,11281,85
2021-08-21,Nevada,057,99092,7159,6810,237,7047,77
2021-08-21,Orange,059,3164182,284137,279855,13154,293009,5181
2021-08-21,Placer,061,380077,29946,28289,2524,30813,314
2021-08-21,Plumas,063,18699,977,916,14,930,5
2021-08-21,Riverside,065,2383286,327240,320086,15297,335383,4594
2021-08-21,Sacramento,067,1510023,133170,127751,2765,130516,1809
2021-08-21,San Benito,069,59416,6628,6542,130,6672,64
2021-08-21,San Bernardino,071,2135413,323119,318293,9938,328231,5324
2021-08-21,San Diego,073,3302833,328411,322620,19094,341714,3848
2021-08-21,San Francisco,075,870044,46908,45637,1938,47575,573
2021-08-21,San Joaquin,077,732212,85546,82825,4460,87285,1498
2021-08-21,San Luis Obispo,079,281455,24856,24169,951,25120,273
2021-08-21,San Mateo,081,765935,49020,47685,707,48392,553
2021-08-21,Santa Barbara,083,443738,38891,37951,1350,39301,478
2021-08-21,Santa Clara,085,1922200,133171,129911,988,130899,1778
2021-08-21,Santa Cruz,087,273765,18207,17763,914,18677,209
2021-08-21,Shasta,089,179085,14957,14417,2096,16513,217
2021-08-21,Sierra,091,2930,98,85,13,98,0
2021-08-21,Siskiyou,093,43540,2382,2246,632,2878,33
2021-08-21,Solano,095,438530,40597,38423,969,39392,281
2021-08-21,Sonoma,097,501317,36809,35582,445,36027,336
2021-08-21,Stanislaus,099,539301,65067,63512,7236,70748,1058
2021-08-21,Sutter,101,95872,11492,11204,127,11331,133
2021-08-21,Tehama,103,63373,5941,5757,781,6538,67
2021-08-21,Trinity,105,12862,588,431,141,572,3
2021-08-21,Tulare,107,460477,54855,53045,10951,63996,857
2021-08-21,Tuolumne,109,53932,5305,5193,58,5251,73
2021-08-21,Ventura,111,848112,89828,88558,3867,92425,1063
2021-08-21,Yolo,113,214977,16864,16322,744,17066,226
2021-08-21,Yuba,115,75493,7859,7580,172,7752,54
2021-08-20,Alameda,001,1643700,107124,103812,2429,106241,1294
2021-08-20,Alpine,003,1148,91,91,0,91,0
2021-08-20,Amador,005,37829,4464,4323,39,4362,50
2021-08-20,Butte,007,227075,15276,14617,2476,17093,211
2021-08-20,Calaveras,009,45235,2856,2717,20,2737,59
2021-08-20,Colusa,011,21464,2251,2178,459,2637,16
2021-08-20,Contra Costa,013,1133247,87459,83721,1735,85456,857
2021-08-20,Del Norte,015,27424,2635,2316,16,2332,8
2021-08-20,El Dorado,017,186661,13172,12495,1126,13621,118
2021-08-20,Fresno,019,978130,114560,111315,10116,121431,1759
2021-08-20,Glenn,021,27897,2760,2642,722,3364,20
2021-08-20,Humboldt,023,135768,6684,6349,159,6508,52
2021-08-20,Imperial,025,180216,30190,29934,2888,32822,747
2021-08-20,Inyo,027,18085,1510,1495,13,1508,39
2021-08-20,Kern,029,883053,106363,104048,14052,118100,1373
2021-08-20,Kings,031,150075,26022,25241,1372,26613,256
2021-08-20,Lake,033,64148,5213,5024,46,5070,69
2021-08-20,Lassen,035,31185,5653,5539,147,5686,21
2021-08-20,Los Angeles,037,10098052,1335589,1317541,49744,1367285,25049
2021-08-20,Madera,039,155013,18586,18018,1272,19290,246
2021-08-20,Marin,041,260295,16077,15727,327,16054,240
2021-08-20,Mariposa,043,17540,687,630,17,647,5
2021-08-20,Mendocino,045,87422,5538,5241,181,5422,51
2021-08-20,Merced,047,269075,34632,34035,1281,35316,486
2021-08-20,Modoc,049,8938,443,429,155,584,6
2021-08-20,Mono,051,14174,1391,1368,18,1386,3
2021-08-20,Monterey,053,433212,45507,44890,2273,47163,538
2021-08-20,Napa,055,140530,11393,11152,70,11222,83
2021-08-20,Nevada,057,99092,7117,6753,231,6984,77
2021-08-20,Orange,059,3164182,283692,279193,13133,292326,5179
2021-08-20,Placer,061,380077,29851,28156,2495,30651,313
2021-08-20,Plumas,063,18699,967,908,14,922,5
2021-08-20,Riverside,065,2383286,326544,319072,15266,334338,4594
2021-08-20,Sacramento,067,1510023,132695,127226,2748,129974,1797
2021-08-20,San Benito,069,59416,6614,6508,130,6638,64
2021-08-20,San Bernardino,071,2135413,322506,317372,9909,327281,5322
2021-08-20,San Diego,073,3302833,327502,321102,19024,340126,3846
2021-08-20,San Francisco,075,870044,46811,45432,1923,47355,573
2021-08-20,San Joaquin,077,732212,85316,82419,4442,86861,1496
2021-08-20,San Luis Obispo,079,281455,24778,23986,947,24933,273
2021-08-20,San Mateo,081,765935,48907,47561,704,48265,551
2021-08-20,Santa Barbara,083,443738,38806,37794,1345,39139,477
2021-08-20,Santa Clara,085,1922200,132888,129510,983,130493,1774
2021-08-20,Santa Cruz,087,273765,18167,17701,911,18612,209
2021-08-20,Shasta,089,179085,14878,14277,2077,16354,215
2021-08-20,Sierra,091,2930,97,83,13,96,0
2021-08-20,Siskiyou,093,43540,2366,2226,627,2853,33
2021-08-20,Solano,095,438530,40457,38214,958,39172,277
2021-08-20,Sonoma,097,501317,36741,35416,444,35860,336
2021-08-20,Stanislaus,099,539301,64878,63219,7212,70431,1047
2021-08-20,Sutter,101,95872,11436,11136,126,11262,133
2021-08-20,Tehama,103,63373,5925,5730,769,6499,66
2021-08-20,Trinity,105,12862,588,422,140,562,3
2021-08-20,Tulare,107,460477,54725,52855,10908,63763,856
2021-08-20,Tuolumne,109,53932,5281,5153,57,5210,73
2021-08-20,Ventura,111,848112,89661,88285,3864,92149,1061
2021-08-20,Yolo,113,214977,16810,16236,738,16974,225
2021-08-20,Yuba,115,75493,7818,7523,172,7695,54
2021-08-19,Alameda,001,1643700,106673,103276,2407,105683,1294
2021-08-19,Alpine,003,1148,91,91,0,91,0
2021-08-19,Amador,005,37829,4457,4317,39,4356,50
2021-08-19,Butte,007,227075,15142,14518,2447,16965,211
2021-08-19,Calaveras,009,45235,2836,2673,20,2693,59
2021-08-19,Colusa,011,21464,2242,2167,454,2621,16
2021-08-19,Contra Costa,013,1133247,87021,83296,1721,85017,852
2021-08-19,Del Norte,015,27424,2585,2257,16,2273,8
2021-08-19,El Dorado,017,186661,13087,12410,1106,13516,118
2021-08-19,Fresno,019,978130,114121,110947,10062,121009,1759
2021-08-19,Glenn,021,27897,2742,2629,715,3344,20
2021-08-19,Humboldt,023,135768,6623,6246,153,6399,52
2021-08-19,Imperial,025,180216,30144,29865,2883,32748,747
2021-08-19,Inyo,027,18085,1503,1494,13,1507,39
2021-08-19,Kern,029,883053,105967,103731,13911,117642,1371
2021-08-19,Kings,031,150075,25891,25128,1360,26488,256
2021-08-19,Lake,033,64148,5183,4991,42,5033,69
2021-08-19,Lassen,035,31185,5635,5520,146,5666,21
2021-08-19,Los Angeles,037,10098052,1332609,1314453,49601,1364054,25020
2021-08-19,Madera,039,155013,18524,17947,1257,19204,246
2021-08-19,Marin,041,260295,16044,15672,324,15996,240
2021-08-19,Mariposa,043,17540,672,618,17,635,5
2021-08-19,Mendocino,045,87422,5505,5167,178,5345,51
2021-08-19,Merced,047,269075,34497,33851,1268,35119,486
2021-08-19,Modoc,049,8938,443,427,155,582,6
2021-08-19,Mono,051,14174,1387,1349,18,1367,3
2021-08-19,Monterey,053,433212,45434,44821,2263,47084,538
2021-08-19,Napa,055,140530,11341,11104,70,11174,83
2021-08-19,Nevada,057,99092,7053,6695,229,6924,77
2021-08-19,Orange,059,3164182,283057,278562,13082,291644,5172
2021-08-19,Placer,061,380077,29671,27953,2477,30430,313
2021-08-19,Plumas,063,18699,954,896,14,910,5
2021-08-19,Riverside,065,2383286,325516,318056,15237,333293,4589
2021-08-19,Sacramento,067,1510023,131991,126720,2712,129432,1801
2021-08-19,San Benito,069,59416,6596,6493,128,6621,64
2021-08-19,San Bernardino,071,2135413,321684,316398,9886,326284,5318
2021-08-19,San Diego,073,3302833,326251,319582,18927,338509,3839
2021-08-19,San Francisco,075,870044,46648,45220,1910,47130,571
2021-08-19,San Joaquin,077,732212,84871,82047,4391,86438,1491
2021-08-19,San Luis Obispo,079,281455,24640,23878,940,24818,271
2021-08-19,San Mateo,081,765935,48775,47431,702,48133,551
2021-08-19,Santa Barbara,083,443738,38661,37693,1342,39035,477
2021-08-19,Santa Clara,085,1922200,132498,129133,976,130109,1774
2021-08-19,Santa Cruz,087,273765,18104,17644,904,18548,209
2021-08-19,Shasta,089,179085,14754,14200,2054,16254,214
2021-08-19,Sierra,091,2930,93,83,13,96,0
2021-08-19,Siskiyou,093,43540,2351,2218,615,2833,33
2021-08-19,Solano,095,438530,40299,38025,946,38971,273
2021-08-19,Sonoma,097,501317,36653,35233,443,35676,336
2021-08-19,Stanislaus,099,539301,64536,62928,7168,70096,1047
2021-08-19,Sutter,101,95872,11351,11057,125,11182,133
2021-08-19,Tehama,103,63373,5889,5683,742,6425,66
2021-08-19,Trinity,105,12862,584,414,138,552,3
2021-08-19,Tulare,107,460477,54493,52685,10844,63529,856
2021-08-19,Tuolumne,109,53932,5245,5112,56,5168,64
2021-08-19,Ventura,111,848112,89458,88073,3849,91922,1060
2021-08-19,Yolo,113,214977,16725,16153,730,16883,225
2021-08-19,Yuba,115,75493,7765,7458,171,7629,51
2021-08-18,Alameda,001,1643700,106259,102696,2385,105081,1294
2021-08-18,Alpine,003,1148,90,91,0,91,0
2021-08-18,Amador,005,37829,4440,4279,38,4317,50
2021-08-18,Butte,007,227075,15032,14426,2421,16847,208
2021-08-18,Calaveras,009,45235,2799,2643,19,2662,59
2021-08-18,Colusa,011,21464,2234,2160,450,2610,16
2021-08-18,Contra Costa,013,1133247,86521,82767,1715,84482,851
2021-08-18,Del Norte,015,27424,2528,2219,16,2235,8
2021-08-18,El Dorado,017,186661,12997,12306,1092,13398,118
2021-08-18,Fresno,019,978130,113667,110523,9999,120522,1759
2021-08-18,Glenn,021,27897,2710,2623,707,3330,20
2021-08-18,Humboldt,023,135768,6551,6195,148,6343,52
2021-08-18,Imperial,025,180216,30111,29821,2881,32702,746
2021-08-18,Inyo,027,18085,1500,1494,13,1507,39
2021-08-18,Kern,029,883053,105620,103440,13816,117256,1370
2021-08-18,Kings,031,150075,25782,24984,1352,26336,256
2021-08-18,Lake,033,64148,5142,4957,41,4998,69
2021-08-18,Lassen,035,31185,5616,5506,145,5651,21
2021-08-18,Los Angeles,037,10098052,1329462,1311477,49467,1360944,24984
2021-08-18,Madera,039,155013,18464,17871,1244,19115,246
2021-08-18,Marin,041,260295,16006,15610,321,15931,240
2021-08-18,Mariposa,043,17540,659,615,16,631,5
2021-08-18,Mendocino,045,87422,5454,5129,176,5305,51
2021-08-18,Merced,047,269075,34332,33708,1257,34965,484
2021-08-18,Modoc,049,8938,443,427,154,581,6
2021-08-18,Mono,051,14174,1384,1344,18,1362,3
2021-08-18,Monterey,053,433212,45350,44735,2246,46981,532
2021-08-18,Napa,055,140530,11302,11060,69,11129,83
2021-08-18,Nevada,057,99092,6987,6633,229,6862,76
2021-08-18,Orange,059,3164182,282420,277795,13027,290822,5168
2021-08-18,Placer,061,380077,29445,27741,2449,30190,312
2021-08-18,Plumas,063,18699,945,874,14,888,5
2021-08-18,Riverside,065,2383286,324516,317107,15203,332310,4585
2021-08-18,Sacramento,067,1510023,131231,125599,2681,128280,1781
2021-08-18,San Benito,069,59416,6585,6481,127,6608,64
2021-08-18,San Bernardino,071,2135413,320883,315477,9867,325344,5304
2021-08-18,San Diego,073,3302833,324910,318152,18861,337013,3834
2021-08-18,San Francisco,075,870044,46445,44957,1900,46857,568
2021-08-18,San Joaquin,077,732212,84418,81601,4360,85961,1491
2021-08-18,San Luis Obispo,079,281455,24490,23726,927,24653,270
2021-08-18,San Mateo,081,765935,48610,47255,701,47956,551
2021-08-18,Santa Barbara,083,443738,38530,37599,1336,38935,475
2021-08-18,Santa Clara,085,1922200,132135,128563,973,129536,1773
2021-08-18,Santa Cruz,087,273765,18049,17566,900,18466,209
2021-08-18,Shasta,089,179085,14655,14087,2035,16122,213
2021-08-18,Sierra,091,2930,92,83,13,96,0
2021-08-18,Siskiyou,093,43540,2322,2204,603,2807,33
2021-08-18,Solano,095,438530,40093,37812,931,38743,271
2021-08-18,Sonoma,097,501317,36509,35063,442,35505,333
2021-08-18,Stanislaus,099,539301,64205,62613,7124,69737,1047
2021-08-18,Sutter,101,95872,11279,11004,120,11124,130
2021-08-18,Tehama,103,63373,5854,5653,732,6385,66
2021-08-18,Trinity,105,12862,577,409,135,544,3
2021-08-18,Tulare,107,460477,54253,52486,10775,63261,856
2021-08-18,Tuolumne,109,53932,5209,5081,54,5135,64
2021-08-18,Ventura,111,848112,89226,87835,3839,91674,1055
2021-08-18,Yolo,113,214977,16642,16047,711,16758,225
2021-08-18,Yuba,115,75493,7700,7391,171,7562,51
2021-08-17,Alameda,001,1643700,105859,102379,2370,104749,1290
2021-08-17,Alpine,003,1148,90,91,0,91,0
2021-08-17,Amador,005,37829,4411,4266,38,4304,50
2021-08-17,Butte,007,227075,14925,14357,2387,16744,206
2021-08-17,Calaveras,009,45235,2765,2624,19,2643,59
2021-08-17,Colusa,011,21464,2225,2156,446,2602,16
2021-08-17,Contra Costa,013,1133247,86075,82482,1704,84186,848
2021-08-17,Del Norte,015,27424,2474,2188,16,2204,8
2021-08-17,El Dorado,017,186661,12909,12242,1078,13320,118
2021-08-17,Fresno,019,978130,113183,110263,9934,120197,1755
2021-08-17,Glenn,021,27897,2696,2608,698,3306,20
2021-08-17,Humboldt,023,135768,6471,6155,146,6301,52
2021-08-17,Imperial,025,180216,30060,29768,2877,32645,746
2021-08-17,Inyo,027,18085,1497,1492,13,1505,39
2021-08-17,Kern,029,883053,105226,103048,13692,116740,1367
2021-08-17,Kings,031,150075,25676,24930,1341,26271,254
2021-08-17,Lake,033,64148,5099,4930,35,4965,68
2021-08-17,Lassen,035,31185,5599,5499,143,5642,21
2021-08-17,Los Angeles,037,10098052,1325910,1307999,49335,1357334,24952
2021-08-17,Madera,039,155013,18390,17838,1224,19062,246
2021-08-17,Marin,041,260295,15950,15570,321,15891,240
2021-08-17,Mariposa,043,17540,651,609,15,624,5
2021-08-17,Mendocino,045,87422,5399,5097,176,5273,51
2021-08-17,Merced,047,269075,34182,33508,1247,34755,482
2021-08-17,Modoc,049,8938,440,424,152,576,6
2021-08-17,Mono,051,14174,1379,1341,18,1359,3
2021-08-17,Monterey,053,433212,45266,44672,2236,46908,528
2021-08-17,Napa,055,140530,11261,11007,68,11075,83
2021-08-17,Nevada,057,99092,6912,6605,227,6832,75
2021-08-17,Orange,059,3164182,281773,277121,12991,290112,5164
2021-08-17,Placer,061,380077,29230,27634,2420,30054,312
2021-08-17,Plumas,063,18699,933,860,14,874,5
2021-08-17,Riverside,065,2383286,323504,316051,15160,331211,4582
2021-08-17,Sacramento,067,1510023,130438,125151,2638,127789,1774
2021-08-17,San Benito,069,59416,6566,6470,127,6597,64
2021-08-17,San Bernardino,071,2135413,319946,314402,9827,324229,5302
2021-08-17,San Diego,073,3302833,323299,317058,18763,335821,3824
2021-08-17,San Francisco,075,870044,46245,44820,1894,46714,567
2021-08-17,San Joaquin,077,732212,83948,81300,4327,85627,1489
2021-08-17,San Luis Obispo,079,281455,24334,23556,924,24480,268
2021-08-17,San Mateo,081,765935,48455,47127,696,47823,551
2021-08-17,Santa Barbara,083,443738,38371,37478,1329,38807,475
2021-08-17,Santa Clara,085,1922200,131732,128354,966,129320,1773
2021-08-17,Santa Cruz,087,273765,17964,17528,899,18427,209
2021-08-17,Shasta,089,179085,14524,14012,2016,16028,214
2021-08-17,Sierra,091,2930,91,82,13,95,0
2021-08-17,Siskiyou,093,43540,2306,2183,590,2773,33
2021-08-17,Solano,095,438530,39864,37662,918,38580,269
2021-08-17,Sonoma,097,501317,36361,34943,438,35381,333
2021-08-17,Stanislaus,099,539301,63867,62385,7064,69449,1047
2021-08-17,Sutter,101,95872,11207,10973,120,11093,130
2021-08-17,Tehama,103,63373,5820,5612,710,6322,66
2021-08-17,Trinity,105,12862,572,406,132,538,3
2021-08-17,Tulare,107,460477,53985,52362,10709,63071,856
2021-08-17,Tuolumne,109,53932,5166,5042,53,5095,64
2021-08-17,Ventura,111,848112,88988,87601,3818,91419,1053
2021-08-17,Yolo,113,214977,16553,15975,697,16672,225
2021-08-17,Yuba,115,75493,7629,7355,171,7526,51
2021-08-16,Alameda,001,1643700,105356,102052,2361,104413,1287
2021-08-16,Alpine,003,1148,90,91,0,91,0
2021-08-16,Amador,005,37829,4401,4235,38,4273,50
2021-08-16,Butte,007,227075,14807,14283,2353,16636,206
2021-08-16,Calaveras,009,45235,2705,2609,18,2627,57
2021-08-16,Colusa,011,21464,2214,2147,442,2589,16
2021-08-16,Contra Costa,013,1133247,85532,82070,1694,83764,848
2021-08-16,Del Norte,015,27424,2397,2125,16,2141,8
2021-08-16,El Dorado,017,186661,12807,12139,1065,13204,118
2021-08-16,Fresno,019,978130,112685,109623,9882,119505,1753
2021-08-16,Glenn,021,27897,2677,2593,692,3285,20
2021-08-16,Humboldt,023,135768,6400,6064,125,6189,52
2021-08-16,Imperial,025,180216,30019,29737,2862,32599,746
2021-08-16,Inyo,027,18085,1494,1490,13,1503,39
2021-08-16,Kern,029,883053,104851,102690,13576,116266,1367
2021-08-16,Kings,031,150075,25573,24817,1331,26148,254
2021-08-16,Lake,033,64148,5072,4898,34,4932,68
2021-08-16,Lassen,035,31185,5583,5481,135,5616,21
2021-08-16,Los Angeles,037,10098052,1322529,1305330,49189,1354519,24923
2021-08-16,Madera,039,155013,18315,17756,1203,18959,246
2021-08-16,Marin,041,260295,15891,15497,319,15816,239
2021-08-16,Mariposa,043,17540,634,597,15,612,5
2021-08-16,Mendocino,045,87422,5343,5037,174,5211,49
2021-08-16,Merced,047,269075,33981,33364,1234,34598,481
2021-08-16,Modoc,049,8938,438,421,151,572,5
2021-08-16,Mono,051,14174,1374,1339,18,1357,3
2021-08-16,Monterey,053,433212,45187,44595,2224,46819,527
2021-08-16,Napa,055,140530,11232,10946,68,11014,83
2021-08-16,Nevada,057,99092,6857,6535,226,6761,74
2021-08-16,Orange,059,3164182,280979,275985,12946,288931,5161
2021-08-16,Placer,061,380077,29047,27384,2387,29771,306
2021-08-16,Plumas,063,18699,922,851,14,865,5
2021-08-16,Riverside,065,2383286,322413,314774,15123,329897,4582
2021-08-16,Sacramento,067,1510023,129628,124554,2595,127149,1762
2021-08-16,San Benito,069,59416,6542,6452,127,6579,64
2021-08-16,San Bernardino,071,2135413,318983,313617,9800,323417,5301
2021-08-16,San Diego,073,3302833,321702,315348,18623,333971,3824
2021-08-16,San Francisco,075,870044,46041,44681,1885,46566,567
2021-08-16,San Joaquin,077,732212,83445,81087,4300,85387,1488
2021-08-16,San Luis Obispo,079,281455,24184,23452,916,24368,265
2021-08-16,San Mateo,081,765935,48272,47024,689,47713,548
2021-08-16,Santa Barbara,083,443738,38200,37358,1324,38682,475
2021-08-16,Santa Clara,085,1922200,131268,127978,962,128940,1773
2021-08-16,Santa Cruz,087,273765,17900,17491,893,18384,209
2021-08-16,Shasta,089,179085,14435,13862,2000,15862,211
2021-08-16,Sierra,091,2930,88,82,13,95,0
2021-08-16,Siskiyou,093,43540,2289,2169,570,2739,33
2021-08-16,Solano,095,438530,39583,37436,904,38340,263
2021-08-16,Sonoma,097,501317,36193,34844,436,35280,333
2021-08-16,Stanislaus,099,539301,63528,62033,7012,69045,1039
2021-08-16,Sutter,101,95872,11138,10902,119,11021,130
2021-08-16,Tehama,103,63373,5757,5565,705,6270,66
2021-08-16,Trinity,105,12862,566,400,131,531,3
2021-08-16,Tulare,107,460477,53742,52162,10639,62801,856
2021-08-16,Tuolumne,109,53932,5127,4984,52,5036,64
2021-08-16,Ventura,111,848112,88743,86954,3800,90754,1052
2021-08-16,Yolo,113,214977,16452,15922,689,16611,225
2021-08-16,Yuba,115,75493,7545,7314,170,7484,51
2021-08-15,Alameda,001,1643700,104860,101660,2344,104004,1287
2021-08-15,Alpine,003,1148,90,91,0,91,0
2021-08-15,Amador,005,37829,4373,4231,38,4269,49
2021-08-15,Butte,007,227075,14683,14263,2330,16593,206
2021-08-15,Calaveras,009,45235,2662,2599,18,2617,57
2021-08-15,Colusa,011,21464,2202,2140,432,2572,16
2021-08-15,Contra Costa,013,1133247,85050,81781,1679,83460,848
2021-08-15,Del Norte,015,27424,2330,2060,16,2076,8
2021-08-15,El Dorado,017,186661,12672,12057,1048,13105,118
2021-08-15,Fresno,019,978130,112206,109382,9816,119198,1753
2021-08-15,Glenn,021,27897,2654,2592,680,3272,20
2021-08-15,Humboldt,023,135768,6326,6024,119,6143,52
2021-08-15,Imperial,025,180216,29953,29711,2858,32569,746
2021-08-15,Inyo,027,18085,1493,1489,13,1502,39
2021-08-15,Kern,029,883053,104407,102524,13463,115987,1367
2021-08-15,Kings,031,150075,25428,24736,1321,26057,254
2021-08-15,Lake,033,64148,5013,4886,33,4919,68
2021-08-15,Lassen,035,31185,5566,5482,134,5616,21
2021-08-15,Los Angeles,037,10098052,1318997,1302882,49016,1351898,24918
2021-08-15,Madera,039,155013,18227,17714,1187,18901,246
2021-08-15,Marin,041,260295,15832,15461,317,15778,239
2021-08-15,Mariposa,043,17540,627,591,14,605,5
2021-08-15,Mendocino,045,87422,5287,5022,168,5190,49
2021-08-15,Merced,047,269075,33736,33305,1223,34528,481
2021-08-15,Modoc,049,8938,436,421,151,572,5
2021-08-15,Mono,051,14174,1370,1334,18,1352,3
2021-08-15,Monterey,053,433212,45065,44567,2202,46769,527
2021-08-15,Napa,055,140530,11177,10919,68,10987,83
2021-08-15,Nevada,057,99092,6772,6486,226,6712,74
2021-08-15,Orange,059,3164182,280208,275447,12905,288352,5161
2021-08-15,Placer,061,380077,28825,27220,2339,29559,306
2021-08-15,Plumas,063,18699,910,850,14,864,5
2021-08-15,Riverside,065,2383286,321274,314133,15096,329229,4582
2021-08-15,Sacramento,067,1510023,128811,123924,2563,126487,1761
2021-08-15,San Benito,069,59416,6524,6446,126,6572,64
2021-08-15,San Bernardino,071,2135413,317908,313120,9768,322888,5301
2021-08-15,San Diego,073,3302833,320232,314247,18496,332743,3824
2021-08-15,San Francisco,075,870044,45817,44531,1868,46399,567
2021-08-15,San Joaquin,077,732212,82957,80832,4261,85093,1488
2021-08-15,San Luis Obispo,079,281455,23987,23404,906,24310,265
2021-08-15,San Mateo,081,765935,48083,46897,683,47580,548
2021-08-15,Santa Barbara,083,443738,38028,37276,1317,38593,475
2021-08-15,Santa Clara,085,1922200,130835,127715,956,128671,1773
2021-08-15,Santa Cruz,087,273765,17830,17440,886,18326,209
2021-08-15,Shasta,089,179085,14332,13835,1975,15810,211
2021-08-15,Sierra,091,2930,87,82,12,94,0
2021-08-15,Siskiyou,093,43540,2268,2169,556,2725,33
2021-08-15,Solano,095,438530,39327,37320,893,38213,263
2021-08-15,Sonoma,097,501317,35997,34706,428,35134,333
2021-08-15,Stanislaus,099,539301,63160,61795,6934,68729,1039
2021-08-15,Sutter,101,95872,11047,10863,119,10982,130
2021-08-15,Tehama,103,63373,5708,5550,699,6249,66
2021-08-15,Trinity,105,12862,562,400,130,530,3
2021-08-15,Tulare,107,460477,53485,52046,10579,62625,856
2021-08-15,Tuolumne,109,53932,5089,4934,50,4984,64
2021-08-15,Ventura,111,848112,88438,86797,3786,90583,1052
2021-08-15,Yolo,113,214977,16355,15873,679,16552,225
2021-08-15,Yuba,115,75493,7468,7265,169,7434,51
2021-08-14,Alameda,001,1643700,104643,101305,2340,103645,1287
2021-08-14,Alpine,003,1148,90,91,0,91,0
2021-08-14,Amador,005,37829,4355,4206,38,4244,49
2021-08-14,Butte,007,227075,14647,14192,2314,16506,206
2021-08-14,Calaveras,009,45235,2655,2579,18,2597,57
2021-08-14,Colusa,011,21464,2191,2134,428,2562,16
2021-08-14,Contra Costa,013,1133247,84802,81458,1671,83129,848
2021-08-14,Del Norte,015,27424,2303,2015,16,2031,8
2021-08-14,El Dorado,017,186661,12636,12019,1040,13059,118
2021-08-14,Fresno,019,978130,112045,109056,9786,118842,1753
2021-08-14,Glenn,021,27897,2643,2583,677,3260,20
2021-08-14,Humboldt,023,135768,6273,5998,115,6113,52
2021-08-14,Imperial,025,180216,29926,29671,2858,32529,746
2021-08-14,Inyo,027,18085,1491,1487,13,1500,39
2021-08-14,Kern,029,883053,104212,102306,13367,115673,1367
2021-08-14,Kings,031,150075,25330,24647,1312,25959,254
2021-08-14,Lake,033,64148,4996,4850,32,4882,68
2021-08-14,Lassen,035,31185,5559,5475,133,5608,21
2021-08-14,Los Angeles,037,10098052,1317224,1299346,48875,1348221,24911
2021-08-14,Madera,039,155013,18180,17691,1182,18873,246
2021-08-14,Marin,041,260295,15798,15441,317,15758,239
2021-08-14,Mariposa,043,17540,623,584,14,598,5
2021-08-14,Mendocino,045,87422,5251,4977,165,5142,49
2021-08-14,Merced,047,269075,33672,33234,1217,34451,481
2021-08-14,Modoc,049,8938,436,421,151,572,5
2021-08-14,Mono,051,14174,1365,1332,18,1350,3
2021-08-14,Monterey,053,433212,45020,44514,2199,46713,527
2021-08-14,Napa,055,140530,11147,10878,67,10945,83
2021-08-14,Nevada,057,99092,6737,6419,225,6644,74
2021-08-14,Orange,059,3164182,279774,274732,12877,287609,5161
2021-08-14,Placer,061,380077,28679,27115,2315,29430,306
2021-08-14,Plumas,063,18699,900,849,14,863,5
2021-08-14,Riverside,065,2383286,320558,313264,15075,328339,4582
2021-08-14,Sacramento,067,1510023,128317,123438,2545,125983,1758
2021-08-14,San Benito,069,59416,6511,6428,126,6554,64
2021-08-14,San Bernardino,071,2135413,317359,312142,9747,321889,5301
2021-08-14,San Diego,073,3302833,319561,313589,18428,332017,3824
2021-08-14,San Francisco,075,870044,45688,44353,1849,46202,567
2021-08-14,San Joaquin,077,732212,82741,80585,4246,84831,1488
2021-08-14,San Luis Obispo,079,281455,23926,23328,903,24231,265
2021-08-14,San Mateo,081,765935,47964,46792,679,47471,548
2021-08-14,Santa Barbara,083,443738,37934,37118,1314,38432,475
2021-08-14,Santa Clara,085,1922200,130556,127432,953,128385,1772
2021-08-14,Santa Cruz,087,273765,17791,17384,885,18269,209
2021-08-14,Shasta,089,179085,14257,13813,1954,15767,211
2021-08-14,Sierra,091,2930,86,81,12,93,0
2021-08-14,Siskiyou,093,43540,2258,2160,546,2706,33
2021-08-14,Solano,095,438530,39240,37237,881,38118,263
2021-08-14,Sonoma,097,501317,35874,34606,426,35032,333
2021-08-14,Stanislaus,099,539301,62986,61564,6889,68453,1039
2021-08-14,Sutter,101,95872,11002,10808,118,10926,130
2021-08-14,Tehama,103,63373,5684,5530,695,6225,66
2021-08-14,Trinity,105,12862,556,399,130,529,3
2021-08-14,Tulare,107,460477,53349,51951,10533,62484,856
2021-08-14,Tuolumne,109,53932,5054,4924,50,4974,64
2021-08-14,Ventura,111,848112,88282,86569,3766,90335,1052
2021-08-14,Yolo,113,214977,16310,15815,669,16484,225
2021-08-14,Yuba,115,75493,7419,7223,169,7392,51
2021-08-13,Alameda,001,1643700,104344,100930,2332,103262,1284
2021-08-13,Alpine,003,1148,90,91,0,91,0
2021-08-13,Amador,005,37829,4327,4169,38,4207,49
2021-08-13,Butte,007,227075,14577,14100,2298,16398,206
2021-08-13,Calaveras,009,45235,2648,2564,18,2582,57
2021-08-13,Colusa,011,21464,2184,2123,423,2546,16
2021-08-13,Contra Costa,013,1133247,84490,81046,1663,82709,848
2021-08-13,Del Norte,015,27424,2262,1973,16,1989,8
2021-08-13,El Dorado,017,186661,12596,11951,1028,12979,118
2021-08-13,Fresno,019,978130,111753,108638,9762,118400,1753
2021-08-13,Glenn,021,27897,2632,2574,673,3247,20
2021-08-13,Humboldt,023,135768,6226,5882,112,5994,52
2021-08-13,Imperial,025,180216,29899,29654,2857,32511,745
2021-08-13,Inyo,027,18085,1490,1484,13,1497,39
2021-08-13,Kern,029,883053,104003,102029,13258,115287,1364
2021-08-13,Kings,031,150075,25245,24531,1305,25836,253
2021-08-13,Lake,033,64148,4973,4811,31,4842,68
2021-08-13,Lassen,035,31185,5551,5455,132,5587,21
2021-08-13,Los Angeles,037,10098052,1314906,1295406,48737,1344143,24891
2021-08-13,Madera,039,155013,18131,17614,1173,18787,246
2021-08-13,Marin,041,260295,15767,15380,317,15697,239
2021-08-13,Mariposa,043,17540,617,577,14,591,5
2021-08-13,Mendocino,045,87422,5198,4924,163,5087,49
2021-08-13,Merced,047,269075,33625,33111,1211,34322,480
2021-08-13,Modoc,049,8938,435,421,150,571,5
2021-08-13,Mono,051,14174,1362,1331,18,1349,3
2021-08-13,Monterey,053,433212,44960,44450,2197,46647,527
2021-08-13,Napa,055,140530,11111,10830,67,10897,83
2021-08-13,Nevada,057,99092,6696,6356,224,6580,74
2021-08-13,Orange,059,3164182,279279,274004,12828,286832,5159
2021-08-13,Placer,061,380077,28579,26987,2288,29275,306
2021-08-13,Plumas,063,18699,886,842,14,856,5
2021-08-13,Riverside,065,2383286,319820,312408,15050,327458,4581
2021-08-13,Sacramento,067,1510023,127847,122868,2518,125386,1758
2021-08-13,San Benito,069,59416,6505,6422,124,6546,64
2021-08-13,San Bernardino,071,2135413,316691,311378,9728,321106,5301
2021-08-13,San Diego,073,3302833,318515,312293,18349,330642,3821
2021-08-13,San Francisco,075,870044,45552,44196,1826,46022,567
2021-08-13,San Joaquin,077,732212,82524,80232,4229,84461,1481
2021-08-13,San Luis Obispo,079,281455,23863,23226,900,24126,265
2021-08-13,San Mateo,081,765935,47845,46660,678,47338,548
2021-08-13,Santa Barbara,083,443738,37849,37023,1310,38333,474
2021-08-13,Santa Clara,085,1922200,130269,126958,947,127905,1769
2021-08-13,Santa Cruz,087,273765,17751,17332,878,18210,209
2021-08-13,Shasta,089,179085,14194,13698,1940,15638,211
2021-08-13,Sierra,091,2930,85,81,12,93,0
2021-08-13,Siskiyou,093,43540,2249,2147,542,2689,33
2021-08-13,Solano,095,438530,39106,37104,873,37977,264
2021-08-13,Sonoma,097,501317,35769,34464,426,34890,333
2021-08-13,Stanislaus,099,539301,62816,61294,6846,68140,1039
2021-08-13,Sutter,101,95872,10958,10751,117,10868,130
2021-08-13,Tehama,103,63373,5660,5496,693,6189,66
2021-08-13,Trinity,105,12862,552,392,130,522,3
2021-08-13,Tulare,107,460477,53245,51770,10458,62228,856
2021-08-13,Tuolumne,109,53932,5021,4899,49,4948,64
2021-08-13,Ventura,111,848112,88124,86368,3753,90121,1052
2021-08-13,Yolo,113,214977,16257,15761,659,16420,225
2021-08-13,Yuba,115,75493,7381,7184,169,7353,51
2021-08-12,Alameda,001,1643700,103852,100472,2319,102791,1284
2021-08-12,Alpine,003,1148,90,91,0,91,0
2021-08-12,Amador,005,37829,4297,4161,37,4198,49
2021-08-12,Butte,007,227075,14507,14006,2280,16286,206
2021-08-12,Calaveras,009,45235,2633,2531,18,2549,57
2021-08-12,Colusa,011,21464,2179,2111,422,2533,17
2021-08-12,Contra Costa,013,1133247,84008,80738,1648,82386,846
2021-08-12,Del Norte,015,27424,2190,1923,16,1939,8
2021-08-12,El Dorado,017,186661,12482,11880,1020,12900,118
2021-08-12,Fresno,019,978130,111331,108193,9694,117887,1753
2021-08-12,Glenn,021,27897,2624,2559,661,3220,20
2021-08-12,Humboldt,023,135768,6157,5845,108,5953,52
2021-08-12,Imperial,025,180216,29843,29585,2851,32436,745
2021-08-12,Inyo,027,18085,1488,1483,13,1496,39
2021-08-12,Kern,029,883053,103714,101698,13178,114876,1364
2021-08-12,Kings,031,150075,25145,24423,1296,25719,252
2021-08-12,Lake,033,64148,4947,4774,31,4805,68
2021-08-12,Lassen,035,31185,5529,5428,131,5559,21
2021-08-12,Los Angeles,037,10098052,1311719,1291875,48602,1340477,24874
2021-08-12,Madera,039,155013,18067,17564,1161,18725,246
2021-08-12,Marin,041,260295,15718,15277,314,15591,239
2021-08-12,Mariposa,043,17540,608,568,13,581,5
2021-08-12,Mendocino,045,87422,5168,4873,157,5030,49
2021-08-12,Merced,047,269075,33501,32960,1204,34164,480
2021-08-12,Modoc,049,8938,434,423,150,573,5
2021-08-12,Mono,051,14174,1357,1325,18,1343,3
2021-08-12,Monterey,053,433212,44884,44383,2180,46563,527
2021-08-12,Napa,055,140530,11062,10780,66,10846,83
2021-08-12,Nevada,057,99092,6635,6283,224,6507,74
2021-08-12,Orange,059,3164182,278600,273167,12770,285937,5158
2021-08-12,Placer,061,380077,28381,26856,2265,29121,306
2021-08-12,Plumas,063,18699,878,829,14,843,5
2021-08-12,Riverside,065,2383286,318810,311304,15017,326321,4575
2021-08-12,Sacramento,067,1510023,127076,122222,2488,124710,1758
2021-08-12,San Benito,069,59416,6488,6398,122,6520,64
2021-08-12,San Bernardino,071,2135413,315817,310420,9699,320119,5297
2021-08-12,San Diego,073,3302833,317146,310596,18260,328856,3821
2021-08-12,San Francisco,075,870044,45345,43774,1813,45587,564
2021-08-12,San Joaquin,077,732212,82128,79945,4206,84151,1479
2021-08-12,San Luis Obispo,079,281455,23763,23101,886,23987,264
2021-08-12,San Mateo,081,765935,47701,46435,675,47110,548
2021-08-12,Santa Barbara,083,443738,37712,36881,1302,38183,473
2021-08-12,Santa Clara,085,1922200,129820,126614,941,127555,1769
2021-08-12,Santa Cruz,087,273765,17687,17261,877,18138,209
2021-08-12,Shasta,089,179085,14108,13621,1913,15534,211
2021-08-12,Sierra,091,2930,85,81,12,93,0
2021-08-12,Siskiyou,093,43540,2242,2134,532,2666,33
2021-08-12,Solano,095,438530,38877,36980,864,37844,262
2021-08-12,Sonoma,097,501317,35621,34299,423,34722,333
2021-08-12,Stanislaus,099,539301,62552,61026,6787,67813,1039
2021-08-12,Sutter,101,95872,10897,10695,115,10810,130
2021-08-12,Tehama,103,63373,5630,5462,684,6146,66
2021-08-12,Trinity,105,12862,548,386,129,515,3
2021-08-12,Tulare,107,460477,53099,51632,10409,62041,856
2021-08-12,Tuolumne,109,53932,4974,4845,47,4892,64
2021-08-12,Ventura,111,848112,87886,86106,3729,89835,1052
2021-08-12,Yolo,113,214977,16185,15686,646,16332,224
2021-08-12,Yuba,115,75493,7333,7128,168,7296,51
2021-08-11,Alameda,001,1643700,103335,100040,2315,102355,1281
2021-08-11,Alpine,003,1148,90,91,0,91,0
2021-08-11,Amador,005,37829,4273,4127,37,4164,49
2021-08-11,Butte,007,227075,14407,13905,2255,16160,206
2021-08-11,Calaveras,009,45235,2611,2505,18,2523,57
2021-08-11,Colusa,011,21464,2169,2101,420,2521,16
2021-08-11,Contra Costa,013,1133247,83508,80275,1630,81905,843
2021-08-11,Del Norte,015,27424,2131,1893,16,1909,8
2021-08-11,El Dorado,017,186661,12370,11799,1008,12807,119
2021-08-11,Fresno,019,978130,110877,107773,9647,117420,1751
2021-08-11,Glenn,021,27897,2615,2547,651,3198,20
2021-08-11,Humboldt,023,135768,6110,5765,107,5872,52
2021-08-11,Imperial,025,180216,29800,29565,2847,32412,745
2021-08-11,Inyo,027,18085,1488,1483,13,1496,39
2021-08-11,Kern,029,883053,103400,101448,13068,114516,1363
2021-08-11,Kings,031,150075,25032,24304,1287,25591,250
2021-08-11,Lake,033,64148,4910,4713,30,4743,68
2021-08-11,Lassen,035,31185,5520,5408,129,5537,21
2021-08-11,Los Angeles,037,10098052,1308397,1288238,48413,1336651,24851
2021-08-11,Madera,039,155013,18017,17511,1150,18661,245
2021-08-11,Marin,041,260295,15669,15235,314,15549,239
2021-08-11,Mariposa,043,17540,598,554,12,566,5
2021-08-11,Mendocino,045,87422,5099,4796,148,4944,49
2021-08-11,Merced,047,269075,33368,32802,1200,34002,479
2021-08-11,Modoc,049,8938,434,421,150,571,5
2021-08-11,Mono,051,14174,1352,1320,18,1338,3
2021-08-11,Monterey,053,433212,44785,44314,2162,46476,527
2021-08-11,Napa,055,140530,11021,10732,66,10798,83
2021-08-11,Nevada,057,99092,6581,6172,221,6393,74
2021-08-11,Orange,059,3164182,277743,272212,12723,284935,5155
2021-08-11,Placer,061,380077,28169,26687,2239,28926,305
2021-08-11,Plumas,063,18699,868,824,14,838,5
2021-08-11,Riverside,065,2383286,317817,310265,14982,325247,4570
2021-08-11,Sacramento,067,1510023,126283,121603,2446,124049,1757
2021-08-11,San Benito,069,59416,6475,6381,122,6503,64
2021-08-11,San Bernardino,071,2135413,314924,309498,9677,319175,5296
2021-08-11,San Diego,073,3302833,315676,309406,18156,327562,3818
2021-08-11,San Francisco,075,870044,45121,43555,1805,45360,564
2021-08-11,San Joaquin,077,732212,81721,79641,4178,83819,1478
2021-08-11,San Luis Obispo,079,281455,23659,22920,879,23799,264
2021-08-11,San Mateo,081,765935,47533,46300,672,46972,548
2021-08-11,Santa Barbara,083,443738,37548,36699,1293,37992,472
2021-08-11,Santa Clara,085,1922200,129339,126301,933,127234,1769
2021-08-11,Santa Cruz,087,273765,17622,17191,874,18065,209
2021-08-11,Shasta,089,179085,14034,13546,1897,15443,211
2021-08-11,Sierra,091,2930,84,81,12,93,0
2021-08-11,Siskiyou,093,43540,2228,2124,525,2649,33
2021-08-11,Solano,095,438530,38642,36862,850,37712,262
2021-08-11,Sonoma,097,501317,35442,34188,418,34606,333
2021-08-11,Stanislaus,099,539301,62222,60767,6757,67524,1037
2021-08-11,Sutter,101,95872,10825,10628,115,10743,130
2021-08-11,Tehama,103,63373,5600,5410,667,6077,66
2021-08-11,Trinity,105,12862,546,385,129,514,3
2021-08-11,Tulare,107,460477,52931,51464,10364,61828,854
2021-08-11,Tuolumne,109,53932,4942,4794,47,4841,64
2021-08-11,Ventura,111,848112,87634,85863,3708,89571,1051
2021-08-11,Yolo,113,214977,16110,15593,632,16225,218
2021-08-11,Yuba,115,75493,7274,7063,167,7230,53
2021-08-10,Alameda,001,1643700,102854,99771,2307,102078,1281
2021-08-10,Alpine,003,1148,90,91,0,91,0
2021-08-10,Amador,005,37829,4257,4093,37,4130,49
2021-08-10,Butte,007,227075,14324,13853,2234,16087,205
2021-08-10,Calaveras,009,45235,2586,2491,16,2507,57
2021-08-10,Colusa,011,21464,2156,2088,411,2499,16
2021-08-10,Contra Costa,013,1133247,82964,80018,1620,81638,840
2021-08-10,Del Norte,015,27424,2087,1870,16,1886,8
2021-08-10,El Dorado,017,186661,12271,11734,998,12732,117
2021-08-10,Fresno,019,978130,110420,107616,9590,117206,1747
2021-08-10,Glenn,021,27897,2602,2538,641,3179,20
2021-08-10,Humboldt,023,135768,6056,5718,104,5822,52
2021-08-10,Imperial,025,180216,29765,29522,2841,32363,745
2021-08-10,Inyo,027,18085,1488,1482,13,1495,39
2021-08-10,Kern,029,883053,103071,101254,12972,114226,1359
2021-08-10,Kings,031,150075,24906,24252,1271,25523,251
2021-08-10,Lake,033,64148,4869,4700,30,4730,67
2021-08-10,Lassen,035,31185,5502,5401,129,5530,21
2021-08-10,Los Angeles,037,10098052,1304646,1285140,48241,1333381,24821
2021-08-10,Madera,039,155013,17944,17481,1140,18621,245
2021-08-10,Marin,041,260295,15622,15194,314,15508,239
2021-08-10,Mariposa,043,17540,585,550,12,562,5
2021-08-10,Mendocino,045,87422,5054,4775,144,4919,49
2021-08-10,Merced,047,269075,33220,32721,1191,33912,477
2021-08-10,Modoc,049,8938,433,421,150,571,5
2021-08-10,Mono,051,14174,1347,1320,18,1338,3
2021-08-10,Monterey,053,433212,44722,44259,2147,46406,527
2021-08-10,Napa,055,140530,10965,10703,65,10768,83
2021-08-10,Nevada,057,99092,6516,6151,220,6371,73
2021-08-10,Orange,059,3164182,276864,271688,12675,284363,5155
2021-08-10,Placer,061,380077,27950,26561,2197,28758,305
2021-08-10,Plumas,063,18699,859,816,14,830,5
2021-08-10,Riverside,065,2383286,316702,309529,14956,324485,4564
2021-08-10,Sacramento,067,1510023,125430,121159,2416,123575,1755
2021-08-10,San Benito,069,59416,6461,6371,122,6493,64
2021-08-10,San Bernardino,071,2135413,314001,308672,9659,318331,5295
2021-08-10,San Diego,073,3302833,314034,308288,18064,326352,3815
2021-08-10,San Francisco,075,870044,44868,43389,1790,45179,564
2021-08-10,San Joaquin,077,732212,81323,79391,4161,83552,1478
2021-08-10,San Luis Obispo,079,281455,23533,22776,877,23653,264
2021-08-10,San Mateo,081,765935,47361,46184,670,46854,548
2021-08-10,Santa Barbara,083,443738,37383,36574,1286,37860,472
2021-08-10,Santa Clara,085,1922200,128876,126019,926,126945,1770
2021-08-10,Santa Cruz,087,273765,17539,17142,872,18014,209
2021-08-10,Shasta,089,179085,13956,13461,1873,15334,211
2021-08-10,Sierra,091,2930,84,76,12,88,0
2021-08-10,Siskiyou,093,43540,2219,2088,518,2606,33
2021-08-10,Solano,095,438530,38396,36767,839,37606,262
2021-08-10,Sonoma,097,501317,35297,34054,415,34469,333
2021-08-10,Stanislaus,099,539301,61877,60605,6720,67325,1037
2021-08-10,Sutter,101,95872,10760,10569,115,10684,130
2021-08-10,Tehama,103,63373,5571,5392,662,6054,66
2021-08-10,Trinity,105,12862,546,384,129,513,3
2021-08-10,Tulare,107,460477,52766,51390,10312,61702,854
2021-08-10,Tuolumne,109,53932,4913,4780,45,4825,64
2021-08-10,Ventura,111,848112,87344,85714,3687,89401,1051
2021-08-10,Yolo,113,214977,16023,15568,622,16190,218
2021-08-10,Yuba,115,75493,7224,7028,167,7195,50
2021-08-09,Alameda,001,1643700,102295,99496,2303,101799,1276
2021-08-09,Alpine,003,1148,90,91,0,91,0
2021-08-09,Amador,005,37829,4231,4078,37,4115,48
2021-08-09,Butte,007,227075,14225,13813,2206,16019,205
2021-08-09,Calaveras,009,45235,2560,2472,16,2488,57
2021-08-09,Colusa,011,21464,2146,2075,403,2478,16
2021-08-09,Contra Costa,013,1133247,82419,79740,1608,81348,840
2021-08-09,Del Norte,015,27424,2019,1848,16,1864,8
2021-08-09,El Dorado,017,186661,12163,11672,984,12656,117
2021-08-09,Fresno,019,978130,109926,107310,9551,116861,1747
2021-08-09,Glenn,021,27897,2591,2532,629,3161,20
2021-08-09,Humboldt,023,135768,5965,5632,102,5734,52
2021-08-09,Imperial,025,180216,29720,29512,2837,32349,745
2021-08-09,Inyo,027,18085,1488,1481,13,1494,39
2021-08-09,Kern,029,883053,102759,101069,12886,113955,1359
2021-08-09,Kings,031,150075,24798,24155,1256,25411,250
2021-08-09,Lake,033,64148,4834,4670,28,4698,66
2021-08-09,Lassen,035,31185,5480,5393,128,5521,21
2021-08-09,Los Angeles,037,10098052,1300634,1282891,48033,1330924,24798
2021-08-09,Madera,039,155013,17885,17429,1120,18549,245
2021-08-09,Marin,041,260295,15569,15154,313,15467,239
2021-08-09,Mariposa,043,17540,572,545,12,557,5
2021-08-09,Mendocino,045,87422,5003,4732,136,4868,49
2021-08-09,Merced,047,269075,33074,32666,1184,33850,477
2021-08-09,Modoc,049,8938,433,419,150,569,5
2021-08-09,Mono,051,14174,1344,1337,18,1355,3
2021-08-09,Monterey,053,433212,44649,44190,2131,46321,527
2021-08-09,Napa,055,140530,10918,10679,65,10744,83
2021-08-09,Nevada,057,99092,6445,6088,219,6307,73
2021-08-09,Orange,059,3164182,275827,271036,12623,283659,5153
2021-08-09,Placer,061,380077,27727,26457,2166,28623,305
2021-08-09,Plumas,063,18699,842,803,14,817,5
2021-08-09,Riverside,065,2383286,315626,308678,14936,323614,4562
2021-08-09,Sacramento,067,1510023,124595,120812,2391,123203,1748
2021-08-09,San Benito,069,59416,6441,6359,120,6479,63
2021-08-09,San Bernardino,071,2135413,313017,308038,9635,317673,5295
2021-08-09,San Diego,073,3302833,312375,306855,17965,324820,3811
2021-08-09,San Francisco,075,870044,44622,43261,1772,45033,564
2021-08-09,San Joaquin,077,732212,80940,79198,4143,83341,1469
2021-08-09,San Luis Obispo,079,281455,23394,22695,868,23563,264
2021-08-09,San Mateo,081,765935,47189,46040,666,46706,548
2021-08-09,Santa Barbara,083,443738,37199,36474,1278,37752,470
2021-08-09,Santa Clara,085,1922200,128373,125791,917,126708,2187
2021-08-09,Santa Cruz,087,273765,17477,17082,872,17954,209
2021-08-09,Shasta,089,179085,13839,13397,1862,15259,210
2021-08-09,Sierra,091,2930,83,75,12,87,0
2021-08-09,Siskiyou,093,43540,2207,2047,502,2549,32
2021-08-09,Solano,095,438530,38120,36653,837,37490,262
2021-08-09,Sonoma,097,501317,35116,33933,413,34346,333
2021-08-09,Stanislaus,099,539301,61600,60410,6669,67079,1037
2021-08-09,Sutter,101,95872,10711,10525,112,10637,129
2021-08-09,Tehama,103,63373,5528,5373,660,6033,66
2021-08-09,Trinity,105,12862,544,378,127,505,3
2021-08-09,Tulare,107,460477,52605,51274,10247,61521,854
2021-08-09,Tuolumne,109,53932,4871,4745,45,4790,64
2021-08-09,Ventura,111,848112,87072,85514,3676,89190,1047
2021-08-09,Yolo,113,214977,15945,15521,601,16122,218
2021-08-09,Yuba,115,75493,7165,6994,167,7161,50
2021-08-08,Alameda,001,1643700,101741,99135,2297,101432,1276
2021-08-08,Alpine,003,1148,90,91,0,91,0
2021-08-08,Amador,005,37829,4197,4057,36,4093,48
2021-08-08,Butte,007,227075,14143,13791,2188,15979,205
2021-08-08,Calaveras,009,45235,2529,2462,16,2478,57
2021-08-08,Colusa,011,21464,2129,2070,396,2466,16
2021-08-08,Contra Costa,013,1133247,81895,79454,1601,81055,840
2021-08-08,Del Norte,015,27424,1973,1810,16,1826,8
2021-08-08,El Dorado,017,186661,12043,11631,973,12604,117
2021-08-08,Fresno,019,978130,109483,107078,9513,116591,1747
2021-08-08,Glenn,021,27897,2583,2527,622,3149,20
2021-08-08,Humboldt,023,135768,5877,5571,102,5673,52
2021-08-08,Imperial,025,180216,29696,29485,2827,32312,745
2021-08-08,Inyo,027,18085,1488,1481,13,1494,39
2021-08-08,Kern,029,883053,102439,100909,12774,113683,1359
2021-08-08,Kings,031,150075,24683,24095,1247,25342,250
2021-08-08,Lake,033,64148,4784,4636,27,4663,66
2021-08-08,Lassen,035,31185,5465,5391,127,5518,21
2021-08-08,Los Angeles,037,10098052,1296382,1279982,47846,1327828,24793
2021-08-08,Madera,039,155013,17806,17398,1103,18501,245
2021-08-08,Marin,041,260295,15516,15124,311,15435,239
2021-08-08,Mariposa,043,17540,568,538,12,550,5
2021-08-08,Mendocino,045,87422,4941,4702,123,4825,49
2021-08-08,Merced,047,269075,32927,32634,1175,33809,477
2021-08-08,Modoc,049,8938,432,419,149,568,5
2021-08-08,Mono,051,14174,1340,1336,18,1354,3
2021-08-08,Monterey,053,433212,44579,44171,2120,46291,527
2021-08-08,Napa,055,140530,10882,10668,65,10733,83
2021-08-08,Nevada,057,99092,6361,6009,217,6226,73
2021-08-08,Orange,059,3164182,274914,270532,12584,283116,5153
2021-08-08,Placer,061,380077,27518,26332,2125,28457,305
2021-08-08,Plumas,063,18699,833,803,14,817,5
2021-08-08,Riverside,065,2383286,314505,308042,14912,322954,4562
2021-08-08,Sacramento,067,1510023,123767,120109,2379,122488,1744
2021-08-08,San Benito,069,59416,6424,6350,119,6469,63
2021-08-08,San Bernardino,071,2135413,311871,307378,9605,316983,5295
2021-08-08,San Diego,073,3302833,311034,305983,17867,323850,3811
2021-08-08,San Francisco,075,870044,44362,43098,1749,44847,564
2021-08-08,San Joaquin,077,732212,80490,79002,4127,83129,1469
2021-08-08,San Luis Obispo,079,281455,23220,22668,860,23528,263
2021-08-08,San Mateo,081,765935,46999,45927,663,46590,548
2021-08-08,Santa Barbara,083,443738,37022,36417,1271,37688,470
2021-08-08,Santa Clara,085,1922200,127922,125553,912,126465,2187
2021-08-08,Santa Cruz,087,273765,17406,17035,867,17902,209
2021-08-08,Shasta,089,179085,13753,13381,1851,15232,210
2021-08-08,Sierra,091,2930,83,74,12,86,0
2021-08-08,Siskiyou,093,43540,2191,2041,497,2538,32
2021-08-08,Solano,095,438530,37868,36551,833,37384,262
2021-08-08,Sonoma,097,501317,34872,33805,412,34217,333
2021-08-08,Stanislaus,099,539301,61278,60269,6624,66893,1037
2021-08-08,Sutter,101,95872,10651,10481,111,10592,129
2021-08-08,Tehama,103,63373,5490,5359,657,6016,66
2021-08-08,Trinity,105,12862,539,378,127,505,3
2021-08-08,Tulare,107,460477,52426,51220,10187,61407,854
2021-08-08,Tuolumne,109,53932,4832,4731,45,4776,64
2021-08-08,Ventura,111,848112,86781,85382,3666,89048,1047
2021-08-08,Yolo,113,214977,15853,15477,594,16071,218
2021-08-08,Yuba,115,75493,7126,6967,167,7134,50
2021-08-07,Alameda,001,1643700,101487,98812,2291,101103,1276
2021-08-07,Alpine,003,1148,90,91,0,91,0
2021-08-07,Amador,005,37829,4180,4041,35,4076,48
2021-08-07,Butte,007,227075,14091,13714,2176,15890,205
2021-08-07,Calaveras,009,45235,2518,2446,16,2462,57
2021-08-07,Colusa,011,21464,2124,2067,387,2454,16
2021-08-07,Contra Costa,013,1133247,81599,79168,1598,80766,840
2021-08-07,Del Norte,015,27424,1941,1791,16,1807,8
2021-08-07,El Dorado,017,186661,11993,11575,966,12541,117
2021-08-07,Fresno,019,978130,109279,106861,9486,116347,1747
2021-08-07,Glenn,021,27897,2575,2515,621,3136,20
2021-08-07,Humboldt,023,135768,5827,5510,99,5609,52
2021-08-07,Imperial,025,180216,29677,29470,2827,32297,745
2021-08-07,Inyo,027,18085,1486,1476,13,1489,39
2021-08-07,Kern,029,883053,102281,100693,12719,113412,1359
2021-08-07,Kings,031,150075,24623,24048,1241,25289,250
2021-08-07,Lake,033,64148,4763,4613,27,4640,66
2021-08-07,Lassen,035,31185,5461,5386,127,5513,21
2021-08-07,Los Angeles,037,10098052,1294356,1276853,47694,1324547,24786
2021-08-07,Madera,039,155013,17771,17366,1098,18464,245
2021-08-07,Marin,041,260295,15482,15085,310,15395,239
2021-08-07,Mariposa,043,17540,565,530,12,542,5
2021-08-07,Mendocino,045,87422,4905,4690,121,4811,49
2021-08-07,Merced,047,269075,32863,32569,1172,33741,477
2021-08-07,Modoc,049,8938,432,419,149,568,5
2021-08-07,Mono,051,14174,1337,1329,18,1347,3
2021-08-07,Monterey,053,433212,44527,44124,2115,46239,527
2021-08-07,Napa,055,140530,10861,10658,64,10722,83
2021-08-07,Nevada,057,99092,6311,5967,215,6182,73
2021-08-07,Orange,059,3164182,274321,269900,12553,282453,5153
2021-08-07,Placer,061,380077,27330,26244,2117,28361,305
2021-08-07,Plumas,063,18699,828,801,14,815,5
2021-08-07,Riverside,065,2383286,313833,307326,14905,322231,4562
2021-08-07,Sacramento,067,1510023,123266,119636,2375,122011,1744
2021-08-07,San Benito,069,59416,6414,6332,119,6451,63
2021-08-07,San Bernardino,071,2135413,311283,306663,9588,316251,5295
2021-08-07,San Diego,073,3302833,310280,304974,17832,322806,3811
2021-08-07,San Francisco,075,870044,44191,42926,1731,44657,564
2021-08-07,San Joaquin,077,732212,80326,78769,4113,82882,1469
2021-08-07,San Luis Obispo,079,281455,23151,22579,859,23438,263
2021-08-07,San Mateo,081,765935,46872,45804,661,46465,548
2021-08-07,Santa Barbara,083,443738,36926,36303,1265,37568,470
2021-08-07,Santa Clara,085,1922200,127651,125196,907,126103,2188
2021-08-07,Santa Cruz,087,273765,17363,16994,865,17859,209
2021-08-07,Shasta,089,179085,13698,13361,1843,15204,210
2021-08-07,Sierra,091,2930,83,74,12,86,0
2021-08-07,Siskiyou,093,43540,2179,2039,495,2534,32
2021-08-07,Solano,095,438530,37752,36458,825,37283,262
2021-08-07,Sonoma,097,501317,34750,33716,412,34128,333
2021-08-07,Stanislaus,099,539301,61110,60093,6594,66687,1037
2021-08-07,Sutter,101,95872,10614,10447,111,10558,129
2021-08-07,Tehama,103,63373,5480,5343,652,5995,66
2021-08-07,Trinity,105,12862,535,377,126,503,3
2021-08-07,Tulare,107,460477,52339,51133,10149,61282,854
2021-08-07,Tuolumne,109,53932,4802,4721,45,4766,64
2021-08-07,Ventura,111,848112,86601,85232,3651,88883,1047
2021-08-07,Yolo,113,214977,15809,15423,587,16010,218
2021-08-07,Yuba,115,75493,7101,6937,165,7102,50
2021-08-06,Alameda,001,1643700,101157,98487,2283,100770,1275
2021-08-06,Alpine,003,1148,90,91,0,91,0
2021-08-06,Amador,005,37829,4159,4002,35,4037,48
2021-08-06,Butte,007,227075,14041,13626,2161,15787,205
2021-08-06,Calaveras,009,45235,2506,2419,16,2435,57
2021-08-06,Colusa,011,21464,2117,2045,381,2426,16
2021-08-06,Contra Costa,013,1133247,81304,78796,1592,80388,840
2021-08-06,Del Norte,015,27424,1914,1755,15,1770,8
2021-08-06,El Dorado,017,186661,11944,11498,954,12452,117
2021-08-06,Fresno,019,978130,109015,106542,9459,116001,1747
2021-08-06,Glenn,021,27897,2560,2504,618,3122,20
2021-08-06,Humboldt,023,135768,5776,5421,96,5517,52
2021-08-06,Imperial,025,180216,29666,29404,2823,32227,745
2021-08-06,Inyo,027,18085,1483,1471,13,1484,39
2021-08-06,Kern,029,883053,102104,100427,12634,113061,1359
2021-08-06,Kings,031,150075,24568,23974,1237,25211,250
2021-08-06,Lake,033,64148,4740,4557,27,4584,66
2021-08-06,Lassen,035,31185,5439,5368,127,5495,21
2021-08-06,Los Angeles,037,10098052,1291871,1273081,47541,1320622,24772
2021-08-06,Madera,039,155013,17732,17324,1089,18413,245
2021-08-06,Marin,041,260295,15449,15051,310,15361,239
2021-08-06,Mariposa,043,17540,556,511,12,523,5
2021-08-06,Mendocino,045,87422,4863,4649,120,4769,49
2021-08-06,Merced,047,269075,32803,32456,1169,33625,477
2021-08-06,Modoc,049,8938,432,419,149,568,5
2021-08-06,Mono,051,14174,1336,1328,18,1346,3
2021-08-06,Monterey,053,433212,44459,44058,2102,46160,527
2021-08-06,Napa,055,140530,10834,10620,64,10684,83
2021-08-06,Nevada,057,99092,6255,5874,215,6089,73
2021-08-06,Orange,059,3164182,273756,269077,12536,281613,5151
2021-08-06,Placer,061,380077,27207,26086,2095,28181,305
2021-08-06,Plumas,063,18699,819,795,14,809,5
2021-08-06,Riverside,065,2383286,313123,306304,14894,321198,4562
2021-08-06,Sacramento,067,1510023,122778,119169,2355,121524,1740
2021-08-06,San Benito,069,59416,6397,6315,119,6434,63
2021-08-06,San Bernardino,071,2135413,310583,305806,9580,315386,5286
2021-08-06,San Diego,073,3302833,309240,303691,17783,321474,3810
2021-08-06,San Francisco,075,870044,44034,42659,1713,44372,565
2021-08-06,San Joaquin,077,732212,80177,78405,4101,82506,1469
2021-08-06,San Luis Obispo,079,281455,23083,22472,854,23326,263
2021-08-06,San Mateo,081,765935,46719,45665,656,46321,548
2021-08-06,Santa Barbara,083,443738,36837,36208,1261,37469,470
2021-08-06,Santa Clara,085,1922200,127360,124767,901,125668,2185
2021-08-06,Santa Cruz,087,273765,17319,16924,861,17785,207
2021-08-06,Shasta,089,179085,13632,13284,1837,15121,210
2021-08-06,Sierra,091,2930,83,73,12,85,0
2021-08-06,Siskiyou,093,43540,2169,2030,491,2521,32
2021-08-06,Solano,095,438530,37642,36351,816,37167,262
2021-08-06,Sonoma,097,501317,34664,33594,411,34005,333
2021-08-06,Stanislaus,099,539301,60972,59854,6573,66427,1037
2021-08-06,Sutter,101,95872,10571,10391,111,10502,128
2021-08-06,Tehama,103,63373,5456,5325,651,5976,66
2021-08-06,Trinity,105,12862,534,371,125,496,3
2021-08-06,Tulare,107,460477,52238,51018,10102,61120,854
2021-08-06,Tuolumne,109,53932,4775,4674,45,4719,64
2021-08-06,Ventura,111,848112,86430,85046,3639,88685,1047
2021-08-06,Yolo,113,214977,15756,15299,582,15881,218
2021-08-06,Yuba,115,75493,7078,6904,165,7069,50
2021-08-05,Alameda,001,1643700,100670,98052,2278,100330,1275
2021-08-05,Alpine,003,1148,90,91,0,91,0
2021-08-05,Amador,005,37829,4139,3992,35,4027,48
2021-08-05,Butte,007,227075,13980,13564,2138,15702,206
2021-08-05,Calaveras,009,45235,2486,2397,16,2413,57
2021-08-05,Colusa,011,21464,2105,2036,377,2413,16
2021-08-05,Contra Costa,013,1133247,80877,78514,1585,80099,840
2021-08-05,Del Norte,015,27424,1887,1731,15,1746,8
2021-08-05,El Dorado,017,186661,11860,11408,943,12351,117
2021-08-05,Fresno,019,978130,108644,106219,9421,115640,1747
2021-08-05,Glenn,021,27897,2554,2494,615,3109,20
2021-08-05,Humboldt,023,135768,5702,5328,95,5423,52
2021-08-05,Imperial,025,180216,29635,29383,2819,32202,745
2021-08-05,Inyo,027,18085,1479,1468,13,1481,38
2021-08-05,Kern,029,883053,101882,100091,12549,112640,1358
2021-08-05,Kings,031,150075,24484,23906,1231,25137,249
2021-08-05,Lake,033,64148,4701,4490,25,4515,66
2021-08-05,Lassen,035,31185,5431,5344,127,5471,21
2021-08-05,Los Angeles,037,10098052,1288651,1269445,47406,1316851,24756
2021-08-05,Madera,039,155013,17691,17301,1081,18382,245
2021-08-05,Marin,041,260295,15405,15005,306,15311,239
2021-08-05,Mariposa,043,17540,545,504,11,515,5
2021-08-05,Mendocino,045,87422,4820,4597,111,4708,49
2021-08-05,Merced,047,269075,32736,32381,1158,33539,477
2021-08-05,Modoc,049,8938,431,418,149,567,5
2021-08-05,Mono,051,14174,1328,1309,18,1327,3
2021-08-05,Monterey,053,433212,44402,43992,2084,46076,527
2021-08-05,Napa,055,140530,10798,10591,62,10653,83
2021-08-05,Nevada,057,99092,6173,5778,212,5990,73
2021-08-05,Orange,059,3164182,272975,268329,12511,280840,5149
2021-08-05,Placer,061,380077,27006,25965,2068,28033,305
2021-08-05,Plumas,063,18699,810,787,14,801,5
2021-08-05,Riverside,065,2383286,312206,305415,14867,320282,4562
2021-08-05,Sacramento,067,1510023,122068,118590,2342,120932,1739
2021-08-05,San Benito,069,59416,6379,6305,119,6424,63
2021-08-05,San Bernardino,071,2135413,309748,304956,9559,314515,5284
2021-08-05,San Diego,073,3302833,307968,302220,17701,319921,3806
2021-08-05,San Francisco,075,870044,43824,42301,1704,44005,564
2021-08-05,San Joaquin,077,732212,79816,78151,4083,82234,1468
2021-08-05,San Luis Obispo,079,281455,22968,22362,848,23210,263
2021-08-05,San Mateo,081,765935,46546,45554,654,46208,548
2021-08-05,Santa Barbara,083,443738,36730,36112,1258,37370,470
2021-08-05,Santa Clara,085,1922200,127027,124490,901,125391,2185
2021-08-05,Santa Cruz,087,273765,17275,16867,858,17725,207
2021-08-05,Shasta,089,179085,13574,13217,1829,15046,210
2021-08-05,Sierra,091,2930,78,73,12,85,0
2021-08-05,Siskiyou,093,43540,2148,2024,481,2505,32
2021-08-05,Solano,095,438530,37461,36250,809,37059,262
2021-08-05,Sonoma,097,501317,34529,33455,410,33865,330
2021-08-05,Stanislaus,099,539301,60755,59692,6534,66226,1037
2021-08-05,Sutter,101,95872,10516,10349,111,10460,127
2021-08-05,Tehama,103,63373,5438,5305,647,5952,66
2021-08-05,Trinity,105,12862,528,367,125,492,3
2021-08-05,Tulare,107,460477,52121,50889,10045,60934,854
2021-08-05,Tuolumne,109,53932,4745,4619,45,4664,64
2021-08-05,Ventura,111,848112,86179,84837,3625,88462,1047
2021-08-05,Yolo,113,214977,15690,15250,572,15822,218
2021-08-05,Yuba,115,75493,7035,6872,163,7035,50
2021-08-04,Alameda,001,1643700,100169,97477,2267,99744,1274
2021-08-04,Alpine,003,1148,90,91,0,91,0
2021-08-04,Amador,005,37829,4109,3962,34,3996,48
2021-08-04,Butte,007,227075,13912,13509,2121,15630,205
2021-08-04,Calaveras,009,45235,2461,2374,16,2390,57
2021-08-04,Colusa,011,21464,2093,2025,371,2396,16
2021-08-04,Contra Costa,013,1133247,80361,77966,1580,79546,840
2021-08-04,Del Norte,015,27424,1864,1701,15,1716,8
2021-08-04,El Dorado,017,186661,11782,11319,932,12251,117
2021-08-04,Fresno,019,978130,108276,105899,9380,115279,1747
2021-08-04,Glenn,021,27897,2546,2487,613,3100,20
2021-08-04,Humboldt,023,135768,5626,5271,94,5365,52
2021-08-04,Imperial,025,180216,29587,29375,2817,32192,745
2021-08-04,Inyo,027,18085,1478,1465,13,1478,38
2021-08-04,Kern,029,883053,101632,99868,12464,112332,1358
2021-08-04,Kings,031,150075,24412,23840,1223,25063,250
2021-08-04,Lake,033,64148,4671,4423,20,4443,65
2021-08-04,Lassen,035,31185,5423,5340,127,5467,21
2021-08-04,Los Angeles,037,10098052,1285165,1265788,47243,1313031,24737
2021-08-04,Madera,039,155013,17656,17251,1074,18325,245
2021-08-04,Marin,041,260295,15358,14950,304,15254,239
2021-08-04,Mariposa,043,17540,530,497,11,508,5
2021-08-04,Mendocino,045,87422,4796,4560,107,4667,49
2021-08-04,Merced,047,269075,32599,32274,1153,33427,476
2021-08-04,Modoc,049,8938,431,416,149,565,5
2021-08-04,Mono,051,14174,1324,1307,18,1325,3
2021-08-04,Monterey,053,433212,44337,43926,2073,45999,526
2021-08-04,Napa,055,140530,10761,10544,62,10606,82
2021-08-04,Nevada,057,99092,6109,5702,211,5913,73
2021-08-04,Orange,059,3164182,272102,267199,12474,279673,5146
2021-08-04,Placer,061,380077,26789,25688,2048,27736,305
2021-08-04,Plumas,063,18699,804,784,14,798,5
2021-08-04,Riverside,065,2383286,311281,304272,14841,319113,4562
2021-08-04,Sacramento,067,1510023,121310,117882,2316,120198,1736
2021-08-04,San Benito,069,59416,6364,6300,119,6419,63
2021-08-04,San Bernardino,071,2135413,308891,304164,9542,313706,5285
2021-08-04,San Diego,073,3302833,306454,301100,17635,318735,3805
2021-08-04,San Francisco,075,870044,43570,41913,1691,43604,562
2021-08-04,San Joaquin,077,732212,79459,77846,4071,81917,1466
2021-08-04,San Luis Obispo,079,281455,22860,22245,842,23087,262
2021-08-04,San Mateo,081,765935,46374,45392,653,46045,548
2021-08-04,Santa Barbara,083,443738,36601,36013,1250,37263,470
2021-08-04,Santa Clara,085,1922200,126636,124127,894,125021,2183
2021-08-04,Santa Cruz,087,273765,17213,16820,851,17671,208
2021-08-04,Shasta,089,179085,13523,13134,1818,14952,211
2021-08-04,Sierra,091,2930,78,73,12,85,0
2021-08-04,Siskiyou,093,43540,2128,2010,476,2486,32
2021-08-04,Solano,095,438530,37261,36025,800,36825,262
2021-08-04,Sonoma,097,501317,34357,33311,408,33719,330
2021-08-04,Stanislaus,099,539301,60532,59396,6496,65892,1037
2021-08-04,Sutter,101,95872,10479,10294,111,10405,127
2021-08-04,Tehama,103,63373,5412,5281,642,5923,66
2021-08-04,Trinity,105,12862,526,362,122,484,3
2021-08-04,Tulare,107,460477,52011,50797,10001,60798,855
2021-08-04,Tuolumne,109,53932,4720,4584,45,4629,64
2021-08-04,Ventura,111,848112,85921,84406,3603,88009,1047
2021-08-04,Yolo,113,214977,15611,15189,559,15748,215
2021-08-04,Yuba,115,75493,6995,6827,161,6988,50
2021-08-03,Alameda,001,1643700,99720,97275,2262,99537,1270
2021-08-03,Alpine,003,1148,90,91,0,91,0
2021-08-03,Amador,005,37829,4073,3953,34,3987,48
2021-08-03,Butte,007,227075,13844,13468,2106,15574,205
2021-08-03,Calaveras,009,45235,2439,2356,16,2372,57
2021-08-03,Colusa,011,21464,2080,2023,365,2388,16
2021-08-03,Contra Costa,013,1133247,79880,77739,1573,79312,836
2021-08-03,Del Norte,015,27424,1832,1691,14,1705,8
2021-08-03,El Dorado,017,186661,11692,11255,922,12177,117
2021-08-03,Fresno,019,978130,107914,105732,9348,115080,1746
2021-08-03,Glenn,021,27897,2539,2481,607,3088,20
2021-08-03,Humboldt,023,135768,5561,5199,89,5288,52
2021-08-03,Imperial,025,180216,29565,29333,2810,32143,745
2021-08-03,Inyo,027,18085,1475,1459,13,1472,38
2021-08-03,Kern,029,883053,101370,99708,12385,112093,1358
2021-08-03,Kings,031,150075,24324,23780,1216,24996,249
2021-08-03,Lake,033,64148,4615,4408,16,4424,66
2021-08-03,Lassen,035,31185,5413,5341,127,5468,21
2021-08-03,Los Angeles,037,10098052,1281428,1262678,47062,1309740,24721
2021-08-03,Madera,039,155013,17615,17220,1059,18279,245
2021-08-03,Marin,041,260295,15309,14906,301,15207,243
2021-08-03,Mariposa,043,17540,519,495,11,506,5
2021-08-03,Mendocino,045,87422,4747,4546,106,4652,49
2021-08-03,Merced,047,269075,32516,32197,1151,33348,476
2021-08-03,Modoc,049,8938,431,416,149,565,5
2021-08-03,Mono,051,14174,1319,1303,18,1321,3
2021-08-03,Monterey,053,433212,44273,43872,2060,45932,525
2021-08-03,Napa,055,140530,10718,10527,61,10588,82
2021-08-03,Nevada,057,99092,6028,5685,210,5895,73
2021-08-03,Orange,059,3164182,271363,266649,12444,279093,5146
2021-08-03,Placer,061,380077,26588,25624,2023,27647,305
2021-08-03,Plumas,063,18699,797,779,14,793,5
2021-08-03,Riverside,065,2383286,310357,303499,14814,318313,4562
2021-08-03,Sacramento,067,1510023,120566,117591,2295,119886,1732
2021-08-03,San Benito,069,59416,6348,6284,118,6402,63
2021-08-03,San Bernardino,071,2135413,307969,303386,9522,312908,5265
2021-08-03,San Diego,073,3302833,305019,300189,17525,317714,3803
2021-08-03,San Francisco,075,870044,43288,41758,1671,43429,562
2021-08-03,San Joaquin,077,732212,79110,77615,4050,81665,1461
2021-08-03,San Luis Obispo,079,281455,22720,22166,835,23001,264
2021-08-03,San Mateo,081,765935,46180,45255,648,45903,548
2021-08-03,Santa Barbara,083,443738,36482,35912,1244,37156,469
2021-08-03,Santa Clara,085,1922200,126215,123914,888,124802,2183
2021-08-03,Santa Cruz,087,273765,17147,16778,848,17626,207
2021-08-03,Shasta,089,179085,13449,13091,1807,14898,211
2021-08-03,Sierra,091,2930,78,72,12,84,0
2021-08-03,Siskiyou,093,43540,2117,1998,471,2469,32
2021-08-03,Solano,095,438530,37041,35953,788,36741,261
2021-08-03,Sonoma,097,501317,34176,33243,407,33650,330
2021-08-03,Stanislaus,099,539301,60311,59282,6477,65759,1037
2021-08-03,Sutter,101,95872,10439,10263,110,10373,127
2021-08-03,Tehama,103,63373,5387,5269,637,5906,66
2021-08-03,Trinity,105,12862,523,361,119,480,3
2021-08-03,Tulare,107,460477,51916,50729,9955,60684,854
2021-08-03,Tuolumne,109,53932,4685,4563,45,4608,64
2021-08-03,Ventura,111,848112,85677,84270,3582,87852,1046
2021-08-03,Yolo,113,214977,15520,15149,545,15694,215
2021-08-03,Yuba,115,75493,6958,6781,159,6940,50
2021-08-02,Alameda,001,1643700,99163,96954,2257,99211,1270
2021-08-02,Alpine,003,1148,90,91,0,91,0
2021-08-02,Amador,005,37829,4053,3927,34,3961,48
2021-08-02,Butte,007,227075,13764,13442,2087,15529,205
2021-08-02,Calaveras,009,45235,2413,2347,16,2363,57
2021-08-02,Colusa,011,21464,2068,2019,362,2381,16
2021-08-02,Contra Costa,013,1133247,79370,77516,1559,79075,836
2021-08-02,Del Norte,015,27424,1802,1653,14,1667,8
2021-08-02,El Dorado,017,186661,11589,11226,908,12134,116
2021-08-02,Fresno,019,978130,107568,105471,9310,114781,1744
2021-08-02,Glenn,021,27897,2531,2477,604,3081,20
2021-08-02,Humboldt,023,135768,5478,5161,87,5248,52
2021-08-02,Imperial,025,180216,29532,29302,2807,32109,743
2021-08-02,Inyo,027,18085,1469,1455,13,1468,38
2021-08-02,Kern,029,883053,101115,99556,12292,111848,1357
2021-08-02,Kings,031,150075,24254,23722,1210,24932,249
2021-08-02,Lake,033,64148,4572,4375,16,4391,66
2021-08-02,Lassen,035,31185,5390,5338,125,5463,21
2021-08-02,Los Angeles,037,10098052,1277709,1260807,46852,1307659,24705
2021-08-02,Madera,039,155013,17571,17158,1046,18204,245
2021-08-02,Marin,041,260295,15266,14859,299,15158,239
2021-08-02,Mariposa,043,17540,510,490,11,501,5
2021-08-02,Mendocino,045,87422,4707,4512,103,4615,49
2021-08-02,Merced,047,269075,32418,32163,1144,33307,474
2021-08-02,Modoc,049,8938,431,415,149,564,5
2021-08-02,Mono,051,14174,1312,1296,18,1314,3
2021-08-02,Monterey,053,433212,44213,43842,2052,45894,525
2021-08-02,Napa,055,140530,10675,10490,58,10548,82
2021-08-02,Nevada,057,99092,5957,5611,209,5820,73
2021-08-02,Orange,059,3164182,270449,266050,12398,278448,5146
2021-08-02,Placer,061,380077,26441,25516,1989,27505,306
2021-08-02,Plumas,063,18699,790,762,14,776,5
2021-08-02,Riverside,065,2383286,309419,302756,14799,317555,4562
2021-08-02,Sacramento,067,1510023,119869,117183,2274,119457,1728
2021-08-02,San Benito,069,59416,6329,6276,117,6393,63
2021-08-02,San Bernardino,071,2135413,307092,303000,9490,312490,5253
2021-08-02,San Diego,073,3302833,303539,299021,17445,316466,3798
2021-08-02,San Francisco,075,870044,43001,41553,1647,43200,562
2021-08-02,San Joaquin,077,732212,78767,77447,4023,81470,1461
2021-08-02,San Luis Obispo,079,281455,22626,22093,828,22921,261
2021-08-02,San Mateo,081,765935,46004,45154,635,45789,548
2021-08-02,Santa Barbara,083,443738,36343,35851,1238,37089,469
2021-08-02,Santa Clara,085,1922200,125745,123655,880,124535,2183
2021-08-02,Santa Cruz,087,273765,17089,16746,844,17590,207
2021-08-02,Shasta,089,179085,13386,13049,1793,14842,212
2021-08-02,Sierra,091,2930,78,71,12,83,0
2021-08-02,Siskiyou,093,43540,2106,1992,457,2449,31
2021-08-02,Solano,095,438530,36793,35852,775,36627,260
2021-08-02,Sonoma,097,501317,33950,33132,402,33534,330
2021-08-02,Stanislaus,099,539301,60092,59160,6449,65609,1037
2021-08-02,Sutter,101,95872,10393,10220,110,10330,127
2021-08-02,Tehama,103,63373,5363,5260,633,5893,66
2021-08-02,Trinity,105,12862,518,359,118,477,3
2021-08-02,Tulare,107,460477,51814,50640,9881,60521,854
2021-08-02,Tuolumne,109,53932,4618,4524,45,4569,64
2021-08-02,Ventura,111,848112,85492,84143,3559,87702,1044
2021-08-02,Yolo,113,214977,15422,15072,527,15599,215
2021-08-02,Yuba,115,75493,6916,6743,156,6899,50
2021-08-01,Alameda,001,1643700,98626,96775,2251,99026,1270
2021-08-01,Alpine,003,1148,90,91,0,91,0
2021-08-01,Amador,005,37829,4015,3923,34,3957,48
2021-08-01,Butte,007,227075,13683,13406,2070,15476,205
2021-08-01,Calaveras,009,45235,2389,2341,16,2357,57
2021-08-01,Colusa,011,21464,2057,2014,360,2374,16
2021-08-01,Contra Costa,013,1133247,78935,77360,1551,78911,836
2021-08-01,Del Norte,015,27424,1770,1642,14,1656,8
2021-08-01,El Dorado,017,186661,11488,11189,898,12087,116
2021-08-01,Fresno,019,978130,107242,105339,9263,114602,1744
2021-08-01,Glenn,021,27897,2525,2476,601,3077,20
2021-08-01,Humboldt,023,135768,5401,5118,83,5201,52
2021-08-01,Imperial,025,180216,29497,29297,2802,32099,743
2021-08-01,Inyo,027,18085,1467,1454,13,1467,38
2021-08-01,Kern,029,883053,100837,99396,12218,111614,1357
2021-08-01,Kings,031,150075,24167,23700,1205,24905,249
2021-08-01,Lake,033,64148,4493,4356,16,4372,66
2021-08-01,Lassen,035,31185,5377,5336,123,5459,21
2021-08-01,Los Angeles,037,10098052,1274022,1258461,46628,1305089,24700
2021-08-01,Madera,039,155013,17514,17146,1041,18187,245
2021-08-01,Marin,041,260295,15189,14844,298,15142,239
2021-08-01,Mariposa,043,17540,503,482,11,493,5
2021-08-01,Mendocino,045,87422,4661,4476,99,4575,49
2021-08-01,Merced,047,269075,32326,32144,1138,33282,474
2021-08-01,Modoc,049,8938,429,413,149,562,5
2021-08-01,Mono,051,14174,1309,1294,18,1312,3
2021-08-01,Monterey,053,433212,44166,43808,2039,45847,525
2021-08-01,Napa,055,140530,10627,10473,56,10529,82
2021-08-01,Nevada,057,99092,5870,5561,208,5769,73
2021-08-01,Orange,059,3164182,269636,265467,12355,277822,5146
2021-08-01,Placer,061,380077,26226,25464,1959,27423,306
2021-08-01,Plumas,063,18699,784,761,14,775,5
2021-08-01,Riverside,065,2383286,308486,302256,14781,317037,4562
2021-08-01,Sacramento,067,1510023,119133,116923,2258,119181,1727
2021-08-01,San Benito,069,59416,6312,6271,117,6388,63
2021-08-01,San Bernardino,071,2135413,306158,302542,9479,312021,5248
2021-08-01,San Diego,073,3302833,302353,298002,17380,315382,3798
2021-08-01,San Francisco,075,870044,42663,41432,1634,43066,562
2021-08-01,San Joaquin,077,732212,78401,77338,3996,81334,1461
2021-08-01,San Luis Obispo,079,281455,22523,22083,823,22906,261
2021-08-01,San Mateo,081,765935,45822,45036,627,45663,548
2021-08-01,Santa Barbara,083,443738,36219,35809,1234,37043,469
2021-08-01,Santa Clara,085,1922200,125333,123511,872,124383,2183
2021-08-01,Santa Cruz,087,273765,17010,16709,837,17546,207
2021-08-01,Shasta,089,179085,13315,13036,1784,14820,212
2021-08-01,Sierra,091,2930,76,71,12,83,0
2021-08-01,Siskiyou,093,43540,2100,1989,451,2440,31
2021-08-01,Solano,095,438530,36558,35800,766,36566,260
2021-08-01,Sonoma,097,501317,33758,33076,399,33475,330
2021-08-01,Stanislaus,099,539301,59855,59078,6417,65495,1037
2021-08-01,Sutter,101,95872,10338,10198,107,10305,127
2021-08-01,Tehama,103,63373,5346,5252,629,5881,66
2021-08-01,Trinity,105,12862,515,359,117,476,3
2021-08-01,Tulare,107,460477,51657,50600,9818,60418,854
2021-08-01,Tuolumne,109,53932,4580,4489,45,4534,64
2021-08-01,Ventura,111,848112,85262,84040,3544,87584,1044
2021-08-01,Yolo,113,214977,15350,15042,518,15560,215
2021-08-01,Yuba,115,75493,6879,6721,155,6876,50
2021-07-31,Alameda,001,1643700,98298,95279,2245,97524,1265
2021-07-31,Alpine,003,1148,90,89,0,89,0
2021-07-31,Amador,005,37829,3995,3877,34,3911,48
2021-07-31,Butte,007,227075,13650,13235,2050,15285,205
2021-07-31,Calaveras,009,45235,2380,2294,16,2310,57
2021-07-31,Colusa,011,21464,2051,2006,358,2364,16
2021-07-31,Contra Costa,013,1133247,78656,75866,1549,77415,832
2021-07-31,Del Norte,015,27424,1744,1576,14,1590,8
2021-07-31,El Dorado,017,186661,11435,11017,892,11909,116
2021-07-31,Fresno,019,978130,107083,104639,9249,113888,1744
2021-07-31,Glenn,021,27897,2520,2465,596,3061,20
2021-07-31,Humboldt,023,135768,5346,4978,82,5060,52
2021-07-31,Imperial,025,180216,29480,29164,2799,31963,743
2021-07-31,Inyo,027,18085,1464,1442,13,1455,38
2021-07-31,Kern,029,883053,100672,98903,12159,111062,1357
2021-07-31,Kings,031,150075,24114,23548,1200,24748,248
2021-07-31,Lake,033,64148,4468,4238,16,4254,66
2021-07-31,Lassen,035,31185,5370,5320,123,5443,21
2021-07-31,Los Angeles,037,10098052,1271826,1248545,46481,1295026,24691
2021-07-31,Madera,039,155013,17481,17058,1035,18093,245
2021-07-31,Marin,041,260295,15145,14701,297,14998,239
2021-07-31,Mariposa,043,17540,494,470,11,481,5
2021-07-31,Mendocino,045,87422,4636,4400,96,4496,49
2021-07-31,Merced,047,269075,32278,31959,1133,33092,474
2021-07-31,Modoc,049,8938,429,413,149,562,5
2021-07-31,Mono,051,14174,1307,1287,18,1305,3
2021-07-31,Monterey,053,433212,44127,43720,2029,45749,525
2021-07-31,Napa,055,140530,10607,10401,55,10456,82
2021-07-31,Nevada,057,99092,5831,5373,207,5580,72
2021-07-31,Orange,059,3164182,269062,263446,12336,275782,5144
2021-07-31,Placer,061,380077,26093,25104,1952,27056,306
2021-07-31,Plumas,063,18699,781,743,14,757,5
2021-07-31,Riverside,065,2383286,307870,300315,14771,315086,4554
2021-07-31,Sacramento,067,1510023,118721,115259,2252,117511,1720
2021-07-31,San Benito,069,59416,6301,6251,117,6368,63
2021-07-31,San Bernardino,071,2135413,305586,300726,9476,310202,5240
2021-07-31,San Diego,073,3302833,301680,295054,17334,312388,3798
2021-07-31,San Francisco,075,870044,42436,40412,1614,42026,562
2021-07-31,San Joaquin,077,732212,78236,76575,3983,80558,1443
2021-07-31,San Luis Obispo,079,281455,22469,21922,821,22743,260
2021-07-31,San Mateo,081,765935,45665,44622,622,45244,548
2021-07-31,Santa Barbara,083,443738,36138,35531,1233,36764,467
2021-07-31,Santa Clara,085,1922200,125078,122614,870,123484,2099
2021-07-31,Santa Cruz,087,273765,16971,16576,836,17412,207
2021-07-31,Shasta,089,179085,13278,12918,1776,14694,212
2021-07-31,Sierra,091,2930,76,68,12,80,0
2021-07-31,Siskiyou,093,43540,2091,1976,445,2421,31
2021-07-31,Solano,095,438530,36457,35340,758,36098,263
2021-07-31,Sonoma,097,501317,33632,32601,399,33000,329
2021-07-31,Stanislaus,099,539301,59696,58586,6394,64980,1035
2021-07-31,Sutter,101,95872,10304,10068,106,10174,127
2021-07-31,Tehama,103,63373,5331,5216,626,5842,66
2021-07-31,Trinity,105,12862,514,354,116,470,3
2021-07-31,Tulare,107,460477,51568,50409,9765,60174,854
2021-07-31,Tuolumne,109,53932,4541,4362,45,4407,64
2021-07-31,Ventura,111,848112,85101,83509,3527,87036,1044
2021-07-31,Yolo,113,214977,15302,14863,507,15370,215
2021-07-31,Yuba,115,75493,6856,6615,151,6766,50
2021-07-30,Alameda,001,1643700,97966,95279,2241,97520,1265
2021-07-30,Alpine,003,1148,90,89,0,89,0
2021-07-30,Amador,005,37829,3972,3877,34,3911,48
2021-07-30,Butte,007,227075,13595,13235,2037,15272,205
2021-07-30,Calaveras,009,45235,2370,2294,16,2310,57
2021-07-30,Colusa,011,21464,2047,2006,356,2362,16
2021-07-30,Contra Costa,013,1133247,78412,75866,1545,77411,832
2021-07-30,Del Norte,015,27424,1726,1576,14,1590,8
2021-07-30,El Dorado,017,186661,11402,11017,886,11903,116
2021-07-30,Fresno,019,978130,106889,104639,9237,113876,1744
2021-07-30,Glenn,021,27897,2515,2465,595,3060,20
2021-07-30,Humboldt,023,135768,5282,4978,79,5057,52
2021-07-30,Imperial,025,180216,29466,29164,2796,31960,743
2021-07-30,Inyo,027,18085,1463,1442,13,1455,38
2021-07-30,Kern,029,883053,100547,98903,12112,111015,1357
2021-07-30,Kings,031,150075,24074,23548,1196,24744,248
2021-07-30,Lake,033,64148,4440,4238,16,4254,66
2021-07-30,Lassen,035,31185,5366,5320,123,5443,21
2021-07-30,Los Angeles,037,10098052,1269505,1248545,46330,1294875,24691
2021-07-30,Madera,039,155013,17439,17058,1032,18090,245
2021-07-30,Marin,041,260295,15111,14701,297,14998,239
2021-07-30,Mariposa,043,17540,490,470,11,481,5
2021-07-30,Mendocino,045,87422,4606,4400,95,4495,49
2021-07-30,Merced,047,269075,32237,31959,1129,33088,474
2021-07-30,Modoc,049,8938,427,413,149,562,5
2021-07-30,Mono,051,14174,1302,1287,18,1305,3
2021-07-30,Monterey,053,433212,44093,43720,2020,45740,525
2021-07-30,Napa,055,140530,10585,10401,54,10455,82
2021-07-30,Nevada,057,99092,5774,5373,207,5580,72
2021-07-30,Orange,059,3164182,268436,263446,12310,275756,5144
2021-07-30,Placer,061,380077,26004,25104,1934,27038,306
2021-07-30,Plumas,063,18699,776,743,14,757,5
2021-07-30,Riverside,065,2383286,307232,300315,14761,315076,4554
2021-07-30,Sacramento,067,1510023,118270,115259,2248,117507,1720
2021-07-30,San Benito,069,59416,6294,6251,117,6368,63
2021-07-30,San Bernardino,071,2135413,305072,300726,9470,310196,5240
2021-07-30,San Diego,073,3302833,300907,295054,17276,312330,3798
2021-07-30,San Francisco,075,870044,42223,40412,1599,42011,562
2021-07-30,San Joaquin,077,732212,78082,76575,3978,80553,1443
2021-07-30,San Luis Obispo,079,281455,22431,21922,817,22739,260
2021-07-30,San Mateo,081,765935,45540,44622,609,45231,548
2021-07-30,Santa Barbara,083,443738,36069,35531,1227,36758,467
2021-07-30,Santa Clara,085,1922200,124854,122614,868,123482,2099
2021-07-30,Santa Cruz,087,273765,16945,16576,834,17410,207
2021-07-30,Shasta,089,179085,13232,12918,1776,14694,212
2021-07-30,Sierra,091,2930,75,68,12,80,0
2021-07-30,Siskiyou,093,43540,2082,1976,444,2420,31
2021-07-30,Solano,095,438530,36366,35340,742,36082,263
2021-07-30,Sonoma,097,501317,33537,32601,399,33000,329
2021-07-30,Stanislaus,099,539301,59552,58586,6374,64960,1035
2021-07-30,Sutter,101,95872,10269,10068,106,10174,127
2021-07-30,Tehama,103,63373,5320,5216,626,5842,66
2021-07-30,Trinity,105,12862,514,354,116,470,3
2021-07-30,Tulare,107,460477,51525,50409,9730,60139,854
2021-07-30,Tuolumne,109,53932,4523,4362,45,4407,64
2021-07-30,Ventura,111,848112,84937,83509,3512,87021,1044
2021-07-30,Yolo,113,214977,15241,14863,503,15366,215
2021-07-30,Yuba,115,75493,6820,6615,150,6765,50
2021-07-29,Alameda,001,1643700,97546,95279,2235,97514,1265
2021-07-29,Alpine,003,1148,90,89,0,89,0
2021-07-29,Amador,005,37829,3953,3877,34,3911,48
2021-07-29,Butte,007,227075,13548,13235,2029,15264,205
2021-07-29,Calaveras,009,45235,2356,2294,16,2310,57
2021-07-29,Colusa,011,21464,2040,2006,356,2362,16
2021-07-29,Contra Costa,013,1133247,77973,75866,1541,77407,832
2021-07-29,Del Norte,015,27424,1702,1576,14,1590,8
2021-07-29,El Dorado,017,186661,11338,11017,874,11891,116
2021-07-29,Fresno,019,978130,106624,104639,9209,113848,1744
2021-07-29,Glenn,021,27897,2505,2465,594,3059,20
2021-07-29,Humboldt,023,135768,5222,4978,77,5055,52
2021-07-29,Imperial,025,180216,29420,29164,2794,31958,743
2021-07-29,Inyo,027,18085,1459,1442,13,1455,38
2021-07-29,Kern,029,883053,100341,98903,12034,110937,1357
2021-07-29,Kings,031,150075,24028,23548,1192,24740,248
2021-07-29,Lake,033,64148,4405,4238,16,4254,66
2021-07-29,Lassen,035,31185,5358,5320,120,5440,21
2021-07-29,Los Angeles,037,10098052,1266415,1248545,46144,1294689,24691
2021-07-29,Madera,039,155013,17392,17058,1028,18086,245
2021-07-29,Marin,041,260295,15068,14701,297,14998,239
2021-07-29,Mariposa,043,17540,486,470,11,481,5
2021-07-29,Mendocino,045,87422,4583,4400,93,4493,49
2021-07-29,Merced,047,269075,32182,31959,1129,33088,474
2021-07-29,Modoc,049,8938,427,413,149,562,5
2021-07-29,Mono,051,14174,1300,1287,18,1305,3
2021-07-29,Monterey,053,433212,44044,43720,2010,45730,525
2021-07-29,Napa,055,140530,10553,10401,52,10453,82
2021-07-29,Nevada,057,99092,5722,5373,206,5579,72
2021-07-29,Orange,059,3164182,267724,263446,12278,275724,5144
2021-07-29,Placer,061,380077,25881,25104,1919,27023,306
2021-07-29,Plumas,063,18699,768,743,14,757,5
2021-07-29,Riverside,065,2383286,306527,300315,14737,315052,4554
2021-07-29,Sacramento,067,1510023,117715,115259,2235,117494,1720
2021-07-29,San Benito,069,59416,6283,6251,117,6368,63
2021-07-29,San Bernardino,071,2135413,304433,300726,9460,310186,5240
2021-07-29,San Diego,073,3302833,299849,295054,17208,312262,3798
2021-07-29,San Francisco,075,870044,41976,40412,1578,41990,562
2021-07-29,San Joaquin,077,732212,77826,76575,3970,80545,1443
2021-07-29,San Luis Obispo,079,281455,22377,21922,815,22737,260
2021-07-29,San Mateo,081,765935,45413,44622,599,45221,548
2021-07-29,Santa Barbara,083,443738,35983,35531,1226,36757,467
2021-07-29,Santa Clara,085,1922200,124557,122614,865,123479,2099
2021-07-29,Santa Cruz,087,273765,16892,16576,832,17408,207
2021-07-29,Shasta,089,179085,13178,12918,1767,14685,212
2021-07-29,Sierra,091,2930,75,68,12,80,0
2021-07-29,Siskiyou,093,43540,2077,1976,442,2418,31
2021-07-29,Solano,095,438530,36206,35340,732,36072,263
2021-07-29,Sonoma,097,501317,33363,32601,397,32998,329
2021-07-29,Stanislaus,099,539301,59380,58586,6359,64945,1035
2021-07-29,Sutter,101,95872,10223,10068,105,10173,127
2021-07-29,Tehama,103,63373,5308,5216,620,5836,66
2021-07-29,Trinity,105,12862,512,354,115,469,3
2021-07-29,Tulare,107,460477,51435,50409,9690,60099,854
2021-07-29,Tuolumne,109,53932,4483,4362,44,4406,64
2021-07-29,Ventura,111,848112,84771,83509,3505,87014,1044
2021-07-29,Yolo,113,214977,15173,14863,489,15352,215
2021-07-29,Yuba,115,75493,6771,6615,147,6762,50
2021-07-28,Alameda,001,1643700,97080,94965,2228,97193,1262
2021-07-28,Alpine,003,1148,90,89,0,89,0
2021-07-28,Amador,005,37829,3939,3870,34,3904,48
2021-07-28,Butte,007,227075,13491,13184,2016,15200,205
2021-07-28,Calaveras,009,45235,2336,2289,16,2305,57
2021-07-28,Colusa,011,21464,2037,2001,355,2356,16
2021-07-28,Contra Costa,013,1133247,77486,75487,1533,77020,832
2021-07-28,Del Norte,015,27424,1669,1545,14,1559,8
2021-07-28,El Dorado,017,186661,11289,10967,864,11831,116
2021-07-28,Fresno,019,978130,106376,104458,9188,113646,1744
2021-07-28,Glenn,021,27897,2502,2464,591,3055,20
2021-07-28,Humboldt,023,135768,5171,4946,76,5022,52
2021-07-28,Imperial,025,180216,29373,29096,2794,31890,743
2021-07-28,Inyo,027,18085,1453,1439,12,1451,38
2021-07-28,Kern,029,883053,100185,98781,11987,110768,1352
2021-07-28,Kings,031,150075,23964,23503,1182,24685,248
2021-07-28,Lake,033,64148,4359,4191,15,4206,65
2021-07-28,Lassen,035,31185,5350,5318,120,5438,21
2021-07-28,Los Angeles,037,10098052,1263251,1245485,45957,1291442,24673
2021-07-28,Madera,039,155013,17351,17024,1022,18046,245
2021-07-28,Marin,041,260295,15013,14652,297,14949,239
2021-07-28,Mariposa,043,17540,479,469,11,480,5
2021-07-28,Mendocino,045,87422,4555,4377,93,4470,49
2021-07-28,Merced,047,269075,32126,31886,1125,33011,474
2021-07-28,Modoc,049,8938,425,413,149,562,5
2021-07-28,Mono,051,14174,1299,1286,18,1304,3
2021-07-28,Monterey,053,433212,43997,43668,2000,45668,524
2021-07-28,Napa,055,140530,10513,10376,50,10426,82
2021-07-28,Nevada,057,99092,5668,5320,206,5526,72
2021-07-28,Orange,059,3164182,266931,262735,12248,274983,5143
2021-07-28,Placer,061,380077,25734,24978,1903,26881,306
2021-07-28,Plumas,063,18699,763,754,14,768,5
2021-07-28,Riverside,065,2383286,305759,299611,14718,314329,4554
2021-07-28,Sacramento,067,1510023,117064,114665,2215,116880,1714
2021-07-28,San Benito,069,59416,6272,6236,117,6353,63
2021-07-28,San Bernardino,071,2135413,303812,300121,9448,309569,5236
2021-07-28,San Diego,073,3302833,298568,294176,17142,311318,3798
2021-07-28,San Francisco,075,870044,41673,40144,1552,41696,561
2021-07-28,San Joaquin,077,732212,77575,76312,3940,80252,1443
2021-07-28,San Luis Obispo,079,281455,22318,21865,814,22679,260
2021-07-28,San Mateo,081,765935,45263,44477,590,45067,547
2021-07-28,Santa Barbara,083,443738,35908,35431,1221,36652,467
2021-07-28,Santa Clara,085,1922200,124296,122345,863,123208,2099
2021-07-28,Santa Cruz,087,273765,16854,16551,831,17382,207
2021-07-28,Shasta,089,179085,13134,12882,1757,14639,212
2021-07-28,Sierra,091,2930,71,67,12,79,0
2021-07-28,Siskiyou,093,43540,2068,1971,439,2410,31
2021-07-28,Solano,095,438530,36032,35204,725,35929,262
2021-07-28,Sonoma,097,501317,33220,32434,394,32828,328
2021-07-28,Stanislaus,099,539301,59183,58427,6343,64770,1035
2021-07-28,Sutter,101,95872,10191,10033,104,10137,126
2021-07-28,Tehama,103,63373,5296,5209,617,5826,66
2021-07-28,Trinity,105,12862,511,352,115,467,3
2021-07-28,Tulare,107,460477,51347,50363,9643,60006,854
2021-07-28,Tuolumne,109,53932,4444,4313,44,4357,64
2021-07-28,Ventura,111,848112,84575,83360,3489,86849,1043
2021-07-28,Yolo,113,214977,15101,14801,480,15281,215
2021-07-28,Yuba,115,75493,6738,6591,146,6737,51
2021-07-27,Alameda,001,1643700,96677,94682,2219,96901,1256
2021-07-27,Alpine,003,1148,90,89,0,89,0
2021-07-27,Amador,005,37829,3923,3861,34,3895,48
2021-07-27,Butte,007,227075,13443,13127,2005,15132,205
2021-07-27,Calaveras,009,45235,2326,2280,16,2296,57
2021-07-27,Colusa,011,21464,2028,1999,354,2353,16
2021-07-27,Contra Costa,013,1133247,77001,75227,1529,76756,830
2021-07-27,Del Norte,015,27424,1649,1538,14,1552,8
2021-07-27,El Dorado,017,186661,11229,10941,854,11795,116
2021-07-27,Fresno,019,978130,106083,104288,9164,113452,1746
2021-07-27,Glenn,021,27897,2494,2460,589,3049,20
2021-07-27,Humboldt,023,135768,5117,4925,75,5000,52
2021-07-27,Imperial,025,180216,29328,29048,2793,31841,743
2021-07-27,Inyo,027,18085,1451,1430,12,1442,38
2021-07-27,Kern,029,883053,100015,98724,11931,110655,1352
2021-07-27,Kings,031,150075,23907,23463,1172,24635,248
2021-07-27,Lake,033,64148,4320,4157,15,4172,65
2021-07-27,Lassen,035,31185,5344,5315,120,5435,21
2021-07-27,Los Angeles,037,10098052,1259796,1243336,45745,1289081,24658
2021-07-27,Madera,039,155013,17298,16998,1017,18015,245
2021-07-27,Marin,041,260295,14965,14631,294,14925,239
2021-07-27,Mariposa,043,17540,476,468,11,479,5
2021-07-27,Mendocino,045,87422,4532,4371,93,4464,49
2021-07-27,Merced,047,269075,32059,31825,1122,32947,473
2021-07-27,Modoc,049,8938,424,413,149,562,5
2021-07-27,Mono,051,14174,1295,1288,18,1306,3
2021-07-27,Monterey,053,433212,43957,43646,1989,45635,523
2021-07-27,Napa,055,140530,10483,10354,50,10404,82
2021-07-27,Nevada,057,99092,5591,5305,204,5509,72
2021-07-27,Orange,059,3164182,266187,262193,12223,274416,5143
2021-07-27,Placer,061,380077,25575,24916,1877,26793,306
2021-07-27,Plumas,063,18699,760,752,14,766,5
2021-07-27,Riverside,065,2383286,305030,299160,14699,313859,4554
2021-07-27,Sacramento,067,1510023,116461,114413,2206,116619,1710
2021-07-27,San Benito,069,59416,6263,6229,117,6346,63
2021-07-27,San Bernardino,071,2135413,303123,299593,9426,309019,5236
2021-07-27,San Diego,073,3302833,297477,293408,17068,310476,3798
2021-07-27,San Francisco,075,870044,41315,39939,1534,41473,561
2021-07-27,San Joaquin,077,732212,77312,76166,3920,80086,1442
2021-07-27,San Luis Obispo,079,281455,22263,21803,805,22608,260
2021-07-27,San Mateo,081,765935,45111,44378,587,44965,547
2021-07-27,Santa Barbara,083,443738,35813,35355,1219,36574,467
2021-07-27,Santa Clara,085,1922200,124002,122154,861,123015,2099
2021-07-27,Santa Cruz,087,273765,16808,16523,830,17353,207
2021-07-27,Shasta,089,179085,13084,12846,1744,14590,212
2021-07-27,Sierra,091,2930,71,65,12,77,0
2021-07-27,Siskiyou,093,43540,2063,1964,436,2400,31
2021-07-27,Solano,095,438530,35900,35093,715,35808,261
2021-07-27,Sonoma,097,501317,33076,32367,392,32759,328
2021-07-27,Stanislaus,099,539301,59013,58333,6315,64648,1033
2021-07-27,Sutter,101,95872,10150,9998,104,10102,115
2021-07-27,Tehama,103,63373,5275,5192,615,5807,66
2021-07-27,Trinity,105,12862,510,351,115,466,3
2021-07-27,Tulare,107,460477,51281,50324,9612,59936,854
2021-07-27,Tuolumne,109,53932,4392,4282,44,4326,64
2021-07-27,Ventura,111,848112,84367,83189,3477,86666,1043
2021-07-27,Yolo,113,214977,15027,14759,475,15234,215
2021-07-27,Yuba,115,75493,6716,6564,144,6708,51
2021-07-26,Alameda,001,1643700,96234,94436,2213,96649,1259
2021-07-26,Alpine,003,1148,90,89,0,89,0
2021-07-26,Amador,005,37829,3913,3854,34,3888,48
2021-07-26,Butte,007,227075,13388,13082,1994,15076,203
2021-07-26,Calaveras,009,45235,2320,2276,16,2292,57
2021-07-26,Colusa,011,21464,2021,1996,352,2348,16
2021-07-26,Contra Costa,013,1133247,76505,74854,1522,76376,830
2021-07-26,Del Norte,015,27424,1628,1530,14,1544,8
2021-07-26,El Dorado,017,186661,11165,10899,851,11750,116
2021-07-26,Fresno,019,978130,105879,104143,9140,113283,1742
2021-07-26,Glenn,021,27897,2492,2461,588,3049,20
2021-07-26,Humboldt,023,135768,5078,4906,73,4979,52
2021-07-26,Imperial,025,180216,29288,29034,2793,31827,743
2021-07-26,Inyo,027,18085,1446,1429,12,1441,38
2021-07-26,Kern,029,883053,99849,98633,11866,110499,1351
2021-07-26,Kings,031,150075,23858,23426,1168,24594,247
2021-07-26,Lake,033,64148,4299,4133,15,4148,65
2021-07-26,Lassen,035,31185,5340,5314,120,5434,21
2021-07-26,Los Angeles,037,10098052,1256460,1241527,45571,1287098,24647
2021-07-26,Madera,039,155013,17270,16971,1010,17981,245
2021-07-26,Marin,041,260295,14908,14579,293,14872,239
2021-07-26,Mariposa,043,17540,475,467,11,478,5
2021-07-26,Mendocino,045,87422,4511,4354,93,4447,49
2021-07-26,Merced,047,269075,31968,31774,1118,32892,473
2021-07-26,Modoc,049,8938,424,413,149,562,5
2021-07-26,Mono,051,14174,1294,1286,18,1304,3
2021-07-26,Monterey,053,433212,43914,43595,1976,45571,521
2021-07-26,Napa,055,140530,10460,10332,50,10382,82
2021-07-26,Nevada,057,99092,5505,5280,204,5484,72
2021-07-26,Orange,059,3164182,265549,261803,12202,274005,5142
2021-07-26,Placer,061,380077,25439,24842,1856,26698,304
2021-07-26,Plumas,063,18699,756,750,14,764,5
2021-07-26,Riverside,065,2383286,304337,298626,14685,313311,4553
2021-07-26,Sacramento,067,1510023,115862,113986,2190,116176,1705
2021-07-26,San Benito,069,59416,6257,6222,117,6339,63
2021-07-26,San Bernardino,071,2135413,302508,299238,9414,308652,5237
2021-07-26,San Diego,073,3302833,296366,292688,16990,309678,3793
2021-07-26,San Francisco,075,870044,40954,39800,1508,41308,561
2021-07-26,San Joaquin,077,732212,77077,76033,3916,79949,1440
2021-07-26,San Luis Obispo,079,281455,22214,21752,802,22554,260
2021-07-26,San Mateo,081,765935,44963,44297,578,44875,547
2021-07-26,Santa Barbara,083,443738,35740,35311,1207,36518,467
2021-07-26,Santa Clara,085,1922200,123693,121978,852,122830,2099
2021-07-26,Santa Cruz,087,273765,16768,16493,827,17320,207
2021-07-26,Shasta,089,179085,13035,12819,1731,14550,211
2021-07-26,Sierra,091,2930,70,65,12,77,0
2021-07-26,Siskiyou,093,43540,2060,1962,434,2396,31
2021-07-26,Solano,095,438530,35745,34990,707,35697,259
2021-07-26,Sonoma,097,501317,32940,32283,390,32673,328
2021-07-26,Stanislaus,099,539301,58868,58219,6295,64514,1033
2021-07-26,Sutter,101,95872,10110,9963,101,10064,115
2021-07-26,Tehama,103,63373,5265,5183,611,5794,66
2021-07-26,Trinity,105,12862,510,351,114,465,3
2021-07-26,Tulare,107,460477,51215,50265,9581,59846,854
2021-07-26,Tuolumne,109,53932,4361,4271,44,4315,64
2021-07-26,Ventura,111,848112,84194,83072,3462,86534,1041
2021-07-26,Yolo,113,214977,14966,14727,463,15190,215
2021-07-26,Yuba,115,75493,6682,6538,142,6680,51
2021-07-25,Alameda,001,1643700,95741,94146,2207,96353,1259
2021-07-25,Alpine,003,1148,88,89,0,89,0
2021-07-25,Amador,005,37829,3898,3848,34,3882,48
2021-07-25,Butte,007,227075,13349,13074,1984,15058,203
2021-07-25,Calaveras,009,45235,2311,2275,16,2291,57
2021-07-25,Colusa,011,21464,2012,1996,348,2344,16
2021-07-25,Contra Costa,013,1133247,76020,74634,1508,76142,830
2021-07-25,Del Norte,015,27424,1607,1526,14,1540,8
2021-07-25,El Dorado,017,186661,11108,10878,848,11726,116
2021-07-25,Fresno,019,978130,105638,104019,9124,113143,1742
2021-07-25,Glenn,021,27897,2483,2461,586,3047,20
2021-07-25,Humboldt,023,135768,5019,4892,72,4964,52
2021-07-25,Imperial,025,180216,29251,29037,2793,31830,743
2021-07-25,Inyo,027,18085,1441,1427,12,1439,38
2021-07-25,Kern,029,883053,99677,98503,11795,110298,1351
2021-07-25,Kings,031,150075,23804,23396,1164,24560,247
2021-07-25,Lake,033,64148,4246,4109,14,4123,65
2021-07-25,Lassen,035,31185,5335,5314,120,5434,21
2021-07-25,Los Angeles,037,10098052,1253049,1239596,45373,1284969,24643
2021-07-25,Madera,039,155013,17233,16947,1003,17950,245
2021-07-25,Marin,041,260295,14858,14558,290,14848,239
2021-07-25,Mariposa,043,17540,472,465,11,476,5
2021-07-25,Mendocino,045,87422,4482,4335,91,4426,49
2021-07-25,Merced,047,269075,31895,31760,1116,32876,473
2021-07-25,Modoc,049,8938,424,413,149,562,5
2021-07-25,Mono,051,14174,1291,1286,18,1304,3
2021-07-25,Monterey,053,433212,43876,43590,1968,45558,521
2021-07-25,Napa,055,140530,10424,10316,49,10365,82
2021-07-25,Nevada,057,99092,5440,5256,201,5457,72
2021-07-25,Orange,059,3164182,264841,261351,12179,273530,5142
2021-07-25,Placer,061,380077,25317,24755,1835,26590,304
2021-07-25,Plumas,063,18699,754,750,14,764,5
2021-07-25,Riverside,065,2383286,303573,298181,14667,312848,4553
2021-07-25,Sacramento,067,1510023,115312,113611,2174,115785,1704
2021-07-25,San Benito,069,59416,6250,6217,117,6334,63
2021-07-25,San Bernardino,071,2135413,301848,298982,9408,308390,5237
2021-07-25,San Diego,073,3302833,295300,290626,16918,307544,3793
2021-07-25,San Francisco,075,870044,40604,39663,1482,41145,561
2021-07-25,San Joaquin,077,732212,76822,75926,3897,79823,1440
2021-07-25,San Luis Obispo,079,281455,22141,21741,799,22540,260
2021-07-25,San Mateo,081,765935,44800,44189,572,44761,547
2021-07-25,Santa Barbara,083,443738,35660,35261,1204,36465,467
2021-07-25,Santa Clara,085,1922200,123363,121800,847,122647,2099
2021-07-25,Santa Cruz,087,273765,16721,16474,826,17300,207
2021-07-25,Shasta,089,179085,12988,12815,1726,14541,211
2021-07-25,Sierra,091,2930,70,65,12,77,0
2021-07-25,Siskiyou,093,43540,2052,1963,431,2394,31
2021-07-25,Solano,095,438530,35553,34863,704,35567,259
2021-07-25,Sonoma,097,501317,32815,32202,387,32589,328
2021-07-25,Stanislaus,099,539301,58702,58154,6290,64444,1033
2021-07-25,Sutter,101,95872,10057,9937,99,10036,115
2021-07-25,Tehama,103,63373,5249,5181,610,5791,66
2021-07-25,Trinity,105,12862,508,351,112,463,3
2021-07-25,Tulare,107,460477,51140,50221,9543,59764,854
2021-07-25,Tuolumne,109,53932,4309,4267,44,4311,64
2021-07-25,Ventura,111,848112,83980,82986,3439,86425,1041
2021-07-25,Yolo,113,214977,14905,14693,449,15142,215
2021-07-25,Yuba,115,75493,6649,6519,142,6661,51
2021-07-24,Alameda,001,1643700,95465,93170,2203,95373,1259
2021-07-24,Alpine,003,1148,88,89,0,89,0
2021-07-24,Amador,005,37829,3889,3816,34,3850,48
2021-07-24,Butte,007,227075,13320,12982,1982,14964,203
2021-07-24,Calaveras,009,45235,2306,2267,16,2283,57
2021-07-24,Colusa,011,21464,2011,1992,346,2338,16
2021-07-24,Contra Costa,013,1133247,75792,73682,1505,75187,830
2021-07-24,Del Norte,015,27424,1596,1497,14,1511,8
2021-07-24,El Dorado,017,186661,11074,10773,845,11618,116
2021-07-24,Fresno,019,978130,105520,103637,9114,112751,1736
2021-07-24,Glenn,021,27897,2481,2457,586,3043,20
2021-07-24,Humboldt,023,135768,4984,4780,71,4851,52
2021-07-24,Imperial,025,180216,29231,28996,2793,31789,742
2021-07-24,Inyo,027,18085,1438,1424,12,1436,38
2021-07-24,Kern,029,883053,99599,98261,11773,110034,1350
2021-07-24,Kings,031,150075,23773,23304,1161,24465,246
2021-07-24,Lake,033,64148,4223,3963,14,3977,64
2021-07-24,Lassen,035,31185,5334,5311,120,5431,21
2021-07-24,Los Angeles,037,10098052,1251274,1232164,45240,1277404,24623
2021-07-24,Madera,039,155013,17209,16885,1001,17886,245
2021-07-24,Marin,041,260295,14819,14454,290,14744,238
2021-07-24,Mariposa,043,17540,472,453,11,464,5
2021-07-24,Mendocino,045,87422,4457,4293,91,4384,49
2021-07-24,Merced,047,269075,31873,31661,1115,32776,473
2021-07-24,Modoc,049,8938,424,413,149,562,5
2021-07-24,Mono,051,14174,1289,1284,18,1302,3
2021-07-24,Monterey,053,433212,43851,43525,1961,45486,521
2021-07-24,Napa,055,140530,10408,10230,49,10279,81
2021-07-24,Nevada,057,99092,5408,5183,201,5384,72
2021-07-24,Orange,059,3164182,264377,259973,12167,272140,5141
2021-07-24,Placer,061,380077,25234,24530,1830,26360,303
2021-07-24,Plumas,063,18699,753,737,14,751,4
2021-07-24,Riverside,065,2383286,303105,296912,14657,311569,4552
2021-07-24,Sacramento,067,1510023,114997,112438,2170,114608,1698
2021-07-24,San Benito,069,59416,6246,6200,116,6316,63
2021-07-24,San Bernardino,071,2135413,301456,297899,9399,307298,5236
2021-07-24,San Diego,073,3302833,294834,289368,16890,306258,3788
2021-07-24,San Francisco,075,870044,40430,38954,1466,40420,561
2021-07-24,San Joaquin,077,732212,76694,75461,3886,79347,1436
2021-07-24,San Luis Obispo,079,281455,22110,21616,797,22413,260
2021-07-24,San Mateo,081,765935,44682,43880,566,44446,542
2021-07-24,Santa Barbara,083,443738,35601,35071,1200,36271,465
2021-07-24,Santa Clara,085,1922200,123151,121092,846,121938,2099
2021-07-24,Santa Cruz,087,273765,16698,16416,826,17242,207
2021-07-24,Shasta,089,179085,12960,12759,1723,14482,211
2021-07-24,Sierra,091,2930,69,64,12,76,0
2021-07-24,Siskiyou,093,43540,2052,1951,431,2382,31
2021-07-24,Solano,095,438530,35461,34499,695,35194,259
2021-07-24,Sonoma,097,501317,32690,31928,385,32313,327
2021-07-24,Stanislaus,099,539301,58610,57879,6280,64159,1030
2021-07-24,Sutter,101,95872,10030,9890,99,9989,115
2021-07-24,Tehama,103,63373,5242,5166,608,5774,65
2021-07-24,Trinity,105,12862,508,345,112,457,3
2021-07-24,Tulare,107,460477,51097,50104,9525,59629,854
2021-07-24,Tuolumne,109,53932,4283,4216,44,4260,64
2021-07-24,Ventura,111,848112,83853,82687,3422,86109,1041
2021-07-24,Yolo,113,214977,14867,14557,446,15003,214
2021-07-24,Yuba,115,75493,6630,6449,142,6591,51
2021-07-23,Alameda,001,1643700,95214,93170,2198,95368,1259
2021-07-23,Alpine,003,1148,88,89,0,89,0
2021-07-23,Amador,005,37829,3882,3816,34,3850,48
2021-07-23,Butte,007,227075,13291,12982,1974,14956,203
2021-07-23,Calaveras,009,45235,2296,2267,16,2283,57
2021-07-23,Colusa,011,21464,2010,1992,346,2338,16
2021-07-23,Contra Costa,013,1133247,75532,73682,1495,75177,830
2021-07-23,Del Norte,015,27424,1588,1497,14,1511,8
2021-07-23,El Dorado,017,186661,11045,10773,841,11614,116
2021-07-23,Fresno,019,978130,105388,103637,9104,112741,1736
2021-07-23,Glenn,021,27897,2479,2457,583,3040,20
2021-07-23,Humboldt,023,135768,4962,4780,68,4848,52
2021-07-23,Imperial,025,180216,29219,28996,2793,31789,742
2021-07-23,Inyo,027,18085,1435,1424,12,1436,38
2021-07-23,Kern,029,883053,99517,98261,11747,110008,1350
2021-07-23,Kings,031,150075,23742,23304,1158,24462,246
2021-07-23,Lake,033,64148,4194,3963,14,3977,64
2021-07-23,Lassen,035,31185,5332,5311,120,5431,21
2021-07-23,Los Angeles,037,10098052,1249342,1232164,45128,1277292,24623
2021-07-23,Madera,039,155013,17179,16885,996,17881,245
2021-07-23,Marin,041,260295,14782,14454,288,14742,238
2021-07-23,Mariposa,043,17540,469,453,11,464,5
2021-07-23,Mendocino,045,87422,4444,4293,91,4384,49
2021-07-23,Merced,047,269075,31848,31661,1115,32776,473
2021-07-23,Modoc,049,8938,424,413,149,562,5
2021-07-23,Mono,051,14174,1288,1284,18,1302,3
2021-07-23,Monterey,053,433212,43825,43525,1961,45486,521
2021-07-23,Napa,055,140530,10387,10230,49,10279,81
2021-07-23,Nevada,057,99092,5364,5183,201,5384,72
2021-07-23,Orange,059,3164182,263927,259973,12144,272117,5141
2021-07-23,Placer,061,380077,25154,24530,1814,26344,303
2021-07-23,Plumas,063,18699,751,737,14,751,4
2021-07-23,Riverside,065,2383286,302639,296912,14645,311557,4552
2021-07-23,Sacramento,067,1510023,114644,112438,2168,114606,1698
2021-07-23,San Benito,069,59416,6240,6200,116,6316,63
2021-07-23,San Bernardino,071,2135413,301076,297899,9390,307289,5236
2021-07-23,San Diego,073,3302833,294227,289368,16843,306211,3788
2021-07-23,San Francisco,075,870044,40243,38954,1453,40407,561
2021-07-23,San Joaquin,077,732212,76590,75461,3871,79332,1436
2021-07-23,San Luis Obispo,079,281455,22071,21616,797,22413,260
2021-07-23,San Mateo,081,765935,44577,43880,561,44441,542
2021-07-23,Santa Barbara,083,443738,35536,35071,1199,36270,465
2021-07-23,Santa Clara,085,1922200,122932,121092,843,121935,2099
2021-07-23,Santa Cruz,087,273765,16673,16416,826,17242,207
2021-07-23,Shasta,089,179085,12933,12759,1720,14479,211
2021-07-23,Sierra,091,2930,69,64,12,76,0
2021-07-23,Siskiyou,093,43540,2050,1951,431,2382,31
2021-07-23,Solano,095,438530,35369,34499,691,35190,259
2021-07-23,Sonoma,097,501317,32595,31928,384,32312,327
2021-07-23,Stanislaus,099,539301,58534,57879,6271,64150,1030
2021-07-23,Sutter,101,95872,10001,9890,99,9989,115
2021-07-23,Tehama,103,63373,5233,5166,608,5774,65
2021-07-23,Trinity,105,12862,507,345,111,456,3
2021-07-23,Tulare,107,460477,51050,50104,9500,59604,854
2021-07-23,Tuolumne,109,53932,4261,4216,44,4260,64
2021-07-23,Ventura,111,848112,83691,82687,3404,86091,1041
2021-07-23,Yolo,113,214977,14830,14557,439,14996,214
2021-07-23,Yuba,115,75493,6604,6449,141,6590,51
2021-07-22,Alameda,001,1643700,94860,93170,2193,95363,1259
2021-07-22,Alpine,003,1148,88,89,0,89,0
2021-07-22,Amador,005,37829,3873,3816,34,3850,48
2021-07-22,Butte,007,227075,13257,12982,1965,14947,203
2021-07-22,Calaveras,009,45235,2286,2267,16,2283,57
2021-07-22,Colusa,011,21464,2008,1992,343,2335,16
2021-07-22,Contra Costa,013,1133247,75193,73682,1490,75172,830
2021-07-22,Del Norte,015,27424,1571,1497,14,1511,8
2021-07-22,El Dorado,017,186661,11010,10773,833,11606,116
2021-07-22,Fresno,019,978130,105259,103637,9094,112731,1736
2021-07-22,Glenn,021,27897,2475,2457,583,3040,20
2021-07-22,Humboldt,023,135768,4931,4780,66,4846,52
2021-07-22,Imperial,025,180216,29189,28996,2793,31789,742
2021-07-22,Inyo,027,18085,1433,1424,12,1436,38
2021-07-22,Kern,029,883053,99402,98261,11706,109967,1350
2021-07-22,Kings,031,150075,23703,23304,1156,24460,246
2021-07-22,Lake,033,64148,4143,3963,14,3977,64
2021-07-22,Lassen,035,31185,5329,5311,120,5431,21
2021-07-22,Los Angeles,037,10098052,1246920,1232164,44941,1277105,24623
2021-07-22,Madera,039,155013,17144,16885,994,17879,245
2021-07-22,Marin,041,260295,14741,14454,287,14741,238
2021-07-22,Mariposa,043,17540,462,453,11,464,5
2021-07-22,Mendocino,045,87422,4431,4293,90,4383,49
2021-07-22,Merced,047,269075,31806,31661,1113,32774,473
2021-07-22,Modoc,049,8938,424,413,149,562,5
2021-07-22,Mono,051,14174,1287,1284,18,1302,3
2021-07-22,Monterey,053,433212,43797,43525,1955,45480,521
2021-07-22,Napa,055,140530,10369,10230,49,10279,81
2021-07-22,Nevada,057,99092,5338,5183,200,5383,72
2021-07-22,Orange,059,3164182,263374,259973,12135,272108,5141
2021-07-22,Placer,061,380077,25060,24530,1803,26333,303
2021-07-22,Plumas,063,18699,750,737,14,751,4
2021-07-22,Riverside,065,2383286,302130,296912,14624,311536,4552
2021-07-22,Sacramento,067,1510023,114206,112438,2159,114597,1698
2021-07-22,San Benito,069,59416,6232,6200,116,6316,63
2021-07-22,San Bernardino,071,2135413,300673,297899,9374,307273,5236
2021-07-22,San Diego,073,3302833,293497,289368,16785,306153,3788
2021-07-22,San Francisco,075,870044,40030,38954,1441,40395,561
2021-07-22,San Joaquin,077,732212,76447,75461,3858,79319,1436
2021-07-22,San Luis Obispo,079,281455,22034,21616,793,22409,260
2021-07-22,San Mateo,081,765935,44465,43880,556,44436,542
2021-07-22,Santa Barbara,083,443738,35470,35071,1197,36268,465
2021-07-22,Santa Clara,085,1922200,122690,121092,840,121932,2099
2021-07-22,Santa Cruz,087,273765,16636,16416,825,17241,207
2021-07-22,Shasta,089,179085,12909,12759,1716,14475,211
2021-07-22,Sierra,091,2930,67,64,12,76,0
2021-07-22,Siskiyou,093,43540,2047,1951,431,2382,31
2021-07-22,Solano,095,438530,35223,34499,684,35183,259
2021-07-22,Sonoma,097,501317,32485,31928,382,32310,327
2021-07-22,Stanislaus,099,539301,58406,57879,6259,64138,1030
2021-07-22,Sutter,101,95872,9980,9890,99,9989,115
2021-07-22,Tehama,103,63373,5227,5166,608,5774,65
2021-07-22,Trinity,105,12862,507,345,111,456,3
2021-07-22,Tulare,107,460477,51007,50104,9472,59576,854
2021-07-22,Tuolumne,109,53932,4249,4216,44,4260,64
2021-07-22,Ventura,111,848112,83557,82687,3391,86078,1041
2021-07-22,Yolo,113,214977,14792,14557,438,14995,214
2021-07-22,Yuba,115,75493,6573,6449,138,6587,51
2021-07-21,Alameda,001,1643700,94541,92840,2189,95029,1256
2021-07-21,Alpine,003,1148,88,89,0,89,0
2021-07-21,Amador,005,37829,3860,3813,34,3847,48
2021-07-21,Butte,007,227075,13216,12939,1960,14899,203
2021-07-21,Calaveras,009,45235,2282,2257,16,2273,57
2021-07-21,Colusa,011,21464,2004,1988,342,2330,16
2021-07-21,Contra Costa,013,1133247,74929,73320,1481,74801,827
2021-07-21,Del Norte,015,27424,1561,1492,14,1506,8
2021-07-21,El Dorado,017,186661,10974,10742,829,11571,116
2021-07-21,Fresno,019,978130,105111,103504,9085,112589,1736
2021-07-21,Glenn,021,27897,2473,2455,582,3037,20
2021-07-21,Humboldt,023,135768,4899,4763,64,4827,52
2021-07-21,Imperial,025,180216,29177,28964,2790,31754,742
2021-07-21,Inyo,027,18085,1433,1423,12,1435,38
2021-07-21,Kern,029,883053,99284,98152,11665,109817,1350
2021-07-21,Kings,031,150075,23675,23270,1152,24422,246
2021-07-21,Lake,033,64148,4077,3896,14,3910,64
2021-07-21,Lassen,035,31185,5326,5310,120,5430,21
2021-07-21,Los Angeles,037,10098052,1244414,1229598,44802,1274400,24609
2021-07-21,Madera,039,155013,17120,16858,991,17849,245
2021-07-21,Marin,041,260295,14692,14427,287,14714,238
2021-07-21,Mariposa,043,17540,458,449,11,460,5
2021-07-21,Mendocino,045,87422,4413,4274,90,4364,49
2021-07-21,Merced,047,269075,31767,31607,1109,32716,473
2021-07-21,Modoc,049,8938,424,413,149,562,5
2021-07-21,Mono,051,14174,1284,1282,18,1300,3
2021-07-21,Monterey,053,433212,43767,43502,1951,45453,515
2021-07-21,Napa,055,140530,10343,10209,49,10258,81
2021-07-21,Nevada,057,99092,5303,5152,200,5352,72
2021-07-21,Orange,059,3164182,262821,259615,12104,271719,5139
2021-07-21,Placer,061,380077,24951,24441,1792,26233,303
2021-07-21,Plumas,063,18699,750,736,14,750,4
2021-07-21,Riverside,065,2383286,301617,296419,14607,311026,4552
2021-07-21,Sacramento,067,1510023,113784,112043,2148,114191,1696
2021-07-21,San Benito,069,59416,6222,6196,116,6312,63
2021-07-21,San Bernardino,071,2135413,300222,297519,9366,306885,5230
2021-07-21,San Diego,073,3302833,292646,288682,16722,305404,3787
2021-07-21,San Francisco,075,870044,39805,38699,1436,40135,559
2021-07-21,San Joaquin,077,732212,76258,75288,3846,79134,1434
2021-07-21,San Luis Obispo,079,281455,21997,21579,790,22369,260
2021-07-21,San Mateo,081,765935,44373,43755,552,44307,542
2021-07-21,Santa Barbara,083,443738,35411,34998,1181,36179,465
2021-07-21,Santa Clara,085,1922200,122480,120838,838,121676,2099
2021-07-21,Santa Cruz,087,273765,16602,16407,825,17232,207
2021-07-21,Shasta,089,179085,12876,12751,1713,14464,211
2021-07-21,Sierra,091,2930,67,64,12,76,0
2021-07-21,Siskiyou,093,43540,2045,1943,429,2372,31
2021-07-21,Solano,095,438530,35065,34374,679,35053,258
2021-07-21,Sonoma,097,501317,32369,31789,382,32171,327
2021-07-21,Stanislaus,099,539301,58303,57774,6249,64023,1028
2021-07-21,Sutter,101,95872,9956,9862,99,9961,113
2021-07-21,Tehama,103,63373,5223,5161,608,5769,65
2021-07-21,Trinity,105,12862,505,345,110,455,3
2021-07-21,Tulare,107,460477,50947,50066,9446,59512,854
2021-07-21,Tuolumne,109,53932,4212,4156,44,4200,64
2021-07-21,Ventura,111,848112,83435,82573,3379,85952,1041
2021-07-21,Yolo,113,214977,14750,14525,437,14962,213
2021-07-21,Yuba,115,75493,6545,6425,138,6563,52
2021-07-20,Alameda,001,1643700,94167,92625,2175,94800,1256
2021-07-20,Alpine,003,1148,88,89,0,89,0
2021-07-20,Amador,005,37829,3849,3807,34,3841,48
2021-07-20,Butte,007,227075,13179,12916,1955,14871,203
2021-07-20,Calaveras,009,45235,2279,2249,16,2265,57
2021-07-20,Colusa,011,21464,2004,1985,342,2327,16
2021-07-20,Contra Costa,013,1133247,74645,73143,1463,74606,825
2021-07-20,Del Norte,015,27424,1551,1490,14,1504,8
2021-07-20,El Dorado,017,186661,10934,10727,825,11552,116
2021-07-20,Fresno,019,978130,104975,103438,9066,112504,1736
2021-07-20,Glenn,021,27897,2473,2453,582,3035,20
2021-07-20,Humboldt,023,135768,4854,4735,62,4797,52
2021-07-20,Imperial,025,180216,29157,28933,2790,31723,742
2021-07-20,Inyo,027,18085,1429,1420,12,1432,36
2021-07-20,Kern,029,883053,99172,98082,11637,109719,1350
2021-07-20,Kings,031,150075,23634,23254,1148,24402,246
2021-07-20,Lake,033,64148,4052,3871,14,3885,64
2021-07-20,Lassen,035,31185,5326,5306,120,5426,21
2021-07-20,Los Angeles,037,10098052,1241624,1227404,44633,1272037,24603
2021-07-20,Madera,039,155013,17099,16856,987,17843,245
2021-07-20,Marin,041,260295,14656,14396,284,14680,234
2021-07-20,Mariposa,043,17540,456,448,11,459,5
2021-07-20,Mendocino,045,87422,4396,4259,90,4349,49
2021-07-20,Merced,047,269075,31728,31578,1102,32680,473
2021-07-20,Modoc,049,8938,424,413,149,562,5
2021-07-20,Mono,051,14174,1280,1281,18,1299,3
2021-07-20,Monterey,053,433212,43736,43481,1948,45429,515
2021-07-20,Napa,055,140530,10320,10191,49,10240,81
2021-07-20,Nevada,057,99092,5284,5148,199,5347,72
2021-07-20,Orange,059,3164182,262264,259303,12072,271375,5139
2021-07-20,Placer,061,380077,24859,24408,1769,26177,303
2021-07-20,Plumas,063,18699,748,736,14,750,4
2021-07-20,Riverside,065,2383286,301082,296118,14593,310711,4543
2021-07-20,Sacramento,067,1510023,113344,111796,2118,113914,1695
2021-07-20,San Benito,069,59416,6215,6196,116,6312,63
2021-07-20,San Bernardino,071,2135413,299811,297222,9341,306563,5231
2021-07-20,San Diego,073,3302833,291720,288209,16625,304834,3786
2021-07-20,San Francisco,075,870044,39546,38536,1425,39961,558
2021-07-20,San Joaquin,077,732212,76086,75198,3833,79031,1433
2021-07-20,San Luis Obispo,079,281455,21951,21556,789,22345,259
2021-07-20,San Mateo,081,765935,44254,43670,551,44221,542
2021-07-20,Santa Barbara,083,443738,35341,34935,1175,36110,462
2021-07-20,Santa Clara,085,1922200,122223,120704,835,121539,2098
2021-07-20,Santa Cruz,087,273765,16573,16399,825,17224,207
2021-07-20,Shasta,089,179085,12850,12734,1709,14443,211
2021-07-20,Sierra,091,2930,67,64,12,76,0
2021-07-20,Siskiyou,093,43540,2041,1931,428,2359,31
2021-07-20,Solano,095,438530,34930,34337,672,35009,258
2021-07-20,Sonoma,097,501317,32250,31763,381,32144,326
2021-07-20,Stanislaus,099,539301,58188,57706,6243,63949,1028
2021-07-20,Sutter,101,95872,9929,9854,96,9950,114
2021-07-20,Tehama,103,63373,5221,5153,608,5761,65
2021-07-20,Trinity,105,12862,503,344,109,453,3
2021-07-20,Tulare,107,460477,50905,50047,9429,59476,854
2021-07-20,Tuolumne,109,53932,4193,4156,44,4200,64
2021-07-20,Ventura,111,848112,83282,82504,3362,85866,1041
2021-07-20,Yolo,113,214977,14685,14495,434,14929,213
2021-07-20,Yuba,115,75493,6520,6393,135,6528,52
2021-07-19,Alameda,001,1643700,93794,92357,2159,94516,1256
2021-07-19,Alpine,003,1148,88,89,0,89,0
2021-07-19,Amador,005,37829,3845,3802,34,3836,48
2021-07-19,Butte,007,227075,13135,12901,1949,14850,202
2021-07-19,Calaveras,009,45235,2275,2245,16,2261,57
2021-07-19,Colusa,011,21464,2002,1981,341,2322,16
2021-07-19,Contra Costa,013,1133247,74332,72935,1443,74378,825
2021-07-19,Del Norte,015,27424,1538,1484,14,1498,8
2021-07-19,El Dorado,017,186661,10904,10703,817,11520,114
2021-07-19,Fresno,019,978130,104845,103350,9053,112403,1731
2021-07-19,Glenn,021,27897,2473,2452,581,3033,20
2021-07-19,Humboldt,023,135768,4824,4719,60,4779,52
2021-07-19,Imperial,025,180216,29130,28888,2789,31677,742
2021-07-19,Inyo,027,18085,1428,1417,12,1429,36
2021-07-19,Kern,029,883053,99058,97999,11603,109602,1349
2021-07-19,Kings,031,150075,23604,23221,1142,24363,246
2021-07-19,Lake,033,64148,4016,3848,14,3862,64
2021-07-19,Lassen,035,31185,5325,5305,120,5425,21
2021-07-19,Los Angeles,037,10098052,1239025,1225946,44436,1270382,24600
2021-07-19,Madera,039,155013,17076,16846,984,17830,244
2021-07-19,Marin,041,260295,14621,14369,281,14650,234
2021-07-19,Mariposa,043,17540,450,447,11,458,5
2021-07-19,Mendocino,045,87422,4378,4251,90,4341,49
2021-07-19,Merced,047,269075,31664,31565,1095,32660,472
2021-07-19,Modoc,049,8938,423,413,149,562,5
2021-07-19,Mono,051,14174,1278,1280,18,1298,3
2021-07-19,Monterey,053,433212,43712,43436,1947,45383,515
2021-07-19,Napa,055,140530,10295,10180,47,10227,81
2021-07-19,Nevada,057,99092,5256,5133,198,5331,72
2021-07-19,Orange,059,3164182,261741,258927,12040,270967,5138
2021-07-19,Placer,061,380077,24760,24359,1747,26106,303
2021-07-19,Plumas,063,18699,748,730,14,744,4
2021-07-19,Riverside,065,2383286,300592,295736,14555,310291,4543
2021-07-19,Sacramento,067,1510023,112980,111470,2094,113564,1696
2021-07-19,San Benito,069,59416,6212,6193,116,6309,63
2021-07-19,San Bernardino,071,2135413,299437,296929,9323,306252,5235
2021-07-19,San Diego,073,3302833,290823,287695,16520,304215,3786
2021-07-19,San Francisco,075,870044,39274,38463,1412,39875,560
2021-07-19,San Joaquin,077,732212,75921,75086,3827,78913,1431
2021-07-19,San Luis Obispo,079,281455,21906,21531,785,22316,259
2021-07-19,San Mateo,081,765935,44112,43563,542,44105,542
2021-07-19,Santa Barbara,083,443738,35269,34904,1173,36077,461
2021-07-19,Santa Clara,085,1922200,121965,120554,834,121388,2098
2021-07-19,Santa Cruz,087,273765,16557,16387,825,17212,207
2021-07-19,Shasta,089,179085,12832,12723,1707,14430,209
2021-07-19,Sierra,091,2930,66,64,12,76,0
2021-07-19,Siskiyou,093,43540,2036,1927,426,2353,31
2021-07-19,Solano,095,438530,34755,34262,661,34923,261
2021-07-19,Sonoma,097,501317,32129,31713,380,32093,325
2021-07-19,Stanislaus,099,539301,58087,57644,6233,63877,1027
2021-07-19,Sutter,101,95872,9913,9834,96,9930,114
2021-07-19,Tehama,103,63373,5215,5152,606,5758,65
2021-07-19,Trinity,105,12862,503,344,108,452,3
2021-07-19,Tulare,107,460477,50859,49994,9412,59406,855
2021-07-19,Tuolumne,109,53932,4183,4151,44,4195,64
2021-07-19,Ventura,111,848112,83186,82409,3340,85749,1041
2021-07-19,Yolo,113,214977,14653,14439,432,14871,213
2021-07-19,Yuba,115,75493,6496,6370,135,6505,52
2021-07-18,Alameda,001,1643700,93438,92162,2146,94308,1256
2021-07-18,Alpine,003,1148,88,89,0,89,0
2021-07-18,Amador,005,37829,3834,3799,34,3833,48
2021-07-18,Butte,007,227075,13092,12888,1944,14832,202
2021-07-18,Calaveras,009,45235,2272,2243,16,2259,57
2021-07-18,Colusa,011,21464,2002,1981,340,2321,16
2021-07-18,Contra Costa,013,1133247,74016,72849,1425,74274,825
2021-07-18,Del Norte,015,27424,1529,1482,14,1496,8
2021-07-18,El Dorado,017,186661,10866,10687,809,11496,114
2021-07-18,Fresno,019,978130,104691,103298,9035,112333,1731
2021-07-18,Glenn,021,27897,2472,2452,580,3032,20
2021-07-18,Humboldt,023,135768,4788,4714,60,4774,52
2021-07-18,Imperial,025,180216,29093,28877,2788,31665,742
2021-07-18,Inyo,027,18085,1424,1417,12,1429,36
2021-07-18,Kern,029,883053,98932,97963,11561,109524,1349
2021-07-18,Kings,031,150075,23583,23203,1138,24341,246
2021-07-18,Lake,033,64148,3980,3825,14,3839,64
2021-07-18,Lassen,035,31185,5325,5305,120,5425,21
2021-07-18,Los Angeles,037,10098052,1236337,1224691,44243,1268934,24598
2021-07-18,Madera,039,155013,17051,16838,980,17818,244
2021-07-18,Marin,041,260295,14585,14358,279,14637,234
2021-07-18,Mariposa,043,17540,449,447,11,458,5
2021-07-18,Mendocino,045,87422,4357,4246,90,4336,49
2021-07-18,Merced,047,269075,31633,31537,1093,32630,471
2021-07-18,Modoc,049,8938,423,413,149,562,5
2021-07-18,Mono,051,14174,1277,1280,18,1298,3
2021-07-18,Monterey,053,433212,43694,43422,1938,45360,515
2021-07-18,Napa,055,140530,10278,10174,44,10218,81
2021-07-18,Nevada,057,99092,5230,5124,198,5322,72
2021-07-18,Orange,059,3164182,261256,258724,12010,270734,5138
2021-07-18,Placer,061,380077,24693,24313,1720,26033,303
2021-07-18,Plumas,063,18699,748,730,14,744,4
2021-07-18,Riverside,065,2383286,300100,295522,14513,310035,4543
2021-07-18,Sacramento,067,1510023,112548,111255,2062,113317,1696
2021-07-18,San Benito,069,59416,6204,6191,116,6307,63
2021-07-18,San Bernardino,071,2135413,298963,296739,9308,306047,5233
2021-07-18,San Diego,073,3302833,290005,286287,16438,302725,3786
2021-07-18,San Francisco,075,870044,39040,38367,1401,39768,560
2021-07-18,San Joaquin,077,732212,75744,74997,3814,78811,1431
2021-07-18,San Luis Obispo,079,281455,21871,21527,782,22309,259
2021-07-18,San Mateo,081,765935,43999,43506,536,44042,542
2021-07-18,Santa Barbara,083,443738,35204,34880,1171,36051,461
2021-07-18,Santa Clara,085,1922200,121751,120438,827,121265,2098
2021-07-18,Santa Cruz,087,273765,16525,16372,824,17196,207
2021-07-18,Shasta,089,179085,12807,12714,1703,14417,209
2021-07-18,Sierra,091,2930,66,64,12,76,0
2021-07-18,Siskiyou,093,43540,2030,1927,421,2348,31
2021-07-18,Solano,095,438530,34627,34215,657,34872,261
2021-07-18,Sonoma,097,501317,32024,31675,379,32054,325
2021-07-18,Stanislaus,099,539301,57976,57600,6208,63808,1028
2021-07-18,Sutter,101,95872,9881,9826,96,9922,114
2021-07-18,Tehama,103,63373,5212,5150,605,5755,65
2021-07-18,Trinity,105,12862,503,344,108,452,3
2021-07-18,Tulare,107,460477,50806,49985,9389,59374,855
2021-07-18,Tuolumne,109,53932,4165,4149,44,4193,64
2021-07-18,Ventura,111,848112,83072,82361,3316,85677,1041
2021-07-18,Yolo,113,214977,14594,14425,426,14851,213
2021-07-18,Yuba,115,75493,6455,6357,135,6492,52
2021-07-17,Alameda,001,1643700,93221,91346,2134,93480,1255
2021-07-17,Alpine,003,1148,88,89,0,89,0
2021-07-17,Amador,005,37829,3825,3785,34,3819,48
2021-07-17,Butte,007,227075,13078,12824,1939,14763,202
2021-07-17,Calaveras,009,45235,2266,2237,16,2253,57
2021-07-17,Colusa,011,21464,1999,1976,340,2316,16
2021-07-17,Contra Costa,013,1133247,73834,72254,1412,73666,824
2021-07-17,Del Norte,015,27424,1521,1475,14,1489,8
2021-07-17,El Dorado,017,186661,10839,10622,805,11427,114
2021-07-17,Fresno,019,978130,104618,103055,9021,112076,1730
2021-07-17,Glenn,021,27897,2471,2451,580,3031,20
2021-07-17,Humboldt,023,135768,4775,4654,59,4713,52
2021-07-17,Imperial,025,180216,29077,28840,2788,31628,742
2021-07-17,Inyo,027,18085,1424,1416,12,1428,36
2021-07-17,Kern,029,883053,98875,97796,11524,109320,1348
2021-07-17,Kings,031,150075,23563,23163,1137,24300,246
2021-07-17,Lake,033,64148,3955,3760,14,3774,64
2021-07-17,Lassen,035,31185,5325,5302,120,5422,21
2021-07-17,Los Angeles,037,10098052,1234815,1219733,44097,1263830,24582
2021-07-17,Madera,039,155013,17043,16804,980,17784,240
2021-07-17,Marin,041,260295,14567,14297,277,14574,234
2021-07-17,Mariposa,043,17540,449,445,11,456,5
2021-07-17,Mendocino,045,87422,4345,4209,90,4299,49
2021-07-17,Merced,047,269075,31612,31451,1089,32540,471
2021-07-17,Modoc,049,8938,423,412,149,561,5
2021-07-17,Mono,051,14174,1275,1277,18,1295,3
2021-07-17,Monterey,053,433212,43671,43367,1933,45300,515
2021-07-17,Napa,055,140530,10262,10129,44,10173,81
2021-07-17,Nevada,057,99092,5215,5066,198,5264,72
2021-07-17,Orange,059,3164182,260949,257805,11971,269776,5136
2021-07-17,Placer,061,380077,24626,24169,1706,25875,303
2021-07-17,Plumas,063,18699,743,721,14,735,4
2021-07-17,Riverside,065,2383286,299793,294751,14481,309232,4542
2021-07-17,Sacramento,067,1510023,112313,110432,2040,112472,1694
2021-07-17,San Benito,069,59416,6198,6181,116,6297,63
2021-07-17,San Bernardino,071,2135413,298727,296048,9289,305337,5218
2021-07-17,San Diego,073,3302833,289597,285698,16371,302069,3786
2021-07-17,San Francisco,075,870044,38918,37978,1397,39375,560
2021-07-17,San Joaquin,077,732212,75657,74695,3808,78503,1430
2021-07-17,San Luis Obispo,079,281455,21844,21462,782,22244,258
2021-07-17,San Mateo,081,765935,43928,43324,535,43859,542
2021-07-17,Santa Barbara,083,443738,35163,34769,1168,35937,461
2021-07-17,Santa Clara,085,1922200,121579,119980,824,120804,2097
2021-07-17,Santa Cruz,087,273765,16518,16337,824,17161,207
2021-07-17,Shasta,089,179085,12792,12683,1698,14381,210
2021-07-17,Sierra,091,2930,66,62,12,74,0
2021-07-17,Siskiyou,093,43540,2025,1922,418,2340,29
2021-07-17,Solano,095,438530,34562,34015,649,34664,263
2021-07-17,Sonoma,097,501317,31956,31536,378,31914,322
2021-07-17,Stanislaus,099,539301,57899,57400,6194,63594,1028
2021-07-17,Sutter,101,95872,9871,9778,96,9874,114
2021-07-17,Tehama,103,63373,5209,5145,605,5750,64
2021-07-17,Trinity,105,12862,502,341,108,449,3
2021-07-17,Tulare,107,460477,50785,49937,9377,59314,854
2021-07-17,Tuolumne,109,53932,4155,4131,44,4175,64
2021-07-17,Ventura,111,848112,83003,82125,3305,85430,1041
2021-07-17,Yolo,113,214977,14562,14356,419,14775,213
2021-07-17,Yuba,115,75493,6444,6309,135,6444,52
2021-07-16,Alameda,001,1643700,92981,91346,2122,93468,1255
2021-07-16,Alpine,003,1148,88,89,0,89,0
2021-07-16,Amador,005,37829,3822,3785,34,3819,48
2021-07-16,Butte,007,227075,13053,12824,1936,14760,202
2021-07-16,Calaveras,009,45235,2265,2237,16,2253,57
2021-07-16,Colusa,011,21464,1997,1976,339,2315,16
2021-07-16,Contra Costa,013,1133247,73646,72254,1408,73662,824
2021-07-16,Del Norte,015,27424,1519,1475,14,1489,8
2021-07-16,El Dorado,017,186661,10820,10622,804,11426,114
2021-07-16,Fresno,019,978130,104566,103055,9001,112056,1730
2021-07-16,Glenn,021,27897,2471,2451,580,3031,20
2021-07-16,Humboldt,023,135768,4753,4654,59,4713,52
2021-07-16,Imperial,025,180216,29065,28840,2788,31628,742
2021-07-16,Inyo,027,18085,1422,1416,12,1428,36
2021-07-16,Kern,029,883053,98813,97796,11484,109280,1348
2021-07-16,Kings,031,150075,23538,23163,1135,24298,246
2021-07-16,Lake,033,64148,3928,3760,14,3774,64
2021-07-16,Lassen,035,31185,5324,5302,120,5422,21
2021-07-16,Los Angeles,037,10098052,1233316,1219733,43950,1263683,24582
2021-07-16,Madera,039,155013,17025,16804,980,17784,240
2021-07-16,Marin,041,260295,14543,14297,274,14571,234
2021-07-16,Mariposa,043,17540,449,445,11,456,5
2021-07-16,Mendocino,045,87422,4336,4209,89,4298,49
2021-07-16,Merced,047,269075,31590,31451,1087,32538,471
2021-07-16,Modoc,049,8938,423,412,149,561,5
2021-07-16,Mono,051,14174,1274,1277,18,1295,3
2021-07-16,Monterey,053,433212,43649,43367,1932,45299,515
2021-07-16,Napa,055,140530,10238,10129,43,10172,81
2021-07-16,Nevada,057,99092,5205,5066,198,5264,72
2021-07-16,Orange,059,3164182,260677,257805,11931,269736,5136
2021-07-16,Placer,061,380077,24573,24169,1701,25870,303
2021-07-16,Plumas,063,18699,742,721,14,735,4
2021-07-16,Riverside,065,2383286,299517,294751,14455,309206,4542
2021-07-16,Sacramento,067,1510023,112096,110432,2027,112459,1694
2021-07-16,San Benito,069,59416,6196,6181,116,6297,63
2021-07-16,San Bernardino,071,2135413,298449,296048,9272,305320,5218
2021-07-16,San Diego,073,3302833,289154,285698,16324,302022,3786
2021-07-16,San Francisco,075,870044,38801,37978,1392,39370,560
2021-07-16,San Joaquin,077,732212,75562,74695,3805,78500,1430
2021-07-16,San Luis Obispo,079,281455,21827,21462,782,22244,258
2021-07-16,San Mateo,081,765935,43875,43324,534,43858,542
2021-07-16,Santa Barbara,083,443738,35125,34769,1168,35937,461
2021-07-16,Santa Clara,085,1922200,121432,119980,816,120796,2097
2021-07-16,Santa Cruz,087,273765,16505,16337,824,17161,207
2021-07-16,Shasta,089,179085,12782,12683,1697,14380,210
2021-07-16,Sierra,091,2930,66,62,12,74,0
2021-07-16,Siskiyou,093,43540,2023,1922,416,2338,29
2021-07-16,Solano,095,438530,34495,34015,641,34656,263
2021-07-16,Sonoma,097,501317,31904,31536,375,31911,322
2021-07-16,Stanislaus,099,539301,57849,57400,6184,63584,1028
2021-07-16,Sutter,101,95872,9859,9778,96,9874,114
2021-07-16,Tehama,103,63373,5207,5145,605,5750,64
2021-07-16,Trinity,105,12862,502,341,107,448,3
2021-07-16,Tulare,107,460477,50761,49937,9367,59304,854
2021-07-16,Tuolumne,109,53932,4149,4131,44,4175,64
2021-07-16,Ventura,111,848112,82938,82125,3298,85423,1041
2021-07-16,Yolo,113,214977,14536,14356,415,14771,213
2021-07-16,Yuba,115,75493,6422,6309,134,6443,52
2021-07-15,Alameda,001,1643700,92684,91346,2112,93458,1255
2021-07-15,Alpine,003,1148,88,89,0,89,0
2021-07-15,Amador,005,37829,3819,3785,34,3819,48
2021-07-15,Butte,007,227075,13027,12824,1934,14758,202
2021-07-15,Calaveras,009,45235,2262,2237,16,2253,57
2021-07-15,Colusa,011,21464,1996,1976,338,2314,16
2021-07-15,Contra Costa,013,1133247,73433,72254,1401,73655,824
2021-07-15,Del Norte,015,27424,1516,1475,14,1489,8
2021-07-15,El Dorado,017,186661,10793,10622,802,11424,114
2021-07-15,Fresno,019,978130,104469,103055,8981,112036,1730
2021-07-15,Glenn,021,27897,2471,2451,580,3031,20
2021-07-15,Humboldt,023,135768,4735,4654,58,4712,52
2021-07-15,Imperial,025,180216,29042,28840,2788,31628,742
2021-07-15,Inyo,027,18085,1422,1416,12,1428,36
2021-07-15,Kern,029,883053,98743,97796,11456,109252,1348
2021-07-15,Kings,031,150075,23500,23163,1132,24295,246
2021-07-15,Lake,033,64148,3889,3760,14,3774,64
2021-07-15,Lassen,035,31185,5323,5302,120,5422,21
2021-07-15,Los Angeles,037,10098052,1231340,1219733,43788,1263521,24582
2021-07-15,Madera,039,155013,17003,16804,976,17780,240
2021-07-15,Marin,041,260295,14518,14297,274,14571,234
2021-07-15,Mariposa,043,17540,449,445,11,456,5
2021-07-15,Mendocino,045,87422,4328,4209,88,4297,49
2021-07-15,Merced,047,269075,31560,31451,1087,32538,471
2021-07-15,Modoc,049,8938,423,412,149,561,5
2021-07-15,Mono,051,14174,1274,1277,18,1295,3
2021-07-15,Monterey,053,433212,43620,43367,1929,45296,515
2021-07-15,Napa,055,140530,10213,10129,42,10171,81
2021-07-15,Nevada,057,99092,5188,5066,197,5263,72
2021-07-15,Orange,059,3164182,260326,257805,11900,269705,5136
2021-07-15,Placer,061,380077,24514,24169,1684,25853,303
2021-07-15,Plumas,063,18699,741,721,14,735,4
2021-07-15,Riverside,065,2383286,299195,294751,14440,309191,4542
2021-07-15,Sacramento,067,1510023,111792,110432,2010,112442,1694
2021-07-15,San Benito,069,59416,6194,6181,116,6297,63
2021-07-15,San Bernardino,071,2135413,298144,296048,9257,305305,5218
2021-07-15,San Diego,073,3302833,288516,285698,16246,301944,3786
2021-07-15,San Francisco,075,870044,38649,37978,1384,39362,560
2021-07-15,San Joaquin,077,732212,75445,74695,3800,78495,1430
2021-07-15,San Luis Obispo,079,281455,21795,21462,782,22244,258
2021-07-15,San Mateo,081,765935,43771,43324,529,43853,542
2021-07-15,Santa Barbara,083,443738,35069,34769,1167,35936,461
2021-07-15,Santa Clara,085,1922200,121310,119980,813,120793,2097
2021-07-15,Santa Cruz,087,273765,16492,16337,824,17161,207
2021-07-15,Shasta,089,179085,12774,12683,1693,14376,210
2021-07-15,Sierra,091,2930,66,62,12,74,0
2021-07-15,Siskiyou,093,43540,2022,1922,416,2338,29
2021-07-15,Solano,095,438530,34420,34015,635,34650,263
2021-07-15,Sonoma,097,501317,31843,31536,375,31911,322
2021-07-15,Stanislaus,099,539301,57781,57400,6171,63571,1028
2021-07-15,Sutter,101,95872,9839,9778,95,9873,114
2021-07-15,Tehama,103,63373,5201,5145,604,5749,64
2021-07-15,Trinity,105,12862,502,341,107,448,3
2021-07-15,Tulare,107,460477,50741,49937,9350,59287,854
2021-07-15,Tuolumne,109,53932,4137,4131,44,4175,64
2021-07-15,Ventura,111,848112,82861,82125,3293,85418,1041
2021-07-15,Yolo,113,214977,14509,14356,414,14770,213
2021-07-15,Yuba,115,75493,6407,6309,133,6442,52
2021-07-14,Alameda,001,1643700,92422,91092,2093,93185,1255
2021-07-14,Alpine,003,1148,88,89,0,89,0
2021-07-14,Amador,005,37829,3811,3784,34,3818,48
2021-07-14,Butte,007,227075,13000,12813,1927,14740,202
2021-07-14,Calaveras,009,45235,2255,2234,16,2250,57
2021-07-14,Colusa,011,21464,1993,1974,338,2312,16
2021-07-14,Contra Costa,013,1133247,73207,72091,1389,73480,823
2021-07-14,Del Norte,015,27424,1515,1472,14,1486,8
2021-07-14,El Dorado,017,186661,10767,10598,799,11397,114
2021-07-14,Fresno,019,978130,104389,102966,8970,111936,1728
2021-07-14,Glenn,021,27897,2471,2449,580,3029,20
2021-07-14,Humboldt,023,135768,4712,4644,56,4700,52
2021-07-14,Imperial,025,180216,29013,28822,2788,31610,742
2021-07-14,Inyo,027,18085,1421,1415,12,1427,36
2021-07-14,Kern,029,883053,98679,97736,11431,109167,1346
2021-07-14,Kings,031,150075,23487,23142,1132,24274,246
2021-07-14,Lake,033,64148,3856,3739,14,3753,63
2021-07-14,Lassen,035,31185,5322,5298,120,5418,21
2021-07-14,Los Angeles,037,10098052,1229330,1218265,43644,1261909,24578
2021-07-14,Madera,039,155013,16991,16786,974,17760,240
2021-07-14,Marin,041,260295,14484,14269,272,14541,233
2021-07-14,Mariposa,043,17540,447,445,11,456,5
2021-07-14,Mendocino,045,87422,4315,4193,88,4281,49
2021-07-14,Merced,047,269075,31523,31412,1083,32495,471
2021-07-14,Modoc,049,8938,423,412,149,561,4
2021-07-14,Mono,051,14174,1274,1278,18,1296,3
2021-07-14,Monterey,053,433212,43596,43347,1927,45274,504
2021-07-14,Napa,055,140530,10191,10121,42,10163,81
2021-07-14,Nevada,057,99092,5168,5058,197,5255,72
2021-07-14,Orange,059,3164182,260009,257558,11870,269428,5137
2021-07-14,Placer,061,380077,24461,24125,1672,25797,303
2021-07-14,Plumas,063,18699,734,719,14,733,4
2021-07-14,Riverside,065,2383286,298870,294511,14424,308935,4542
2021-07-14,Sacramento,067,1510023,111464,110193,1986,112179,1688
2021-07-14,San Benito,069,59416,6191,6177,116,6293,63
2021-07-14,San Bernardino,071,2135413,297843,295820,9242,305062,5193
2021-07-14,San Diego,073,3302833,287944,285269,16166,301435,3786
2021-07-14,San Francisco,075,870044,38510,37836,1378,39214,559
2021-07-14,San Joaquin,077,732212,75353,74599,3791,78390,1416
2021-07-14,San Luis Obispo,079,281455,21773,21444,780,22224,258
2021-07-14,San Mateo,081,765935,43672,43249,525,43774,542
2021-07-14,Santa Barbara,083,443738,35027,34719,1165,35884,461
2021-07-14,Santa Clara,085,1922200,121160,119844,810,120654,2098
2021-07-14,Santa Cruz,087,273765,16480,16326,824,17150,207
2021-07-14,Shasta,089,179085,12754,12669,1690,14359,209
2021-07-14,Sierra,091,2930,66,62,12,74,0
2021-07-14,Siskiyou,093,43540,2015,1922,413,2335,29
2021-07-14,Solano,095,438530,34347,33948,635,34583,268
2021-07-14,Sonoma,097,501317,31791,31470,375,31845,322
2021-07-14,Stanislaus,099,539301,57706,57340,6159,63499,1028
2021-07-14,Sutter,101,95872,9817,9766,95,9861,114
2021-07-14,Tehama,103,63373,5199,5142,604,5746,64
2021-07-14,Trinity,105,12862,502,341,107,448,3
2021-07-14,Tulare,107,460477,50724,49908,9336,59244,853
2021-07-14,Tuolumne,109,53932,4134,4128,43,4171,64
2021-07-14,Ventura,111,848112,82767,82041,3282,85323,1040
2021-07-14,Yolo,113,214977,14476,14332,411,14743,213
2021-07-14,Yuba,115,75493,6389,6294,133,6427,52
2021-07-13,Alameda,001,1643700,92157,90874,2083,92957,1255
2021-07-13,Alpine,003,1148,88,89,0,89,0
2021-07-13,Amador,005,37829,3804,3783,34,3817,48
2021-07-13,Butte,007,227075,12986,12802,1926,14728,202
2021-07-13,Calaveras,009,45235,2251,2230,16,2246,57
2021-07-13,Colusa,011,21464,1991,1972,334,2306,16
2021-07-13,Contra Costa,013,1133247,72981,71963,1380,73343,823
2021-07-13,Del Norte,015,27424,1511,1471,14,1485,8
2021-07-13,El Dorado,017,186661,10749,10581,796,11377,114
2021-07-13,Fresno,019,978130,104313,102909,8960,111869,1727
2021-07-13,Glenn,021,27897,2469,2448,580,3028,20
2021-07-13,Humboldt,023,135768,4697,4634,56,4690,51
2021-07-13,Imperial,025,180216,29002,28792,2788,31580,741
2021-07-13,Inyo,027,18085,1420,1415,12,1427,36
2021-07-13,Kern,029,883053,98590,97698,11392,109090,1346
2021-07-13,Kings,031,150075,23469,23132,1132,24264,246
2021-07-13,Lake,033,64148,3829,3719,13,3732,63
2021-07-13,Lassen,035,31185,5320,5292,120,5412,21
2021-07-13,Los Angeles,037,10098052,1227482,1217184,43473,1260657,24569
2021-07-13,Madera,039,155013,16981,16773,970,17743,240
2021-07-13,Marin,041,260295,14455,14254,271,14525,233
2021-07-13,Mariposa,043,17540,446,443,11,454,5
2021-07-13,Mendocino,045,87422,4308,4185,88,4273,49
2021-07-13,Merced,047,269075,31502,31379,1080,32459,471
2021-07-13,Modoc,049,8938,423,411,149,560,4
2021-07-13,Mono,051,14174,1273,1277,18,1295,3
2021-07-13,Monterey,053,433212,43578,43333,1923,45256,504
2021-07-13,Napa,055,140530,10170,10118,42,10160,81
2021-07-13,Nevada,057,99092,5143,5053,197,5250,72
2021-07-13,Orange,059,3164182,259679,257339,11841,269180,5136
2021-07-13,Placer,061,380077,24415,24091,1659,25750,303
2021-07-13,Plumas,063,18699,733,716,14,730,4
2021-07-13,Riverside,065,2383286,298547,294302,14397,308699,4541
2021-07-13,Sacramento,067,1510023,111154,109990,1963,111953,1687
2021-07-13,San Benito,069,59416,6189,6173,116,6289,63
2021-07-13,San Bernardino,071,2135413,297567,295596,9220,304816,5183
2021-07-13,San Diego,073,3302833,287395,284997,16088,301085,3785
2021-07-13,San Francisco,075,870044,38366,37725,1372,39097,559
2021-07-13,San Joaquin,077,732212,75237,74500,3788,78288,1417
2021-07-13,San Luis Obispo,079,281455,21747,21423,777,22200,258
2021-07-13,San Mateo,081,765935,43604,43180,524,43704,542
2021-07-13,Santa Barbara,083,443738,34978,34679,1162,35841,461
2021-07-13,Santa Clara,085,1922200,121006,119727,806,120533,2098
2021-07-13,Santa Cruz,087,273765,16471,16315,822,17137,207
2021-07-13,Shasta,089,179085,12741,12659,1683,14342,209
2021-07-13,Sierra,091,2930,66,62,12,74,0
2021-07-13,Siskiyou,093,43540,2014,1916,411,2327,29
2021-07-13,Solano,095,438530,34282,33918,629,34547,268
2021-07-13,Sonoma,097,501317,31732,31431,375,31806,322
2021-07-13,Stanislaus,099,539301,57636,57282,6144,63426,1028
2021-07-13,Sutter,101,95872,9799,9752,94,9846,114
2021-07-13,Tehama,103,63373,5192,5144,604,5748,64
2021-07-13,Trinity,105,12862,502,341,106,447,3
2021-07-13,Tulare,107,460477,50699,49891,9320,59211,853
2021-07-13,Tuolumne,109,53932,4126,4122,42,4164,64
2021-07-13,Ventura,111,848112,82682,81982,3257,85239,1040
2021-07-13,Yolo,113,214977,14448,14320,404,14724,213
2021-07-13,Yuba,115,75493,6372,6279,133,6412,52
2021-07-12,Alameda,001,1643700,91897,90720,2076,92796,1254
2021-07-12,Alpine,003,1148,88,89,0,89,0
2021-07-12,Amador,005,37829,3797,3781,34,3815,47
2021-07-12,Butte,007,227075,12966,12796,1924,14720,202
2021-07-12,Calaveras,009,45235,2249,2228,16,2244,57
2021-07-12,Colusa,011,21464,1987,1971,333,2304,16
2021-07-12,Contra Costa,013,1133247,72780,71833,1375,73208,823
2021-07-12,Del Norte,015,27424,1508,1469,14,1483,8
2021-07-12,El Dorado,017,186661,10721,10569,794,11363,114
2021-07-12,Fresno,019,978130,104219,102853,8947,111800,1728
2021-07-12,Glenn,021,27897,2469,2446,580,3026,20
2021-07-12,Humboldt,023,135768,4681,4621,56,4677,51
2021-07-12,Imperial,025,180216,28972,28789,2788,31577,741
2021-07-12,Inyo,027,18085,1420,1415,12,1427,36
2021-07-12,Kern,029,883053,98521,97660,11367,109027,1346
2021-07-12,Kings,031,150075,23449,23124,1130,24254,246
2021-07-12,Lake,033,64148,3808,3706,13,3719,63
2021-07-12,Lassen,035,31185,5319,5292,120,5412,21
2021-07-12,Los Angeles,037,10098052,1225694,1216230,43335,1259565,24559
2021-07-12,Madera,039,155013,16970,16772,970,17742,240
2021-07-12,Marin,041,260295,14430,14238,270,14508,233
2021-07-12,Mariposa,043,17540,446,442,11,453,5
2021-07-12,Mendocino,045,87422,4297,4175,88,4263,49
2021-07-12,Merced,047,269075,31471,31374,1079,32453,471
2021-07-12,Modoc,049,8938,422,411,149,560,4
2021-07-12,Mono,051,14174,1271,1275,18,1293,3
2021-07-12,Monterey,053,433212,43557,43315,1919,45234,504
2021-07-12,Napa,055,140530,10152,10104,41,10145,81
2021-07-12,Nevada,057,99092,5120,5046,197,5243,72
2021-07-12,Orange,059,3164182,259326,257171,11816,268987,5136
2021-07-12,Placer,061,380077,24364,24052,1653,25705,302
2021-07-12,Plumas,063,18699,733,716,14,730,4
2021-07-12,Riverside,065,2383286,298239,294108,14367,308475,4541
2021-07-12,Sacramento,067,1510023,110939,109849,1937,111786,1685
2021-07-12,San Benito,069,59416,6186,6166,116,6282,63
2021-07-12,San Bernardino,071,2135413,297296,295447,9206,304653,5171
2021-07-12,San Diego,073,3302833,286926,284648,16012,300660,3785
2021-07-12,San Francisco,075,870044,38219,37656,1369,39025,559
2021-07-12,San Joaquin,077,732212,75143,74424,3778,78202,1415
2021-07-12,San Luis Obispo,079,281455,21728,21408,776,22184,258
2021-07-12,San Mateo,081,765935,43511,43138,517,43655,542
2021-07-12,Santa Barbara,083,443738,34935,34664,1160,35824,461
2021-07-12,Santa Clara,085,1922200,120841,119634,803,120437,2098
2021-07-12,Santa Cruz,087,273765,16446,16310,821,17131,207
2021-07-12,Shasta,089,179085,12734,12648,1680,14328,208
2021-07-12,Sierra,091,2930,66,62,12,74,0
2021-07-12,Siskiyou,093,43540,2009,1916,406,2322,29
2021-07-12,Solano,095,438530,34192,33859,620,34479,268
2021-07-12,Sonoma,097,501317,31684,31377,374,31751,322
2021-07-12,Stanislaus,099,539301,57567,57243,6137,63380,1028
2021-07-12,Sutter,101,95872,9782,9736,93,9829,114
2021-07-12,Tehama,103,63373,5187,5138,603,5741,63
2021-07-12,Trinity,105,12862,498,340,104,444,3
2021-07-12,Tulare,107,460477,50671,49882,9307,59189,853
2021-07-12,Tuolumne,109,53932,4122,4116,42,4158,64
2021-07-12,Ventura,111,848112,82581,81919,3236,85155,1040
2021-07-12,Yolo,113,214977,14420,14303,400,14703,213
2021-07-12,Yuba,115,75493,6357,6266,133,6399,52
2021-07-11,Alameda,001,1643700,91568,90597,2062,92659,1254
2021-07-11,Alpine,003,1148,88,89,0,89,0
2021-07-11,Amador,005,37829,3795,3779,34,3813,47
2021-07-11,Butte,007,227075,12944,12794,1918,14712,202
2021-07-11,Calaveras,009,45235,2247,2226,15,2241,57
2021-07-11,Colusa,011,21464,1986,1971,332,2303,16
2021-07-11,Contra Costa,013,1133247,72570,71744,1368,73112,823
2021-07-11,Del Norte,015,27424,1504,1467,13,1480,8
2021-07-11,El Dorado,017,186661,10692,10554,792,11346,114
2021-07-11,Fresno,019,978130,104124,102813,8927,111740,1728
2021-07-11,Glenn,021,27897,2468,2446,580,3026,20
2021-07-11,Humboldt,023,135768,4668,4611,55,4666,51
2021-07-11,Imperial,025,180216,28954,28787,2787,31574,741
2021-07-11,Inyo,027,18085,1418,1415,12,1427,36
2021-07-11,Kern,029,883053,98448,97637,11351,108988,1346
2021-07-11,Kings,031,150075,23418,23116,1127,24243,246
2021-07-11,Lake,033,64148,3777,3699,13,3712,63
2021-07-11,Lassen,035,31185,5316,5291,120,5411,21
2021-07-11,Los Angeles,037,10098052,1223946,1215182,43176,1258358,24558
2021-07-11,Madera,039,155013,16951,16766,969,17735,240
2021-07-11,Marin,041,260295,14404,14231,270,14501,233
2021-07-11,Mariposa,043,17540,445,442,11,453,5
2021-07-11,Mendocino,045,87422,4277,4167,88,4255,49
2021-07-11,Merced,047,269075,31447,31366,1074,32440,471
2021-07-11,Modoc,049,8938,421,411,149,560,4
2021-07-11,Mono,051,14174,1271,1275,18,1293,3
2021-07-11,Monterey,053,433212,43538,43307,1915,45222,504
2021-07-11,Napa,055,140530,10148,10100,41,10141,81
2021-07-11,Nevada,057,99092,5109,5035,196,5231,72
2021-07-11,Orange,059,3164182,259013,257009,11787,268796,5136
2021-07-11,Placer,061,380077,24307,24017,1641,25658,302
2021-07-11,Plumas,063,18699,733,716,14,730,4
2021-07-11,Riverside,065,2383286,297975,293969,14349,308318,4541
2021-07-11,Sacramento,067,1510023,110660,109696,1927,111623,1685
2021-07-11,San Benito,069,59416,6181,6163,116,6279,63
2021-07-11,San Bernardino,071,2135413,296991,295342,9181,304523,5167
2021-07-11,San Diego,073,3302833,286512,283819,15926,299745,3784
2021-07-11,San Francisco,075,870044,38090,37596,1363,38959,559
2021-07-11,San Joaquin,077,732212,75026,74376,3761,78137,1415
2021-07-11,San Luis Obispo,079,281455,21695,21403,775,22178,258
2021-07-11,San Mateo,081,765935,43432,43107,510,43617,542
2021-07-11,Santa Barbara,083,443738,34888,34646,1160,35806,461
2021-07-11,Santa Clara,085,1922200,120687,119549,802,120351,2098
2021-07-11,Santa Cruz,087,273765,16430,16303,821,17124,207
2021-07-11,Shasta,089,179085,12717,12647,1678,14325,208
2021-07-11,Sierra,091,2930,66,62,12,74,0
2021-07-11,Siskiyou,093,43540,2005,1915,404,2319,29
2021-07-11,Solano,095,438530,34110,33837,616,34453,268
2021-07-11,Sonoma,097,501317,31602,31352,374,31726,322
2021-07-11,Stanislaus,099,539301,57503,57230,6126,63356,1028
2021-07-11,Sutter,101,95872,9768,9728,93,9821,114
2021-07-11,Tehama,103,63373,5184,5138,603,5741,63
2021-07-11,Trinity,105,12862,497,340,104,444,3
2021-07-11,Tulare,107,460477,50646,49877,9288,59165,853
2021-07-11,Tuolumne,109,53932,4116,4116,42,4158,64
2021-07-11,Ventura,111,848112,82508,81875,3216,85091,1040
2021-07-11,Yolo,113,214977,14394,14285,394,14679,213
2021-07-11,Yuba,115,75493,6346,6260,133,6393,52
2021-07-10,Alameda,001,1643700,91417,90090,2058,92148,1252
2021-07-10,Alpine,003,1148,88,89,0,89,0
2021-07-10,Amador,005,37829,3789,3773,34,3807,47
2021-07-10,Butte,007,227075,12933,12764,1915,14679,202
2021-07-10,Calaveras,009,45235,2246,2214,15,2229,57
2021-07-10,Colusa,011,21464,1984,1969,332,2301,16
2021-07-10,Contra Costa,013,1133247,72470,71376,1367,72743,821
2021-07-10,Del Norte,015,27424,1502,1451,13,1464,8
2021-07-10,El Dorado,017,186661,10676,10508,788,11296,114
2021-07-10,Fresno,019,978130,104091,102675,8920,111595,1730
2021-07-10,Glenn,021,27897,2465,2440,579,3019,20
2021-07-10,Humboldt,023,135768,4659,4574,55,4629,51
2021-07-10,Imperial,025,180216,28941,28729,2787,31516,741
2021-07-10,Inyo,027,18085,1417,1415,12,1427,36
2021-07-10,Kern,029,883053,98408,97538,11334,108872,1346
2021-07-10,Kings,031,150075,23411,23090,1126,24216,246
2021-07-10,Lake,033,64148,3760,3667,13,3680,63
2021-07-10,Lassen,035,31185,5316,5290,120,5410,21
2021-07-10,Los Angeles,037,10098052,1222924,1212043,43073,1255116,24542
2021-07-10,Madera,039,155013,16945,16744,966,17710,241
2021-07-10,Marin,041,260295,14390,14194,270,14464,233
2021-07-10,Mariposa,043,17540,445,442,11,453,5
2021-07-10,Mendocino,045,87422,4270,4153,87,4240,49
2021-07-10,Merced,047,269075,31434,31328,1074,32402,470
2021-07-10,Modoc,049,8938,421,410,149,559,4
2021-07-10,Mono,051,14174,1271,1275,18,1293,3
2021-07-10,Monterey,053,433212,43524,43251,1913,45164,499
2021-07-10,Napa,055,140530,10136,10077,41,10118,81
2021-07-10,Nevada,057,99092,5100,5000,196,5196,72
2021-07-10,Orange,059,3164182,258835,256438,11771,268209,5135
2021-07-10,Placer,061,380077,24278,23916,1631,25547,302
2021-07-10,Plumas,063,18699,732,717,14,731,4
2021-07-10,Riverside,065,2383286,297785,293474,14335,307809,4541
2021-07-10,Sacramento,067,1510023,110511,109091,1922,111013,1682
2021-07-10,San Benito,069,59416,6176,6141,116,6257,63
2021-07-10,San Bernardino,071,2135413,296803,294932,9169,304101,5117
2021-07-10,San Diego,073,3302833,286223,283577,15873,299450,3783
2021-07-10,San Francisco,075,870044,38007,37338,1360,38698,559
2021-07-10,San Joaquin,077,732212,74969,74150,3755,77905,1412
2021-07-10,San Luis Obispo,079,281455,21684,21375,774,22149,258
2021-07-10,San Mateo,081,765935,43380,42948,508,43456,542
2021-07-10,Santa Barbara,083,443738,34861,34595,1160,35755,460
2021-07-10,Santa Clara,085,1922200,120584,119330,799,120129,2094
2021-07-10,Santa Cruz,087,273765,16423,16286,821,17107,207
2021-07-10,Shasta,089,179085,12704,12623,1673,14296,206
2021-07-10,Sierra,091,2930,66,61,12,73,0
2021-07-10,Siskiyou,093,43540,2003,1909,401,2310,29
2021-07-10,Solano,095,438530,34068,33678,610,34288,268
2021-07-10,Sonoma,097,501317,31551,31231,374,31605,317
2021-07-10,Stanislaus,099,539301,57467,57104,6116,63220,1026
2021-07-10,Sutter,101,95872,9756,9692,93,9785,114
2021-07-10,Tehama,103,63373,5181,5131,603,5734,63
2021-07-10,Trinity,105,12862,497,341,104,445,3
2021-07-10,Tulare,107,460477,50636,49850,9282,59132,853
2021-07-10,Tuolumne,109,53932,4114,4114,42,4156,64
2021-07-10,Ventura,111,848112,82463,81713,3198,84911,1039
2021-07-10,Yolo,113,214977,14373,14250,391,14641,213
2021-07-10,Yuba,115,75493,6336,6238,133,6371,52
2021-07-09,Alameda,001,1643700,91257,90090,2053,92143,1252
2021-07-09,Alpine,003,1148,88,89,0,89,0
2021-07-09,Amador,005,37829,3788,3773,34,3807,47
2021-07-09,Butte,007,227075,12922,12764,1913,14677,202
2021-07-09,Calaveras,009,45235,2244,2214,15,2229,57
2021-07-09,Colusa,011,21464,1983,1969,332,2301,16
2021-07-09,Contra Costa,013,1133247,72345,71376,1365,72741,821
2021-07-09,Del Norte,015,27424,1497,1451,13,1464,8
2021-07-09,El Dorado,017,186661,10661,10508,787,11295,114
2021-07-09,Fresno,019,978130,104035,102675,8913,111588,1730
2021-07-09,Glenn,021,27897,2464,2440,577,3017,20
2021-07-09,Humboldt,023,135768,4640,4574,55,4629,51
2021-07-09,Imperial,025,180216,28933,28729,2786,31515,741
2021-07-09,Inyo,027,18085,1416,1415,12,1427,36
2021-07-09,Kern,029,883053,98370,97538,11322,108860,1346
2021-07-09,Kings,031,150075,23400,23090,1125,24215,246
2021-07-09,Lake,033,64148,3746,3667,13,3680,63
2021-07-09,Lassen,035,31185,5314,5290,119,5409,21
2021-07-09,Los Angeles,037,10098052,1221920,1212043,43000,1255043,24542
2021-07-09,Madera,039,155013,16935,16744,965,17709,241
2021-07-09,Marin,041,260295,14369,14194,269,14463,233
2021-07-09,Mariposa,043,17540,445,442,11,453,5
2021-07-09,Mendocino,045,87422,4263,4153,87,4240,49
2021-07-09,Merced,047,269075,31419,31328,1074,32402,470
2021-07-09,Modoc,049,8938,421,410,149,559,4
2021-07-09,Mono,051,14174,1271,1275,18,1293,3
2021-07-09,Monterey,053,433212,43515,43251,1913,45164,499
2021-07-09,Napa,055,140530,10129,10077,41,10118,81
2021-07-09,Nevada,057,99092,5091,5000,196,5196,72
2021-07-09,Orange,059,3164182,258630,256438,11757,268195,5135
2021-07-09,Placer,061,380077,24256,23916,1625,25541,302
2021-07-09,Plumas,063,18699,730,717,14,731,4
2021-07-09,Riverside,065,2383286,297599,293474,14322,307796,4541
2021-07-09,Sacramento,067,1510023,110357,109091,1913,111004,1682
2021-07-09,San Benito,069,59416,6174,6141,116,6257,63
2021-07-09,San Bernardino,071,2135413,296651,294932,9162,304094,5117
2021-07-09,San Diego,073,3302833,285934,283577,15825,299402,3783
2021-07-09,San Francisco,075,870044,37927,37338,1353,38691,559
2021-07-09,San Joaquin,077,732212,74895,74150,3748,77898,1412
2021-07-09,San Luis Obispo,079,281455,21672,21375,774,22149,258
2021-07-09,San Mateo,081,765935,43336,42948,504,43452,542
2021-07-09,Santa Barbara,083,443738,34840,34595,1159,35754,460
2021-07-09,Santa Clara,085,1922200,120474,119330,799,120129,2094
2021-07-09,Santa Cruz,087,273765,16420,16286,821,17107,207
2021-07-09,Shasta,089,179085,12698,12623,1668,14291,206
2021-07-09,Sierra,091,2930,66,61,12,73,0
2021-07-09,Siskiyou,093,43540,2001,1909,400,2309,29
2021-07-09,Solano,095,438530,34032,33678,606,34284,268
2021-07-09,Sonoma,097,501317,31515,31231,374,31605,317
2021-07-09,Stanislaus,099,539301,57438,57104,6114,63218,1026
2021-07-09,Sutter,101,95872,9747,9692,93,9785,114
2021-07-09,Tehama,103,63373,5179,5131,603,5734,63
2021-07-09,Trinity,105,12862,496,341,101,442,3
2021-07-09,Tulare,107,460477,50623,49850,9276,59126,853
2021-07-09,Tuolumne,109,53932,4110,4114,42,4156,64
2021-07-09,Ventura,111,848112,82408,81713,3189,84902,1039
2021-07-09,Yolo,113,214977,14358,14250,387,14637,213
2021-07-09,Yuba,115,75493,6323,6238,133,6371,52
2021-07-08,Alameda,001,1643700,91050,90090,2050,92140,1252
2021-07-08,Alpine,003,1148,88,89,0,89,0
2021-07-08,Amador,005,37829,3786,3773,34,3807,47
2021-07-08,Butte,007,227075,12909,12764,1910,14674,202
2021-07-08,Calaveras,009,45235,2241,2214,14,2228,57
2021-07-08,Colusa,011,21464,1983,1969,332,2301,16
2021-07-08,Contra Costa,013,1133247,72217,71376,1360,72736,821
2021-07-08,Del Norte,015,27424,1495,1451,13,1464,8
2021-07-08,El Dorado,017,186661,10644,10508,782,11290,114
2021-07-08,Fresno,019,978130,103973,102675,8902,111577,1730
2021-07-08,Glenn,021,27897,2464,2440,577,3017,20
2021-07-08,Humboldt,023,135768,4624,4574,54,4628,51
2021-07-08,Imperial,025,180216,28921,28729,2785,31514,741
2021-07-08,Inyo,027,18085,1416,1415,12,1427,36
2021-07-08,Kern,029,883053,98322,97538,11307,108845,1346
2021-07-08,Kings,031,150075,23391,23090,1125,24215,246
2021-07-08,Lake,033,64148,3732,3667,13,3680,63
2021-07-08,Lassen,035,31185,5311,5290,119,5409,21
2021-07-08,Los Angeles,037,10098052,1220706,1212043,42904,1254947,24542
2021-07-08,Madera,039,155013,16919,16744,965,17709,241
2021-07-08,Marin,041,260295,14355,14194,269,14463,233
2021-07-08,Mariposa,043,17540,444,442,11,453,5
2021-07-08,Mendocino,045,87422,4260,4153,87,4240,49
2021-07-08,Merced,047,269075,31405,31328,1072,32400,470
2021-07-08,Modoc,049,8938,421,410,149,559,4
2021-07-08,Mono,051,14174,1271,1275,18,1293,3
2021-07-08,Monterey,053,433212,43495,43251,1907,45158,499
2021-07-08,Napa,055,140530,10125,10077,41,10118,81
2021-07-08,Nevada,057,99092,5085,5000,196,5196,72
2021-07-08,Orange,059,3164182,258435,256438,11735,268173,5135
2021-07-08,Placer,061,380077,24217,23916,1617,25533,302
2021-07-08,Plumas,063,18699,729,717,14,731,4
2021-07-08,Riverside,065,2383286,297398,293474,14306,307780,4541
2021-07-08,Sacramento,067,1510023,110135,109091,1906,110997,1682
2021-07-08,San Benito,069,59416,6171,6141,116,6257,63
2021-07-08,San Bernardino,071,2135413,296475,294932,9153,304085,5117
2021-07-08,San Diego,073,3302833,285607,283577,15777,299354,3783
2021-07-08,San Francisco,075,870044,37847,37338,1349,38687,559
2021-07-08,San Joaquin,077,732212,74807,74150,3735,77885,1412
2021-07-08,San Luis Obispo,079,281455,21660,21375,771,22146,258
2021-07-08,San Mateo,081,765935,43285,42948,503,43451,542
2021-07-08,Santa Barbara,083,443738,34813,34595,1157,35752,460
2021-07-08,Santa Clara,085,1922200,120381,119330,798,120128,2094
2021-07-08,Santa Cruz,087,273765,16414,16286,821,17107,207
2021-07-08,Shasta,089,179085,12692,12623,1664,14287,206
2021-07-08,Sierra,091,2930,66,61,12,73,0
2021-07-08,Siskiyou,093,43540,1996,1909,397,2306,29
2021-07-08,Solano,095,438530,33977,33678,600,34278,268
2021-07-08,Sonoma,097,501317,31484,31231,373,31604,317
2021-07-08,Stanislaus,099,539301,57412,57104,6110,63214,1026
2021-07-08,Sutter,101,95872,9733,9692,91,9783,114
2021-07-08,Tehama,103,63373,5176,5131,602,5733,63
2021-07-08,Trinity,105,12862,496,341,101,442,3
2021-07-08,Tulare,107,460477,50605,49850,9268,59118,853
2021-07-08,Tuolumne,109,53932,4108,4114,42,4156,64
2021-07-08,Ventura,111,848112,82344,81713,3173,84886,1039
2021-07-08,Yolo,113,214977,14339,14250,385,14635,213
2021-07-08,Yuba,115,75493,6315,6238,133,6371,52
2021-07-07,Alameda,001,1643700,90865,89995,2044,92039,1253
2021-07-07,Alpine,003,1148,88,89,0,89,0
2021-07-07,Amador,005,37829,3781,3770,34,3804,47
2021-07-07,Butte,007,227075,12896,12750,1905,14655,202
2021-07-07,Calaveras,009,45235,2234,2212,14,2226,57
2021-07-07,Colusa,011,21464,1979,1969,332,2301,16
2021-07-07,Contra Costa,013,1133247,72070,71308,1358,72666,821
2021-07-07,Del Norte,015,27424,1490,1446,13,1459,8
2021-07-07,El Dorado,017,186661,10624,10494,780,11274,114
2021-07-07,Fresno,019,978130,103923,102639,8895,111534,1729
2021-07-07,Glenn,021,27897,2464,2441,577,3018,20
2021-07-07,Humboldt,023,135768,4610,4566,54,4620,51
2021-07-07,Imperial,025,180216,28914,28701,2785,31486,740
2021-07-07,Inyo,027,18085,1415,1415,12,1427,36
2021-07-07,Kern,029,883053,98278,97507,11292,108799,1348
2021-07-07,Kings,031,150075,23378,23085,1122,24207,245
2021-07-07,Lake,033,64148,3713,3660,13,3673,63
2021-07-07,Lassen,035,31185,5311,5286,119,5405,21
2021-07-07,Los Angeles,037,10098052,1219527,1211316,42798,1254114,24531
2021-07-07,Madera,039,155013,16908,16733,963,17696,241
2021-07-07,Marin,041,260295,14336,14183,268,14451,233
2021-07-07,Mariposa,043,17540,442,442,11,453,5
2021-07-07,Mendocino,045,87422,4251,4145,87,4232,49
2021-07-07,Merced,047,269075,31390,31317,1072,32389,470
2021-07-07,Modoc,049,8938,421,410,149,559,4
2021-07-07,Mono,051,14174,1270,1274,18,1292,3
2021-07-07,Monterey,053,433212,43470,43233,1905,45138,494
2021-07-07,Napa,055,140530,10114,10078,41,10119,81
2021-07-07,Nevada,057,99092,5078,4996,196,5192,72
2021-07-07,Orange,059,3164182,258209,256301,11713,268014,5132
2021-07-07,Placer,061,380077,24181,23901,1607,25508,302
2021-07-07,Plumas,063,18699,729,710,14,724,4
2021-07-07,Riverside,065,2383286,297183,293331,14296,307627,4538
2021-07-07,Sacramento,067,1510023,109944,108954,1898,110852,1682
2021-07-07,San Benito,069,59416,6166,6137,116,6253,63
2021-07-07,San Bernardino,071,2135413,296307,294787,9146,303933,5087
2021-07-07,San Diego,073,3302833,285287,283377,15737,299114,3782
2021-07-07,San Francisco,075,870044,37755,37284,1346,38630,558
2021-07-07,San Joaquin,077,732212,74731,74095,3719,77814,1410
2021-07-07,San Luis Obispo,079,281455,21651,21360,769,22129,258
2021-07-07,San Mateo,081,765935,43230,42908,500,43408,542
2021-07-07,Santa Barbara,083,443738,34787,34582,1157,35739,460
2021-07-07,Santa Clara,085,1922200,120283,119250,797,120047,2094
2021-07-07,Santa Cruz,087,273765,16405,16279,820,17099,207
2021-07-07,Shasta,089,179085,12684,12613,1661,14274,206
2021-07-07,Sierra,091,2930,66,60,12,72,0
2021-07-07,Siskiyou,093,43540,1990,1908,393,2301,29
2021-07-07,Solano,095,438530,33928,33659,593,34252,268
2021-07-07,Sonoma,097,501317,31438,31172,373,31545,316
2021-07-07,Stanislaus,099,539301,57380,57102,6105,63207,1028
2021-07-07,Sutter,101,95872,9723,9683,91,9774,114
2021-07-07,Tehama,103,63373,5175,5129,602,5731,63
2021-07-07,Trinity,105,12862,496,341,101,442,3
2021-07-07,Tulare,107,460477,50601,49835,9259,59094,853
2021-07-07,Tuolumne,109,53932,4104,4115,41,4156,64
2021-07-07,Ventura,111,848112,82300,81608,3159,84767,1036
2021-07-07,Yolo,113,214977,14329,14236,382,14618,213
2021-07-07,Yuba,115,75493,6299,6233,133,6366,51
2021-07-06,Alameda,001,1643700,90667,89918,2036,91954,1253
2021-07-06,Alpine,003,1148,88,89,0,89,0
2021-07-06,Amador,005,37829,3780,3768,33,3801,47
2021-07-06,Butte,007,227075,12883,12744,1902,14646,201
2021-07-06,Calaveras,009,45235,2234,2211,14,2225,55
2021-07-06,Colusa,011,21464,1978,1967,329,2296,16
2021-07-06,Contra Costa,013,1133247,71942,71262,1355,72617,820
2021-07-06,Del Norte,015,27424,1486,1445,13,1458,8
2021-07-06,El Dorado,017,186661,10606,10484,779,11263,113
2021-07-06,Fresno,019,978130,103871,102616,8883,111499,1727
2021-07-06,Glenn,021,27897,2463,2438,577,3015,20
2021-07-06,Humboldt,023,135768,4596,4565,53,4618,49
2021-07-06,Imperial,025,180216,28899,28693,2783,31476,739
2021-07-06,Inyo,027,18085,1415,1412,12,1424,36
2021-07-06,Kern,029,883053,98236,97491,11281,108772,1346
2021-07-06,Kings,031,150075,23370,23077,1121,24198,245
2021-07-06,Lake,033,64148,3703,3659,13,3672,63
2021-07-06,Lassen,035,31185,5310,5288,118,5406,21
2021-07-06,Los Angeles,037,10098052,1218308,1210965,42699,1253664,24525
2021-07-06,Madera,039,155013,16896,16730,963,17693,241
2021-07-06,Marin,041,260295,14322,14181,268,14449,233
2021-07-06,Mariposa,043,17540,442,442,11,453,5
2021-07-06,Mendocino,045,87422,4244,4143,87,4230,49
2021-07-06,Merced,047,269075,31373,31317,1071,32388,470
2021-07-06,Modoc,049,8938,421,411,149,560,4
2021-07-06,Mono,051,14174,1269,1274,18,1292,3
2021-07-06,Monterey,053,433212,43447,43224,1904,45128,494
2021-07-06,Napa,055,140530,10103,10081,41,10122,81
2021-07-06,Nevada,057,99092,5069,4988,196,5184,72
2021-07-06,Orange,059,3164182,257965,256227,11696,267923,5129
2021-07-06,Placer,061,380077,24140,23876,1601,25477,302
2021-07-06,Plumas,063,18699,728,708,14,722,4
2021-07-06,Riverside,065,2383286,296981,293227,14278,307505,4539
2021-07-06,Sacramento,067,1510023,109733,108850,1890,110740,1679
2021-07-06,San Benito,069,59416,6162,6137,116,6253,63
2021-07-06,San Bernardino,071,2135413,296128,294712,9133,303845,5056
2021-07-06,San Diego,073,3302833,284930,283278,15678,298956,3782
2021-07-06,San Francisco,075,870044,37638,37251,1345,38596,558
2021-07-06,San Joaquin,077,732212,74661,74019,3707,77726,1410
2021-07-06,San Luis Obispo,079,281455,21634,21354,768,22122,257
2021-07-06,San Mateo,081,765935,43155,42895,500,43395,541
2021-07-06,Santa Barbara,083,443738,34768,34572,1155,35727,460
2021-07-06,Santa Clara,085,1922200,120165,119194,794,119988,2095
2021-07-06,Santa Cruz,087,273765,16400,16274,819,17093,207
2021-07-06,Shasta,089,179085,12674,12606,1659,14265,205
2021-07-06,Sierra,091,2930,65,60,12,72,0
2021-07-06,Siskiyou,093,43540,1987,1905,389,2294,29
2021-07-06,Solano,095,438530,33877,33619,590,34209,268
2021-07-06,Sonoma,097,501317,31375,31130,372,31502,316
2021-07-06,Stanislaus,099,539301,57333,57120,6094,63214,1029
2021-07-06,Sutter,101,95872,9714,9674,90,9764,114
2021-07-06,Tehama,103,63373,5172,5126,601,5727,63
2021-07-06,Trinity,105,12862,496,341,101,442,3
2021-07-06,Tulare,107,460477,50586,49826,9248,59074,853
2021-07-06,Tuolumne,109,53932,4102,4113,41,4154,64
2021-07-06,Ventura,111,848112,82260,81534,3133,84667,1033
2021-07-06,Yolo,113,214977,14307,14227,379,14606,213
2021-07-06,Yuba,115,75493,6288,6231,133,6364,51
2021-07-05,Alameda,001,1643700,90489,89892,2031,91923,1253
2021-07-05,Alpine,003,1148,88,89,0,89,0
2021-07-05,Amador,005,37829,3778,3768,33,3801,47
2021-07-05,Butte,007,227075,12875,12740,1892,14632,201
2021-07-05,Calaveras,009,45235,2232,2211,14,2225,55
2021-07-05,Colusa,011,21464,1976,1966,328,2294,16
2021-07-05,Contra Costa,013,1133247,71814,71235,1355,72590,820
2021-07-05,Del Norte,015,27424,1482,1446,13,1459,8
2021-07-05,El Dorado,017,186661,10581,10481,779,11260,113
2021-07-05,Fresno,019,978130,103812,102592,8868,111460,1727
2021-07-05,Glenn,021,27897,2460,2438,576,3014,20
2021-07-05,Humboldt,023,135768,4582,4563,53,4616,49
2021-07-05,Imperial,025,180216,28880,28689,2783,31472,739
2021-07-05,Inyo,027,18085,1415,1412,12,1424,36
2021-07-05,Kern,029,883053,98189,97479,11260,108739,1346
2021-07-05,Kings,031,150075,23362,23065,1118,24183,245
2021-07-05,Lake,033,64148,3685,3645,13,3658,63
2021-07-05,Lassen,035,31185,5307,5288,117,5405,21
2021-07-05,Los Angeles,037,10098052,1217117,1210653,42596,1253249,24522
2021-07-05,Madera,039,155013,16885,16722,962,17684,241
2021-07-05,Marin,041,260295,14301,14178,268,14446,233
2021-07-05,Mariposa,043,17540,442,441,11,452,5
2021-07-05,Mendocino,045,87422,4239,4139,86,4225,49
2021-07-05,Merced,047,269075,31353,31312,1071,32383,470
2021-07-05,Modoc,049,8938,421,410,149,559,4
2021-07-05,Mono,051,14174,1269,1273,18,1291,3
2021-07-05,Monterey,053,433212,43427,43218,1899,45117,494
2021-07-05,Napa,055,140530,10097,10074,41,10115,81
2021-07-05,Nevada,057,99092,5051,4980,195,5175,72
2021-07-05,Orange,059,3164182,257764,256173,11678,267851,5129
2021-07-05,Placer,061,380077,24093,23867,1593,25460,302
2021-07-05,Plumas,063,18699,727,708,14,722,4
2021-07-05,Riverside,065,2383286,296789,293193,14266,307459,4539
2021-07-05,Sacramento,067,1510023,109550,108758,1881,110639,1679
2021-07-05,San Benito,069,59416,6155,6137,116,6253,63
2021-07-05,San Bernardino,071,2135413,295966,294647,9126,303773,5037
2021-07-05,San Diego,073,3302833,284567,282834,15634,298468,3782
2021-07-05,San Francisco,075,870044,37552,37237,1340,38577,558
2021-07-05,San Joaquin,077,732212,74591,73999,3702,77701,1410
2021-07-05,San Luis Obispo,079,281455,21621,21351,767,22118,257
2021-07-05,San Mateo,081,765935,43103,42876,497,43373,541
2021-07-05,Santa Barbara,083,443738,34748,34569,1155,35724,460
2021-07-05,Santa Clara,085,1922200,120059,119184,792,119976,2095
2021-07-05,Santa Cruz,087,273765,16391,16273,818,17091,208
2021-07-05,Shasta,089,179085,12665,12603,1657,14260,205
2021-07-05,Sierra,091,2930,65,60,12,72,0
2021-07-05,Siskiyou,093,43540,1985,1904,388,2292,29
2021-07-05,Solano,095,438530,33807,33612,584,34196,268
2021-07-05,Sonoma,097,501317,31322,31116,372,31488,316
2021-07-05,Stanislaus,099,539301,57303,57109,6083,63192,1029
2021-07-05,Sutter,101,95872,9702,9667,90,9757,114
2021-07-05,Tehama,103,63373,5171,5125,601,5726,63
2021-07-05,Trinity,105,12862,495,341,100,441,3
2021-07-05,Tulare,107,460477,50568,49818,9245,59063,853
2021-07-05,Tuolumne,109,53932,4098,4112,41,4153,64
2021-07-05,Ventura,111,848112,82209,81519,3114,84633,1033
2021-07-05,Yolo,113,214977,14288,14225,371,14596,213
2021-07-05,Yuba,115,75493,6280,6223,133,6356,51
2021-07-04,Alameda,001,1643700,90324,89683,2028,91711,1253
2021-07-04,Alpine,003,1148,88,89,0,89,0
2021-07-04,Amador,005,37829,3777,3758,33,3791,46
2021-07-04,Butte,007,227075,12865,12684,1892,14576,201
2021-07-04,Calaveras,009,45235,2228,2200,14,2214,55
2021-07-04,Colusa,011,21464,1976,1969,328,2297,15
2021-07-04,Contra Costa,013,1133247,71708,70941,1350,72291,818
2021-07-04,Del Norte,015,27424,1479,1439,13,1452,8
2021-07-04,El Dorado,017,186661,10572,10433,778,11211,113
2021-07-04,Fresno,019,978130,103766,102512,8851,111363,1727
2021-07-04,Glenn,021,27897,2458,2442,575,3017,20
2021-07-04,Humboldt,023,135768,4574,4530,53,4583,49
2021-07-04,Imperial,025,180216,28874,28661,2783,31444,739
2021-07-04,Inyo,027,18085,1415,1412,12,1424,35
2021-07-04,Kern,029,883053,98170,97421,11251,108672,1347
2021-07-04,Kings,031,150075,23354,23051,1118,24169,245
2021-07-04,Lake,033,64148,3675,3623,13,3636,62
2021-07-04,Lassen,035,31185,5306,5277,117,5394,20
2021-07-04,Los Angeles,037,10098052,1216259,1208705,42509,1251214,24506
2021-07-04,Madera,039,155013,16873,16696,960,17656,240
2021-07-04,Marin,041,260295,14286,14143,268,14411,233
2021-07-04,Mariposa,043,17540,442,441,11,452,5
2021-07-04,Mendocino,045,87422,4229,4122,86,4208,49
2021-07-04,Merced,047,269075,31342,31297,1071,32368,469
2021-07-04,Modoc,049,8938,421,410,149,559,4
2021-07-04,Mono,051,14174,1269,1275,18,1293,3
2021-07-04,Monterey,053,433212,43411,43212,1898,45110,492
2021-07-04,Napa,055,140530,10089,10045,40,10085,81
2021-07-04,Nevada,057,99092,5041,4966,195,5161,72
2021-07-04,Orange,059,3164182,257589,255823,11657,267480,5126
2021-07-04,Placer,061,380077,24056,23764,1586,25350,299
2021-07-04,Plumas,063,18699,727,707,14,721,4
2021-07-04,Riverside,065,2383286,296629,293260,14260,307520,4536
2021-07-04,Sacramento,067,1510023,109380,108257,1875,110132,1676
2021-07-04,San Benito,069,59416,6148,6108,116,6224,63
2021-07-04,San Bernardino,071,2135413,295799,294294,9119,303413,5003
2021-07-04,San Diego,073,3302833,284343,282692,15596,298288,3780
2021-07-04,San Francisco,075,870044,37494,37107,1334,38441,558
2021-07-04,San Joaquin,077,732212,74525,73841,3694,77535,1409
2021-07-04,San Luis Obispo,079,281455,21615,21330,766,22096,256
2021-07-04,San Mateo,081,765935,43069,42691,497,43188,541
2021-07-04,Santa Barbara,083,443738,34725,34526,1154,35680,456
2021-07-04,Santa Clara,085,1922200,119969,118966,791,119757,2090
2021-07-04,Santa Cruz,087,273765,16380,16254,818,17072,208
2021-07-04,Shasta,089,179085,12661,12582,1656,14238,204
2021-07-04,Sierra,091,2930,64,60,12,72,0
2021-07-04,Siskiyou,093,43540,1981,1899,387,2286,29
2021-07-04,Solano,095,438530,33766,33486,582,34068,268
2021-07-04,Sonoma,097,501317,31292,31000,371,31371,316
2021-07-04,Stanislaus,099,539301,57288,57018,6077,63095,1018
2021-07-04,Sutter,101,95872,9691,9644,90,9734,114
2021-07-04,Tehama,103,63373,5167,5124,601,5725,63
2021-07-04,Trinity,105,12862,494,341,100,441,3
2021-07-04,Tulare,107,460477,50558,49789,9242,59031,853
2021-07-04,Tuolumne,109,53932,4090,4113,41,4154,64
2021-07-04,Ventura,111,848112,82151,81425,3103,84528,1033
2021-07-04,Yolo,113,214977,14268,14188,368,14556,213
2021-07-04,Yuba,115,75493,6272,6197,133,6330,51
2021-07-03,Alameda,001,1643700,90235,89683,2020,91703,1253
2021-07-03,Alpine,003,1148,88,89,0,89,0
2021-07-03,Amador,005,37829,3777,3758,33,3791,46
2021-07-03,Butte,007,227075,12861,12684,1891,14575,201
2021-07-03,Calaveras,009,45235,2226,2200,14,2214,55
2021-07-03,Colusa,011,21464,1975,1969,328,2297,15
2021-07-03,Contra Costa,013,1133247,71649,70941,1347,72288,818
2021-07-03,Del Norte,015,27424,1476,1439,13,1452,8
2021-07-03,El Dorado,017,186661,10565,10433,776,11209,113
2021-07-03,Fresno,019,978130,103742,102512,8842,111354,1727
2021-07-03,Glenn,021,27897,2458,2442,575,3017,20
2021-07-03,Humboldt,023,135768,4569,4530,53,4583,49
2021-07-03,Imperial,025,180216,28864,28661,2783,31444,739
2021-07-03,Inyo,027,18085,1415,1412,12,1424,35
2021-07-03,Kern,029,883053,98150,97421,11243,108664,1347
2021-07-03,Kings,031,150075,23354,23051,1117,24168,245
2021-07-03,Lake,033,64148,3665,3623,13,3636,62
2021-07-03,Lassen,035,31185,5305,5277,117,5394,20
2021-07-03,Los Angeles,037,10098052,1215831,1208705,42478,1251183,24506
2021-07-03,Madera,039,155013,16864,16696,957,17653,240
2021-07-03,Marin,041,260295,14282,14143,268,14411,233
2021-07-03,Mariposa,043,17540,442,441,11,452,5
2021-07-03,Mendocino,045,87422,4228,4122,86,4208,49
2021-07-03,Merced,047,269075,31329,31297,1070,32367,469
2021-07-03,Modoc,049,8938,420,410,149,559,4
2021-07-03,Mono,051,14174,1268,1275,18,1293,3
2021-07-03,Monterey,053,433212,43399,43212,1895,45107,492
2021-07-03,Napa,055,140530,10084,10045,40,10085,81
2021-07-03,Nevada,057,99092,5027,4966,195,5161,72
2021-07-03,Orange,059,3164182,257505,255823,11650,267473,5126
2021-07-03,Placer,061,380077,24037,23764,1583,25347,299
2021-07-03,Plumas,063,18699,727,707,14,721,4
2021-07-03,Riverside,065,2383286,296537,293260,14256,307516,4536
2021-07-03,Sacramento,067,1510023,109306,108257,1872,110129,1676
2021-07-03,San Benito,069,59416,6141,6108,116,6224,63
2021-07-03,San Bernardino,071,2135413,295709,294294,9116,303410,5003
2021-07-03,San Diego,073,3302833,284212,282692,15577,298269,3780
2021-07-03,San Francisco,075,870044,37453,37107,1331,38438,558
2021-07-03,San Joaquin,077,732212,74489,73841,3689,77530,1409
2021-07-03,San Luis Obispo,079,281455,21603,21330,766,22096,256
2021-07-03,San Mateo,081,765935,43044,42691,496,43187,541
2021-07-03,Santa Barbara,083,443738,34716,34526,1153,35679,456
2021-07-03,Santa Clara,085,1922200,119922,118966,791,119757,2090
2021-07-03,Santa Cruz,087,273765,16373,16254,818,17072,208
2021-07-03,Shasta,089,179085,12657,12582,1654,14236,204
2021-07-03,Sierra,091,2930,64,60,12,72,0
2021-07-03,Siskiyou,093,43540,1980,1899,386,2285,29
2021-07-03,Solano,095,438530,33722,33486,582,34068,268
2021-07-03,Sonoma,097,501317,31258,31000,371,31371,316
2021-07-03,Stanislaus,099,539301,57277,57018,6069,63087,1018
2021-07-03,Sutter,101,95872,9681,9644,90,9734,114
2021-07-03,Tehama,103,63373,5165,5124,601,5725,63
2021-07-03,Trinity,105,12862,494,341,100,441,3
2021-07-03,Tulare,107,460477,50552,49789,9236,59025,853
2021-07-03,Tuolumne,109,53932,4089,4113,41,4154,64
2021-07-03,Ventura,111,848112,82121,81425,3095,84520,1033
2021-07-03,Yolo,113,214977,14258,14188,365,14553,213
2021-07-03,Yuba,115,75493,6266,6197,133,6330,51
2021-07-02,Alameda,001,1643700,90153,89683,2019,91702,1253
2021-07-02,Alpine,003,1148,88,89,0,89,0
2021-07-02,Amador,005,37829,3775,3758,33,3791,46
2021-07-02,Butte,007,227075,12854,12684,1891,14575,201
2021-07-02,Calaveras,009,45235,2224,2200,14,2214,55
2021-07-02,Colusa,011,21464,1974,1969,327,2296,15
2021-07-02,Contra Costa,013,1133247,71579,70941,1343,72284,818
2021-07-02,Del Norte,015,27424,1476,1439,13,1452,8
2021-07-02,El Dorado,017,186661,10557,10433,776,11209,113
2021-07-02,Fresno,019,978130,103713,102512,8836,111348,1727
2021-07-02,Glenn,021,27897,2457,2442,574,3016,20
2021-07-02,Humboldt,023,135768,4566,4530,52,4582,49
2021-07-02,Imperial,025,180216,28858,28661,2782,31443,739
2021-07-02,Inyo,027,18085,1415,1412,12,1424,35
2021-07-02,Kern,029,883053,98132,97421,11234,108655,1347
2021-07-02,Kings,031,150075,23344,23051,1117,24168,245
2021-07-02,Lake,033,64148,3659,3623,13,3636,62
2021-07-02,Lassen,035,31185,5305,5277,117,5394,20
2021-07-02,Los Angeles,037,10098052,1215357,1208705,42439,1251144,24506
2021-07-02,Madera,039,155013,16855,16696,956,17652,240
2021-07-02,Marin,041,260295,14278,14143,268,14411,233
2021-07-02,Mariposa,043,17540,442,441,11,452,5
2021-07-02,Mendocino,045,87422,4224,4122,85,4207,49
2021-07-02,Merced,047,269075,31320,31297,1070,32367,469
2021-07-02,Modoc,049,8938,420,410,149,559,4
2021-07-02,Mono,051,14174,1267,1275,18,1293,3
2021-07-02,Monterey,053,433212,43391,43212,1894,45106,492
2021-07-02,Napa,055,140530,10079,10045,40,10085,81
2021-07-02,Nevada,057,99092,5018,4966,195,5161,72
2021-07-02,Orange,059,3164182,257394,255823,11643,267466,5126
2021-07-02,Placer,061,380077,24020,23764,1576,25340,299
2021-07-02,Plumas,063,18699,727,707,14,721,4
2021-07-02,Riverside,065,2383286,296440,293260,14251,307511,4536
2021-07-02,Sacramento,067,1510023,109228,108257,1871,110128,1676
2021-07-02,San Benito,069,59416,6138,6108,116,6224,63
2021-07-02,San Bernardino,071,2135413,295622,294294,9114,303408,5003
2021-07-02,San Diego,073,3302833,284067,282692,15551,298243,3780
2021-07-02,San Francisco,075,870044,37404,37107,1329,38436,558
2021-07-02,San Joaquin,077,732212,74456,73841,3683,77524,1409
2021-07-02,San Luis Obispo,079,281455,21597,21330,765,22095,256
2021-07-02,San Mateo,081,765935,43008,42691,496,43187,541
2021-07-02,Santa Barbara,083,443738,34706,34526,1153,35679,456
2021-07-02,Santa Clara,085,1922200,119844,118966,791,119757,2090
2021-07-02,Santa Cruz,087,273765,16369,16254,818,17072,208
2021-07-02,Shasta,089,179085,12653,12582,1654,14236,204
2021-07-02,Sierra,091,2930,63,60,12,72,0
2021-07-02,Siskiyou,093,43540,1977,1899,385,2284,29
2021-07-02,Solano,095,438530,33697,33486,582,34068,268
2021-07-02,Sonoma,097,501317,31235,31000,371,31371,316
2021-07-02,Stanislaus,099,539301,57262,57018,6068,63086,1018
2021-07-02,Sutter,101,95872,9677,9644,90,9734,114
2021-07-02,Tehama,103,63373,5163,5124,599,5723,63
2021-07-02,Trinity,105,12862,494,341,100,441,3
2021-07-02,Tulare,107,460477,50542,49789,9228,59017,853
2021-07-02,Tuolumne,109,53932,4086,4113,41,4154,64
2021-07-02,Ventura,111,848112,82078,81425,3087,84512,1033
2021-07-02,Yolo,113,214977,14242,14188,363,14551,213
2021-07-02,Yuba,115,75493,6258,6197,133,6330,51
2021-07-01,Alameda,001,1643700,90053,89683,2017,91700,1253
2021-07-01,Alpine,003,1148,88,89,0,89,0
2021-07-01,Amador,005,37829,3774,3758,33,3791,46
2021-07-01,Butte,007,227075,12842,12684,1889,14573,201
2021-07-01,Calaveras,009,45235,2222,2200,14,2214,55
2021-07-01,Colusa,011,21464,1974,1969,325,2294,15
2021-07-01,Contra Costa,013,1133247,71507,70941,1343,72284,818
2021-07-01,Del Norte,015,27424,1475,1439,13,1452,8
2021-07-01,El Dorado,017,186661,10545,10433,776,11209,113
2021-07-01,Fresno,019,978130,103674,102512,8831,111343,1727
2021-07-01,Glenn,021,27897,2457,2442,574,3016,20
2021-07-01,Humboldt,023,135768,4564,4530,52,4582,49
2021-07-01,Imperial,025,180216,28841,28661,2782,31443,739
2021-07-01,Inyo,027,18085,1415,1412,12,1424,35
2021-07-01,Kern,029,883053,98106,97421,11224,108645,1347
2021-07-01,Kings,031,150075,23330,23051,1117,24168,245
2021-07-01,Lake,033,64148,3656,3623,13,3636,62
2021-07-01,Lassen,035,31185,5303,5277,117,5394,20
2021-07-01,Los Angeles,037,10098052,1214759,1208705,42383,1251088,24506
2021-07-01,Madera,039,155013,16846,16696,955,17651,240
2021-07-01,Marin,041,260295,14274,14143,268,14411,233
2021-07-01,Mariposa,043,17540,442,441,11,452,5
2021-07-01,Mendocino,045,87422,4220,4122,84,4206,49
2021-07-01,Merced,047,269075,31314,31297,1070,32367,469
2021-07-01,Modoc,049,8938,420,410,149,559,4
2021-07-01,Mono,051,14174,1266,1275,18,1293,3
2021-07-01,Monterey,053,433212,43383,43212,1890,45102,492
2021-07-01,Napa,055,140530,10072,10045,40,10085,81
2021-07-01,Nevada,057,99092,5013,4966,195,5161,72
2021-07-01,Orange,059,3164182,257273,255823,11624,267447,5126
2021-07-01,Placer,061,380077,24001,23764,1573,25337,299
2021-07-01,Plumas,063,18699,724,707,12,719,4
2021-07-01,Riverside,065,2383286,296331,293260,14243,307503,4536
2021-07-01,Sacramento,067,1510023,109102,108257,1864,110121,1676
2021-07-01,San Benito,069,59416,6134,6108,116,6224,63
2021-07-01,San Bernardino,071,2135413,295502,294294,9109,303403,5003
2021-07-01,San Diego,073,3302833,283889,282692,15514,298206,3780
2021-07-01,San Francisco,075,870044,37368,37107,1327,38434,558
2021-07-01,San Joaquin,077,732212,74405,73841,3679,77520,1409
2021-07-01,San Luis Obispo,079,281455,21582,21330,764,22094,256
2021-07-01,San Mateo,081,765935,42980,42691,495,43186,541
2021-07-01,Santa Barbara,083,443738,34693,34526,1153,35679,456
2021-07-01,Santa Clara,085,1922200,119795,118966,791,119757,2090
2021-07-01,Santa Cruz,087,273765,16364,16254,818,17072,208
2021-07-01,Shasta,089,179085,12645,12582,1653,14235,204
2021-07-01,Sierra,091,2930,63,60,12,72,0
2021-07-01,Siskiyou,093,43540,1977,1899,385,2284,29
2021-07-01,Solano,095,438530,33656,33486,581,34067,268
2021-07-01,Sonoma,097,501317,31191,31000,371,31371,316
2021-07-01,Stanislaus,099,539301,57245,57018,6064,63082,1018
2021-07-01,Sutter,101,95872,9668,9644,90,9734,114
2021-07-01,Tehama,103,63373,5163,5124,598,5722,63
2021-07-01,Trinity,105,12862,494,341,100,441,3
2021-07-01,Tulare,107,460477,50533,49789,9221,59010,853
2021-07-01,Tuolumne,109,53932,4079,4113,41,4154,64
2021-07-01,Ventura,111,848112,82047,81425,3076,84501,1033
2021-07-01,Yolo,113,214977,14227,14188,361,14549,213
2021-07-01,Yuba,115,75493,6251,6197,133,6330,51
2021-06-30,Alameda,001,1643700,89974,89597,2012,91609,1256
2021-06-30,Alpine,003,1148,88,89,0,89,0
2021-06-30,Amador,005,37829,3772,3756,33,3789,46
2021-06-30,Butte,007,227075,12835,12676,1880,14556,201
2021-06-30,Calaveras,009,45235,2216,2198,14,2212,55
2021-06-30,Colusa,011,21464,1972,1967,322,2289,15
2021-06-30,Contra Costa,013,1133247,71442,70869,1340,72209,818
2021-06-30,Del Norte,015,27424,1470,1435,13,1448,8
2021-06-30,El Dorado,017,186661,10526,10420,776,11196,113
2021-06-30,Fresno,019,978130,103637,102490,8828,111318,1727
2021-06-30,Glenn,021,27897,2455,2440,574,3014,20
2021-06-30,Humboldt,023,135768,4548,4522,50,4572,49
2021-06-30,Imperial,025,180216,28833,28651,2782,31433,739
2021-06-30,Inyo,027,18085,1415,1409,12,1421,35
2021-06-30,Kern,029,883053,98065,97267,11212,108479,1348
2021-06-30,Kings,031,150075,23325,23038,1116,24154,245
2021-06-30,Lake,033,64148,3643,3601,13,3614,56
2021-06-30,Lassen,035,31185,5298,5269,117,5386,20
2021-06-30,Los Angeles,037,10098052,1214087,1208246,42338,1250584,24499
2021-06-30,Madera,039,155013,16838,16688,953,17641,240
2021-06-30,Marin,041,260295,14265,14133,267,14400,232
2021-06-30,Mariposa,043,17540,441,441,11,452,5
2021-06-30,Mendocino,045,87422,4210,4115,84,4199,49
2021-06-30,Merced,047,269075,31304,31286,1070,32356,469
2021-06-30,Modoc,049,8938,420,410,149,559,4
2021-06-30,Mono,051,14174,1266,1275,18,1293,3
2021-06-30,Monterey,053,433212,43378,43209,1888,45097,492
2021-06-30,Napa,055,140530,10064,10039,40,10079,81
2021-06-30,Nevada,057,99092,5002,4958,195,5153,72
2021-06-30,Orange,059,3164182,257146,255764,11613,267377,5125
2021-06-30,Placer,061,380077,23977,23721,1570,25291,299
2021-06-30,Plumas,063,18699,724,705,12,717,4
2021-06-30,Riverside,065,2383286,296217,293280,14233,307513,4535
2021-06-30,Sacramento,067,1510023,108963,108137,1860,109997,1676
2021-06-30,San Benito,069,59416,6130,6105,116,6221,63
2021-06-30,San Bernardino,071,2135413,295343,294211,9104,303315,4975
2021-06-30,San Diego,073,3302833,283753,282583,15486,298069,3780
2021-06-30,San Francisco,075,870044,37319,37065,1322,38387,558
2021-06-30,San Joaquin,077,732212,74343,73777,3678,77455,1409
2021-06-30,San Luis Obispo,079,281455,21569,21326,763,22089,256
2021-06-30,San Mateo,081,765935,42943,42599,494,43093,537
2021-06-30,Santa Barbara,083,443738,34677,34521,1153,35674,456
2021-06-30,Santa Clara,085,1922200,119748,118930,788,119718,2090
2021-06-30,Santa Cruz,087,273765,16358,16250,818,17068,208
2021-06-30,Shasta,089,179085,12639,12564,1653,14217,204
2021-06-30,Sierra,091,2930,63,60,12,72,0
2021-06-30,Siskiyou,093,43540,1975,1900,382,2282,29
2021-06-30,Solano,095,438530,33617,33453,579,34032,268
2021-06-30,Sonoma,097,501317,31161,30947,371,31318,316
2021-06-30,Stanislaus,099,539301,57228,56997,6063,63060,1018
2021-06-30,Sutter,101,95872,9658,9638,90,9728,114
2021-06-30,Tehama,103,63373,5161,5124,598,5722,63
2021-06-30,Trinity,105,12862,494,341,100,441,3
2021-06-30,Tulare,107,460477,50522,49764,9210,58974,853
2021-06-30,Tuolumne,109,53932,4076,4112,41,4153,64
2021-06-30,Ventura,111,848112,82004,81392,3071,84463,1032
2021-06-30,Yolo,113,214977,14221,14178,358,14536,213
2021-06-30,Yuba,115,75493,6244,6191,133,6324,51
2021-06-29,Alameda,001,1643700,89867,89519,2011,91530,1257
2021-06-29,Alpine,003,1148,88,89,0,89,0
2021-06-29,Amador,005,37829,3768,3754,33,3787,46
2021-06-29,Butte,007,227075,12827,12669,1880,14549,201
2021-06-29,Calaveras,009,45235,2210,2198,14,2212,55
2021-06-29,Colusa,011,21464,1970,1967,322,2289,15
2021-06-29,Contra Costa,013,1133247,71368,70775,1339,72114,817
2021-06-29,Del Norte,015,27424,1469,1435,13,1448,8
2021-06-29,El Dorado,017,186661,10513,10403,772,11175,113
2021-06-29,Fresno,019,978130,103604,102464,8825,111289,1725
2021-06-29,Glenn,021,27897,2454,2439,574,3013,20
2021-06-29,Humboldt,023,135768,4544,4514,49,4563,49
2021-06-29,Imperial,025,180216,28824,28645,2781,31426,737
2021-06-29,Inyo,027,18085,1415,1408,12,1420,35
2021-06-29,Kern,029,883053,98044,97173,11206,108379,1347
2021-06-29,Kings,031,150075,23316,23035,1115,24150,245
2021-06-29,Lake,033,64148,3637,3594,13,3607,56
2021-06-29,Lassen,035,31185,5291,5268,117,5385,20
2021-06-29,Los Angeles,037,10098052,1213478,1207895,42307,1250202,24498
2021-06-29,Madera,039,155013,16834,16680,952,17632,240
2021-06-29,Marin,041,260295,14253,14127,267,14394,232
2021-06-29,Mariposa,043,17540,441,441,11,452,5
2021-06-29,Mendocino,045,87422,4206,4107,83,4190,49
2021-06-29,Merced,047,269075,31292,31277,1070,32347,469
2021-06-29,Modoc,049,8938,419,408,149,557,3
2021-06-29,Mono,051,14174,1266,1275,18,1293,3
2021-06-29,Monterey,053,433212,43368,43196,1886,45082,471
2021-06-29,Napa,055,140530,10058,10033,40,10073,81
2021-06-29,Nevada,057,99092,4995,4952,195,5147,72
2021-06-29,Orange,059,3164182,257046,255686,11598,267284,5124
2021-06-29,Placer,061,380077,23957,23693,1568,25261,299
2021-06-29,Plumas,063,18699,724,704,12,716,4
2021-06-29,Riverside,065,2383286,296118,292962,14226,307188,4524
2021-06-29,Sacramento,067,1510023,108811,108067,1857,109924,1677
2021-06-29,San Benito,069,59416,6119,6099,116,6215,63
2021-06-29,San Bernardino,071,2135413,295231,294118,9102,303220,4940
2021-06-29,San Diego,073,3302833,283597,282499,15459,297958,3780
2021-06-29,San Francisco,075,870044,37281,37041,1319,38360,558
2021-06-29,San Joaquin,077,732212,74295,73724,3675,77399,1409
2021-06-29,San Luis Obispo,079,281455,21559,21324,762,22086,256
2021-06-29,San Mateo,081,765935,42909,42540,494,43034,540
2021-06-29,Santa Barbara,083,443738,34667,34507,1152,35659,455
2021-06-29,Santa Clara,085,1922200,119694,118893,787,119680,2090
2021-06-29,Santa Cruz,087,273765,16352,16249,818,17067,208
2021-06-29,Shasta,089,179085,12627,12564,1652,14216,204
2021-06-29,Sierra,091,2930,63,59,12,71,0
2021-06-29,Siskiyou,093,43540,1972,1897,378,2275,29
2021-06-29,Solano,095,438530,33584,33440,577,34017,268
2021-06-29,Sonoma,097,501317,31119,30950,369,31319,316
2021-06-29,Stanislaus,099,539301,57207,56980,6056,63036,1018
2021-06-29,Sutter,101,95872,9647,9634,90,9724,114
2021-06-29,Tehama,103,63373,5161,5124,598,5722,63
2021-06-29,Trinity,105,12862,494,341,100,441,3
2021-06-29,Tulare,107,460477,50509,49751,9205,58956,852
2021-06-29,Tuolumne,109,53932,4074,4111,41,4152,64
2021-06-29,Ventura,111,848112,81966,81363,3065,84428,1032
2021-06-29,Yolo,113,214977,14209,14171,357,14528,213
2021-06-29,Yuba,115,75493,6234,6188,133,6321,51
2021-06-28,Alameda,001,1643700,89774,89638,2008,91646,1259
2021-06-28,Alpine,003,1148,88,89,0,89,0
2021-06-28,Amador,005,37829,3767,3753,33,3786,46
2021-06-28,Butte,007,227075,12818,12697,1878,14575,198
2021-06-28,Calaveras,009,45235,2207,2203,14,2217,55
2021-06-28,Colusa,011,21464,1968,1974,322,2296,15
2021-06-28,Contra Costa,013,1133247,71294,70807,1337,72144,816
2021-06-28,Del Norte,015,27424,1469,1436,13,1449,8
2021-06-28,El Dorado,017,186661,10503,10422,768,11190,115
2021-06-28,Fresno,019,978130,103573,103121,8823,111944,1727
2021-06-28,Glenn,021,27897,2454,2439,574,3013,20
2021-06-28,Humboldt,023,135768,4537,4520,48,4568,49
2021-06-28,Imperial,025,180216,28816,28981,2780,31761,741
2021-06-28,Inyo,027,18085,1412,1407,12,1419,35
2021-06-28,Kern,029,883053,98025,97252,11201,108453,1348
2021-06-28,Kings,031,150075,23310,23134,1115,24249,246
2021-06-28,Lake,033,64148,3629,3591,13,3604,56
2021-06-28,Lassen,035,31185,5289,5268,117,5385,20
2021-06-28,Los Angeles,037,10098052,1212959,1207714,42272,1249986,24496
2021-06-28,Madera,039,155013,16823,16683,951,17634,240
2021-06-28,Marin,041,260295,14238,14186,267,14453,232
2021-06-28,Mariposa,043,17540,441,440,11,451,5
2021-06-28,Mendocino,045,87422,4197,4102,82,4184,49
2021-06-28,Merced,047,269075,31280,31277,1070,32347,469
2021-06-28,Modoc,049,8938,419,411,148,559,3
2021-06-28,Mono,051,14174,1266,1276,18,1294,3
2021-06-28,Monterey,053,433212,43364,43202,1885,45087,462
2021-06-28,Napa,055,140530,10049,10050,39,10089,81
2021-06-28,Nevada,057,99092,4991,4951,195,5146,72
2021-06-28,Orange,059,3164182,256956,255755,11584,267339,5123
2021-06-28,Placer,061,380077,23937,23756,1564,25320,299
2021-06-28,Plumas,063,18699,722,704,12,716,4
2021-06-28,Riverside,065,2383286,295992,292647,14213,306860,4507
2021-06-28,Sacramento,067,1510023,108679,108342,1852,110194,1675
2021-06-28,San Benito,069,59416,6117,6101,116,6217,63
2021-06-28,San Bernardino,071,2135413,295130,294151,9097,303248,4928
2021-06-28,San Diego,073,3302833,283433,282417,15430,297847,3780
2021-06-28,San Francisco,075,870044,37245,37372,1317,38689,559
2021-06-28,San Joaquin,077,732212,74248,73973,3671,77644,1411
2021-06-28,San Luis Obispo,079,281455,21555,21340,761,22101,256
2021-06-28,San Mateo,081,765935,42875,42927,493,43420,540
2021-06-28,Santa Barbara,083,443738,34660,34534,1150,35684,455
2021-06-28,Santa Clara,085,1922200,119630,120377,786,121163,2103
2021-06-28,Santa Cruz,087,273765,16347,16245,818,17063,208
2021-06-28,Shasta,089,179085,12623,12642,1650,14292,203
2021-06-28,Sierra,091,2930,63,58,12,70,0
2021-06-28,Siskiyou,093,43540,1971,1896,378,2274,29
2021-06-28,Solano,095,438530,33548,33524,575,34099,267
2021-06-28,Sonoma,097,501317,31082,31137,368,31505,315
2021-06-28,Stanislaus,099,539301,57189,57047,6052,63099,1018
2021-06-28,Sutter,101,95872,9643,9682,90,9772,114
2021-06-28,Tehama,103,63373,5159,5122,598,5720,63
2021-06-28,Trinity,105,12862,494,341,100,441,3
2021-06-28,Tulare,107,460477,50499,49751,9201,58952,850
2021-06-28,Tuolumne,109,53932,4067,4121,41,4162,64
2021-06-28,Ventura,111,848112,81909,81393,3060,84453,1032
2021-06-28,Yolo,113,214977,14200,14199,354,14553,213
2021-06-28,Yuba,115,75493,6229,6207,133,6340,51
2021-06-27,Alameda,001,1643700,89688,89611,2003,91614,1259
2021-06-27,Alpine,003,1148,88,89,0,89,0
2021-06-27,Amador,005,37829,3766,3752,33,3785,46
2021-06-27,Butte,007,227075,12809,12696,1877,14573,198
2021-06-27,Calaveras,009,45235,2206,2203,14,2217,55
2021-06-27,Colusa,011,21464,1968,1974,322,2296,15
2021-06-27,Contra Costa,013,1133247,71208,70762,1333,72095,816
2021-06-27,Del Norte,015,27424,1466,1436,13,1449,8
2021-06-27,El Dorado,017,186661,10491,10418,765,11183,115
2021-06-27,Fresno,019,978130,103544,103110,8821,111931,1727
2021-06-27,Glenn,021,27897,2453,2439,573,3012,20
2021-06-27,Humboldt,023,135768,4525,4513,45,4558,49
2021-06-27,Imperial,025,180216,28802,28987,2780,31767,741
2021-06-27,Inyo,027,18085,1412,1407,12,1419,35
2021-06-27,Kern,029,883053,97999,97249,11194,108443,1348
2021-06-27,Kings,031,150075,23300,23132,1115,24247,246
2021-06-27,Lake,033,64148,3622,3581,13,3594,56
2021-06-27,Lassen,035,31185,5288,5265,117,5382,20
2021-06-27,Los Angeles,037,10098052,1212414,1207461,42231,1249692,24493
2021-06-27,Madera,039,155013,16815,16680,951,17631,240
2021-06-27,Marin,041,260295,14229,14182,267,14449,232
2021-06-27,Mariposa,043,17540,441,440,11,451,5
2021-06-27,Mendocino,045,87422,4190,4100,82,4182,49
2021-06-27,Merced,047,269075,31268,31266,1070,32336,469
2021-06-27,Modoc,049,8938,419,411,148,559,3
2021-06-27,Mono,051,14174,1266,1279,18,1297,3
2021-06-27,Monterey,053,433212,43351,43199,1885,45084,462
2021-06-27,Napa,055,140530,10043,10046,39,10085,81
2021-06-27,Nevada,057,99092,4985,4946,195,5141,72
2021-06-27,Orange,059,3164182,256842,255710,11573,267283,5123
2021-06-27,Placer,061,380077,23904,23731,1561,25292,299
2021-06-27,Plumas,063,18699,722,704,12,716,4
2021-06-27,Riverside,065,2383286,295890,292641,14206,306847,4507
2021-06-27,Sacramento,067,1510023,108544,108279,1848,110127,1675
2021-06-27,San Benito,069,59416,6111,6101,116,6217,63
2021-06-27,San Bernardino,071,2135413,295017,294115,9095,303210,4927
2021-06-27,San Diego,073,3302833,283293,282359,15404,297763,3780
2021-06-27,San Francisco,075,870044,37208,37360,1316,38676,559
2021-06-27,San Joaquin,077,732212,74212,73960,3669,77629,1411
2021-06-27,San Luis Obispo,079,281455,21548,21340,760,22100,256
2021-06-27,San Mateo,081,765935,42846,42925,490,43415,539
2021-06-27,Santa Barbara,083,443738,34646,34533,1148,35681,455
2021-06-27,Santa Clara,085,1922200,119579,120352,785,121137,2103
2021-06-27,Santa Cruz,087,273765,16338,16241,818,17059,208
2021-06-27,Shasta,089,179085,12617,12640,1649,14289,203
2021-06-27,Sierra,091,2930,63,58,12,70,0
2021-06-27,Siskiyou,093,43540,1969,1896,377,2273,29
2021-06-27,Solano,095,438530,33520,33516,575,34091,267
2021-06-27,Sonoma,097,501317,31044,31129,368,31497,315
2021-06-27,Stanislaus,099,539301,57149,57021,6049,63070,1018
2021-06-27,Sutter,101,95872,9637,9678,90,9768,114
2021-06-27,Tehama,103,63373,5155,5122,598,5720,63
2021-06-27,Trinity,105,12862,494,341,99,440,3
2021-06-27,Tulare,107,460477,50486,49749,9194,58943,850
2021-06-27,Tuolumne,109,53932,4065,4121,41,4162,64
2021-06-27,Ventura,111,848112,81875,81361,3051,84412,1032
2021-06-27,Yolo,113,214977,14185,14194,350,14544,213
2021-06-27,Yuba,115,75493,6223,6205,133,6338,51
2021-06-26,Alameda,001,1643700,89631,89560,2001,91561,1259
2021-06-26,Alpine,003,1148,88,89,0,89,0
2021-06-26,Amador,005,37829,3766,3748,33,3781,46
2021-06-26,Butte,007,227075,12805,12693,1874,14567,198
2021-06-26,Calaveras,009,45235,2204,2202,14,2216,55
2021-06-26,Colusa,011,21464,1968,1973,322,2295,15
2021-06-26,Contra Costa,013,1133247,71165,70712,1332,72044,816
2021-06-26,Del Norte,015,27424,1465,1432,13,1445,8
2021-06-26,El Dorado,017,186661,10483,10414,764,11178,115
2021-06-26,Fresno,019,978130,103524,103091,8819,111910,1727
2021-06-26,Glenn,021,27897,2451,2441,573,3014,20
2021-06-26,Humboldt,023,135768,4522,4509,45,4554,49
2021-06-26,Imperial,025,180216,28798,28970,2780,31750,741
2021-06-26,Inyo,027,18085,1412,1407,12,1419,35
2021-06-26,Kern,029,883053,97973,97239,11185,108424,1348
2021-06-26,Kings,031,150075,23296,23128,1114,24242,246
2021-06-26,Lake,033,64148,3611,3576,13,3589,56
2021-06-26,Lassen,035,31185,5285,5263,117,5380,20
2021-06-26,Los Angeles,037,10098052,1212108,1207198,42198,1249396,24490
2021-06-26,Madera,039,155013,16808,16679,950,17629,240
2021-06-26,Marin,041,260295,14220,14180,267,14447,232
2021-06-26,Mariposa,043,17540,441,440,11,451,5
2021-06-26,Mendocino,045,87422,4188,4096,82,4178,49
2021-06-26,Merced,047,269075,31262,31259,1069,32328,469
2021-06-26,Modoc,049,8938,419,411,148,559,3
2021-06-26,Mono,051,14174,1266,1279,18,1297,3
2021-06-26,Monterey,053,433212,43348,43192,1885,45077,462
2021-06-26,Napa,055,140530,10037,10043,39,10082,81
2021-06-26,Nevada,057,99092,4980,4939,195,5134,72
2021-06-26,Orange,059,3164182,256763,255640,11566,267206,5123
2021-06-26,Placer,061,380077,23890,23702,1559,25261,299
2021-06-26,Plumas,063,18699,722,704,12,716,4
2021-06-26,Riverside,065,2383286,295832,292480,14200,306680,4505
2021-06-26,Sacramento,067,1510023,108473,108179,1846,110025,1675
2021-06-26,San Benito,069,59416,6107,6100,116,6216,63
2021-06-26,San Bernardino,071,2135413,294922,294034,9090,303124,4928
2021-06-26,San Diego,073,3302833,283208,282263,15386,297649,3780
2021-06-26,San Francisco,075,870044,37176,37348,1315,38663,559
2021-06-26,San Joaquin,077,732212,74183,73928,3668,77596,1411
2021-06-26,San Luis Obispo,079,281455,21547,21330,759,22089,256
2021-06-26,San Mateo,081,765935,42826,42898,490,43388,539
2021-06-26,Santa Barbara,083,443738,34637,34525,1148,35673,455
2021-06-26,Santa Clara,085,1922200,119546,120321,785,121106,2103
2021-06-26,Santa Cruz,087,273765,16335,16239,818,17057,208
2021-06-26,Shasta,089,179085,12613,12635,1645,14280,203
2021-06-26,Sierra,091,2930,63,58,12,70,0
2021-06-26,Siskiyou,093,43540,1968,1896,376,2272,29
2021-06-26,Solano,095,438530,33502,33489,573,34062,267
2021-06-26,Sonoma,097,501317,31018,31088,368,31456,315
2021-06-26,Stanislaus,099,539301,57133,57006,6047,63053,1018
2021-06-26,Sutter,101,95872,9636,9669,90,9759,114
2021-06-26,Tehama,103,63373,5155,5119,598,5717,63
2021-06-26,Trinity,105,12862,494,341,99,440,3
2021-06-26,Tulare,107,460477,50480,49745,9194,58939,850
2021-06-26,Tuolumne,109,53932,4065,4121,41,4162,64
2021-06-26,Ventura,111,848112,81851,81352,3050,84402,1032
2021-06-26,Yolo,113,214977,14177,14184,350,14534,213
2021-06-26,Yuba,115,75493,6220,6200,133,6333,51
2021-06-25,Alameda,001,1643700,89565,89453,1998,91451,1271
2021-06-25,Alpine,003,1148,88,89,0,89,0
2021-06-25,Amador,005,37829,3765,3746,33,3779,46
2021-06-25,Butte,007,227075,12800,12682,1871,14553,198
2021-06-25,Calaveras,009,45235,2203,2201,14,2215,55
2021-06-25,Colusa,011,21464,1968,1972,322,2294,15
2021-06-25,Contra Costa,013,1133247,71129,70659,1332,71991,815
2021-06-25,Del Norte,015,27424,1465,1426,13,1439,8
2021-06-25,El Dorado,017,186661,10475,10406,761,11167,115
2021-06-25,Fresno,019,978130,103506,103073,8815,111888,1727
2021-06-25,Glenn,021,27897,2451,2441,573,3014,20
2021-06-25,Humboldt,023,135768,4516,4503,43,4546,49
2021-06-25,Imperial,025,180216,28795,28968,2780,31748,740
2021-06-25,Inyo,027,18085,1411,1406,12,1418,35
2021-06-25,Kern,029,883053,97954,97182,11181,108363,1347
2021-06-25,Kings,031,150075,23290,23118,1114,24232,246
2021-06-25,Lake,033,64148,3605,3571,13,3584,56
2021-06-25,Lassen,035,31185,5284,5259,117,5376,20
2021-06-25,Los Angeles,037,10098052,1211827,1206909,42181,1249090,24483
2021-06-25,Madera,039,155013,16805,16670,950,17620,240
2021-06-25,Marin,041,260295,14217,14179,267,14446,232
2021-06-25,Mariposa,043,17540,441,440,11,451,5
2021-06-25,Mendocino,045,87422,4185,4089,82,4171,49
2021-06-25,Merced,047,269075,31254,31256,1069,32325,467
2021-06-25,Modoc,049,8938,419,411,148,559,3
2021-06-25,Mono,051,14174,1266,1279,18,1297,3
2021-06-25,Monterey,053,433212,43343,43184,1884,45068,462
2021-06-25,Napa,055,140530,10032,10037,39,10076,81
2021-06-25,Nevada,057,99092,4977,4932,195,5127,72
2021-06-25,Orange,059,3164182,256692,255574,11564,267138,5119
2021-06-25,Placer,061,380077,23871,23672,1558,25230,299
2021-06-25,Plumas,063,18699,722,702,11,713,4
2021-06-25,Riverside,065,2383286,295764,291663,14193,305856,4490
2021-06-25,Sacramento,067,1510023,108401,108034,1843,109877,1673
2021-06-25,San Benito,069,59416,6103,6098,116,6214,63
2021-06-25,San Bernardino,071,2135413,294867,293941,9088,303029,4911
2021-06-25,San Diego,073,3302833,283148,282157,15373,297530,3779
2021-06-25,San Francisco,075,870044,37153,37338,1314,38652,559
2021-06-25,San Joaquin,077,732212,74150,73860,3666,77526,1410
2021-06-25,San Luis Obispo,079,281455,21544,21325,758,22083,256
2021-06-25,San Mateo,081,765935,42808,42849,490,43339,537
2021-06-25,Santa Barbara,083,443738,34628,34518,1147,35665,454
2021-06-25,Santa Clara,085,1922200,119526,120272,785,121057,2103
2021-06-25,Santa Cruz,087,273765,16332,16230,816,17046,208
2021-06-25,Shasta,089,179085,12603,12633,1644,14277,202
2021-06-25,Sierra,091,2930,63,58,12,70,0
2021-06-25,Siskiyou,093,43540,1967,1894,376,2270,29
2021-06-25,Solano,095,438530,33482,33449,573,34022,267
2021-06-25,Sonoma,097,501317,30995,31043,368,31411,314
2021-06-25,Stanislaus,099,539301,57117,56973,6040,63013,1018
2021-06-25,Sutter,101,95872,9629,9664,90,9754,114
2021-06-25,Tehama,103,63373,5154,5119,598,5717,63
2021-06-25,Trinity,105,12862,494,338,99,437,3
2021-06-25,Tulare,107,460477,50473,49731,9191,58922,850
2021-06-25,Tuolumne,109,53932,4064,4121,41,4162,64
2021-06-25,Ventura,111,848112,81822,81342,3044,84386,1032
2021-06-25,Yolo,113,214977,14171,14172,350,14522,213
2021-06-25,Yuba,115,75493,6216,6195,133,6328,51
2021-06-24,Alameda,001,1643700,89494,89358,1995,91353,1268
2021-06-24,Alpine,003,1148,88,89,0,89,0
2021-06-24,Amador,005,37829,3761,3745,33,3778,46
2021-06-24,Butte,007,227075,12794,12673,1869,14542,198
2021-06-24,Calaveras,009,45235,2200,2202,14,2216,55
2021-06-24,Colusa,011,21464,1967,1972,322,2294,15
2021-06-24,Contra Costa,013,1133247,71070,70590,1332,71922,813
2021-06-24,Del Norte,015,27424,1464,1421,13,1434,8
2021-06-24,El Dorado,017,186661,10468,10402,761,11163,115
2021-06-24,Fresno,019,978130,103486,103061,8812,111873,1727
2021-06-24,Glenn,021,27897,2450,2439,573,3012,20
2021-06-24,Humboldt,023,135768,4511,4493,43,4536,49
2021-06-24,Imperial,025,180216,28792,28981,2780,31761,740
2021-06-24,Inyo,027,18085,1410,1406,12,1418,35
2021-06-24,Kern,029,883053,97935,97129,11168,108297,1346
2021-06-24,Kings,031,150075,23286,23114,1112,24226,246
2021-06-24,Lake,033,64148,3599,3571,13,3584,56
2021-06-24,Lassen,035,31185,5283,5258,117,5375,20
2021-06-24,Los Angeles,037,10098052,1211503,1206590,42158,1248748,24480
2021-06-24,Madera,039,155013,16794,16662,949,17611,240
2021-06-24,Marin,041,260295,14213,14180,267,14447,232
2021-06-24,Mariposa,043,17540,441,440,11,451,5
2021-06-24,Mendocino,045,87422,4177,4085,82,4167,49
2021-06-24,Merced,047,269075,31244,31248,1068,32316,466
2021-06-24,Modoc,049,8938,419,411,148,559,3
2021-06-24,Mono,051,14174,1266,1276,18,1294,3
2021-06-24,Monterey,053,433212,43336,43180,1884,45064,451
2021-06-24,Napa,055,140530,10030,10036,39,10075,80
2021-06-24,Nevada,057,99092,4975,4927,195,5122,72
2021-06-24,Orange,059,3164182,256628,255520,11556,267076,5117
2021-06-24,Placer,061,380077,23846,23659,1556,25215,299
2021-06-24,Plumas,063,18699,721,702,11,713,4
2021-06-24,Riverside,065,2383286,295684,291067,14182,305249,4473
2021-06-24,Sacramento,067,1510023,108313,107965,1841,109806,1672
2021-06-24,San Benito,069,59416,6100,6098,116,6214,63
2021-06-24,San Bernardino,071,2135413,294798,293895,9083,302978,4898
2021-06-24,San Diego,073,3302833,283044,282053,15360,297413,3778
2021-06-24,San Francisco,075,870044,37131,37320,1312,38632,559
2021-06-24,San Joaquin,077,732212,74102,73814,3666,77480,1408
2021-06-24,San Luis Obispo,079,281455,21538,21326,758,22084,256
2021-06-24,San Mateo,081,765935,42782,42814,489,43303,542
2021-06-24,Santa Barbara,083,443738,34622,34512,1146,35658,454
2021-06-24,Santa Clara,085,1922200,119495,120274,784,121058,2103
2021-06-24,Santa Cruz,087,273765,16331,16227,816,17043,208
2021-06-24,Shasta,089,179085,12598,12629,1640,14269,202
2021-06-24,Sierra,091,2930,63,58,12,70,0
2021-06-24,Siskiyou,093,43540,1967,1892,376,2268,28
2021-06-24,Solano,095,438530,33459,33432,571,34003,267
2021-06-24,Sonoma,097,501317,30966,31020,368,31388,314
2021-06-24,Stanislaus,099,539301,57091,56946,6040,62986,1018
2021-06-24,Sutter,101,95872,9622,9660,90,9750,113
2021-06-24,Tehama,103,63373,5151,5115,598,5713,63
2021-06-24,Trinity,105,12862,493,338,99,437,3
2021-06-24,Tulare,107,460477,50462,49730,9189,58919,850
2021-06-24,Tuolumne,109,53932,4062,4120,41,4161,64
2021-06-24,Ventura,111,848112,81794,81332,3043,84375,1032
2021-06-24,Yolo,113,214977,14162,14169,347,14516,213
2021-06-24,Yuba,115,75493,6211,6195,133,6328,51
2021-06-23,Alameda,001,1643700,89421,89338,1994,91332,1266
2021-06-23,Alpine,003,1148,88,88,0,88,0
2021-06-23,Amador,005,37829,3759,3743,33,3776,46
2021-06-23,Butte,007,227075,12787,12666,1869,14535,198
2021-06-23,Calaveras,009,45235,2199,2199,14,2213,55
2021-06-23,Colusa,011,21464,1966,1972,322,2294,15
2021-06-23,Contra Costa,013,1133247,71005,70526,1331,71857,813
2021-06-23,Del Norte,015,27424,1460,1418,13,1431,8
2021-06-23,El Dorado,017,186661,10459,10395,758,11153,115
2021-06-23,Fresno,019,978130,103457,103020,8810,111830,1724
2021-06-23,Glenn,021,27897,2450,2437,572,3009,20
2021-06-23,Humboldt,023,135768,4502,4490,43,4533,48
2021-06-23,Imperial,025,180216,28785,28908,2780,31688,740
2021-06-23,Inyo,027,18085,1410,1406,12,1418,35
2021-06-23,Kern,029,883053,97907,97078,11155,108233,1345
2021-06-23,Kings,031,150075,23279,23105,1110,24215,245
2021-06-23,Lake,033,64148,3590,3566,13,3579,53
2021-06-23,Lassen,035,31185,5280,5257,117,5374,20
2021-06-23,Los Angeles,037,10098052,1211166,1206358,42148,1248506,24472
2021-06-23,Madera,039,155013,16787,16660,949,17609,240
2021-06-23,Marin,041,260295,14207,14177,267,14444,230
2021-06-23,Mariposa,043,17540,441,439,11,450,5
2021-06-23,Mendocino,045,87422,4173,4078,82,4160,49
2021-06-23,Merced,047,269075,31235,31260,1068,32328,465
2021-06-23,Modoc,049,8938,417,407,148,555,3
2021-06-23,Mono,051,14174,1266,1279,18,1297,3
2021-06-23,Monterey,053,433212,43327,43166,1884,45050,439
2021-06-23,Napa,055,140530,10021,10032,39,10071,80
2021-06-23,Nevada,057,99092,4972,4924,195,5119,72
2021-06-23,Orange,059,3164182,256562,255479,11548,267027,5116
2021-06-23,Placer,061,380077,23817,23630,1551,25181,299
2021-06-23,Plumas,063,18699,720,701,11,712,4
2021-06-23,Riverside,065,2383286,295601,290343,14180,304523,4462
2021-06-23,Sacramento,067,1510023,108221,107868,1836,109704,1671
2021-06-23,San Benito,069,59416,6096,6097,116,6213,63
2021-06-23,San Bernardino,071,2135413,294719,293816,9078,302894,4886
2021-06-23,San Diego,073,3302833,282944,281937,15339,297276,3777
2021-06-23,San Francisco,075,870044,37107,37304,1310,38614,559
2021-06-23,San Joaquin,077,732212,74063,73764,3664,77428,1405
2021-06-23,San Luis Obispo,079,281455,21534,21323,757,22080,257
2021-06-23,San Mateo,081,765935,42766,42756,489,43245,542
2021-06-23,Santa Barbara,083,443738,34612,34505,1146,35651,454
2021-06-23,Santa Clara,085,1922200,119466,120233,784,121017,2098
2021-06-23,Santa Cruz,087,273765,16327,16215,816,17031,209
2021-06-23,Shasta,089,179085,12591,12604,1638,14242,202
2021-06-23,Sierra,091,2930,63,57,12,69,0
2021-06-23,Siskiyou,093,43540,1965,1892,376,2268,28
2021-06-23,Solano,095,438530,33415,33408,571,33979,267
2021-06-23,Sonoma,097,501317,30926,30959,366,31325,314
2021-06-23,Stanislaus,099,539301,57061,56926,6039,62965,1017
2021-06-23,Sutter,101,95872,9616,9653,90,9743,113
2021-06-23,Tehama,103,63373,5151,5119,597,5716,63
2021-06-23,Trinity,105,12862,493,338,99,437,3
2021-06-23,Tulare,107,460477,50455,49711,9185,58896,850
2021-06-23,Tuolumne,109,53932,4059,4120,41,4161,64
2021-06-23,Ventura,111,848112,81771,81312,3040,84352,1032
2021-06-23,Yolo,113,214977,14152,14161,347,14508,212
2021-06-23,Yuba,115,75493,6208,6190,133,6323,51
2021-06-22,Alameda,001,1643700,89354,89308,1994,91302,1263
2021-06-22,Alpine,003,1148,88,88,0,88,0
2021-06-22,Amador,005,37829,3756,3743,33,3776,46
2021-06-22,Butte,007,227075,12783,12662,1866,14528,198
2021-06-22,Calaveras,009,45235,2198,2198,14,2212,55
2021-06-22,Colusa,011,21464,1965,1971,322,2293,15
2021-06-22,Contra Costa,013,1133247,70949,70480,1330,71810,813
2021-06-22,Del Norte,015,27424,1457,1417,13,1430,8
2021-06-22,El Dorado,017,186661,10454,10380,757,11137,113
2021-06-22,Fresno,019,978130,103438,102996,8806,111802,1724
2021-06-22,Glenn,021,27897,2449,2435,570,3005,19
2021-06-22,Humboldt,023,135768,4492,4483,43,4526,42
2021-06-22,Imperial,025,180216,28780,28880,2780,31660,740
2021-06-22,Inyo,027,18085,1410,1405,12,1417,35
2021-06-22,Kern,029,883053,97894,97013,11151,108164,1342
2021-06-22,Kings,031,150075,23271,23098,1109,24207,245
2021-06-22,Lake,033,64148,3588,3564,13,3577,45
2021-06-22,Lassen,035,31185,5275,5254,117,5371,20
2021-06-22,Los Angeles,037,10098052,1210852,1206146,42136,1248282,24461
2021-06-22,Madera,039,155013,16782,16652,949,17601,240
2021-06-22,Marin,041,260295,14205,14174,267,14441,230
2021-06-22,Mariposa,043,17540,441,439,11,450,5
2021-06-22,Mendocino,045,87422,4167,4072,82,4154,49
2021-06-22,Merced,047,269075,31224,31267,1068,32335,464
2021-06-22,Modoc,049,8938,415,405,147,552,3
2021-06-22,Mono,051,14174,1266,1277,18,1295,3
2021-06-22,Monterey,053,433212,43324,43162,1883,45045,427
2021-06-22,Napa,055,140530,10017,10029,39,10068,80
2021-06-22,Nevada,057,99092,4966,4923,195,5118,72
2021-06-22,Orange,059,3164182,256493,255452,11537,266989,5114
2021-06-22,Placer,061,380077,23795,23603,1551,25154,299
2021-06-22,Plumas,063,18699,720,697,11,708,4
2021-06-22,Riverside,065,2383286,295540,289839,14176,304015,4456
2021-06-22,Sacramento,067,1510023,108120,107801,1831,109632,1670
2021-06-22,San Benito,069,59416,6095,6098,116,6214,63
2021-06-22,San Bernardino,071,2135413,294644,293770,9072,302842,4873
2021-06-22,San Diego,073,3302833,282840,281867,15316,297183,3771
2021-06-22,San Francisco,075,870044,37093,37287,1310,38597,556
2021-06-22,San Joaquin,077,732212,74033,73723,3662,77385,1405
2021-06-22,San Luis Obispo,079,281455,21531,21321,756,22077,257
2021-06-22,San Mateo,081,765935,42752,42725,484,43209,542
2021-06-22,Santa Barbara,083,443738,34601,34500,1145,35645,454
2021-06-22,Santa Clara,085,1922200,119434,120194,784,120978,2095
2021-06-22,Santa Cruz,087,273765,16322,16218,816,17034,209
2021-06-22,Shasta,089,179085,12580,12616,1635,14251,202
2021-06-22,Sierra,091,2930,62,57,12,69,0
2021-06-22,Siskiyou,093,43540,1965,1892,376,2268,28
2021-06-22,Solano,095,438530,33397,33397,570,33967,267
2021-06-22,Sonoma,097,501317,30886,30933,366,31299,314
2021-06-22,Stanislaus,099,539301,57045,56915,6037,62952,1017
2021-06-22,Sutter,101,95872,9609,9649,90,9739,113
2021-06-22,Tehama,103,63373,5149,5118,596,5714,63
2021-06-22,Trinity,105,12862,491,337,99,436,3
2021-06-22,Tulare,107,460477,50446,49706,9180,58886,850
2021-06-22,Tuolumne,109,53932,4057,4119,41,4160,64
2021-06-22,Ventura,111,848112,81757,81300,3039,84339,1032
2021-06-22,Yolo,113,214977,14147,14157,345,14502,212
2021-06-22,Yuba,115,75493,6204,6181,133,6314,51
2021-06-21,Alameda,001,1643700,89297,89281,1993,91274,1262
2021-06-21,Alpine,003,1148,88,88,0,88,0
2021-06-21,Amador,005,37829,3750,3742,33,3775,46
2021-06-21,Butte,007,227075,12777,12668,1864,14532,195
2021-06-21,Calaveras,009,45235,2196,2194,14,2208,55
2021-06-21,Colusa,011,21464,1964,1970,321,2291,15
2021-06-21,Contra Costa,013,1133247,70878,70439,1328,71767,813
2021-06-21,Del Norte,015,27424,1453,1416,13,1429,8
2021-06-21,El Dorado,017,186661,10448,10375,756,11131,113
2021-06-21,Fresno,019,978130,103418,102971,8803,111774,1724
2021-06-21,Glenn,021,27897,2448,2433,570,3003,19
2021-06-21,Humboldt,023,135768,4483,4478,42,4520,42
2021-06-21,Imperial,025,180216,28776,28855,2780,31635,740
2021-06-21,Inyo,027,18085,1409,1405,12,1417,35
2021-06-21,Kern,029,883053,97865,96995,11142,108137,1342
2021-06-21,Kings,031,150075,23264,23091,1106,24197,245
2021-06-21,Lake,033,64148,3582,3563,13,3576,45
2021-06-21,Lassen,035,31185,5273,5233,117,5350,19
2021-06-21,Los Angeles,037,10098052,1210560,1205994,42115,1248109,24459
2021-06-21,Madera,039,155013,16773,16647,949,17596,240
2021-06-21,Marin,041,260295,14201,14173,267,14440,230
2021-06-21,Mariposa,043,17540,441,439,11,450,5
2021-06-21,Mendocino,045,87422,4164,4085,82,4167,49
2021-06-21,Merced,047,269075,31214,31264,1067,32331,465
2021-06-21,Modoc,049,8938,415,405,147,552,3
2021-06-21,Mono,051,14174,1266,1277,18,1295,3
2021-06-21,Monterey,053,433212,43321,43157,1883,45040,427
2021-06-21,Napa,055,140530,10012,10028,39,10067,80
2021-06-21,Nevada,057,99092,4962,4921,195,5116,72
2021-06-21,Orange,059,3164182,256420,255400,11530,266930,5113
2021-06-21,Placer,061,380077,23771,23577,1551,25128,298
2021-06-21,Plumas,063,18699,718,697,11,708,4
2021-06-21,Riverside,065,2383286,295464,289797,14171,303968,4456
2021-06-21,Sacramento,067,1510023,108008,107757,1830,109587,1669
2021-06-21,San Benito,069,59416,6091,6098,116,6214,63
2021-06-21,San Bernardino,071,2135413,294557,293736,9068,302804,4850
2021-06-21,San Diego,073,3302833,282735,281811,15296,297107,3771
2021-06-21,San Francisco,075,870044,37077,37275,1309,38584,556
2021-06-21,San Joaquin,077,732212,73992,73687,3661,77348,1405
2021-06-21,San Luis Obispo,079,281455,21522,21316,756,22072,257
2021-06-21,San Mateo,081,765935,42736,42685,483,43168,542
2021-06-21,Santa Barbara,083,443738,34596,34492,1145,35637,455
2021-06-21,Santa Clara,085,1922200,119401,120192,783,120975,2093
2021-06-21,Santa Cruz,087,273765,16320,16212,816,17028,208
2021-06-21,Shasta,089,179085,12567,12617,1632,14249,201
2021-06-21,Sierra,091,2930,62,57,12,69,0
2021-06-21,Siskiyou,093,43540,1965,1892,376,2268,27
2021-06-21,Solano,095,438530,33374,33383,569,33952,266
2021-06-21,Sonoma,097,501317,30863,30912,366,31278,314
2021-06-21,Stanislaus,099,539301,57015,56891,6032,62923,1017
2021-06-21,Sutter,101,95872,9606,9649,90,9739,113
2021-06-21,Tehama,103,63373,5149,5115,595,5710,63
2021-06-21,Trinity,105,12862,491,337,99,436,3
2021-06-21,Tulare,107,460477,50435,49689,9176,58865,849
2021-06-21,Tuolumne,109,53932,4053,4119,41,4160,63
2021-06-21,Ventura,111,848112,81729,81291,3035,84326,1031
2021-06-21,Yolo,113,214977,14141,14165,345,14510,212
2021-06-21,Yuba,115,75493,6203,6172,133,6305,51
2021-06-20,Alameda,001,1643700,89232,89255,1992,91247,1263
2021-06-20,Alpine,003,1148,88,88,0,88,0
2021-06-20,Amador,005,37829,3747,3740,33,3773,46
2021-06-20,Butte,007,227075,12770,12668,1863,14531,194
2021-06-20,Calaveras,009,45235,2195,2193,14,2207,55
2021-06-20,Colusa,011,21464,1964,1970,321,2291,15
2021-06-20,Contra Costa,013,1133247,70821,70401,1326,71727,813
2021-06-20,Del Norte,015,27424,1449,1416,13,1429,8
2021-06-20,El Dorado,017,186661,10434,10372,753,11125,113
2021-06-20,Fresno,019,978130,103377,102947,8800,111747,1724
2021-06-20,Glenn,021,27897,2448,2434,570,3004,19
2021-06-20,Humboldt,023,135768,4477,4472,42,4514,42
2021-06-20,Imperial,025,180216,28767,28855,2780,31635,740
2021-06-20,Inyo,027,18085,1408,1405,12,1417,35
2021-06-20,Kern,029,883053,97844,96985,11131,108116,1342
2021-06-20,Kings,031,150075,23259,23088,1104,24192,245
2021-06-20,Lake,033,64148,3580,3563,13,3576,45
2021-06-20,Lassen,035,31185,5270,5230,117,5347,19
2021-06-20,Los Angeles,037,10098052,1210261,1205874,42107,1247981,24456
2021-06-20,Madera,039,155013,16765,16638,947,17585,240
2021-06-20,Marin,041,260295,14198,14166,267,14433,230
2021-06-20,Mariposa,043,17540,439,439,11,450,5
2021-06-20,Mendocino,045,87422,4157,4080,82,4162,49
2021-06-20,Merced,047,269075,31201,31265,1067,32332,465
2021-06-20,Modoc,049,8938,415,405,147,552,3
2021-06-20,Mono,051,14174,1266,1275,18,1293,3
2021-06-20,Monterey,053,433212,43312,43156,1882,45038,427
2021-06-20,Napa,055,140530,10005,10026,38,10064,80
2021-06-20,Nevada,057,99092,4955,4919,195,5114,72
2021-06-20,Orange,059,3164182,256356,255377,11519,266896,5113
2021-06-20,Placer,061,380077,23737,23562,1547,25109,298
2021-06-20,Plumas,063,18699,717,697,11,708,4
2021-06-20,Riverside,065,2383286,295385,289770,14160,303930,4456
2021-06-20,Sacramento,067,1510023,107897,107700,1827,109527,1669
2021-06-20,San Benito,069,59416,6091,6098,116,6214,63
2021-06-20,San Bernardino,071,2135413,294457,293713,9064,302777,4845
2021-06-20,San Diego,073,3302833,282629,281750,15274,297024,3771
2021-06-20,San Francisco,075,870044,37054,37269,1309,38578,556
2021-06-20,San Joaquin,077,732212,73947,73676,3652,77328,1405
2021-06-20,San Luis Obispo,079,281455,21520,21313,756,22069,257
2021-06-20,San Mateo,081,765935,42707,42681,483,43164,542
2021-06-20,Santa Barbara,083,443738,34587,34487,1145,35632,455
2021-06-20,Santa Clara,085,1922200,119366,120163,783,120946,2093
2021-06-20,Santa Cruz,087,273765,16314,16210,816,17026,208
2021-06-20,Shasta,089,179085,12562,12617,1630,14247,201
2021-06-20,Sierra,091,2930,62,57,12,69,0
2021-06-20,Siskiyou,093,43540,1964,1891,376,2267,27
2021-06-20,Solano,095,438530,33352,33361,567,33928,266
2021-06-20,Sonoma,097,501317,30816,30884,363,31247,314
2021-06-20,Stanislaus,099,539301,56984,56868,6031,62899,1017
2021-06-20,Sutter,101,95872,9603,9645,90,9735,113
2021-06-20,Tehama,103,63373,5145,5115,595,5710,63
2021-06-20,Trinity,105,12862,491,337,99,436,3
2021-06-20,Tulare,107,460477,50426,49685,9174,58859,849
2021-06-20,Tuolumne,109,53932,4050,4117,41,4158,63
2021-06-20,Ventura,111,848112,81713,81282,3033,84315,1031
2021-06-20,Yolo,113,214977,14134,14160,345,14505,212
2021-06-20,Yuba,115,75493,6196,6167,133,6300,51
2021-06-19,Alameda,001,1643700,89197,89202,1992,91194,1263
2021-06-19,Alpine,003,1148,88,88,0,88,0
2021-06-19,Amador,005,37829,3745,3739,33,3772,46
2021-06-19,Butte,007,227075,12766,12659,1863,14522,194
2021-06-19,Calaveras,009,45235,2195,2192,14,2206,55
2021-06-19,Colusa,011,21464,1964,1969,321,2290,15
2021-06-19,Contra Costa,013,1133247,70790,70334,1325,71659,813
2021-06-19,Del Norte,015,27424,1448,1416,13,1429,8
2021-06-19,El Dorado,017,186661,10433,10363,752,11115,113
2021-06-19,Fresno,019,978130,103364,102922,8797,111719,1724
2021-06-19,Glenn,021,27897,2447,2434,569,3003,19
2021-06-19,Humboldt,023,135768,4466,4463,42,4505,42
2021-06-19,Imperial,025,180216,28766,28813,2780,31593,740
2021-06-19,Inyo,027,18085,1408,1405,12,1417,35
2021-06-19,Kern,029,883053,97828,96966,11127,108093,1342
2021-06-19,Kings,031,150075,23256,23086,1104,24190,245
2021-06-19,Lake,033,64148,3576,3563,13,3576,45
2021-06-19,Lassen,035,31185,5269,5225,117,5342,19
2021-06-19,Los Angeles,037,10098052,1210061,1205602,42092,1247694,24454
2021-06-19,Madera,039,155013,16763,16632,947,17579,240
2021-06-19,Marin,041,260295,14190,14152,267,14419,230
2021-06-19,Mariposa,043,17540,439,439,11,450,5
2021-06-19,Mendocino,045,87422,4151,4077,82,4159,49
2021-06-19,Merced,047,269075,31199,31256,1067,32323,465
2021-06-19,Modoc,049,8938,414,402,147,549,3
2021-06-19,Mono,051,14174,1266,1275,18,1293,3
2021-06-19,Monterey,053,433212,43306,43153,1882,45035,427
2021-06-19,Napa,055,140530,10001,10025,38,10063,80
2021-06-19,Nevada,057,99092,4950,4910,195,5105,72
2021-06-19,Orange,059,3164182,256309,255329,11516,266845,5112
2021-06-19,Placer,061,380077,23721,23537,1544,25081,298
2021-06-19,Plumas,063,18699,716,697,11,708,4
2021-06-19,Riverside,065,2383286,295339,289720,14160,303880,4456
2021-06-19,Sacramento,067,1510023,107851,107631,1824,109455,1669
2021-06-19,San Benito,069,59416,6090,6098,116,6214,63
2021-06-19,San Bernardino,071,2135413,294413,293673,9061,302734,4844
2021-06-19,San Diego,073,3302833,282569,281682,15260,296942,3771
2021-06-19,San Francisco,075,870044,37041,37256,1309,38565,556
2021-06-19,San Joaquin,077,732212,73931,73652,3648,77300,1405
2021-06-19,San Luis Obispo,079,281455,21518,21308,756,22064,257
2021-06-19,San Mateo,081,765935,42689,42646,481,43127,542
2021-06-19,Santa Barbara,083,443738,34585,34472,1145,35617,455
2021-06-19,Santa Clara,085,1922200,119343,120110,782,120892,2093
2021-06-19,Santa Cruz,087,273765,16309,16206,816,17022,208
2021-06-19,Shasta,089,179085,12560,12615,1629,14244,201
2021-06-19,Sierra,091,2930,62,57,12,69,0
2021-06-19,Siskiyou,093,43540,1964,1891,375,2266,27
2021-06-19,Solano,095,438530,33342,33341,566,33907,266
2021-06-19,Sonoma,097,501317,30775,30841,362,31203,314
2021-06-19,Stanislaus,099,539301,56965,56847,6028,62875,1017
2021-06-19,Sutter,101,95872,9600,9645,90,9735,113
2021-06-19,Tehama,103,63373,5144,5115,595,5710,63
2021-06-19,Trinity,105,12862,491,337,99,436,3
2021-06-19,Tulare,107,460477,50419,49681,9169,58850,849
2021-06-19,Tuolumne,109,53932,4050,4117,41,4158,63
2021-06-19,Ventura,111,848112,81700,81270,3032,84302,1031
2021-06-19,Yolo,113,214977,14130,14156,344,14500,212
2021-06-19,Yuba,115,75493,6195,6157,133,6290,51
2021-06-18,Alameda,001,1643700,89160,89123,1992,91115,1263
2021-06-18,Alpine,003,1148,88,88,0,88,0
2021-06-18,Amador,005,37829,3745,3739,33,3772,46
2021-06-18,Butte,007,227075,12763,12653,1860,14513,194
2021-06-18,Calaveras,009,45235,2195,2191,14,2205,55
2021-06-18,Colusa,011,21464,1963,1969,321,2290,15
2021-06-18,Contra Costa,013,1133247,70748,70271,1323,71594,813
2021-06-18,Del Norte,015,27424,1448,1415,13,1428,8
2021-06-18,El Dorado,017,186661,10430,10348,750,11098,113
2021-06-18,Fresno,019,978130,103348,102894,8795,111689,1722
2021-06-18,Glenn,021,27897,2446,2430,569,2999,19
2021-06-18,Humboldt,023,135768,4458,4450,42,4492,42
2021-06-18,Imperial,025,180216,28764,28809,2780,31589,740
2021-06-18,Inyo,027,18085,1408,1405,12,1417,35
2021-06-18,Kern,029,883053,97817,96948,11121,108069,1341
2021-06-18,Kings,031,150075,23251,23082,1104,24186,245
2021-06-18,Lake,033,64148,3572,3563,13,3576,45
2021-06-18,Lassen,035,31185,5268,5224,117,5341,19
2021-06-18,Los Angeles,037,10098052,1209904,1205472,42075,1247547,24451
2021-06-18,Madera,039,155013,16757,16625,947,17572,241
2021-06-18,Marin,041,260295,14187,14147,267,14414,230
2021-06-18,Mariposa,043,17540,439,439,11,450,5
2021-06-18,Mendocino,045,87422,4146,4068,82,4150,49
2021-06-18,Merced,047,269075,31197,31262,1067,32329,464
2021-06-18,Modoc,049,8938,414,402,147,549,3
2021-06-18,Mono,051,14174,1265,1275,17,1292,3
2021-06-18,Monterey,053,433212,43303,43148,1882,45030,427
2021-06-18,Napa,055,140530,9997,10021,38,10059,80
2021-06-18,Nevada,057,99092,4942,4903,195,5098,72
2021-06-18,Orange,059,3164182,256272,255274,11513,266787,5108
2021-06-18,Placer,061,380077,23713,23500,1541,25041,298
2021-06-18,Plumas,063,18699,716,697,11,708,4
2021-06-18,Riverside,065,2383286,295291,289676,14159,303835,4457
2021-06-18,Sacramento,067,1510023,107803,107570,1824,109394,1669
2021-06-18,San Benito,069,59416,6089,6097,116,6213,63
2021-06-18,San Bernardino,071,2135413,294368,293629,9057,302686,4826
2021-06-18,San Diego,073,3302833,282493,281608,15249,296857,3771
2021-06-18,San Francisco,075,870044,37032,37246,1309,38555,556
2021-06-18,San Joaquin,077,732212,73913,73623,3646,77269,1403
2021-06-18,San Luis Obispo,079,281455,21514,21301,755,22056,257
2021-06-18,San Mateo,081,765935,42678,42630,480,43110,542
2021-06-18,Santa Barbara,083,443738,34575,34469,1145,35614,455
2021-06-18,Santa Clara,085,1922200,119322,120081,780,120861,2093
2021-06-18,Santa Cruz,087,273765,16305,16202,816,17018,208
2021-06-18,Shasta,089,179085,12556,12607,1627,14234,201
2021-06-18,Sierra,091,2930,61,57,12,69,0
2021-06-18,Siskiyou,093,43540,1964,1890,375,2265,27
2021-06-18,Solano,095,438530,33328,33323,566,33889,266
2021-06-18,Sonoma,097,501317,30757,30816,361,31177,313
2021-06-18,Stanislaus,099,539301,56950,56803,6026,62829,1012
2021-06-18,Sutter,101,95872,9597,9643,90,9733,113
2021-06-18,Tehama,103,63373,5142,5114,595,5709,63
2021-06-18,Trinity,105,12862,491,337,98,435,3
2021-06-18,Tulare,107,460477,50417,49664,9162,58826,849
2021-06-18,Tuolumne,109,53932,4048,4116,41,4157,63
2021-06-18,Ventura,111,848112,81690,81256,3027,84283,1031
2021-06-18,Yolo,113,214977,14127,14148,342,14490,212
2021-06-18,Yuba,115,75493,6189,6150,133,6283,51
2021-06-17,Alameda,001,1643700,89113,89087,1992,91079,1262
2021-06-17,Alpine,003,1148,88,88,0,88,0
2021-06-17,Amador,005,37829,3743,3731,33,3764,46
2021-06-17,Butte,007,227075,12753,12644,1859,14503,194
2021-06-17,Calaveras,009,45235,2194,2189,14,2203,55
2021-06-17,Colusa,011,21464,1962,1969,321,2290,15
2021-06-17,Contra Costa,013,1133247,70709,70190,1319,71509,810
2021-06-17,Del Norte,015,27424,1446,1413,13,1426,8
2021-06-17,El Dorado,017,186661,10420,10341,750,11091,113
2021-06-17,Fresno,019,978130,103322,102867,8791,111658,1722
2021-06-17,Glenn,021,27897,2446,2430,569,2999,19
2021-06-17,Humboldt,023,135768,4449,4438,42,4480,42
2021-06-17,Imperial,025,180216,28756,28801,2780,31581,741
2021-06-17,Inyo,027,18085,1408,1405,12,1417,35
2021-06-17,Kern,029,883053,97802,96840,11115,107955,1340
2021-06-17,Kings,031,150075,23247,23078,1103,24181,245
2021-06-17,Lake,033,64148,3569,3563,9,3572,45
2021-06-17,Lassen,035,31185,5264,5223,117,5340,19
2021-06-17,Los Angeles,037,10098052,1209692,1205301,42046,1247347,24444
2021-06-17,Madera,039,155013,16752,16618,947,17565,241
2021-06-17,Marin,041,260295,14187,14141,267,14408,229
2021-06-17,Mariposa,043,17540,439,439,11,450,5
2021-06-17,Mendocino,045,87422,4139,4054,82,4136,49
2021-06-17,Merced,047,269075,31192,31262,1067,32329,464
2021-06-17,Modoc,049,8938,413,401,147,548,3
2021-06-17,Mono,051,14174,1264,1275,17,1292,3
2021-06-17,Monterey,053,433212,43295,43140,1882,45022,416
2021-06-17,Napa,055,140530,9997,10014,38,10052,80
2021-06-17,Nevada,057,99092,4938,4898,195,5093,72
2021-06-17,Orange,059,3164182,256226,255240,11502,266742,5109
2021-06-17,Placer,061,380077,23697,23461,1539,25000,298
2021-06-17,Plumas,063,18699,715,697,11,708,4
2021-06-17,Riverside,065,2383286,295237,289627,14157,303784,4458
2021-06-17,Sacramento,067,1510023,107739,107492,1822,109314,1666
2021-06-17,San Benito,069,59416,6089,6097,116,6213,63
2021-06-17,San Bernardino,071,2135413,294327,293560,9057,302617,4811
2021-06-17,San Diego,073,3302833,282417,281531,15235,296766,3771
2021-06-17,San Francisco,075,870044,37021,37243,1308,38551,556
2021-06-17,San Joaquin,077,732212,73890,73560,3641,77201,1403
2021-06-17,San Luis Obispo,079,281455,21512,21297,755,22052,257
2021-06-17,San Mateo,081,765935,42672,42615,480,43095,542
2021-06-17,Santa Barbara,083,443738,34569,34466,1145,35611,453
2021-06-17,Santa Clara,085,1922200,119297,120032,779,120811,2093
2021-06-17,Santa Cruz,087,273765,16301,16197,816,17013,208
2021-06-17,Shasta,089,179085,12548,12597,1627,14224,201
2021-06-17,Sierra,091,2930,61,56,12,68,0
2021-06-17,Siskiyou,093,43540,1963,1889,375,2264,27
2021-06-17,Solano,095,438530,33307,33296,565,33861,266
2021-06-17,Sonoma,097,501317,30726,30793,361,31154,323
2021-06-17,Stanislaus,099,539301,56919,56752,6021,62773,1012
2021-06-17,Sutter,101,95872,9594,9629,90,9719,113
2021-06-17,Tehama,103,63373,5141,5112,593,5705,63
2021-06-17,Trinity,105,12862,490,337,98,435,3
2021-06-17,Tulare,107,460477,50412,49649,9154,58803,849
2021-06-17,Tuolumne,109,53932,4047,4116,41,4157,63
2021-06-17,Ventura,111,848112,81681,81248,3024,84272,1030
2021-06-17,Yolo,113,214977,14119,14141,342,14483,212
2021-06-17,Yuba,115,75493,6180,6140,133,6273,51
2021-06-16,Alameda,001,1643700,89064,89045,1991,91036,1265
2021-06-16,Alpine,003,1148,88,88,0,88,0
2021-06-16,Amador,005,37829,3742,3730,33,3763,46
2021-06-16,Butte,007,227075,12751,12635,1857,14492,194
2021-06-16,Calaveras,009,45235,2192,2188,14,2202,55
2021-06-16,Colusa,011,21464,1962,1967,321,2288,15
2021-06-16,Contra Costa,013,1133247,70657,70136,1318,71454,810
2021-06-16,Del Norte,015,27424,1443,1413,13,1426,8
2021-06-16,El Dorado,017,186661,10414,10334,749,11083,113
2021-06-16,Fresno,019,978130,103292,102842,8787,111629,1722
2021-06-16,Glenn,021,27897,2446,2430,569,2999,19
2021-06-16,Humboldt,023,135768,4440,4427,41,4468,42
2021-06-16,Imperial,025,180216,28753,28796,2780,31576,741
2021-06-16,Inyo,027,18085,1407,1405,12,1417,35
2021-06-16,Kern,029,883053,97780,96789,11108,107897,1339
2021-06-16,Kings,031,150075,23246,23072,1102,24174,245
2021-06-16,Lake,033,64148,3569,3562,9,3571,45
2021-06-16,Lassen,035,31185,5261,5216,117,5333,19
2021-06-16,Los Angeles,037,10098052,1209469,1205102,42035,1247137,24439
2021-06-16,Madera,039,155013,16748,16603,947,17550,240
2021-06-16,Marin,041,260295,14185,14137,267,14404,229
2021-06-16,Mariposa,043,17540,439,437,11,448,5
2021-06-16,Mendocino,045,87422,4131,4041,82,4123,49
2021-06-16,Merced,047,269075,31184,31250,1067,32317,463
2021-06-16,Modoc,049,8938,412,383,146,529,3
2021-06-16,Mono,051,14174,1264,1275,17,1292,3
2021-06-16,Monterey,053,433212,43292,43122,1882,45004,416
2021-06-16,Napa,055,140530,9993,10011,38,10049,80
2021-06-16,Nevada,057,99092,4933,4894,195,5089,72
2021-06-16,Orange,059,3164182,256172,255188,11494,266682,5109
2021-06-16,Placer,061,380077,23687,23425,1535,24960,298
2021-06-16,Plumas,063,18699,715,697,11,708,4
2021-06-16,Riverside,065,2383286,295176,289539,14155,303694,4457
2021-06-16,Sacramento,067,1510023,107669,107422,1818,109240,1665
2021-06-16,San Benito,069,59416,6089,6090,116,6206,63
2021-06-16,San Bernardino,071,2135413,294278,293499,9055,302554,4797
2021-06-16,San Diego,073,3302833,282338,281423,15222,296645,3770
2021-06-16,San Francisco,075,870044,37008,37222,1306,38528,555
2021-06-16,San Joaquin,077,732212,73851,73530,3637,77167,1399
2021-06-16,San Luis Obispo,079,281455,21507,21294,755,22049,257
2021-06-16,San Mateo,081,765935,42656,42601,480,43081,542
2021-06-16,Santa Barbara,083,443738,34563,34459,1145,35604,460
2021-06-16,Santa Clara,085,1922200,119265,119982,779,120761,2087
2021-06-16,Santa Cruz,087,273765,16298,16187,816,17003,208
2021-06-16,Shasta,089,179085,12543,12592,1626,14218,200
2021-06-16,Sierra,091,2930,61,56,12,68,0
2021-06-16,Siskiyou,093,43540,1962,1886,375,2261,26
2021-06-16,Solano,095,438530,33279,33276,565,33841,266
2021-06-16,Sonoma,097,501317,30690,30741,361,31102,323
2021-06-16,Stanislaus,099,539301,56888,56738,6019,62757,984
2021-06-16,Sutter,101,95872,9590,9620,90,9710,113
2021-06-16,Tehama,103,63373,5139,5106,593,5699,63
2021-06-16,Trinity,105,12862,489,332,98,430,3
2021-06-16,Tulare,107,460477,50407,49578,9150,58728,849
2021-06-16,Tuolumne,109,53932,4047,4110,41,4151,63
2021-06-16,Ventura,111,848112,81667,81229,3022,84251,1029
2021-06-16,Yolo,113,214977,14110,14135,341,14476,212
2021-06-16,Yuba,115,75493,6170,6134,133,6267,51
2021-06-15,Alameda,001,1643700,89021,89008,1991,90999,1262
2021-06-15,Alpine,003,1148,88,88,0,88,0
2021-06-15,Amador,005,37829,3739,3723,33,3756,46
2021-06-15,Butte,007,227075,12743,12620,1856,14476,194
2021-06-15,Calaveras,009,45235,2191,2188,14,2202,55
2021-06-15,Colusa,011,21464,1962,1967,319,2286,15
2021-06-15,Contra Costa,013,1133247,70595,70101,1318,71419,810
2021-06-15,Del Norte,015,27424,1442,1411,13,1424,8
2021-06-15,El Dorado,017,186661,10405,10330,749,11079,113
2021-06-15,Fresno,019,978130,103260,102828,8786,111614,1722
2021-06-15,Glenn,021,27897,2445,2426,569,2995,19
2021-06-15,Humboldt,023,135768,4431,4414,40,4454,42
2021-06-15,Imperial,025,180216,28747,28789,2780,31569,741
2021-06-15,Inyo,027,18085,1407,1405,12,1417,35
2021-06-15,Kern,029,883053,97752,96782,11100,107882,1338
2021-06-15,Kings,031,150075,23240,23070,1100,24170,245
2021-06-15,Lake,033,64148,3568,3559,9,3568,45
2021-06-15,Lassen,035,31185,5260,5211,117,5328,19
2021-06-15,Los Angeles,037,10098052,1209237,1204926,42027,1246953,24435
2021-06-15,Madera,039,155013,16741,16600,946,17546,240
2021-06-15,Marin,041,260295,14177,14135,267,14402,229
2021-06-15,Mariposa,043,17540,439,437,11,448,5
2021-06-15,Mendocino,045,87422,4124,4034,82,4116,49
2021-06-15,Merced,047,269075,31178,31244,1067,32311,461
2021-06-15,Modoc,049,8938,411,383,146,529,3
2021-06-15,Mono,051,14174,1264,1275,17,1292,3
2021-06-15,Monterey,053,433212,43286,43118,1882,45000,416
2021-06-15,Napa,055,140530,9991,10010,38,10048,80
2021-06-15,Nevada,057,99092,4930,4888,195,5083,72
2021-06-15,Orange,059,3164182,256131,255127,11485,266612,5105
2021-06-15,Placer,061,380077,23665,23396,1534,24930,298
2021-06-15,Plumas,063,18699,714,697,11,708,4
2021-06-15,Riverside,065,2383286,295116,289508,14151,303659,4455
2021-06-15,Sacramento,067,1510023,107594,107370,1812,109182,1662
2021-06-15,San Benito,069,59416,6088,6089,116,6205,63
2021-06-15,San Bernardino,071,2135413,294228,293463,9049,302512,4790
2021-06-15,San Diego,073,3302833,282254,281375,15207,296582,3770
2021-06-15,San Francisco,075,870044,36999,37210,1305,38515,555
2021-06-15,San Joaquin,077,732212,73811,73494,3632,77126,1399
2021-06-15,San Luis Obispo,079,281455,21502,21293,754,22047,257
2021-06-15,San Mateo,081,765935,42642,42593,480,43073,543
2021-06-15,Santa Barbara,083,443738,34558,34451,1145,35596,460
2021-06-15,Santa Clara,085,1922200,119227,119963,779,120742,2086
2021-06-15,Santa Cruz,087,273765,16292,16180,815,16995,208
2021-06-15,Shasta,089,179085,12537,12583,1626,14209,201
2021-06-15,Sierra,091,2930,60,55,12,67,0
2021-06-15,Siskiyou,093,43540,1961,1887,375,2262,26
2021-06-15,Solano,095,438530,33260,33264,565,33829,266
2021-06-15,Sonoma,097,501317,30651,30707,360,31067,323
2021-06-15,Stanislaus,099,539301,56860,56724,6016,62740,979
2021-06-15,Sutter,101,95872,9581,9616,90,9706,113
2021-06-15,Tehama,103,63373,5137,5102,593,5695,63
2021-06-15,Trinity,105,12862,488,332,97,429,3
2021-06-15,Tulare,107,460477,50400,49561,9147,58708,848
2021-06-15,Tuolumne,109,53932,4047,4111,41,4152,63
2021-06-15,Ventura,111,848112,81656,81215,3019,84234,1029
2021-06-15,Yolo,113,214977,14106,14127,339,14466,212
2021-06-15,Yuba,115,75493,6159,6130,133,6263,51
2021-06-14,Alameda,001,1643700,88972,88966,1991,90957,1264
2021-06-14,Alpine,003,1148,88,88,0,88,0
2021-06-14,Amador,005,37829,3738,3722,33,3755,46
2021-06-14,Butte,007,227075,12732,12613,1852,14465,194
2021-06-14,Calaveras,009,45235,2190,2190,14,2204,55
2021-06-14,Colusa,011,21464,1961,1966,319,2285,15
2021-06-14,Contra Costa,013,1133247,70542,70069,1316,71385,810
2021-06-14,Del Norte,015,27424,1442,1411,13,1424,8
2021-06-14,El Dorado,017,186661,10396,10327,748,11075,113
2021-06-14,Fresno,019,978130,103238,102812,8784,111596,1719
2021-06-14,Glenn,021,27897,2445,2426,569,2995,19
2021-06-14,Humboldt,023,135768,4423,4407,39,4446,42
2021-06-14,Imperial,025,180216,28735,28836,2780,31616,741
2021-06-14,Inyo,027,18085,1406,1405,12,1417,35
2021-06-14,Kern,029,883053,97732,96760,11090,107850,1337
2021-06-14,Kings,031,150075,23237,23071,1099,24170,245
2021-06-14,Lake,033,64148,3567,3557,9,3566,45
2021-06-14,Lassen,035,31185,5257,5209,116,5325,19
2021-06-14,Los Angeles,037,10098052,1209002,1204748,42017,1246765,24434
2021-06-14,Madera,039,155013,16735,16597,945,17542,240
2021-06-14,Marin,041,260295,14175,14133,267,14400,229
2021-06-14,Mariposa,043,17540,438,437,11,448,5
2021-06-14,Mendocino,045,87422,4118,4028,82,4110,49
2021-06-14,Merced,047,269075,31169,31241,1066,32307,461
2021-06-14,Modoc,049,8938,402,382,144,526,3
2021-06-14,Mono,051,14174,1264,1275,17,1292,3
2021-06-14,Monterey,053,433212,43283,43110,1882,44992,415
2021-06-14,Napa,055,140530,9987,10000,38,10038,80
2021-06-14,Nevada,057,99092,4923,4885,195,5080,72
2021-06-14,Orange,059,3164182,256093,255069,11481,266550,5103
2021-06-14,Placer,061,380077,23640,23379,1533,24912,298
2021-06-14,Plumas,063,18699,714,696,11,707,4
2021-06-14,Riverside,065,2383286,295062,289476,14151,303627,4453
2021-06-14,Sacramento,067,1510023,107540,107334,1807,109141,1661
2021-06-14,San Benito,069,59416,6088,6087,116,6203,63
2021-06-14,San Bernardino,071,2135413,294172,293446,9045,302491,4790
2021-06-14,San Diego,073,3302833,282148,281314,15187,296501,3770
2021-06-14,San Francisco,075,870044,36986,37206,1305,38511,555
2021-06-14,San Joaquin,077,732212,73782,73453,3632,77085,1398
2021-06-14,San Luis Obispo,079,281455,21500,21302,754,22056,256
2021-06-14,San Mateo,081,765935,42629,42619,479,43098,543
2021-06-14,Santa Barbara,083,443738,34555,34449,1145,35594,460
2021-06-14,Santa Clara,085,1922200,119196,119957,778,120735,2085
2021-06-14,Santa Cruz,087,273765,16289,16175,815,16990,208
2021-06-14,Shasta,089,179085,12526,12561,1623,14184,201
2021-06-14,Sierra,091,2930,59,55,12,67,0
2021-06-14,Siskiyou,093,43540,1961,1886,375,2261,26
2021-06-14,Solano,095,438530,33243,33243,564,33807,266
2021-06-14,Sonoma,097,501317,30619,30679,359,31038,323
2021-06-14,Stanislaus,099,539301,56824,56689,6013,62702,975
2021-06-14,Sutter,101,95872,9578,9607,90,9697,112
2021-06-14,Tehama,103,63373,5135,5102,593,5695,63
2021-06-14,Trinity,105,12862,488,332,97,429,3
2021-06-14,Tulare,107,460477,50395,49538,9144,58682,848
2021-06-14,Tuolumne,109,53932,4044,4108,41,4149,63
2021-06-14,Ventura,111,848112,81646,81209,3019,84228,1028
2021-06-14,Yolo,113,214977,14098,14123,339,14462,212
2021-06-14,Yuba,115,75493,6152,6127,133,6260,50
2021-06-13,Alameda,001,1643700,88915,88947,1990,90937,1264
2021-06-13,Alpine,003,1148,87,88,0,88,0
2021-06-13,Amador,005,37829,3734,3721,33,3754,46
2021-06-13,Butte,007,227075,12721,12586,1849,14435,194
2021-06-13,Calaveras,009,45235,2190,2189,14,2203,55
2021-06-13,Colusa,011,21464,1961,1965,318,2283,15
2021-06-13,Contra Costa,013,1133247,70488,70040,1314,71354,810
2021-06-13,Del Norte,015,27424,1440,1412,13,1425,8
2021-06-13,El Dorado,017,186661,10387,10324,748,11072,113
2021-06-13,Fresno,019,978130,103207,102795,8779,111574,1719
2021-06-13,Glenn,021,27897,2444,2425,567,2992,19
2021-06-13,Humboldt,023,135768,4410,4401,39,4440,42
2021-06-13,Imperial,025,180216,28726,28800,2780,31580,741
2021-06-13,Inyo,027,18085,1406,1405,12,1417,35
2021-06-13,Kern,029,883053,97708,96743,11078,107821,1337
2021-06-13,Kings,031,150075,23232,23069,1098,24167,245
2021-06-13,Lake,033,64148,3567,3556,9,3565,45
2021-06-13,Lassen,035,31185,5252,5209,116,5325,19
2021-06-13,Los Angeles,037,10098052,1208739,1204614,42004,1246618,24433
2021-06-13,Madera,039,155013,16721,16590,945,17535,240
2021-06-13,Marin,041,260295,14169,14126,267,14393,229
2021-06-13,Mariposa,043,17540,438,434,11,445,5
2021-06-13,Mendocino,045,87422,4111,4026,82,4108,49
2021-06-13,Merced,047,269075,31163,31240,1065,32305,461
2021-06-13,Modoc,049,8938,400,382,142,524,3
2021-06-13,Mono,051,14174,1264,1275,17,1292,3
2021-06-13,Monterey,053,433212,43275,43108,1882,44990,415
2021-06-13,Napa,055,140530,9981,9995,38,10033,80
2021-06-13,Nevada,057,99092,4918,4883,195,5078,72
2021-06-13,Orange,059,3164182,256038,255043,11479,266522,5103
2021-06-13,Placer,061,380077,23614,23365,1531,24896,295
2021-06-13,Plumas,063,18699,713,696,11,707,4
2021-06-13,Riverside,065,2383286,294995,289447,14148,303595,4453
2021-06-13,Sacramento,067,1510023,107464,107289,1804,109093,1658
2021-06-13,San Benito,069,59416,6088,6086,116,6202,63
2021-06-13,San Bernardino,071,2135413,294121,293416,9040,302456,4788
2021-06-13,San Diego,073,3302833,282069,281268,15171,296439,3770
2021-06-13,San Francisco,075,870044,36973,37197,1305,38502,555
2021-06-13,San Joaquin,077,732212,73746,73438,3630,77068,1398
2021-06-13,San Luis Obispo,079,281455,21494,21298,753,22051,256
2021-06-13,San Mateo,081,765935,42616,42611,479,43090,542
2021-06-13,Santa Barbara,083,443738,34544,34449,1144,35593,460
2021-06-13,Santa Clara,085,1922200,119172,119946,778,120724,2085
2021-06-13,Santa Cruz,087,273765,16282,16172,815,16987,208
2021-06-13,Shasta,089,179085,12517,12560,1622,14182,201
2021-06-13,Sierra,091,2930,59,55,12,67,0
2021-06-13,Siskiyou,093,43540,1960,1885,375,2260,26
2021-06-13,Solano,095,438530,33222,33234,564,33798,266
2021-06-13,Sonoma,097,501317,30584,30663,357,31020,323
2021-06-13,Stanislaus,099,539301,56798,56671,6010,62681,975
2021-06-13,Sutter,101,95872,9571,9603,90,9693,112
2021-06-13,Tehama,103,63373,5133,5100,593,5693,63
2021-06-13,Trinity,105,12862,487,332,97,429,3
2021-06-13,Tulare,107,460477,50386,49537,9139,58676,848
2021-06-13,Tuolumne,109,53932,4042,4107,40,4147,63
2021-06-13,Ventura,111,848112,81632,81201,3019,84220,1028
2021-06-13,Yolo,113,214977,14090,14120,337,14457,212
2021-06-13,Yuba,115,75493,6145,6125,133,6258,50
2021-06-12,Alameda,001,1643700,88888,88901,1990,90891,1271
2021-06-12,Alpine,003,1148,87,88,0,88,0
2021-06-12,Amador,005,37829,3733,3721,33,3754,46
2021-06-12,Butte,007,227075,12717,12576,1849,14425,194
2021-06-12,Calaveras,009,45235,2190,2189,14,2203,55
2021-06-12,Colusa,011,21464,1961,1965,318,2283,15
2021-06-12,Contra Costa,013,1133247,70457,69989,1311,71300,810
2021-06-12,Del Norte,015,27424,1440,1412,13,1425,8
2021-06-12,El Dorado,017,186661,10382,10320,747,11067,113
2021-06-12,Fresno,019,978130,103197,102783,8778,111561,1720
2021-06-12,Glenn,021,27897,2442,2425,567,2992,19
2021-06-12,Humboldt,023,135768,4402,4396,39,4435,42
2021-06-12,Imperial,025,180216,28723,28799,2780,31579,741
2021-06-12,Inyo,027,18085,1406,1405,12,1417,35
2021-06-12,Kern,029,883053,97693,96731,11074,107805,1337
2021-06-12,Kings,031,150075,23230,23067,1098,24165,245
2021-06-12,Lake,033,64148,3566,3552,9,3561,45
2021-06-12,Lassen,035,31185,5252,5208,116,5324,19
2021-06-12,Los Angeles,037,10098052,1208601,1204439,41998,1246437,24434
2021-06-12,Madera,039,155013,16717,16586,945,17531,240
2021-06-12,Marin,041,260295,14166,14121,267,14388,229
2021-06-12,Mariposa,043,17540,438,434,11,445,5
2021-06-12,Mendocino,045,87422,4108,4024,82,4106,49
2021-06-12,Merced,047,269075,31160,31236,1065,32301,461
2021-06-12,Modoc,049,8938,399,382,142,524,3
2021-06-12,Mono,051,14174,1264,1275,17,1292,3
2021-06-12,Monterey,053,433212,43269,43103,1882,44985,415
2021-06-12,Napa,055,140530,9977,9986,38,10024,80
2021-06-12,Nevada,057,99092,4912,4878,195,5073,72
2021-06-12,Orange,059,3164182,256005,255004,11477,266481,5103
2021-06-12,Placer,061,380077,23595,23345,1531,24876,295
2021-06-12,Plumas,063,18699,713,696,11,707,4
2021-06-12,Riverside,065,2383286,294953,289413,14145,303558,4453
2021-06-12,Sacramento,067,1510023,107404,107199,1801,109000,1658
2021-06-12,San Benito,069,59416,6086,6083,116,6199,63
2021-06-12,San Bernardino,071,2135413,294087,293375,9038,302413,4788
2021-06-12,San Diego,073,3302833,282012,281203,15162,296365,3770
2021-06-12,San Francisco,075,870044,36963,37189,1305,38494,555
2021-06-12,San Joaquin,077,732212,73727,73413,3629,77042,1398
2021-06-12,San Luis Obispo,079,281455,21491,21293,753,22046,256
2021-06-12,San Mateo,081,765935,42611,42604,479,43083,542
2021-06-12,Santa Barbara,083,443738,34539,34450,1144,35594,460
2021-06-12,Santa Clara,085,1922200,119132,119894,778,120672,2085
2021-06-12,Santa Cruz,087,273765,16274,16170,815,16985,208
2021-06-12,Shasta,089,179085,12514,12556,1621,14177,201
2021-06-12,Sierra,091,2930,59,55,12,67,0
2021-06-12,Siskiyou,093,43540,1959,1884,375,2259,25
2021-06-12,Solano,095,438530,33213,33219,564,33783,266
2021-06-12,Sonoma,097,501317,30555,30647,357,31004,323
2021-06-12,Stanislaus,099,539301,56781,56649,6009,62658,974
2021-06-12,Sutter,101,95872,9567,9603,90,9693,112
2021-06-12,Tehama,103,63373,5133,5099,592,5691,63
2021-06-12,Trinity,105,12862,487,332,97,429,3
2021-06-12,Tulare,107,460477,50381,49533,9132,58665,848
2021-06-12,Tuolumne,109,53932,4041,4105,40,4145,63
2021-06-12,Ventura,111,848112,81620,81197,3019,84216,1028
2021-06-12,Yolo,113,214977,14087,14118,336,14454,212
2021-06-12,Yuba,115,75493,6140,6120,133,6253,50
2021-06-11,Alameda,001,1643700,88860,88844,1990,90834,1278
2021-06-11,Alpine,003,1148,87,88,0,88,0
2021-06-11,Amador,005,37829,3732,3710,33,3743,46
2021-06-11,Butte,007,227075,12713,12576,1847,14423,194
2021-06-11,Calaveras,009,45235,2190,2188,14,2202,55
2021-06-11,Colusa,011,21464,1960,1964,318,2282,15
2021-06-11,Contra Costa,013,1133247,70424,69940,1309,71249,808
2021-06-11,Del Norte,015,27424,1440,1409,13,1422,8
2021-06-11,El Dorado,017,186661,10379,10316,747,11063,113
2021-06-11,Fresno,019,978130,103178,102770,8777,111547,1720
2021-06-11,Glenn,021,27897,2442,2425,567,2992,19
2021-06-11,Humboldt,023,135768,4398,4389,39,4428,42
2021-06-11,Imperial,025,180216,28718,28793,2780,31573,741
2021-06-11,Inyo,027,18085,1406,1405,12,1417,35
2021-06-11,Kern,029,883053,97681,96718,11071,107789,1340
2021-06-11,Kings,031,150075,23226,23069,1097,24166,245
2021-06-11,Lake,033,64148,3565,3550,9,3559,45
2021-06-11,Lassen,035,31185,5251,5204,116,5320,18
2021-06-11,Los Angeles,037,10098052,1208454,1204259,41983,1246242,24434
2021-06-11,Madera,039,155013,16714,16582,945,17527,240
2021-06-11,Marin,041,260295,14163,14116,267,14383,229
2021-06-11,Mariposa,043,17540,438,434,11,445,5
2021-06-11,Mendocino,045,87422,4105,4022,82,4104,49
2021-06-11,Merced,047,269075,31155,31231,1065,32296,461
2021-06-11,Modoc,049,8938,399,382,141,523,3
2021-06-11,Mono,051,14174,1264,1274,17,1291,3
2021-06-11,Monterey,053,433212,43265,43097,1882,44979,415
2021-06-11,Napa,055,140530,9974,9977,38,10015,80
2021-06-11,Nevada,057,99092,4910,4873,195,5068,72
2021-06-11,Orange,059,3164182,255971,254975,11474,266449,5101
2021-06-11,Placer,061,380077,23590,23330,1531,24861,294
2021-06-11,Plumas,063,18699,713,696,11,707,4
2021-06-11,Riverside,065,2383286,294915,289376,14140,303516,4451
2021-06-11,Sacramento,067,1510023,107344,107119,1800,108919,1659
2021-06-11,San Benito,069,59416,6085,6082,116,6198,63
2021-06-11,San Bernardino,071,2135413,294052,293335,9034,302369,4788
2021-06-11,San Diego,073,3302833,281972,281144,15155,296299,3768
2021-06-11,San Francisco,075,870044,36958,37177,1305,38482,555
2021-06-11,San Joaquin,077,732212,73710,73347,3626,76973,1397
2021-06-11,San Luis Obispo,079,281455,21490,21288,753,22041,256
2021-06-11,San Mateo,081,765935,42597,42585,479,43064,542
2021-06-11,Santa Barbara,083,443738,34536,34438,1144,35582,460
2021-06-11,Santa Clara,085,1922200,119112,119860,778,120638,2083
2021-06-11,Santa Cruz,087,273765,16266,16164,815,16979,208
2021-06-11,Shasta,089,179085,12506,12550,1619,14169,201
2021-06-11,Sierra,091,2930,59,55,12,67,0
2021-06-11,Siskiyou,093,43540,1958,1882,375,2257,25
2021-06-11,Solano,095,438530,33193,33179,563,33742,266
2021-06-11,Sonoma,097,501317,30537,30624,357,30981,323
2021-06-11,Stanislaus,099,539301,56756,56617,6005,62622,974
2021-06-11,Sutter,101,95872,9564,9600,89,9689,112
2021-06-11,Tehama,103,63373,5132,5099,592,5691,63
2021-06-11,Trinity,105,12862,487,331,97,428,3
2021-06-11,Tulare,107,460477,50375,49516,9131,58647,848
2021-06-11,Tuolumne,109,53932,4038,4104,40,4144,63
2021-06-11,Ventura,111,848112,81610,81189,3019,84208,1026
2021-06-11,Yolo,113,214977,14080,14111,332,14443,212
2021-06-11,Yuba,115,75493,6136,6113,133,6246,50
2021-06-10,Alameda,001,1643700,88816,88806,1989,90795,1275
2021-06-10,Alpine,003,1148,87,88,0,88,0
2021-06-10,Amador,005,37829,3728,3709,33,3742,46
2021-06-10,Butte,007,227075,12696,12565,1847,14412,194
2021-06-10,Calaveras,009,45235,2189,2188,14,2202,55
2021-06-10,Colusa,011,21464,1958,1964,318,2282,15
2021-06-10,Contra Costa,013,1133247,70370,69876,1309,71185,807
2021-06-10,Del Norte,015,27424,1440,1405,13,1418,8
2021-06-10,El Dorado,017,186661,10372,10314,743,11057,113
2021-06-10,Fresno,019,978130,103152,102724,8776,111500,1717
2021-06-10,Glenn,021,27897,2442,2425,567,2992,19
2021-06-10,Humboldt,023,135768,4390,4384,39,4423,42
2021-06-10,Imperial,025,180216,28712,28779,2780,31559,739
2021-06-10,Inyo,027,18085,1406,1405,12,1417,35
2021-06-10,Kern,029,883053,97667,96706,11066,107772,1336
2021-06-10,Kings,031,150075,23225,23067,1097,24164,245
2021-06-10,Lake,033,64148,3560,3550,9,3559,45
2021-06-10,Lassen,035,31185,5249,5201,116,5317,18
2021-06-10,Los Angeles,037,10098052,1208289,1204110,41966,1246076,24440
2021-06-10,Madera,039,155013,16707,16581,944,17525,240
2021-06-10,Marin,041,260295,14160,14118,267,14385,229
2021-06-10,Mariposa,043,17540,436,434,11,445,5
2021-06-10,Mendocino,045,87422,4100,4016,82,4098,48
2021-06-10,Merced,047,269075,31147,31231,1062,32293,461
2021-06-10,Modoc,049,8938,398,381,141,522,3
2021-06-10,Mono,051,14174,1263,1274,17,1291,3
2021-06-10,Monterey,053,433212,43259,43090,1882,44972,415
2021-06-10,Napa,055,140530,9973,9974,38,10012,80
2021-06-10,Nevada,057,99092,4905,4866,195,5061,72
2021-06-10,Orange,059,3164182,255941,254950,11467,266417,5097
2021-06-10,Placer,061,380077,23577,23296,1531,24827,293
2021-06-10,Plumas,063,18699,713,696,11,707,4
2021-06-10,Riverside,065,2383286,294873,289335,14135,303470,4450
2021-06-10,Sacramento,067,1510023,107282,107049,1800,108849,1658
2021-06-10,San Benito,069,59416,6085,6079,116,6195,63
2021-06-10,San Bernardino,071,2135413,294011,293281,9031,302312,4782
2021-06-10,San Diego,073,3302833,281914,281052,15138,296190,3766
2021-06-10,San Francisco,075,870044,36948,37159,1303,38462,552
2021-06-10,San Joaquin,077,732212,73676,73276,3625,76901,1393
2021-06-10,San Luis Obispo,079,281455,21487,21280,753,22033,256
2021-06-10,San Mateo,081,765935,42590,42562,479,43041,666
2021-06-10,Santa Barbara,083,443738,34532,34434,1144,35578,460
2021-06-10,Santa Clara,085,1922200,119077,119832,777,120609,2075
2021-06-10,Santa Cruz,087,273765,16265,16159,815,16974,208
2021-06-10,Shasta,089,179085,12496,12536,1618,14154,201
2021-06-10,Sierra,091,2930,58,55,12,67,0
2021-06-10,Siskiyou,093,43540,1958,1881,375,2256,25
2021-06-10,Solano,095,438530,33176,33150,562,33712,265
2021-06-10,Sonoma,097,501317,30502,30571,355,30926,323
2021-06-10,Stanislaus,099,539301,56735,56588,6001,62589,974
2021-06-10,Sutter,101,95872,9557,9594,89,9683,112
2021-06-10,Tehama,103,63373,5132,5096,592,5688,63
2021-06-10,Trinity,105,12862,487,331,97,428,3
2021-06-10,Tulare,107,460477,50367,49503,9131,58634,848
2021-06-10,Tuolumne,109,53932,4038,4100,40,4140,63
2021-06-10,Ventura,111,848112,81599,81172,3018,84190,1026
2021-06-10,Yolo,113,214977,14077,14107,332,14439,212
2021-06-10,Yuba,115,75493,6132,6112,133,6245,50
2021-06-09,Alameda,001,1643700,88773,88762,1988,90750,1271
2021-06-09,Alpine,003,1148,87,88,0,88,0
2021-06-09,Amador,005,37829,3724,3706,33,3739,46
2021-06-09,Butte,007,227075,12690,12555,1845,14400,194
2021-06-09,Calaveras,009,45235,2187,2184,14,2198,55
2021-06-09,Colusa,011,21464,1958,1962,317,2279,15
2021-06-09,Contra Costa,013,1133247,70333,69829,1308,71137,803
2021-06-09,Del Norte,015,27424,1436,1403,13,1416,8
2021-06-09,El Dorado,017,186661,10369,10312,742,11054,113
2021-06-09,Fresno,019,978130,103132,102690,8772,111462,1717
2021-06-09,Glenn,021,27897,2441,2424,567,2991,19
2021-06-09,Humboldt,023,135768,4385,4379,38,4417,42
2021-06-09,Imperial,025,180216,28709,28754,2780,31534,739
2021-06-09,Inyo,027,18085,1406,1405,12,1417,35
2021-06-09,Kern,029,883053,97653,96697,11057,107754,1328
2021-06-09,Kings,031,150075,23223,23061,1097,24158,245
2021-06-09,Lake,033,64148,3557,3541,9,3550,45
2021-06-09,Lassen,035,31185,5248,5200,116,5316,18
2021-06-09,Los Angeles,037,10098052,1208104,1203955,41953,1245908,24432
2021-06-09,Madera,039,155013,16702,16580,944,17524,240
2021-06-09,Marin,041,260295,14155,14114,267,14381,229
2021-06-09,Mariposa,043,17540,436,434,11,445,5
2021-06-09,Mendocino,045,87422,4094,4008,82,4090,47
2021-06-09,Merced,047,269075,31143,31225,1062,32287,461
2021-06-09,Modoc,049,8938,396,377,140,517,3
2021-06-09,Mono,051,14174,1263,1274,17,1291,3
2021-06-09,Monterey,053,433212,43252,43082,1882,44964,415
2021-06-09,Napa,055,140530,9967,9971,38,10009,80
2021-06-09,Nevada,057,99092,4895,4863,194,5057,72
2021-06-09,Orange,059,3164182,255897,254893,11463,266356,5080
2021-06-09,Placer,061,380077,23558,23237,1531,24768,293
2021-06-09,Plumas,063,18699,712,697,11,708,4
2021-06-09,Riverside,065,2383286,294827,289299,14133,303432,4450
2021-06-09,Sacramento,067,1510023,107220,106971,1797,108768,1657
2021-06-09,San Benito,069,59416,6081,6078,116,6194,63
2021-06-09,San Bernardino,071,2135413,293969,293222,9031,302253,4782
2021-06-09,San Diego,073,3302833,281850,280941,15126,296067,3765
2021-06-09,San Francisco,075,870044,36935,37143,1302,38445,552
2021-06-09,San Joaquin,077,732212,73650,73232,3624,76856,1392
2021-06-09,San Luis Obispo,079,281455,21486,21259,753,22012,256
2021-06-09,San Mateo,081,765935,42574,42502,477,42979,666
2021-06-09,Santa Barbara,083,443738,34521,34422,1144,35566,460
2021-06-09,Santa Clara,085,1922200,119039,119793,776,120569,2068
2021-06-09,Santa Cruz,087,273765,16262,16155,815,16970,208
2021-06-09,Shasta,089,179085,12486,12521,1616,14137,201
2021-06-09,Sierra,091,2930,57,55,12,67,0
2021-06-09,Siskiyou,093,43540,1957,1871,375,2246,25
2021-06-09,Solano,095,438530,33160,33137,561,33698,264
2021-06-09,Sonoma,097,501317,30480,30540,355,30895,323
2021-06-09,Stanislaus,099,539301,56715,56560,5998,62558,974
2021-06-09,Sutter,101,95872,9548,9586,88,9674,111
2021-06-09,Tehama,103,63373,5131,5093,592,5685,63
2021-06-09,Trinity,105,12862,486,331,97,428,3
2021-06-09,Tulare,107,460477,50363,49496,9129,58625,847
2021-06-09,Tuolumne,109,53932,4035,4100,40,4140,63
2021-06-09,Ventura,111,848112,81589,81154,3017,84171,1026
2021-06-09,Yolo,113,214977,14075,14102,331,14433,212
2021-06-09,Yuba,115,75493,6128,6109,133,6242,50
2021-06-08,Alameda,001,1643700,88725,88731,1988,90719,1267
2021-06-08,Alpine,003,1148,87,88,0,88,0
2021-06-08,Amador,005,37829,3723,3704,33,3737,46
2021-06-08,Butte,007,227075,12684,12540,1843,14383,194
2021-06-08,Calaveras,009,45235,2186,2181,14,2195,55
2021-06-08,Colusa,011,21464,1958,1961,317,2278,15
2021-06-08,Contra Costa,013,1133247,70285,69762,1307,71069,803
2021-06-08,Del Norte,015,27424,1434,1402,13,1415,8
2021-06-08,El Dorado,017,186661,10364,10306,740,11046,113
2021-06-08,Fresno,019,978130,103107,102680,8770,111450,1717
2021-06-08,Glenn,021,27897,2440,2423,567,2990,19
2021-06-08,Humboldt,023,135768,4380,4363,38,4401,42
2021-06-08,Imperial,025,180216,28700,28752,2780,31532,738
2021-06-08,Inyo,027,18085,1406,1405,12,1417,35
2021-06-08,Kern,029,883053,97634,96671,11050,107721,1325
2021-06-08,Kings,031,150075,23222,23036,1097,24133,245
2021-06-08,Lake,033,64148,3556,3540,9,3549,45
2021-06-08,Lassen,035,31185,5248,5200,116,5316,18
2021-06-08,Los Angeles,037,10098052,1207907,1203794,41941,1245735,24426
2021-06-08,Madera,039,155013,16696,16579,943,17522,240
2021-06-08,Marin,041,260295,14153,14111,266,14377,229
2021-06-08,Mariposa,043,17540,436,434,11,445,5
2021-06-08,Mendocino,045,87422,4087,4002,82,4084,47
2021-06-08,Merced,047,269075,31135,31225,1062,32287,461
2021-06-08,Modoc,049,8938,390,377,139,516,3
2021-06-08,Mono,051,14174,1263,1274,17,1291,3
2021-06-08,Monterey,053,433212,43246,43078,1881,44959,415
2021-06-08,Napa,055,140530,9963,9962,38,10000,80
2021-06-08,Nevada,057,99092,4890,4861,194,5055,72
2021-06-08,Orange,059,3164182,255855,254852,11456,266308,5078
2021-06-08,Placer,061,380077,23540,23209,1527,24736,293
2021-06-08,Plumas,063,18699,712,692,11,703,4
2021-06-08,Riverside,065,2383286,294791,289268,14125,303393,4452
2021-06-08,Sacramento,067,1510023,107158,106901,1794,108695,1654
2021-06-08,San Benito,069,59416,6079,6076,116,6192,63
2021-06-08,San Bernardino,071,2135413,293920,293186,9027,302213,4778
2021-06-08,San Diego,073,3302833,281787,280879,15117,295996,3764
2021-06-08,San Francisco,075,870044,36920,37134,1301,38435,552
2021-06-08,San Joaquin,077,732212,73606,73186,3619,76805,1390
2021-06-08,San Luis Obispo,079,281455,21480,21251,752,22003,255
2021-06-08,San Mateo,081,765935,42561,42488,477,42965,663
2021-06-08,Santa Barbara,083,443738,34517,34418,1144,35562,459
2021-06-08,Santa Clara,085,1922200,119018,119770,775,120545,2068
2021-06-08,Santa Cruz,087,273765,16259,16160,815,16975,208
2021-06-08,Shasta,089,179085,12471,12498,1616,14114,201
2021-06-08,Sierra,091,2930,57,55,12,67,0
2021-06-08,Siskiyou,093,43540,1955,1870,373,2243,21
2021-06-08,Solano,095,438530,33139,33130,561,33691,259
2021-06-08,Sonoma,097,501317,30453,30523,353,30876,323
2021-06-08,Stanislaus,099,539301,56688,56548,5996,62544,973
2021-06-08,Sutter,101,95872,9545,9581,88,9669,111
2021-06-08,Tehama,103,63373,5128,5093,592,5685,63
2021-06-08,Trinity,105,12862,486,330,96,426,3
2021-06-08,Tulare,107,460477,50351,49485,9124,58609,847
2021-06-08,Tuolumne,109,53932,4032,4099,40,4139,63
2021-06-08,Ventura,111,848112,81573,81142,3016,84158,1026
2021-06-08,Yolo,113,214977,14070,14099,330,14429,212
2021-06-08,Yuba,115,75493,6126,6103,133,6236,50
2021-06-07,Alameda,001,1643700,88668,88688,1988,90676,1267
2021-06-07,Alpine,003,1148,87,88,0,88,0
2021-06-07,Amador,005,37829,3713,3697,33,3730,46
2021-06-07,Butte,007,227075,12677,12533,1842,14375,194
2021-06-07,Calaveras,009,45235,2185,2181,14,2195,55
2021-06-07,Colusa,011,21464,1957,1960,317,2277,15
2021-06-07,Contra Costa,013,1133247,70228,69718,1306,71024,817
2021-06-07,Del Norte,015,27424,1434,1401,13,1414,8
2021-06-07,El Dorado,017,186661,10359,10305,740,11045,113
2021-06-07,Fresno,019,978130,103076,102659,8762,111421,1717
2021-06-07,Glenn,021,27897,2440,2423,567,2990,19
2021-06-07,Humboldt,023,135768,4372,4354,38,4392,42
2021-06-07,Imperial,025,180216,28698,28754,2780,31534,738
2021-06-07,Inyo,027,18085,1406,1404,12,1416,35
2021-06-07,Kern,029,883053,97618,96645,11043,107688,1324
2021-06-07,Kings,031,150075,23218,23023,1097,24120,244
2021-06-07,Lake,033,64148,3554,3540,9,3549,45
2021-06-07,Lassen,035,31185,5243,5198,116,5314,18
2021-06-07,Los Angeles,037,10098052,1207683,1203664,41926,1245590,24413
2021-06-07,Madera,039,155013,16689,16572,943,17515,240
2021-06-07,Marin,041,260295,14149,14108,265,14373,229
2021-06-07,Mariposa,043,17540,436,434,11,445,5
2021-06-07,Mendocino,045,87422,4081,3998,82,4080,47
2021-06-07,Merced,047,269075,31123,31212,1061,32273,459
2021-06-07,Modoc,049,8938,389,375,136,511,3
2021-06-07,Mono,051,14174,1263,1275,17,1292,3
2021-06-07,Monterey,053,433212,43239,43077,1881,44958,415
2021-06-07,Napa,055,140530,9955,9962,38,10000,80
2021-06-07,Nevada,057,99092,4888,4860,194,5054,72
2021-06-07,Orange,059,3164182,255815,254808,11449,266257,5073
2021-06-07,Placer,061,380077,23521,23176,1525,24701,293
2021-06-07,Plumas,063,18699,712,692,11,703,4
2021-06-07,Riverside,065,2383286,294748,289232,14121,303353,4451
2021-06-07,Sacramento,067,1510023,107082,106841,1791,108632,1655
2021-06-07,San Benito,069,59416,6078,6074,116,6190,63
2021-06-07,San Bernardino,071,2135413,293882,293129,9026,302155,4775
2021-06-07,San Diego,073,3302833,281705,280808,15104,295912,3764
2021-06-07,San Francisco,075,870044,36904,37122,1301,38423,552
2021-06-07,San Joaquin,077,732212,73561,73130,3612,76742,1388
2021-06-07,San Luis Obispo,079,281455,21467,21252,752,22004,255
2021-06-07,San Mateo,081,765935,42545,42479,477,42956,664
2021-06-07,Santa Barbara,083,443738,34511,34407,1144,35551,459
2021-06-07,Santa Clara,085,1922200,118986,119743,775,120518,2066
2021-06-07,Santa Cruz,087,273765,16258,16159,815,16974,208
2021-06-07,Shasta,089,179085,12457,12483,1611,14094,200
2021-06-07,Sierra,091,2930,57,55,12,67,0
2021-06-07,Siskiyou,093,43540,1955,1869,373,2242,21
2021-06-07,Solano,095,438530,33117,33124,560,33684,258
2021-06-07,Sonoma,097,501317,30417,30504,352,30856,323
2021-06-07,Stanislaus,099,539301,56655,56521,5994,62515,972
2021-06-07,Sutter,101,95872,9541,9571,88,9659,111
2021-06-07,Tehama,103,63373,5124,5092,590,5682,63
2021-06-07,Trinity,105,12862,486,329,96,425,3
2021-06-07,Tulare,107,460477,50345,49471,9124,58595,847
2021-06-07,Tuolumne,109,53932,4031,4098,40,4138,63
2021-06-07,Ventura,111,848112,81556,81137,3015,84152,1025
2021-06-07,Yolo,113,214977,14065,14097,329,14426,211
2021-06-07,Yuba,115,75493,6124,6099,130,6229,49
2021-06-06,Alameda,001,1643700,88630,88636,1987,90623,1267
2021-06-06,Alpine,003,1148,87,88,0,88,0
2021-06-06,Amador,005,37829,3710,3696,33,3729,46
2021-06-06,Butte,007,227075,12666,12527,1841,14368,194
2021-06-06,Calaveras,009,45235,2184,2181,14,2195,55
2021-06-06,Colusa,011,21464,1955,1959,317,2276,15
2021-06-06,Contra Costa,013,1133247,70163,69659,1304,70963,817
2021-06-06,Del Norte,015,27424,1429,1401,13,1414,8
2021-06-06,El Dorado,017,186661,10352,10294,740,11034,113
2021-06-06,Fresno,019,978130,103043,102642,8759,111401,1717
2021-06-06,Glenn,021,27897,2439,2423,567,2990,19
2021-06-06,Humboldt,023,135768,4361,4353,38,4391,42
2021-06-06,Imperial,025,180216,28692,28762,2780,31542,738
2021-06-06,Inyo,027,18085,1405,1404,12,1416,35
2021-06-06,Kern,029,883053,97600,96623,11036,107659,1324
2021-06-06,Kings,031,150075,23212,23021,1097,24118,244
2021-06-06,Lake,033,64148,3554,3535,9,3544,45
2021-06-06,Lassen,035,31185,5241,5191,116,5307,18
2021-06-06,Los Angeles,037,10098052,1207483,1203539,41911,1245450,24410
2021-06-06,Madera,039,155013,16682,16567,943,17510,240
2021-06-06,Marin,041,260295,14143,14106,264,14370,229
2021-06-06,Mariposa,043,17540,435,435,11,446,5
2021-06-06,Mendocino,045,87422,4077,3993,82,4075,47
2021-06-06,Merced,047,269075,31117,31215,1060,32275,459
2021-06-06,Modoc,049,8938,389,375,135,510,3
2021-06-06,Mono,051,14174,1263,1275,17,1292,3
2021-06-06,Monterey,053,433212,43234,43078,1881,44959,415
2021-06-06,Napa,055,140530,9949,9963,38,10001,80
2021-06-06,Nevada,057,99092,4881,4854,193,5047,72
2021-06-06,Orange,059,3164182,255779,254782,11444,266226,5073
2021-06-06,Placer,061,380077,23496,23156,1522,24678,293
2021-06-06,Plumas,063,18699,712,692,11,703,4
2021-06-06,Riverside,065,2383286,294709,289201,14115,303316,4451
2021-06-06,Sacramento,067,1510023,106996,106749,1790,108539,1655
2021-06-06,San Benito,069,59416,6072,6074,116,6190,63
2021-06-06,San Bernardino,071,2135413,293826,293117,9017,302134,4773
2021-06-06,San Diego,073,3302833,281625,280743,15087,295830,3764
2021-06-06,San Francisco,075,870044,36891,37118,1299,38417,552
2021-06-06,San Joaquin,077,732212,73529,73105,3608,76713,1388
2021-06-06,San Luis Obispo,079,281455,21464,21246,752,21998,255
2021-06-06,San Mateo,081,765935,42528,42457,477,42934,664
2021-06-06,Santa Barbara,083,443738,34507,34403,1143,35546,459
2021-06-06,Santa Clara,085,1922200,118964,119711,775,120486,2066
2021-06-06,Santa Cruz,087,273765,16257,16158,815,16973,208
2021-06-06,Shasta,089,179085,12442,12478,1608,14086,200
2021-06-06,Sierra,091,2930,57,55,12,67,0
2021-06-06,Siskiyou,093,43540,1952,1869,373,2242,21
2021-06-06,Solano,095,438530,33090,33093,560,33653,258
2021-06-06,Sonoma,097,501317,30386,30478,351,30829,323
2021-06-06,Stanislaus,099,539301,56619,56486,5991,62477,972
2021-06-06,Sutter,101,95872,9534,9567,88,9655,111
2021-06-06,Tehama,103,63373,5114,5092,588,5680,63
2021-06-06,Trinity,105,12862,486,328,96,424,3
2021-06-06,Tulare,107,460477,50337,49466,9119,58585,847
2021-06-06,Tuolumne,109,53932,4029,4097,40,4137,63
2021-06-06,Ventura,111,848112,81545,81130,3012,84142,1025
2021-06-06,Yolo,113,214977,14057,14089,328,14417,210
2021-06-06,Yuba,115,75493,6116,6096,130,6226,49
2021-06-05,Alameda,001,1643700,88597,88612,1987,90599,1268
2021-06-05,Alpine,003,1148,87,88,0,88,0
2021-06-05,Amador,005,37829,3710,3694,33,3727,46
2021-06-05,Butte,007,227075,12660,12514,1840,14354,194
2021-06-05,Calaveras,009,45235,2184,2181,14,2195,55
2021-06-05,Colusa,011,21464,1955,1959,317,2276,15
2021-06-05,Contra Costa,013,1133247,70134,69601,1304,70905,817
2021-06-05,Del Norte,015,27424,1429,1400,13,1413,8
2021-06-05,El Dorado,017,186661,10350,10288,739,11027,113
2021-06-05,Fresno,019,978130,103034,102626,8759,111385,1717
2021-06-05,Glenn,021,27897,2438,2423,567,2990,19
2021-06-05,Humboldt,023,135768,4356,4346,38,4384,42
2021-06-05,Imperial,025,180216,28689,28764,2780,31544,738
2021-06-05,Inyo,027,18085,1405,1405,12,1417,35
2021-06-05,Kern,029,883053,97587,96597,11032,107629,1324
2021-06-05,Kings,031,150075,23209,23017,1097,24114,244
2021-06-05,Lake,033,64148,3551,3534,9,3543,45
2021-06-05,Lassen,035,31185,5240,5191,116,5307,18
2021-06-05,Los Angeles,037,10098052,1207356,1203338,41900,1245238,24411
2021-06-05,Madera,039,155013,16678,16563,943,17506,240
2021-06-05,Marin,041,260295,14141,14101,264,14365,229
2021-06-05,Mariposa,043,17540,435,435,11,446,5
2021-06-05,Mendocino,045,87422,4074,3989,82,4071,47
2021-06-05,Merced,047,269075,31115,31212,1059,32271,459
2021-06-05,Modoc,049,8938,389,375,134,509,3
2021-06-05,Mono,051,14174,1263,1274,17,1291,3
2021-06-05,Monterey,053,433212,43230,43071,1880,44951,415
2021-06-05,Napa,055,140530,9944,9960,38,9998,80
2021-06-05,Nevada,057,99092,4879,4849,193,5042,72
2021-06-05,Orange,059,3164182,255755,254752,11441,266193,5069
2021-06-05,Placer,061,380077,23480,23133,1522,24655,293
2021-06-05,Plumas,063,18699,712,692,11,703,4
2021-06-05,Riverside,065,2383286,294674,289157,14111,303268,4451
2021-06-05,Sacramento,067,1510023,106944,106688,1788,108476,1655
2021-06-05,San Benito,069,59416,6070,6074,116,6190,63
2021-06-05,San Bernardino,071,2135413,293793,293081,9015,302096,4772
2021-06-05,San Diego,073,3302833,281584,280676,15074,295750,3764
2021-06-05,San Francisco,075,870044,36882,37111,1299,38410,552
2021-06-05,San Joaquin,077,732212,73513,73078,3602,76680,1388
2021-06-05,San Luis Obispo,079,281455,21461,21236,752,21988,255
2021-06-05,San Mateo,081,765935,42518,42433,477,42910,664
2021-06-05,Santa Barbara,083,443738,34504,34399,1142,35541,459
2021-06-05,Santa Clara,085,1922200,118942,119676,773,120449,2066
2021-06-05,Santa Cruz,087,273765,16257,16154,815,16969,208
2021-06-05,Shasta,089,179085,12432,12472,1607,14079,200
2021-06-05,Sierra,091,2930,57,55,12,67,0
2021-06-05,Siskiyou,093,43540,1952,1867,373,2240,21
2021-06-05,Solano,095,438530,33075,33074,560,33634,257
2021-06-05,Sonoma,097,501317,30359,30450,349,30799,323
2021-06-05,Stanislaus,099,539301,56611,56463,5989,62452,973
2021-06-05,Sutter,101,95872,9531,9559,88,9647,111
2021-06-05,Tehama,103,63373,5113,5092,587,5679,63
2021-06-05,Trinity,105,12862,486,328,96,424,3
2021-06-05,Tulare,107,460477,50331,49463,9119,58582,847
2021-06-05,Tuolumne,109,53932,4027,4098,40,4138,63
2021-06-05,Ventura,111,848112,81536,81119,3010,84129,1025
2021-06-05,Yolo,113,214977,14055,14088,328,14416,210
2021-06-05,Yuba,115,75493,6115,6087,130,6217,49
2021-06-04,Alameda,001,1643700,88570,88585,1984,90569,1263
2021-06-04,Alpine,003,1148,87,88,0,88,0
2021-06-04,Amador,005,37829,3710,3690,33,3723,46
2021-06-04,Butte,007,227075,12649,12494,1837,14331,193
2021-06-04,Calaveras,009,45235,2184,2179,14,2193,55
2021-06-04,Colusa,011,21464,1955,1959,317,2276,15
2021-06-04,Contra Costa,013,1133247,70099,69540,1301,70841,816
2021-06-04,Del Norte,015,27424,1429,1398,13,1411,8
2021-06-04,El Dorado,017,186661,10346,10284,737,11021,112
2021-06-04,Fresno,019,978130,103018,102601,8759,111360,1712
2021-06-04,Glenn,021,27897,2438,2423,566,2989,19
2021-06-04,Humboldt,023,135768,4351,4327,38,4365,42
2021-06-04,Imperial,025,180216,28685,28753,2780,31533,738
2021-06-04,Inyo,027,18085,1405,1404,12,1416,35
2021-06-04,Kern,029,883053,97569,96573,11030,107603,1327
2021-06-04,Kings,031,150075,23208,23002,1097,24099,244
2021-06-04,Lake,033,64148,3549,3528,9,3537,45
2021-06-04,Lassen,035,31185,5240,5180,116,5296,18
2021-06-04,Los Angeles,037,10098052,1207232,1203106,41891,1244997,24400
2021-06-04,Madera,039,155013,16676,16557,943,17500,240
2021-06-04,Marin,041,260295,14140,14099,263,14362,229
2021-06-04,Mariposa,043,17540,435,435,11,446,5
2021-06-04,Mendocino,045,87422,4065,3983,82,4065,47
2021-06-04,Merced,047,269075,31110,31204,1058,32262,459
2021-06-04,Modoc,049,8938,387,375,134,509,3
2021-06-04,Mono,051,14174,1263,1275,17,1292,3
2021-06-04,Monterey,053,433212,43226,43068,1880,44948,415
2021-06-04,Napa,055,140530,9940,9958,38,9996,80
2021-06-04,Nevada,057,99092,4875,4844,193,5037,72
2021-06-04,Orange,059,3164182,255718,254730,11438,266168,5059
2021-06-04,Placer,061,380077,23464,23110,1521,24631,293
2021-06-04,Plumas,063,18699,712,691,11,702,4
2021-06-04,Riverside,065,2383286,294648,289098,14107,303205,4452
2021-06-04,Sacramento,067,1510023,106890,106616,1787,108403,1654
2021-06-04,San Benito,069,59416,6068,6073,116,6189,63
2021-06-04,San Bernardino,071,2135413,293770,293056,9013,302069,4768
2021-06-04,San Diego,073,3302833,281541,280556,15067,295623,3763
2021-06-04,San Francisco,075,870044,36877,37079,1298,38377,551
2021-06-04,San Joaquin,077,732212,73494,73039,3600,76639,1388
2021-06-04,San Luis Obispo,079,281455,21458,21234,751,21985,255
2021-06-04,San Mateo,081,765935,42506,42413,477,42890,478
2021-06-04,Santa Barbara,083,443738,34498,34402,1141,35543,459
2021-06-04,Santa Clara,085,1922200,118912,119619,773,120392,2065
2021-06-04,Santa Cruz,087,273765,16254,16150,815,16965,207
2021-06-04,Shasta,089,179085,12426,12458,1602,14060,200
2021-06-04,Sierra,091,2930,57,55,12,67,0
2021-06-04,Siskiyou,093,43540,1951,1865,373,2238,21
2021-06-04,Solano,095,438530,33064,33058,560,33618,256
2021-06-04,Sonoma,097,501317,30338,30411,349,30760,323
2021-06-04,Stanislaus,099,539301,56596,56442,5987,62429,973
2021-06-04,Sutter,101,95872,9526,9554,88,9642,111
2021-06-04,Tehama,103,63373,5108,5090,587,5677,63
2021-06-04,Trinity,105,12862,486,328,96,424,3
2021-06-04,Tulare,107,460477,50322,49452,9117,58569,847
2021-06-04,Tuolumne,109,53932,4026,4095,40,4135,63
2021-06-04,Ventura,111,848112,81529,81104,3008,84112,1023
2021-06-04,Yolo,113,214977,14053,14083,328,14411,210
2021-06-04,Yuba,115,75493,6112,6084,130,6214,49
2021-06-03,Alameda,001,1643700,88532,88555,1981,90536,1257
2021-06-03,Alpine,003,1148,87,88,0,88,0
2021-06-03,Amador,005,37829,3702,3688,33,3721,46
2021-06-03,Butte,007,227075,12645,12478,1836,14314,193
2021-06-03,Calaveras,009,45235,2184,2179,14,2193,55
2021-06-03,Colusa,011,21464,1955,1957,317,2274,15
2021-06-03,Contra Costa,013,1133247,70045,69500,1296,70796,816
2021-06-03,Del Norte,015,27424,1427,1397,13,1410,8
2021-06-03,El Dorado,017,186661,10340,10284,734,11018,112
2021-06-03,Fresno,019,978130,103001,102566,8759,111325,1709
2021-06-03,Glenn,021,27897,2438,2421,566,2987,19
2021-06-03,Humboldt,023,135768,4343,4314,38,4352,42
2021-06-03,Imperial,025,180216,28673,28737,2780,31517,738
2021-06-03,Inyo,027,18085,1405,1404,12,1416,35
2021-06-03,Kern,029,883053,97542,96507,11016,107523,1326
2021-06-03,Kings,031,150075,23204,22982,1097,24079,244
2021-06-03,Lake,033,64148,3547,3526,9,3535,45
2021-06-03,Lassen,035,31185,5231,5177,116,5293,12
2021-06-03,Los Angeles,037,10098052,1207057,1202923,41883,1244806,24386
2021-06-03,Madera,039,155013,16669,16554,943,17497,240
2021-06-03,Marin,041,260295,14135,14095,263,14358,230
2021-06-03,Mariposa,043,17540,435,435,11,446,5
2021-06-03,Mendocino,045,87422,4058,3978,82,4060,47
2021-06-03,Merced,047,269075,31107,31199,1058,32257,459
2021-06-03,Modoc,049,8938,386,376,133,509,3
2021-06-03,Mono,051,14174,1263,1275,17,1292,3
2021-06-03,Monterey,053,433212,43223,43063,1880,44943,415
2021-06-03,Napa,055,140530,9933,9957,38,9995,81
2021-06-03,Nevada,057,99092,4871,4837,193,5030,72
2021-06-03,Orange,059,3164182,255690,254676,11428,266104,5056
2021-06-03,Placer,061,380077,23455,23100,1520,24620,293
2021-06-03,Plumas,063,18699,712,691,11,702,4
2021-06-03,Riverside,065,2383286,294593,289035,14103,303138,4447
2021-06-03,Sacramento,067,1510023,106812,106526,1785,108311,1654
2021-06-03,San Benito,069,59416,6068,6073,116,6189,63
2021-06-03,San Bernardino,071,2135413,293738,293021,9013,302034,4762
2021-06-03,San Diego,073,3302833,281477,280430,15057,295487,3761
2021-06-03,San Francisco,075,870044,36871,37072,1298,38370,551
2021-06-03,San Joaquin,077,732212,73466,72989,3596,76585,1388
2021-06-03,San Luis Obispo,079,281455,21453,21224,751,21975,255
2021-06-03,San Mateo,081,765935,42493,42396,477,42873,467
2021-06-03,Santa Barbara,083,443738,34495,34391,1141,35532,459
2021-06-03,Santa Clara,085,1922200,118890,119592,771,120363,2058
2021-06-03,Santa Cruz,087,273765,16252,16144,815,16959,207
2021-06-03,Shasta,089,179085,12411,12441,1599,14040,199
2021-06-03,Sierra,091,2930,57,55,12,67,0
2021-06-03,Siskiyou,093,43540,1951,1862,372,2234,21
2021-06-03,Solano,095,438530,33050,33019,560,33579,256
2021-06-03,Sonoma,097,501317,30316,30383,348,30731,322
2021-06-03,Stanislaus,099,539301,56578,56401,5981,62382,973
2021-06-03,Sutter,101,95872,9517,9539,88,9627,111
2021-06-03,Tehama,103,63373,5108,5087,587,5674,63
2021-06-03,Trinity,105,12862,486,328,96,424,3
2021-06-03,Tulare,107,460477,50319,49442,9113,58555,848
2021-06-03,Tuolumne,109,53932,4024,4095,40,4135,63
2021-06-03,Ventura,111,848112,81517,81078,3006,84084,1023
2021-06-03,Yolo,113,214977,14049,14078,325,14403,210
2021-06-03,Yuba,115,75493,6105,6077,130,6207,49
2021-06-02,Alameda,001,1643700,88487,88525,1979,90504,1254
2021-06-02,Alpine,003,1148,87,88,0,88,0
2021-06-02,Amador,005,37829,3700,3687,33,3720,46
2021-06-02,Butte,007,227075,12625,12432,1833,14265,193
2021-06-02,Calaveras,009,45235,2181,2174,14,2188,55
2021-06-02,Colusa,011,21464,1954,1957,317,2274,15
2021-06-02,Contra Costa,013,1133247,69994,69455,1294,70749,814
2021-06-02,Del Norte,015,27424,1425,1395,13,1408,8
2021-06-02,El Dorado,017,186661,10336,10275,734,11009,110
2021-06-02,Fresno,019,978130,102977,102547,8756,111303,1707
2021-06-02,Glenn,021,27897,2438,2421,566,2987,19
2021-06-02,Humboldt,023,135768,4328,4302,38,4340,42
2021-06-02,Imperial,025,180216,28667,28737,2779,31516,738
2021-06-02,Inyo,027,18085,1404,1403,12,1415,35
2021-06-02,Kern,029,883053,97515,96481,11009,107490,1326
2021-06-02,Kings,031,150075,23202,22981,1097,24078,244
2021-06-02,Lake,033,64148,3542,3522,9,3531,45
2021-06-02,Lassen,035,31185,5230,5177,116,5293,6
2021-06-02,Los Angeles,037,10098052,1206853,1202760,41874,1244634,24375
2021-06-02,Madera,039,155013,16661,16550,943,17493,240
2021-06-02,Marin,041,260295,14133,14091,262,14353,229
2021-06-02,Mariposa,043,17540,435,434,11,445,5
2021-06-02,Mendocino,045,87422,4052,3970,82,4052,47
2021-06-02,Merced,047,269075,31094,31195,1057,32252,458
2021-06-02,Modoc,049,8938,385,375,132,507,3
2021-06-02,Mono,051,14174,1263,1275,17,1292,3
2021-06-02,Monterey,053,433212,43221,43056,1880,44936,380
2021-06-02,Napa,055,140530,9932,9953,38,9991,82
2021-06-02,Nevada,057,99092,4868,4833,193,5026,72
2021-06-02,Orange,059,3164182,255641,254637,11421,266058,5055
2021-06-02,Placer,061,380077,23434,23058,1518,24576,293
2021-06-02,Plumas,063,18699,712,690,11,701,4
2021-06-02,Riverside,065,2383286,294535,289012,14093,303105,4445
2021-06-02,Sacramento,067,1510023,106747,106435,1779,108214,1649
2021-06-02,San Benito,069,59416,6067,6073,116,6189,63
2021-06-02,San Bernardino,071,2135413,293690,293004,9008,302012,4760
2021-06-02,San Diego,073,3302833,281397,280347,15036,295383,3760
2021-06-02,San Francisco,075,870044,36851,37050,1297,38347,550
2021-06-02,San Joaquin,077,732212,73435,72893,3593,76486,1387
2021-06-02,San Luis Obispo,079,281455,21446,21214,750,21964,255
2021-06-02,San Mateo,081,765935,42483,42383,476,42859,464
2021-06-02,Santa Barbara,083,443738,34488,34381,1141,35522,456
2021-06-02,Santa Clara,085,1922200,118862,119553,770,120323,2058
2021-06-02,Santa Cruz,087,273765,16249,16144,815,16959,207
2021-06-02,Shasta,089,179085,12393,12426,1594,14020,199
2021-06-02,Sierra,091,2930,57,55,12,67,0
2021-06-02,Siskiyou,093,43540,1951,1861,370,2231,21
2021-06-02,Solano,095,438530,33038,33007,559,33566,256
2021-06-02,Sonoma,097,501317,30297,30359,343,30702,322
2021-06-02,Stanislaus,099,539301,56560,56377,5976,62353,973
2021-06-02,Sutter,101,95872,9514,9533,88,9621,111
2021-06-02,Tehama,103,63373,5105,5081,587,5668,63
2021-06-02,Trinity,105,12862,484,328,96,424,3
2021-06-02,Tulare,107,460477,50310,49434,9109,58543,846
2021-06-02,Tuolumne,109,53932,4023,4095,40,4135,63
2021-06-02,Ventura,111,848112,81492,81033,3006,84039,1020
2021-06-02,Yolo,113,214977,14046,14074,324,14398,210
2021-06-02,Yuba,115,75493,6099,6072,130,6202,48
2021-06-01,Alameda,001,1643700,88452,88472,1977,90449,1253
2021-06-01,Alpine,003,1148,87,88,0,88,0
2021-06-01,Amador,005,37829,3698,3687,33,3720,46
2021-06-01,Butte,007,227075,12611,12427,1832,14259,193
2021-06-01,Calaveras,009,45235,2179,2173,14,2187,55
2021-06-01,Colusa,011,21464,1953,1955,316,2271,15
2021-06-01,Contra Costa,013,1133247,69936,69404,1294,70698,813
2021-06-01,Del Norte,015,27424,1424,1394,13,1407,8
2021-06-01,El Dorado,017,186661,10330,10271,734,11005,110
2021-06-01,Fresno,019,978130,102953,102534,8753,111287,1706
2021-06-01,Glenn,021,27897,2438,2422,566,2988,18
2021-06-01,Humboldt,023,135768,4318,4299,38,4337,42
2021-06-01,Imperial,025,180216,28663,28722,2777,31499,736
2021-06-01,Inyo,027,18085,1404,1403,12,1415,35
2021-06-01,Kern,029,883053,97488,96477,11001,107478,1319
2021-06-01,Kings,031,150075,23198,22977,1097,24074,244
2021-06-01,Lake,033,64148,3541,3523,9,3532,45
2021-06-01,Lassen,035,31185,5223,5172,116,5288,6
2021-06-01,Los Angeles,037,10098052,1206618,1202673,41860,1244533,24367
2021-06-01,Madera,039,155013,16652,16549,942,17491,240
2021-06-01,Marin,041,260295,14131,14081,262,14343,229
2021-06-01,Mariposa,043,17540,435,431,11,442,5
2021-06-01,Mendocino,045,87422,4045,3966,82,4048,47
2021-06-01,Merced,047,269075,31084,31195,1057,32252,456
2021-06-01,Modoc,049,8938,383,375,132,507,3
2021-06-01,Mono,051,14174,1263,1275,17,1292,3
2021-06-01,Monterey,053,433212,43215,43051,1880,44931,379
2021-06-01,Napa,055,140530,9930,9949,38,9987,82
2021-06-01,Nevada,057,99092,4863,4825,193,5018,72
2021-06-01,Orange,059,3164182,255605,254603,11413,266016,5051
2021-06-01,Placer,061,380077,23404,23021,1516,24537,293
2021-06-01,Plumas,063,18699,711,690,11,701,4
2021-06-01,Riverside,065,2383286,294482,288996,14087,303083,4442
2021-06-01,Sacramento,067,1510023,106675,106330,1777,108107,1644
2021-06-01,San Benito,069,59416,6066,6073,115,6188,63
2021-06-01,San Bernardino,071,2135413,293665,292990,9007,301997,4758
2021-06-01,San Diego,073,3302833,281293,280305,15019,295324,3756
2021-06-01,San Francisco,075,870044,36835,37031,1297,38328,550
2021-06-01,San Joaquin,077,732212,73403,72858,3591,76449,1383
2021-06-01,San Luis Obispo,079,281455,21441,21217,750,21967,256
2021-06-01,San Mateo,081,765935,42467,42383,475,42858,462
2021-06-01,Santa Barbara,083,443738,34484,34374,1141,35515,456
2021-06-01,Santa Clara,085,1922200,118834,119528,770,120298,2057
2021-06-01,Santa Cruz,087,273765,16245,16143,814,16957,207
2021-06-01,Shasta,089,179085,12384,12409,1589,13998,199
2021-06-01,Sierra,091,2930,57,55,12,67,0
2021-06-01,Siskiyou,093,43540,1944,1860,369,2229,21
2021-06-01,Solano,095,438530,33013,32974,558,33532,256
2021-06-01,Sonoma,097,501317,30258,30324,342,30666,322
2021-06-01,Stanislaus,099,539301,56544,56348,5974,62322,973
2021-06-01,Sutter,101,95872,9507,9528,88,9616,111
2021-06-01,Tehama,103,63373,5103,5079,587,5666,63
2021-06-01,Trinity,105,12862,483,328,95,423,3
2021-06-01,Tulare,107,460477,50302,49419,9105,58524,845
2021-06-01,Tuolumne,109,53932,4023,4094,40,4134,63
2021-06-01,Ventura,111,848112,81476,81018,3005,84023,1021
2021-06-01,Yolo,113,214977,14040,14067,324,14391,210
2021-06-01,Yuba,115,75493,6095,6067,130,6197,48
2021-05-31,Alameda,001,1643700,88415,88458,1973,90431,1253
2021-05-31,Alpine,003,1148,87,88,0,88,0
2021-05-31,Amador,005,37829,3692,3687,33,3720,46
2021-05-31,Butte,007,227075,12598,12429,1832,14261,193
2021-05-31,Calaveras,009,45235,2178,2171,14,2185,55
2021-05-31,Colusa,011,21464,1953,1956,315,2271,15
2021-05-31,Contra Costa,013,1133247,69899,69390,1292,70682,813
2021-05-31,Del Norte,015,27424,1421,1394,13,1407,8
2021-05-31,El Dorado,017,186661,10324,10271,732,11003,110
2021-05-31,Fresno,019,978130,102916,102507,8753,111260,1706
2021-05-31,Glenn,021,27897,2437,2422,565,2987,18
2021-05-31,Humboldt,023,135768,4306,4295,38,4333,42
2021-05-31,Imperial,025,180216,28657,28732,2774,31506,736
2021-05-31,Inyo,027,18085,1403,1403,12,1415,35
2021-05-31,Kern,029,883053,97452,96457,10992,107449,1319
2021-05-31,Kings,031,150075,23194,22977,1097,24074,244
2021-05-31,Lake,033,64148,3536,3523,9,3532,45
2021-05-31,Lassen,035,31185,5221,5172,115,5287,6
2021-05-31,Los Angeles,037,10098052,1206376,1202567,41852,1244419,24364
2021-05-31,Madera,039,155013,16651,16543,941,17484,240
2021-05-31,Marin,041,260295,14129,14080,262,14342,229
2021-05-31,Mariposa,043,17540,435,430,11,441,5
2021-05-31,Mendocino,045,87422,4035,3961,82,4043,47
2021-05-31,Merced,047,269075,31079,31194,1057,32251,456
2021-05-31,Modoc,049,8938,382,374,132,506,3
2021-05-31,Mono,051,14174,1263,1275,17,1292,3
2021-05-31,Monterey,053,433212,43211,43051,1880,44931,379
2021-05-31,Napa,055,140530,9923,9948,38,9986,82
2021-05-31,Nevada,057,99092,4853,4823,192,5015,72
2021-05-31,Orange,059,3164182,255577,254572,11405,265977,5051
2021-05-31,Placer,061,380077,23377,23019,1512,24531,293
2021-05-31,Plumas,063,18699,710,690,11,701,4
2021-05-31,Riverside,065,2383286,294425,288970,14075,303045,4442
2021-05-31,Sacramento,067,1510023,106578,106278,1771,108049,1644
2021-05-31,San Benito,069,59416,6066,6072,115,6187,63
2021-05-31,San Bernardino,071,2135413,293617,292973,9006,301979,4758
2021-05-31,San Diego,073,3302833,281189,280254,15007,295261,3756
2021-05-31,San Francisco,075,870044,36820,37022,1296,38318,550
2021-05-31,San Joaquin,077,732212,73354,72856,3585,76441,1383
2021-05-31,San Luis Obispo,079,281455,21433,21215,750,21965,256
2021-05-31,San Mateo,081,765935,42451,42389,475,42864,442
2021-05-31,Santa Barbara,083,443738,34471,34369,1139,35508,456
2021-05-31,Santa Clara,085,1922200,118790,119515,770,120285,2057
2021-05-31,Santa Cruz,087,273765,16242,16139,814,16953,207
2021-05-31,Shasta,089,179085,12368,12408,1586,13994,199
2021-05-31,Sierra,091,2930,57,55,12,67,0
2021-05-31,Siskiyou,093,43540,1943,1856,368,2224,21
2021-05-31,Solano,095,438530,32963,32973,558,33531,256
2021-05-31,Sonoma,097,501317,30215,30314,342,30656,322
2021-05-31,Stanislaus,099,539301,56503,56335,5971,62306,973
2021-05-31,Sutter,101,95872,9488,9523,88,9611,111
2021-05-31,Tehama,103,63373,5100,5076,586,5662,63
2021-05-31,Trinity,105,12862,483,328,95,423,3
2021-05-31,Tulare,107,460477,50291,49404,9100,58504,845
2021-05-31,Tuolumne,109,53932,4021,4095,40,4135,63
2021-05-31,Ventura,111,848112,81461,81017,3002,84019,1021
2021-05-31,Yolo,113,214977,14036,14064,324,14388,210
2021-05-31,Yuba,115,75493,6089,6063,127,6190,48
2021-05-30,Alameda,001,1643700,88392,88429,1973,90402,1253
2021-05-30,Alpine,003,1148,87,88,0,88,0
2021-05-30,Amador,005,37829,3688,3685,33,3718,46
2021-05-30,Butte,007,227075,12588,12427,1830,14257,190
2021-05-30,Calaveras,009,45235,2174,2166,14,2180,55
2021-05-30,Colusa,011,21464,1953,1954,315,2269,15
2021-05-30,Contra Costa,013,1133247,69865,69381,1290,70671,813
2021-05-30,Del Norte,015,27424,1420,1393,13,1406,8
2021-05-30,El Dorado,017,186661,10321,10271,732,11003,110
2021-05-30,Fresno,019,978130,102899,102499,8749,111248,1706
2021-05-30,Glenn,021,27897,2437,2422,564,2986,18
2021-05-30,Humboldt,023,135768,4298,4291,38,4329,42
2021-05-30,Imperial,025,180216,28652,28732,2773,31505,736
2021-05-30,Inyo,027,18085,1403,1403,12,1415,35
2021-05-30,Kern,029,883053,97436,96443,10989,107432,1319
2021-05-30,Kings,031,150075,23193,22974,1096,24070,244
2021-05-30,Lake,033,64148,3536,3517,9,3526,45
2021-05-30,Lassen,035,31185,5219,5171,115,5286,6
2021-05-30,Los Angeles,037,10098052,1206267,1202425,41845,1244270,24360
2021-05-30,Madera,039,155013,16647,16538,941,17479,240
2021-05-30,Marin,041,260295,14125,14083,261,14344,229
2021-05-30,Mariposa,043,17540,435,430,11,441,5
2021-05-30,Mendocino,045,87422,4028,3955,82,4037,47
2021-05-30,Merced,047,269075,31075,31189,1056,32245,456
2021-05-30,Modoc,049,8938,382,374,132,506,3
2021-05-30,Mono,051,14174,1263,1275,17,1292,3
2021-05-30,Monterey,053,433212,43208,43049,1880,44929,379
2021-05-30,Napa,055,140530,9922,9948,38,9986,82
2021-05-30,Nevada,057,99092,4847,4818,192,5010,72
2021-05-30,Orange,059,3164182,255554,254559,11404,265963,5051
2021-05-30,Placer,061,380077,23371,23016,1512,24528,293
2021-05-30,Plumas,063,18699,708,690,11,701,4
2021-05-30,Riverside,065,2383286,294404,288961,14073,303034,4442
2021-05-30,Sacramento,067,1510023,106533,106252,1769,108021,1644
2021-05-30,San Benito,069,59416,6066,6072,115,6187,63
2021-05-30,San Bernardino,071,2135413,293591,292981,9005,301986,4758
2021-05-30,San Diego,073,3302833,281133,280209,15002,295211,3756
2021-05-30,San Francisco,075,870044,36801,37016,1296,38312,550
2021-05-30,San Joaquin,077,732212,73337,72853,3584,76437,1383
2021-05-30,San Luis Obispo,079,281455,21424,21211,749,21960,256
2021-05-30,San Mateo,081,765935,42443,42386,475,42861,439
2021-05-30,Santa Barbara,083,443738,34467,34369,1139,35508,456
2021-05-30,Santa Clara,085,1922200,118768,119510,766,120276,2057
2021-05-30,Santa Cruz,087,273765,16240,16140,814,16954,207
2021-05-30,Shasta,089,179085,12366,12408,1583,13991,199
2021-05-30,Sierra,091,2930,57,55,12,67,0
2021-05-30,Siskiyou,093,43540,1943,1856,368,2224,21
2021-05-30,Solano,095,438530,32952,32952,557,33509,256
2021-05-30,Sonoma,097,501317,30198,30310,341,30651,322
2021-05-30,Stanislaus,099,539301,56492,56323,5970,62293,973
2021-05-30,Sutter,101,95872,9487,9519,87,9606,111
2021-05-30,Tehama,103,63373,5100,5073,586,5659,63
2021-05-30,Trinity,105,12862,483,328,95,423,3
2021-05-30,Tulare,107,460477,50284,49397,9091,58488,845
2021-05-30,Tuolumne,109,53932,4021,4094,40,4134,63
2021-05-30,Ventura,111,848112,81457,81012,3001,84013,1021
2021-05-30,Yolo,113,214977,14031,14059,323,14382,210
2021-05-30,Yuba,115,75493,6082,6063,126,6189,48
2021-05-29,Alameda,001,1643700,88369,88433,1971,90404,1253
2021-05-29,Alpine,003,1148,87,88,0,88,0
2021-05-29,Amador,005,37829,3687,3683,33,3716,46
2021-05-29,Butte,007,227075,12582,12425,1830,14255,190
2021-05-29,Calaveras,009,45235,2173,2166,14,2180,55
2021-05-29,Colusa,011,21464,1950,1954,315,2269,15
2021-05-29,Contra Costa,013,1133247,69832,69351,1290,70641,813
2021-05-29,Del Norte,015,27424,1420,1391,13,1404,8
2021-05-29,El Dorado,017,186661,10320,10269,730,10999,110
2021-05-29,Fresno,019,978130,102887,102470,8746,111216,1706
2021-05-29,Glenn,021,27897,2437,2422,563,2985,18
2021-05-29,Humboldt,023,135768,4292,4283,38,4321,42
2021-05-29,Imperial,025,180216,28649,28729,2772,31501,736
2021-05-29,Inyo,027,18085,1403,1404,12,1416,35
2021-05-29,Kern,029,883053,97425,96424,10976,107400,1319
2021-05-29,Kings,031,150075,23192,22970,1095,24065,244
2021-05-29,Lake,033,64148,3536,3515,9,3524,45
2021-05-29,Lassen,035,31185,5219,5171,115,5286,6
2021-05-29,Los Angeles,037,10098052,1206144,1202264,41841,1244105,24359
2021-05-29,Madera,039,155013,16645,16535,941,17476,240
2021-05-29,Marin,041,260295,14121,14071,260,14331,229
2021-05-29,Mariposa,043,17540,434,428,11,439,5
2021-05-29,Mendocino,045,87422,4022,3952,82,4034,47
2021-05-29,Merced,047,269075,31063,31187,1056,32243,456
2021-05-29,Modoc,049,8938,382,374,132,506,3
2021-05-29,Mono,051,14174,1263,1275,17,1292,3
2021-05-29,Monterey,053,433212,43206,43042,1880,44922,379
2021-05-29,Napa,055,140530,9919,9948,38,9986,82
2021-05-29,Nevada,057,99092,4846,4816,192,5008,72
2021-05-29,Orange,059,3164182,255532,254537,11394,265931,5049
2021-05-29,Placer,061,380077,23356,23009,1511,24520,293
2021-05-29,Plumas,063,18699,708,689,11,700,4
2021-05-29,Riverside,065,2383286,294384,288908,14072,302980,4442
2021-05-29,Sacramento,067,1510023,106503,106218,1768,107986,1643
2021-05-29,San Benito,069,59416,6065,6072,115,6187,63
2021-05-29,San Bernardino,071,2135413,293559,292961,9004,301965,4757
2021-05-29,San Diego,073,3302833,281074,280151,14997,295148,3756
2021-05-29,San Francisco,075,870044,36792,37008,1296,38304,550
2021-05-29,San Joaquin,077,732212,73321,72827,3582,76409,1383
2021-05-29,San Luis Obispo,079,281455,21422,21201,749,21950,256
2021-05-29,San Mateo,081,765935,42435,42375,474,42849,439
2021-05-29,Santa Barbara,083,443738,34463,34367,1139,35506,456
2021-05-29,Santa Clara,085,1922200,118744,119498,765,120263,2056
2021-05-29,Santa Cruz,087,273765,16239,16137,814,16951,207
2021-05-29,Shasta,089,179085,12358,12401,1582,13983,199
2021-05-29,Sierra,091,2930,57,55,12,67,0
2021-05-29,Siskiyou,093,43540,1938,1856,368,2224,21
2021-05-29,Solano,095,438530,32943,32917,557,33474,256
2021-05-29,Sonoma,097,501317,30175,30298,340,30638,322
2021-05-29,Stanislaus,099,539301,56474,56305,5968,62273,974
2021-05-29,Sutter,101,95872,9483,9516,87,9603,111
2021-05-29,Tehama,103,63373,5099,5070,586,5656,63
2021-05-29,Trinity,105,12862,483,328,95,423,3
2021-05-29,Tulare,107,460477,50274,49392,9087,58479,845
2021-05-29,Tuolumne,109,53932,4021,4093,40,4133,63
2021-05-29,Ventura,111,848112,81449,81008,3001,84009,1021
2021-05-29,Yolo,113,214977,14030,14055,323,14378,210
2021-05-29,Yuba,115,75493,6082,6059,126,6185,48
2021-05-28,Alameda,001,1643700,88345,88391,1967,90358,1261
2021-05-28,Alpine,003,1148,87,88,0,88,0
2021-05-28,Amador,005,37829,3687,3680,33,3713,46
2021-05-28,Butte,007,227075,12579,12407,1829,14236,190
2021-05-28,Calaveras,009,45235,2172,2165,14,2179,55
2021-05-28,Colusa,011,21464,1950,1954,313,2267,15
2021-05-28,Contra Costa,013,1133247,69796,69290,1289,70579,813
2021-05-28,Del Norte,015,27424,1419,1390,13,1403,8
2021-05-28,El Dorado,017,186661,10317,10265,730,10995,110
2021-05-28,Fresno,019,978130,102872,102437,8746,111183,1705
2021-05-28,Glenn,021,27897,2437,2419,563,2982,18
2021-05-28,Humboldt,023,135768,4285,4265,38,4303,42
2021-05-28,Imperial,025,180216,28646,28722,2772,31494,736
2021-05-28,Inyo,027,18085,1403,1404,12,1416,35
2021-05-28,Kern,029,883053,97408,96396,10968,107364,1320
2021-05-28,Kings,031,150075,23190,22962,1095,24057,244
2021-05-28,Lake,033,64148,3534,3515,9,3524,45
2021-05-28,Lassen,035,31185,5219,5169,115,5284,6
2021-05-28,Los Angeles,037,10098052,1206034,1202103,41830,1243933,24357
2021-05-28,Madera,039,155013,16643,16530,941,17471,240
2021-05-28,Marin,041,260295,14120,14063,259,14322,229
2021-05-28,Mariposa,043,17540,434,428,11,439,5
2021-05-28,Mendocino,045,87422,4017,3947,82,4029,47
2021-05-28,Merced,047,269075,31060,31176,1056,32232,455
2021-05-28,Modoc,049,8938,382,374,132,506,3
2021-05-28,Mono,051,14174,1263,1274,17,1291,3
2021-05-28,Monterey,053,433212,43205,43036,1880,44916,379
2021-05-28,Napa,055,140530,9919,9941,38,9979,82
2021-05-28,Nevada,057,99092,4844,4813,192,5005,71
2021-05-28,Orange,059,3164182,255512,254494,11392,265886,5047
2021-05-28,Placer,061,380077,23346,22987,1509,24496,293
2021-05-28,Plumas,063,18699,706,688,11,699,4
2021-05-28,Riverside,065,2383286,294362,288872,14070,302942,4442
2021-05-28,Sacramento,067,1510023,106447,106131,1766,107897,1642
2021-05-28,San Benito,069,59416,6065,6074,115,6189,63
2021-05-28,San Bernardino,071,2135413,293536,292905,9004,301909,4757
2021-05-28,San Diego,073,3302833,281011,280043,14986,295029,3756
2021-05-28,San Francisco,075,870044,36786,36987,1296,38283,546
2021-05-28,San Joaquin,077,732212,73291,72793,3580,76373,1383
2021-05-28,San Luis Obispo,079,281455,21417,21190,747,21937,256
2021-05-28,San Mateo,081,765935,42429,42364,474,42838,439
2021-05-28,Santa Barbara,083,443738,34462,34371,1139,35510,455
2021-05-28,Santa Clara,085,1922200,118720,119462,765,120227,2056
2021-05-28,Santa Cruz,087,273765,16238,16129,814,16943,207
2021-05-28,Shasta,089,179085,12349,12383,1580,13963,198
2021-05-28,Sierra,091,2930,57,54,12,66,0
2021-05-28,Siskiyou,093,43540,1936,1850,368,2218,19
2021-05-28,Solano,095,438530,32928,32892,557,33449,256
2021-05-28,Sonoma,097,501317,30156,30270,340,30610,321
2021-05-28,Stanislaus,099,539301,56456,56278,5965,62243,974
2021-05-28,Sutter,101,95872,9479,9511,87,9598,111
2021-05-28,Tehama,103,63373,5093,5064,586,5650,63
2021-05-28,Trinity,105,12862,483,328,95,423,3
2021-05-28,Tulare,107,460477,50269,49375,9078,58453,846
2021-05-28,Tuolumne,109,53932,4021,4090,40,4130,63
2021-05-28,Ventura,111,848112,81438,80985,3000,83985,1021
2021-05-28,Yolo,113,214977,14027,14050,322,14372,210
2021-05-28,Yuba,115,75493,6080,6050,125,6175,48
2021-05-27,Alameda,001,1643700,88310,88342,1966,90308,1274
2021-05-27,Alpine,003,1148,87,88,0,88,0
2021-05-27,Amador,005,37829,3684,3680,33,3713,46
2021-05-27,Butte,007,227075,12574,12401,1828,14229,190
2021-05-27,Calaveras,009,45235,2171,2163,14,2177,55
2021-05-27,Colusa,011,21464,1947,1952,313,2265,15
2021-05-27,Contra Costa,013,1133247,69754,69245,1287,70532,813
2021-05-27,Del Norte,015,27424,1419,1388,13,1401,8
2021-05-27,El Dorado,017,186661,10316,10248,730,10978,112
2021-05-27,Fresno,019,978130,102855,102413,8743,111156,1704
2021-05-27,Glenn,021,27897,2437,2415,563,2978,18
2021-05-27,Humboldt,023,135768,4277,4260,38,4298,42
2021-05-27,Imperial,025,180216,28635,28728,2772,31500,736
2021-05-27,Inyo,027,18085,1403,1404,12,1416,35
2021-05-27,Kern,029,883053,97392,96364,10960,107324,1322
2021-05-27,Kings,031,150075,23187,22953,1095,24048,245
2021-05-27,Lake,033,64148,3529,3509,9,3518,45
2021-05-27,Lassen,035,31185,5218,5170,114,5284,6
2021-05-27,Los Angeles,037,10098052,1205871,1201927,41814,1243741,24348
2021-05-27,Madera,039,155013,16634,16527,941,17468,240
2021-05-27,Marin,041,260295,14116,14061,259,14320,229
2021-05-27,Mariposa,043,17540,432,427,11,438,5
2021-05-27,Mendocino,045,87422,4011,3945,82,4027,47
2021-05-27,Merced,047,269075,31048,31161,1056,32217,455
2021-05-27,Modoc,049,8938,381,374,132,506,3
2021-05-27,Mono,051,14174,1263,1276,17,1293,3
2021-05-27,Monterey,053,433212,43199,43032,1880,44912,379
2021-05-27,Napa,055,140530,9918,9934,38,9972,82
2021-05-27,Nevada,057,99092,4840,4807,190,4997,71
2021-05-27,Orange,059,3164182,255475,254438,11388,265826,5059
2021-05-27,Placer,061,380077,23337,22966,1509,24475,293
2021-05-27,Plumas,063,18699,706,687,11,698,4
2021-05-27,Riverside,065,2383286,294326,288835,14065,302900,4443
2021-05-27,Sacramento,067,1510023,106372,106015,1764,107779,1642
2021-05-27,San Benito,069,59416,6064,6074,115,6189,63
2021-05-27,San Bernardino,071,2135413,293500,292755,9002,301757,4756
2021-05-27,San Diego,073,3302833,280937,279960,14972,294932,3756
2021-05-27,San Francisco,075,870044,36780,36980,1293,38273,546
2021-05-27,San Joaquin,077,732212,73259,72714,3576,76290,1388
2021-05-27,San Luis Obispo,079,281455,21412,21171,747,21918,256
2021-05-27,San Mateo,081,765935,42420,42345,474,42819,436
2021-05-27,Santa Barbara,083,443738,34457,34355,1139,35494,456
2021-05-27,Santa Clara,085,1922200,118699,119452,765,120217,2053
2021-05-27,Santa Cruz,087,273765,16236,16134,814,16948,207
2021-05-27,Shasta,089,179085,12338,12380,1580,13960,202
2021-05-27,Sierra,091,2930,57,54,12,66,0
2021-05-27,Siskiyou,093,43540,1933,1846,368,2214,18
2021-05-27,Solano,095,438530,32887,32855,556,33411,257
2021-05-27,Sonoma,097,501317,30129,30253,336,30589,321
2021-05-27,Stanislaus,099,539301,56431,56207,5964,62171,974
2021-05-27,Sutter,101,95872,9475,9501,87,9588,111
2021-05-27,Tehama,103,63373,5090,5064,585,5649,63
2021-05-27,Trinity,105,12862,483,328,95,423,3
2021-05-27,Tulare,107,460477,50255,49366,9069,58435,840
2021-05-27,Tuolumne,109,53932,4020,4090,40,4130,66
2021-05-27,Ventura,111,848112,81425,80965,2997,83962,1023
2021-05-27,Yolo,113,214977,14024,14036,322,14358,213
2021-05-27,Yuba,115,75493,6075,6040,124,6164,48
2021-05-26,Alameda,001,1643700,88281,88297,1966,90263,1266
2021-05-26,Alpine,003,1148,87,88,0,88,0
2021-05-26,Amador,005,37829,3684,3679,33,3712,46
2021-05-26,Butte,007,227075,12565,12332,1827,14159,190
2021-05-26,Calaveras,009,45235,2170,2154,14,2168,55
2021-05-26,Colusa,011,21464,1946,1952,313,2265,15
2021-05-26,Contra Costa,013,1133247,69717,69210,1287,70497,812
2021-05-26,Del Norte,015,27424,1419,1386,12,1398,8
2021-05-26,El Dorado,017,186661,10312,10242,729,10971,112
2021-05-26,Fresno,019,978130,102823,102374,8738,111112,1702
2021-05-26,Glenn,021,27897,2436,2415,563,2978,18
2021-05-26,Humboldt,023,135768,4272,4246,38,4284,42
2021-05-26,Imperial,025,180216,28630,28712,2770,31482,734
2021-05-26,Inyo,027,18085,1403,1403,12,1415,36
2021-05-26,Kern,029,883053,97367,96343,10953,107296,1320
2021-05-26,Kings,031,150075,23183,22950,1094,24044,245
2021-05-26,Lake,033,64148,3528,3508,9,3517,45
2021-05-26,Lassen,035,31185,5217,5164,114,5278,6
2021-05-26,Los Angeles,037,10098052,1205705,1198100,41797,1239897,24221
2021-05-26,Madera,039,155013,16631,16520,941,17461,240
2021-05-26,Marin,041,260295,14113,14061,258,14319,227
2021-05-26,Mariposa,043,17540,432,427,11,438,5
2021-05-26,Mendocino,045,87422,4005,3938,82,4020,47
2021-05-26,Merced,047,269075,31039,31139,1056,32195,455
2021-05-26,Modoc,049,8938,381,371,131,502,3
2021-05-26,Mono,051,14174,1263,1274,17,1291,3
2021-05-26,Monterey,053,433212,43193,43018,1879,44897,379
2021-05-26,Napa,055,140530,9911,9932,36,9968,82
2021-05-26,Nevada,057,99092,4835,4803,190,4993,70
2021-05-26,Orange,059,3164182,255439,254368,11385,265753,5058
2021-05-26,Placer,061,380077,23313,22940,1509,24449,293
2021-05-26,Plumas,063,18699,705,685,11,696,4
2021-05-26,Riverside,065,2383286,294280,288782,14058,302840,4443
2021-05-26,Sacramento,067,1510023,106286,105919,1760,107679,1637
2021-05-26,San Benito,069,59416,6064,6074,115,6189,63
2021-05-26,San Bernardino,071,2135413,293464,292662,9001,301663,4755
2021-05-26,San Diego,073,3302833,280862,279859,14962,294821,3755
2021-05-26,San Francisco,075,870044,36768,36954,1293,38247,546
2021-05-26,San Joaquin,077,732212,73217,72681,3573,76254,1388
2021-05-26,San Luis Obispo,079,281455,21406,21163,747,21910,256
2021-05-26,San Mateo,081,765935,42411,42331,474,42805,436
2021-05-26,Santa Barbara,083,443738,34448,34348,1139,35487,459
2021-05-26,Santa Clara,085,1922200,118672,119421,764,120185,2031
2021-05-26,Santa Cruz,087,273765,16235,16139,814,16953,207
2021-05-26,Shasta,089,179085,12324,12357,1577,13934,202
2021-05-26,Sierra,091,2930,57,54,12,66,0
2021-05-26,Siskiyou,093,43540,1931,1847,366,2213,18
2021-05-26,Solano,095,438530,32851,32831,556,33387,257
2021-05-26,Sonoma,097,501317,30102,30230,336,30566,321
2021-05-26,Stanislaus,099,539301,56409,56193,5962,62155,974
2021-05-26,Sutter,101,95872,9470,9495,87,9582,112
2021-05-26,Tehama,103,63373,5089,5054,582,5636,63
2021-05-26,Trinity,105,12862,483,328,95,423,3
2021-05-26,Tulare,107,460477,50248,49352,9065,58417,839
2021-05-26,Tuolumne,109,53932,4016,4088,39,4127,66
2021-05-26,Ventura,111,848112,81402,80944,2995,83939,1023
2021-05-26,Yolo,113,214977,14021,14025,322,14347,213
2021-05-26,Yuba,115,75493,6070,6036,124,6160,49
2021-05-25,Alameda,001,1643700,88251,88237,1966,90203,1263
2021-05-25,Alpine,003,1148,87,88,0,88,0
2021-05-25,Amador,005,37829,3679,3676,33,3709,46
2021-05-25,Butte,007,227075,12554,12295,1826,14121,189
2021-05-25,Calaveras,009,45235,2168,2148,14,2162,55
2021-05-25,Colusa,011,21464,1945,1949,313,2262,15
2021-05-25,Contra Costa,013,1133247,69665,69167,1282,70449,809
2021-05-25,Del Norte,015,27424,1419,1385,12,1397,8
2021-05-25,El Dorado,017,186661,10305,10240,728,10968,112
2021-05-25,Fresno,019,978130,102801,102329,8736,111065,1701
2021-05-25,Glenn,021,27897,2435,2414,562,2976,17
2021-05-25,Humboldt,023,135768,4265,4231,36,4267,42
2021-05-25,Imperial,025,180216,28623,28586,2770,31356,735
2021-05-25,Inyo,027,18085,1403,1402,12,1414,36
2021-05-25,Kern,029,883053,97336,96319,10939,107258,1319
2021-05-25,Kings,031,150075,23176,22944,1094,24038,245
2021-05-25,Lake,033,64148,3527,3508,9,3517,44
2021-05-25,Lassen,035,31185,5213,5164,114,5278,6
2021-05-25,Los Angeles,037,10098052,1205526,1197940,41778,1239718,24212
2021-05-25,Madera,039,155013,16626,16519,940,17459,240
2021-05-25,Marin,041,260295,14107,14053,258,14311,227
2021-05-25,Mariposa,043,17540,431,427,11,438,5
2021-05-25,Mendocino,045,87422,4000,3928,82,4010,47
2021-05-25,Merced,047,269075,31018,31132,1056,32188,455
2021-05-25,Modoc,049,8938,380,367,131,498,3
2021-05-25,Mono,051,14174,1263,1274,17,1291,3
2021-05-25,Monterey,053,433212,43189,43012,1878,44890,379
2021-05-25,Napa,055,140530,9909,9926,36,9962,82
2021-05-25,Nevada,057,99092,4829,4795,190,4985,70
2021-05-25,Orange,059,3164182,255410,254321,11384,265705,5057
2021-05-25,Placer,061,380077,23302,22920,1507,24427,292
2021-05-25,Plumas,063,18699,705,684,11,695,4
2021-05-25,Riverside,065,2383286,294241,288725,14055,302780,4443
2021-05-25,Sacramento,067,1510023,106205,105828,1756,107584,1633
2021-05-25,San Benito,069,59416,6064,6073,115,6188,63
2021-05-25,San Bernardino,071,2135413,293404,292485,8999,301484,4755
2021-05-25,San Diego,073,3302833,280780,279786,14957,294743,3753
2021-05-25,San Francisco,075,870044,36745,36939,1293,38232,546
2021-05-25,San Joaquin,077,732212,73175,72628,3570,76198,1387
2021-05-25,San Luis Obispo,079,281455,21403,21153,747,21900,256
2021-05-25,San Mateo,081,765935,42401,42268,474,42742,435
2021-05-25,Santa Barbara,083,443738,34445,34337,1139,35476,459
2021-05-25,Santa Clara,085,1922200,118648,119393,763,120156,2032
2021-05-25,Santa Cruz,087,273765,16230,16141,814,16955,207
2021-05-25,Shasta,089,179085,12315,12328,1575,13903,202
2021-05-25,Sierra,091,2930,56,54,12,66,0
2021-05-25,Siskiyou,093,43540,1930,1845,365,2210,18
2021-05-25,Solano,095,438530,32832,32817,555,33372,256
2021-05-25,Sonoma,097,501317,30073,30207,335,30542,321
2021-05-25,Stanislaus,099,539301,56373,56168,5959,62127,974
2021-05-25,Sutter,101,95872,9466,9495,87,9582,112
2021-05-25,Tehama,103,63373,5086,5048,581,5629,63
2021-05-25,Trinity,105,12862,483,328,94,422,3
2021-05-25,Tulare,107,460477,50238,49326,9057,58383,838
2021-05-25,Tuolumne,109,53932,4016,4084,39,4123,66
2021-05-25,Ventura,111,848112,81384,80905,2995,83900,1022
2021-05-25,Yolo,113,214977,14013,14018,320,14338,213
2021-05-25,Yuba,115,75493,6063,6028,124,6152,49
2021-05-24,Alameda,001,1643700,88209,88182,1965,90147,1263
2021-05-24,Alpine,003,1148,87,88,0,88,0
2021-05-24,Amador,005,37829,3677,3675,33,3708,46
2021-05-24,Butte,007,227075,12541,12279,1823,14102,189
2021-05-24,Calaveras,009,45235,2166,2146,14,2160,54
2021-05-24,Colusa,011,21464,1945,1949,313,2262,15
2021-05-24,Contra Costa,013,1133247,69624,69107,1278,70385,809
2021-05-24,Del Norte,015,27424,1418,1384,12,1396,8
2021-05-24,El Dorado,017,186661,10295,10227,727,10954,112
2021-05-24,Fresno,019,978130,102759,102289,8735,111024,1698
2021-05-24,Glenn,021,27897,2435,2413,562,2975,17
2021-05-24,Humboldt,023,135768,4258,4225,36,4261,42
2021-05-24,Imperial,025,180216,28621,28575,2770,31345,735
2021-05-24,Inyo,027,18085,1403,1402,12,1414,36
2021-05-24,Kern,029,883053,97309,96296,10934,107230,1319
2021-05-24,Kings,031,150075,23172,22940,1094,24034,246
2021-05-24,Lake,033,64148,3525,3506,9,3515,43
2021-05-24,Lassen,035,31185,5209,5163,114,5277,6
2021-05-24,Los Angeles,037,10098052,1205352,1197782,41763,1239545,24201
2021-05-24,Madera,039,155013,16622,16513,939,17452,239
2021-05-24,Marin,041,260295,14105,14051,258,14309,227
2021-05-24,Mariposa,043,17540,430,427,11,438,5
2021-05-24,Mendocino,045,87422,3998,3919,82,4001,47
2021-05-24,Merced,047,269075,31008,31128,1055,32183,455
2021-05-24,Modoc,049,8938,380,366,130,496,3
2021-05-24,Mono,051,14174,1263,1270,17,1287,3
2021-05-24,Monterey,053,433212,43184,43005,1877,44882,379
2021-05-24,Napa,055,140530,9909,9924,36,9960,82
2021-05-24,Nevada,057,99092,4826,4790,190,4980,70
2021-05-24,Orange,059,3164182,255376,254287,11374,265661,5056
2021-05-24,Placer,061,380077,23283,22895,1506,24401,292
2021-05-24,Plumas,063,18699,704,683,11,694,4
2021-05-24,Riverside,065,2383286,294184,288669,14045,302714,4442
2021-05-24,Sacramento,067,1510023,106090,105716,1755,107471,1632
2021-05-24,San Benito,069,59416,6064,6072,115,6187,63
2021-05-24,San Bernardino,071,2135413,293364,292343,8998,301341,4747
2021-05-24,San Diego,073,3302833,280671,279715,14947,294662,3749
2021-05-24,San Francisco,075,870044,36725,36934,1291,38225,547
2021-05-24,San Joaquin,077,732212,73143,72586,3569,76155,1371
2021-05-24,San Luis Obispo,079,281455,21385,21146,746,21892,256
2021-05-24,San Mateo,081,765935,42391,42249,474,42723,433
2021-05-24,Santa Barbara,083,443738,34440,34322,1139,35461,459
2021-05-24,Santa Clara,085,1922200,118616,119358,763,120121,2030
2021-05-24,Santa Cruz,087,273765,16224,16135,814,16949,207
2021-05-24,Shasta,089,179085,12298,12315,1572,13887,201
2021-05-24,Sierra,091,2930,56,54,12,66,0
2021-05-24,Siskiyou,093,43540,1927,1840,365,2205,17
2021-05-24,Solano,095,438530,32807,32792,554,33346,254
2021-05-24,Sonoma,097,501317,30058,30187,335,30522,321
2021-05-24,Stanislaus,099,539301,56339,56128,5955,62083,974
2021-05-24,Sutter,101,95872,9460,9486,87,9573,113
2021-05-24,Tehama,103,63373,5083,5043,579,5622,63
2021-05-24,Trinity,105,12862,483,328,94,422,3
2021-05-24,Tulare,107,460477,50231,49318,9053,58371,838
2021-05-24,Tuolumne,109,53932,4016,4083,39,4122,65
2021-05-24,Ventura,111,848112,81371,80876,2993,83869,1022
2021-05-24,Yolo,113,214977,13996,14012,318,14330,213
2021-05-24,Yuba,115,75493,6054,6022,124,6146,49
2021-05-23,Alameda,001,1643700,88145,88157,1962,90119,1263
2021-05-23,Alpine,003,1148,87,88,0,88,0
2021-05-23,Amador,005,37829,3676,3673,33,3706,46
2021-05-23,Butte,007,227075,12527,12271,1822,14093,189
2021-05-23,Calaveras,009,45235,2158,2144,14,2158,54
2021-05-23,Colusa,011,21464,1945,1949,311,2260,15
2021-05-23,Contra Costa,013,1133247,69580,69075,1276,70351,809
2021-05-23,Del Norte,015,27424,1414,1383,12,1395,8
2021-05-23,El Dorado,017,186661,10289,10222,727,10949,112
2021-05-23,Fresno,019,978130,102714,102270,8730,111000,1698
2021-05-23,Glenn,021,27897,2433,2413,562,2975,17
2021-05-23,Humboldt,023,135768,4241,4216,36,4252,42
2021-05-23,Imperial,025,180216,28615,28569,2769,31338,735
2021-05-23,Inyo,027,18085,1403,1402,12,1414,36
2021-05-23,Kern,029,883053,97285,96282,10926,107208,1319
2021-05-23,Kings,031,150075,23159,22939,1092,24031,246
2021-05-23,Lake,033,64148,3522,3504,9,3513,43
2021-05-23,Lassen,035,31185,5205,5163,113,5276,6
2021-05-23,Los Angeles,037,10098052,1205165,1197633,41751,1239384,24197
2021-05-23,Madera,039,155013,16616,16504,939,17443,239
2021-05-23,Marin,041,260295,14096,14048,257,14305,227
2021-05-23,Mariposa,043,17540,430,427,11,438,5
2021-05-23,Mendocino,045,87422,3992,3913,81,3994,47
2021-05-23,Merced,047,269075,30998,31118,1055,32173,455
2021-05-23,Modoc,049,8938,376,366,130,496,3
2021-05-23,Mono,051,14174,1262,1270,17,1287,3
2021-05-23,Monterey,053,433212,43174,43003,1877,44880,379
2021-05-23,Napa,055,140530,9905,9923,36,9959,82
2021-05-23,Nevada,057,99092,4816,4790,190,4980,70
2021-05-23,Orange,059,3164182,255338,254277,11368,265645,5050
2021-05-23,Placer,061,380077,23263,22888,1506,24394,292
2021-05-23,Plumas,063,18699,703,683,11,694,4
2021-05-23,Riverside,065,2383286,294116,288641,14041,302682,4442
2021-05-23,Sacramento,067,1510023,105974,105663,1752,107415,1632
2021-05-23,San Benito,069,59416,6063,6072,115,6187,63
2021-05-23,San Bernardino,071,2135413,293313,292327,8997,301324,4747
2021-05-23,San Diego,073,3302833,280581,279690,14936,294626,3751
2021-05-23,San Francisco,075,870044,36714,36927,1290,38217,547
2021-05-23,San Joaquin,077,732212,73094,72571,3566,76137,1371
2021-05-23,San Luis Obispo,079,281455,21375,21141,745,21886,256
2021-05-23,San Mateo,081,765935,42374,42248,474,42722,433
2021-05-23,Santa Barbara,083,443738,34433,34319,1139,35458,459
2021-05-23,Santa Clara,085,1922200,118592,119333,763,120096,2030
2021-05-23,Santa Cruz,087,273765,16221,16130,814,16944,207
2021-05-23,Shasta,089,179085,12281,12313,1568,13881,201
2021-05-23,Sierra,091,2930,56,54,12,66,0
2021-05-23,Siskiyou,093,43540,1922,1826,358,2184,17
2021-05-23,Solano,095,438530,32789,32780,553,33333,254
2021-05-23,Sonoma,097,501317,30029,30168,334,30502,321
2021-05-23,Stanislaus,099,539301,56291,56104,5952,62056,974
2021-05-23,Sutter,101,95872,9451,9479,87,9566,113
2021-05-23,Tehama,103,63373,5076,5041,577,5618,63
2021-05-23,Trinity,105,12862,483,328,94,422,3
2021-05-23,Tulare,107,460477,50217,49310,9049,58359,838
2021-05-23,Tuolumne,109,53932,4013,4081,39,4120,65
2021-05-23,Ventura,111,848112,81341,80872,2992,83864,1022
2021-05-23,Yolo,113,214977,13984,14004,315,14319,213
2021-05-23,Yuba,115,75493,6049,6017,124,6141,49
2021-05-22,Alameda,001,1643700,88118,88101,1962,90063,1263
2021-05-22,Alpine,003,1148,87,88,0,88,0
2021-05-22,Amador,005,37829,3675,3672,33,3705,46
2021-05-22,Butte,007,227075,12515,12265,1821,14086,189
2021-05-22,Calaveras,009,45235,2154,2141,14,2155,54
2021-05-22,Colusa,011,21464,1941,1949,310,2259,15
2021-05-22,Contra Costa,013,1133247,69547,69004,1275,70279,809
2021-05-22,Del Norte,015,27424,1413,1381,12,1393,8
2021-05-22,El Dorado,017,186661,10284,10215,727,10942,112
2021-05-22,Fresno,019,978130,102700,102238,8728,110966,1698
2021-05-22,Glenn,021,27897,2433,2412,562,2974,17
2021-05-22,Humboldt,023,135768,4232,4194,35,4229,42
2021-05-22,Imperial,025,180216,28606,28574,2769,31343,735
2021-05-22,Inyo,027,18085,1403,1402,12,1414,36
2021-05-22,Kern,029,883053,97273,96260,10919,107179,1319
2021-05-22,Kings,031,150075,23159,22936,1092,24028,246
2021-05-22,Lake,033,64148,3519,3502,9,3511,43
2021-05-22,Lassen,035,31185,5205,5163,113,5276,6
2021-05-22,Los Angeles,037,10098052,1205059,1197454,41742,1239196,24192
2021-05-22,Madera,039,155013,16613,16503,939,17442,239
2021-05-22,Marin,041,260295,14093,14043,257,14300,227
2021-05-22,Mariposa,043,17540,430,427,11,438,5
2021-05-22,Mendocino,045,87422,3986,3908,81,3989,47
2021-05-22,Merced,047,269075,30988,31099,1055,32154,455
2021-05-22,Modoc,049,8938,376,366,130,496,3
2021-05-22,Mono,051,14174,1260,1270,17,1287,3
2021-05-22,Monterey,053,433212,43168,42998,1877,44875,379
2021-05-22,Napa,055,140530,9903,9918,36,9954,82
2021-05-22,Nevada,057,99092,4809,4787,189,4976,70
2021-05-22,Orange,059,3164182,255317,254238,11362,265600,5048
2021-05-22,Placer,061,380077,23249,22865,1505,24370,292
2021-05-22,Plumas,063,18699,702,683,11,694,4
2021-05-22,Riverside,065,2383286,294084,288580,14040,302620,4442
2021-05-22,Sacramento,067,1510023,105899,105551,1749,107300,1632
2021-05-22,San Benito,069,59416,6063,6071,115,6186,63
2021-05-22,San Bernardino,071,2135413,293288,292292,8997,301289,4747
2021-05-22,San Diego,073,3302833,280522,279614,14928,294542,3751
2021-05-22,San Francisco,075,870044,36704,36906,1288,38194,547
2021-05-22,San Joaquin,077,732212,73072,72528,3563,76091,1371
2021-05-22,San Luis Obispo,079,281455,21367,21134,744,21878,256
2021-05-22,San Mateo,081,765935,42364,42218,474,42692,433
2021-05-22,Santa Barbara,083,443738,34429,34313,1138,35451,459
2021-05-22,Santa Clara,085,1922200,118568,119292,763,120055,2030
2021-05-22,Santa Cruz,087,273765,16221,16125,814,16939,207
2021-05-22,Shasta,089,179085,12274,12307,1565,13872,201
2021-05-22,Sierra,091,2930,56,54,12,66,0
2021-05-22,Siskiyou,093,43540,1921,1824,357,2181,17
2021-05-22,Solano,095,438530,32776,32753,553,33306,254
2021-05-22,Sonoma,097,501317,30017,30154,334,30488,321
2021-05-22,Stanislaus,099,539301,56268,56069,5950,62019,974
2021-05-22,Sutter,101,95872,9446,9476,87,9563,113
2021-05-22,Tehama,103,63373,5075,5036,577,5613,63
2021-05-22,Trinity,105,12862,483,328,94,422,3
2021-05-22,Tulare,107,460477,50211,49299,9044,58343,838
2021-05-22,Tuolumne,109,53932,4013,4078,39,4117,65
2021-05-22,Ventura,111,848112,81337,80859,2992,83851,1022
2021-05-22,Yolo,113,214977,13982,13997,315,14312,213
2021-05-22,Yuba,115,75493,6046,6010,124,6134,49
2021-05-21,Alameda,001,1643700,88092,88041,1961,90002,1263
2021-05-21,Alpine,003,1148,87,88,0,88,0
2021-05-21,Amador,005,37829,3672,3672,33,3705,46
2021-05-21,Butte,007,227075,12509,12236,1819,14055,188
2021-05-21,Calaveras,009,45235,2152,2138,14,2152,54
2021-05-21,Colusa,011,21464,1941,1947,310,2257,15
2021-05-21,Contra Costa,013,1133247,69504,68965,1274,70239,810
2021-05-21,Del Norte,015,27424,1412,1376,12,1388,8
2021-05-21,El Dorado,017,186661,10280,10204,727,10931,112
2021-05-21,Fresno,019,978130,102672,102189,8726,110915,1698
2021-05-21,Glenn,021,27897,2432,2408,562,2970,17
2021-05-21,Humboldt,023,135768,4225,4175,35,4210,42
2021-05-21,Imperial,025,180216,28599,28572,2768,31340,732
2021-05-21,Inyo,027,18085,1403,1402,12,1414,36
2021-05-21,Kern,029,883053,97259,96233,10912,107145,1318
2021-05-21,Kings,031,150075,23159,22927,1092,24019,246
2021-05-21,Lake,033,64148,3517,3500,9,3509,43
2021-05-21,Lassen,035,31185,5204,5161,113,5274,6
2021-05-21,Los Angeles,037,10098052,1204948,1197263,41733,1238996,24180
2021-05-21,Madera,039,155013,16612,16500,938,17438,238
2021-05-21,Marin,041,260295,14088,14042,257,14299,227
2021-05-21,Mariposa,043,17540,429,427,11,438,5
2021-05-21,Mendocino,045,87422,3980,3897,81,3978,47
2021-05-21,Merced,047,269075,30980,31076,1055,32131,455
2021-05-21,Modoc,049,8938,376,365,130,495,3
2021-05-21,Mono,051,14174,1260,1269,17,1286,3
2021-05-21,Monterey,053,433212,43166,42995,1877,44872,379
2021-05-21,Napa,055,140530,9899,9913,36,9949,82
2021-05-21,Nevada,057,99092,4808,4779,189,4968,70
2021-05-21,Orange,059,3164182,255298,254171,11360,265531,5042
2021-05-21,Placer,061,380077,23240,22853,1505,24358,292
2021-05-21,Plumas,063,18699,702,683,10,693,4
2021-05-21,Riverside,065,2383286,294057,288499,14033,302532,4442
2021-05-21,Sacramento,067,1510023,105832,105476,1746,107222,1632
2021-05-21,San Benito,069,59416,6063,6068,115,6183,63
2021-05-21,San Bernardino,071,2135413,293256,292205,8994,301199,4744
2021-05-21,San Diego,073,3302833,280450,279554,14918,294472,3748
2021-05-21,San Francisco,075,870044,36699,36879,1288,38167,546
2021-05-21,San Joaquin,077,732212,73052,72467,3561,76028,1371
2021-05-21,San Luis Obispo,079,281455,21361,21128,741,21869,256
2021-05-21,San Mateo,081,765935,42351,42163,473,42636,432
2021-05-21,Santa Barbara,083,443738,34424,34302,1138,35440,459
2021-05-21,Santa Clara,085,1922200,118541,119247,763,120010,2029
2021-05-21,Santa Cruz,087,273765,16217,16120,814,16934,207
2021-05-21,Shasta,089,179085,12257,12289,1563,13852,201
2021-05-21,Sierra,091,2930,56,54,12,66,0
2021-05-21,Siskiyou,093,43540,1920,1815,357,2172,16
2021-05-21,Solano,095,438530,32761,32742,553,33295,254
2021-05-21,Sonoma,097,501317,30004,30126,334,30460,321
2021-05-21,Stanislaus,099,539301,56239,56036,5948,61984,975
2021-05-21,Sutter,101,95872,9444,9470,87,9557,113
2021-05-21,Tehama,103,63373,5069,5030,577,5607,63
2021-05-21,Trinity,105,12862,483,329,93,422,3
2021-05-21,Tulare,107,460477,50206,49271,9042,58313,838
2021-05-21,Tuolumne,109,53932,4011,4079,39,4118,65
2021-05-21,Ventura,111,848112,81329,80821,2989,83810,1021
2021-05-21,Yolo,113,214977,13976,13983,315,14298,213
2021-05-21,Yuba,115,75493,6040,6006,124,6130,49
2021-05-20,Alameda,001,1643700,88048,87975,1960,89935,1264
2021-05-20,Alpine,003,1148,87,88,0,88,0
2021-05-20,Amador,005,37829,3671,3671,33,3704,46
2021-05-20,Butte,007,227075,12502,12220,1816,14036,188
2021-05-20,Calaveras,009,45235,2148,2138,14,2152,54
2021-05-20,Colusa,011,21464,1940,1946,308,2254,15
2021-05-20,Contra Costa,013,1133247,69459,68913,1272,70185,809
2021-05-20,Del Norte,015,27424,1412,1373,12,1385,8
2021-05-20,El Dorado,017,186661,10270,10188,727,10915,112
2021-05-20,Fresno,019,978130,102650,102135,8724,110859,1696
2021-05-20,Glenn,021,27897,2429,2406,562,2968,17
2021-05-20,Humboldt,023,135768,4208,4162,34,4196,42
2021-05-20,Imperial,025,180216,28594,28551,2768,31319,732
2021-05-20,Inyo,027,18085,1403,1402,12,1414,36
2021-05-20,Kern,029,883053,97238,96204,10905,107109,1317
2021-05-20,Kings,031,150075,23157,22922,1092,24014,246
2021-05-20,Lake,033,64148,3514,3500,9,3509,43
2021-05-20,Lassen,035,31185,5202,5160,112,5272,6
2021-05-20,Los Angeles,037,10098052,1204792,1197073,41724,1238797,24168
2021-05-20,Madera,039,155013,16606,16499,936,17435,238
2021-05-20,Marin,041,260295,14084,14036,256,14292,227
2021-05-20,Mariposa,043,17540,429,426,11,437,5
2021-05-20,Mendocino,045,87422,3973,3897,81,3978,47
2021-05-20,Merced,047,269075,30967,31046,1054,32100,454
2021-05-20,Modoc,049,8938,376,365,130,495,3
2021-05-20,Mono,051,14174,1259,1269,17,1286,3
2021-05-20,Monterey,053,433212,43160,42984,1876,44860,379
2021-05-20,Napa,055,140530,9896,9913,36,9949,82
2021-05-20,Nevada,057,99092,4807,4775,189,4964,70
2021-05-20,Orange,059,3164182,255255,254127,11357,265484,5038
2021-05-20,Placer,061,380077,23227,22823,1504,24327,292
2021-05-20,Plumas,063,18699,700,682,10,692,4
2021-05-20,Riverside,065,2383286,294009,288453,14028,302481,4442
2021-05-20,Sacramento,067,1510023,105736,105414,1743,107157,1629
2021-05-20,San Benito,069,59416,6062,6067,115,6182,63
2021-05-20,San Bernardino,071,2135413,293210,292153,8993,301146,4728
2021-05-20,San Diego,073,3302833,280362,279490,14906,294396,3749
2021-05-20,San Francisco,075,870044,36690,36860,1288,38148,546
2021-05-20,San Joaquin,077,732212,73014,72388,3559,75947,1371
2021-05-20,San Luis Obispo,079,281455,21349,21095,739,21834,256
2021-05-20,San Mateo,081,765935,42337,42152,471,42623,432
2021-05-20,Santa Barbara,083,443738,34420,34293,1138,35431,459
2021-05-20,Santa Clara,085,1922200,118520,119222,763,119985,2029
2021-05-20,Santa Cruz,087,273765,16212,16119,814,16933,207
2021-05-20,Shasta,089,179085,12244,12266,1560,13826,200
2021-05-20,Sierra,091,2930,56,54,12,66,0
2021-05-20,Siskiyou,093,43540,1913,1811,356,2167,16
2021-05-20,Solano,095,438530,32746,32725,553,33278,253
2021-05-20,Sonoma,097,501317,29987,30107,333,30440,321
2021-05-20,Stanislaus,099,539301,56215,55979,5946,61925,970
2021-05-20,Sutter,101,95872,9440,9467,87,9554,113
2021-05-20,Tehama,103,63373,5067,5029,577,5606,63
2021-05-20,Trinity,105,12862,483,329,92,421,3
2021-05-20,Tulare,107,460477,50195,49217,9039,58256,837
2021-05-20,Tuolumne,109,53932,4010,4077,39,4116,65
2021-05-20,Ventura,111,848112,81318,80800,2989,83789,1019
2021-05-20,Yolo,113,214977,13971,13973,315,14288,211
2021-05-20,Yuba,115,75493,6031,6002,124,6126,49
2021-05-19,Alameda,001,1643700,88008,87889,1958,89847,1260
2021-05-19,Alpine,003,1148,87,88,0,88,0
2021-05-19,Amador,005,37829,3671,3669,33,3702,46
2021-05-19,Butte,007,227075,12492,12198,1816,14014,188
2021-05-19,Calaveras,009,45235,2144,2132,14,2146,54
2021-05-19,Colusa,011,21464,1940,1945,306,2251,15
2021-05-19,Contra Costa,013,1133247,69412,68836,1272,70108,808
2021-05-19,Del Norte,015,27424,1410,1371,12,1383,8
2021-05-19,El Dorado,017,186661,10265,10179,726,10905,112
2021-05-19,Fresno,019,978130,102620,102085,8721,110806,1693
2021-05-19,Glenn,021,27897,2429,2404,562,2966,17
2021-05-19,Humboldt,023,135768,4198,4143,34,4177,42
2021-05-19,Imperial,025,180216,28585,28550,2768,31318,732
2021-05-19,Inyo,027,18085,1403,1402,12,1414,36
2021-05-19,Kern,029,883053,97209,96173,10897,107070,1316
2021-05-19,Kings,031,150075,23151,22919,1092,24011,246
2021-05-19,Lake,033,64148,3514,3497,9,3506,43
2021-05-19,Lassen,035,31185,5201,5157,112,5269,6
2021-05-19,Los Angeles,037,10098052,1204599,1196856,41709,1238565,24143
2021-05-19,Madera,039,155013,16603,16496,936,17432,238
2021-05-19,Marin,041,260295,14080,14033,254,14287,227
2021-05-19,Mariposa,043,17540,429,425,11,436,5
2021-05-19,Mendocino,045,87422,3969,3886,81,3967,47
2021-05-19,Merced,047,269075,30951,31044,1054,32098,452
2021-05-19,Modoc,049,8938,376,364,127,491,3
2021-05-19,Mono,051,14174,1259,1266,17,1283,3
2021-05-19,Monterey,053,433212,43155,42973,1875,44848,379
2021-05-19,Napa,055,140530,9893,9906,36,9942,82
2021-05-19,Nevada,057,99092,4805,4769,189,4958,70
2021-05-19,Orange,059,3164182,255218,254087,11347,265434,5035
2021-05-19,Placer,061,380077,23208,22784,1499,24283,291
2021-05-19,Plumas,063,18699,700,682,10,692,4
2021-05-19,Riverside,065,2383286,293962,288398,14026,302424,4442
2021-05-19,Sacramento,067,1510023,105659,105225,1742,106967,1629
2021-05-19,San Benito,069,59416,6061,6064,115,6179,63
2021-05-19,San Bernardino,071,2135413,293166,292078,8990,301068,4725
2021-05-19,San Diego,073,3302833,280277,279345,14885,294230,3746
2021-05-19,San Francisco,075,870044,36677,36835,1287,38122,546
2021-05-19,San Joaquin,077,732212,72971,72338,3554,75892,1369
2021-05-19,San Luis Obispo,079,281455,21341,21085,738,21823,256
2021-05-19,San Mateo,081,765935,42330,42126,471,42597,429
2021-05-19,Santa Barbara,083,443738,34412,34292,1138,35430,459
2021-05-19,Santa Clara,085,1922200,118480,119176,762,119938,2015
2021-05-19,Santa Cruz,087,273765,16208,16121,813,16934,207
2021-05-19,Shasta,089,179085,12226,12233,1557,13790,200
2021-05-19,Sierra,091,2930,56,54,12,66,0
2021-05-19,Siskiyou,093,43540,1910,1803,355,2158,16
2021-05-19,Solano,095,438530,32719,32678,551,33229,253
2021-05-19,Sonoma,097,501317,29972,30080,333,30413,321
2021-05-19,Stanislaus,099,539301,56197,55912,5941,61853,967
2021-05-19,Sutter,101,95872,9433,9459,86,9545,113
2021-05-19,Tehama,103,63373,5058,5026,571,5597,63
2021-05-19,Trinity,105,12862,483,329,92,421,3
2021-05-19,Tulare,107,460477,50182,49163,9034,58197,837
2021-05-19,Tuolumne,109,53932,4010,4074,39,4113,64
2021-05-19,Ventura,111,848112,81303,80747,2988,83735,1019
2021-05-19,Yolo,113,214977,13964,13961,314,14275,211
2021-05-19,Yuba,115,75493,6027,5993,124,6117,49
2021-05-18,Alameda,001,1643700,87934,87816,1958,89774,1254
2021-05-18,Alpine,003,1148,87,88,0,88,0
2021-05-18,Amador,005,37829,3671,3669,33,3702,46
2021-05-18,Butte,007,227075,12479,12164,1813,13977,191
2021-05-18,Calaveras,009,45235,2140,2131,14,2145,54
2021-05-18,Colusa,011,21464,1940,1943,306,2249,14
2021-05-18,Contra Costa,013,1133247,69355,68750,1271,70021,808
2021-05-18,Del Norte,015,27424,1407,1371,12,1383,8
2021-05-18,El Dorado,017,186661,10254,10169,725,10894,112
2021-05-18,Fresno,019,978130,102584,102056,8718,110774,1690
2021-05-18,Glenn,021,27897,2423,2403,561,2964,17
2021-05-18,Humboldt,023,135768,4180,4132,34,4166,42
2021-05-18,Imperial,025,180216,28579,28538,2766,31304,730
2021-05-18,Inyo,027,18085,1403,1401,12,1413,36
2021-05-18,Kern,029,883053,97175,96128,10883,107011,1315
2021-05-18,Kings,031,150075,23145,22916,1092,24008,247
2021-05-18,Lake,033,64148,3512,3495,9,3504,43
2021-05-18,Lassen,035,31185,5200,5157,111,5268,6
2021-05-18,Los Angeles,037,10098052,1204420,1196668,41698,1238366,24133
2021-05-18,Madera,039,155013,16593,16491,935,17426,238
2021-05-18,Marin,041,260295,14077,14026,254,14280,227
2021-05-18,Mariposa,043,17540,429,424,11,435,5
2021-05-18,Mendocino,045,87422,3958,3877,80,3957,47
2021-05-18,Merced,047,269075,30932,31036,1054,32090,452
2021-05-18,Modoc,049,8938,375,364,126,490,3
2021-05-18,Mono,051,14174,1258,1265,17,1282,3
2021-05-18,Monterey,053,433212,43149,43001,1875,44876,379
2021-05-18,Napa,055,140530,9893,9905,36,9941,82
2021-05-18,Nevada,057,99092,4798,4762,189,4951,70
2021-05-18,Orange,059,3164182,255177,254041,11337,265378,5031
2021-05-18,Placer,061,380077,23175,22726,1495,24221,291
2021-05-18,Plumas,063,18699,700,682,10,692,4
2021-05-18,Riverside,065,2383286,293907,288354,14019,302373,4438
2021-05-18,Sacramento,067,1510023,105557,105083,1740,106823,1629
2021-05-18,San Benito,069,59416,6060,6065,115,6180,63
2021-05-18,San Bernardino,071,2135413,293108,292014,8985,300999,4722
2021-05-18,San Diego,073,3302833,280169,279254,14876,294130,3742
2021-05-18,San Francisco,075,870044,36657,36818,1287,38105,546
2021-05-18,San Joaquin,077,732212,72924,72282,3550,75832,1368
2021-05-18,San Luis Obispo,079,281455,21331,21080,736,21816,256
2021-05-18,San Mateo,081,765935,42318,42099,470,42569,428
2021-05-18,Santa Barbara,083,443738,34403,34278,1138,35416,459
2021-05-18,Santa Clara,085,1922200,118453,119171,762,119933,2014
2021-05-18,Santa Cruz,087,273765,16200,16137,813,16950,207
2021-05-18,Shasta,089,179085,12208,12197,1551,13748,200
2021-05-18,Sierra,091,2930,56,54,12,66,0
2021-05-18,Siskiyou,093,43540,1909,1799,355,2154,16
2021-05-18,Solano,095,438530,32694,32644,551,33195,253
2021-05-18,Sonoma,097,501317,29952,30054,332,30386,321
2021-05-18,Stanislaus,099,539301,56161,55860,5941,61801,959
2021-05-18,Sutter,101,95872,9425,9453,86,9539,113
2021-05-18,Tehama,103,63373,5052,5020,568,5588,63
2021-05-18,Trinity,105,12862,483,329,91,420,3
2021-05-18,Tulare,107,460477,50174,49142,9029,58171,836
2021-05-18,Tuolumne,109,53932,4008,4073,39,4112,64
2021-05-18,Ventura,111,848112,81287,80726,2985,83711,1017
2021-05-18,Yolo,113,214977,13957,13951,313,14264,211
2021-05-18,Yuba,115,75493,6023,5989,123,6112,49
2021-05-17,Alameda,001,1643700,87881,87766,1955,89721,1253
2021-05-17,Alpine,003,1148,87,88,0,88,0
2021-05-17,Amador,005,37829,3668,3668,33,3701,46
2021-05-17,Butte,007,227075,12471,12144,1813,13957,192
2021-05-17,Calaveras,009,45235,2140,2131,14,2145,53
2021-05-17,Colusa,011,21464,1940,1943,306,2249,14
2021-05-17,Contra Costa,013,1133247,69300,68720,1270,69990,805
2021-05-17,Del Norte,015,27424,1402,1369,12,1381,8
2021-05-17,El Dorado,017,186661,10237,10163,725,10888,112
2021-05-17,Fresno,019,978130,102540,102013,8710,110723,1690
2021-05-17,Glenn,021,27897,2423,2401,561,2962,17
2021-05-17,Humboldt,023,135768,4169,4112,34,4146,42
2021-05-17,Imperial,025,180216,28573,28533,2764,31297,729
2021-05-17,Inyo,027,18085,1403,1401,12,1413,36
2021-05-17,Kern,029,883053,97146,96095,10866,106961,1315
2021-05-17,Kings,031,150075,23142,22918,1092,24010,246
2021-05-17,Lake,033,64148,3507,3489,9,3498,43
2021-05-17,Lassen,035,31185,5197,5156,110,5266,6
2021-05-17,Los Angeles,037,10098052,1204244,1196556,41692,1238248,24123
2021-05-17,Madera,039,155013,16586,16486,935,17421,238
2021-05-17,Marin,041,260295,14071,14021,254,14275,227
2021-05-17,Mariposa,043,17540,428,423,11,434,5
2021-05-17,Mendocino,045,87422,3949,3868,80,3948,46
2021-05-17,Merced,047,269075,30917,31031,1054,32085,450
2021-05-17,Modoc,049,8938,374,362,126,488,3
2021-05-17,Mono,051,14174,1254,1265,17,1282,3
2021-05-17,Monterey,053,433212,43142,42995,1875,44870,379
2021-05-17,Napa,055,140530,9892,9894,36,9930,82
2021-05-17,Nevada,057,99092,4794,4761,188,4949,70
2021-05-17,Orange,059,3164182,255130,253993,11330,265323,5031
2021-05-17,Placer,061,380077,23149,22706,1488,24194,289
2021-05-17,Plumas,063,18699,700,682,10,692,4
2021-05-17,Riverside,065,2383286,293838,288304,14015,302319,4433
2021-05-17,Sacramento,067,1510023,105449,105035,1738,106773,1629
2021-05-17,San Benito,069,59416,6057,6067,115,6182,63
2021-05-17,San Bernardino,071,2135413,293059,291989,8977,300966,4724
2021-05-17,San Diego,073,3302833,280037,279146,14854,294000,3742
2021-05-17,San Francisco,075,870044,36645,36816,1285,38101,546
2021-05-17,San Joaquin,077,732212,72886,72234,3547,75781,1359
2021-05-17,San Luis Obispo,079,281455,21322,21079,734,21813,256
2021-05-17,San Mateo,081,765935,42290,42083,470,42553,428
2021-05-17,Santa Barbara,083,443738,34396,34275,1138,35413,459
2021-05-17,Santa Clara,085,1922200,118416,119116,760,119876,2015
2021-05-17,Santa Cruz,087,273765,16197,16151,813,16964,206
2021-05-17,Shasta,089,179085,12186,12163,1550,13713,200
2021-05-17,Sierra,091,2930,56,54,12,66,0
2021-05-17,Siskiyou,093,43540,1900,1795,352,2147,15
2021-05-17,Solano,095,438530,32676,32627,550,33177,253
2021-05-17,Sonoma,097,501317,29929,30043,331,30374,321
2021-05-17,Stanislaus,099,539301,56116,55839,5934,61773,951
2021-05-17,Sutter,101,95872,9418,9447,86,9533,113
2021-05-17,Tehama,103,63373,5048,5016,567,5583,63
2021-05-17,Trinity,105,12862,483,328,91,419,3
2021-05-17,Tulare,107,460477,50152,49107,9023,58130,836
2021-05-17,Tuolumne,109,53932,4008,4071,39,4110,64
2021-05-17,Ventura,111,848112,81267,80699,2985,83684,1017
2021-05-17,Yolo,113,214977,13950,13941,313,14254,211
2021-05-17,Yuba,115,75493,6015,5987,123,6110,49
2021-05-16,Alameda,001,1643700,87817,87743,1955,89698,1253
2021-05-16,Alpine,003,1148,87,88,0,88,0
2021-05-16,Amador,005,37829,3667,3667,33,3700,46
2021-05-16,Butte,007,227075,12457,12140,1813,13953,192
2021-05-16,Calaveras,009,45235,2138,2129,14,2143,53
2021-05-16,Colusa,011,21464,1938,1943,306,2249,14
2021-05-16,Contra Costa,013,1133247,69232,68694,1267,69961,805
2021-05-16,Del Norte,015,27424,1399,1365,12,1377,8
2021-05-16,El Dorado,017,186661,10221,10159,724,10883,112
2021-05-16,Fresno,019,978130,102496,101987,8704,110691,1690
2021-05-16,Glenn,021,27897,2423,2401,560,2961,17
2021-05-16,Humboldt,023,135768,4154,4104,34,4138,42
2021-05-16,Imperial,025,180216,28562,28516,2763,31279,729
2021-05-16,Inyo,027,18085,1403,1401,12,1413,36
2021-05-16,Kern,029,883053,97113,96083,10846,106929,1315
2021-05-16,Kings,031,150075,23138,22918,1089,24007,246
2021-05-16,Lake,033,64148,3504,3489,9,3498,43
2021-05-16,Lassen,035,31185,5196,5156,110,5266,6
2021-05-16,Los Angeles,037,10098052,1204021,1196397,41676,1238073,24120
2021-05-16,Madera,039,155013,16581,16483,932,17415,238
2021-05-16,Marin,041,260295,14068,14015,254,14269,227
2021-05-16,Mariposa,043,17540,428,423,11,434,5
2021-05-16,Mendocino,045,87422,3939,3863,80,3943,46
2021-05-16,Merced,047,269075,30896,31023,1052,32075,450
2021-05-16,Modoc,049,8938,374,362,126,488,3
2021-05-16,Mono,051,14174,1254,1265,17,1282,3
2021-05-16,Monterey,053,433212,43137,42991,1875,44866,379
2021-05-16,Napa,055,140530,9889,9891,36,9927,82
2021-05-16,Nevada,057,99092,4790,4755,188,4943,70
2021-05-16,Orange,059,3164182,255098,253962,11327,265289,5031
2021-05-16,Placer,061,380077,23117,22696,1482,24178,289
2021-05-16,Plumas,063,18699,699,682,10,692,4
2021-05-16,Riverside,065,2383286,293762,288259,14007,302266,4433
2021-05-16,Sacramento,067,1510023,105335,105013,1736,106749,1628
2021-05-16,San Benito,069,59416,6056,6067,114,6181,63
2021-05-16,San Bernardino,071,2135413,292987,291940,8975,300915,4724
2021-05-16,San Diego,073,3302833,279919,279099,14841,293940,3742
2021-05-16,San Francisco,075,870044,36622,36808,1284,38092,546
2021-05-16,San Joaquin,077,732212,72837,72218,3542,75760,1359
2021-05-16,San Luis Obispo,079,281455,21314,21072,732,21804,256
2021-05-16,San Mateo,081,765935,42279,42063,469,42532,428
2021-05-16,Santa Barbara,083,443738,34389,34270,1138,35408,459
2021-05-16,Santa Clara,085,1922200,118387,119098,759,119857,2015
2021-05-16,Santa Cruz,087,273765,16195,16143,813,16956,206
2021-05-16,Shasta,089,179085,12170,12156,1546,13702,200
2021-05-16,Sierra,091,2930,56,54,12,66,0
2021-05-16,Siskiyou,093,43540,1896,1790,351,2141,15
2021-05-16,Solano,095,438530,32643,32619,548,33167,253
2021-05-16,Sonoma,097,501317,29910,30033,331,30364,321
2021-05-16,Stanislaus,099,539301,56067,55814,5922,61736,951
2021-05-16,Sutter,101,95872,9411,9445,86,9531,113
2021-05-16,Tehama,103,63373,5044,5013,566,5579,63
2021-05-16,Trinity,105,12862,483,328,91,419,3
2021-05-16,Tulare,107,460477,50135,49091,9020,58111,837
2021-05-16,Tuolumne,109,53932,4004,4070,39,4109,64
2021-05-16,Ventura,111,848112,81236,80689,2985,83674,1017
2021-05-16,Yolo,113,214977,13935,13938,313,14251,211
2021-05-16,Yuba,115,75493,6012,5987,123,6110,49
2021-05-15,Alameda,001,1643700,87791,87677,1954,89631,1252
2021-05-15,Alpine,003,1148,87,88,0,88,0
2021-05-15,Amador,005,37829,3667,3666,33,3699,46
2021-05-15,Butte,007,227075,12450,12095,1812,13907,192
2021-05-15,Calaveras,009,45235,2137,2126,14,2140,53
2021-05-15,Colusa,011,21464,1938,1941,304,2245,14
2021-05-15,Contra Costa,013,1133247,69186,68658,1267,69925,805
2021-05-15,Del Norte,015,27424,1394,1359,12,1371,8
2021-05-15,El Dorado,017,186661,10209,10156,723,10879,112
2021-05-15,Fresno,019,978130,102459,101957,8701,110658,1690
2021-05-15,Glenn,021,27897,2423,2400,560,2960,17
2021-05-15,Humboldt,023,135768,4144,4080,34,4114,42
2021-05-15,Imperial,025,180216,28559,28504,2762,31266,729
2021-05-15,Inyo,027,18085,1403,1402,12,1414,36
2021-05-15,Kern,029,883053,97099,96061,10831,106892,1315
2021-05-15,Kings,031,150075,23137,22913,1089,24002,246
2021-05-15,Lake,033,64148,3503,3485,9,3494,43
2021-05-15,Lassen,035,31185,5193,5156,109,5265,6
2021-05-15,Los Angeles,037,10098052,1203897,1196255,41663,1237918,24115
2021-05-15,Madera,039,155013,16578,16482,932,17414,238
2021-05-15,Marin,041,260295,14064,14012,254,14266,227
2021-05-15,Mariposa,043,17540,428,423,11,434,5
2021-05-15,Mendocino,045,87422,3936,3861,80,3941,46
2021-05-15,Merced,047,269075,30875,31012,1052,32064,450
2021-05-15,Modoc,049,8938,374,362,126,488,3
2021-05-15,Mono,051,14174,1254,1265,17,1282,3
2021-05-15,Monterey,053,433212,43133,42982,1875,44857,379
2021-05-15,Napa,055,140530,9886,9887,36,9923,82
2021-05-15,Nevada,057,99092,4789,4755,188,4943,70
2021-05-15,Orange,059,3164182,255071,253919,11320,265239,5030
2021-05-15,Placer,061,380077,23096,22688,1482,24170,289
2021-05-15,Plumas,063,18699,699,681,10,691,4
2021-05-15,Riverside,065,2383286,293720,288203,14002,302205,4433
2021-05-15,Sacramento,067,1510023,105263,104929,1733,106662,1628
2021-05-15,San Benito,069,59416,6056,6066,114,6180,63
2021-05-15,San Bernardino,071,2135413,292945,291892,8973,300865,4724
2021-05-15,San Diego,073,3302833,279848,278991,14826,293817,3737
2021-05-15,San Francisco,075,870044,36606,36795,1282,38077,546
2021-05-15,San Joaquin,077,732212,72811,72197,3540,75737,1359
2021-05-15,San Luis Obispo,079,281455,21311,21061,731,21792,256
2021-05-15,San Mateo,081,765935,42263,42059,469,42528,428
2021-05-15,Santa Barbara,083,443738,34381,34259,1138,35397,459
2021-05-15,Santa Clara,085,1922200,118366,119060,759,119819,2016
2021-05-15,Santa Cruz,087,273765,16191,16137,813,16950,206
2021-05-15,Shasta,089,179085,12158,12152,1543,13695,200
2021-05-15,Sierra,091,2930,56,54,12,66,0
2021-05-15,Siskiyou,093,43540,1890,1788,349,2137,15
2021-05-15,Solano,095,438530,32634,32604,547,33151,253
2021-05-15,Sonoma,097,501317,29891,30020,331,30351,321
2021-05-15,Stanislaus,099,539301,56038,55795,5915,61710,952
2021-05-15,Sutter,101,95872,9409,9436,86,9522,113
2021-05-15,Tehama,103,63373,5040,5012,565,5577,63
2021-05-15,Trinity,105,12862,483,328,91,419,3
2021-05-15,Tulare,107,460477,50125,49080,9016,58096,837
2021-05-15,Tuolumne,109,53932,4002,4064,39,4103,63
2021-05-15,Ventura,111,848112,81225,80662,2985,83647,1017
2021-05-15,Yolo,113,214977,13928,13932,312,14244,211
2021-05-15,Yuba,115,75493,6009,5979,122,6101,49
2021-05-14,Alameda,001,1643700,87757,87621,1951,89572,1249
2021-05-14,Alpine,003,1148,87,88,0,88,0
2021-05-14,Amador,005,37829,3667,3665,33,3698,46
2021-05-14,Butte,007,227075,12441,12076,1809,13885,192
2021-05-14,Calaveras,009,45235,2133,2121,14,2135,53
2021-05-14,Colusa,011,21464,1937,1940,303,2243,14
2021-05-14,Contra Costa,013,1133247,69144,68589,1265,69854,806
2021-05-14,Del Norte,015,27424,1394,1355,12,1367,8
2021-05-14,El Dorado,017,186661,10202,10143,722,10865,113
2021-05-14,Fresno,019,978130,102430,101917,8695,110612,1688
2021-05-14,Glenn,021,27897,2422,2398,560,2958,17
2021-05-14,Humboldt,023,135768,4137,4050,34,4084,37
2021-05-14,Imperial,025,180216,28552,28485,2761,31246,728
2021-05-14,Inyo,027,18085,1403,1400,12,1412,36
2021-05-14,Kern,029,883053,97069,96033,10822,106855,1311
2021-05-14,Kings,031,150075,23136,22910,1089,23999,246
2021-05-14,Lake,033,64148,3499,3483,9,3492,43
2021-05-14,Lassen,035,31185,5193,5154,109,5263,6
2021-05-14,Los Angeles,037,10098052,1203763,1196038,41658,1237696,24101
2021-05-14,Madera,039,155013,16575,16474,932,17406,238
2021-05-14,Marin,041,260295,14060,14010,254,14264,227
2021-05-14,Mariposa,043,17540,428,422,11,433,5
2021-05-14,Mendocino,045,87422,3934,3855,80,3935,46
2021-05-14,Merced,047,269075,30865,31010,1052,32062,450
2021-05-14,Modoc,049,8938,374,362,126,488,3
2021-05-14,Mono,051,14174,1253,1265,17,1282,3
2021-05-14,Monterey,053,433212,43128,42973,1875,44848,380
2021-05-14,Napa,055,140530,9883,9883,36,9919,82
2021-05-14,Nevada,057,99092,4784,4745,188,4933,70
2021-05-14,Orange,059,3164182,255037,253855,11313,265168,5028
2021-05-14,Placer,061,380077,23077,22660,1476,24136,287
2021-05-14,Plumas,063,18699,698,680,10,690,4
2021-05-14,Riverside,065,2383286,293670,288140,13999,302139,4433
2021-05-14,Sacramento,067,1510023,105174,104828,1732,106560,1627
2021-05-14,San Benito,069,59416,6056,6064,114,6178,63
2021-05-14,San Bernardino,071,2135413,292897,291834,8973,300807,4721
2021-05-14,San Diego,073,3302833,279775,278853,14815,293668,3732
2021-05-14,San Francisco,075,870044,36597,36771,1278,38049,545
2021-05-14,San Joaquin,077,732212,72779,72160,3533,75693,1359
2021-05-14,San Luis Obispo,079,281455,21307,21051,731,21782,256
2021-05-14,San Mateo,081,765935,42252,42041,469,42510,428
2021-05-14,Santa Barbara,083,443738,34371,34243,1138,35381,456
2021-05-14,Santa Clara,085,1922200,118337,119006,759,119765,2014
2021-05-14,Santa Cruz,087,273765,16186,16130,813,16943,207
2021-05-14,Shasta,089,179085,12152,12130,1538,13668,200
2021-05-14,Sierra,091,2930,56,54,12,66,0
2021-05-14,Siskiyou,093,43540,1883,1779,348,2127,14
2021-05-14,Solano,095,438530,32614,32585,546,33131,252
2021-05-14,Sonoma,097,501317,29872,30007,331,30338,321
2021-05-14,Stanislaus,099,539301,56005,55752,5909,61661,950
2021-05-14,Sutter,101,95872,9400,9433,84,9517,113
2021-05-14,Tehama,103,63373,5033,5005,565,5570,63
2021-05-14,Trinity,105,12862,483,328,91,419,3
2021-05-14,Tulare,107,460477,50108,49060,9011,58071,836
2021-05-14,Tuolumne,109,53932,4002,4060,39,4099,63
2021-05-14,Ventura,111,848112,81211,80628,2985,83613,1014
2021-05-14,Yolo,113,214977,13923,13922,308,14230,210
2021-05-14,Yuba,115,75493,6005,5970,122,6092,47
2021-05-13,Alameda,001,1643700,87714,87557,1950,89507,1250
2021-05-13,Alpine,003,1148,87,88,0,88,0
2021-05-13,Amador,005,37829,3667,3662,33,3695,46
2021-05-13,Butte,007,227075,12426,12051,1808,13859,196
2021-05-13,Calaveras,009,45235,2133,2120,14,2134,53
2021-05-13,Colusa,011,21464,1936,1939,299,2238,14
2021-05-13,Contra Costa,013,1133247,69095,68522,1264,69786,806
2021-05-13,Del Norte,015,27424,1392,1354,12,1366,8
2021-05-13,El Dorado,017,186661,10199,10133,722,10855,112
2021-05-13,Fresno,019,978130,102401,101862,8694,110556,1687
2021-05-13,Glenn,021,27897,2421,2395,560,2955,17
2021-05-13,Humboldt,023,135768,4119,4027,34,4061,37
2021-05-13,Imperial,025,180216,28537,28468,2759,31227,729
2021-05-13,Inyo,027,18085,1403,1400,12,1412,36
2021-05-13,Kern,029,883053,97045,95996,10804,106800,1311
2021-05-13,Kings,031,150075,23135,22904,1089,23993,246
2021-05-13,Lake,033,64148,3498,3479,9,3488,43
2021-05-13,Lassen,035,31185,5193,5152,108,5260,6
2021-05-13,Los Angeles,037,10098052,1203575,1195504,41643,1237147,24083
2021-05-13,Madera,039,155013,16567,16467,932,17399,238
2021-05-13,Marin,041,260295,14055,14004,252,14256,227
2021-05-13,Mariposa,043,17540,428,422,11,433,5
2021-05-13,Mendocino,045,87422,3930,3846,80,3926,46
2021-05-13,Merced,047,269075,30858,30989,1051,32040,450
2021-05-13,Modoc,049,8938,374,362,126,488,3
2021-05-13,Mono,051,14174,1253,1265,17,1282,3
2021-05-13,Monterey,053,433212,43113,42966,1875,44841,380
2021-05-13,Napa,055,140530,9876,9877,36,9913,82
2021-05-13,Nevada,057,99092,4780,4743,187,4930,70
2021-05-13,Orange,059,3164182,254992,253778,11311,265089,5026
2021-05-13,Placer,061,380077,23053,22668,1469,24137,288
2021-05-13,Plumas,063,18699,698,680,10,690,4
2021-05-13,Riverside,065,2383286,293604,288067,13994,302061,4433
2021-05-13,Sacramento,067,1510023,105088,104711,1730,106441,1626
2021-05-13,San Benito,069,59416,6054,6062,114,6176,63
2021-05-13,San Bernardino,071,2135413,292831,291765,8973,300738,4722
2021-05-13,San Diego,073,3302833,279661,278592,14798,293390,3729
2021-05-13,San Francisco,075,870044,36573,36741,1276,38017,544
2021-05-13,San Joaquin,077,732212,72737,72096,3529,75625,1357
2021-05-13,San Luis Obispo,079,281455,21292,21043,730,21773,255
2021-05-13,San Mateo,081,765935,42235,42059,469,42528,426
2021-05-13,Santa Barbara,083,443738,34359,34242,1138,35380,456
2021-05-13,Santa Clara,085,1922200,118310,118952,759,119711,2013
2021-05-13,Santa Cruz,087,273765,16180,16129,813,16942,208
2021-05-13,Shasta,089,179085,12132,12111,1534,13645,200
2021-05-13,Sierra,091,2930,56,54,12,66,0
2021-05-13,Siskiyou,093,43540,1876,1769,345,2114,14
2021-05-13,Solano,095,438530,32601,32548,544,33092,252
2021-05-13,Sonoma,097,501317,29847,29991,331,30322,321
2021-05-13,Stanislaus,099,539301,55968,55678,5903,61581,949
2021-05-13,Sutter,101,95872,9395,9431,83,9514,112
2021-05-13,Tehama,103,63373,5028,4997,565,5562,63
2021-05-13,Trinity,105,12862,482,327,90,417,3
2021-05-13,Tulare,107,460477,50082,49032,9003,58035,837
2021-05-13,Tuolumne,109,53932,4001,4059,39,4098,63
2021-05-13,Ventura,111,848112,81181,80615,2984,83599,1012
2021-05-13,Yolo,113,214977,13914,13914,306,14220,210
2021-05-13,Yuba,115,75493,5996,5962,122,6084,47
2021-05-12,Alameda,001,1643700,87681,87482,1948,89430,1261
2021-05-12,Alpine,003,1148,87,88,0,88,0
2021-05-12,Amador,005,37829,3667,3658,33,3691,46
2021-05-12,Butte,007,227075,12416,12026,1808,13834,199
2021-05-12,Calaveras,009,45235,2130,2119,14,2133,53
2021-05-12,Colusa,011,21464,1934,1939,298,2237,14
2021-05-12,Contra Costa,013,1133247,69036,68462,1258,69720,805
2021-05-12,Del Norte,015,27424,1390,1352,12,1364,8
2021-05-12,El Dorado,017,186661,10190,10123,722,10845,112
2021-05-12,Fresno,019,978130,102352,101838,8683,110521,1688
2021-05-12,Glenn,021,27897,2418,2391,560,2951,17
2021-05-12,Humboldt,023,135768,4091,3982,34,4016,37
2021-05-12,Imperial,025,180216,28519,28443,2756,31199,726
2021-05-12,Inyo,027,18085,1403,1400,12,1412,36
2021-05-12,Kern,029,883053,97009,95955,10797,106752,1310
2021-05-12,Kings,031,150075,23133,22896,1089,23985,246
2021-05-12,Lake,033,64148,3496,3476,9,3485,43
2021-05-12,Lassen,035,31185,5191,5151,108,5259,6
2021-05-12,Los Angeles,037,10098052,1203393,1195318,41626,1236944,24067
2021-05-12,Madera,039,155013,16560,16462,931,17393,238
2021-05-12,Marin,041,260295,14050,13997,252,14249,227
2021-05-12,Mariposa,043,17540,428,422,11,433,5
2021-05-12,Mendocino,045,87422,3920,3836,80,3916,46
2021-05-12,Merced,047,269075,30842,30941,1051,31992,450
2021-05-12,Modoc,049,8938,373,362,126,488,3
2021-05-12,Mono,051,14174,1253,1265,17,1282,3
2021-05-12,Monterey,053,433212,43101,42950,1874,44824,380
2021-05-12,Napa,055,140530,9870,9870,36,9906,82
2021-05-12,Nevada,057,99092,4776,4738,187,4925,70
2021-05-12,Orange,059,3164182,254941,253587,11308,264895,5024
2021-05-12,Placer,061,380077,23035,22652,1462,24114,288
2021-05-12,Plumas,063,18699,698,681,10,691,4
2021-05-12,Riverside,065,2383286,293534,287830,13990,301820,4431
2021-05-12,Sacramento,067,1510023,104992,104592,1728,106320,1621
2021-05-12,San Benito,069,59416,6054,6062,114,6176,63
2021-05-12,San Bernardino,071,2135413,292783,291505,8968,300473,4715
2021-05-12,San Diego,073,3302833,279556,278402,14777,293179,3729
2021-05-12,San Francisco,075,870044,36553,36720,1275,37995,544
2021-05-12,San Joaquin,077,732212,72683,72043,3525,75568,1356
2021-05-12,San Luis Obispo,079,281455,21282,21021,730,21751,255
2021-05-12,San Mateo,081,765935,42226,42038,467,42505,426
2021-05-12,Santa Barbara,083,443738,34351,34218,1138,35356,456
2021-05-12,Santa Clara,085,1922200,118267,118897,759,119656,2005
2021-05-12,Santa Cruz,087,273765,16174,16123,813,16936,207
2021-05-12,Shasta,089,179085,12112,12092,1532,13624,200
2021-05-12,Sierra,091,2930,56,54,12,66,0
2021-05-12,Siskiyou,093,43540,1872,1760,344,2104,13
2021-05-12,Solano,095,438530,32577,32519,544,33063,252
2021-05-12,Sonoma,097,501317,29835,29976,331,30307,320
2021-05-12,Stanislaus,099,539301,55928,55632,5896,61528,919
2021-05-12,Sutter,101,95872,9392,9427,83,9510,112
2021-05-12,Tehama,103,63373,5023,4989,565,5554,62
2021-05-12,Trinity,105,12862,482,327,90,417,3
2021-05-12,Tulare,107,460477,50066,49001,8995,57996,838
2021-05-12,Tuolumne,109,53932,4000,4056,39,4095,63
2021-05-12,Ventura,111,848112,81162,80577,2984,83561,1010
2021-05-12,Yolo,113,214977,13907,13910,305,14215,210
2021-05-12,Yuba,115,75493,5993,5956,122,6078,47
2021-05-11,Alameda,001,1643700,87616,87413,1944,89357,1290
2021-05-11,Alpine,003,1148,87,88,0,88,0
2021-05-11,Amador,005,37829,3665,3657,33,3690,46
2021-05-11,Butte,007,227075,12401,12008,1805,13813,199
2021-05-11,Calaveras,009,45235,2130,2118,14,2132,52
2021-05-11,Colusa,011,21464,1933,1939,298,2237,14
2021-05-11,Contra Costa,013,1133247,68976,68406,1257,69663,806
2021-05-11,Del Norte,015,27424,1388,1347,12,1359,8
2021-05-11,El Dorado,017,186661,10184,10108,721,10829,112
2021-05-11,Fresno,019,978130,102306,101792,8678,110470,1686
2021-05-11,Glenn,021,27897,2417,2387,559,2946,17
2021-05-11,Humboldt,023,135768,4070,3964,33,3997,37
2021-05-11,Imperial,025,180216,28511,28413,2752,31165,722
2021-05-11,Inyo,027,18085,1402,1402,12,1414,36
2021-05-11,Kern,029,883053,96981,95938,10784,106722,1310
2021-05-11,Kings,031,150075,23125,22887,1089,23976,246
2021-05-11,Lake,033,64148,3496,3473,9,3482,43
2021-05-11,Lassen,035,31185,5189,5148,108,5256,6
2021-05-11,Los Angeles,037,10098052,1203153,1195100,41610,1236710,24048
2021-05-11,Madera,039,155013,16556,16459,930,17389,238
2021-05-11,Marin,041,260295,14043,13987,252,14239,227
2021-05-11,Mariposa,043,17540,428,421,11,432,5
2021-05-11,Mendocino,045,87422,3912,3821,80,3901,46
2021-05-11,Merced,047,269075,30833,30893,1051,31944,449
2021-05-11,Modoc,049,8938,373,362,125,487,3
2021-05-11,Mono,051,14174,1253,1265,17,1282,3
2021-05-11,Monterey,053,433212,43093,42934,1873,44807,380
2021-05-11,Napa,055,140530,9863,9870,36,9906,81
2021-05-11,Nevada,057,99092,4772,4737,187,4924,70
2021-05-11,Orange,059,3164182,254878,253545,11300,264845,5017
2021-05-11,Placer,061,380077,23013,22615,1458,24073,287
2021-05-11,Plumas,063,18699,696,679,10,689,4
2021-05-11,Riverside,065,2383286,293472,287757,13985,301742,4429
2021-05-11,Sacramento,067,1510023,104893,104496,1725,106221,1616
2021-05-11,San Benito,069,59416,6051,6058,114,6172,63
2021-05-11,San Bernardino,071,2135413,292723,291421,8966,300387,4707
2021-05-11,San Diego,073,3302833,279421,278308,14758,293066,3725
2021-05-11,San Francisco,075,870044,36533,36707,1275,37982,543
2021-05-11,San Joaquin,077,732212,72635,71999,3522,75521,1356
2021-05-11,San Luis Obispo,079,281455,21275,21008,728,21736,255
2021-05-11,San Mateo,081,765935,42207,41985,466,42451,425
2021-05-11,Santa Barbara,083,443738,34341,34207,1138,35345,456
2021-05-11,Santa Clara,085,1922200,118220,118857,758,119615,2005
2021-05-11,Santa Cruz,087,273765,16170,16113,813,16926,206
2021-05-11,Shasta,089,179085,12089,12050,1526,13576,200
2021-05-11,Sierra,091,2930,56,54,12,66,0
2021-05-11,Siskiyou,093,43540,1862,1756,342,2098,13
2021-05-11,Solano,095,438530,32559,32499,542,33041,250
2021-05-11,Sonoma,097,501317,29820,29966,331,30297,318
2021-05-11,Stanislaus,099,539301,55881,55589,5892,61481,909
2021-05-11,Sutter,101,95872,9385,9417,83,9500,112
2021-05-11,Tehama,103,63373,5019,4985,564,5549,62
2021-05-11,Trinity,105,12862,482,327,89,416,3
2021-05-11,Tulare,107,460477,50039,48974,8981,57955,837
2021-05-11,Tuolumne,109,53932,3999,4056,39,4095,63
2021-05-11,Ventura,111,848112,81138,80544,2981,83525,1008
2021-05-11,Yolo,113,214977,13894,13902,302,14204,210
2021-05-11,Yuba,115,75493,5984,5950,122,6072,46
2021-05-10,Alameda,001,1643700,87546,87366,1943,89309,1284
2021-05-10,Alpine,003,1148,87,88,0,88,0
2021-05-10,Amador,005,37829,3664,3657,33,3690,46
2021-05-10,Butte,007,227075,12385,11993,1801,13794,199
2021-05-10,Calaveras,009,45235,2123,2118,14,2132,52
2021-05-10,Colusa,011,21464,1933,1939,298,2237,14
2021-05-10,Contra Costa,013,1133247,68912,68357,1257,69614,806
2021-05-10,Del Norte,015,27424,1385,1339,12,1351,8
2021-05-10,El Dorado,017,186661,10170,10093,721,10814,113
2021-05-10,Fresno,019,978130,102274,101755,8671,110426,1682
2021-05-10,Glenn,021,27897,2416,2384,557,2941,17
2021-05-10,Humboldt,023,135768,4040,3961,33,3994,36
2021-05-10,Imperial,025,180216,28497,28397,2748,31145,722
2021-05-10,Inyo,027,18085,1402,1401,12,1413,36
2021-05-10,Kern,029,883053,96938,95920,10770,106690,1310
2021-05-10,Kings,031,150075,23114,22884,1088,23972,246
2021-05-10,Lake,033,64148,3488,3471,9,3480,43
2021-05-10,Lassen,035,31185,5185,5148,108,5256,5
2021-05-10,Los Angeles,037,10098052,1202890,1194976,41594,1236570,24030
2021-05-10,Madera,039,155013,16546,16450,930,17380,238
2021-05-10,Marin,041,260295,14040,13981,252,14233,228
2021-05-10,Mariposa,043,17540,427,420,11,431,5
2021-05-10,Mendocino,045,87422,3906,3818,80,3898,46
2021-05-10,Merced,047,269075,30822,30880,1051,31931,448
2021-05-10,Modoc,049,8938,373,361,125,486,3
2021-05-10,Mono,051,14174,1253,1265,17,1282,3
2021-05-10,Monterey,053,433212,43087,42927,1868,44795,380
2021-05-10,Napa,055,140530,9861,9860,36,9896,81
2021-05-10,Nevada,057,99092,4765,4735,187,4922,70
2021-05-10,Orange,059,3164182,254825,253484,11294,264778,5008
2021-05-10,Placer,061,380077,22991,22590,1455,24045,286
2021-05-10,Plumas,063,18699,695,679,10,689,4
2021-05-10,Riverside,065,2383286,293403,287689,13979,301668,4427
2021-05-10,Sacramento,067,1510023,104780,104378,1720,106098,1613
2021-05-10,San Benito,069,59416,6050,6058,114,6172,63
2021-05-10,San Bernardino,071,2135413,292671,291360,8965,300325,4707
2021-05-10,San Diego,073,3302833,279256,278183,14731,292914,3725
2021-05-10,San Francisco,075,870044,36514,36683,1275,37958,543
2021-05-10,San Joaquin,077,732212,72598,71954,3507,75461,1356
2021-05-10,San Luis Obispo,079,281455,21257,20993,727,21720,256
2021-05-10,San Mateo,081,765935,42189,41926,466,42392,424
2021-05-10,Santa Barbara,083,443738,34333,34201,1138,35339,456
2021-05-10,Santa Clara,085,1922200,118161,118822,758,119580,2003
2021-05-10,Santa Cruz,087,273765,16165,16114,813,16927,206
2021-05-10,Shasta,089,179085,12075,12036,1522,13558,200
2021-05-10,Sierra,091,2930,56,54,12,66,0
2021-05-10,Siskiyou,093,43540,1852,1752,340,2092,13
2021-05-10,Solano,095,438530,32539,32466,540,33006,250
2021-05-10,Sonoma,097,501317,29805,29955,330,30285,318
2021-05-10,Stanislaus,099,539301,55807,55541,5886,61427,898
2021-05-10,Sutter,101,95872,9379,9412,83,9495,111
2021-05-10,Tehama,103,63373,5015,4980,564,5544,62
2021-05-10,Trinity,105,12862,482,327,87,414,3
2021-05-10,Tulare,107,460477,50015,48956,8975,57931,837
2021-05-10,Tuolumne,109,53932,3995,4054,38,4092,63
2021-05-10,Ventura,111,848112,81122,80501,2979,83480,1008
2021-05-10,Yolo,113,214977,13882,13898,300,14198,209
2021-05-10,Yuba,115,75493,5982,5942,122,6064,46
2021-05-09,Alameda,001,1643700,87475,87292,1940,89232,1284
2021-05-09,Alpine,003,1148,87,88,0,88,0
2021-05-09,Amador,005,37829,3662,3655,33,3688,46
2021-05-09,Butte,007,227075,12367,11985,1797,13782,199
2021-05-09,Calaveras,009,45235,2122,2116,14,2130,52
2021-05-09,Colusa,011,21464,1932,1940,298,2238,14
2021-05-09,Contra Costa,013,1133247,68849,68302,1255,69557,806
2021-05-09,Del Norte,015,27424,1378,1338,12,1350,8
2021-05-09,El Dorado,017,186661,10156,10089,718,10807,113
2021-05-09,Fresno,019,978130,102236,101729,8662,110391,1682
2021-05-09,Glenn,021,27897,2409,2382,554,2936,17
2021-05-09,Humboldt,023,135768,4020,3950,33,3983,36
2021-05-09,Imperial,025,180216,28474,28388,2740,31128,722
2021-05-09,Inyo,027,18085,1402,1401,11,1412,36
2021-05-09,Kern,029,883053,96910,95903,10760,106663,1310
2021-05-09,Kings,031,150075,23105,22878,1088,23966,246
2021-05-09,Lake,033,64148,3484,3471,9,3480,43
2021-05-09,Lassen,035,31185,5183,5147,108,5255,5
2021-05-09,Los Angeles,037,10098052,1202629,1194820,41578,1236398,24026
2021-05-09,Madera,039,155013,16537,16444,924,17368,238
2021-05-09,Marin,041,260295,14029,13979,251,14230,228
2021-05-09,Mariposa,043,17540,424,420,11,431,5
2021-05-09,Mendocino,045,87422,3896,3814,80,3894,46
2021-05-09,Merced,047,269075,30799,30883,1051,31934,448
2021-05-09,Modoc,049,8938,373,360,125,485,3
2021-05-09,Mono,051,14174,1253,1264,17,1281,3
2021-05-09,Monterey,053,433212,43069,42918,1868,44786,380
2021-05-09,Napa,055,140530,9850,9857,36,9893,81
2021-05-09,Nevada,057,99092,4758,4727,187,4914,70
2021-05-09,Orange,059,3164182,254771,253451,11286,264737,5008
2021-05-09,Placer,061,380077,22965,22566,1452,24018,286
2021-05-09,Plumas,063,18699,694,679,10,689,4
2021-05-09,Riverside,065,2383286,293323,287644,13973,301617,4427
2021-05-09,Sacramento,067,1510023,104631,104309,1714,106023,1612
2021-05-09,San Benito,069,59416,6048,6056,114,6170,63
2021-05-09,San Bernardino,071,2135413,292588,291337,8959,300296,4707
2021-05-09,San Diego,073,3302833,279089,277950,14709,292659,3725
2021-05-09,San Francisco,075,870044,36488,36669,1273,37942,543
2021-05-09,San Joaquin,077,732212,72552,71927,3506,75433,1356
2021-05-09,San Luis Obispo,079,281455,21246,20999,727,21726,256
2021-05-09,San Mateo,081,765935,42160,41903,466,42369,424
2021-05-09,Santa Barbara,083,443738,34320,34196,1137,35333,456
2021-05-09,Santa Clara,085,1922200,118107,118798,757,119555,2003
2021-05-09,Santa Cruz,087,273765,16159,16094,813,16907,206
2021-05-09,Shasta,089,179085,12045,12034,1517,13551,200
2021-05-09,Sierra,091,2930,56,54,12,66,0
2021-05-09,Siskiyou,093,43540,1845,1741,337,2078,13
2021-05-09,Solano,095,438530,32500,32434,537,32971,250
2021-05-09,Sonoma,097,501317,29791,29953,329,30282,318
2021-05-09,Stanislaus,099,539301,55741,55511,5882,61393,898
2021-05-09,Sutter,101,95872,9373,9413,83,9496,111
2021-05-09,Tehama,103,63373,5010,4979,564,5543,62
2021-05-09,Trinity,105,12862,482,327,87,414,3
2021-05-09,Tulare,107,460477,49988,48948,8970,57918,837
2021-05-09,Tuolumne,109,53932,3993,4053,38,4091,63
2021-05-09,Ventura,111,848112,81107,80487,2978,83465,1008
2021-05-09,Yolo,113,214977,13872,13897,299,14196,209
2021-05-09,Yuba,115,75493,5976,5934,122,6056,46
2021-05-08,Alameda,001,1643700,87433,87213,1936,89149,1284
2021-05-08,Alpine,003,1148,87,88,0,88,0
2021-05-08,Amador,005,37829,3660,3652,33,3685,46
2021-05-08,Butte,007,227075,12355,11962,1796,13758,199
2021-05-08,Calaveras,009,45235,2121,2114,14,2128,52
2021-05-08,Colusa,011,21464,1932,1939,298,2237,14
2021-05-08,Contra Costa,013,1133247,68816,68223,1253,69476,803
2021-05-08,Del Norte,015,27424,1375,1335,12,1347,8
2021-05-08,El Dorado,017,186661,10142,10079,718,10797,113
2021-05-08,Fresno,019,978130,102200,101676,8657,110333,1682
2021-05-08,Glenn,021,27897,2407,2382,552,2934,17
2021-05-08,Humboldt,023,135768,4004,3939,33,3972,36
2021-05-08,Imperial,025,180216,28466,28373,2740,31113,721
2021-05-08,Inyo,027,18085,1402,1402,11,1413,36
2021-05-08,Kern,029,883053,96885,95880,10747,106627,1310
2021-05-08,Kings,031,150075,23102,22872,1087,23959,246
2021-05-08,Lake,033,64148,3483,3470,9,3479,43
2021-05-08,Lassen,035,31185,5182,5145,108,5253,5
2021-05-08,Los Angeles,037,10098052,1202478,1194584,41562,1236146,24022
2021-05-08,Madera,039,155013,16533,16442,924,17366,238
2021-05-08,Marin,041,260295,14026,13974,250,14224,228
2021-05-08,Mariposa,043,17540,424,420,11,431,5
2021-05-08,Mendocino,045,87422,3891,3810,79,3889,46
2021-05-08,Merced,047,269075,30790,30876,1051,31927,448
2021-05-08,Modoc,049,8938,373,360,124,484,3
2021-05-08,Mono,051,14174,1253,1262,17,1279,3
2021-05-08,Monterey,053,433212,43064,42914,1867,44781,380
2021-05-08,Napa,055,140530,9843,9853,36,9889,81
2021-05-08,Nevada,057,99092,4755,4716,187,4903,70
2021-05-08,Orange,059,3164182,254737,253412,11283,264695,5006
2021-05-08,Placer,061,380077,22947,22547,1450,23997,286
2021-05-08,Plumas,063,18699,693,679,10,689,4
2021-05-08,Riverside,065,2383286,293280,287574,13971,301545,4427
2021-05-08,Sacramento,067,1510023,104546,104208,1711,105919,1610
2021-05-08,San Benito,069,59416,6047,6048,114,6162,63
2021-05-08,San Bernardino,071,2135413,292545,291296,8959,300255,4707
2021-05-08,San Diego,073,3302833,279004,277760,14691,292451,3725
2021-05-08,San Francisco,075,870044,36465,36642,1273,37915,543
2021-05-08,San Joaquin,077,732212,72523,71869,3497,75366,1356
2021-05-08,San Luis Obispo,079,281455,21235,20992,727,21719,256
2021-05-08,San Mateo,081,765935,42149,41871,466,42337,424
2021-05-08,Santa Barbara,083,443738,34307,34185,1137,35322,456
2021-05-08,Santa Clara,085,1922200,118076,118751,757,119508,2003
2021-05-08,Santa Cruz,087,273765,16156,16089,813,16902,206
2021-05-08,Shasta,089,179085,12035,12030,1513,13543,200
2021-05-08,Sierra,091,2930,56,54,12,66,0
2021-05-08,Siskiyou,093,43540,1844,1741,333,2074,13
2021-05-08,Solano,095,438530,32476,32395,535,32930,249
2021-05-08,Sonoma,097,501317,29778,29942,329,30271,318
2021-05-08,Stanislaus,099,539301,55710,55467,5878,61345,898
2021-05-08,Sutter,101,95872,9370,9413,83,9496,111
2021-05-08,Tehama,103,63373,5008,4977,564,5541,62
2021-05-08,Trinity,105,12862,482,327,87,414,3
2021-05-08,Tulare,107,460477,49974,48929,8960,57889,837
2021-05-08,Tuolumne,109,53932,3992,4050,38,4088,63
2021-05-08,Ventura,111,848112,81096,80481,2975,83456,1008
2021-05-08,Yolo,113,214977,13869,13894,298,14192,209
2021-05-08,Yuba,115,75493,5968,5928,122,6050,46
2021-05-07,Alameda,001,1643700,87379,87128,1935,89063,1280
2021-05-07,Alpine,003,1148,87,88,0,88,0
2021-05-07,Amador,005,37829,3657,3651,33,3684,46
2021-05-07,Butte,007,227075,12334,11943,1793,13736,199
2021-05-07,Calaveras,009,45235,2119,2114,14,2128,52
2021-05-07,Colusa,011,21464,1932,1937,298,2235,14
2021-05-07,Contra Costa,013,1133247,68769,68156,1251,69407,804
2021-05-07,Del Norte,015,27424,1370,1329,12,1341,8
2021-05-07,El Dorado,017,186661,10129,10065,716,10781,112
2021-05-07,Fresno,019,978130,102167,101625,8656,110281,1684
2021-05-07,Glenn,021,27897,2404,2381,551,2932,17
2021-05-07,Humboldt,023,135768,3989,3919,33,3952,36
2021-05-07,Imperial,025,180216,28458,28352,2740,31092,721
2021-05-07,Inyo,027,18085,1402,1402,11,1413,36
2021-05-07,Kern,029,883053,96872,95839,10735,106574,1308
2021-05-07,Kings,031,150075,23101,22857,1086,23943,246
2021-05-07,Lake,033,64148,3481,3467,9,3476,43
2021-05-07,Lassen,035,31185,5181,5144,107,5251,5
2021-05-07,Los Angeles,037,10098052,1202300,1194294,41554,1235848,24008
2021-05-07,Madera,039,155013,16528,16439,923,17362,238
2021-05-07,Marin,041,260295,14022,13968,250,14218,228
2021-05-07,Mariposa,043,17540,423,419,11,430,5
2021-05-07,Mendocino,045,87422,3885,3805,79,3884,46
2021-05-07,Merced,047,269075,30787,30862,1051,31913,446
2021-05-07,Modoc,049,8938,373,360,124,484,3
2021-05-07,Mono,051,14174,1252,1261,17,1278,3
2021-05-07,Monterey,053,433212,43058,42909,1865,44774,380
2021-05-07,Napa,055,140530,9842,9849,36,9885,81
2021-05-07,Nevada,057,99092,4751,4704,187,4891,70
2021-05-07,Orange,059,3164182,254697,253338,11274,264612,5000
2021-05-07,Placer,061,380077,22927,22524,1448,23972,286
2021-05-07,Plumas,063,18699,693,678,10,688,4
2021-05-07,Riverside,065,2383286,293222,287479,13970,301449,4426
2021-05-07,Sacramento,067,1510023,104474,104068,1706,105774,1609
2021-05-07,San Benito,069,59416,6046,6048,114,6162,63
2021-05-07,San Bernardino,071,2135413,292503,291185,8954,300139,4697
2021-05-07,San Diego,073,3302833,278918,277534,14676,292210,3718
2021-05-07,San Francisco,075,870044,36452,36616,1272,37888,543
2021-05-07,San Joaquin,077,732212,72483,71804,3495,75299,1351
2021-05-07,San Luis Obispo,079,281455,21228,20979,727,21706,256
2021-05-07,San Mateo,081,765935,42133,41844,466,42310,424
2021-05-07,Santa Barbara,083,443738,34297,34166,1137,35303,453
2021-05-07,Santa Clara,085,1922200,118043,118691,756,119447,2002
2021-05-07,Santa Cruz,087,273765,16153,16074,813,16887,206
2021-05-07,Shasta,089,179085,12013,12005,1511,13516,200
2021-05-07,Sierra,091,2930,56,54,12,66,0
2021-05-07,Siskiyou,093,43540,1841,1723,333,2056,13
2021-05-07,Solano,095,438530,32448,32352,533,32885,249
2021-05-07,Sonoma,097,501317,29760,29925,327,30252,318
2021-05-07,Stanislaus,099,539301,55669,55407,5873,61280,896
2021-05-07,Sutter,101,95872,9370,9407,82,9489,111
2021-05-07,Tehama,103,63373,5001,4974,564,5538,57
2021-05-07,Trinity,105,12862,482,327,87,414,3
2021-05-07,Tulare,107,460477,49957,48913,8955,57868,837
2021-05-07,Tuolumne,109,53932,3990,4048,38,4086,63
2021-05-07,Ventura,111,848112,81072,80444,2975,83419,1008
2021-05-07,Yolo,113,214977,13863,13875,297,14172,209
2021-05-07,Yuba,115,75493,5958,5910,122,6032,46
2021-05-06,Alameda,001,1643700,87302,87028,1932,88960,1278
2021-05-06,Alpine,003,1148,87,88,0,88,0
2021-05-06,Amador,005,37829,3655,3650,33,3683,46
2021-05-06,Butte,007,227075,12314,11929,1788,13717,198
2021-05-06,Calaveras,009,45235,2118,2111,14,2125,52
2021-05-06,Colusa,011,21464,1932,1935,298,2233,14
2021-05-06,Contra Costa,013,1133247,68714,68076,1248,69324,802
2021-05-06,Del Norte,015,27424,1362,1324,12,1336,6
2021-05-06,El Dorado,017,186661,10122,10048,716,10764,112
2021-05-06,Fresno,019,978130,102123,101536,8652,110188,1680
2021-05-06,Glenn,021,27897,2403,2380,550,2930,17
2021-05-06,Humboldt,023,135768,3964,3898,33,3931,36
2021-05-06,Imperial,025,180216,28447,28311,2739,31050,720
2021-05-06,Inyo,027,18085,1402,1401,11,1412,36
2021-05-06,Kern,029,883053,96847,95801,10718,106519,1307
2021-05-06,Kings,031,150075,23094,22848,1085,23933,246
2021-05-06,Lake,033,64148,3480,3465,9,3474,43
2021-05-06,Lassen,035,31185,5180,5143,107,5250,1
2021-05-06,Los Angeles,037,10098052,1202059,1193954,41537,1235491,23991
2021-05-06,Madera,039,155013,16520,16430,923,17353,238
2021-05-06,Marin,041,260295,14018,13956,250,14206,228
2021-05-06,Mariposa,043,17540,422,419,11,430,5
2021-05-06,Mendocino,045,87422,3874,3802,79,3881,46
2021-05-06,Merced,047,269075,30772,30863,1050,31913,444
2021-05-06,Modoc,049,8938,373,360,124,484,3
2021-05-06,Mono,051,14174,1250,1261,17,1278,3
2021-05-06,Monterey,053,433212,43043,42899,1865,44764,379
2021-05-06,Napa,055,140530,9836,9843,36,9879,81
2021-05-06,Nevada,057,99092,4750,4687,187,4874,70
2021-05-06,Orange,059,3164182,254629,253286,11268,264554,4991
2021-05-06,Placer,061,380077,22905,22493,1448,23941,286
2021-05-06,Plumas,063,18699,693,678,10,688,4
2021-05-06,Riverside,065,2383286,293149,287399,13965,301364,4422
2021-05-06,Sacramento,067,1510023,104357,103956,1703,105659,1609
2021-05-06,San Benito,069,59416,6045,6045,114,6159,63
2021-05-06,San Bernardino,071,2135413,292433,291085,8953,300038,4683
2021-05-06,San Diego,073,3302833,278793,277324,14653,291977,3716
2021-05-06,San Francisco,075,870044,36437,36599,1272,37871,543
2021-05-06,San Joaquin,077,732212,72428,71729,3492,75221,1350
2021-05-06,San Luis Obispo,079,281455,21216,20965,725,21690,256
2021-05-06,San Mateo,081,765935,42114,41802,465,42267,424
2021-05-06,Santa Barbara,083,443738,34284,34152,1137,35289,453
2021-05-06,Santa Clara,085,1922200,118002,118591,756,119347,2001
2021-05-06,Santa Cruz,087,273765,16146,16050,813,16863,206
2021-05-06,Shasta,089,179085,11991,11983,1505,13488,199
2021-05-06,Sierra,091,2930,56,54,12,66,0
2021-05-06,Siskiyou,093,43540,1831,1711,332,2043,12
2021-05-06,Solano,095,438530,32422,32320,525,32845,249
2021-05-06,Sonoma,097,501317,29752,29911,327,30238,318
2021-05-06,Stanislaus,099,539301,55613,55323,5868,61191,834
2021-05-06,Sutter,101,95872,9364,9396,82,9478,111
2021-05-06,Tehama,103,63373,4996,4970,564,5534,53
2021-05-06,Trinity,105,12862,482,327,87,414,3
2021-05-06,Tulare,107,460477,49932,48890,8940,57830,836
2021-05-06,Tuolumne,109,53932,3986,4047,38,4085,63
2021-05-06,Ventura,111,848112,81041,80411,2972,83383,1005
2021-05-06,Yolo,113,214977,13856,13871,293,14164,209
2021-05-06,Yuba,115,75493,5946,5901,122,6023,46
2021-05-05,Alameda,001,1643700,87240,86950,1930,88880,1278
2021-05-05,Alpine,003,1148,87,88,0,88,0
2021-05-05,Amador,005,37829,3652,3650,33,3683,46
2021-05-05,Butte,007,227075,12296,11907,1785,13692,198
2021-05-05,Calaveras,009,45235,2114,2103,14,2117,52
2021-05-05,Colusa,011,21464,1931,1933,298,2231,14
2021-05-05,Contra Costa,013,1133247,68649,67997,1244,69241,803
2021-05-05,Del Norte,015,27424,1359,1317,12,1329,6
2021-05-05,El Dorado,017,186661,10111,10020,715,10735,111
2021-05-05,Fresno,019,978130,102074,101491,8643,110134,1680
2021-05-05,Glenn,021,27897,2400,2380,549,2929,17
2021-05-05,Humboldt,023,135768,3945,3886,32,3918,36
2021-05-05,Imperial,025,180216,28406,28295,2732,31027,720
2021-05-05,Inyo,027,18085,1401,1401,11,1412,36
2021-05-05,Kern,029,883053,96803,95753,10714,106467,1304
2021-05-05,Kings,031,150075,23088,22840,1084,23924,246
2021-05-05,Lake,033,64148,3477,3458,9,3467,43
2021-05-05,Lassen,035,31185,5180,5143,106,5249,1
2021-05-05,Los Angeles,037,10098052,1201788,1193608,41523,1235131,23977
2021-05-05,Madera,039,155013,16518,16423,923,17346,235
2021-05-05,Marin,041,260295,14010,13950,249,14199,228
2021-05-05,Mariposa,043,17540,422,418,11,429,5
2021-05-05,Mendocino,045,87422,3870,3799,79,3878,46
2021-05-05,Merced,047,269075,30751,30844,1050,31894,444
2021-05-05,Modoc,049,8938,372,361,123,484,3
2021-05-05,Mono,051,14174,1250,1260,17,1277,3
2021-05-05,Monterey,053,433212,43029,42870,1862,44732,379
2021-05-05,Napa,055,140530,9830,9833,36,9869,81
2021-05-05,Nevada,057,99092,4747,4666,187,4853,70
2021-05-05,Orange,059,3164182,254571,253237,11263,264500,4978
2021-05-05,Placer,061,380077,22873,22362,1444,23806,287
2021-05-05,Plumas,063,18699,693,677,10,687,4
2021-05-05,Riverside,065,2383286,293054,287353,13955,301308,4414
2021-05-05,Sacramento,067,1510023,104269,103476,1698,105174,1607
2021-05-05,San Benito,069,59416,6036,6046,114,6160,63
2021-05-05,San Bernardino,071,2135413,292358,291008,8949,299957,4677
2021-05-05,San Diego,073,3302833,278656,277098,14633,291731,3716
2021-05-05,San Francisco,075,870044,36423,36577,1271,37848,543
2021-05-05,San Joaquin,077,732212,72375,71638,3489,75127,1345
2021-05-05,San Luis Obispo,079,281455,21208,20958,725,21683,256
2021-05-05,San Mateo,081,765935,42084,41755,464,42219,415
2021-05-05,Santa Barbara,083,443738,34269,34139,1136,35275,453
2021-05-05,Santa Clara,085,1922200,117972,118482,752,119234,1992
2021-05-05,Santa Cruz,087,273765,16140,16013,813,16826,207
2021-05-05,Shasta,089,179085,11975,11939,1501,13440,200
2021-05-05,Sierra,091,2930,56,54,12,66,0
2021-05-05,Siskiyou,093,43540,1814,1706,324,2030,11
2021-05-05,Solano,095,438530,32387,32250,523,32773,249
2021-05-05,Sonoma,097,501317,29739,29879,327,30206,318
2021-05-05,Stanislaus,099,539301,55556,55231,5866,61097,807
2021-05-05,Sutter,101,95872,9358,9387,82,9469,111
2021-05-05,Tehama,103,63373,4992,4968,564,5532,53
2021-05-05,Trinity,105,12862,482,326,87,413,3
2021-05-05,Tulare,107,460477,49908,48875,8933,57808,835
2021-05-05,Tuolumne,109,53932,3983,4040,38,4078,63
2021-05-05,Ventura,111,848112,81013,80372,2968,83340,1005
2021-05-05,Yolo,113,214977,13852,13846,291,14137,209
2021-05-05,Yuba,115,75493,5936,5895,121,6016,44
2021-05-04,Alameda,001,1643700,87148,86894,1930,88824,1277
2021-05-04,Alpine,003,1148,87,88,0,88,0
2021-05-04,Amador,005,37829,3652,3650,33,3683,46
2021-05-04,Butte,007,227075,12272,11883,1784,13667,198
2021-05-04,Calaveras,009,45235,2109,2100,14,2114,52
2021-05-04,Colusa,011,21464,1930,1933,298,2231,14
2021-05-04,Contra Costa,013,1133247,68569,67931,1242,69173,799
2021-05-04,Del Norte,015,27424,1359,1314,12,1326,6
2021-05-04,El Dorado,017,186661,10100,10009,711,10720,110
2021-05-04,Fresno,019,978130,102019,101451,8636,110087,1677
2021-05-04,Glenn,021,27897,2397,2379,546,2925,17
2021-05-04,Humboldt,023,135768,3919,3877,32,3909,36
2021-05-04,Imperial,025,180216,28386,28276,2728,31004,720
2021-05-04,Inyo,027,18085,1401,1399,11,1410,36
2021-05-04,Kern,029,883053,96767,95720,10696,106416,1301
2021-05-04,Kings,031,150075,23074,22822,1081,23903,246
2021-05-04,Lake,033,64148,3476,3454,9,3463,43
2021-05-04,Lassen,035,31185,5179,5142,106,5248,1
2021-05-04,Los Angeles,037,10098052,1201500,1193453,41511,1234964,23957
2021-05-04,Madera,039,155013,16517,16418,923,17341,235
2021-05-04,Marin,041,260295,14002,13935,249,14184,228
2021-05-04,Mariposa,043,17540,422,418,11,429,5
2021-05-04,Mendocino,045,87422,3865,3794,79,3873,46
2021-05-04,Merced,047,269075,30734,30829,1050,31879,444
2021-05-04,Modoc,049,8938,371,360,122,482,3
2021-05-04,Mono,051,14174,1250,1260,17,1277,3
2021-05-04,Monterey,053,433212,43017,42845,1861,44706,380
2021-05-04,Napa,055,140530,9821,9824,36,9860,81
2021-05-04,Nevada,057,99092,4740,4656,187,4843,70
2021-05-04,Orange,059,3164182,254503,253177,11253,264430,4977
2021-05-04,Placer,061,380077,22844,22326,1441,23767,287
2021-05-04,Plumas,063,18699,692,675,10,685,4
2021-05-04,Riverside,065,2383286,292970,287285,13948,301233,4411
2021-05-04,Sacramento,067,1510023,104140,103383,1693,105076,1604
2021-05-04,San Benito,069,59416,6035,6039,114,6153,63
2021-05-04,San Bernardino,071,2135413,292281,290934,8942,299876,4668
2021-05-04,San Diego,073,3302833,278490,276879,14616,291495,3713
2021-05-04,San Francisco,075,870044,36405,36550,1271,37821,541
2021-05-04,San Joaquin,077,732212,72314,71582,3484,75066,1342
2021-05-04,San Luis Obispo,079,281455,21202,20923,723,21646,255
2021-05-04,San Mateo,081,765935,42058,41708,464,42172,415
2021-05-04,Santa Barbara,083,443738,34253,34131,1135,35266,453
2021-05-04,Santa Clara,085,1922200,117909,118431,751,119182,1988
2021-05-04,Santa Cruz,087,273765,16134,16005,813,16818,207
2021-05-04,Shasta,089,179085,11955,11923,1495,13418,198
2021-05-04,Sierra,091,2930,56,54,12,66,0
2021-05-04,Siskiyou,093,43540,1807,1694,322,2016,11
2021-05-04,Solano,095,438530,32346,32220,521,32741,249
2021-05-04,Sonoma,097,501317,29719,29867,326,30193,318
2021-05-04,Stanislaus,099,539301,55500,55165,5863,61028,807
2021-05-04,Sutter,101,95872,9353,9375,82,9457,111
2021-05-04,Tehama,103,63373,4989,4959,563,5522,53
2021-05-04,Trinity,105,12862,482,326,87,413,3
2021-05-04,Tulare,107,460477,49881,48857,8924,57781,835
2021-05-04,Tuolumne,109,53932,3981,4041,38,4079,61
2021-05-04,Ventura,111,848112,80984,80351,2966,83317,1005
2021-05-04,Yolo,113,214977,13839,13820,289,14109,208
2021-05-04,Yuba,115,75493,5930,5891,121,6012,44
2021-05-03,Alameda,001,1643700,87072,86845,1924,88769,1272
2021-05-03,Alpine,003,1148,87,88,0,88,0
2021-05-03,Amador,005,37829,3652,3651,33,3684,46
2021-05-03,Butte,007,227075,12262,11864,1781,13645,198
2021-05-03,Calaveras,009,45235,2108,2099,14,2113,50
2021-05-03,Colusa,011,21464,1929,1931,296,2227,14
2021-05-03,Contra Costa,013,1133247,68510,67895,1238,69133,799
2021-05-03,Del Norte,015,27424,1354,1306,11,1317,6
2021-05-03,El Dorado,017,186661,10082,9984,706,10690,110
2021-05-03,Fresno,019,978130,101963,101405,8625,110030,1678
2021-05-03,Glenn,021,27897,2397,2375,545,2920,17
2021-05-03,Humboldt,023,135768,3904,3865,32,3897,36
2021-05-03,Imperial,025,180216,28364,28280,2725,31005,720
2021-05-03,Inyo,027,18085,1400,1398,11,1409,36
2021-05-03,Kern,029,883053,96730,95693,10684,106377,1299
2021-05-03,Kings,031,150075,23065,22821,1081,23902,246
2021-05-03,Lake,033,64148,3474,3446,9,3455,43
2021-05-03,Lassen,035,31185,5178,5142,106,5248,1
2021-05-03,Los Angeles,037,10098052,1201231,1193261,41485,1234746,23942
2021-05-03,Madera,039,155013,16512,16414,922,17336,235
2021-05-03,Marin,041,260295,13996,13927,249,14176,228
2021-05-03,Mariposa,043,17540,422,418,11,429,5
2021-05-03,Mendocino,045,87422,3858,3792,79,3871,46
2021-05-03,Merced,047,269075,30723,30814,1048,31862,444
2021-05-03,Modoc,049,8938,371,360,122,482,3
2021-05-03,Mono,051,14174,1250,1259,17,1276,3
2021-05-03,Monterey,053,433212,43005,42837,1859,44696,380
2021-05-03,Napa,055,140530,9816,9815,36,9851,81
2021-05-03,Nevada,057,99092,4732,4650,187,4837,70
2021-05-03,Orange,059,3164182,254444,253107,11244,264351,4968
2021-05-03,Placer,061,380077,22813,22289,1435,23724,287
2021-05-03,Plumas,063,18699,691,675,10,685,4
2021-05-03,Riverside,065,2383286,292896,287233,13947,301180,4412
2021-05-03,Sacramento,067,1510023,103987,103303,1683,104986,1602
2021-05-03,San Benito,069,59416,6034,6038,114,6152,63
2021-05-03,San Bernardino,071,2135413,292213,290886,8939,299825,4659
2021-05-03,San Diego,073,3302833,278327,276693,14591,291284,3712
2021-05-03,San Francisco,075,870044,36379,36538,1271,37809,541
2021-05-03,San Joaquin,077,732212,72264,71504,3481,74985,1325
2021-05-03,San Luis Obispo,079,281455,21186,20915,720,21635,254
2021-05-03,San Mateo,081,765935,42035,41689,463,42152,413
2021-05-03,Santa Barbara,083,443738,34241,34119,1135,35254,453
2021-05-03,Santa Clara,085,1922200,117855,118373,750,119123,1988
2021-05-03,Santa Cruz,087,273765,16131,16000,813,16813,207
2021-05-03,Shasta,089,179085,11932,11890,1490,13380,197
2021-05-03,Sierra,091,2930,56,54,12,66,0
2021-05-03,Siskiyou,093,43540,1801,1683,316,1999,11
2021-05-03,Solano,095,438530,32305,32201,520,32721,249
2021-05-03,Sonoma,097,501317,29707,29855,323,30178,318
2021-05-03,Stanislaus,099,539301,55434,55116,5854,60970,774
2021-05-03,Sutter,101,95872,9341,9370,82,9452,111
2021-05-03,Tehama,103,63373,4981,4952,563,5515,53
2021-05-03,Trinity,105,12862,482,326,87,413,3
2021-05-03,Tulare,107,460477,49864,48844,8914,57758,835
2021-05-03,Tuolumne,109,53932,3980,4038,38,4076,61
2021-05-03,Ventura,111,848112,80962,80291,2966,83257,1005
2021-05-03,Yolo,113,214977,13826,13809,287,14096,208
2021-05-03,Yuba,115,75493,5925,5880,121,6001,44
2021-05-02,Alameda,001,1643700,86987,86784,1923,88707,1272
2021-05-02,Alpine,003,1148,87,88,0,88,0
2021-05-02,Amador,005,37829,3652,3650,33,3683,46
2021-05-02,Butte,007,227075,12238,11859,1778,13637,198
2021-05-02,Calaveras,009,45235,2104,2098,14,2112,50
2021-05-02,Colusa,011,21464,1928,1931,295,2226,14
2021-05-02,Contra Costa,013,1133247,68425,67843,1236,69079,800
2021-05-02,Del Norte,015,27424,1347,1305,11,1316,6
2021-05-02,El Dorado,017,186661,10067,9962,705,10667,110
2021-05-02,Fresno,019,978130,101891,101372,8614,109986,1678
2021-05-02,Glenn,021,27897,2396,2374,543,2917,17
2021-05-02,Humboldt,023,135768,3892,3858,31,3889,36
2021-05-02,Imperial,025,180216,28330,28275,2716,30991,721
2021-05-02,Inyo,027,18085,1398,1398,11,1409,36
2021-05-02,Kern,029,883053,96672,95668,10677,106345,1299
2021-05-02,Kings,031,150075,23047,22816,1080,23896,246
2021-05-02,Lake,033,64148,3472,3443,9,3452,43
2021-05-02,Lassen,035,31185,5177,5142,105,5247,1
2021-05-02,Los Angeles,037,10098052,1200881,1193056,41462,1234518,23943
2021-05-02,Madera,039,155013,16506,16410,922,17332,235
2021-05-02,Marin,041,260295,13986,13917,249,14166,228
2021-05-02,Mariposa,043,17540,422,419,11,430,5
2021-05-02,Mendocino,045,87422,3853,3787,79,3866,46
2021-05-02,Merced,047,269075,30703,30793,1044,31837,444
2021-05-02,Modoc,049,8938,370,360,122,482,3
2021-05-02,Mono,051,14174,1249,1259,17,1276,3
2021-05-02,Monterey,053,433212,42991,42837,1858,44695,380
2021-05-02,Napa,055,140530,9812,9805,36,9841,81
2021-05-02,Nevada,057,99092,4716,4635,187,4822,70
2021-05-02,Orange,059,3164182,254370,253025,11230,264255,4968
2021-05-02,Placer,061,380077,22784,22264,1432,23696,287
2021-05-02,Plumas,063,18699,691,675,10,685,4
2021-05-02,Riverside,065,2383286,292796,287197,13937,301134,4412
2021-05-02,Sacramento,067,1510023,103847,103153,1676,104829,1602
2021-05-02,San Benito,069,59416,6029,6037,114,6151,63
2021-05-02,San Bernardino,071,2135413,292114,290859,8937,299796,4655
2021-05-02,San Diego,073,3302833,278130,276521,14564,291085,3712
2021-05-02,San Francisco,075,870044,36353,36522,1271,37793,541
2021-05-02,San Joaquin,077,732212,72200,71447,3474,74921,1325
2021-05-02,San Luis Obispo,079,281455,21165,20910,719,21629,254
2021-05-02,San Mateo,081,765935,42019,41656,462,42118,412
2021-05-02,Santa Barbara,083,443738,34227,34106,1135,35241,453
2021-05-02,Santa Clara,085,1922200,117781,118321,750,119071,1988
2021-05-02,Santa Cruz,087,273765,16126,15995,812,16807,207
2021-05-02,Shasta,089,179085,11916,11885,1482,13367,197
2021-05-02,Sierra,091,2930,56,54,12,66,0
2021-05-02,Siskiyou,093,43540,1790,1661,315,1976,11
2021-05-02,Solano,095,438530,32266,32151,516,32667,249
2021-05-02,Sonoma,097,501317,29685,29842,323,30165,318
2021-05-02,Stanislaus,099,539301,55360,55057,5847,60904,774
2021-05-02,Sutter,101,95872,9335,9363,82,9445,111
2021-05-02,Tehama,103,63373,4976,4950,561,5511,53
2021-05-02,Trinity,105,12862,482,326,87,413,3
2021-05-02,Tulare,107,460477,49846,48834,8906,57740,835
2021-05-02,Tuolumne,109,53932,3977,4038,38,4076,61
2021-05-02,Ventura,111,848112,80925,80284,2965,83249,1005
2021-05-02,Yolo,113,214977,13814,13799,286,14085,208
2021-05-02,Yuba,115,75493,5915,5879,121,6000,44
2021-05-01,Alameda,001,1643700,86944,86704,1920,88624,1270
2021-05-01,Alpine,003,1148,87,88,0,88,0
2021-05-01,Amador,005,37829,3652,3650,33,3683,46
2021-05-01,Butte,007,227075,12224,11845,1773,13618,198
2021-05-01,Calaveras,009,45235,2102,2096,14,2110,50
2021-05-01,Colusa,011,21464,1927,1931,295,2226,14
2021-05-01,Contra Costa,013,1133247,68373,67779,1233,69012,800
2021-05-01,Del Norte,015,27424,1346,1292,11,1303,6
2021-05-01,El Dorado,017,186661,10053,9944,703,10647,110
2021-05-01,Fresno,019,978130,101846,101326,8608,109934,1678
2021-05-01,Glenn,021,27897,2393,2369,542,2911,17
2021-05-01,Humboldt,023,135768,3878,3845,31,3876,36
2021-05-01,Imperial,025,180216,28323,28262,2716,30978,721
2021-05-01,Inyo,027,18085,1398,1397,11,1408,36
2021-05-01,Kern,029,883053,96645,95645,10666,106311,1299
2021-05-01,Kings,031,150075,23044,22797,1079,23876,246
2021-05-01,Lake,033,64148,3470,3441,9,3450,43
2021-05-01,Lassen,035,31185,5175,5142,105,5247,1
2021-05-01,Los Angeles,037,10098052,1200712,1192781,41447,1234228,23946
2021-05-01,Madera,039,155013,16502,16408,922,17330,235
2021-05-01,Marin,041,260295,13979,13902,249,14151,228
2021-05-01,Mariposa,043,17540,422,418,11,429,5
2021-05-01,Mendocino,045,87422,3851,3782,79,3861,46
2021-05-01,Merced,047,269075,30686,30771,1043,31814,444
2021-05-01,Modoc,049,8938,370,361,122,483,3
2021-05-01,Mono,051,14174,1249,1258,17,1275,3
2021-05-01,Monterey,053,433212,42985,42828,1858,44686,379
2021-05-01,Napa,055,140530,9809,9800,36,9836,81
2021-05-01,Nevada,057,99092,4711,4625,187,4812,70
2021-05-01,Orange,059,3164182,254327,252969,11219,264188,4964
2021-05-01,Placer,061,380077,22758,22240,1430,23670,287
2021-05-01,Plumas,063,18699,690,675,10,685,4
2021-05-01,Riverside,065,2383286,292757,287129,13935,301064,4412
2021-05-01,Sacramento,067,1510023,103766,103043,1675,104718,1602
2021-05-01,San Benito,069,59416,6026,6030,114,6144,63
2021-05-01,San Bernardino,071,2135413,292071,290802,8935,299737,4652
2021-05-01,San Diego,073,3302833,278006,276367,14543,290910,3706
2021-05-01,San Francisco,075,870044,36338,36496,1271,37767,541
2021-05-01,San Joaquin,077,732212,72151,71389,3472,74861,1325
2021-05-01,San Luis Obispo,079,281455,21160,20896,719,21615,254
2021-05-01,San Mateo,081,765935,41990,41617,461,42078,411
2021-05-01,Santa Barbara,083,443738,34222,34085,1134,35219,453
2021-05-01,Santa Clara,085,1922200,117729,118265,748,119013,1988
2021-05-01,Santa Cruz,087,273765,16123,15984,812,16796,207
2021-05-01,Shasta,089,179085,11896,11878,1474,13352,197
2021-05-01,Sierra,091,2930,56,53,12,65,0
2021-05-01,Siskiyou,093,43540,1782,1653,314,1967,11
2021-05-01,Solano,095,438530,32236,32124,508,32632,249
2021-05-01,Sonoma,097,501317,29682,29835,323,30158,318
2021-05-01,Stanislaus,099,539301,55325,55005,5841,60846,774
2021-05-01,Sutter,101,95872,9332,9358,82,9440,110
2021-05-01,Tehama,103,63373,4975,4950,560,5510,53
2021-05-01,Trinity,105,12862,482,326,86,412,3
2021-05-01,Tulare,107,460477,49839,48818,8900,57718,835
2021-05-01,Tuolumne,109,53932,3971,4035,38,4073,61
2021-05-01,Ventura,111,848112,80907,80268,2965,83233,1005
2021-05-01,Yolo,113,214977,13807,13784,284,14068,208
2021-05-01,Yuba,115,75493,5913,5875,121,5996,44
2021-04-30,Alameda,001,1643700,86883,86602,1917,88519,1268
2021-04-30,Alpine,003,1148,87,88,0,88,0
2021-04-30,Amador,005,37829,3650,3650,33,3683,46
2021-04-30,Butte,007,227075,12205,11812,1769,13581,197
2021-04-30,Calaveras,009,45235,2101,2087,14,2101,50
2021-04-30,Colusa,011,21464,1927,1931,294,2225,14
2021-04-30,Contra Costa,013,1133247,68325,67684,1230,68914,800
2021-04-30,Del Norte,015,27424,1334,1276,11,1287,6
2021-04-30,El Dorado,017,186661,10039,9906,703,10609,110
2021-04-30,Fresno,019,978130,101800,101263,8604,109867,1670
2021-04-30,Glenn,021,27897,2392,2369,542,2911,17
2021-04-30,Humboldt,023,135768,3865,3834,31,3865,36
2021-04-30,Imperial,025,180216,28314,28244,2713,30957,721
2021-04-30,Inyo,027,18085,1398,1397,11,1408,36
2021-04-30,Kern,029,883053,96628,95605,10662,106267,1298
2021-04-30,Kings,031,150075,23041,22793,1078,23871,246
2021-04-30,Lake,033,64148,3466,3440,9,3449,43
2021-04-30,Lassen,035,31185,5174,5140,105,5245,1
2021-04-30,Los Angeles,037,10098052,1200501,1192393,41434,1233827,23919
2021-04-30,Madera,039,155013,16496,16395,922,17317,235
2021-04-30,Marin,041,260295,13971,13895,247,14142,228
2021-04-30,Mariposa,043,17540,422,417,11,428,5
2021-04-30,Mendocino,045,87422,3847,3777,79,3856,46
2021-04-30,Merced,047,269075,30673,30740,1042,31782,444
2021-04-30,Modoc,049,8938,369,360,122,482,3
2021-04-30,Mono,051,14174,1249,1258,17,1275,3
2021-04-30,Monterey,053,433212,42971,42810,1857,44667,379
2021-04-30,Napa,055,140530,9805,9792,36,9828,81
2021-04-30,Nevada,057,99092,4703,4608,187,4795,70
2021-04-30,Orange,059,3164182,254270,252883,11213,264096,4956
2021-04-30,Placer,061,380077,22739,22190,1426,23616,287
2021-04-30,Plumas,063,18699,690,677,10,687,4
2021-04-30,Riverside,065,2383286,292699,287030,13928,300958,4412
2021-04-30,Sacramento,067,1510023,103665,102864,1671,104535,1596
2021-04-30,San Benito,069,59416,6022,6024,113,6137,63
2021-04-30,San Bernardino,071,2135413,292010,290704,8934,299638,4640
2021-04-30,San Diego,073,3302833,277911,276157,14532,290689,3702
2021-04-30,San Francisco,075,870044,36327,36453,1270,37723,538
2021-04-30,San Joaquin,077,732212,72099,71311,3469,74780,1306
2021-04-30,San Luis Obispo,079,281455,21154,20884,719,21603,255
2021-04-30,San Mateo,081,765935,41975,41583,460,42043,380
2021-04-30,Santa Barbara,083,443738,34209,34061,1134,35195,451
2021-04-30,Santa Clara,085,1922200,117671,118170,744,118914,1988
2021-04-30,Santa Cruz,087,273765,16118,15975,812,16787,207
2021-04-30,Shasta,089,179085,11875,11848,1471,13319,197
2021-04-30,Sierra,091,2930,56,53,12,65,0
2021-04-30,Siskiyou,093,43540,1771,1628,311,1939,11
2021-04-30,Solano,095,438530,32204,32050,505,32555,249
2021-04-30,Sonoma,097,501317,29672,29816,321,30137,318
2021-04-30,Stanislaus,099,539301,55274,54938,5838,60776,774
2021-04-30,Sutter,101,95872,9330,9353,82,9435,110
2021-04-30,Tehama,103,63373,4972,4944,560,5504,53
2021-04-30,Trinity,105,12862,482,326,86,412,3
2021-04-30,Tulare,107,460477,49829,48797,8884,57681,836
2021-04-30,Tuolumne,109,53932,3970,4033,38,4071,61
2021-04-30,Ventura,111,848112,80867,80232,2960,83192,1004
2021-04-30,Yolo,113,214977,13795,13756,284,14040,208
2021-04-30,Yuba,115,75493,5905,5870,121,5991,44
2021-04-29,Alameda,001,1643700,86817,86490,1916,88406,1263
2021-04-29,Alpine,003,1148,87,88,0,88,0
2021-04-29,Amador,005,37829,3650,3649,33,3682,46
2021-04-29,Butte,007,227075,12190,11787,1767,13554,196
2021-04-29,Calaveras,009,45235,2098,2082,14,2096,50
2021-04-29,Colusa,011,21464,1927,1929,294,2223,14
2021-04-29,Contra Costa,013,1133247,68270,67606,1227,68833,795
2021-04-29,Del Norte,015,27424,1330,1271,11,1282,6
2021-04-29,El Dorado,017,186661,10019,9884,700,10584,107
2021-04-29,Fresno,019,978130,101746,101189,8593,109782,1667
2021-04-29,Glenn,021,27897,2389,2369,542,2911,17
2021-04-29,Humboldt,023,135768,3851,3815,31,3846,36
2021-04-29,Imperial,025,180216,28302,28235,2712,30947,720
2021-04-29,Inyo,027,18085,1398,1396,11,1407,36
2021-04-29,Kern,029,883053,96595,95547,10658,106205,1295
2021-04-29,Kings,031,150075,23031,22777,1073,23850,245
2021-04-29,Lake,033,64148,3458,3438,9,3447,43
2021-04-29,Lassen,035,31185,5174,5140,105,5245,1
2021-04-29,Los Angeles,037,10098052,1200223,1192068,41414,1233482,23899
2021-04-29,Madera,039,155013,16491,16383,921,17304,235
2021-04-29,Marin,041,260295,13967,13884,239,14123,228
2021-04-29,Mariposa,043,17540,421,416,11,427,5
2021-04-29,Mendocino,045,87422,3841,3774,79,3853,46
2021-04-29,Merced,047,269075,30654,30706,1041,31747,444
2021-04-29,Modoc,049,8938,369,360,122,482,3
2021-04-29,Mono,051,14174,1246,1259,17,1276,3
2021-04-29,Monterey,053,433212,42954,42797,1856,44653,379
2021-04-29,Napa,055,140530,9791,9789,36,9825,81
2021-04-29,Nevada,057,99092,4692,4590,187,4777,70
2021-04-29,Orange,059,3164182,254200,252823,11198,264021,4934
2021-04-29,Placer,061,380077,22714,22161,1424,23585,286
2021-04-29,Plumas,063,18699,689,676,10,686,4
2021-04-29,Riverside,065,2383286,292631,286947,13925,300872,4409
2021-04-29,Sacramento,067,1510023,103532,102686,1661,104347,1593
2021-04-29,San Benito,069,59416,6021,6023,113,6136,63
2021-04-29,San Bernardino,071,2135413,291938,290606,8929,299535,4609
2021-04-29,San Diego,073,3302833,277761,275961,14515,290476,3700
2021-04-29,San Francisco,075,870044,36301,36412,1270,37682,537
2021-04-29,San Joaquin,077,732212,72033,71225,3464,74689,1301
2021-04-29,San Luis Obispo,079,281455,21143,20876,719,21595,255
2021-04-29,San Mateo,081,765935,41947,41538,459,41997,358
2021-04-29,Santa Barbara,083,443738,34193,34039,1132,35171,448
2021-04-29,Santa Clara,085,1922200,117616,118082,741,118823,1984
2021-04-29,Santa Cruz,087,273765,16112,15961,812,16773,205
2021-04-29,Shasta,089,179085,11844,11836,1463,13299,193
2021-04-29,Sierra,091,2930,56,53,12,65,0
2021-04-29,Siskiyou,093,43540,1762,1615,308,1923,11
2021-04-29,Solano,095,438530,32163,32002,501,32503,248
2021-04-29,Sonoma,097,501317,29657,29785,318,30103,318
2021-04-29,Stanislaus,099,539301,55207,54836,5833,60669,774
2021-04-29,Sutter,101,95872,9323,9346,82,9428,110
2021-04-29,Tehama,103,63373,4964,4939,560,5499,53
2021-04-29,Trinity,105,12862,482,326,86,412,3
2021-04-29,Tulare,107,460477,49811,48785,8872,57657,832
2021-04-29,Tuolumne,109,53932,3969,4030,38,4068,58
2021-04-29,Ventura,111,848112,80833,80188,2958,83146,1002
2021-04-29,Yolo,113,214977,13775,13745,283,14028,205
2021-04-29,Yuba,115,75493,5895,5865,121,5986,44
2021-04-28,Alameda,001,1643700,86745,86390,1912,88302,1260
2021-04-28,Alpine,003,1148,87,88,0,88,0
2021-04-28,Amador,005,37829,3650,3646,33,3679,46
2021-04-28,Butte,007,227075,12170,11762,1762,13524,196
2021-04-28,Calaveras,009,45235,2094,2078,13,2091,50
2021-04-28,Colusa,011,21464,1924,1927,293,2220,14
2021-04-28,Contra Costa,013,1133247,68210,67539,1226,68765,795
2021-04-28,Del Norte,015,27424,1322,1267,11,1278,6
2021-04-28,El Dorado,017,186661,9994,9873,700,10573,107
2021-04-28,Fresno,019,978130,101699,101161,8583,109744,1666
2021-04-28,Glenn,021,27897,2386,2368,542,2910,17
2021-04-28,Humboldt,023,135768,3835,3796,31,3827,36
2021-04-28,Imperial,025,180216,28288,28177,2711,30888,720
2021-04-28,Inyo,027,18085,1398,1396,10,1406,36
2021-04-28,Kern,029,883053,96566,95494,10649,106143,1295
2021-04-28,Kings,031,150075,23019,22767,1071,23838,245
2021-04-28,Lake,033,64148,3455,3433,9,3442,43
2021-04-28,Lassen,035,31185,5174,5138,105,5243,1
2021-04-28,Los Angeles,037,10098052,1199924,1191729,41388,1233117,23858
2021-04-28,Madera,039,155013,16487,16372,921,17293,235
2021-04-28,Marin,041,260295,13956,13866,239,14105,227
2021-04-28,Mariposa,043,17540,418,415,11,426,5
2021-04-28,Mendocino,045,87422,3835,3770,77,3847,46
2021-04-28,Merced,047,269075,30636,30649,1041,31690,443
2021-04-28,Modoc,049,8938,369,360,122,482,3
2021-04-28,Mono,051,14174,1246,1258,17,1275,3
2021-04-28,Monterey,053,433212,42949,42776,1856,44632,379
2021-04-28,Napa,055,140530,9780,9777,36,9813,81
2021-04-28,Nevada,057,99092,4672,4570,187,4757,70
2021-04-28,Orange,059,3164182,254120,252747,11185,263932,4931
2021-04-28,Placer,061,380077,22687,22115,1423,23538,285
2021-04-28,Plumas,063,18699,689,676,10,686,4
2021-04-28,Riverside,065,2383286,292575,286868,13919,300787,4407
2021-04-28,Sacramento,067,1510023,103410,102613,1657,104270,1591
2021-04-28,San Benito,069,59416,6019,6021,113,6134,63
2021-04-28,San Bernardino,071,2135413,291859,290548,8919,299467,4582
2021-04-28,San Diego,073,3302833,277606,275821,14501,290322,3698
2021-04-28,San Francisco,075,870044,36271,36382,1269,37651,534
2021-04-28,San Joaquin,077,732212,71953,71171,3456,74627,1301
2021-04-28,San Luis Obispo,079,281455,21135,20851,719,21570,255
2021-04-28,San Mateo,081,765935,41922,41498,457,41955,358
2021-04-28,Santa Barbara,083,443738,34179,34003,1132,35135,448
2021-04-28,Santa Clara,085,1922200,117547,117997,739,118736,1969
2021-04-28,Santa Cruz,087,273765,16108,15943,811,16754,205
2021-04-28,Shasta,089,179085,11828,11815,1456,13271,192
2021-04-28,Sierra,091,2930,56,51,12,63,0
2021-04-28,Siskiyou,093,43540,1749,1603,305,1908,11
2021-04-28,Solano,095,438530,32131,31982,496,32478,248
2021-04-28,Sonoma,097,501317,29643,29773,314,30087,318
2021-04-28,Stanislaus,099,539301,55152,54745,5830,60575,774
2021-04-28,Sutter,101,95872,9318,9343,82,9425,110
2021-04-28,Tehama,103,63373,4959,4930,559,5489,53
2021-04-28,Trinity,105,12862,482,326,86,412,3
2021-04-28,Tulare,107,460477,49793,48754,8857,57611,832
2021-04-28,Tuolumne,109,53932,3966,4029,38,4067,58
2021-04-28,Ventura,111,848112,80798,80172,2956,83128,1000
2021-04-28,Yolo,113,214977,13761,13721,282,14003,205
2021-04-28,Yuba,115,75493,5889,5857,121,5978,44
2021-04-27,Alameda,001,1643700,86654,86301,1906,88207,1260
2021-04-27,Alpine,003,1148,87,88,0,88,0
2021-04-27,Amador,005,37829,3650,3645,33,3678,46
2021-04-27,Butte,007,227075,12145,11738,1756,13494,196
2021-04-27,Calaveras,009,45235,2092,2076,13,2089,50
2021-04-27,Colusa,011,21464,1923,1926,293,2219,14
2021-04-27,Contra Costa,013,1133247,68141,67470,1222,68692,791
2021-04-27,Del Norte,015,27424,1310,1266,11,1277,6
2021-04-27,El Dorado,017,186661,9965,9866,697,10563,106
2021-04-27,Fresno,019,978130,101634,101138,8573,109711,1663
2021-04-27,Glenn,021,27897,2386,2368,542,2910,17
2021-04-27,Humboldt,023,135768,3823,3780,31,3811,35
2021-04-27,Imperial,025,180216,28272,28149,2705,30854,720
2021-04-27,Inyo,027,18085,1398,1396,10,1406,36
2021-04-27,Kern,029,883053,96509,95466,10638,106104,1295
2021-04-27,Kings,031,150075,23004,22759,1069,23828,244
2021-04-27,Lake,033,64148,3454,3431,9,3440,43
2021-04-27,Lassen,035,31185,5174,5137,105,5242,1
2021-04-27,Los Angeles,037,10098052,1199600,1191504,41358,1232862,23825
2021-04-27,Madera,039,155013,16480,16365,921,17286,235
2021-04-27,Marin,041,260295,13934,13855,239,14094,227
2021-04-27,Mariposa,043,17540,417,413,11,424,5
2021-04-27,Mendocino,045,87422,3831,3765,77,3842,46
2021-04-27,Merced,047,269075,30595,30620,1041,31661,443
2021-04-27,Modoc,049,8938,368,360,122,482,3
2021-04-27,Mono,051,14174,1246,1257,17,1274,3
2021-04-27,Monterey,053,433212,42931,42752,1853,44605,379
2021-04-27,Napa,055,140530,9773,9774,34,9808,81
2021-04-27,Nevada,057,99092,4657,4557,187,4744,70
2021-04-27,Orange,059,3164182,254051,252667,11180,263847,4925
2021-04-27,Placer,061,380077,22658,22050,1419,23469,285
2021-04-27,Plumas,063,18699,688,675,10,685,4
2021-04-27,Riverside,065,2383286,292499,286820,13915,300735,4405
2021-04-27,Sacramento,067,1510023,103281,102595,1647,104242,1589
2021-04-27,San Benito,069,59416,6014,6016,113,6129,63
2021-04-27,San Bernardino,071,2135413,291791,290461,8914,299375,4575
2021-04-27,San Diego,073,3302833,277449,275685,14481,290166,3692
2021-04-27,San Francisco,075,870044,36243,36358,1268,37626,533
2021-04-27,San Joaquin,077,732212,71900,71104,3450,74554,1301
2021-04-27,San Luis Obispo,079,281455,21128,20841,719,21560,255
2021-04-27,San Mateo,081,765935,41887,41474,456,41930,358
2021-04-27,Santa Barbara,083,443738,34155,33973,1131,35104,448
2021-04-27,Santa Clara,085,1922200,117497,117945,738,118683,1969
2021-04-27,Santa Cruz,087,273765,16101,15905,810,16715,205
2021-04-27,Shasta,089,179085,11800,11802,1449,13251,192
2021-04-27,Sierra,091,2930,56,51,12,63,0
2021-04-27,Siskiyou,093,43540,1734,1597,304,1901,11
2021-04-27,Solano,095,438530,32083,31964,495,32459,248
2021-04-27,Sonoma,097,501317,29625,29761,313,30074,318
2021-04-27,Stanislaus,099,539301,55082,54695,5822,60517,752
2021-04-27,Sutter,101,95872,9313,9342,82,9424,110
2021-04-27,Tehama,103,63373,4956,4922,555,5477,53
2021-04-27,Trinity,105,12862,482,326,86,412,3
2021-04-27,Tulare,107,460477,49777,48744,8848,57592,832
2021-04-27,Tuolumne,109,53932,3963,4028,38,4066,58
2021-04-27,Ventura,111,848112,80769,80152,2954,83106,1000
2021-04-27,Yolo,113,214977,13748,13697,280,13977,205
2021-04-27,Yuba,115,75493,5889,5853,121,5974,44
2021-04-26,Alameda,001,1643700,86560,86230,1903,88133,1256
2021-04-26,Alpine,003,1148,87,88,0,88,0
2021-04-26,Amador,005,37829,3649,3645,33,3678,46
2021-04-26,Butte,007,227075,12121,11720,1752,13472,196
2021-04-26,Calaveras,009,45235,2086,2074,13,2087,50
2021-04-26,Colusa,011,21464,1923,1925,292,2217,14
2021-04-26,Contra Costa,013,1133247,68074,67392,1218,68610,789
2021-04-26,Del Norte,015,27424,1301,1263,11,1274,6
2021-04-26,El Dorado,017,186661,9944,9849,696,10545,106
2021-04-26,Fresno,019,978130,101579,101099,8559,109658,1662
2021-04-26,Glenn,021,27897,2384,2367,542,2909,17
2021-04-26,Humboldt,023,135768,3813,3764,30,3794,35
2021-04-26,Imperial,025,180216,28259,28148,2702,30850,720
2021-04-26,Inyo,027,18085,1397,1396,10,1406,36
2021-04-26,Kern,029,883053,96482,95429,10632,106061,1295
2021-04-26,Kings,031,150075,23001,22756,1066,23822,244
2021-04-26,Lake,033,64148,3449,3428,9,3437,43
2021-04-26,Lassen,035,31185,5174,5138,105,5243,1
2021-04-26,Los Angeles,037,10098052,1199270,1191253,41339,1232592,23802
2021-04-26,Madera,039,155013,16468,16353,920,17273,231
2021-04-26,Marin,041,260295,13919,13849,239,14088,227
2021-04-26,Mariposa,043,17540,416,410,11,421,5
2021-04-26,Mendocino,045,87422,3829,3757,76,3833,46
2021-04-26,Merced,047,269075,30578,30611,1038,31649,443
2021-04-26,Modoc,049,8938,368,360,122,482,3
2021-04-26,Mono,051,14174,1246,1258,17,1275,3
2021-04-26,Monterey,053,433212,42915,42740,1852,44592,379
2021-04-26,Napa,055,140530,9761,9769,34,9803,79
2021-04-26,Nevada,057,99092,4636,4548,187,4735,70
2021-04-26,Orange,059,3164182,253967,252592,11169,263761,4919
2021-04-26,Placer,061,380077,22630,22032,1414,23446,285
2021-04-26,Plumas,063,18699,688,670,10,680,4
2021-04-26,Riverside,065,2383286,292437,286724,13907,300631,4401
2021-04-26,Sacramento,067,1510023,103109,102459,1634,104093,1587
2021-04-26,San Benito,069,59416,6012,6013,113,6126,63
2021-04-26,San Bernardino,071,2135413,291740,290394,8913,299307,4572
2021-04-26,San Diego,073,3302833,277275,275541,14453,289994,3692
2021-04-26,San Francisco,075,870044,36215,36330,1267,37597,532
2021-04-26,San Joaquin,077,732212,71834,71050,3442,74492,1301
2021-04-26,San Luis Obispo,079,281455,21120,20830,718,21548,255
2021-04-26,San Mateo,081,765935,41857,41457,456,41913,357
2021-04-26,Santa Barbara,083,443738,34124,33948,1131,35079,448
2021-04-26,Santa Clara,085,1922200,117397,117874,735,118609,1968
2021-04-26,Santa Cruz,087,273765,16092,15877,810,16687,205
2021-04-26,Shasta,089,179085,11783,11787,1443,13230,192
2021-04-26,Sierra,091,2930,55,51,12,63,0
2021-04-26,Siskiyou,093,43540,1724,1592,301,1893,11
2021-04-26,Solano,095,438530,32038,31913,493,32406,247
2021-04-26,Sonoma,097,501317,29602,29755,311,30066,318
2021-04-26,Stanislaus,099,539301,54992,54638,5816,60454,744
2021-04-26,Sutter,101,95872,9308,9328,82,9410,110
2021-04-26,Tehama,103,63373,4951,4920,552,5472,53
2021-04-26,Trinity,105,12862,482,326,86,412,3
2021-04-26,Tulare,107,460477,49757,48735,8839,57574,831
2021-04-26,Tuolumne,109,53932,3962,4024,38,4062,58
2021-04-26,Ventura,111,848112,80744,80137,2951,83088,999
2021-04-26,Yolo,113,214977,13728,13684,277,13961,205
2021-04-26,Yuba,115,75493,5887,5851,121,5972,44
2021-04-25,Alameda,001,1643700,86457,86162,1896,88058,1256
2021-04-25,Alpine,003,1148,87,87,0,87,0
2021-04-25,Amador,005,37829,3648,3643,33,3676,46
2021-04-25,Butte,007,227075,12092,11709,1745,13454,196
2021-04-25,Calaveras,009,45235,2081,2072,12,2084,50
2021-04-25,Colusa,011,21464,1922,1924,292,2216,14
2021-04-25,Contra Costa,013,1133247,67982,67316,1217,68533,789
2021-04-25,Del Norte,015,27424,1295,1259,11,1270,6
2021-04-25,El Dorado,017,186661,9928,9837,694,10531,106
2021-04-25,Fresno,019,978130,101520,101061,8547,109608,1662
2021-04-25,Glenn,021,27897,2384,2366,542,2908,17
2021-04-25,Humboldt,023,135768,3800,3751,30,3781,35
2021-04-25,Imperial,025,180216,28233,28136,2699,30835,720
2021-04-25,Inyo,027,18085,1397,1396,10,1406,36
2021-04-25,Kern,029,883053,96416,95398,10619,106017,1295
2021-04-25,Kings,031,150075,22987,22755,1064,23819,244
2021-04-25,Lake,033,64148,3447,3427,9,3436,43
2021-04-25,Lassen,035,31185,5172,5138,105,5243,1
2021-04-25,Los Angeles,037,10098052,1198936,1190970,41318,1232288,23799
2021-04-25,Madera,039,155013,16456,16346,920,17266,231
2021-04-25,Marin,041,260295,13910,13852,239,14091,227
2021-04-25,Mariposa,043,17540,416,410,11,421,5
2021-04-25,Mendocino,045,87422,3822,3757,76,3833,46
2021-04-25,Merced,047,269075,30544,30586,1037,31623,443
2021-04-25,Modoc,049,8938,368,360,122,482,3
2021-04-25,Mono,051,14174,1246,1257,17,1274,3
2021-04-25,Monterey,053,433212,42902,42737,1850,44587,379
2021-04-25,Napa,055,140530,9756,9762,34,9796,79
2021-04-25,Nevada,057,99092,4624,4536,187,4723,70
2021-04-25,Orange,059,3164182,253891,252531,11162,263693,4919
2021-04-25,Placer,061,380077,22584,22011,1406,23417,285
2021-04-25,Plumas,063,18699,687,670,10,680,4
2021-04-25,Riverside,065,2383286,292343,286651,13901,300552,4401
2021-04-25,Sacramento,067,1510023,102941,102319,1624,103943,1587
2021-04-25,San Benito,069,59416,6010,6014,112,6126,63
2021-04-25,San Bernardino,071,2135413,291665,290357,8905,299262,4571
2021-04-25,San Diego,073,3302833,277062,275412,14420,289832,3692
2021-04-25,San Francisco,075,870044,36184,36310,1267,37577,532
2021-04-25,San Joaquin,077,732212,71739,70987,3432,74419,1301
2021-04-25,San Luis Obispo,079,281455,21101,20820,716,21536,255
2021-04-25,San Mateo,081,765935,41822,41465,455,41920,356
2021-04-25,Santa Barbara,083,443738,34098,33931,1131,35062,448
2021-04-25,Santa Clara,085,1922200,117318,117778,733,118511,1968
2021-04-25,Santa Cruz,087,273765,16086,15868,808,16676,205
2021-04-25,Shasta,089,179085,11760,11784,1438,13222,192
2021-04-25,Sierra,091,2930,55,51,12,63,0
2021-04-25,Siskiyou,093,43540,1713,1580,299,1879,11
2021-04-25,Solano,095,438530,31991,31864,485,32349,247
2021-04-25,Sonoma,097,501317,29584,29756,311,30067,318
2021-04-25,Stanislaus,099,539301,54896,54543,5808,60351,744
2021-04-25,Sutter,101,95872,9302,9326,82,9408,110
2021-04-25,Tehama,103,63373,4947,4916,550,5466,53
2021-04-25,Trinity,105,12862,482,326,86,412,3
2021-04-25,Tulare,107,460477,49741,48728,8825,57553,831
2021-04-25,Tuolumne,109,53932,3960,4022,38,4060,58
2021-04-25,Ventura,111,848112,80720,80110,2951,83061,999
2021-04-25,Yolo,113,214977,13704,13667,275,13942,205
2021-04-25,Yuba,115,75493,5884,5849,120,5969,44
2021-04-24,Alameda,001,1643700,86403,86016,1894,87910,1257
2021-04-24,Alpine,003,1148,87,86,0,86,0
2021-04-24,Amador,005,37829,3647,3640,33,3673,46
2021-04-24,Butte,007,227075,12076,11678,1743,13421,196
2021-04-24,Calaveras,009,45235,2077,2067,12,2079,50
2021-04-24,Colusa,011,21464,1921,1921,292,2213,14
2021-04-24,Contra Costa,013,1133247,67912,67222,1215,68437,789
2021-04-24,Del Norte,015,27424,1290,1255,11,1266,6
2021-04-24,El Dorado,017,186661,9917,9814,693,10507,106
2021-04-24,Fresno,019,978130,101489,100991,8541,109532,1662
2021-04-24,Glenn,021,27897,2384,2363,542,2905,17
2021-04-24,Humboldt,023,135768,3786,3722,30,3752,35
2021-04-24,Imperial,025,180216,28226,28124,2698,30822,720
2021-04-24,Inyo,027,18085,1396,1396,10,1406,36
2021-04-24,Kern,029,883053,96397,95365,10609,105974,1295
2021-04-24,Kings,031,150075,22984,22749,1064,23813,244
2021-04-24,Lake,033,64148,3446,3426,9,3435,43
2021-04-24,Lassen,035,31185,5171,5137,105,5242,1
2021-04-24,Los Angeles,037,10098052,1198707,1190603,41302,1231905,23802
2021-04-24,Madera,039,155013,16453,16338,920,17258,231
2021-04-24,Marin,041,260295,13902,13847,239,14086,227
2021-04-24,Mariposa,043,17540,416,409,11,420,5
2021-04-24,Mendocino,045,87422,3820,3754,74,3828,46
2021-04-24,Merced,047,269075,30524,30559,1037,31596,443
2021-04-24,Modoc,049,8938,368,360,122,482,3
2021-04-24,Mono,051,14174,1246,1256,17,1273,3
2021-04-24,Monterey,053,433212,42890,42727,1849,44576,379
2021-04-24,Napa,055,140530,9750,9756,34,9790,79
2021-04-24,Nevada,057,99092,4617,4522,187,4709,70
2021-04-24,Orange,059,3164182,253847,252441,11156,263597,4910
2021-04-24,Placer,061,380077,22571,21983,1405,23388,285
2021-04-24,Plumas,063,18699,686,670,10,680,4
2021-04-24,Riverside,065,2383286,292275,286552,13897,300449,4400
2021-04-24,Sacramento,067,1510023,102858,102179,1617,103796,1587
2021-04-24,San Benito,069,59416,6008,6007,112,6119,63
2021-04-24,San Bernardino,071,2135413,291616,290264,8904,299168,4568
2021-04-24,San Diego,073,3302833,276958,275252,14400,289652,3688
2021-04-24,San Francisco,075,870044,36155,36285,1263,37548,532
2021-04-24,San Joaquin,077,732212,71696,70911,3429,74340,1301
2021-04-24,San Luis Obispo,079,281455,21091,20797,715,21512,255
2021-04-24,San Mateo,081,765935,41809,41424,453,41877,355
2021-04-24,Santa Barbara,083,443738,34083,33911,1130,35041,448
2021-04-24,Santa Clara,085,1922200,117263,117674,731,118405,1968
2021-04-24,Santa Cruz,087,273765,16078,15840,808,16648,205
2021-04-24,Shasta,089,179085,11742,11770,1435,13205,192
2021-04-24,Sierra,091,2930,55,51,12,63,0
2021-04-24,Siskiyou,093,43540,1703,1574,298,1872,11
2021-04-24,Solano,095,438530,31968,31821,482,32303,247
2021-04-24,Sonoma,097,501317,29582,29739,311,30050,318
2021-04-24,Stanislaus,099,539301,54847,54455,5805,60260,744
2021-04-24,Sutter,101,95872,9299,9316,82,9398,110
2021-04-24,Tehama,103,63373,4942,4907,550,5457,53
2021-04-24,Trinity,105,12862,482,326,86,412,3
2021-04-24,Tulare,107,460477,49730,48705,8815,57520,830
2021-04-24,Tuolumne,109,53932,3956,4020,38,4058,58
2021-04-24,Ventura,111,848112,80707,80097,2949,83046,999
2021-04-24,Yolo,113,214977,13693,13653,275,13928,205
2021-04-24,Yuba,115,75493,5882,5837,120,5957,44
2021-04-23,Alameda,001,1643700,86329,85935,1891,87826,1256
2021-04-23,Alpine,003,1148,86,86,0,86,0
2021-04-23,Amador,005,37829,3646,3637,33,3670,46
2021-04-23,Butte,007,227075,12055,11672,1738,13410,196
2021-04-23,Calaveras,009,45235,2074,2064,12,2076,50
2021-04-23,Colusa,011,21464,1920,1921,292,2213,14
2021-04-23,Contra Costa,013,1133247,67858,67164,1213,68377,785
2021-04-23,Del Norte,015,27424,1289,1254,11,1265,6
2021-04-23,El Dorado,017,186661,9900,9788,690,10478,106
2021-04-23,Fresno,019,978130,101448,100928,8535,109463,1662
2021-04-23,Glenn,021,27897,2384,2361,541,2902,17
2021-04-23,Humboldt,023,135768,3776,3698,30,3728,35
2021-04-23,Imperial,025,180216,28211,28108,2697,30805,720
2021-04-23,Inyo,027,18085,1396,1395,10,1405,36
2021-04-23,Kern,029,883053,96372,95330,10603,105933,1295
2021-04-23,Kings,031,150075,22981,22735,1064,23799,244
2021-04-23,Lake,033,64148,3444,3425,9,3434,43
2021-04-23,Lassen,035,31185,5171,5141,105,5246,1
2021-04-23,Los Angeles,037,10098052,1198443,1190264,41276,1231540,23785
2021-04-23,Madera,039,155013,16444,16328,920,17248,231
2021-04-23,Marin,041,260295,13897,13838,239,14077,227
2021-04-23,Mariposa,043,17540,415,405,11,416,5
2021-04-23,Mendocino,045,87422,3818,3745,73,3818,46
2021-04-23,Merced,047,269075,30507,30530,1036,31566,443
2021-04-23,Modoc,049,8938,368,360,122,482,3
2021-04-23,Mono,051,14174,1244,1256,17,1273,3
2021-04-23,Monterey,053,433212,42884,42722,1849,44571,377
2021-04-23,Napa,055,140530,9745,9752,34,9786,79
2021-04-23,Nevada,057,99092,4608,4510,187,4697,70
2021-04-23,Orange,059,3164182,253803,252399,11149,263548,4904
2021-04-23,Placer,061,380077,22548,21959,1404,23363,282
2021-04-23,Plumas,063,18699,685,670,10,680,4
2021-04-23,Riverside,065,2383286,292216,286456,13892,300348,4399
2021-04-23,Sacramento,067,1510023,102771,102041,1614,103655,1586
2021-04-23,San Benito,069,59416,6006,6005,112,6117,63
2021-04-23,San Bernardino,071,2135413,291565,290189,8903,299092,4568
2021-04-23,San Diego,073,3302833,276820,275097,14377,289474,3684
2021-04-23,San Francisco,075,870044,36139,36252,1262,37514,532
2021-04-23,San Joaquin,077,732212,71640,70840,3426,74266,1295
2021-04-23,San Luis Obispo,079,281455,21082,20781,714,21495,255
2021-04-23,San Mateo,081,765935,41782,41386,453,41839,355
2021-04-23,Santa Barbara,083,443738,34073,33895,1128,35023,447
2021-04-23,Santa Clara,085,1922200,117201,117593,730,118323,1965
2021-04-23,Santa Cruz,087,273765,16071,15802,808,16610,205
2021-04-23,Shasta,089,179085,11735,11759,1434,13193,192
2021-04-23,Sierra,091,2930,55,51,12,63,0
2021-04-23,Siskiyou,093,43540,1691,1567,297,1864,11
2021-04-23,Solano,095,438530,31936,31784,478,32262,247
2021-04-23,Sonoma,097,501317,29568,29727,311,30038,318
2021-04-23,Stanislaus,099,539301,54784,54391,5797,60188,744
2021-04-23,Sutter,101,95872,9297,9312,82,9394,110
2021-04-23,Tehama,103,63373,4939,4906,550,5456,53
2021-04-23,Trinity,105,12862,482,326,86,412,3
2021-04-23,Tulare,107,460477,49713,48694,8807,57501,829
2021-04-23,Tuolumne,109,53932,3955,4020,38,4058,58
2021-04-23,Ventura,111,848112,80688,80095,2949,83044,996
2021-04-23,Yolo,113,214977,13682,13647,274,13921,205
2021-04-23,Yuba,115,75493,5879,5828,120,5948,44
2021-04-22,Alameda,001,1643700,86240,85829,1890,87719,1253
2021-04-22,Alpine,003,1148,86,86,0,86,0
2021-04-22,Amador,005,37829,3645,3633,33,3666,46
2021-04-22,Butte,007,227075,12041,11656,1735,13391,196
2021-04-22,Calaveras,009,45235,2072,2059,12,2071,50
2021-04-22,Colusa,011,21464,1918,1920,290,2210,14
2021-04-22,Contra Costa,013,1133247,67786,67029,1208,68237,782
2021-04-22,Del Norte,015,27424,1284,1252,11,1263,6
2021-04-22,El Dorado,017,186661,9889,9773,687,10460,106
2021-04-22,Fresno,019,978130,101403,100864,8524,109388,1657
2021-04-22,Glenn,021,27897,2383,2361,541,2902,17
2021-04-22,Humboldt,023,135768,3767,3680,30,3710,35
2021-04-22,Imperial,025,180216,28190,28096,2694,30790,720
2021-04-22,Inyo,027,18085,1395,1394,10,1404,36
2021-04-22,Kern,029,883053,96329,95292,10586,105878,1299
2021-04-22,Kings,031,150075,22971,22725,1064,23789,243
2021-04-22,Lake,033,64148,3442,3423,9,3432,43
2021-04-22,Lassen,035,31185,5171,5155,105,5260,1
2021-04-22,Los Angeles,037,10098052,1198123,1189878,41254,1231132,23762
2021-04-22,Madera,039,155013,16425,16316,920,17236,231
2021-04-22,Marin,041,260295,13889,13832,239,14071,227
2021-04-22,Mariposa,043,17540,414,403,11,414,5
2021-04-22,Mendocino,045,87422,3812,3729,73,3802,46
2021-04-22,Merced,047,269075,30472,30490,1035,31525,443
2021-04-22,Modoc,049,8938,368,360,122,482,3
2021-04-22,Mono,051,14174,1244,1254,17,1271,3
2021-04-22,Monterey,053,433212,42877,42708,1847,44555,377
2021-04-22,Napa,055,140530,9735,9734,34,9768,79
2021-04-22,Nevada,057,99092,4598,4504,185,4689,70
2021-04-22,Orange,059,3164182,253730,252307,11137,263444,4898
2021-04-22,Placer,061,380077,22516,21916,1400,23316,282
2021-04-22,Plumas,063,18699,684,670,10,680,4
2021-04-22,Riverside,065,2383286,292117,286362,13883,300245,4398
2021-04-22,Sacramento,067,1510023,102622,101870,1605,103475,1585
2021-04-22,San Benito,069,59416,6002,5998,112,6110,63
2021-04-22,San Bernardino,071,2135413,291494,290125,8894,299019,4571
2021-04-22,San Diego,073,3302833,276654,275913,14355,290268,3684
2021-04-22,San Francisco,075,870044,36116,36218,1259,37477,532
2021-04-22,San Joaquin,077,732212,71581,70751,3419,74170,1295
2021-04-22,San Luis Obispo,079,281455,21068,20761,714,21475,255
2021-04-22,San Mateo,081,765935,41755,41345,451,41796,355
2021-04-22,Santa Barbara,083,443738,34050,33870,1127,34997,446
2021-04-22,Santa Clara,085,1922200,117113,117457,726,118183,1954
2021-04-22,Santa Cruz,087,273765,16068,15737,807,16544,205
2021-04-22,Shasta,089,179085,11720,11738,1432,13170,192
2021-04-22,Sierra,091,2930,55,51,12,63,0
2021-04-22,Siskiyou,093,43540,1687,1564,296,1860,11
2021-04-22,Solano,095,438530,31890,31731,475,32206,247
2021-04-22,Sonoma,097,501317,29553,29705,307,30012,318
2021-04-22,Stanislaus,099,539301,54711,54313,5791,60104,744
2021-04-22,Sutter,101,95872,9293,9302,82,9384,110
2021-04-22,Tehama,103,63373,4933,4896,546,5442,53
2021-04-22,Trinity,105,12862,482,326,86,412,3
2021-04-22,Tulare,107,460477,49693,48669,8798,57467,828
2021-04-22,Tuolumne,109,53932,3951,4020,38,4058,58
2021-04-22,Ventura,111,848112,80662,80073,2947,83020,996
2021-04-22,Yolo,113,214977,13661,13616,274,13890,205
2021-04-22,Yuba,115,75493,5869,5825,120,5945,44
2021-04-21,Alameda,001,1643700,86161,85762,1888,87650,1249
2021-04-21,Alpine,003,1148,86,86,0,86,0
2021-04-21,Amador,005,37829,3642,3632,33,3665,46
2021-04-21,Butte,007,227075,12021,11643,1733,13376,196
2021-04-21,Calaveras,009,45235,2062,2057,12,2069,50
2021-04-21,Colusa,011,21464,1916,1920,289,2209,14
2021-04-21,Contra Costa,013,1133247,67720,66981,1207,68188,782
2021-04-21,Del Norte,015,27424,1280,1252,11,1263,6
2021-04-21,El Dorado,017,186661,9872,9760,684,10444,106
2021-04-21,Fresno,019,978130,101347,100838,8518,109356,1654
2021-04-21,Glenn,021,27897,2382,2361,541,2902,17
2021-04-21,Humboldt,023,135768,3748,3642,30,3672,35
2021-04-21,Imperial,025,180216,28178,28052,2693,30745,719
2021-04-21,Inyo,027,18085,1395,1392,10,1402,36
2021-04-21,Kern,029,883053,96283,95257,10576,105833,1297
2021-04-21,Kings,031,150075,22964,22713,1063,23776,243
2021-04-21,Lake,033,64148,3439,3421,9,3430,43
2021-04-21,Lassen,035,31185,5170,5156,105,5261,1
2021-04-21,Los Angeles,037,10098052,1197783,1189530,41234,1230764,23729
2021-04-21,Madera,039,155013,16420,16309,920,17229,231
2021-04-21,Marin,041,260295,13874,13822,239,14061,227
2021-04-21,Mariposa,043,17540,413,402,11,413,5
2021-04-21,Mendocino,045,87422,3810,3729,73,3802,46
2021-04-21,Merced,047,269075,30452,30471,1033,31504,442
2021-04-21,Modoc,049,8938,368,360,122,482,3
2021-04-21,Mono,051,14174,1244,1254,17,1271,3
2021-04-21,Monterey,053,433212,42862,42699,1845,44544,377
2021-04-21,Napa,055,140530,9729,9727,34,9761,79
2021-04-21,Nevada,057,99092,4584,4499,185,4684,70
2021-04-21,Orange,059,3164182,253654,252243,11124,263367,4889
2021-04-21,Placer,061,380077,22485,21896,1395,23291,282
2021-04-21,Plumas,063,18699,684,670,10,680,4
2021-04-21,Riverside,065,2383286,292023,286299,13876,300175,4388
2021-04-21,Sacramento,067,1510023,102493,101803,1599,103402,1579
2021-04-21,San Benito,069,59416,5999,5998,112,6110,63
2021-04-21,San Bernardino,071,2135413,291419,290049,8892,298941,4572
2021-04-21,San Diego,073,3302833,276445,275632,14317,289949,3681
2021-04-21,San Francisco,075,870044,36096,36194,1258,37452,529
2021-04-21,San Joaquin,077,732212,71526,70687,3409,74096,1295
2021-04-21,San Luis Obispo,079,281455,21053,20724,713,21437,255
2021-04-21,San Mateo,081,765935,41723,41318,450,41768,355
2021-04-21,Santa Barbara,083,443738,34031,33830,1126,34956,445
2021-04-21,Santa Clara,085,1922200,117035,117318,720,118038,1946
2021-04-21,Santa Cruz,087,273765,16059,15698,807,16505,204
2021-04-21,Shasta,089,179085,11701,11722,1430,13152,192
2021-04-21,Sierra,091,2930,55,51,12,63,0
2021-04-21,Siskiyou,093,43540,1680,1557,296,1853,11
2021-04-21,Solano,095,438530,31851,31712,474,32186,244
2021-04-21,Sonoma,097,501317,29541,29697,305,30002,318
2021-04-21,Stanislaus,099,539301,54650,54290,5785,60075,742
2021-04-21,Sutter,101,95872,9285,9297,82,9379,110
2021-04-21,Tehama,103,63373,4926,4893,545,5438,53
2021-04-21,Trinity,105,12862,482,326,86,412,3
2021-04-21,Tulare,107,460477,49678,48653,8785,57438,828
2021-04-21,Tuolumne,109,53932,3948,4019,38,4057,58
2021-04-21,Ventura,111,848112,80630,80039,2944,82983,996
2021-04-21,Yolo,113,214977,13641,13606,273,13879,200
2021-04-21,Yuba,115,75493,5862,5822,119,5941,44
2021-04-20,Alameda,001,1643700,86066,85652,1886,87538,1248
2021-04-20,Alpine,003,1148,85,85,0,85,0
2021-04-20,Amador,005,37829,3641,3631,33,3664,46
2021-04-20,Butte,007,227075,12002,11619,1731,13350,196
2021-04-20,Calaveras,009,45235,2061,2053,12,2065,50
2021-04-20,Colusa,011,21464,1916,1915,288,2203,14
2021-04-20,Contra Costa,013,1133247,67636,66889,1204,68093,782
2021-04-20,Del Norte,015,27424,1279,1250,11,1261,6
2021-04-20,El Dorado,017,186661,9844,9743,682,10425,106
2021-04-20,Fresno,019,978130,101289,100768,8508,109276,1650
2021-04-20,Glenn,021,27897,2380,2359,540,2899,17
2021-04-20,Humboldt,023,135768,3730,3612,30,3642,35
2021-04-20,Imperial,025,180216,28159,28024,2689,30713,719
2021-04-20,Inyo,027,18085,1395,1393,10,1403,36
2021-04-20,Kern,029,883053,96247,95223,10559,105782,1295
2021-04-20,Kings,031,150075,22958,22693,1060,23753,243
2021-04-20,Lake,033,64148,3437,3418,9,3427,43
2021-04-20,Lassen,035,31185,5170,5155,105,5260,1
2021-04-20,Los Angeles,037,10098052,1197436,1189256,41204,1230460,23694
2021-04-20,Madera,039,155013,16414,16301,920,17221,231
2021-04-20,Marin,041,260295,13860,13807,239,14046,227
2021-04-20,Mariposa,043,17540,412,402,11,413,5
2021-04-20,Mendocino,045,87422,3809,3726,73,3799,46
2021-04-20,Merced,047,269075,30425,30439,1032,31471,441
2021-04-20,Modoc,049,8938,368,359,122,481,3
2021-04-20,Mono,051,14174,1243,1254,17,1271,3
2021-04-20,Monterey,053,433212,42851,42663,1842,44505,363
2021-04-20,Napa,055,140530,9725,9711,34,9745,79
2021-04-20,Nevada,057,99092,4566,4485,185,4670,70
2021-04-20,Orange,059,3164182,253564,252134,11112,263246,4887
2021-04-20,Placer,061,380077,22451,21846,1391,23237,282
2021-04-20,Plumas,063,18699,683,670,10,680,4
2021-04-20,Riverside,065,2383286,291926,286194,13871,300065,4388
2021-04-20,Sacramento,067,1510023,102355,101629,1591,103220,1574
2021-04-20,San Benito,069,59416,5996,5988,112,6100,63
2021-04-20,San Bernardino,071,2135413,291339,289905,8890,298795,4569
2021-04-20,San Diego,073,3302833,276214,275369,14284,289653,3674
2021-04-20,San Francisco,075,870044,36077,36117,1257,37374,529
2021-04-20,San Joaquin,077,732212,71453,70590,3400,73990,1289
2021-04-20,San Luis Obispo,079,281455,21030,20691,705,21396,254
2021-04-20,San Mateo,081,765935,41692,41251,450,41701,355
2021-04-20,Santa Barbara,083,443738,34012,33803,1126,34929,445
2021-04-20,Santa Clara,085,1922200,116937,117228,716,117944,1944
2021-04-20,Santa Cruz,087,273765,16047,15647,807,16454,204
2021-04-20,Shasta,089,179085,11685,11677,1427,13104,189
2021-04-20,Sierra,091,2930,55,51,12,63,0
2021-04-20,Siskiyou,093,43540,1672,1551,295,1846,10
2021-04-20,Solano,095,438530,31796,31673,470,32143,243
2021-04-20,Sonoma,097,501317,29532,29676,303,29979,311
2021-04-20,Stanislaus,099,539301,54585,54236,5772,60008,735
2021-04-20,Sutter,101,95872,9281,9279,82,9361,109
2021-04-20,Tehama,103,63373,4921,4887,544,5431,52
2021-04-20,Trinity,105,12862,482,326,86,412,3
2021-04-20,Tulare,107,460477,49655,48650,8777,57427,831
2021-04-20,Tuolumne,109,53932,3948,4014,38,4052,58
2021-04-20,Ventura,111,848112,80602,80018,2942,82960,995
2021-04-20,Yolo,113,214977,13621,13581,272,13853,200
2021-04-20,Yuba,115,75493,5852,5814,119,5933,44
2021-04-19,Alameda,001,1643700,85946,85583,1883,87466,1247
2021-04-19,Alpine,003,1148,85,85,0,85,0
2021-04-19,Amador,005,37829,3640,3629,33,3662,46
2021-04-19,Butte,007,227075,11984,11601,1726,13327,196
2021-04-19,Calaveras,009,45235,2059,2050,12,2062,50
2021-04-19,Colusa,011,21464,1916,1913,287,2200,14
2021-04-19,Contra Costa,013,1133247,67558,66833,1202,68035,782
2021-04-19,Del Norte,015,27424,1277,1247,11,1258,6
2021-04-19,El Dorado,017,186661,9828,9726,677,10403,106
2021-04-19,Fresno,019,978130,101221,100702,8496,109198,1646
2021-04-19,Glenn,021,27897,2380,2358,539,2897,17
2021-04-19,Humboldt,023,135768,3710,3602,28,3630,35
2021-04-19,Imperial,025,180216,28138,27995,2689,30684,719
2021-04-19,Inyo,027,18085,1395,1392,10,1402,36
2021-04-19,Kern,029,883053,96217,95162,10544,105706,1290
2021-04-19,Kings,031,150075,22942,22688,1060,23748,243
2021-04-19,Lake,033,64148,3436,3416,9,3425,43
2021-04-19,Lassen,035,31185,5169,5156,105,5261,1
2021-04-19,Los Angeles,037,10098052,1197059,1188945,41179,1230124,23666
2021-04-19,Madera,039,155013,16403,16289,919,17208,231
2021-04-19,Marin,041,260295,13849,13804,238,14042,226
2021-04-19,Mariposa,043,17540,411,401,11,412,5
2021-04-19,Mendocino,045,87422,3807,3722,73,3795,46
2021-04-19,Merced,047,269075,30396,30422,1031,31453,441
2021-04-19,Modoc,049,8938,368,359,122,481,3
2021-04-19,Mono,051,14174,1242,1254,17,1271,3
2021-04-19,Monterey,053,433212,42838,42642,1837,44479,356
2021-04-19,Napa,055,140530,9717,9680,34,9714,79
2021-04-19,Nevada,057,99092,4550,4477,185,4662,70
2021-04-19,Orange,059,3164182,253446,252013,11098,263111,4883
2021-04-19,Placer,061,380077,22428,21814,1387,23201,282
2021-04-19,Plumas,063,18699,683,665,10,675,4
2021-04-19,Riverside,065,2383286,291830,286087,13861,299948,4371
2021-04-19,Sacramento,067,1510023,102220,101482,1581,103063,1572
2021-04-19,San Benito,069,59416,5988,5989,112,6101,63
2021-04-19,San Bernardino,071,2135413,291253,289738,8884,298622,4561
2021-04-19,San Diego,073,3302833,275966,275113,14251,289364,3674
2021-04-19,San Francisco,075,870044,36041,36094,1254,37348,529
2021-04-19,San Joaquin,077,732212,71373,70514,3393,73907,1289
2021-04-19,San Luis Obispo,079,281455,21004,20669,699,21368,254
2021-04-19,San Mateo,081,765935,41659,41226,449,41675,355
2021-04-19,Santa Barbara,083,443738,33998,33786,1126,34912,446
2021-04-19,Santa Clara,085,1922200,116826,117099,712,117811,1944
2021-04-19,Santa Cruz,087,273765,16035,15600,807,16407,204
2021-04-19,Shasta,089,179085,11670,11662,1419,13081,189
2021-04-19,Sierra,091,2930,55,51,12,63,0
2021-04-19,Siskiyou,093,43540,1662,1544,295,1839,10
2021-04-19,Solano,095,438530,31757,31643,465,32108,239
2021-04-19,Sonoma,097,501317,29513,29667,303,29970,311
2021-04-19,Stanislaus,099,539301,54509,54179,5768,59947,728
2021-04-19,Sutter,101,95872,9270,9269,82,9351,109
2021-04-19,Tehama,103,63373,4915,4878,544,5422,52
2021-04-19,Trinity,105,12862,482,326,85,411,3
2021-04-19,Tulare,107,460477,49639,48630,8764,57394,831
2021-04-19,Tuolumne,109,53932,3947,4010,38,4048,58
2021-04-19,Ventura,111,848112,80576,80000,2940,82940,996
2021-04-19,Yolo,113,214977,13609,13572,269,13841,200
2021-04-19,Yuba,115,75493,5845,5804,118,5922,44
2021-04-18,Alameda,001,1643700,85832,85481,1875,87356,1247
2021-04-18,Alpine,003,1148,85,85,0,85,0
2021-04-18,Amador,005,37829,3637,3627,33,3660,46
2021-04-18,Butte,007,227075,11966,11591,1721,13312,196
2021-04-18,Calaveras,009,45235,2053,2047,12,2059,50
2021-04-18,Colusa,011,21464,1912,1912,286,2198,14
2021-04-18,Contra Costa,013,1133247,67455,66750,1198,67948,782
2021-04-18,Del Norte,015,27424,1277,1240,11,1251,6
2021-04-18,El Dorado,017,186661,9805,9710,675,10385,106
2021-04-18,Fresno,019,978130,101163,100621,8490,109111,1646
2021-04-18,Glenn,021,27897,2375,2358,539,2897,17
2021-04-18,Humboldt,023,135768,3682,3590,28,3618,35
2021-04-18,Imperial,025,180216,28123,27991,2684,30675,719
2021-04-18,Inyo,027,18085,1394,1392,10,1402,36
2021-04-18,Kern,029,883053,96181,95129,10528,105657,1290
2021-04-18,Kings,031,150075,22933,22685,1060,23745,243
2021-04-18,Lake,033,64148,3435,3413,9,3422,43
2021-04-18,Lassen,035,31185,5166,5156,105,5261,1
2021-04-18,Los Angeles,037,10098052,1196598,1188620,41156,1229776,23648
2021-04-18,Madera,039,155013,16392,16277,918,17195,231
2021-04-18,Marin,041,260295,13842,13801,237,14038,226
2021-04-18,Mariposa,043,17540,410,400,10,410,5
2021-04-18,Mendocino,045,87422,3804,3722,73,3795,46
2021-04-18,Merced,047,269075,30359,30405,1029,31434,441
2021-04-18,Modoc,049,8938,368,359,122,481,3
2021-04-18,Mono,051,14174,1242,1254,17,1271,3
2021-04-18,Monterey,053,433212,42826,42638,1836,44474,356
2021-04-18,Napa,055,140530,9701,9674,34,9708,79
2021-04-18,Nevada,057,99092,4535,4464,185,4649,70
2021-04-18,Orange,059,3164182,253332,251940,11090,263030,4883
2021-04-18,Placer,061,380077,22385,21783,1381,23164,282
2021-04-18,Plumas,063,18699,682,665,10,675,4
2021-04-18,Riverside,065,2383286,291740,286043,13857,299900,4371
2021-04-18,Sacramento,067,1510023,102045,101354,1575,102929,1572
2021-04-18,San Benito,069,59416,5986,5989,112,6101,63
2021-04-18,San Bernardino,071,2135413,291160,289691,8875,298566,4556
2021-04-18,San Diego,073,3302833,275687,274961,14216,289177,3674
2021-04-18,San Francisco,075,870044,36004,36073,1250,37323,525
2021-04-18,San Joaquin,077,732212,71292,70466,3384,73850,1289
2021-04-18,San Luis Obispo,079,281455,20982,20656,693,21349,254
2021-04-18,San Mateo,081,765935,41630,41201,448,41649,352
2021-04-18,Santa Barbara,083,443738,33963,33769,1125,34894,446
2021-04-18,Santa Clara,085,1922200,116658,116996,706,117702,1944
2021-04-18,Santa Cruz,087,273765,16025,15580,806,16386,204
2021-04-18,Shasta,089,179085,11649,11658,1416,13074,189
2021-04-18,Sierra,091,2930,55,51,12,63,0
2021-04-18,Siskiyou,093,43540,1651,1538,293,1831,10
2021-04-18,Solano,095,438530,31707,31606,464,32070,239
2021-04-18,Sonoma,097,501317,29497,29660,301,29961,311
2021-04-18,Stanislaus,099,539301,54427,54132,5761,59893,728
2021-04-18,Sutter,101,95872,9256,9261,82,9343,109
2021-04-18,Tehama,103,63373,4906,4877,543,5420,52
2021-04-18,Trinity,105,12862,482,326,85,411,3
2021-04-18,Tulare,107,460477,49627,48618,8758,57376,829
2021-04-18,Tuolumne,109,53932,3946,4008,37,4045,58
2021-04-18,Ventura,111,848112,80545,79984,2936,82920,996
2021-04-18,Yolo,113,214977,13597,13562,267,13829,200
2021-04-18,Yuba,115,75493,5838,5804,118,5922,44
2021-04-17,Alameda,001,1643700,85759,85367,1871,87238,1247
2021-04-17,Alpine,003,1148,85,85,0,85,0
2021-04-17,Amador,005,37829,3635,3625,33,3658,46
2021-04-17,Butte,007,227075,11946,11573,1717,13290,196
2021-04-17,Calaveras,009,45235,2051,2045,12,2057,50
2021-04-17,Colusa,011,21464,1912,1912,286,2198,14
2021-04-17,Contra Costa,013,1133247,67407,66657,1190,67847,782
2021-04-17,Del Norte,015,27424,1277,1238,11,1249,6
2021-04-17,El Dorado,017,186661,9790,9692,672,10364,106
2021-04-17,Fresno,019,978130,101130,100562,8485,109047,1646
2021-04-17,Glenn,021,27897,2375,2357,539,2896,17
2021-04-17,Humboldt,023,135768,3658,3579,28,3607,35
2021-04-17,Imperial,025,180216,28112,27987,2683,30670,719
2021-04-17,Inyo,027,18085,1391,1392,10,1402,36
2021-04-17,Kern,029,883053,96163,95102,10524,105626,1290
2021-04-17,Kings,031,150075,22928,22678,1059,23737,243
2021-04-17,Lake,033,64148,3434,3409,9,3418,43
2021-04-17,Lassen,035,31185,5166,5154,105,5259,1
2021-04-17,Los Angeles,037,10098052,1196342,1188262,41123,1229385,23653
2021-04-17,Madera,039,155013,16388,16260,917,17177,231
2021-04-17,Marin,041,260295,13838,13797,237,14034,226
2021-04-17,Mariposa,043,17540,409,398,10,408,5
2021-04-17,Mendocino,045,87422,3801,3721,73,3794,46
2021-04-17,Merced,047,269075,30343,30392,1028,31420,441
2021-04-17,Modoc,049,8938,368,357,122,479,3
2021-04-17,Mono,051,14174,1242,1253,17,1270,3
2021-04-17,Monterey,053,433212,42817,42630,1834,44464,356
2021-04-17,Napa,055,140530,9697,9666,34,9700,79
2021-04-17,Nevada,057,99092,4527,4457,185,4642,70
2021-04-17,Orange,059,3164182,253263,251873,11078,262951,4878
2021-04-17,Placer,061,380077,22362,21736,1376,23112,282
2021-04-17,Plumas,063,18699,681,666,10,676,4
2021-04-17,Riverside,065,2383286,291671,285963,13849,299812,4371
2021-04-17,Sacramento,067,1510023,101935,101172,1564,102736,1572
2021-04-17,San Benito,069,59416,5980,5986,112,6098,63
2021-04-17,San Bernardino,071,2135413,291105,289624,8872,298496,4555
2021-04-17,San Diego,073,3302833,275540,274812,14182,288994,3674
2021-04-17,San Francisco,075,870044,35982,36032,1247,37279,523
2021-04-17,San Joaquin,077,732212,71252,70372,3374,73746,1288
2021-04-17,San Luis Obispo,079,281455,20969,20642,690,21332,254
2021-04-17,San Mateo,081,765935,41607,41157,448,41605,352
2021-04-17,Santa Barbara,083,443738,33932,33738,1123,34861,446
2021-04-17,Santa Clara,085,1922200,116566,116887,704,117591,1944
2021-04-17,Santa Cruz,087,273765,16019,15571,806,16377,204
2021-04-17,Shasta,089,179085,11634,11647,1415,13062,189
2021-04-17,Sierra,091,2930,55,51,12,63,0
2021-04-17,Siskiyou,093,43540,1646,1539,290,1829,10
2021-04-17,Solano,095,438530,31676,31541,461,32002,239
2021-04-17,Sonoma,097,501317,29490,29637,301,29938,311
2021-04-17,Stanislaus,099,539301,54390,54058,5756,59814,728
2021-04-17,Sutter,101,95872,9250,9252,82,9334,109
2021-04-17,Tehama,103,63373,4900,4875,542,5417,52
2021-04-17,Trinity,105,12862,482,326,85,411,3
2021-04-17,Tulare,107,460477,49615,48603,8754,57357,829
2021-04-17,Tuolumne,109,53932,3944,4005,37,4042,58
2021-04-17,Ventura,111,848112,80524,79964,2936,82900,996
2021-04-17,Yolo,113,214977,13587,13580,267,13847,200
2021-04-17,Yuba,115,75493,5833,5802,117,5919,44
2021-04-16,Alameda,001,1643700,85680,85243,1869,87112,1245
2021-04-16,Alpine,003,1148,85,85,0,85,0
2021-04-16,Amador,005,37829,3630,3621,33,3654,46
2021-04-16,Butte,007,227075,11934,11549,1715,13264,196
2021-04-16,Calaveras,009,45235,2049,2042,12,2054,50
2021-04-16,Colusa,011,21464,1910,1911,286,2197,14
2021-04-16,Contra Costa,013,1133247,67353,66569,1187,67756,782
2021-04-16,Del Norte,015,27424,1276,1237,11,1248,6
2021-04-16,El Dorado,017,186661,9770,9665,668,10333,106
2021-04-16,Fresno,019,978130,101080,100500,8479,108979,1643
2021-04-16,Glenn,021,27897,2375,2355,539,2894,17
2021-04-16,Humboldt,023,135768,3637,3570,27,3597,35
2021-04-16,Imperial,025,180216,28102,27962,2683,30645,719
2021-04-16,Inyo,027,18085,1391,1392,10,1402,36
2021-04-16,Kern,029,883053,96134,95066,10521,105587,1288
2021-04-16,Kings,031,150075,22924,22667,1058,23725,243
2021-04-16,Lake,033,64148,3428,3406,9,3415,43
2021-04-16,Lassen,035,31185,5165,5155,105,5260,1
2021-04-16,Los Angeles,037,10098052,1196041,1187818,41087,1228905,23627
2021-04-16,Madera,039,155013,16382,16250,916,17166,231
2021-04-16,Marin,041,260295,13835,13788,237,14025,226
2021-04-16,Mariposa,043,17540,408,396,9,405,5
2021-04-16,Mendocino,045,87422,3799,3719,73,3792,46
2021-04-16,Merced,047,269075,30328,30355,1028,31383,438
2021-04-16,Modoc,049,8938,368,355,122,477,3
2021-04-16,Mono,051,14174,1242,1253,17,1270,3
2021-04-16,Monterey,053,433212,42806,42620,1831,44451,351
2021-04-16,Napa,055,140530,9689,9653,34,9687,79
2021-04-16,Nevada,057,99092,4518,4443,185,4628,70
2021-04-16,Orange,059,3164182,253199,251770,11069,262839,4873
2021-04-16,Placer,061,380077,22335,21680,1371,23051,282
2021-04-16,Plumas,063,18699,680,665,10,675,4
2021-04-16,Riverside,065,2383286,291594,285818,13847,299665,4369
2021-04-16,Sacramento,067,1510023,101838,100993,1559,102552,1572
2021-04-16,San Benito,069,59416,5978,5982,112,6094,63
2021-04-16,San Bernardino,071,2135413,291058,289424,8871,298295,4550
2021-04-16,San Diego,073,3302833,275386,274567,14164,288731,3662
2021-04-16,San Francisco,075,870044,35956,35993,1243,37236,517
2021-04-16,San Joaquin,077,732212,71185,70280,3366,73646,1288
2021-04-16,San Luis Obispo,079,281455,20957,20623,689,21312,253
2021-04-16,San Mateo,081,765935,41578,41107,447,41554,352
2021-04-16,Santa Barbara,083,443738,33914,33703,1123,34826,446
2021-04-16,Santa Clara,085,1922200,116466,116693,701,117394,1941
2021-04-16,Santa Cruz,087,273765,16017,15539,806,16345,204
2021-04-16,Shasta,089,179085,11622,11623,1413,13036,189
2021-04-16,Sierra,091,2930,55,51,12,63,0
2021-04-16,Siskiyou,093,43540,1642,1530,288,1818,10
2021-04-16,Solano,095,438530,31637,31470,458,31928,239
2021-04-16,Sonoma,097,501317,29479,29617,301,29918,311
2021-04-16,Stanislaus,099,539301,54342,53983,5754,59737,728
2021-04-16,Sutter,101,95872,9244,9247,82,9329,109
2021-04-16,Tehama,103,63373,4899,4866,542,5408,52
2021-04-16,Trinity,105,12862,482,326,85,411,3
2021-04-16,Tulare,107,460477,49603,48583,8750,57333,830
2021-04-16,Tuolumne,109,53932,3941,4005,37,4042,58
2021-04-16,Ventura,111,848112,80499,79942,2931,82873,994
2021-04-16,Yolo,113,214977,13574,13559,265,13824,198
2021-04-16,Yuba,115,75493,5830,5795,116,5911,44
2021-04-15,Alameda,001,1643700,85573,85089,1867,86956,1246
2021-04-15,Alpine,003,1148,85,85,0,85,0
2021-04-15,Amador,005,37829,3629,3616,33,3649,46
2021-04-15,Butte,007,227075,11919,11529,1711,13240,196
2021-04-15,Calaveras,009,45235,2049,2039,12,2051,50
2021-04-15,Colusa,011,21464,1908,1909,285,2194,14
2021-04-15,Contra Costa,013,1133247,67279,66480,1183,67663,781
2021-04-15,Del Norte,015,27424,1269,1235,11,1246,6
2021-04-15,El Dorado,017,186661,9757,9639,666,10305,106
2021-04-15,Fresno,019,978130,101018,100431,8473,108904,1642
2021-04-15,Glenn,021,27897,2375,2354,539,2893,17
2021-04-15,Humboldt,023,135768,3616,3561,27,3588,35
2021-04-15,Imperial,025,180216,28074,27920,2680,30600,718
2021-04-15,Inyo,027,18085,1391,1393,10,1403,36
2021-04-15,Kern,029,883053,96101,94989,10507,105496,1289
2021-04-15,Kings,031,150075,22910,22648,1058,23706,242
2021-04-15,Lake,033,64148,3427,3399,9,3408,43
2021-04-15,Lassen,035,31185,5164,5152,105,5257,1
2021-04-15,Los Angeles,037,10098052,1195639,1187274,41051,1228325,23598
2021-04-15,Madera,039,155013,16367,16234,916,17150,231
2021-04-15,Marin,041,260295,13831,13783,236,14019,226
2021-04-15,Mariposa,043,17540,406,395,9,404,5
2021-04-15,Mendocino,045,87422,3798,3714,73,3787,46
2021-04-15,Merced,047,269075,30302,30325,1027,31352,437
2021-04-15,Modoc,049,8938,368,355,122,477,3
2021-04-15,Mono,051,14174,1241,1253,17,1270,3
2021-04-15,Monterey,053,433212,42796,42604,1829,44433,347
2021-04-15,Napa,055,140530,9681,9645,34,9679,79
2021-04-15,Nevada,057,99092,4506,4434,184,4618,70
2021-04-15,Orange,059,3164182,253104,251679,11056,262735,4857
2021-04-15,Placer,061,380077,22304,21614,1364,22978,281
2021-04-15,Plumas,063,18699,678,665,10,675,4
2021-04-15,Riverside,065,2383286,291490,285698,13840,299538,4363
2021-04-15,Sacramento,067,1510023,101708,100782,1545,102327,1570
2021-04-15,San Benito,069,59416,5975,5969,111,6080,63
2021-04-15,San Bernardino,071,2135413,290969,289288,8864,298152,4544
2021-04-15,San Diego,073,3302833,275140,274250,14105,288355,3653
2021-04-15,San Francisco,075,870044,35937,35947,1241,37188,510
2021-04-15,San Joaquin,077,732212,71104,70189,3358,73547,1288
2021-04-15,San Luis Obispo,079,281455,20941,20591,686,21277,253
2021-04-15,San Mateo,081,765935,41539,41050,446,41496,352
2021-04-15,Santa Barbara,083,443738,33896,33672,1119,34791,446
2021-04-15,Santa Clara,085,1922200,116360,116602,697,117299,1927
2021-04-15,Santa Cruz,087,273765,16007,15509,806,16315,203
2021-04-15,Shasta,089,179085,11608,11597,1409,13006,191
2021-04-15,Sierra,091,2930,55,51,12,63,0
2021-04-15,Siskiyou,093,43540,1636,1524,287,1811,10
2021-04-15,Solano,095,438530,31599,31394,457,31851,239
2021-04-15,Sonoma,097,501317,29465,29587,301,29888,311
2021-04-15,Stanislaus,099,539301,54288,53918,5745,59663,728
2021-04-15,Sutter,101,95872,9237,9237,82,9319,109
2021-04-15,Tehama,103,63373,4898,4854,541,5395,52
2021-04-15,Trinity,105,12862,482,326,85,411,3
2021-04-15,Tulare,107,460477,49582,48556,8750,57306,829
2021-04-15,Tuolumne,109,53932,3941,4003,37,4040,57
2021-04-15,Ventura,111,848112,80480,79917,2929,82846,989
2021-04-15,Yolo,113,214977,13555,13547,263,13810,198
2021-04-15,Yuba,115,75493,5827,5788,116,5904,44
2021-04-14,Alameda,001,1643700,85476,85009,1866,86875,1247
2021-04-14,Alpine,003,1148,85,85,0,85,0
2021-04-14,Amador,005,37829,3628,3613,33,3646,46
2021-04-14,Butte,007,227075,11906,11513,1710,13223,196
2021-04-14,Calaveras,009,45235,2048,2037,12,2049,50
2021-04-14,Colusa,011,21464,1908,1905,285,2190,14
2021-04-14,Contra Costa,013,1133247,67193,66400,1177,67577,781
2021-04-14,Del Norte,015,27424,1269,1228,11,1239,6
2021-04-14,El Dorado,017,186661,9742,9625,661,10286,106
2021-04-14,Fresno,019,978130,100961,100376,8460,108836,1640
2021-04-14,Glenn,021,27897,2375,2353,539,2892,17
2021-04-14,Humboldt,023,135768,3594,3551,26,3577,35
2021-04-14,Imperial,025,180216,28052,27907,2678,30585,718
2021-04-14,Inyo,027,18085,1391,1392,10,1402,36
2021-04-14,Kern,029,883053,96076,94947,10500,105447,1287
2021-04-14,Kings,031,150075,22901,22641,1056,23697,243
2021-04-14,Lake,033,64148,3422,3396,9,3405,43
2021-04-14,Lassen,035,31185,5163,5151,105,5256,1
2021-04-14,Los Angeles,037,10098052,1195241,1186821,41006,1227827,23579
2021-04-14,Madera,039,155013,16358,16218,916,17134,231
2021-04-14,Marin,041,260295,13829,13768,235,14003,226
2021-04-14,Mariposa,043,17540,405,394,9,403,5
2021-04-14,Mendocino,045,87422,3793,3711,73,3784,46
2021-04-14,Merced,047,269075,30286,30296,1025,31321,436
2021-04-14,Modoc,049,8938,368,355,122,477,3
2021-04-14,Mono,051,14174,1240,1252,17,1269,3
2021-04-14,Monterey,053,433212,42780,42595,1825,44420,347
2021-04-14,Napa,055,140530,9670,9643,34,9677,79
2021-04-14,Nevada,057,99092,4499,4421,184,4605,70
2021-04-14,Orange,059,3164182,252999,251568,11036,262604,4849
2021-04-14,Placer,061,380077,22271,21575,1363,22938,280
2021-04-14,Plumas,063,18699,678,665,10,675,4
2021-04-14,Riverside,065,2383286,291380,285583,13834,299417,4358
2021-04-14,Sacramento,067,1510023,101533,100645,1531,102176,1570
2021-04-14,San Benito,069,59416,5973,5960,111,6071,62
2021-04-14,San Bernardino,071,2135413,290902,289078,8861,297939,4523
2021-04-14,San Diego,073,3302833,274929,273969,14076,288045,3648
2021-04-14,San Francisco,075,870044,35899,35898,1240,37138,510
2021-04-14,San Joaquin,077,732212,71034,70095,3352,73447,1288
2021-04-14,San Luis Obispo,079,281455,20918,20561,676,21237,253
2021-04-14,San Mateo,081,765935,41499,40982,443,41425,352
2021-04-14,Santa Barbara,083,443738,33867,33650,1119,34769,445
2021-04-14,Santa Clara,085,1922200,116243,116488,694,117182,1922
2021-04-14,Santa Cruz,087,273765,15997,15481,806,16287,203
2021-04-14,Shasta,089,179085,11582,11581,1407,12988,190
2021-04-14,Sierra,091,2930,55,51,12,63,0
2021-04-14,Siskiyou,093,43540,1628,1518,286,1804,10
2021-04-14,Solano,095,438530,31546,31357,450,31807,239
2021-04-14,Sonoma,097,501317,29457,29572,299,29871,311
2021-04-14,Stanislaus,099,539301,54217,53836,5736,59572,727
2021-04-14,Sutter,101,95872,9229,9230,82,9312,106
2021-04-14,Tehama,103,63373,4892,4853,540,5393,52
2021-04-14,Trinity,105,12862,482,326,85,411,3
2021-04-14,Tulare,107,460477,49556,48527,8747,57274,827
2021-04-14,Tuolumne,109,53932,3940,3997,37,4034,57
2021-04-14,Ventura,111,848112,80444,79891,2927,82818,986
2021-04-14,Yolo,113,214977,13539,13530,261,13791,198
2021-04-14,Yuba,115,75493,5825,5778,116,5894,44
2021-04-13,Alameda,001,1643700,85370,84921,1863,86784,1239
2021-04-13,Alpine,003,1148,85,85,0,85,0
2021-04-13,Amador,005,37829,3625,3609,33,3642,46
2021-04-13,Butte,007,227075,11888,11497,1707,13204,196
2021-04-13,Calaveras,009,45235,2045,2035,12,2047,50
2021-04-13,Colusa,011,21464,1906,1905,283,2188,14
2021-04-13,Contra Costa,013,1133247,67104,66304,1177,67481,778
2021-04-13,Del Norte,015,27424,1264,1221,11,1232,6
2021-04-13,El Dorado,017,186661,9716,9609,658,10267,106
2021-04-13,Fresno,019,978130,100879,100357,8454,108811,1636
2021-04-13,Glenn,021,27897,2374,2351,539,2890,17
2021-04-13,Humboldt,023,135768,3577,3540,26,3566,35
2021-04-13,Imperial,025,180216,28033,27887,2670,30557,718
2021-04-13,Inyo,027,18085,1391,1391,10,1401,36
2021-04-13,Kern,029,883053,96032,94908,10488,105396,1285
2021-04-13,Kings,031,150075,22885,22636,1055,23691,243
2021-04-13,Lake,033,64148,3419,3390,9,3399,43
2021-04-13,Lassen,035,31185,5162,5147,105,5252,1
2021-04-13,Los Angeles,037,10098052,1194785,1186482,40964,1227446,23526
2021-04-13,Madera,039,155013,16348,16207,914,17121,231
2021-04-13,Marin,041,260295,13821,13760,234,13994,224
2021-04-13,Mariposa,043,17540,404,394,6,400,5
2021-04-13,Mendocino,045,87422,3787,3702,73,3775,46
2021-04-13,Merced,047,269075,30256,30276,1022,31298,435
2021-04-13,Modoc,049,8938,368,355,122,477,3
2021-04-13,Mono,051,14174,1240,1251,17,1268,3
2021-04-13,Monterey,053,433212,42769,42577,1825,44402,347
2021-04-13,Napa,055,140530,9660,9627,34,9661,79
2021-04-13,Nevada,057,99092,4487,4415,184,4599,69
2021-04-13,Orange,059,3164182,252904,251491,11018,262509,4836
2021-04-13,Placer,061,380077,22234,21534,1360,22894,280
2021-04-13,Plumas,063,18699,677,665,10,675,4
2021-04-13,Riverside,065,2383286,291261,285505,13828,299333,4348
2021-04-13,Sacramento,067,1510023,101358,100551,1526,102077,1569
2021-04-13,San Benito,069,59416,5970,5946,111,6057,62
2021-04-13,San Bernardino,071,2135413,290786,288929,8855,297784,4521
2021-04-13,San Diego,073,3302833,274675,273709,14041,287750,3623
2021-04-13,San Francisco,075,870044,35863,35869,1236,37105,506
2021-04-13,San Joaquin,077,732212,70926,70034,3344,73378,1288
2021-04-13,San Luis Obispo,079,281455,20891,20536,666,21202,253
2021-04-13,San Mateo,081,765935,41454,40955,443,41398,353
2021-04-13,Santa Barbara,083,443738,33844,33613,1116,34729,444
2021-04-13,Santa Clara,085,1922200,116114,116363,693,117056,1923
2021-04-13,Santa Cruz,087,273765,15990,15449,806,16255,203
2021-04-13,Shasta,089,179085,11562,11536,1404,12940,189
2021-04-13,Sierra,091,2930,55,51,12,63,0
2021-04-13,Siskiyou,093,43540,1620,1511,281,1792,10
2021-04-13,Solano,095,438530,31497,31335,446,31781,239
2021-04-13,Sonoma,097,501317,29449,29544,298,29842,311
2021-04-13,Stanislaus,099,539301,54144,53797,5727,59524,722
2021-04-13,Sutter,101,95872,9225,9226,82,9308,106
2021-04-13,Tehama,103,63373,4885,4850,537,5387,52
2021-04-13,Trinity,105,12862,482,326,85,411,3
2021-04-13,Tulare,107,460477,49543,48511,8744,57255,825
2021-04-13,Tuolumne,109,53932,3938,3995,37,4032,57
2021-04-13,Ventura,111,848112,80412,79854,2925,82779,986
2021-04-13,Yolo,113,214977,13527,13516,260,13776,198
2021-04-13,Yuba,115,75493,5816,5776,116,5892,44
2021-04-12,Alameda,001,1643700,85268,84817,1862,86679,1238
2021-04-12,Alpine,003,1148,85,85,0,85,0
2021-04-12,Amador,005,37829,3624,3607,33,3640,46
2021-04-12,Butte,007,227075,11873,11488,1703,13191,193
2021-04-12,Calaveras,009,45235,2042,2033,12,2045,50
2021-04-12,Colusa,011,21464,1904,1904,281,2185,14
2021-04-12,Contra Costa,013,1133247,67023,66176,1177,67353,777
2021-04-12,Del Norte,015,27424,1261,1216,11,1227,6
2021-04-12,El Dorado,017,186661,9699,9588,656,10244,106
2021-04-12,Fresno,019,978130,100818,100277,8430,108707,1633
2021-04-12,Glenn,021,27897,2373,2349,539,2888,17
2021-04-12,Humboldt,023,135768,3563,3533,25,3558,35
2021-04-12,Imperial,025,180216,28003,27851,2665,30516,717
2021-04-12,Inyo,027,18085,1391,1390,10,1400,36
2021-04-12,Kern,029,883053,95995,94861,10477,105338,1283
2021-04-12,Kings,031,150075,22877,22621,1054,23675,241
2021-04-12,Lake,033,64148,3415,3380,9,3389,43
2021-04-12,Lassen,035,31185,5161,5147,105,5252,1
2021-04-12,Los Angeles,037,10098052,1194281,1186145,40925,1227070,23505
2021-04-12,Madera,039,155013,16336,16174,912,17086,231
2021-04-12,Marin,041,260295,13808,13751,232,13983,224
2021-04-12,Mariposa,043,17540,403,394,6,400,5
2021-04-12,Mendocino,045,87422,3786,3699,73,3772,46
2021-04-12,Merced,047,269075,30225,30261,1019,31280,435
2021-04-12,Modoc,049,8938,366,352,122,474,3
2021-04-12,Mono,051,14174,1240,1251,17,1268,3
2021-04-12,Monterey,053,433212,42755,42555,1823,44378,346
2021-04-12,Napa,055,140530,9646,9603,34,9637,80
2021-04-12,Nevada,057,99092,4476,4408,184,4592,69
2021-04-12,Orange,059,3164182,252818,251350,10996,262346,4826
2021-04-12,Placer,061,380077,22183,21475,1357,22832,278
2021-04-12,Plumas,063,18699,675,666,10,676,4
2021-04-12,Riverside,065,2383286,291150,285361,13822,299183,4336
2021-04-12,Sacramento,067,1510023,101184,100394,1521,101915,1566
2021-04-12,San Benito,069,59416,5962,5942,110,6052,62
2021-04-12,San Bernardino,071,2135413,290679,288736,8843,297579,4493
2021-04-12,San Diego,073,3302833,274415,273431,14012,287443,3621
2021-04-12,San Francisco,075,870044,35829,35841,1235,37076,506
2021-04-12,San Joaquin,077,732212,70854,69968,3337,73305,1288
2021-04-12,San Luis Obispo,079,281455,20846,20515,653,21168,253
2021-04-12,San Mateo,081,765935,41412,40920,439,41359,353
2021-04-12,Santa Barbara,083,443738,33813,33606,1116,34722,444
2021-04-12,Santa Clara,085,1922200,115986,116252,691,116943,1923
2021-04-12,Santa Cruz,087,273765,15970,15406,806,16212,203
2021-04-12,Shasta,089,179085,11545,11509,1400,12909,189
2021-04-12,Sierra,091,2930,55,51,12,63,0
2021-04-12,Siskiyou,093,43540,1609,1511,278,1789,7
2021-04-12,Solano,095,438530,31455,31305,443,31748,238
2021-04-12,Sonoma,097,501317,29421,29500,298,29798,310
2021-04-12,Stanislaus,099,539301,54078,53722,5720,59442,707
2021-04-12,Sutter,101,95872,9214,9221,82,9303,106
2021-04-12,Tehama,103,63373,4876,4834,533,5367,52
2021-04-12,Trinity,105,12862,482,324,85,409,3
2021-04-12,Tulare,107,460477,49523,48495,8734,57229,824
2021-04-12,Tuolumne,109,53932,3934,3993,37,4030,57
2021-04-12,Ventura,111,848112,80379,79818,2923,82741,985
2021-04-12,Yolo,113,214977,13513,13510,259,13769,198
2021-04-12,Yuba,115,75493,5810,5773,116,5889,43
2021-04-11,Alameda,001,1643700,85131,84756,1856,86612,1238
2021-04-11,Alpine,003,1148,85,85,0,85,0
2021-04-11,Amador,005,37829,3622,3605,33,3638,46
2021-04-11,Butte,007,227075,11839,11487,1699,13186,193
2021-04-11,Calaveras,009,45235,2038,2036,12,2048,50
2021-04-11,Colusa,011,21464,1903,1904,280,2184,14
2021-04-11,Contra Costa,013,1133247,66914,66107,1175,67282,777
2021-04-11,Del Norte,015,27424,1255,1214,11,1225,6
2021-04-11,El Dorado,017,186661,9685,9575,653,10228,106
2021-04-11,Fresno,019,978130,100750,100230,8420,108650,1633
2021-04-11,Glenn,021,27897,2368,2348,539,2887,17
2021-04-11,Humboldt,023,135768,3553,3523,25,3548,35
2021-04-11,Imperial,025,180216,27979,27841,2663,30504,717
2021-04-11,Inyo,027,18085,1391,1390,10,1400,36
2021-04-11,Kern,029,883053,95934,94830,10469,105299,1283
2021-04-11,Kings,031,150075,22868,22618,1051,23669,241
2021-04-11,Lake,033,64148,3411,3377,9,3386,43
2021-04-11,Lassen,035,31185,5157,5147,105,5252,1
2021-04-11,Los Angeles,037,10098052,1193769,1185757,40883,1226640,23503
2021-04-11,Madera,039,155013,16317,16166,911,17077,231
2021-04-11,Marin,041,260295,13801,13741,231,13972,226
2021-04-11,Mariposa,043,17540,403,394,6,400,5
2021-04-11,Mendocino,045,87422,3784,3696,73,3769,46
2021-04-11,Merced,047,269075,30187,30249,1018,31267,435
2021-04-11,Modoc,049,8938,365,352,120,472,3
2021-04-11,Mono,051,14174,1239,1250,17,1267,3
2021-04-11,Monterey,053,433212,42748,42547,1816,44363,346
2021-04-11,Napa,055,140530,9635,9592,34,9626,80
2021-04-11,Nevada,057,99092,4462,4394,184,4578,69
2021-04-11,Orange,059,3164182,252691,251233,10985,262218,4826
2021-04-11,Placer,061,380077,22126,21458,1352,22810,278
2021-04-11,Plumas,063,18699,675,666,10,676,4
2021-04-11,Riverside,065,2383286,291017,285269,13812,299081,4336
2021-04-11,Sacramento,067,1510023,101014,100296,1509,101805,1566
2021-04-11,San Benito,069,59416,5954,5941,109,6050,62
2021-04-11,San Bernardino,071,2135413,290571,288686,8837,297523,4492
2021-04-11,San Diego,073,3302833,274117,273287,13953,287240,3621
2021-04-11,San Francisco,075,870044,35793,35815,1232,37047,498
2021-04-11,San Joaquin,077,732212,70768,69939,3326,73265,1288
2021-04-11,San Luis Obispo,079,281455,20820,20501,650,21151,253
2021-04-11,San Mateo,081,765935,41354,40901,438,41339,353
2021-04-11,Santa Barbara,083,443738,33778,33591,1115,34706,444
2021-04-11,Santa Clara,085,1922200,115850,116161,688,116849,1923
2021-04-11,Santa Cruz,087,273765,15958,15382,806,16188,203
2021-04-11,Shasta,089,179085,11501,11504,1399,12903,189
2021-04-11,Sierra,091,2930,55,51,12,63,0
2021-04-11,Siskiyou,093,43540,1602,1509,275,1784,7
2021-04-11,Solano,095,438530,31402,31268,439,31707,238
2021-04-11,Sonoma,097,501317,29395,29496,294,29790,310
2021-04-11,Stanislaus,099,539301,53995,53683,5711,59394,707
2021-04-11,Sutter,101,95872,9205,9222,82,9304,106
2021-04-11,Tehama,103,63373,4873,4832,531,5363,52
2021-04-11,Trinity,105,12862,482,324,85,409,3
2021-04-11,Tulare,107,460477,49509,48479,8727,57206,824
2021-04-11,Tuolumne,109,53932,3932,3993,37,4030,57
2021-04-11,Ventura,111,848112,80331,79800,2917,82717,985
2021-04-11,Yolo,113,214977,13493,13496,257,13753,198
2021-04-11,Yuba,115,75493,5800,5768,116,5884,43
2021-04-10,Alameda,001,1643700,85067,84626,1856,86482,1238
2021-04-10,Alpine,003,1148,85,85,0,85,0
2021-04-10,Amador,005,37829,3620,3603,33,3636,46
2021-04-10,Butte,007,227075,11828,11482,1698,13180,193
2021-04-10,Calaveras,009,45235,2036,2032,12,2044,50
2021-04-10,Colusa,011,21464,1903,1902,280,2182,14
2021-04-10,Contra Costa,013,1133247,66853,66001,1172,67173,778
2021-04-10,Del Norte,015,27424,1252,1212,11,1223,6
2021-04-10,El Dorado,017,186661,9673,9549,650,10199,106
2021-04-10,Fresno,019,978130,100717,100135,8413,108548,1633
2021-04-10,Glenn,021,27897,2368,2343,539,2882,17
2021-04-10,Humboldt,023,135768,3543,3508,25,3533,35
2021-04-10,Imperial,025,180216,27965,27816,2663,30479,717
2021-04-10,Inyo,027,18085,1391,1387,10,1397,36
2021-04-10,Kern,029,883053,95920,94802,10463,105265,1284
2021-04-10,Kings,031,150075,22864,22614,1049,23663,241
2021-04-10,Lake,033,64148,3406,3368,9,3377,43
2021-04-10,Lassen,035,31185,5157,5146,104,5250,1
2021-04-10,Los Angeles,037,10098052,1193495,1185246,40865,1226111,23493
2021-04-10,Madera,039,155013,16309,16143,910,17053,231
2021-04-10,Marin,041,260295,13796,13731,231,13962,226
2021-04-10,Mariposa,043,17540,400,393,6,399,5
2021-04-10,Mendocino,045,87422,3782,3696,73,3769,46
2021-04-10,Merced,047,269075,30167,30225,1017,31242,435
2021-04-10,Modoc,049,8938,365,352,120,472,3
2021-04-10,Mono,051,14174,1239,1249,17,1266,3
2021-04-10,Monterey,053,433212,42737,42527,1815,44342,346
2021-04-10,Napa,055,140530,9628,9569,34,9603,79
2021-04-10,Nevada,057,99092,4455,4379,184,4563,69
2021-04-10,Orange,059,3164182,252598,251139,10978,262117,4818
2021-04-10,Placer,061,380077,22095,21402,1346,22748,278
2021-04-10,Plumas,063,18699,675,666,10,676,4
2021-04-10,Riverside,065,2383286,290937,285082,13804,298886,4336
2021-04-10,Sacramento,067,1510023,100911,100048,1507,101555,1566
2021-04-10,San Benito,069,59416,5943,5932,108,6040,62
2021-04-10,San Bernardino,071,2135413,290507,288590,8830,297420,4489
2021-04-10,San Diego,073,3302833,273901,273058,13933,286991,3613
2021-04-10,San Francisco,075,870044,35763,35774,1229,37003,498
2021-04-10,San Joaquin,077,732212,70733,69852,3316,73168,1288
2021-04-10,San Luis Obispo,079,281455,20804,20461,649,21110,253
2021-04-10,San Mateo,081,765935,41321,40878,438,41316,350
2021-04-10,Santa Barbara,083,443738,33750,33541,1113,34654,444
2021-04-10,Santa Clara,085,1922200,115754,116015,687,116702,1923
2021-04-10,Santa Cruz,087,273765,15952,15360,806,16166,203
2021-04-10,Shasta,089,179085,11492,11492,1396,12888,189
2021-04-10,Sierra,091,2930,55,51,12,63,0
2021-04-10,Siskiyou,093,43540,1599,1512,275,1787,7
2021-04-10,Solano,095,438530,31368,31218,435,31653,238
2021-04-10,Sonoma,097,501317,29380,29469,294,29763,310
2021-04-10,Stanislaus,099,539301,53960,53596,5705,59301,707
2021-04-10,Sutter,101,95872,9203,9214,82,9296,106
2021-04-10,Tehama,103,63373,4871,4820,529,5349,52
2021-04-10,Trinity,105,12862,482,324,85,409,3
2021-04-10,Tulare,107,460477,49500,48470,8721,57191,824
2021-04-10,Tuolumne,109,53932,3929,3991,37,4028,57
2021-04-10,Ventura,111,848112,80303,79758,2915,82673,985
2021-04-10,Yolo,113,214977,13485,13494,256,13750,198
2021-04-10,Yuba,115,75493,5797,5757,115,5872,43
2021-04-09,Alameda,001,1643700,85000,84404,1848,86252,1237
2021-04-09,Alpine,003,1148,85,85,0,85,0
2021-04-09,Amador,005,37829,3619,3600,33,3633,46
2021-04-09,Butte,007,227075,11818,11454,1697,13151,193
2021-04-09,Calaveras,009,45235,2035,2028,12,2040,50
2021-04-09,Colusa,011,21464,1903,1898,280,2178,14
2021-04-09,Contra Costa,013,1133247,66760,65857,1166,67023,777
2021-04-09,Del Norte,015,27424,1251,1207,11,1218,6
2021-04-09,El Dorado,017,186661,9650,9528,646,10174,106
2021-04-09,Fresno,019,978130,100683,100027,8408,108435,1630
2021-04-09,Glenn,021,27897,2368,2337,539,2876,17
2021-04-09,Humboldt,023,135768,3534,3496,25,3521,35
2021-04-09,Imperial,025,180216,27950,27764,2661,30425,717
2021-04-09,Inyo,027,18085,1390,1386,10,1396,36
2021-04-09,Kern,029,883053,95882,94675,10461,105136,1282
2021-04-09,Kings,031,150075,22855,22595,1046,23641,242
2021-04-09,Lake,033,64148,3402,3362,9,3371,43
2021-04-09,Lassen,035,31185,5157,5140,104,5244,1
2021-04-09,Los Angeles,037,10098052,1193125,1184501,40836,1225337,23458
2021-04-09,Madera,039,155013,16306,16118,910,17028,231
2021-04-09,Marin,041,260295,13789,13721,231,13952,226
2021-04-09,Mariposa,043,17540,400,393,6,399,5
2021-04-09,Mendocino,045,87422,3780,3693,73,3766,46
2021-04-09,Merced,047,269075,30138,30179,1016,31195,435
2021-04-09,Modoc,049,8938,364,352,120,472,3
2021-04-09,Mono,051,14174,1239,1247,17,1264,3
2021-04-09,Monterey,053,433212,42728,42481,1811,44292,344
2021-04-09,Napa,055,140530,9609,9574,34,9608,80
2021-04-09,Nevada,057,99092,4447,4373,184,4557,69
2021-04-09,Orange,059,3164182,252524,250852,10973,261825,4813
2021-04-09,Placer,061,380077,22064,21327,1338,22665,278
2021-04-09,Plumas,063,18699,674,666,10,676,4
2021-04-09,Riverside,065,2383286,290854,284562,13798,298360,4325
2021-04-09,Sacramento,067,1510023,100756,99722,1501,101223,1564
2021-04-09,San Benito,069,59416,5938,5925,107,6032,62
2021-04-09,San Bernardino,071,2135413,290438,288000,8827,296827,4467
2021-04-09,San Diego,073,3302833,273703,272697,13891,286588,3600
2021-04-09,San Francisco,075,870044,35722,35716,1224,36940,497
2021-04-09,San Joaquin,077,732212,70669,69675,3304,72979,1281
2021-04-09,San Luis Obispo,079,281455,20789,20427,649,21076,252
2021-04-09,San Mateo,081,765935,41285,40800,437,41237,350
2021-04-09,Santa Barbara,083,443738,33727,33424,1110,34534,444
2021-04-09,Santa Clara,085,1922200,115670,115749,685,116434,1923
2021-04-09,Santa Cruz,087,273765,15947,15331,806,16137,203
2021-04-09,Shasta,089,179085,11482,11478,1393,12871,188
2021-04-09,Sierra,091,2930,55,51,12,63,0
2021-04-09,Siskiyou,093,43540,1596,1510,274,1784,7
2021-04-09,Solano,095,438530,31335,31166,430,31596,238
2021-04-09,Sonoma,097,501317,29367,29433,294,29727,310
2021-04-09,Stanislaus,099,539301,53905,53504,5696,59200,705
2021-04-09,Sutter,101,95872,9196,9201,82,9283,106
2021-04-09,Tehama,103,63373,4865,4806,529,5335,52
2021-04-09,Trinity,105,12862,481,324,85,409,3
2021-04-09,Tulare,107,460477,49496,48430,8715,57145,824
2021-04-09,Tuolumne,109,53932,3928,3986,37,4023,57
2021-04-09,Ventura,111,848112,80275,79698,2915,82613,987
2021-04-09,Yolo,113,214977,13474,13478,254,13732,198
2021-04-09,Yuba,115,75493,5790,5754,115,5869,43
2021-04-08,Alameda,001,1643700,84894,84213,1845,86058,1232
2021-04-08,Alpine,003,1148,85,85,0,85,0
2021-04-08,Amador,005,37829,3615,3595,33,3628,46
2021-04-08,Butte,007,227075,11807,11414,1696,13110,193
2021-04-08,Calaveras,009,45235,2033,2027,12,2039,50
2021-04-08,Colusa,011,21464,1902,1897,280,2177,14
2021-04-08,Contra Costa,013,1133247,66650,65706,1163,66869,775
2021-04-08,Del Norte,015,27424,1245,1201,11,1212,6
2021-04-08,El Dorado,017,186661,9634,9513,641,10154,106
2021-04-08,Fresno,019,978130,100620,99935,8401,108336,1627
2021-04-08,Glenn,021,27897,2367,2337,539,2876,17
2021-04-08,Humboldt,023,135768,3524,3486,25,3511,35
2021-04-08,Imperial,025,180216,27922,27744,2657,30401,713
2021-04-08,Inyo,027,18085,1389,1386,10,1396,36
2021-04-08,Kern,029,883053,95836,94493,10448,104941,1281
2021-04-08,Kings,031,150075,22848,22589,1044,23633,243
2021-04-08,Lake,033,64148,3395,3360,9,3369,43
2021-04-08,Lassen,035,31185,5156,5136,104,5240,1
2021-04-08,Los Angeles,037,10098052,1192628,1184443,40798,1225241,23416
2021-04-08,Madera,039,155013,16294,16103,910,17013,231
2021-04-08,Marin,041,260295,13782,13704,231,13935,226
2021-04-08,Mariposa,043,17540,399,393,6,399,5
2021-04-08,Mendocino,045,87422,3778,3690,73,3763,45
2021-04-08,Merced,047,269075,30116,30163,1016,31179,430
2021-04-08,Modoc,049,8938,364,352,120,472,3
2021-04-08,Mono,051,14174,1237,1247,17,1264,3
2021-04-08,Monterey,053,433212,42706,42437,1806,44243,342
2021-04-08,Napa,055,140530,9592,9569,34,9603,80
2021-04-08,Nevada,057,99092,4436,4367,184,4551,69
2021-04-08,Orange,059,3164182,252414,250529,10958,261487,4797
2021-04-08,Placer,061,380077,22022,21258,1329,22587,277
2021-04-08,Plumas,063,18699,674,665,10,675,4
2021-04-08,Riverside,065,2383286,290740,283853,13793,297646,4296
2021-04-08,Sacramento,067,1510023,100616,99319,1490,100809,1561
2021-04-08,San Benito,069,59416,5935,5914,105,6019,62
2021-04-08,San Bernardino,071,2135413,290340,287190,8824,296014,4445
2021-04-08,San Diego,073,3302833,273473,272495,13855,286350,3592
2021-04-08,San Francisco,075,870044,35699,35657,1223,36880,494
2021-04-08,San Joaquin,077,732212,70597,69479,3298,72777,1279
2021-04-08,San Luis Obispo,079,281455,20770,20402,647,21049,252
2021-04-08,San Mateo,081,765935,41245,40749,437,41186,350
2021-04-08,Santa Barbara,083,443738,33703,33309,1109,34418,444
2021-04-08,Santa Clara,085,1922200,115564,115487,684,116171,1905
2021-04-08,Santa Cruz,087,273765,15940,15296,806,16102,203
2021-04-08,Shasta,089,179085,11472,11466,1389,12855,186
2021-04-08,Sierra,091,2930,55,51,12,63,0
2021-04-08,Siskiyou,093,43540,1593,1511,274,1785,7
2021-04-08,Solano,095,438530,31286,31120,430,31550,238
2021-04-08,Sonoma,097,501317,29347,29410,293,29703,310
2021-04-08,Stanislaus,099,539301,53827,53401,5686,59087,706
2021-04-08,Sutter,101,95872,9192,9195,82,9277,106
2021-04-08,Tehama,103,63373,4861,4802,529,5331,52
2021-04-08,Trinity,105,12862,481,324,85,409,3
2021-04-08,Tulare,107,460477,49483,48409,8705,57114,821
2021-04-08,Tuolumne,109,53932,3928,3986,37,4023,57
2021-04-08,Ventura,111,848112,80238,79626,2911,82537,986
2021-04-08,Yolo,113,214977,13465,13468,253,13721,198
2021-04-08,Yuba,115,75493,5786,5743,115,5858,43
2021-04-07,Alameda,001,1643700,84810,84130,1843,85973,1224
2021-04-07,Alpine,003,1148,85,85,0,85,0
2021-04-07,Amador,005,37829,3612,3590,33,3623,46
2021-04-07,Butte,007,227075,11803,11405,1693,13098,193
2021-04-07,Calaveras,009,45235,2032,2022,12,2034,50
2021-04-07,Colusa,011,21464,1898,1894,279,2173,14
2021-04-07,Contra Costa,013,1133247,66564,65619,1162,66781,775
2021-04-07,Del Norte,015,27424,1243,1198,11,1209,6
2021-04-07,El Dorado,017,186661,9613,9500,636,10136,106
2021-04-07,Fresno,019,978130,100555,99865,8390,108255,1627
2021-04-07,Glenn,021,27897,2365,2337,538,2875,17
2021-04-07,Humboldt,023,135768,3511,3484,25,3509,35
2021-04-07,Imperial,025,180216,27898,27704,2651,30355,713
2021-04-07,Inyo,027,18085,1388,1386,10,1396,36
2021-04-07,Kern,029,883053,95800,94456,10433,104889,1275
2021-04-07,Kings,031,150075,22846,22589,1044,23633,243
2021-04-07,Lake,033,64148,3393,3358,9,3367,43
2021-04-07,Lassen,035,31185,5156,5137,104,5241,1
2021-04-07,Los Angeles,037,10098052,1192192,1183862,40776,1224638,23372
2021-04-07,Madera,039,155013,16275,16090,909,16999,231
2021-04-07,Marin,041,260295,13771,13688,229,13917,225
2021-04-07,Mariposa,043,17540,398,391,6,397,5
2021-04-07,Mendocino,045,87422,3777,3691,73,3764,45
2021-04-07,Merced,047,269075,30093,30132,1011,31143,430
2021-04-07,Modoc,049,8938,364,351,120,471,3
2021-04-07,Mono,051,14174,1237,1246,17,1263,3
2021-04-07,Monterey,053,433212,42688,42427,1805,44232,341
2021-04-07,Napa,055,140530,9578,9556,34,9590,80
2021-04-07,Nevada,057,99092,4430,4364,184,4548,69
2021-04-07,Orange,059,3164182,252290,250378,10935,261313,4778
2021-04-07,Placer,061,380077,21977,21227,1321,22548,276
2021-04-07,Plumas,063,18699,674,665,10,675,4
2021-04-07,Riverside,065,2383286,290620,283749,13783,297532,4285
2021-04-07,Sacramento,067,1510023,100448,99202,1484,100686,1544
2021-04-07,San Benito,069,59416,5930,5912,104,6016,62
2021-04-07,San Bernardino,071,2135413,290222,286978,8819,295797,4433
2021-04-07,San Diego,073,3302833,273247,272195,13826,286021,3588
2021-04-07,San Francisco,075,870044,35659,35618,1219,36837,493
2021-04-07,San Joaquin,077,732212,70527,69375,3293,72668,1278
2021-04-07,San Luis Obispo,079,281455,20744,20373,644,21017,252
2021-04-07,San Mateo,081,765935,41201,40693,437,41130,350
2021-04-07,Santa Barbara,083,443738,33677,33289,1106,34395,444
2021-04-07,Santa Clara,085,1922200,115432,115311,682,115993,1900
2021-04-07,Santa Cruz,087,273765,15929,15275,806,16081,203
2021-04-07,Shasta,089,179085,11460,11456,1384,12840,184
2021-04-07,Sierra,091,2930,55,51,12,63,0
2021-04-07,Siskiyou,093,43540,1587,1512,273,1785,7
2021-04-07,Solano,095,438530,31235,31097,429,31526,238
2021-04-07,Sonoma,097,501317,29329,29394,292,29686,310
2021-04-07,Stanislaus,099,539301,53758,53344,5676,59020,686
2021-04-07,Sutter,101,95872,9189,9188,82,9270,106
2021-04-07,Tehama,103,63373,4853,4802,527,5329,52
2021-04-07,Trinity,105,12862,481,322,85,407,3
2021-04-07,Tulare,107,460477,49468,48386,8694,57080,820
2021-04-07,Tuolumne,109,53932,3926,3982,37,4019,57
2021-04-07,Ventura,111,848112,80204,79595,2909,82504,986
2021-04-07,Yolo,113,214977,13450,13450,251,13701,198
2021-04-07,Yuba,115,75493,5782,5737,115,5852,43
2021-04-06,Alameda,001,1643700,84697,84091,1839,85930,1223
2021-04-06,Alpine,003,1148,85,85,0,85,0
2021-04-06,Amador,005,37829,3611,3587,33,3620,45
2021-04-06,Butte,007,227075,11788,11396,1691,13087,193
2021-04-06,Calaveras,009,45235,2028,2021,12,2033,50
2021-04-06,Colusa,011,21464,1896,1894,277,2171,14
2021-04-06,Contra Costa,013,1133247,66486,65575,1161,66736,774
2021-04-06,Del Norte,015,27424,1238,1197,11,1208,6
2021-04-06,El Dorado,017,186661,9583,9489,634,10123,106
2021-04-06,Fresno,019,978130,100491,99814,8384,108198,1626
2021-04-06,Glenn,021,27897,2364,2335,537,2872,17
2021-04-06,Humboldt,023,135768,3502,3477,25,3502,35
2021-04-06,Imperial,025,180216,27864,27661,2641,30302,713
2021-04-06,Inyo,027,18085,1388,1379,10,1389,36
2021-04-06,Kern,029,883053,95756,94422,10427,104849,1259
2021-04-06,Kings,031,150075,22840,22587,1044,23631,240
2021-04-06,Lake,033,64148,3390,3358,9,3367,43
2021-04-06,Lassen,035,31185,5154,5137,104,5241,1
2021-04-06,Los Angeles,037,10098052,1191680,1183499,40736,1224235,23323
2021-04-06,Madera,039,155013,16255,16085,904,16989,230
2021-04-06,Marin,041,260295,13762,13675,225,13900,224
2021-04-06,Mariposa,043,17540,398,390,6,396,5
2021-04-06,Mendocino,045,87422,3775,3686,73,3759,45
2021-04-06,Merced,047,269075,30064,30100,1006,31106,430
2021-04-06,Modoc,049,8938,363,351,120,471,3
2021-04-06,Mono,051,14174,1237,1246,17,1263,3
2021-04-06,Monterey,053,433212,42679,42412,1804,44216,341
2021-04-06,Napa,055,140530,9559,9509,34,9543,78
2021-04-06,Nevada,057,99092,4420,4356,182,4538,69
2021-04-06,Orange,059,3164182,252181,250304,10921,261225,4771
2021-04-06,Placer,061,380077,21929,21184,1319,22503,276
2021-04-06,Plumas,063,18699,674,665,10,675,4
2021-04-06,Riverside,065,2383286,290439,283622,13772,297394,4264
2021-04-06,Sacramento,067,1510023,100239,99110,1478,100588,1537
2021-04-06,San Benito,069,59416,5921,5907,104,6011,62
2021-04-06,San Bernardino,071,2135413,290108,286792,8809,295601,4428
2021-04-06,San Diego,073,3302833,272985,271867,13798,285665,3585
2021-04-06,San Francisco,075,870044,35616,35572,1219,36791,488
2021-04-06,San Joaquin,077,732212,70444,69316,3281,72597,1278
2021-04-06,San Luis Obispo,079,281455,20722,20350,641,20991,252
2021-04-06,San Mateo,081,765935,41153,40649,436,41085,350
2021-04-06,Santa Barbara,083,443738,33659,33257,1105,34362,443
2021-04-06,Santa Clara,085,1922200,115261,115184,681,115865,1900
2021-04-06,Santa Cruz,087,273765,15919,15252,806,16058,203
2021-04-06,Shasta,089,179085,11439,11443,1382,12825,184
2021-04-06,Sierra,091,2930,55,51,12,63,0
2021-04-06,Siskiyou,093,43540,1583,1510,272,1782,7
2021-04-06,Solano,095,438530,31188,31078,428,31506,237
2021-04-06,Sonoma,097,501317,29304,29386,290,29676,311
2021-04-06,Stanislaus,099,539301,53701,53304,5670,58974,686
2021-04-06,Sutter,101,95872,9179,9179,82,9261,106
2021-04-06,Tehama,103,63373,4844,4798,527,5325,52
2021-04-06,Trinity,105,12862,481,321,85,406,3
2021-04-06,Tulare,107,460477,49425,48372,8690,57062,819
2021-04-06,Tuolumne,109,53932,3926,3981,37,4018,57
2021-04-06,Ventura,111,848112,80167,79556,2907,82463,983
2021-04-06,Yolo,113,214977,13437,13443,250,13693,198
2021-04-06,Yuba,115,75493,5778,5733,114,5847,43
2021-04-05,Alameda,001,1643700,84581,84007,1835,85842,1219
2021-04-05,Alpine,003,1148,85,85,0,85,0
2021-04-05,Amador,005,37829,3608,3584,33,3617,45
2021-04-05,Butte,007,227075,11773,11384,1690,13074,193
2021-04-05,Calaveras,009,45235,2026,2019,12,2031,50
2021-04-05,Colusa,011,21464,1896,1894,276,2170,14
2021-04-05,Contra Costa,013,1133247,66420,65457,1159,66616,774
2021-04-05,Del Norte,015,27424,1236,1189,11,1200,6
2021-04-05,El Dorado,017,186661,9568,9463,634,10097,106
2021-04-05,Fresno,019,978130,100403,99755,8376,108131,1622
2021-04-05,Glenn,021,27897,2363,2335,537,2872,17
2021-04-05,Humboldt,023,135768,3493,3475,25,3500,35
2021-04-05,Imperial,025,180216,27832,27604,2636,30240,710
2021-04-05,Inyo,027,18085,1385,1377,10,1387,36
2021-04-05,Kern,029,883053,95701,94401,10402,104803,1249
2021-04-05,Kings,031,150075,22836,22580,1044,23624,239
2021-04-05,Lake,033,64148,3382,3359,9,3368,43
2021-04-05,Lassen,035,31185,5154,5138,103,5241,1
2021-04-05,Los Angeles,037,10098052,1191145,1183200,40685,1223885,23302
2021-04-05,Madera,039,155013,16241,16065,903,16968,230
2021-04-05,Marin,041,260295,13748,13666,221,13887,221
2021-04-05,Mariposa,043,17540,398,390,6,396,5
2021-04-05,Mendocino,045,87422,3773,3687,73,3760,45
2021-04-05,Merced,047,269075,30038,30068,1004,31072,427
2021-04-05,Modoc,049,8938,361,346,120,466,3
2021-04-05,Mono,051,14174,1237,1246,17,1263,3
2021-04-05,Monterey,053,433212,42666,42396,1800,44196,341
2021-04-05,Napa,055,140530,9536,9492,34,9526,78
2021-04-05,Nevada,057,99092,4409,4346,182,4528,69
2021-04-05,Orange,059,3164182,252066,250177,10897,261074,4759
2021-04-05,Placer,061,380077,21883,21133,1312,22445,276
2021-04-05,Plumas,063,18699,674,666,10,676,4
2021-04-05,Riverside,065,2383286,290302,283549,13760,297309,4237
2021-04-05,Sacramento,067,1510023,100077,98908,1470,100378,1533
2021-04-05,San Benito,069,59416,5915,5904,104,6008,61
2021-04-05,San Bernardino,071,2135413,289998,286597,8806,295403,4425
2021-04-05,San Diego,073,3302833,272736,271655,13757,285412,3583
2021-04-05,San Francisco,075,870044,35585,35538,1219,36757,488
2021-04-05,San Joaquin,077,732212,70355,69214,3272,72486,1268
2021-04-05,San Luis Obispo,079,281455,20685,20333,641,20974,252
2021-04-05,San Mateo,081,765935,41109,40609,435,41044,350
2021-04-05,Santa Barbara,083,443738,33624,33235,1105,34340,443
2021-04-05,Santa Clara,085,1922200,115094,115091,678,115769,1893
2021-04-05,Santa Cruz,087,273765,15912,15228,806,16034,201
2021-04-05,Shasta,089,179085,11418,11435,1379,12814,184
2021-04-05,Sierra,091,2930,55,50,12,62,0
2021-04-05,Siskiyou,093,43540,1580,1509,270,1779,7
2021-04-05,Solano,095,438530,31147,31026,426,31452,237
2021-04-05,Sonoma,097,501317,29272,29361,288,29649,311
2021-04-05,Stanislaus,099,539301,53621,53238,5667,58905,686
2021-04-05,Sutter,101,95872,9172,9169,82,9251,106
2021-04-05,Tehama,103,63373,4838,4794,527,5321,52
2021-04-05,Trinity,105,12862,480,321,85,406,3
2021-04-05,Tulare,107,460477,49413,48356,8683,57039,818
2021-04-05,Tuolumne,109,53932,3925,3980,37,4017,57
2021-04-05,Ventura,111,848112,80136,79549,2904,82453,983
2021-04-05,Yolo,113,214977,13423,13427,249,13676,198
2021-04-05,Yuba,115,75493,5773,5728,113,5841,43
2021-04-04,Alameda,001,1643700,84463,83951,1831,85782,1219
2021-04-04,Alpine,003,1148,85,85,0,85,0
2021-04-04,Amador,005,37829,3602,3582,33,3615,45
2021-04-04,Butte,007,227075,11758,11375,1689,13064,193
2021-04-04,Calaveras,009,45235,2022,2020,12,2032,50
2021-04-04,Colusa,011,21464,1895,1893,276,2169,14
2021-04-04,Contra Costa,013,1133247,66314,65408,1154,66562,774
2021-04-04,Del Norte,015,27424,1228,1186,11,1197,6
2021-04-04,El Dorado,017,186661,9549,9455,630,10085,106
2021-04-04,Fresno,019,978130,100329,99702,8363,108065,1622
2021-04-04,Glenn,021,27897,2360,2335,536,2871,17
2021-04-04,Humboldt,023,135768,3482,3472,25,3497,35
2021-04-04,Imperial,025,180216,27776,27588,2634,30222,710
2021-04-04,Inyo,027,18085,1381,1377,10,1387,36
2021-04-04,Kern,029,883053,95657,94388,10381,104769,1247
2021-04-04,Kings,031,150075,22834,22580,1043,23623,239
2021-04-04,Lake,033,64148,3376,3355,8,3363,43
2021-04-04,Lassen,035,31185,5152,5138,103,5241,1
2021-04-04,Los Angeles,037,10098052,1190601,1182872,40640,1223512,23301
2021-04-04,Madera,039,155013,16215,16052,899,16951,230
2021-04-04,Marin,041,260295,13735,13663,220,13883,221
2021-04-04,Mariposa,043,17540,398,390,6,396,5
2021-04-04,Mendocino,045,87422,3770,3684,73,3757,45
2021-04-04,Merced,047,269075,29995,30048,1001,31049,427
2021-04-04,Modoc,049,8938,361,346,120,466,3
2021-04-04,Mono,051,14174,1236,1245,17,1262,3
2021-04-04,Monterey,053,433212,42649,42391,1799,44190,341
2021-04-04,Napa,055,140530,9524,9486,34,9520,78
2021-04-04,Nevada,057,99092,4397,4337,182,4519,69
2021-04-04,Orange,059,3164182,251932,250117,10881,260998,4759
2021-04-04,Placer,061,380077,21837,21104,1294,22398,276
2021-04-04,Plumas,063,18699,674,666,10,676,4
2021-04-04,Riverside,065,2383286,290176,283537,13756,297293,4237
2021-04-04,Sacramento,067,1510023,99878,98821,1461,100282,1531
2021-04-04,San Benito,069,59416,5905,5901,100,6001,61
2021-04-04,San Bernardino,071,2135413,289858,286561,8798,295359,4423
2021-04-04,San Diego,073,3302833,272424,271528,13716,285244,3583
2021-04-04,San Francisco,075,870044,35531,35525,1216,36741,488
2021-04-04,San Joaquin,077,732212,70254,69147,3260,72407,1268
2021-04-04,San Luis Obispo,079,281455,20653,20328,633,20961,252
2021-04-04,San Mateo,081,765935,41066,40587,432,41019,350
2021-04-04,Santa Barbara,083,443738,33588,33213,1105,34318,443
2021-04-04,Santa Clara,085,1922200,114928,114976,671,115647,1893
2021-04-04,Santa Cruz,087,273765,15903,15219,806,16025,201
2021-04-04,Shasta,089,179085,11392,11433,1378,12811,184
2021-04-04,Sierra,091,2930,55,50,12,62,0
2021-04-04,Siskiyou,093,43540,1577,1509,266,1775,7
2021-04-04,Solano,095,438530,31100,31002,424,31426,237
2021-04-04,Sonoma,097,501317,29240,29340,286,29626,311
2021-04-04,Stanislaus,099,539301,53528,53181,5659,58840,686
2021-04-04,Sutter,101,95872,9165,9164,82,9246,106
2021-04-04,Tehama,103,63373,4826,4792,526,5318,52
2021-04-04,Trinity,105,12862,478,321,85,406,3
2021-04-04,Tulare,107,460477,49398,48343,8675,57018,818
2021-04-04,Tuolumne,109,53932,3917,3980,37,4017,57
2021-04-04,Ventura,111,848112,80093,79526,2902,82428,983
2021-04-04,Yolo,113,214977,13402,13425,248,13673,198
2021-04-04,Yuba,115,75493,5766,5722,113,5835,43
2021-04-03,Alameda,001,1643700,84396,83861,1829,85690,1218
2021-04-03,Alpine,003,1148,85,85,0,85,0
2021-04-03,Amador,005,37829,3599,3577,33,3610,45
2021-04-03,Butte,007,227075,11754,11359,1685,13044,193
2021-04-03,Calaveras,009,45235,2020,2019,12,2031,50
2021-04-03,Colusa,011,21464,1895,1891,276,2167,14
2021-04-03,Contra Costa,013,1133247,66242,65338,1154,66492,774
2021-04-03,Del Norte,015,27424,1223,1183,11,1194,6
2021-04-03,El Dorado,017,186661,9540,9448,629,10077,106
2021-04-03,Fresno,019,978130,100272,99602,8357,107959,1622
2021-04-03,Glenn,021,27897,2359,2334,535,2869,17
2021-04-03,Humboldt,023,135768,3480,3467,25,3492,35
2021-04-03,Imperial,025,180216,27760,27572,2631,30203,710
2021-04-03,Inyo,027,18085,1380,1376,10,1386,36
2021-04-03,Kern,029,883053,95631,94369,10365,104734,1243
2021-04-03,Kings,031,150075,22832,22580,1043,23623,239
2021-04-03,Lake,033,64148,3375,3350,8,3358,43
2021-04-03,Lassen,035,31185,5151,5136,103,5239,1
2021-04-03,Los Angeles,037,10098052,1190298,1182402,40623,1223025,23301
2021-04-03,Madera,039,155013,16206,16051,897,16948,230
2021-04-03,Marin,041,260295,13727,13658,219,13877,221
2021-04-03,Mariposa,043,17540,398,390,5,395,5
2021-04-03,Mendocino,045,87422,3769,3684,73,3757,45
2021-04-03,Merced,047,269075,29980,30031,1001,31032,427
2021-04-03,Modoc,049,8938,361,346,120,466,3
2021-04-03,Mono,051,14174,1236,1245,17,1262,3
2021-04-03,Monterey,053,433212,42636,42376,1797,44173,341
2021-04-03,Napa,055,140530,9515,9473,34,9507,78
2021-04-03,Nevada,057,99092,4393,4323,182,4505,69
2021-04-03,Orange,059,3164182,251852,249982,10863,260845,4755
2021-04-03,Placer,061,380077,21806,21060,1290,22350,276
2021-04-03,Plumas,063,18699,674,666,10,676,4
2021-04-03,Riverside,065,2383286,290098,283423,13753,297176,4237
2021-04-03,Sacramento,067,1510023,99770,98660,1455,100115,1531
2021-04-03,San Benito,069,59416,5902,5893,99,5992,61
2021-04-03,San Bernardino,071,2135413,289793,286473,8792,295265,4422
2021-04-03,San Diego,073,3302833,272255,271335,13699,285034,3571
2021-04-03,San Francisco,075,870044,35512,35488,1214,36702,489
2021-04-03,San Joaquin,077,732212,70213,69100,3244,72344,1268
2021-04-03,San Luis Obispo,079,281455,20634,20301,633,20934,252
2021-04-03,San Mateo,081,765935,41041,40560,432,40992,350
2021-04-03,Santa Barbara,083,443738,33562,33172,1104,34276,443
2021-04-03,Santa Clara,085,1922200,114820,114865,669,115534,1893
2021-04-03,Santa Cruz,087,273765,15896,15205,806,16011,201
2021-04-03,Shasta,089,179085,11384,11418,1378,12796,184
2021-04-03,Sierra,091,2930,55,50,12,62,0
2021-04-03,Siskiyou,093,43540,1576,1509,266,1775,7
2021-04-03,Solano,095,438530,31079,30970,421,31391,237
2021-04-03,Sonoma,097,501317,29224,29315,285,29600,311
2021-04-03,Stanislaus,099,539301,53493,53137,5653,58790,686
2021-04-03,Sutter,101,95872,9159,9158,82,9240,106
2021-04-03,Tehama,103,63373,4818,4788,526,5314,52
2021-04-03,Trinity,105,12862,478,321,85,406,3
2021-04-03,Tulare,107,460477,49388,48327,8671,56998,818
2021-04-03,Tuolumne,109,53932,3917,3980,37,4017,57
2021-04-03,Ventura,111,848112,80072,79489,2900,82389,983
2021-04-03,Yolo,113,214977,13396,13414,248,13662,198
2021-04-03,Yuba,115,75493,5760,5716,113,5829,43
2021-04-02,Alameda,001,1643700,84322,83776,1826,85602,1217
2021-04-02,Alpine,003,1148,85,85,0,85,0
2021-04-02,Amador,005,37829,3595,3573,32,3605,45
2021-04-02,Butte,007,227075,11746,11350,1685,13035,193
2021-04-02,Calaveras,009,45235,2018,2010,12,2022,50
2021-04-02,Colusa,011,21464,1895,1891,276,2167,14
2021-04-02,Contra Costa,013,1133247,66178,65299,1153,66452,774
2021-04-02,Del Norte,015,27424,1220,1174,11,1185,6
2021-04-02,El Dorado,017,186661,9527,9437,626,10063,106
2021-04-02,Fresno,019,978130,100218,99551,8346,107897,1620
2021-04-02,Glenn,021,27897,2359,2331,535,2866,17
2021-04-02,Humboldt,023,135768,3476,3465,25,3490,35
2021-04-02,Imperial,025,180216,27747,27553,2625,30178,710
2021-04-02,Inyo,027,18085,1380,1377,10,1387,36
2021-04-02,Kern,029,883053,95613,94348,10362,104710,1233
2021-04-02,Kings,031,150075,22832,22571,1040,23611,239
2021-04-02,Lake,033,64148,3373,3348,8,3356,43
2021-04-02,Lassen,035,31185,5151,5134,103,5237,1
2021-04-02,Los Angeles,037,10098052,1189989,1181682,40600,1222282,23264
2021-04-02,Madera,039,155013,16197,16036,896,16932,230
2021-04-02,Marin,041,260295,13719,13649,219,13868,221
2021-04-02,Mariposa,043,17540,396,390,5,395,5
2021-04-02,Mendocino,045,87422,3766,3682,73,3755,45
2021-04-02,Merced,047,269075,29955,29998,1001,30999,426
2021-04-02,Modoc,049,8938,358,346,120,466,3
2021-04-02,Mono,051,14174,1236,1246,17,1263,3
2021-04-02,Monterey,053,433212,42626,42359,1794,44153,341
2021-04-02,Napa,055,140530,9500,9453,34,9487,78
2021-04-02,Nevada,057,99092,4389,4323,182,4505,69
2021-04-02,Orange,059,3164182,251756,249891,10850,260741,4748
2021-04-02,Placer,061,380077,21770,21035,1284,22319,275
2021-04-02,Plumas,063,18699,674,666,10,676,4
2021-04-02,Riverside,065,2383286,290012,283328,13744,297072,4213
2021-04-02,Sacramento,067,1510023,99663,98648,1448,100096,1527
2021-04-02,San Benito,069,59416,5900,5888,97,5985,61
2021-04-02,San Bernardino,071,2135413,289720,286308,8788,295096,4417
2021-04-02,San Diego,073,3302833,272069,271036,13673,284709,3568
2021-04-02,San Francisco,075,870044,35477,35451,1212,36663,488
2021-04-02,San Joaquin,077,732212,70148,68996,3229,72225,1268
2021-04-02,San Luis Obispo,079,281455,20617,20271,632,20903,252
2021-04-02,San Mateo,081,765935,40999,40514,432,40946,350
2021-04-02,Santa Barbara,083,443738,33534,33145,1104,34249,443
2021-04-02,Santa Clara,085,1922200,114709,114777,667,115444,1882
2021-04-02,Santa Cruz,087,273765,15888,15216,806,16022,202
2021-04-02,Shasta,089,179085,11379,11377,1370,12747,181
2021-04-02,Sierra,091,2930,55,50,12,62,0
2021-04-02,Siskiyou,093,43540,1576,1508,265,1773,7
2021-04-02,Solano,095,438530,31050,30951,418,31369,237
2021-04-02,Sonoma,097,501317,29203,29288,284,29572,311
2021-04-02,Stanislaus,099,539301,53448,53073,5647,58720,687
2021-04-02,Sutter,101,95872,9151,9131,82,9213,106
2021-04-02,Tehama,103,63373,4811,4775,525,5300,52
2021-04-02,Trinity,105,12862,478,320,85,405,3
2021-04-02,Tulare,107,460477,49382,48306,8665,56971,818
2021-04-02,Tuolumne,109,53932,3914,3980,37,4017,57
2021-04-02,Ventura,111,848112,80044,79434,2898,82332,982
2021-04-02,Yolo,113,214977,13386,13381,248,13629,197
2021-04-02,Yuba,115,75493,5756,5709,113,5822,44
2021-04-01,Alameda,001,1643700,84243,83574,1821,85395,1216
2021-04-01,Alpine,003,1148,85,85,0,85,0
2021-04-01,Amador,005,37829,3591,3558,32,3590,45
2021-04-01,Butte,007,227075,11728,11328,1683,13011,193
2021-04-01,Calaveras,009,45235,2014,2006,12,2018,50
2021-04-01,Colusa,011,21464,1892,1890,276,2166,14
2021-04-01,Contra Costa,013,1133247,66118,65176,1151,66327,771
2021-04-01,Del Norte,015,27424,1215,1138,11,1149,6
2021-04-01,El Dorado,017,186661,9518,9393,622,10015,106
2021-04-01,Fresno,019,978130,100165,99317,8338,107655,1616
2021-04-01,Glenn,021,27897,2359,2322,534,2856,17
2021-04-01,Humboldt,023,135768,3472,3464,25,3489,35
2021-04-01,Imperial,025,180216,27717,27520,2619,30139,710
2021-04-01,Inyo,027,18085,1379,1374,10,1384,36
2021-04-01,Kern,029,883053,95577,94244,10350,104594,1233
2021-04-01,Kings,031,150075,22825,22560,1039,23599,239
2021-04-01,Lake,033,64148,3368,3337,8,3345,43
2021-04-01,Lassen,035,31185,5150,5132,103,5235,1
2021-04-01,Los Angeles,037,10098052,1189497,1181101,40571,1221672,23220
2021-04-01,Madera,039,155013,16181,16023,896,16919,230
2021-04-01,Marin,041,260295,13709,13635,219,13854,221
2021-04-01,Mariposa,043,17540,394,389,5,394,5
2021-04-01,Mendocino,045,87422,3766,3680,73,3753,45
2021-04-01,Merced,047,269075,29922,29820,1001,30821,425
2021-04-01,Modoc,049,8938,357,346,120,466,3
2021-04-01,Mono,051,14174,1236,1245,17,1262,3
2021-04-01,Monterey,053,433212,42618,42324,1792,44116,339
2021-04-01,Napa,055,140530,9488,9410,34,9444,78
2021-04-01,Nevada,057,99092,4379,4288,181,4469,68
2021-04-01,Orange,059,3164182,251636,249617,10833,260450,4742
2021-04-01,Placer,061,380077,21731,20909,1272,22181,274
2021-04-01,Plumas,063,18699,674,664,10,674,4
2021-04-01,Riverside,065,2383286,289907,283128,13741,296869,4193
2021-04-01,Sacramento,067,1510023,99519,97952,1434,99386,1521
2021-04-01,San Benito,069,59416,5892,5878,96,5974,61
2021-04-01,San Bernardino,071,2135413,289602,286086,8779,294865,4404
2021-04-01,San Diego,073,3302833,271845,270540,13643,284183,3555
2021-04-01,San Francisco,075,870044,35456,35386,1209,36595,488
2021-04-01,San Joaquin,077,732212,70066,68802,3221,72023,1262
2021-04-01,San Luis Obispo,079,281455,20588,20235,631,20866,252
2021-04-01,San Mateo,081,765935,40958,40454,432,40886,350
2021-04-01,Santa Barbara,083,443738,33487,33096,1099,34195,443
2021-04-01,Santa Clara,085,1922200,114596,114606,666,115272,1874
2021-04-01,Santa Cruz,087,273765,15873,15271,806,16077,202
2021-04-01,Shasta,089,179085,11364,11355,1365,12720,181
2021-04-01,Sierra,091,2930,55,50,12,62,0
2021-04-01,Siskiyou,093,43540,1574,1507,264,1771,7
2021-04-01,Solano,095,438530,31017,30850,415,31265,237
2021-04-01,Sonoma,097,501317,29172,29241,277,29518,311
2021-04-01,Stanislaus,099,539301,53385,52825,5641,58466,687
2021-04-01,Sutter,101,95872,9139,9105,82,9187,106
2021-04-01,Tehama,103,63373,4805,4764,522,5286,52
2021-04-01,Trinity,105,12862,478,319,85,404,3
2021-04-01,Tulare,107,460477,49359,48279,8655,56934,817
2021-04-01,Tuolumne,109,53932,3912,3978,37,4015,57
2021-04-01,Ventura,111,848112,80020,79369,2897,82266,977
2021-04-01,Yolo,113,214977,13373,13342,248,13590,197
2021-04-01,Yuba,115,75493,5751,5694,113,5807,44
2021-03-31,Alameda,001,1643700,84162,83475,1816,85291,1215
2021-03-31,Alpine,003,1148,85,85,0,85,0
2021-03-31,Amador,005,37829,3588,3556,32,3588,45
2021-03-31,Butte,007,227075,11718,11321,1680,13001,193
2021-03-31,Calaveras,009,45235,2012,2005,12,2017,50
2021-03-31,Colusa,011,21464,1892,1890,276,2166,14
2021-03-31,Contra Costa,013,1133247,66033,65109,1150,66259,769
2021-03-31,Del Norte,015,27424,1206,1129,11,1140,6
2021-03-31,El Dorado,017,186661,9501,9390,622,10012,106
2021-03-31,Fresno,019,978130,100072,99240,8321,107561,1616
2021-03-31,Glenn,021,27897,2355,2318,532,2850,17
2021-03-31,Humboldt,023,135768,3466,3460,25,3485,35
2021-03-31,Imperial,025,180216,27697,27506,2618,30124,710
2021-03-31,Inyo,027,18085,1376,1373,9,1382,35
2021-03-31,Kern,029,883053,95534,94205,10341,104546,1229
2021-03-31,Kings,031,150075,22822,22540,1039,23579,239
2021-03-31,Lake,033,64148,3364,3332,8,3340,43
2021-03-31,Lassen,035,31185,5146,5132,103,5235,1
2021-03-31,Los Angeles,037,10098052,1189029,1180538,40531,1221069,23171
2021-03-31,Madera,039,155013,16167,16015,895,16910,229
2021-03-31,Marin,041,260295,13698,13624,219,13843,221
2021-03-31,Mariposa,043,17540,394,389,5,394,5
2021-03-31,Mendocino,045,87422,3760,3675,73,3748,45
2021-03-31,Merced,047,269075,29893,29780,1001,30781,423
2021-03-31,Modoc,049,8938,357,346,120,466,3
2021-03-31,Mono,051,14174,1236,1245,17,1262,3
2021-03-31,Monterey,053,433212,42601,42309,1790,44099,338
2021-03-31,Napa,055,140530,9470,9401,34,9435,78
2021-03-31,Nevada,057,99092,4373,4283,181,4464,68
2021-03-31,Orange,059,3164182,251525,249518,10818,260336,4731
2021-03-31,Placer,061,380077,21681,20885,1265,22150,271
2021-03-31,Plumas,063,18699,673,663,10,673,4
2021-03-31,Riverside,065,2383286,289805,283006,13731,296737,4171
2021-03-31,Sacramento,067,1510023,99344,97760,1427,99187,1519
2021-03-31,San Benito,069,59416,5882,5875,96,5971,61
2021-03-31,San Bernardino,071,2135413,289507,285916,8776,294692,4356
2021-03-31,San Diego,073,3302833,271614,270288,13608,283896,3555
2021-03-31,San Francisco,075,870044,35411,35347,1208,36555,474
2021-03-31,San Joaquin,077,732212,69977,68685,3205,71890,1259
2021-03-31,San Luis Obispo,079,281455,20567,20215,630,20845,251
2021-03-31,San Mateo,081,765935,40928,40423,432,40855,350
2021-03-31,Santa Barbara,083,443738,33455,33052,1097,34149,443
2021-03-31,Santa Clara,085,1922200,114469,114499,666,115165,1874
2021-03-31,Santa Cruz,087,273765,15860,15295,805,16100,201
2021-03-31,Shasta,089,179085,11352,11327,1357,12684,179
2021-03-31,Sierra,091,2930,55,50,12,62,0
2021-03-31,Siskiyou,093,43540,1573,1505,264,1769,7
2021-03-31,Solano,095,438530,30971,30824,414,31238,235
2021-03-31,Sonoma,097,501317,29145,29216,277,29493,311
2021-03-31,Stanislaus,099,539301,53317,52782,5629,58411,687
2021-03-31,Sutter,101,95872,9128,9111,82,9193,106
2021-03-31,Tehama,103,63373,4800,4762,519,5281,52
2021-03-31,Trinity,105,12862,478,319,85,404,3
2021-03-31,Tulare,107,460477,49339,48261,8639,56900,816
2021-03-31,Tuolumne,109,53932,3911,3976,37,4013,57
2021-03-31,Ventura,111,848112,79988,79326,2893,82219,969
2021-03-31,Yolo,113,214977,13356,13359,247,13606,197
2021-03-31,Yuba,115,75493,5744,5686,113,5799,44
2021-03-30,Alameda,001,1643700,84062,83395,1813,85208,1211
2021-03-30,Alpine,003,1148,85,85,0,85,0
2021-03-30,Amador,005,37829,3585,3551,32,3583,45
2021-03-30,Butte,007,227075,11706,11296,1677,12973,193
2021-03-30,Calaveras,009,45235,2008,1997,12,2009,50
2021-03-30,Colusa,011,21464,1891,1890,275,2165,14
2021-03-30,Contra Costa,013,1133247,65944,65041,1148,66189,767
2021-03-30,Del Norte,015,27424,1198,1118,10,1128,6
2021-03-30,El Dorado,017,186661,9482,9381,619,10000,105
2021-03-30,Fresno,019,978130,100007,99156,8308,107464,1609
2021-03-30,Glenn,021,27897,2355,2310,531,2841,17
2021-03-30,Humboldt,023,135768,3464,3461,25,3486,35
2021-03-30,Imperial,025,180216,27668,27471,2616,30087,706
2021-03-30,Inyo,027,18085,1376,1374,9,1383,35
2021-03-30,Kern,029,883053,95492,94151,10332,104483,1221
2021-03-30,Kings,031,150075,22818,22530,1037,23567,238
2021-03-30,Lake,033,64148,3358,3330,8,3338,43
2021-03-30,Lassen,035,31185,5146,5132,103,5235,1
2021-03-30,Los Angeles,037,10098052,1188532,1180044,40509,1220553,23136
2021-03-30,Madera,039,155013,16157,16003,891,16894,229
2021-03-30,Marin,041,260295,13689,13611,211,13822,221
2021-03-30,Mariposa,043,17540,394,388,5,393,5
2021-03-30,Mendocino,045,87422,3758,3670,73,3743,45
2021-03-30,Merced,047,269075,29856,29731,1001,30732,423
2021-03-30,Modoc,049,8938,356,346,120,466,3
2021-03-30,Mono,051,14174,1235,1245,17,1262,3
2021-03-30,Monterey,053,433212,42575,42308,1787,44095,338
2021-03-30,Napa,055,140530,9455,9391,34,9425,78
2021-03-30,Nevada,057,99092,4361,4266,180,4446,68
2021-03-30,Orange,059,3164182,251396,249412,10791,260203,4727
2021-03-30,Placer,061,380077,21641,20866,1259,22125,271
2021-03-30,Plumas,063,18699,673,661,10,671,4
2021-03-30,Riverside,065,2383286,289680,282930,13722,296652,4154
2021-03-30,Sacramento,067,1510023,99207,97718,1423,99141,1516
2021-03-30,San Benito,069,59416,5876,5870,96,5966,61
2021-03-30,San Bernardino,071,2135413,289399,285758,8767,294525,4343
2021-03-30,San Diego,073,3302833,271375,269998,13570,283568,3555
2021-03-30,San Francisco,075,870044,35361,35325,1207,36532,474
2021-03-30,San Joaquin,077,732212,69889,68613,3195,71808,1232
2021-03-30,San Luis Obispo,079,281455,20547,20194,630,20824,251
2021-03-30,San Mateo,081,765935,40883,40377,432,40809,349
2021-03-30,Santa Barbara,083,443738,33430,33016,1097,34113,441
2021-03-30,Santa Clara,085,1922200,114346,114413,665,115078,1873
2021-03-30,Santa Cruz,087,273765,15854,15278,805,16083,201
2021-03-30,Shasta,089,179085,11344,11316,1356,12672,184
2021-03-30,Sierra,091,2930,55,50,12,62,0
2021-03-30,Siskiyou,093,43540,1572,1501,264,1765,7
2021-03-30,Solano,095,438530,30941,30802,413,31215,232
2021-03-30,Sonoma,097,501317,29113,29198,277,29475,311
2021-03-30,Stanislaus,099,539301,53239,52690,5621,58311,677
2021-03-30,Sutter,101,95872,9124,9107,81,9188,106
2021-03-30,Tehama,103,63373,4791,4748,518,5266,52
2021-03-30,Trinity,105,12862,478,316,85,401,3
2021-03-30,Tulare,107,460477,49324,48249,8630,56879,815
2021-03-30,Tuolumne,109,53932,3906,3972,37,4009,57
2021-03-30,Ventura,111,848112,79944,79282,2890,82172,958
2021-03-30,Yolo,113,214977,13343,13353,247,13600,195
2021-03-30,Yuba,115,75493,5733,5679,107,5786,42
2021-03-29,Alameda,001,1643700,83961,83338,1811,85149,1211
2021-03-29,Alpine,003,1148,85,85,0,85,0
2021-03-29,Amador,005,37829,3579,3549,32,3581,45
2021-03-29,Butte,007,227075,11697,11291,1674,12965,191
2021-03-29,Calaveras,009,45235,2006,1998,12,2010,50
2021-03-29,Colusa,011,21464,1891,1889,274,2163,14
2021-03-29,Contra Costa,013,1133247,65875,64971,1147,66118,767
2021-03-29,Del Norte,015,27424,1193,1116,9,1125,6
2021-03-29,El Dorado,017,186661,9462,9374,613,9987,105
2021-03-29,Fresno,019,978130,99924,99085,8293,107378,1606
2021-03-29,Glenn,021,27897,2348,2310,531,2841,17
2021-03-29,Humboldt,023,135768,3459,3459,25,3484,34
2021-03-29,Imperial,025,180216,27647,27442,2614,30056,704
2021-03-29,Inyo,027,18085,1376,1372,9,1381,35
2021-03-29,Kern,029,883053,95445,94098,10312,104410,1220
2021-03-29,Kings,031,150075,22806,22522,1036,23558,238
2021-03-29,Lake,033,64148,3355,3325,8,3333,43
2021-03-29,Lassen,035,31185,5146,5131,103,5234,1
2021-03-29,Los Angeles,037,10098052,1188038,1179736,40468,1220204,23108
2021-03-29,Madera,039,155013,16137,15987,889,16876,210
2021-03-29,Marin,041,260295,13677,13600,207,13807,220
2021-03-29,Mariposa,043,17540,393,388,5,393,5
2021-03-29,Mendocino,045,87422,3755,3667,73,3740,45
2021-03-29,Merced,047,269075,29832,29699,1001,30700,422
2021-03-29,Modoc,049,8938,355,344,120,464,3
2021-03-29,Mono,051,14174,1234,1243,17,1260,3
2021-03-29,Monterey,053,433212,42559,42305,1782,44087,337
2021-03-29,Napa,055,140530,9439,9379,34,9413,78
2021-03-29,Nevada,057,99092,4354,4258,180,4438,68
2021-03-29,Orange,059,3164182,251284,249295,10779,260074,4713
2021-03-29,Placer,061,380077,21606,20827,1252,22079,267
2021-03-29,Plumas,063,18699,672,660,10,670,4
2021-03-29,Riverside,065,2383286,289577,282867,13721,296588,4133
2021-03-29,Sacramento,067,1510023,99013,97577,1415,98992,1514
2021-03-29,San Benito,069,59416,5869,5865,96,5961,61
2021-03-29,San Bernardino,071,2135413,289302,285615,8763,294378,4335
2021-03-29,San Diego,073,3302833,271109,269771,13544,283315,3547
2021-03-29,San Francisco,075,870044,35326,35291,1204,36495,474
2021-03-29,San Joaquin,077,732212,69803,68537,3182,71719,1211
2021-03-29,San Luis Obispo,079,281455,20512,20176,629,20805,250
2021-03-29,San Mateo,081,765935,40841,40357,431,40788,348
2021-03-29,Santa Barbara,083,443738,33396,32983,1096,34079,439
2021-03-29,Santa Clara,085,1922200,114238,114335,660,114995,1871
2021-03-29,Santa Cruz,087,273765,15843,15249,804,16053,201
2021-03-29,Shasta,089,179085,11326,11313,1354,12667,183
2021-03-29,Sierra,091,2930,55,50,12,62,0
2021-03-29,Siskiyou,093,43540,1570,1497,263,1760,6
2021-03-29,Solano,095,438530,30902,30762,411,31173,232
2021-03-29,Sonoma,097,501317,29090,29184,274,29458,310
2021-03-29,Stanislaus,099,539301,53156,52614,5613,58227,677
2021-03-29,Sutter,101,95872,9117,9105,81,9186,106
2021-03-29,Tehama,103,63373,4783,4742,517,5259,52
2021-03-29,Trinity,105,12862,478,314,85,399,3
2021-03-29,Tulare,107,460477,49296,48226,8619,56845,815
2021-03-29,Tuolumne,109,53932,3904,3969,37,4006,57
2021-03-29,Ventura,111,848112,79902,79252,2890,82142,956
2021-03-29,Yolo,113,214977,13325,13346,247,13593,195
2021-03-29,Yuba,115,75493,5726,5671,106,5777,42
2021-03-28,Alameda,001,1643700,83840,83239,1809,85048,1212
2021-03-28,Alpine,003,1148,85,85,0,85,0
2021-03-28,Amador,005,37829,3575,3541,32,3573,45
2021-03-28,Butte,007,227075,11684,11285,1672,12957,191
2021-03-28,Calaveras,009,45235,2004,1995,12,2007,50
2021-03-28,Colusa,011,21464,1890,1889,274,2163,14
2021-03-28,Contra Costa,013,1133247,65801,64878,1143,66021,767
2021-03-28,Del Norte,015,27424,1186,1107,7,1114,6
2021-03-28,El Dorado,017,186661,9447,9371,611,9982,105
2021-03-28,Fresno,019,978130,99842,99004,8281,107285,1606
2021-03-28,Glenn,021,27897,2344,2309,529,2838,17
2021-03-28,Humboldt,023,135768,3456,3452,24,3476,34
2021-03-28,Imperial,025,180216,27620,27426,2611,30037,704
2021-03-28,Inyo,027,18085,1375,1372,9,1381,35
2021-03-28,Kern,029,883053,95400,94084,10301,104385,1219
2021-03-28,Kings,031,150075,22801,22514,1033,23547,238
2021-03-28,Lake,033,64148,3350,3320,8,3328,43
2021-03-28,Lassen,035,31185,5146,5131,102,5233,1
2021-03-28,Los Angeles,037,10098052,1187488,1179316,40409,1219725,23101
2021-03-28,Madera,039,155013,16122,15973,888,16861,210
2021-03-28,Marin,041,260295,13664,13594,205,13799,221
2021-03-28,Mariposa,043,17540,393,388,5,393,5
2021-03-28,Mendocino,045,87422,3753,3666,73,3739,45
2021-03-28,Merced,047,269075,29775,29679,1001,30680,422
2021-03-28,Modoc,049,8938,355,344,120,464,3
2021-03-28,Mono,051,14174,1233,1242,17,1259,3
2021-03-28,Monterey,053,433212,42536,42294,1778,44072,337
2021-03-28,Napa,055,140530,9425,9368,34,9402,78
2021-03-28,Nevada,057,99092,4340,4239,180,4419,68
2021-03-28,Orange,059,3164182,251129,249238,10769,260007,4713
2021-03-28,Placer,061,380077,21562,20796,1246,22042,267
2021-03-28,Plumas,063,18699,670,657,10,667,4
2021-03-28,Riverside,065,2383286,289463,282811,13712,296523,4132
2021-03-28,Sacramento,067,1510023,98839,97425,1409,98834,1514
2021-03-28,San Benito,069,59416,5864,5862,96,5958,61
2021-03-28,San Bernardino,071,2135413,289183,285570,8754,294324,4332
2021-03-28,San Diego,073,3302833,270833,269476,13515,282991,3547
2021-03-28,San Francisco,075,870044,35280,35286,1200,36486,474
2021-03-28,San Joaquin,077,732212,69678,68459,3163,71622,1211
2021-03-28,San Luis Obispo,079,281455,20477,20172,626,20798,250
2021-03-28,San Mateo,081,765935,40796,40305,431,40736,348
2021-03-28,Santa Barbara,083,443738,33354,32953,1095,34048,439
2021-03-28,Santa Clara,085,1922200,114138,114232,656,114888,1871
2021-03-28,Santa Cruz,087,273765,15828,15238,803,16041,201
2021-03-28,Shasta,089,179085,11300,11308,1343,12651,183
2021-03-28,Sierra,091,2930,55,50,12,62,0
2021-03-28,Siskiyou,093,43540,1570,1497,262,1759,6
2021-03-28,Solano,095,438530,30865,30719,409,31128,232
2021-03-28,Sonoma,097,501317,29054,29161,272,29433,310
2021-03-28,Stanislaus,099,539301,53068,52567,5598,58165,678
2021-03-28,Sutter,101,95872,9108,9094,81,9175,106
2021-03-28,Tehama,103,63373,4773,4740,515,5255,52
2021-03-28,Trinity,105,12862,476,314,84,398,3
2021-03-28,Tulare,107,460477,49267,48218,8613,56831,815
2021-03-28,Tuolumne,109,53932,3901,3969,36,4005,57
2021-03-28,Ventura,111,848112,79851,79222,2885,82107,956
2021-03-28,Yolo,113,214977,13308,13325,246,13571,194
2021-03-28,Yuba,115,75493,5722,5662,106,5768,42
2021-03-27,Alameda,001,1643700,83769,83169,1805,84974,1211
2021-03-27,Alpine,003,1148,85,85,0,85,0
2021-03-27,Amador,005,37829,3570,3538,32,3570,45
2021-03-27,Butte,007,227075,11677,11278,1671,12949,191
2021-03-27,Calaveras,009,45235,2001,1992,12,2004,50
2021-03-27,Colusa,011,21464,1890,1889,274,2163,14
2021-03-27,Contra Costa,013,1133247,65731,64804,1140,65944,767
2021-03-27,Del Norte,015,27424,1176,1104,7,1111,6
2021-03-27,El Dorado,017,186661,9433,9367,611,9978,105
2021-03-27,Fresno,019,978130,99789,98901,8275,107176,1606
2021-03-27,Glenn,021,27897,2343,2308,529,2837,17
2021-03-27,Humboldt,023,135768,3451,3442,24,3466,34
2021-03-27,Imperial,025,180216,27608,27406,2608,30014,704
2021-03-27,Inyo,027,18085,1373,1372,9,1381,35
2021-03-27,Kern,029,883053,95380,94041,10289,104330,1217
2021-03-27,Kings,031,150075,22798,22502,1033,23535,238
2021-03-27,Lake,033,64148,3348,3317,8,3325,43
2021-03-27,Lassen,035,31185,5146,5129,102,5231,1
2021-03-27,Los Angeles,037,10098052,1187173,1178831,40382,1219213,23103
2021-03-27,Madera,039,155013,16115,15968,886,16854,210
2021-03-27,Marin,041,260295,13659,13579,205,13784,222
2021-03-27,Mariposa,043,17540,393,386,5,391,5
2021-03-27,Mendocino,045,87422,3751,3666,73,3739,45
2021-03-27,Merced,047,269075,29742,29647,999,30646,422
2021-03-27,Modoc,049,8938,355,344,120,464,3
2021-03-27,Mono,051,14174,1231,1241,17,1258,3
2021-03-27,Monterey,053,433212,42526,42271,1778,44049,337
2021-03-27,Napa,055,140530,9413,9360,34,9394,78
2021-03-27,Nevada,057,99092,4330,4231,180,4411,68
2021-03-27,Orange,059,3164182,251036,249160,10753,259913,4698
2021-03-27,Placer,061,380077,21542,20717,1239,21956,267
2021-03-27,Plumas,063,18699,669,655,10,665,4
2021-03-27,Riverside,065,2383286,289401,282707,13704,296411,4132
2021-03-27,Sacramento,067,1510023,98749,97247,1407,98654,1513
2021-03-27,San Benito,069,59416,5862,5862,94,5956,61
2021-03-27,San Bernardino,071,2135413,289120,285480,8752,294232,4325
2021-03-27,San Diego,073,3302833,270662,269271,13493,282764,3540
2021-03-27,San Francisco,075,870044,35257,35244,1198,36442,474
2021-03-27,San Joaquin,077,732212,69618,68365,3155,71520,1211
2021-03-27,San Luis Obispo,079,281455,20466,20153,623,20776,250
2021-03-27,San Mateo,081,765935,40773,40264,431,40695,348
2021-03-27,Santa Barbara,083,443738,33331,32921,1095,34016,439
2021-03-27,Santa Clara,085,1922200,114042,114124,654,114778,1871
2021-03-27,Santa Cruz,087,273765,15822,15215,803,16018,201
2021-03-27,Shasta,089,179085,11289,11288,1341,12629,183
2021-03-27,Sierra,091,2930,55,50,12,62,0
2021-03-27,Siskiyou,093,43540,1570,1497,262,1759,6
2021-03-27,Solano,095,438530,30837,30669,408,31077,232
2021-03-27,Sonoma,097,501317,29039,29133,270,29403,310
2021-03-27,Stanislaus,099,539301,53003,52497,5590,58087,678
2021-03-27,Sutter,101,95872,9101,9093,81,9174,106
2021-03-27,Tehama,103,63373,4767,4738,513,5251,52
2021-03-27,Trinity,105,12862,476,313,84,397,3
2021-03-27,Tulare,107,460477,49251,48203,8605,56808,813
2021-03-27,Tuolumne,109,53932,3898,3968,36,4004,57
2021-03-27,Ventura,111,848112,79824,79184,2883,82067,956
2021-03-27,Yolo,113,214977,13303,13317,245,13562,194
2021-03-27,Yuba,115,75493,5720,5657,106,5763,42
2021-03-26,Alameda,001,1643700,83707,83043,1803,84846,1208
2021-03-26,Alpine,003,1148,85,85,0,85,0
2021-03-26,Amador,005,37829,3565,3532,32,3564,45
2021-03-26,Butte,007,227075,11667,11278,1671,12949,191
2021-03-26,Calaveras,009,45235,1999,1989,12,2001,50
2021-03-26,Colusa,011,21464,1890,1889,274,2163,14
2021-03-26,Contra Costa,013,1133247,65671,64699,1137,65836,761
2021-03-26,Del Norte,015,27424,1173,1101,7,1108,6
2021-03-26,El Dorado,017,186661,9428,9353,611,9964,105
2021-03-26,Fresno,019,978130,99727,98731,8265,106996,1601
2021-03-26,Glenn,021,27897,2343,2307,528,2835,17
2021-03-26,Humboldt,023,135768,3449,3431,24,3455,34
2021-03-26,Imperial,025,180216,27584,27374,2608,29982,701
2021-03-26,Inyo,027,18085,1372,1369,9,1378,35
2021-03-26,Kern,029,883053,95354,93949,10283,104232,1211
2021-03-26,Kings,031,150075,22790,22493,1031,23524,239
2021-03-26,Lake,033,64148,3347,3314,8,3322,43
2021-03-26,Lassen,035,31185,5145,5131,102,5233,1
2021-03-26,Los Angeles,037,10098052,1186836,1178213,40369,1218582,23080
2021-03-26,Madera,039,155013,16105,15952,886,16838,210
2021-03-26,Marin,041,260295,13653,13553,200,13753,221
2021-03-26,Mariposa,043,17540,393,386,5,391,5
2021-03-26,Mendocino,045,87422,3750,3664,73,3737,45
2021-03-26,Merced,047,269075,29719,29613,997,30610,419
2021-03-26,Modoc,049,8938,355,344,120,464,3
2021-03-26,Mono,051,14174,1230,1236,17,1253,3
2021-03-26,Monterey,053,433212,42513,42241,1774,44015,338
2021-03-26,Napa,055,140530,9403,9349,34,9383,78
2021-03-26,Nevada,057,99092,4310,4222,180,4402,83
2021-03-26,Orange,059,3164182,250973,248995,10739,259734,4671
2021-03-26,Placer,061,380077,21516,20679,1238,21917,259
2021-03-26,Plumas,063,18699,668,654,10,664,4
2021-03-26,Riverside,065,2383286,289323,282602,13698,296300,4109
2021-03-26,Sacramento,067,1510023,98649,97040,1402,98442,1509
2021-03-26,San Benito,069,59416,5859,5855,94,5949,61
2021-03-26,San Bernardino,071,2135413,289064,285313,8750,294063,4288
2021-03-26,San Diego,073,3302833,270484,269045,13467,282512,3525
2021-03-26,San Francisco,075,870044,35231,35186,1198,36384,472
2021-03-26,San Joaquin,077,732212,69555,68249,3151,71400,1202
2021-03-26,San Luis Obispo,079,281455,20453,20118,623,20741,250
2021-03-26,San Mateo,081,765935,40738,40199,431,40630,348
2021-03-26,Santa Barbara,083,443738,33301,32895,1094,33989,439
2021-03-26,Santa Clara,085,1922200,113944,113959,653,114612,1868
2021-03-26,Santa Cruz,087,273765,15807,15199,802,16001,201
2021-03-26,Shasta,089,179085,11280,11276,1335,12611,182
2021-03-26,Sierra,091,2930,55,50,12,62,0
2021-03-26,Siskiyou,093,43540,1570,1493,261,1754,6
2021-03-26,Solano,095,438530,30812,30640,408,31048,205
2021-03-26,Sonoma,097,501317,29023,29101,267,29368,310
2021-03-26,Stanislaus,099,539301,52935,52420,5586,58006,678
2021-03-26,Sutter,101,95872,9098,9082,81,9163,104
2021-03-26,Tehama,103,63373,4766,4722,512,5234,51
2021-03-26,Trinity,105,12862,476,311,84,395,3
2021-03-26,Tulare,107,460477,49236,48179,8597,56776,813
2021-03-26,Tuolumne,109,53932,3897,3965,36,4001,57
2021-03-26,Ventura,111,848112,79790,79122,2881,82003,953
2021-03-26,Yolo,113,214977,13296,13299,243,13542,194
2021-03-26,Yuba,115,75493,5710,5653,106,5759,42
2021-03-25,Alameda,001,1643700,83612,82945,1801,84746,1206
2021-03-25,Alpine,003,1148,85,84,0,84,0
2021-03-25,Amador,005,37829,3563,3530,32,3562,45
2021-03-25,Butte,007,227075,11657,11270,1671,12941,188
2021-03-25,Calaveras,009,45235,1998,1982,12,1994,50
2021-03-25,Colusa,011,21464,1890,1888,274,2162,14
2021-03-25,Contra Costa,013,1133247,65604,64606,1133,65739,757
2021-03-25,Del Norte,015,27424,1167,1095,7,1102,6
2021-03-25,El Dorado,017,186661,9418,9331,611,9942,105
2021-03-25,Fresno,019,978130,99609,98602,8252,106854,1593
2021-03-25,Glenn,021,27897,2342,2302,527,2829,17
2021-03-25,Humboldt,023,135768,3444,3423,24,3447,34
2021-03-25,Imperial,025,180216,27568,27352,2607,29959,699
2021-03-25,Inyo,027,18085,1372,1369,9,1378,35
2021-03-25,Kern,029,883053,95322,93857,10278,104135,1206
2021-03-25,Kings,031,150075,22780,22472,1031,23503,237
2021-03-25,Lake,033,64148,3342,3312,8,3320,43
2021-03-25,Lassen,035,31185,5145,5129,102,5231,1
2021-03-25,Los Angeles,037,10098052,1186403,1177490,40334,1217824,23051
2021-03-25,Madera,039,155013,16086,15937,884,16821,210
2021-03-25,Marin,041,260295,13643,13538,197,13735,219
2021-03-25,Mariposa,043,17540,393,386,5,391,5
2021-03-25,Mendocino,045,87422,3749,3664,73,3737,45
2021-03-25,Merced,047,269075,29685,29576,989,30565,416
2021-03-25,Modoc,049,8938,355,343,120,463,3
2021-03-25,Mono,051,14174,1230,1235,17,1252,3
2021-03-25,Monterey,053,433212,42492,42220,1769,43989,336
2021-03-25,Napa,055,140530,9384,9321,34,9355,78
2021-03-25,Nevada,057,99092,4292,4202,178,4380,84
2021-03-25,Orange,059,3164182,250857,248871,10719,259590,4655
2021-03-25,Placer,061,380077,21475,20639,1231,21870,252
2021-03-25,Plumas,063,18699,668,654,10,664,4
2021-03-25,Riverside,065,2383286,289226,282492,13687,296179,4078
2021-03-25,Sacramento,067,1510023,98504,96823,1399,98222,1505
2021-03-25,San Benito,069,59416,5856,5850,94,5944,61
2021-03-25,San Bernardino,071,2135413,288982,285134,8745,293879,4222
2021-03-25,San Diego,073,3302833,270256,268623,13436,282059,3520
2021-03-25,San Francisco,075,870044,35192,35154,1196,36350,468
2021-03-25,San Joaquin,077,732212,69458,68089,3112,71201,1196
2021-03-25,San Luis Obispo,079,281455,20435,20076,623,20699,250
2021-03-25,San Mateo,081,765935,40698,40147,431,40578,348
2021-03-25,Santa Barbara,083,443738,33274,32857,1094,33951,439
2021-03-25,Santa Clara,085,1922200,113840,113877,651,114528,1868
2021-03-25,Santa Cruz,087,273765,15786,15170,802,15972,201
2021-03-25,Shasta,089,179085,11263,11262,1332,12594,181
2021-03-25,Sierra,091,2930,55,50,12,62,0
2021-03-25,Siskiyou,093,43540,1568,1491,260,1751,6
2021-03-25,Solano,095,438530,30751,30583,406,30989,193
2021-03-25,Sonoma,097,501317,28988,29060,263,29323,310
2021-03-25,Stanislaus,099,539301,52868,52321,5579,57900,678
2021-03-25,Sutter,101,95872,9089,9069,81,9150,104
2021-03-25,Tehama,103,63373,4764,4719,511,5230,52
2021-03-25,Trinity,105,12862,476,310,84,394,3
2021-03-25,Tulare,107,460477,49209,48148,8584,56732,811
2021-03-25,Tuolumne,109,53932,3896,3962,36,3998,57
2021-03-25,Ventura,111,848112,79749,79045,2877,81922,952
2021-03-25,Yolo,113,214977,13290,13287,243,13530,194
2021-03-25,Yuba,115,75493,5704,5647,100,5747,42
2021-03-24,Alameda,001,1643700,83518,82871,1798,84669,1199
2021-03-24,Alpine,003,1148,85,84,0,84,0
2021-03-24,Amador,005,37829,3557,3529,32,3561,45
2021-03-24,Butte,007,227075,11647,11252,1667,12919,187
2021-03-24,Calaveras,009,45235,1995,1975,12,1987,50
2021-03-24,Colusa,011,21464,1890,1886,274,2160,14
2021-03-24,Contra Costa,013,1133247,65524,64539,1132,65671,755
2021-03-24,Del Norte,015,27424,1162,1087,7,1094,6
2021-03-24,El Dorado,017,186661,9412,9319,610,9929,105
2021-03-24,Fresno,019,978130,99519,98437,8237,106674,1585
2021-03-24,Glenn,021,27897,2341,2297,526,2823,17
2021-03-24,Humboldt,023,135768,3441,3414,24,3438,34
2021-03-24,Imperial,025,180216,27559,27325,2607,29932,699
2021-03-24,Inyo,027,18085,1372,1368,9,1377,35
2021-03-24,Kern,029,883053,95274,93800,10269,104069,1198
2021-03-24,Kings,031,150075,22765,22456,1029,23485,237
2021-03-24,Lake,033,64148,3338,3307,8,3315,43
2021-03-24,Lassen,035,31185,5143,5130,101,5231,1
2021-03-24,Los Angeles,037,10098052,1185925,1177015,40299,1217314,22993
2021-03-24,Madera,039,155013,16077,15918,883,16801,210
2021-03-24,Marin,041,260295,13629,13526,195,13721,219
2021-03-24,Mariposa,043,17540,393,384,5,389,5
2021-03-24,Mendocino,045,87422,3746,3660,73,3733,45
2021-03-24,Merced,047,269075,29644,29525,989,30514,415
2021-03-24,Modoc,049,8938,354,341,120,461,3
2021-03-24,Mono,051,14174,1229,1243,17,1260,3
2021-03-24,Monterey,053,433212,42470,42201,1766,43967,335
2021-03-24,Napa,055,140530,9364,9310,34,9344,78
2021-03-24,Nevada,057,99092,4278,4191,177,4368,85
2021-03-24,Orange,059,3164182,250743,248775,10701,259476,4638
2021-03-24,Placer,061,380077,21445,20606,1223,21829,250
2021-03-24,Plumas,063,18699,666,652,10,662,4
2021-03-24,Riverside,065,2383286,289142,282410,13684,296094,4058
2021-03-24,Sacramento,067,1510023,98329,96628,1387,98015,1500
2021-03-24,San Benito,069,59416,5855,5847,94,5941,61
2021-03-24,San Bernardino,071,2135413,288896,284983,8743,293726,4170
2021-03-24,San Diego,073,3302833,270041,268413,13408,281821,3509
2021-03-24,San Francisco,075,870044,35164,35103,1193,36296,462
2021-03-24,San Joaquin,077,732212,69387,67978,3100,71078,1196
2021-03-24,San Luis Obispo,079,281455,20405,20021,622,20643,250
2021-03-24,San Mateo,081,765935,40648,40083,431,40514,348
2021-03-24,Santa Barbara,083,443738,33246,32810,1094,33904,438
2021-03-24,Santa Clara,085,1922200,113724,113757,648,114405,1851
2021-03-24,Santa Cruz,087,273765,15772,15138,801,15939,202
2021-03-24,Shasta,089,179085,11244,11243,1330,12573,181
2021-03-24,Sierra,091,2930,55,50,12,62,0
2021-03-24,Siskiyou,093,43540,1566,1490,260,1750,6
2021-03-24,Solano,095,438530,30714,30552,405,30957,178
2021-03-24,Sonoma,097,501317,28968,29034,259,29293,310
2021-03-24,Stanislaus,099,539301,52792,52259,5570,57829,677
2021-03-24,Sutter,101,95872,9073,9049,81,9130,104
2021-03-24,Tehama,103,63373,4758,4719,510,5229,49
2021-03-24,Trinity,105,12862,475,310,84,394,3
2021-03-24,Tulare,107,460477,49198,48109,8571,56680,808
2021-03-24,Tuolumne,109,53932,3895,3961,36,3997,57
2021-03-24,Ventura,111,848112,79697,78993,2870,81863,944
2021-03-24,Yolo,113,214977,13279,13269,243,13512,194
2021-03-24,Yuba,115,75493,5698,5634,97,5731,42
2021-03-23,Alameda,001,1643700,83416,82799,1794,84593,1190
2021-03-23,Alpine,003,1148,85,84,0,84,0
2021-03-23,Amador,005,37829,3551,3524,32,3556,45
2021-03-23,Butte,007,227075,11635,11227,1666,12893,187
2021-03-23,Calaveras,009,45235,1993,1971,12,1983,50
2021-03-23,Colusa,011,21464,1888,1885,273,2158,14
2021-03-23,Contra Costa,013,1133247,65425,64491,1131,65622,750
2021-03-23,Del Norte,015,27424,1157,1082,7,1089,6
2021-03-23,El Dorado,017,186661,9402,9318,608,9926,105
2021-03-23,Fresno,019,978130,99406,98362,8211,106573,1575
2021-03-23,Glenn,021,27897,2336,2293,524,2817,17
2021-03-23,Humboldt,023,135768,3432,3405,24,3429,34
2021-03-23,Imperial,025,180216,27551,27320,2607,29927,699
2021-03-23,Inyo,027,18085,1370,1364,9,1373,35
2021-03-23,Kern,029,883053,95167,93728,10262,103990,1191
2021-03-23,Kings,031,150075,22754,22439,1027,23466,237
2021-03-23,Lake,033,64148,3336,3294,8,3302,43
2021-03-23,Lassen,035,31185,5143,5130,101,5231,1
2021-03-23,Los Angeles,037,10098052,1185405,1176572,40261,1216833,22904
2021-03-23,Madera,039,155013,16061,15908,882,16790,210
2021-03-23,Marin,041,260295,13606,13514,193,13707,221
2021-03-23,Mariposa,043,17540,392,384,5,389,5
2021-03-23,Mendocino,045,87422,3744,3652,73,3725,45
2021-03-23,Merced,047,269075,29611,29485,989,30474,415
2021-03-23,Modoc,049,8938,353,342,120,462,3
2021-03-23,Mono,051,14174,1228,1263,17,1280,3
2021-03-23,Monterey,053,433212,42459,42180,1764,43944,335
2021-03-23,Napa,055,140530,9339,9299,34,9333,78
2021-03-23,Nevada,057,99092,4259,4179,176,4355,89
2021-03-23,Orange,059,3164182,250617,248661,10683,259344,4626
2021-03-23,Placer,061,380077,21410,20567,1219,21786,248
2021-03-23,Plumas,063,18699,666,652,10,662,4
2021-03-23,Riverside,065,2383286,289042,282317,13677,295994,4035
2021-03-23,Sacramento,067,1510023,98137,96521,1381,97902,1496
2021-03-23,San Benito,069,59416,5850,5845,93,5938,61
2021-03-23,San Bernardino,071,2135413,288812,284875,8735,293610,4134
2021-03-23,San Diego,073,3302833,269796,268156,13376,281532,3498
2021-03-23,San Francisco,075,870044,35106,35071,1187,36258,462
2021-03-23,San Joaquin,077,732212,69291,67903,3082,70985,1182
2021-03-23,San Luis Obispo,079,281455,20364,20009,621,20630,250
2021-03-23,San Mateo,081,765935,40592,40032,430,40462,348
2021-03-23,Santa Barbara,083,443738,33208,32771,1093,33864,438
2021-03-23,Santa Clara,085,1922200,113608,113645,645,114290,1848
2021-03-23,Santa Cruz,087,273765,15757,15106,801,15907,201
2021-03-23,Shasta,089,179085,11231,11234,1329,12563,175
2021-03-23,Sierra,091,2930,55,50,12,62,0
2021-03-23,Siskiyou,093,43540,1561,1485,258,1743,6
2021-03-23,Solano,095,438530,30673,30524,404,30928,178
2021-03-23,Sonoma,097,501317,28931,29020,258,29278,310
2021-03-23,Stanislaus,099,539301,52693,52148,5562,57710,677
2021-03-23,Sutter,101,95872,9065,9039,81,9120,104
2021-03-23,Tehama,103,63373,4749,4707,509,5216,46
2021-03-23,Trinity,105,12862,475,310,84,394,3
2021-03-23,Tulare,107,460477,49171,48095,8555,56650,808
2021-03-23,Tuolumne,109,53932,3892,3957,36,3993,57
2021-03-23,Ventura,111,848112,79636,78930,2867,81797,932
2021-03-23,Yolo,113,214977,13268,13255,243,13498,194
2021-03-23,Yuba,115,75493,5693,5628,97,5725,42
2021-03-22,Alameda,001,1643700,83323,82748,1788,84536,1189
2021-03-22,Alpine,003,1148,84,83,0,83,0
2021-03-22,Amador,005,37829,3543,3522,32,3554,44
2021-03-22,Butte,007,227075,11626,11211,1664,12875,185
2021-03-22,Calaveras,009,45235,1989,1963,12,1975,49
2021-03-22,Colusa,011,21464,1886,1885,273,2158,13
2021-03-22,Contra Costa,013,1133247,65330,64432,1129,65561,740
2021-03-22,Del Norte,015,27424,1151,1082,7,1089,6
2021-03-22,El Dorado,017,186661,9386,9310,605,9915,105
2021-03-22,Fresno,019,978130,99308,98276,8198,106474,1556
2021-03-22,Glenn,021,27897,2328,2291,524,2815,17
2021-03-22,Humboldt,023,135768,3427,3403,24,3427,34
2021-03-22,Imperial,025,180216,27536,27302,2603,29905,699
2021-03-22,Inyo,027,18085,1367,1363,9,1372,35
2021-03-22,Kern,029,883053,95096,93675,10245,103920,1178
2021-03-22,Kings,031,150075,22741,22433,1022,23455,236
2021-03-22,Lake,033,64148,3335,3290,8,3298,43
2021-03-22,Lassen,035,31185,5141,5129,101,5230,1
2021-03-22,Los Angeles,037,10098052,1184892,1176205,40228,1216433,22843
2021-03-22,Madera,039,155013,16046,15904,882,16786,210
2021-03-22,Marin,041,260295,13597,13501,192,13693,221
2021-03-22,Mariposa,043,17540,391,381,5,386,5
2021-03-22,Mendocino,045,87422,3742,3653,73,3726,45
2021-03-22,Merced,047,269075,29568,29468,986,30454,413
2021-03-22,Modoc,049,8938,351,342,120,462,3
2021-03-22,Mono,051,14174,1223,1263,17,1280,3
2021-03-22,Monterey,053,433212,42443,42161,1762,43923,335
2021-03-22,Napa,055,140530,9328,9288,34,9322,77
2021-03-22,Nevada,057,99092,4248,4174,172,4346,89
2021-03-22,Orange,059,3164182,250466,248517,10649,259166,4599
2021-03-22,Placer,061,380077,21375,20543,1214,21757,242
2021-03-22,Plumas,063,18699,666,652,10,662,4
2021-03-22,Riverside,065,2383286,288942,282242,13666,295908,4009
2021-03-22,Sacramento,067,1510023,97959,96385,1372,97757,1493
2021-03-22,San Benito,069,59416,5847,5844,92,5936,61
2021-03-22,San Bernardino,071,2135413,288724,284771,8723,293494,4107
2021-03-22,San Diego,073,3302833,269584,267913,13356,281269,3494
2021-03-22,San Francisco,075,870044,35064,35040,1183,36223,462
2021-03-22,San Joaquin,077,732212,69199,67815,3064,70879,1182
2021-03-22,San Luis Obispo,079,281455,20340,20000,620,20620,250
2021-03-22,San Mateo,081,765935,40541,40024,429,40453,348
2021-03-22,Santa Barbara,083,443738,33164,32756,1091,33847,437
2021-03-22,Santa Clara,085,1922200,113488,113575,645,114220,1845
2021-03-22,Santa Cruz,087,273765,15745,15077,800,15877,201
2021-03-22,Shasta,089,179085,11217,11218,1328,12546,150
2021-03-22,Sierra,091,2930,55,50,12,62,0
2021-03-22,Siskiyou,093,43540,1560,1487,257,1744,5
2021-03-22,Solano,095,438530,30633,30490,400,30890,171
2021-03-22,Sonoma,097,501317,28902,29010,254,29264,310
2021-03-22,Stanislaus,099,539301,52609,52083,5557,57640,677
2021-03-22,Sutter,101,95872,9052,9024,81,9105,104
2021-03-22,Tehama,103,63373,4741,4704,509,5213,45
2021-03-22,Trinity,105,12862,475,310,84,394,3
2021-03-22,Tulare,107,460477,49156,48074,8535,56609,807
2021-03-22,Tuolumne,109,53932,3889,3954,36,3990,57
2021-03-22,Ventura,111,848112,79590,78890,2864,81754,927
2021-03-22,Yolo,113,214977,13256,13243,242,13485,190
2021-03-22,Yuba,115,75493,5682,5627,95,5722,42
2021-03-21,Alameda,001,1643700,83231,82684,1785,84469,1187
2021-03-21,Alpine,003,1148,84,83,0,83,0
2021-03-21,Amador,005,37829,3539,3519,32,3551,44
2021-03-21,Butte,007,227075,11610,11208,1659,12867,185
2021-03-21,Calaveras,009,45235,1983,1962,12,1974,49
2021-03-21,Colusa,011,21464,1886,1885,273,2158,13
2021-03-21,Contra Costa,013,1133247,65248,64382,1125,65507,740
2021-03-21,Del Norte,015,27424,1136,1076,7,1083,6
2021-03-21,El Dorado,017,186661,9376,9302,600,9902,105
2021-03-21,Fresno,019,978130,99194,98211,8174,106385,1556
2021-03-21,Glenn,021,27897,2325,2288,523,2811,17
2021-03-21,Humboldt,023,135768,3422,3402,24,3426,34
2021-03-21,Imperial,025,180216,27519,27267,2598,29865,699
2021-03-21,Inyo,027,18085,1367,1363,9,1372,35
2021-03-21,Kern,029,883053,95030,93649,10236,103885,1170
2021-03-21,Kings,031,150075,22724,22422,1022,23444,236
2021-03-21,Lake,033,64148,3331,3286,8,3294,43
2021-03-21,Lassen,035,31185,5141,5129,101,5230,1
2021-03-21,Los Angeles,037,10098052,1184358,1175684,40181,1215865,22834
2021-03-21,Madera,039,155013,16026,15895,880,16775,210
2021-03-21,Marin,041,260295,13581,13495,191,13686,220
2021-03-21,Mariposa,043,17540,391,381,5,386,5
2021-03-21,Mendocino,045,87422,3739,3651,73,3724,45
2021-03-21,Merced,047,269075,29508,29446,980,30426,413
2021-03-21,Modoc,049,8938,351,341,120,461,3
2021-03-21,Mono,051,14174,1218,1263,17,1280,3
2021-03-21,Monterey,053,433212,42418,42153,1759,43912,335
2021-03-21,Napa,055,140530,9308,9282,34,9316,77
2021-03-21,Nevada,057,99092,4235,4169,172,4341,89
2021-03-21,Orange,059,3164182,250332,248442,10623,259065,4598
2021-03-21,Placer,061,380077,21339,20520,1206,21726,242
2021-03-21,Plumas,063,18699,666,653,10,663,4
2021-03-21,Riverside,065,2383286,288835,282187,13655,295842,4009
2021-03-21,Sacramento,067,1510023,97765,96269,1365,97634,1489
2021-03-21,San Benito,069,59416,5841,5842,92,5934,61
2021-03-21,San Bernardino,071,2135413,288634,284732,8717,293449,4094
2021-03-21,San Diego,073,3302833,269324,267724,13330,281054,3494
2021-03-21,San Francisco,075,870044,35017,35012,1176,36188,460
2021-03-21,San Joaquin,077,732212,69077,67729,3046,70775,1182
2021-03-21,San Luis Obispo,079,281455,20308,19979,618,20597,250
2021-03-21,San Mateo,081,765935,40496,39988,428,40416,344
2021-03-21,Santa Barbara,083,443738,33125,32743,1090,33833,437
2021-03-21,Santa Clara,085,1922200,113359,113487,642,114129,1840
2021-03-21,Santa Cruz,087,273765,15738,15064,800,15864,199
2021-03-21,Shasta,089,179085,11197,11215,1327,12542,150
2021-03-21,Sierra,091,2930,55,50,12,62,0
2021-03-21,Siskiyou,093,43540,1560,1486,256,1742,5
2021-03-21,Solano,095,438530,30593,30474,397,30871,171
2021-03-21,Sonoma,097,501317,28873,28986,253,29239,310
2021-03-21,Stanislaus,099,539301,52519,52014,5555,57569,677
2021-03-21,Sutter,101,95872,9039,9021,81,9102,104
2021-03-21,Tehama,103,63373,4737,4701,509,5210,45
2021-03-21,Trinity,105,12862,473,310,84,394,3
2021-03-21,Tulare,107,460477,49140,48060,8523,56583,807
2021-03-21,Tuolumne,109,53932,3887,3953,36,3989,57
2021-03-21,Ventura,111,848112,79527,78863,2859,81722,927
2021-03-21,Yolo,113,214977,13235,13235,242,13477,190
2021-03-21,Yuba,115,75493,5672,5624,95,5719,42
2021-03-20,Alameda,001,1643700,83163,82614,1783,84397,1178
2021-03-20,Alpine,003,1148,84,83,0,83,0
2021-03-20,Amador,005,37829,3537,3518,32,3550,44
2021-03-20,Butte,007,227075,11604,11199,1657,12856,185
2021-03-20,Calaveras,009,45235,1979,1961,12,1973,49
2021-03-20,Colusa,011,21464,1886,1883,273,2156,12
2021-03-20,Contra Costa,013,1133247,65188,64313,1125,65438,713
2021-03-20,Del Norte,015,27424,1135,1075,7,1082,6
2021-03-20,El Dorado,017,186661,9370,9290,600,9890,105
2021-03-20,Fresno,019,978130,99134,98112,8167,106279,1532
2021-03-20,Glenn,021,27897,2324,2288,521,2809,17
2021-03-20,Humboldt,023,135768,3415,3399,24,3423,33
2021-03-20,Imperial,025,180216,27513,27239,2596,29835,695
2021-03-20,Inyo,027,18085,1367,1362,9,1371,35
2021-03-20,Kern,029,883053,95001,93606,10232,103838,1155
2021-03-20,Kings,031,150075,22719,22415,1021,23436,236
2021-03-20,Lake,033,64148,3327,3280,8,3288,43
2021-03-20,Lassen,035,31185,5141,5128,101,5229,1
2021-03-20,Los Angeles,037,10098052,1184056,1175290,40157,1215447,22810
2021-03-20,Madera,039,155013,16018,15891,879,16770,210
2021-03-20,Marin,041,260295,13569,13470,187,13657,220
2021-03-20,Mariposa,043,17540,390,381,5,386,5
2021-03-20,Mendocino,045,87422,3738,3639,73,3712,43
2021-03-20,Merced,047,269075,29477,29411,977,30388,412
2021-03-20,Modoc,049,8938,350,341,120,461,3
2021-03-20,Mono,051,14174,1218,1256,17,1273,3
2021-03-20,Monterey,053,433212,42409,42146,1758,43904,334
2021-03-20,Napa,055,140530,9300,9274,34,9308,77
2021-03-20,Nevada,057,99092,4224,4164,171,4335,89
2021-03-20,Orange,059,3164182,250251,248348,10611,258959,4522
2021-03-20,Placer,061,380077,21316,20505,1204,21709,242
2021-03-20,Plumas,063,18699,663,652,10,662,4
2021-03-20,Riverside,065,2383286,288760,282081,13651,295732,4000
2021-03-20,Sacramento,067,1510023,97654,96126,1362,97488,1488
2021-03-20,San Benito,069,59416,5837,5840,92,5932,61
2021-03-20,San Bernardino,071,2135413,288569,284690,8713,293403,3965
2021-03-20,San Diego,073,3302833,269153,267532,13323,280855,3493
2021-03-20,San Francisco,075,870044,34994,34968,1169,36137,453
2021-03-20,San Joaquin,077,732212,69036,67662,3039,70701,1161
2021-03-20,San Luis Obispo,079,281455,20292,19951,612,20563,250
2021-03-20,San Mateo,081,765935,40462,39958,427,40385,344
2021-03-20,Santa Barbara,083,443738,33100,32723,1089,33812,434
2021-03-20,Santa Clara,085,1922200,113267,113384,641,114025,1799
2021-03-20,Santa Cruz,087,273765,15722,15053,800,15853,199
2021-03-20,Shasta,089,179085,11191,11211,1327,12538,147
2021-03-20,Sierra,091,2930,55,50,12,62,0
2021-03-20,Siskiyou,093,43540,1560,1483,256,1739,5
2021-03-20,Solano,095,438530,30563,30439,397,30836,170
2021-03-20,Sonoma,097,501317,28858,28962,253,29215,309
2021-03-20,Stanislaus,099,539301,52463,51925,5548,57473,673
2021-03-20,Sutter,101,95872,9031,9014,81,9095,103
2021-03-20,Tehama,103,63373,4732,4696,507,5203,33
2021-03-20,Trinity,105,12862,472,310,84,394,3
2021-03-20,Tulare,107,460477,49125,48030,8506,56536,804
2021-03-20,Tuolumne,109,53932,3884,3950,36,3986,57
2021-03-20,Ventura,111,848112,79492,78818,2857,81675,922
2021-03-20,Yolo,113,214977,13231,13226,242,13468,190
2021-03-20,Yuba,115,75493,5669,5621,94,5715,42
2021-03-19,Alameda,001,1643700,83091,82499,1782,84281,1187
2021-03-19,Alpine,003,1148,83,82,0,82,0
2021-03-19,Amador,005,37829,3534,3515,32,3547,44
2021-03-19,Butte,007,227075,11596,11191,1654,12845,185
2021-03-19,Calaveras,009,45235,1978,1957,12,1969,49
2021-03-19,Colusa,011,21464,1885,1883,273,2156,12
2021-03-19,Contra Costa,013,1133247,65129,64195,1122,65317,737
2021-03-19,Del Norte,015,27424,1129,1071,5,1076,6
2021-03-19,El Dorado,017,186661,9361,9274,600,9874,105
2021-03-19,Fresno,019,978130,99050,97969,8153,106122,1527
2021-03-19,Glenn,021,27897,2324,2282,521,2803,17
2021-03-19,Humboldt,023,135768,3406,3388,24,3412,33
2021-03-19,Imperial,025,180216,27501,27218,2592,29810,695
2021-03-19,Inyo,027,18085,1365,1356,9,1365,35
2021-03-19,Kern,029,883053,94968,93534,10219,103753,1152
2021-03-19,Kings,031,150075,22710,22369,1018,23387,235
2021-03-19,Lake,033,64148,3321,3262,8,3270,43
2021-03-19,Lassen,035,31185,5141,5126,101,5227,1
2021-03-19,Los Angeles,037,10098052,1183721,1174818,40140,1214958,22752
2021-03-19,Madera,039,155013,16011,15877,878,16755,210
2021-03-19,Marin,041,260295,13557,13441,187,13628,220
2021-03-19,Mariposa,043,17540,389,380,5,385,5
2021-03-19,Mendocino,045,87422,3737,3639,73,3712,45
2021-03-19,Merced,047,269075,29450,29376,974,30350,412
2021-03-19,Modoc,049,8938,350,341,120,461,3
2021-03-19,Mono,051,14174,1216,1244,17,1261,3
2021-03-19,Monterey,053,433212,42400,42125,1756,43881,335
2021-03-19,Napa,055,140530,9288,9256,34,9290,77
2021-03-19,Nevada,057,99092,4213,4156,171,4327,88
2021-03-19,Orange,059,3164182,250151,248146,10601,258747,4501
2021-03-19,Placer,061,380077,21298,20451,1202,21653,242
2021-03-19,Plumas,063,18699,663,650,10,660,4
2021-03-19,Riverside,065,2383286,288677,281937,13646,295583,3989
2021-03-19,Sacramento,067,1510023,97551,95934,1359,97293,1486
2021-03-19,San Benito,069,59416,5837,5845,92,5937,61
2021-03-19,San Bernardino,071,2135413,288496,284501,8711,293212,4017
2021-03-19,San Diego,073,3302833,269018,267173,13313,280486,3491
2021-03-19,San Francisco,075,870044,34949,34936,1166,36102,461
2021-03-19,San Joaquin,077,732212,68966,67515,3025,70540,1180
2021-03-19,San Luis Obispo,079,281455,20272,19913,610,20523,249
2021-03-19,San Mateo,081,765935,40438,39893,427,40320,344
2021-03-19,Santa Barbara,083,443738,33070,32685,1088,33773,435
2021-03-19,Santa Clara,085,1922200,113192,113232,640,113872,1797
2021-03-19,Santa Cruz,087,273765,15715,15026,800,15826,199
2021-03-19,Shasta,089,179085,11184,11104,1325,12429,103
2021-03-19,Sierra,091,2930,54,49,12,61,0
2021-03-19,Siskiyou,093,43540,1560,1480,255,1735,5
2021-03-19,Solano,095,438530,30533,30395,395,30790,172
2021-03-19,Sonoma,097,501317,28837,28932,251,29183,292
2021-03-19,Stanislaus,099,539301,52405,51755,5545,57300,679
2021-03-19,Sutter,101,95872,9029,9005,81,9086,103
2021-03-19,Tehama,103,63373,4725,4685,507,5192,33
2021-03-19,Trinity,105,12862,472,310,84,394,3
2021-03-19,Tulare,107,460477,49102,47989,8483,56472,805
2021-03-19,Tuolumne,109,53932,3881,3946,36,3982,57
2021-03-19,Ventura,111,848112,79459,78753,2853,81606,920
2021-03-19,Yolo,113,214977,13223,13197,242,13439,189
2021-03-19,Yuba,115,75493,5666,5615,93,5708,42
2021-03-18,Alameda,001,1643700,83011,82419,1779,84198,1189
2021-03-18,Alpine,003,1148,83,82,0,82,0
2021-03-18,Amador,005,37829,3530,3513,32,3545,44
2021-03-18,Butte,007,227075,11585,11179,1652,12831,185
2021-03-18,Calaveras,009,45235,1976,1954,12,1966,49
2021-03-18,Colusa,011,21464,1885,1882,273,2155,12
2021-03-18,Contra Costa,013,1133247,65056,64103,1119,65222,739
2021-03-18,Del Norte,015,27424,1120,1059,5,1064,6
2021-03-18,El Dorado,017,186661,9348,9261,599,9860,105
2021-03-18,Fresno,019,978130,98953,97856,8138,105994,1527
2021-03-18,Glenn,021,27897,2320,2275,520,2795,17
2021-03-18,Humboldt,023,135768,3398,3381,24,3405,34
2021-03-18,Imperial,025,180216,27486,27190,2587,29777,695
2021-03-18,Inyo,027,18085,1362,1354,9,1363,35
2021-03-18,Kern,029,883053,94911,93458,10205,103663,1158
2021-03-18,Kings,031,150075,22703,22354,1017,23371,235
2021-03-18,Lake,033,64148,3318,3260,8,3268,43
2021-03-18,Lassen,035,31185,5140,5126,101,5227,1
2021-03-18,Los Angeles,037,10098052,1183288,1174205,40111,1214316,22689
2021-03-18,Madera,039,155013,15999,15860,875,16735,211
2021-03-18,Marin,041,260295,13539,13435,186,13621,219
2021-03-18,Mariposa,043,17540,387,380,5,385,5
2021-03-18,Mendocino,045,87422,3727,3630,73,3703,45
2021-03-18,Merced,047,269075,29415,29317,974,30291,410
2021-03-18,Modoc,049,8938,350,341,120,461,3
2021-03-18,Mono,051,14174,1212,1215,16,1231,3
2021-03-18,Monterey,053,433212,42388,42105,1756,43861,335
2021-03-18,Napa,055,140530,9279,9243,34,9277,77
2021-03-18,Nevada,057,99092,4206,4154,171,4325,74
2021-03-18,Orange,059,3164182,250048,248050,10588,258638,4514
2021-03-18,Placer,061,380077,21266,20421,1199,21620,243
2021-03-18,Plumas,063,18699,661,648,10,658,4
2021-03-18,Riverside,065,2383286,288596,281789,13639,295428,3957
2021-03-18,Sacramento,067,1510023,97403,95819,1355,97174,1481
2021-03-18,San Benito,069,59416,5835,5842,92,5934,61
2021-03-18,San Bernardino,071,2135413,288415,284294,8681,292975,4076
2021-03-18,San Diego,073,3302833,268866,266752,13303,280055,3478
2021-03-18,San Francisco,075,870044,34910,34904,1165,36069,461
2021-03-18,San Joaquin,077,732212,68866,67301,3013,70314,1169
2021-03-18,San Luis Obispo,079,281455,20243,19894,609,20503,249
2021-03-18,San Mateo,081,765935,40397,39874,427,40301,344
2021-03-18,Santa Barbara,083,443738,33029,32640,1088,33728,434
2021-03-18,Santa Clara,085,1922200,113075,113119,636,113755,1808
2021-03-18,Santa Cruz,087,273765,15705,14998,800,15798,198
2021-03-18,Shasta,089,179085,11170,11059,1323,12382,100
2021-03-18,Sierra,091,2930,54,49,12,61,0
2021-03-18,Siskiyou,093,43540,1557,1480,254,1734,5
2021-03-18,Solano,095,438530,30491,30352,392,30744,172
2021-03-18,Sonoma,097,501317,28816,28915,249,29164,292
2021-03-18,Stanislaus,099,539301,52334,51615,5541,57156,682
2021-03-18,Sutter,101,95872,9017,8999,81,9080,103
2021-03-18,Tehama,103,63373,4719,4683,506,5189,35
2021-03-18,Trinity,105,12862,472,310,84,394,3
2021-03-18,Tulare,107,460477,49083,47964,8468,56432,805
2021-03-18,Tuolumne,109,53932,3880,3942,36,3978,57
2021-03-18,Ventura,111,848112,79399,78697,2853,81550,918
2021-03-18,Yolo,113,214977,13210,13183,242,13425,191
2021-03-18,Yuba,115,75493,5662,5612,93,5705,42
2021-03-17,Alameda,001,1643700,82935,82353,1774,84127,1185
2021-03-17,Alpine,003,1148,83,82,0,82,0
2021-03-17,Amador,005,37829,3528,3511,32,3543,44
2021-03-17,Butte,007,227075,11576,11170,1650,12820,185
2021-03-17,Calaveras,009,45235,1973,1946,12,1958,49
2021-03-17,Colusa,011,21464,1884,1882,273,2155,12
2021-03-17,Contra Costa,013,1133247,64987,64026,1118,65144,737
2021-03-17,Del Norte,015,27424,1116,1053,5,1058,6
2021-03-17,El Dorado,017,186661,9338,9252,599,9851,105
2021-03-17,Fresno,019,978130,98842,97727,8120,105847,1507
2021-03-17,Glenn,021,27897,2313,2269,519,2788,17
2021-03-17,Humboldt,023,135768,3390,3365,24,3389,33
2021-03-17,Imperial,025,180216,27469,27168,2584,29752,691
2021-03-17,Inyo,027,18085,1360,1351,9,1360,35
2021-03-17,Kern,029,883053,94855,93392,10192,103584,1149
2021-03-17,Kings,031,150075,22687,22336,1016,23352,233
2021-03-17,Lake,033,64148,3311,3251,8,3259,43
2021-03-17,Lassen,035,31185,5139,5125,101,5226,1
2021-03-17,Los Angeles,037,10098052,1182835,1173416,40078,1213494,22602
2021-03-17,Madera,039,155013,15992,15835,875,16710,214
2021-03-17,Marin,041,260295,13522,13428,185,13613,218
2021-03-17,Mariposa,043,17540,387,379,5,384,5
2021-03-17,Mendocino,045,87422,3723,3625,73,3698,44
2021-03-17,Merced,047,269075,29387,29250,970,30220,408
2021-03-17,Modoc,049,8938,350,341,120,461,3
2021-03-17,Mono,051,14174,1210,1212,16,1228,3
2021-03-17,Monterey,053,433212,42370,42061,1753,43814,334
2021-03-17,Napa,055,140530,9264,9219,34,9253,76
2021-03-17,Nevada,057,99092,4196,4145,171,4316,74
2021-03-17,Orange,059,3164182,249929,247943,10560,258503,4502
2021-03-17,Placer,061,380077,21239,20369,1197,21566,243
2021-03-17,Plumas,063,18699,660,645,10,655,4
2021-03-17,Riverside,065,2383286,288480,281649,13631,295280,3925
2021-03-17,Sacramento,067,1510023,97275,95650,1350,97000,1477
2021-03-17,San Benito,069,59416,5832,5841,92,5933,61
2021-03-17,San Bernardino,071,2135413,288298,284170,8676,292846,4049
2021-03-17,San Diego,073,3302833,268655,266313,13285,279598,3470
2021-03-17,San Francisco,075,870044,34875,34873,1164,36037,457
2021-03-17,San Joaquin,077,732212,68781,67093,2997,70090,1164
2021-03-17,San Luis Obispo,079,281455,20220,19858,605,20463,249
2021-03-17,San Mateo,081,765935,40367,39838,426,40264,344
2021-03-17,Santa Barbara,083,443738,33007,32585,1087,33672,433
2021-03-17,Santa Clara,085,1922200,112982,112983,635,113618,1805
2021-03-17,Santa Cruz,087,273765,15697,14967,800,15767,199
2021-03-17,Shasta,089,179085,11165,11045,1320,12365,100
2021-03-17,Sierra,091,2930,54,49,12,61,0
2021-03-17,Siskiyou,093,43540,1556,1479,252,1731,5
2021-03-17,Solano,095,438530,30465,30320,390,30710,171
2021-03-17,Sonoma,097,501317,28792,28877,248,29125,292
2021-03-17,Stanislaus,099,539301,52259,51524,5534,57058,682
2021-03-17,Sutter,101,95872,9007,8982,81,9063,103
2021-03-17,Tehama,103,63373,4714,4670,506,5176,34
2021-03-17,Trinity,105,12862,472,308,84,392,3
2021-03-17,Tulare,107,460477,49063,47929,8458,56387,805
2021-03-17,Tuolumne,109,53932,3877,3938,36,3974,57
2021-03-17,Ventura,111,848112,79343,78648,2850,81498,916
2021-03-17,Yolo,113,214977,13193,13169,242,13411,190
2021-03-17,Yuba,115,75493,5659,5603,93,5696,42
2021-03-16,Alameda,001,1643700,82823,82259,1772,84031,1177
2021-03-16,Alpine,003,1148,83,82,0,82,0
2021-03-16,Amador,005,37829,3526,3510,32,3542,44
2021-03-16,Butte,007,227075,11564,11154,1649,12803,184
2021-03-16,Calaveras,009,45235,1968,1945,12,1957,49
2021-03-16,Colusa,011,21464,1883,1882,273,2155,12
2021-03-16,Contra Costa,013,1133247,64904,63951,1115,65066,736
2021-03-16,Del Norte,015,27424,1108,1048,5,1053,6
2021-03-16,El Dorado,017,186661,9323,9249,599,9848,105
2021-03-16,Fresno,019,978130,98704,97638,8098,105736,1498
2021-03-16,Glenn,021,27897,2305,2267,515,2782,17
2021-03-16,Humboldt,023,135768,3386,3351,24,3375,33
2021-03-16,Imperial,025,180216,27458,27143,2581,29724,689
2021-03-16,Inyo,027,18085,1359,1346,9,1355,35
2021-03-16,Kern,029,883053,94789,93340,10177,103517,1144
2021-03-16,Kings,031,150075,22651,22320,1015,23335,233
2021-03-16,Lake,033,64148,3303,3246,8,3254,43
2021-03-16,Lassen,035,31185,5138,5126,101,5227,1
2021-03-16,Los Angeles,037,10098052,1182302,1172676,40040,1212716,22527
2021-03-16,Madera,039,155013,15976,15822,873,16695,214
2021-03-16,Marin,041,260295,13504,13419,185,13604,218
2021-03-16,Mariposa,043,17540,384,379,5,384,5
2021-03-16,Mendocino,045,87422,3718,3623,73,3696,44
2021-03-16,Merced,047,269075,29334,29198,969,30167,407
2021-03-16,Modoc,049,8938,350,341,120,461,3
2021-03-16,Mono,051,14174,1209,1207,16,1223,3
2021-03-16,Monterey,053,433212,42351,42023,1753,43776,334
2021-03-16,Napa,055,140530,9254,9209,34,9243,75
2021-03-16,Nevada,057,99092,4187,4132,170,4302,67
2021-03-16,Orange,059,3164182,249790,247843,10541,258384,4479
2021-03-16,Placer,061,380077,21206,20339,1193,21532,240
2021-03-16,Plumas,063,18699,659,643,10,653,4
2021-03-16,Riverside,065,2383286,288366,281540,13618,295158,3893
2021-03-16,Sacramento,067,1510023,97132,95522,1346,96868,1466
2021-03-16,San Benito,069,59416,5827,5831,92,5923,61
2021-03-16,San Bernardino,071,2135413,288168,283980,8669,292649,4032
2021-03-16,San Diego,073,3302833,268423,265903,13272,279175,3462
2021-03-16,San Francisco,075,870044,34846,34833,1159,35992,456
2021-03-16,San Joaquin,077,732212,68679,66856,2984,69840,1163
2021-03-16,San Luis Obispo,079,281455,20190,19832,603,20435,248
2021-03-16,San Mateo,081,765935,40333,39806,424,40230,344
2021-03-16,Santa Barbara,083,443738,32975,32556,1086,33642,433
2021-03-16,Santa Clara,085,1922200,112864,112845,632,113477,1797
2021-03-16,Santa Cruz,087,273765,15691,14926,800,15726,199
2021-03-16,Shasta,089,179085,11149,11035,1317,12352,100
2021-03-16,Sierra,091,2930,53,49,12,61,0
2021-03-16,Siskiyou,093,43540,1553,1477,252,1729,5
2021-03-16,Solano,095,438530,30431,30298,388,30686,171
2021-03-16,Sonoma,097,501317,28759,28850,246,29096,291
2021-03-16,Stanislaus,099,539301,52179,51410,5527,56937,683
2021-03-16,Sutter,101,95872,8999,8970,81,9051,102
2021-03-16,Tehama,103,63373,4711,4660,505,5165,34
2021-03-16,Trinity,105,12862,472,308,83,391,3
2021-03-16,Tulare,107,460477,49015,47895,8450,56345,803
2021-03-16,Tuolumne,109,53932,3874,3938,36,3974,57
2021-03-16,Ventura,111,848112,79277,78671,2843,81514,916
2021-03-16,Yolo,113,214977,13178,13162,242,13404,190
2021-03-16,Yuba,115,75493,5656,5596,92,5688,42
2021-03-15,Alameda,001,1643700,82734,82159,1772,83931,1167
2021-03-15,Alpine,003,1148,83,82,0,82,0
2021-03-15,Amador,005,37829,3525,3506,32,3538,44
2021-03-15,Butte,007,227075,11551,11141,1645,12786,185
2021-03-15,Calaveras,009,45235,1967,1941,12,1953,49
2021-03-15,Colusa,011,21464,1883,1883,273,2156,12
2021-03-15,Contra Costa,013,1133247,64842,63847,1114,64961,732
2021-03-15,Del Norte,015,27424,1105,1048,5,1053,6
2021-03-15,El Dorado,017,186661,9317,9235,598,9833,103
2021-03-15,Fresno,019,978130,98577,97520,8083,105603,1496
2021-03-15,Glenn,021,27897,2300,2261,512,2773,15
2021-03-15,Humboldt,023,135768,3380,3337,24,3361,32
2021-03-15,Imperial,025,180216,27438,27122,2578,29700,684
2021-03-15,Inyo,027,18085,1359,1346,9,1355,35
2021-03-15,Kern,029,883053,94729,93266,10170,103436,1141
2021-03-15,Kings,031,150075,22634,22294,1009,23303,233
2021-03-15,Lake,033,64148,3291,3237,8,3245,43
2021-03-15,Lassen,035,31185,5138,5125,101,5226,1
2021-03-15,Los Angeles,037,10098052,1181733,1172445,40005,1212450,22477
2021-03-15,Madera,039,155013,15965,15806,871,16677,214
2021-03-15,Marin,041,260295,13498,13408,184,13592,218
2021-03-15,Mariposa,043,17540,384,376,5,381,5
2021-03-15,Mendocino,045,87422,3714,3615,73,3688,44
2021-03-15,Merced,047,269075,29296,29169,967,30136,407
2021-03-15,Modoc,049,8938,350,340,120,460,3
2021-03-15,Mono,051,14174,1208,1206,16,1222,3
2021-03-15,Monterey,053,433212,42323,42011,1750,43761,333
2021-03-15,Napa,055,140530,9243,9196,34,9230,75
2021-03-15,Nevada,057,99092,4182,4123,169,4292,66
2021-03-15,Orange,059,3164182,249677,247697,10520,258217,4481
2021-03-15,Placer,061,380077,21183,20308,1193,21501,238
2021-03-15,Plumas,063,18699,659,642,10,652,4
2021-03-15,Riverside,065,2383286,288214,281367,13608,294975,3856
2021-03-15,Sacramento,067,1510023,96979,95414,1340,96754,1463
2021-03-15,San Benito,069,59416,5824,5831,92,5923,61
2021-03-15,San Bernardino,071,2135413,288076,283815,8661,292476,4004
2021-03-15,San Diego,073,3302833,268174,265646,13256,278902,3452
2021-03-15,San Francisco,075,870044,34811,34820,1155,35975,456
2021-03-15,San Joaquin,077,732212,68575,66622,2971,69593,1140
2021-03-15,San Luis Obispo,079,281455,20159,19813,599,20412,247
2021-03-15,San Mateo,081,765935,40279,39765,424,40189,344
2021-03-15,Santa Barbara,083,443738,32952,32529,1083,33612,431
2021-03-15,Santa Clara,085,1922200,112763,112729,630,113359,1798
2021-03-15,Santa Cruz,087,273765,15685,14899,798,15697,200
2021-03-15,Shasta,089,179085,11133,11019,1312,12331,92
2021-03-15,Sierra,091,2930,53,49,12,61,0
2021-03-15,Siskiyou,093,43540,1553,1475,252,1727,5
2021-03-15,Solano,095,438530,30402,30258,387,30645,171
2021-03-15,Sonoma,097,501317,28741,28814,243,29057,285
2021-03-15,Stanislaus,099,539301,52101,51357,5520,56877,683
2021-03-15,Sutter,101,95872,8993,8962,81,9043,102
2021-03-15,Tehama,103,63373,4696,4650,504,5154,34
2021-03-15,Trinity,105,12862,472,308,83,391,3
2021-03-15,Tulare,107,460477,48985,47857,8435,56292,800
2021-03-15,Tuolumne,109,53932,3872,3937,35,3972,57
2021-03-15,Ventura,111,848112,79221,78626,2842,81468,910
2021-03-15,Yolo,113,214977,13159,13131,240,13371,190
2021-03-15,Yuba,115,75493,5651,5585,91,5676,42
2021-03-14,Alameda,001,1643700,82650,82116,1769,83885,1168
2021-03-14,Alpine,003,1148,83,82,0,82,0
2021-03-14,Amador,005,37829,3520,3504,32,3536,44
2021-03-14,Butte,007,227075,11538,11140,1641,12781,185
2021-03-14,Calaveras,009,45235,1963,1939,12,1951,49
2021-03-14,Colusa,011,21464,1883,1883,273,2156,12
2021-03-14,Contra Costa,013,1133247,64737,63808,1113,64921,731
2021-03-14,Del Norte,015,27424,1091,1048,5,1053,6
2021-03-14,El Dorado,017,186661,9307,9231,598,9829,103
2021-03-14,Fresno,019,978130,98469,97461,8065,105526,1496
2021-03-14,Glenn,021,27897,2295,2260,509,2769,15
2021-03-14,Humboldt,023,135768,3366,3335,24,3359,32
2021-03-14,Imperial,025,180216,27423,27122,2573,29695,685
2021-03-14,Inyo,027,18085,1355,1346,9,1355,35
2021-03-14,Kern,029,883053,94646,93252,10152,103404,1141
2021-03-14,Kings,031,150075,22615,22292,1007,23299,232
2021-03-14,Lake,033,64148,3286,3237,8,3245,43
2021-03-14,Lassen,035,31185,5136,5125,101,5226,1
2021-03-14,Los Angeles,037,10098052,1181164,1172100,39969,1212069,22476
2021-03-14,Madera,039,155013,15940,15804,871,16675,214
2021-03-14,Marin,041,260295,13482,13405,182,13587,218
2021-03-14,Mariposa,043,17540,382,376,5,381,5
2021-03-14,Mendocino,045,87422,3709,3613,73,3686,44
2021-03-14,Merced,047,269075,29228,29149,963,30112,407
2021-03-14,Modoc,049,8938,350,340,120,460,3
2021-03-14,Mono,051,14174,1202,1206,16,1222,3
2021-03-14,Monterey,053,433212,42299,42007,1746,43753,333
2021-03-14,Napa,055,140530,9225,9194,34,9228,75
2021-03-14,Nevada,057,99092,4176,4122,167,4289,66
2021-03-14,Orange,059,3164182,249544,247656,10500,258156,4460
2021-03-14,Placer,061,380077,21148,20288,1185,21473,238
2021-03-14,Plumas,063,18699,657,642,10,652,4
2021-03-14,Riverside,065,2383286,288056,281332,13600,294932,3845
2021-03-14,Sacramento,067,1510023,96801,95343,1335,96678,1462
2021-03-14,San Benito,069,59416,5815,5829,92,5921,61
2021-03-14,San Bernardino,071,2135413,287952,283791,8650,292441,3996
2021-03-14,San Diego,073,3302833,267939,265468,13243,278711,3452
2021-03-14,San Francisco,075,870044,34772,34810,1152,35962,455
2021-03-14,San Joaquin,077,732212,68447,66563,2954,69517,1140
2021-03-14,San Luis Obispo,079,281455,20130,19806,597,20403,247
2021-03-14,San Mateo,081,765935,40240,39744,424,40168,342
2021-03-14,Santa Barbara,083,443738,32908,32514,1081,33595,431
2021-03-14,Santa Clara,085,1922200,112635,112648,629,113277,1796
2021-03-14,Santa Cruz,087,273765,15668,14887,796,15683,200
2021-03-14,Shasta,089,179085,11117,11019,1305,12324,92
2021-03-14,Sierra,091,2930,53,49,12,61,0
2021-03-14,Siskiyou,093,43540,1550,1473,252,1725,5
2021-03-14,Solano,095,438530,30370,30230,382,30612,171
2021-03-14,Sonoma,097,501317,28706,28798,239,29037,284
2021-03-14,Stanislaus,099,539301,51981,51306,5512,56818,690
2021-03-14,Sutter,101,95872,8977,8958,81,9039,102
2021-03-14,Tehama,103,63373,4689,4650,503,5153,34
2021-03-14,Trinity,105,12862,471,308,82,390,3
2021-03-14,Tulare,107,460477,48952,47845,8414,56259,800
2021-03-14,Tuolumne,109,53932,3870,3937,35,3972,57
2021-03-14,Ventura,111,848112,79173,78611,2836,81447,910
2021-03-14,Yolo,113,214977,13137,13128,236,13364,189
2021-03-14,Yuba,115,75493,5641,5583,91,5674,42
2021-03-13,Alameda,001,1643700,82590,82010,1769,83779,1168
2021-03-13,Alpine,003,1148,83,82,0,82,0
2021-03-13,Amador,005,37829,3517,3504,32,3536,44
2021-03-13,Butte,007,227075,11529,11131,1640,12771,185
2021-03-13,Calaveras,009,45235,1962,1939,12,1951,49
2021-03-13,Colusa,011,21464,1883,1882,273,2155,12
2021-03-13,Contra Costa,013,1133247,64676,63689,1113,64802,731
2021-03-13,Del Norte,015,27424,1087,1041,5,1046,6
2021-03-13,El Dorado,017,186661,9299,9221,598,9819,103
2021-03-13,Fresno,019,978130,98410,97324,8045,105369,1495
2021-03-13,Glenn,021,27897,2294,2260,508,2768,15
2021-03-13,Humboldt,023,135768,3359,3325,24,3349,32
2021-03-13,Imperial,025,180216,27417,27099,2569,29668,677
2021-03-13,Inyo,027,18085,1354,1344,9,1353,35
2021-03-13,Kern,029,883053,94607,93197,10146,103343,1140
2021-03-13,Kings,031,150075,22599,22265,1006,23271,232
2021-03-13,Lake,033,64148,3279,3234,7,3241,43
2021-03-13,Lassen,035,31185,5136,5125,101,5226,1
2021-03-13,Los Angeles,037,10098052,1180848,1171505,39925,1211430,22451
2021-03-13,Madera,039,155013,15928,15780,871,16651,214
2021-03-13,Marin,041,260295,13476,13391,180,13571,218
2021-03-13,Mariposa,043,17540,381,376,5,381,5
2021-03-13,Mendocino,045,87422,3705,3611,73,3684,44
2021-03-13,Merced,047,269075,29197,29106,963,30069,406
2021-03-13,Modoc,049,8938,350,340,119,459,3
2021-03-13,Mono,051,14174,1202,1207,16,1223,3
2021-03-13,Monterey,053,433212,42289,41989,1744,43733,332
2021-03-13,Napa,055,140530,9219,9190,34,9224,75
2021-03-13,Nevada,057,99092,4169,4111,166,4277,66
2021-03-13,Orange,059,3164182,249463,247514,10484,257998,4423
2021-03-13,Placer,061,380077,21127,20238,1182,21420,239
2021-03-13,Plumas,063,18699,655,642,10,652,4
2021-03-13,Riverside,065,2383286,287964,281191,13592,294783,3848
2021-03-13,Sacramento,067,1510023,96715,95192,1333,96525,1461
2021-03-13,San Benito,069,59416,5812,5823,92,5915,61
2021-03-13,San Bernardino,071,2135413,287897,283727,8644,292371,3972
2021-03-13,San Diego,073,3302833,267784,265270,13229,278499,3444
2021-03-13,San Francisco,075,870044,34755,34784,1143,35927,455
2021-03-13,San Joaquin,077,732212,68391,66480,2932,69412,1141
2021-03-13,San Luis Obispo,079,281455,20112,19789,596,20385,247
2021-03-13,San Mateo,081,765935,40213,39689,423,40112,341
2021-03-13,Santa Barbara,083,443738,32883,32486,1080,33566,431
2021-03-13,Santa Clara,085,1922200,112550,112531,628,113159,1790
2021-03-13,Santa Cruz,087,273765,15661,14875,796,15671,199
2021-03-13,Shasta,089,179085,11109,11021,1302,12323,108
2021-03-13,Sierra,091,2930,52,49,12,61,0
2021-03-13,Siskiyou,093,43540,1548,1470,252,1722,5
2021-03-13,Solano,095,438530,30353,30198,382,30580,171
2021-03-13,Sonoma,097,501317,28686,28762,235,28997,285
2021-03-13,Stanislaus,099,539301,51930,51257,5507,56764,695
2021-03-13,Sutter,101,95872,8970,8948,81,9029,102
2021-03-13,Tehama,103,63373,4687,4647,503,5150,33
2021-03-13,Trinity,105,12862,471,306,82,388,3
2021-03-13,Tulare,107,460477,48926,47818,8406,56224,798
2021-03-13,Tuolumne,109,53932,3867,3937,35,3972,57
2021-03-13,Ventura,111,848112,79121,78693,2836,81529,906
2021-03-13,Yolo,113,214977,13129,13087,235,13322,189
2021-03-13,Yuba,115,75493,5640,5577,91,5668,42
2021-03-12,Alameda,001,1643700,82513,81898,1768,83666,1164
2021-03-12,Alpine,003,1148,83,82,0,82,0
2021-03-12,Amador,005,37829,3514,3503,32,3535,44
2021-03-12,Butte,007,227075,11519,11126,1638,12764,184
2021-03-12,Calaveras,009,45235,1962,1916,12,1928,49
2021-03-12,Colusa,011,21464,1883,1883,273,2156,12
2021-03-12,Contra Costa,013,1133247,64600,63583,1113,64696,728
2021-03-12,Del Norte,015,27424,1081,1033,5,1038,6
2021-03-12,El Dorado,017,186661,9290,9219,598,9817,103
2021-03-12,Fresno,019,978130,98313,97185,8034,105219,1489
2021-03-12,Glenn,021,27897,2293,2258,507,2765,15
2021-03-12,Humboldt,023,135768,3354,3315,24,3339,32
2021-03-12,Imperial,025,180216,27406,27071,2567,29638,677
2021-03-12,Inyo,027,18085,1352,1339,9,1348,35
2021-03-12,Kern,029,883053,94573,93142,10130,103272,1132
2021-03-12,Kings,031,150075,22580,22233,1006,23239,232
2021-03-12,Lake,033,64148,3273,3226,6,3232,43
2021-03-12,Lassen,035,31185,5136,5125,100,5225,1
2021-03-12,Los Angeles,037,10098052,1180449,1170860,39908,1210768,22409
2021-03-12,Madera,039,155013,15916,15761,868,16629,214
2021-03-12,Marin,041,260295,13469,13375,180,13555,218
2021-03-12,Mariposa,043,17540,379,376,5,381,5
2021-03-12,Mendocino,045,87422,3702,3605,73,3678,43
2021-03-12,Merced,047,269075,29166,29064,963,30027,403
2021-03-12,Modoc,049,8938,350,340,119,459,3
2021-03-12,Mono,051,14174,1201,1206,16,1222,3
2021-03-12,Monterey,053,433212,42275,41964,1739,43703,329
2021-03-12,Napa,055,140530,9210,9180,34,9214,75
2021-03-12,Nevada,057,99092,4159,4101,166,4267,66
2021-03-12,Orange,059,3164182,249370,247388,10473,257861,4401
2021-03-12,Placer,061,380077,21094,20210,1177,21387,239
2021-03-12,Plumas,063,18699,654,641,10,651,4
2021-03-12,Riverside,065,2383286,287865,281037,13584,294621,3854
2021-03-12,Sacramento,067,1510023,96591,95061,1326,96387,1460
2021-03-12,San Benito,069,59416,5809,5817,92,5909,61
2021-03-12,San Bernardino,071,2135413,287840,283558,8639,292197,3917
2021-03-12,San Diego,073,3302833,267621,264886,13221,278107,3434
2021-03-12,San Francisco,075,870044,34734,34758,1140,35898,452
2021-03-12,San Joaquin,077,732212,68320,66482,2923,69405,1144
2021-03-12,San Luis Obispo,079,281455,20098,19769,594,20363,247
2021-03-12,San Mateo,081,765935,40177,39638,421,40059,341
2021-03-12,Santa Barbara,083,443738,32860,32457,1077,33534,429
2021-03-12,Santa Clara,085,1922200,112455,112396,627,113023,1766
2021-03-12,Santa Cruz,087,273765,15649,14846,794,15640,195
2021-03-12,Shasta,089,179085,11100,11143,1300,12443,153
2021-03-12,Sierra,091,2930,52,49,12,61,0
2021-03-12,Siskiyou,093,43540,1548,1468,251,1719,5
2021-03-12,Solano,095,438530,30334,30180,381,30561,171
2021-03-12,Sonoma,097,501317,28659,28714,235,28949,285
2021-03-12,Stanislaus,099,539301,51872,51146,5500,56646,701
2021-03-12,Sutter,101,95872,8964,8940,81,9021,101
2021-03-12,Tehama,103,63373,4683,4638,502,5140,33
2021-03-12,Trinity,105,12862,470,306,81,387,3
2021-03-12,Tulare,107,460477,48901,47772,8400,56172,798
2021-03-12,Tuolumne,109,53932,3866,3936,35,3971,57
2021-03-12,Ventura,111,848112,79075,78698,2832,81530,899
2021-03-12,Yolo,113,214977,13119,13061,228,13289,189
2021-03-12,Yuba,115,75493,5633,5563,90,5653,42
2021-03-11,Alameda,001,1643700,82421,81809,1763,83572,1164
2021-03-11,Alpine,003,1148,83,78,0,78,0
2021-03-11,Amador,005,37829,3513,3498,32,3530,42
2021-03-11,Butte,007,227075,11508,11110,1636,12746,185
2021-03-11,Calaveras,009,45235,1959,1915,12,1927,49
2021-03-11,Colusa,011,21464,1883,1883,273,2156,12
2021-03-11,Contra Costa,013,1133247,64527,63469,1111,64580,728
2021-03-11,Del Norte,015,27424,1076,1027,5,1032,6
2021-03-11,El Dorado,017,186661,9276,9211,598,9809,101
2021-03-11,Fresno,019,978130,98197,97026,8005,105031,1481
2021-03-11,Glenn,021,27897,2290,2255,507,2762,15
2021-03-11,Humboldt,023,135768,3337,3302,24,3326,32
2021-03-11,Imperial,025,180216,27399,27045,2563,29608,675
2021-03-11,Inyo,027,18085,1347,1335,9,1344,35
2021-03-11,Kern,029,883053,94517,93052,10091,103143,1121
2021-03-11,Kings,031,150075,22565,22183,1003,23186,230
2021-03-11,Lake,033,64148,3269,3214,6,3220,42
2021-03-11,Lassen,035,31185,5135,5124,100,5224,1
2021-03-11,Los Angeles,037,10098052,1179917,1170111,39876,1209987,22316
2021-03-11,Madera,039,155013,15905,15725,866,16591,214
2021-03-11,Marin,041,260295,13457,13356,179,13535,217
2021-03-11,Mariposa,043,17540,379,376,5,381,5
2021-03-11,Mendocino,045,87422,3695,3604,73,3677,42
2021-03-11,Merced,047,269075,29118,29001,962,29963,401
2021-03-11,Modoc,049,8938,350,340,119,459,3
2021-03-11,Mono,051,14174,1200,1206,16,1222,3
2021-03-11,Monterey,053,433212,42252,41936,1733,43669,329
2021-03-11,Napa,055,140530,9197,9173,34,9207,75
2021-03-11,Nevada,057,99092,4147,4085,164,4249,66
2021-03-11,Orange,059,3164182,249232,247217,10455,257672,4373
2021-03-11,Placer,061,380077,21052,20178,1173,21351,239
2021-03-11,Plumas,063,18699,653,640,10,650,4
2021-03-11,Riverside,065,2383286,287695,280881,13571,294452,3842
2021-03-11,Sacramento,067,1510023,96450,94912,1323,96235,1455
2021-03-11,San Benito,069,59416,5806,5816,92,5908,61
2021-03-11,San Bernardino,071,2135413,287742,283312,8633,291945,3869
2021-03-11,San Diego,073,3302833,267457,264524,13205,277729,3422
2021-03-11,San Francisco,075,870044,34698,34722,1134,35856,452
2021-03-11,San Joaquin,077,732212,68208,66522,2915,69437,1157
2021-03-11,San Luis Obispo,079,281455,20073,19748,593,20341,247
2021-03-11,San Mateo,081,765935,40140,39590,420,40010,341
2021-03-11,Santa Barbara,083,443738,32832,32408,1072,33480,430
2021-03-11,Santa Clara,085,1922200,112326,112246,624,112870,1765
2021-03-11,Santa Cruz,087,273765,15637,14812,793,15605,193
2021-03-11,Shasta,089,179085,11090,11139,1295,12434,158
2021-03-11,Sierra,091,2930,52,48,12,60,0
2021-03-11,Siskiyou,093,43540,1545,1466,250,1716,5
2021-03-11,Solano,095,438530,30306,30138,380,30518,171
2021-03-11,Sonoma,097,501317,28630,28677,235,28912,285
2021-03-11,Stanislaus,099,539301,51787,51038,5492,56530,707
2021-03-11,Sutter,101,95872,8958,8933,81,9014,101
2021-03-11,Tehama,103,63373,4675,4632,502,5134,33
2021-03-11,Trinity,105,12862,469,304,80,384,3
2021-03-11,Tulare,107,460477,48864,47709,8389,56098,797
2021-03-11,Tuolumne,109,53932,3864,3934,35,3969,57
2021-03-11,Ventura,111,848112,79025,78697,2828,81525,889
2021-03-11,Yolo,113,214977,13102,13041,226,13267,190
2021-03-11,Yuba,115,75493,5629,5553,90,5643,42
2021-03-10,Alameda,001,1643700,82314,81701,1758,83459,1160
2021-03-10,Alpine,003,1148,82,78,0,78,0
2021-03-10,Amador,005,37829,3511,3496,32,3528,42
2021-03-10,Butte,007,227075,11498,11096,1636,12732,185
2021-03-10,Calaveras,009,45235,1953,1913,12,1925,48
2021-03-10,Colusa,011,21464,1883,1882,273,2155,12
2021-03-10,Contra Costa,013,1133247,64428,63372,1107,64479,725
2021-03-10,Del Norte,015,27424,1074,1020,5,1025,5
2021-03-10,El Dorado,017,186661,9263,9203,598,9801,100
2021-03-10,Fresno,019,978130,98090,96866,7989,104855,1471
2021-03-10,Glenn,021,27897,2287,2253,505,2758,15
2021-03-10,Humboldt,023,135768,3327,3296,23,3319,32
2021-03-10,Imperial,025,180216,27384,27051,2563,29614,675
2021-03-10,Inyo,027,18085,1347,1328,9,1337,35
2021-03-10,Kern,029,883053,94451,92965,10070,103035,1102
2021-03-10,Kings,031,150075,22546,22166,1001,23167,226
2021-03-10,Lake,033,64148,3259,3207,6,3213,42
2021-03-10,Lassen,035,31185,5135,5120,100,5220,1
2021-03-10,Los Angeles,037,10098052,1179370,1169079,39849,1208928,22199
2021-03-10,Madera,039,155013,15884,15705,863,16568,212
2021-03-10,Marin,041,260295,13447,13348,178,13526,216
2021-03-10,Mariposa,043,17540,379,376,5,381,5
2021-03-10,Mendocino,045,87422,3690,3602,73,3675,42
2021-03-10,Merced,047,269075,29080,28927,959,29886,401
2021-03-10,Modoc,049,8938,349,338,119,457,3
2021-03-10,Mono,051,14174,1196,1204,16,1220,3
2021-03-10,Monterey,053,433212,42230,41920,1729,43649,329
2021-03-10,Napa,055,140530,9188,9165,34,9199,75
2021-03-10,Nevada,057,99092,4143,4074,164,4238,66
2021-03-10,Orange,059,3164182,249084,247075,10440,257515,4342
2021-03-10,Placer,061,380077,21018,20144,1167,21311,239
2021-03-10,Plumas,063,18699,652,639,10,649,4
2021-03-10,Riverside,065,2383286,287554,280708,13557,294265,3822
2021-03-10,Sacramento,067,1510023,96320,94796,1317,96113,1452
2021-03-10,San Benito,069,59416,5797,5811,92,5903,61
2021-03-10,San Bernardino,071,2135413,287650,283140,8627,291767,3841
2021-03-10,San Diego,073,3302833,267235,264094,13193,277287,3413
2021-03-10,San Francisco,075,870044,34663,34688,1126,35814,450
2021-03-10,San Joaquin,077,732212,68106,66483,2898,69381,1156
2021-03-10,San Luis Obispo,079,281455,20049,19710,589,20299,247
2021-03-10,San Mateo,081,765935,40116,39571,420,39991,338
2021-03-10,Santa Barbara,083,443738,32805,32356,1069,33425,429
2021-03-10,Santa Clara,085,1922200,112217,112103,620,112723,1759
2021-03-10,Santa Cruz,087,273765,15622,14790,792,15582,192
2021-03-10,Shasta,089,179085,11080,11125,1292,12417,155
2021-03-10,Sierra,091,2930,52,48,12,60,0
2021-03-10,Siskiyou,093,43540,1543,1458,250,1708,5
2021-03-10,Solano,095,438530,30276,30111,379,30490,170
2021-03-10,Sonoma,097,501317,28595,28638,234,28872,286
2021-03-10,Stanislaus,099,539301,51700,50968,5473,56441,706
2021-03-10,Sutter,101,95872,8947,8918,81,8999,101
2021-03-10,Tehama,103,63373,4664,4623,501,5124,33
2021-03-10,Trinity,105,12862,469,304,80,384,3
2021-03-10,Tulare,107,460477,48816,47659,8371,56030,793
2021-03-10,Tuolumne,109,53932,3863,3931,35,3966,57
2021-03-10,Ventura,111,848112,78948,78609,2826,81435,878
2021-03-10,Yolo,113,214977,13079,13021,225,13246,189
2021-03-10,Yuba,115,75493,5616,5545,89,5634,42
2021-03-09,Alameda,001,1643700,82229,81618,1758,83376,1151
2021-03-09,Alpine,003,1148,82,78,0,78,0
2021-03-09,Amador,005,37829,3509,3494,32,3526,42
2021-03-09,Butte,007,227075,11485,11092,1635,12727,185
2021-03-09,Calaveras,009,45235,1951,1913,12,1925,48
2021-03-09,Colusa,011,21464,1883,1880,273,2153,11
2021-03-09,Contra Costa,013,1133247,64337,63314,1105,64419,723
2021-03-09,Del Norte,015,27424,1066,1017,5,1022,5
2021-03-09,El Dorado,017,186661,9255,9198,598,9796,98
2021-03-09,Fresno,019,978130,97971,96744,7962,104706,1463
2021-03-09,Glenn,021,27897,2283,2251,503,2754,15
2021-03-09,Humboldt,023,135768,3315,3288,22,3310,32
2021-03-09,Imperial,025,180216,27374,27045,2559,29604,675
2021-03-09,Inyo,027,18085,1345,1324,9,1333,35
2021-03-09,Kern,029,883053,94372,92924,10052,102976,1088
2021-03-09,Kings,031,150075,22521,22143,999,23142,226
2021-03-09,Lake,033,64148,3253,3202,6,3208,42
2021-03-09,Lassen,035,31185,5135,5120,100,5220,1
2021-03-09,Los Angeles,037,10098052,1178772,1167967,39815,1207782,22080
2021-03-09,Madera,039,155013,15873,15701,861,16562,211
2021-03-09,Marin,041,260295,13429,13335,176,13511,214
2021-03-09,Mariposa,043,17540,379,376,5,381,5
2021-03-09,Mendocino,045,87422,3686,3595,73,3668,42
2021-03-09,Merced,047,269075,29020,28876,956,29832,399
2021-03-09,Modoc,049,8938,349,338,118,456,3
2021-03-09,Mono,051,14174,1195,1203,16,1219,3
2021-03-09,Monterey,053,433212,42211,41894,1721,43615,329
2021-03-09,Napa,055,140530,9174,9155,34,9189,75
2021-03-09,Nevada,057,99092,4135,4062,164,4226,66
2021-03-09,Orange,059,3164182,248942,246989,10420,257409,4310
2021-03-09,Placer,061,380077,20976,20122,1162,21284,239
2021-03-09,Plumas,063,18699,649,639,10,649,4
2021-03-09,Riverside,065,2383286,287419,280562,13553,294115,3821
2021-03-09,Sacramento,067,1510023,96152,94720,1311,96031,1442
2021-03-09,San Benito,069,59416,5793,5800,92,5892,61
2021-03-09,San Bernardino,071,2135413,287536,282971,8621,291592,3823
2021-03-09,San Diego,073,3302833,267003,263745,13172,276917,3405
2021-03-09,San Francisco,075,870044,34632,34654,1122,35776,450
2021-03-09,San Joaquin,077,732212,67978,66383,2888,69271,1150
2021-03-09,San Luis Obispo,079,281455,20031,19672,582,20254,245
2021-03-09,San Mateo,081,765935,40069,39535,418,39953,336
2021-03-09,Santa Barbara,083,443738,32764,32314,1067,33381,428
2021-03-09,Santa Clara,085,1922200,112106,111963,615,112578,1756
2021-03-09,Santa Cruz,087,273765,15600,14764,791,15555,188
2021-03-09,Shasta,089,179085,11073,11113,1287,12400,155
2021-03-09,Sierra,091,2930,52,48,12,60,0
2021-03-09,Siskiyou,093,43540,1539,1447,248,1695,5
2021-03-09,Solano,095,438530,30240,30090,377,30467,169
2021-03-09,Sonoma,097,501317,28545,28601,231,28832,284
2021-03-09,Stanislaus,099,539301,51602,50884,5464,56348,703
2021-03-09,Sutter,101,95872,8934,8914,81,8995,101
2021-03-09,Tehama,103,63373,4659,4620,501,5121,33
2021-03-09,Trinity,105,12862,469,304,80,384,3
2021-03-09,Tulare,107,460477,48789,47637,8350,55987,792
2021-03-09,Tuolumne,109,53932,3861,3929,35,3964,56
2021-03-09,Ventura,111,848112,78885,78526,2824,81350,863
2021-03-09,Yolo,113,214977,13067,13015,224,13239,189
2021-03-09,Yuba,115,75493,5609,5539,89,5628,42
2021-03-08,Alameda,001,1643700,82118,81543,1757,83300,1142
2021-03-08,Alpine,003,1148,82,78,0,78,0
2021-03-08,Amador,005,37829,3506,3490,32,3522,42
2021-03-08,Butte,007,227075,11472,11082,1634,12716,185
2021-03-08,Calaveras,009,45235,1947,1909,12,1921,48
2021-03-08,Colusa,011,21464,1883,1877,273,2150,11
2021-03-08,Contra Costa,013,1133247,64241,63240,1105,64345,719
2021-03-08,Del Norte,015,27424,1061,1012,5,1017,5
2021-03-08,El Dorado,017,186661,9252,9188,597,9785,97
2021-03-08,Fresno,019,978130,97872,96665,7941,104606,1442
2021-03-08,Glenn,021,27897,2282,2249,503,2752,15
2021-03-08,Humboldt,023,135768,3301,3278,22,3300,31
2021-03-08,Imperial,025,180216,27366,27033,2556,29589,663
2021-03-08,Inyo,027,18085,1343,1320,9,1329,35
2021-03-08,Kern,029,883053,94305,92857,10032,102889,1087
2021-03-08,Kings,031,150075,22500,22130,997,23127,226
2021-03-08,Lake,033,64148,3241,3195,6,3201,42
2021-03-08,Lassen,035,31185,5135,5119,100,5219,1
2021-03-08,Los Angeles,037,10098052,1178154,1163409,39783,1203192,21868
2021-03-08,Madera,039,155013,15863,15691,859,16550,211
2021-03-08,Marin,041,260295,13409,13328,174,13502,214
2021-03-08,Mariposa,043,17540,379,376,5,381,5
2021-03-08,Mendocino,045,87422,3684,3590,72,3662,42
2021-03-08,Merced,047,269075,28960,28841,955,29796,398
2021-03-08,Modoc,049,8938,349,338,118,456,3
2021-03-08,Mono,051,14174,1194,1200,16,1216,3
2021-03-08,Monterey,053,433212,42190,41863,1720,43583,328
2021-03-08,Napa,055,140530,9171,9146,34,9180,75
2021-03-08,Nevada,057,99092,4127,4059,164,4223,66
2021-03-08,Orange,059,3164182,248768,246900,10388,257288,4243
2021-03-08,Placer,061,380077,20941,20102,1151,21253,239
2021-03-08,Plumas,063,18699,648,635,10,645,4
2021-03-08,Riverside,065,2383286,287267,280463,13543,294006,3783
2021-03-08,Sacramento,067,1510023,95982,94654,1306,95960,1438
2021-03-08,San Benito,069,59416,5790,5797,92,5889,61
2021-03-08,San Bernardino,071,2135413,287426,282894,8614,291508,3811
2021-03-08,San Diego,073,3302833,266762,263272,13157,276429,3390
2021-03-08,San Francisco,075,870044,34606,34634,1118,35752,446
2021-03-08,San Joaquin,077,732212,67861,66307,2879,69186,1139
2021-03-08,San Luis Obispo,079,281455,19988,19656,579,20235,245
2021-03-08,San Mateo,081,765935,40020,39492,416,39908,335
2021-03-08,Santa Barbara,083,443738,32732,32293,1067,33360,427
2021-03-08,Santa Clara,085,1922200,111978,111882,613,112495,1756
2021-03-08,Santa Cruz,087,273765,15580,14729,791,15520,188
2021-03-08,Shasta,089,179085,11065,11088,1282,12370,155
2021-03-08,Sierra,091,2930,52,48,12,60,0
2021-03-08,Siskiyou,093,43540,1538,1440,248,1688,5
2021-03-08,Solano,095,438530,30200,30068,375,30443,169
2021-03-08,Sonoma,097,501317,28501,28571,230,28801,284
2021-03-08,Stanislaus,099,539301,51523,50825,5459,56284,690
2021-03-08,Sutter,101,95872,8931,8905,81,8986,100
2021-03-08,Tehama,103,63373,4655,4615,501,5116,33
2021-03-08,Trinity,105,12862,468,302,80,382,3
2021-03-08,Tulare,107,460477,48748,47587,8325,55912,791
2021-03-08,Tuolumne,109,53932,3860,3921,35,3956,56
2021-03-08,Ventura,111,848112,78812,78526,2816,81342,852
2021-03-08,Yolo,113,214977,13044,13000,223,13223,189
2021-03-08,Yuba,115,75493,5599,5530,89,5619,42
2021-03-07,Alameda,001,1643700,81998,81413,1756,83169,1145
2021-03-07,Alpine,003,1148,82,78,0,78,0
2021-03-07,Amador,005,37829,3503,3489,32,3521,42
2021-03-07,Butte,007,227075,11456,11075,1633,12708,185
2021-03-07,Calaveras,009,45235,1943,1906,12,1918,48
2021-03-07,Colusa,011,21464,1883,1876,273,2149,11
2021-03-07,Contra Costa,013,1133247,64142,63148,1103,64251,719
2021-03-07,Del Norte,015,27424,1056,1010,5,1015,5
2021-03-07,El Dorado,017,186661,9249,9184,596,9780,97
2021-03-07,Fresno,019,978130,97694,96549,7919,104468,1442
2021-03-07,Glenn,021,27897,2280,2244,503,2747,15
2021-03-07,Humboldt,023,135768,3291,3274,22,3296,31
2021-03-07,Imperial,025,180216,27357,27019,2554,29573,658
2021-03-07,Inyo,027,18085,1340,1320,9,1329,35
2021-03-07,Kern,029,883053,94218,92746,10002,102748,1086
2021-03-07,Kings,031,150075,22478,22103,997,23100,224
2021-03-07,Lake,033,64148,3235,3192,6,3198,42
2021-03-07,Lassen,035,31185,5134,5119,100,5219,1
2021-03-07,Los Angeles,037,10098052,1177430,1162749,39746,1202495,21857
2021-03-07,Madera,039,155013,15844,15675,859,16534,211
2021-03-07,Marin,041,260295,13401,13313,172,13485,214
2021-03-07,Mariposa,043,17540,378,376,5,381,5
2021-03-07,Mendocino,045,87422,3680,3581,72,3653,42
2021-03-07,Merced,047,269075,28886,28829,951,29780,399
2021-03-07,Modoc,049,8938,349,338,118,456,3
2021-03-07,Mono,051,14174,1192,1199,16,1215,3
2021-03-07,Monterey,053,433212,42169,41858,1717,43575,328
2021-03-07,Napa,055,140530,9161,9137,34,9171,75
2021-03-07,Nevada,057,99092,4113,4052,163,4215,66
2021-03-07,Orange,059,3164182,248577,246771,10360,257131,4218
2021-03-07,Placer,061,380077,20900,20070,1147,21217,239
2021-03-07,Plumas,063,18699,647,635,10,645,4
2021-03-07,Riverside,065,2383286,287118,280379,13534,293913,3779
2021-03-07,Sacramento,067,1510023,95805,94513,1299,95812,1437
2021-03-07,San Benito,069,59416,5783,5795,92,5887,61
2021-03-07,San Bernardino,071,2135413,287274,282860,8609,291469,3810
2021-03-07,San Diego,073,3302833,266481,262965,13133,276098,3390
2021-03-07,San Francisco,075,870044,34572,34594,1113,35707,445
2021-03-07,San Joaquin,077,732212,67725,66252,2865,69117,1139
2021-03-07,San Luis Obispo,079,281455,19951,19614,577,20191,245
2021-03-07,San Mateo,081,765935,39980,39436,413,39849,329
2021-03-07,Santa Barbara,083,443738,32685,32218,1066,33284,425
2021-03-07,Santa Clara,085,1922200,111833,111745,609,112354,1752
2021-03-07,Santa Cruz,087,273765,15558,14715,790,15505,189
2021-03-07,Shasta,089,179085,11052,11083,1274,12357,156
2021-03-07,Sierra,091,2930,51,48,12,60,0
2021-03-07,Siskiyou,093,43540,1537,1435,244,1679,5
2021-03-07,Solano,095,438530,30163,30027,375,30402,169
2021-03-07,Sonoma,097,501317,28452,28533,228,28761,284
2021-03-07,Stanislaus,099,539301,51391,50783,5442,56225,699
2021-03-07,Sutter,101,95872,8921,8900,81,8981,100
2021-03-07,Tehama,103,63373,4647,4614,500,5114,33
2021-03-07,Trinity,105,12862,468,302,80,382,3
2021-03-07,Tulare,107,460477,48689,47569,8294,55863,790
2021-03-07,Tuolumne,109,53932,3859,3922,34,3956,56
2021-03-07,Ventura,111,848112,78720,78487,2814,81301,851
2021-03-07,Yolo,113,214977,13025,12988,223,13211,189
2021-03-07,Yuba,115,75493,5594,5516,89,5605,42
2021-03-06,Alameda,001,1643700,81941,81310,1755,83065,1143
2021-03-06,Alpine,003,1148,82,78,0,78,0
2021-03-06,Amador,005,37829,3499,3487,32,3519,42
2021-03-06,Butte,007,227075,11451,11065,1632,12697,185
2021-03-06,Calaveras,009,45235,1939,1904,12,1916,48
2021-03-06,Colusa,011,21464,1881,1874,273,2147,11
2021-03-06,Contra Costa,013,1133247,64081,63040,1099,64139,719
2021-03-06,Del Norte,015,27424,1051,1000,5,1005,5
2021-03-06,El Dorado,017,186661,9245,9166,596,9762,97
2021-03-06,Fresno,019,978130,97599,96366,7908,104274,1440
2021-03-06,Glenn,021,27897,2280,2241,503,2744,15
2021-03-06,Humboldt,023,135768,3281,3260,22,3282,31
2021-03-06,Imperial,025,180216,27352,27009,2549,29558,658
2021-03-06,Inyo,027,18085,1337,1312,9,1321,35
2021-03-06,Kern,029,883053,94172,92684,9982,102666,1082
2021-03-06,Kings,031,150075,22463,22094,997,23091,224
2021-03-06,Lake,033,64148,3233,3189,6,3195,42
2021-03-06,Lassen,035,31185,5134,5119,100,5219,1
2021-03-06,Los Angeles,037,10098052,1176992,1161745,39716,1201461,21843
2021-03-06,Madera,039,155013,15835,15646,857,16503,211
2021-03-06,Marin,041,260295,13392,13289,172,13461,213
2021-03-06,Mariposa,043,17540,378,376,5,381,5
2021-03-06,Mendocino,045,87422,3678,3579,72,3651,42
2021-03-06,Merced,047,269075,28844,28771,951,29722,399
2021-03-06,Modoc,049,8938,348,338,118,456,3
2021-03-06,Mono,051,14174,1191,1198,16,1214,3
2021-03-06,Monterey,053,433212,42164,41838,1714,43552,327
2021-03-06,Napa,055,140530,9153,9129,34,9163,75
2021-03-06,Nevada,057,99092,4107,4044,163,4207,66
2021-03-06,Orange,059,3164182,248484,246634,10346,256980,4165
2021-03-06,Placer,061,380077,20877,20030,1145,21175,239
2021-03-06,Plumas,063,18699,647,634,10,644,4
2021-03-06,Riverside,065,2383286,287025,280225,13526,293751,3781
2021-03-06,Sacramento,067,1510023,95717,94332,1290,95622,1436
2021-03-06,San Benito,069,59416,5778,5793,92,5885,61
2021-03-06,San Bernardino,071,2135413,287190,282737,8607,291344,3791
2021-03-06,San Diego,073,3302833,266294,262778,13116,275894,3385
2021-03-06,San Francisco,075,870044,34541,34560,1109,35669,435
2021-03-06,San Joaquin,077,732212,67651,66162,2855,69017,1138
2021-03-06,San Luis Obispo,079,281455,19931,19592,575,20167,245
2021-03-06,San Mateo,081,765935,39955,39384,413,39797,329
2021-03-06,Santa Barbara,083,443738,32654,32176,1065,33241,424
2021-03-06,Santa Clara,085,1922200,111738,111570,606,112176,1749
2021-03-06,Santa Cruz,087,273765,15547,14701,790,15491,188
2021-03-06,Shasta,089,179085,11043,11076,1272,12348,158
2021-03-06,Sierra,091,2930,51,48,12,60,0
2021-03-06,Siskiyou,093,43540,1535,1432,244,1676,5
2021-03-06,Solano,095,438530,30134,30000,374,30374,169
2021-03-06,Sonoma,097,501317,28429,28484,226,28710,284
2021-03-06,Stanislaus,099,539301,51321,50691,5436,56127,711
2021-03-06,Sutter,101,95872,8915,8887,81,8968,100
2021-03-06,Tehama,103,63373,4645,4610,497,5107,33
2021-03-06,Trinity,105,12862,468,302,80,382,3
2021-03-06,Tulare,107,460477,48657,47515,8265,55780,789
2021-03-06,Tuolumne,109,53932,3857,3920,34,3954,56
2021-03-06,Ventura,111,848112,78664,78439,2813,81252,848
2021-03-06,Yolo,113,214977,13019,12951,223,13174,189
2021-03-06,Yuba,115,75493,5585,5504,89,5593,42
2021-03-05,Alameda,001,1643700,81855,81215,1753,82968,1141
2021-03-05,Alpine,003,1148,82,78,0,78,0
2021-03-05,Amador,005,37829,3498,3484,32,3516,42
2021-03-05,Butte,007,227075,11440,11050,1631,12681,185
2021-03-05,Calaveras,009,45235,1936,1902,12,1914,48
2021-03-05,Colusa,011,21464,1881,1874,273,2147,11
2021-03-05,Contra Costa,013,1133247,64001,62886,1096,63982,711
2021-03-05,Del Norte,015,27424,1047,995,5,1000,5
2021-03-05,El Dorado,017,186661,9240,9150,595,9745,97
2021-03-05,Fresno,019,978130,97491,96184,7889,104073,1432
2021-03-05,Glenn,021,27897,2277,2241,502,2743,15
2021-03-05,Humboldt,023,135768,3274,3234,22,3256,31
2021-03-05,Imperial,025,180216,27342,26970,2540,29510,651
2021-03-05,Inyo,027,18085,1333,1309,9,1318,35
2021-03-05,Kern,029,883053,94132,92601,9969,102570,1076
2021-03-05,Kings,031,150075,22445,22063,996,23059,224
2021-03-05,Lake,033,64148,3231,3185,6,3191,42
2021-03-05,Lassen,035,31185,5134,5117,98,5215,1
2021-03-05,Los Angeles,037,10098052,1176502,1160688,39685,1200373,21745
2021-03-05,Madera,039,155013,15825,15624,855,16479,211
2021-03-05,Marin,041,260295,13380,13275,171,13446,215
2021-03-05,Mariposa,043,17540,378,375,5,380,4
2021-03-05,Mendocino,045,87422,3675,3577,72,3649,42
2021-03-05,Merced,047,269075,28811,28734,950,29684,399
2021-03-05,Modoc,049,8938,348,337,118,455,3
2021-03-05,Mono,051,14174,1190,1197,16,1213,3
2021-03-05,Monterey,053,433212,42151,41802,1714,43516,325
2021-03-05,Napa,055,140530,9145,9109,34,9143,75
2021-03-05,Nevada,057,99092,4103,4033,163,4196,66
2021-03-05,Orange,059,3164182,248371,246489,10333,256822,4108
2021-03-05,Placer,061,380077,20851,19973,1141,21114,239
2021-03-05,Plumas,063,18699,647,635,10,645,4
2021-03-05,Riverside,065,2383286,286913,280075,13521,293596,3781
2021-03-05,Sacramento,067,1510023,95621,94182,1283,95465,1430
2021-03-05,San Benito,069,59416,5775,5790,92,5882,61
2021-03-05,San Bernardino,071,2135413,287097,282640,8603,291243,3774
2021-03-05,San Diego,073,3302833,266061,262357,13099,275456,3371
2021-03-05,San Francisco,075,870044,34501,34526,1105,35631,430
2021-03-05,San Joaquin,077,732212,67571,66041,2846,68887,1133
2021-03-05,San Luis Obispo,079,281455,19910,19557,573,20130,244
2021-03-05,San Mateo,081,765935,39923,39305,413,39718,326
2021-03-05,Santa Barbara,083,443738,32617,32139,1060,33199,424
2021-03-05,Santa Clara,085,1922200,111643,111384,606,111990,1745
2021-03-05,Santa Cruz,087,273765,15536,14694,790,15484,188
2021-03-05,Shasta,089,179085,11031,11062,1266,12328,148
2021-03-05,Sierra,091,2930,51,48,12,60,0
2021-03-05,Siskiyou,093,43540,1530,1429,243,1672,5
2021-03-05,Solano,095,438530,30117,29951,372,30323,168
2021-03-05,Sonoma,097,501317,28403,28417,226,28643,279
2021-03-05,Stanislaus,099,539301,51270,50606,5426,56032,721
2021-03-05,Sutter,101,95872,8908,8876,81,8957,100
2021-03-05,Tehama,103,63373,4636,4606,497,5103,33
2021-03-05,Trinity,105,12862,468,302,80,382,3
2021-03-05,Tulare,107,460477,48628,47469,8246,55715,789
2021-03-05,Tuolumne,109,53932,3855,3917,34,3951,56
2021-03-05,Ventura,111,848112,78597,78368,2812,81180,839
2021-03-05,Yolo,113,214977,13007,12920,222,13142,188
2021-03-05,Yuba,115,75493,5573,5496,89,5585,42
2021-03-04,Alameda,001,1643700,81744,81115,1753,82868,1136
2021-03-04,Alpine,003,1148,82,78,0,78,0
2021-03-04,Amador,005,37829,3497,3480,32,3512,42
2021-03-04,Butte,007,227075,11433,11033,1630,12663,185
2021-03-04,Calaveras,009,45235,1935,1896,12,1908,48
2021-03-04,Colusa,011,21464,1879,1873,268,2141,11
2021-03-04,Contra Costa,013,1133247,63901,62789,1094,63883,708
2021-03-04,Del Norte,015,27424,1039,989,5,994,5
2021-03-04,El Dorado,017,186661,9225,9133,595,9728,97
2021-03-04,Fresno,019,978130,97327,96023,7869,103892,1422
2021-03-04,Glenn,021,27897,2270,2236,501,2737,15
2021-03-04,Humboldt,023,135768,3260,3212,22,3234,31
2021-03-04,Imperial,025,180216,27329,26946,2537,29483,646
2021-03-04,Inyo,027,18085,1330,1300,9,1309,35
2021-03-04,Kern,029,883053,94043,92525,9950,102475,1070
2021-03-04,Kings,031,150075,22419,22025,993,23018,224
2021-03-04,Lake,033,64148,3223,3181,6,3187,42
2021-03-04,Lassen,035,31185,5134,5116,98,5214,1
2021-03-04,Los Angeles,037,10098052,1175892,1159405,39636,1199041,21610
2021-03-04,Madera,039,155013,15790,15596,852,16448,208
2021-03-04,Marin,041,260295,13364,13240,168,13408,215
2021-03-04,Mariposa,043,17540,378,376,5,381,4
2021-03-04,Mendocino,045,87422,3672,3569,72,3641,42
2021-03-04,Merced,047,269075,28760,28671,948,29619,396
2021-03-04,Modoc,049,8938,347,336,118,454,3
2021-03-04,Mono,051,14174,1190,1197,16,1213,3
2021-03-04,Monterey,053,433212,42131,41771,1712,43483,325
2021-03-04,Napa,055,140530,9137,9094,34,9128,74
2021-03-04,Nevada,057,99092,4093,4020,163,4183,66
2021-03-04,Orange,059,3164182,248214,246354,10316,256670,4096
2021-03-04,Placer,061,380077,20819,19900,1135,21035,239
2021-03-04,Plumas,063,18699,647,634,10,644,4
2021-03-04,Riverside,065,2383286,286783,279871,13508,293379,3766
2021-03-04,Sacramento,067,1510023,95486,93982,1280,95262,1426
2021-03-04,San Benito,069,59416,5775,5781,92,5873,61
2021-03-04,San Bernardino,071,2135413,286967,282407,8599,291006,3757
2021-03-04,San Diego,073,3302833,265801,261858,13055,274913,3359
2021-03-04,San Francisco,075,870044,34466,34480,1102,35582,426
2021-03-04,San Joaquin,077,732212,67477,65931,2836,68767,1129
2021-03-04,San Luis Obispo,079,281455,19873,19520,571,20091,243
2021-03-04,San Mateo,081,765935,39879,39225,412,39637,322
2021-03-04,Santa Barbara,083,443738,32580,32090,1059,33149,423
2021-03-04,Santa Clara,085,1922200,111509,111194,604,111798,1723
2021-03-04,Santa Cruz,087,273765,15517,14669,790,15459,186
2021-03-04,Shasta,089,179085,11028,11050,1257,12307,150
2021-03-04,Sierra,091,2930,51,48,12,60,0
2021-03-04,Siskiyou,093,43540,1523,1427,243,1670,5
2021-03-04,Solano,095,438530,30090,29905,371,30276,168
2021-03-04,Sonoma,097,501317,28348,28379,225,28604,279
2021-03-04,Stanislaus,099,539301,51183,50521,5418,55939,731
2021-03-04,Sutter,101,95872,8896,8849,81,8930,100
2021-03-04,Tehama,103,63373,4629,4604,497,5101,33
2021-03-04,Trinity,105,12862,468,302,80,382,3
2021-03-04,Tulare,107,460477,48583,47398,8221,55619,784
2021-03-04,Tuolumne,109,53932,3849,3916,34,3950,56
2021-03-04,Ventura,111,848112,78507,78184,2809,80993,831
2021-03-04,Yolo,113,214977,12986,12895,222,13117,189
2021-03-04,Yuba,115,75493,5561,5483,89,5572,41
2021-03-03,Alameda,001,1643700,81622,80972,1752,82724,1127
2021-03-03,Alpine,003,1148,82,77,0,77,0
2021-03-03,Amador,005,37829,3495,3478,31,3509,42
2021-03-03,Butte,007,227075,11425,11014,1629,12643,184
2021-03-03,Calaveras,009,45235,1934,1893,12,1905,48
2021-03-03,Colusa,011,21464,1878,1873,268,2141,11
2021-03-03,Contra Costa,013,1133247,63802,62668,1091,63759,708
2021-03-03,Del Norte,015,27424,1036,988,5,993,5
2021-03-03,El Dorado,017,186661,9215,9121,595,9716,97
2021-03-03,Fresno,019,978130,97183,95893,7851,103744,1415
2021-03-03,Glenn,021,27897,2270,2233,501,2734,15
2021-03-03,Humboldt,023,135768,3249,3196,22,3218,30
2021-03-03,Imperial,025,180216,27313,26939,2533,29472,640
2021-03-03,Inyo,027,18085,1322,1294,9,1303,35
2021-03-03,Kern,029,883053,93967,92434,9933,102367,1063
2021-03-03,Kings,031,150075,22403,22009,992,23001,223
2021-03-03,Lake,033,64148,3216,3175,6,3181,40
2021-03-03,Lassen,035,31185,5134,5115,98,5213,1
2021-03-03,Los Angeles,037,10098052,1175252,1157911,39595,1197506,21500
2021-03-03,Madera,039,155013,15771,15553,846,16399,203
2021-03-03,Marin,041,260295,13350,13216,168,13384,214
2021-03-03,Mariposa,043,17540,377,376,5,381,4
2021-03-03,Mendocino,045,87422,3664,3564,72,3636,42
2021-03-03,Merced,047,269075,28708,28625,948,29573,393
2021-03-03,Modoc,049,8938,347,333,117,450,3
2021-03-03,Mono,051,14174,1190,1191,16,1207,3
2021-03-03,Monterey,053,433212,42099,41731,1709,43440,325
2021-03-03,Napa,055,140530,9129,9090,34,9124,72
2021-03-03,Nevada,057,99092,4083,4009,163,4172,66
2021-03-03,Orange,059,3164182,248069,246120,10301,256421,4072
2021-03-03,Placer,061,380077,20793,19851,1132,20983,239
2021-03-03,Plumas,063,18699,646,631,10,641,4
2021-03-03,Riverside,065,2383286,286650,279626,13502,293128,3735
2021-03-03,Sacramento,067,1510023,95325,93819,1272,95091,1419
2021-03-03,San Benito,069,59416,5774,5774,92,5866,61
2021-03-03,San Bernardino,071,2135413,286825,282138,8592,290730,3664
2021-03-03,San Diego,073,3302833,265537,261350,13024,274374,3342
2021-03-03,San Francisco,075,870044,34434,34443,1099,35542,426
2021-03-03,San Joaquin,077,732212,67365,65855,2829,68684,1115
2021-03-03,San Luis Obispo,079,281455,19847,19479,568,20047,241
2021-03-03,San Mateo,081,765935,39833,39189,411,39600,319
2021-03-03,Santa Barbara,083,443738,32542,32027,1059,33086,421
2021-03-03,Santa Clara,085,1922200,111355,110991,602,111593,1720
2021-03-03,Santa Cruz,087,273765,15506,14645,790,15435,185
2021-03-03,Shasta,089,179085,11018,11023,1250,12273,150
2021-03-03,Sierra,091,2930,51,48,12,60,0
2021-03-03,Siskiyou,093,43540,1521,1424,243,1667,5
2021-03-03,Solano,095,438530,30054,29866,370,30236,167
2021-03-03,Sonoma,097,501317,28309,28307,224,28531,279
2021-03-03,Stanislaus,099,539301,51105,50438,5411,55849,730
2021-03-03,Sutter,101,95872,8888,8840,81,8921,99
2021-03-03,Tehama,103,63373,4627,4601,497,5098,32
2021-03-03,Trinity,105,12862,468,302,80,382,3
2021-03-03,Tulare,107,460477,48532,47348,8190,55538,778
2021-03-03,Tuolumne,109,53932,3847,3914,33,3947,56
2021-03-03,Ventura,111,848112,78423,78057,2804,80861,822
2021-03-03,Yolo,113,214977,12973,12890,222,13112,189
2021-03-03,Yuba,115,75493,5548,5479,89,5568,41
2021-03-02,Alameda,001,1643700,81501,80904,1750,82654,1116
2021-03-02,Alpine,003,1148,82,77,0,77,0
2021-03-02,Amador,005,37829,3493,3474,31,3505,42
2021-03-02,Butte,007,227075,11415,11007,1626,12633,182
2021-03-02,Calaveras,009,45235,1926,1890,12,1902,48
2021-03-02,Colusa,011,21464,1878,1872,267,2139,11
2021-03-02,Contra Costa,013,1133247,63691,62557,1087,63644,694
2021-03-02,Del Norte,015,27424,1029,983,5,988,5
2021-03-02,El Dorado,017,186661,9207,9116,595,9711,98
2021-03-02,Fresno,019,978130,97037,95785,7825,103610,1410
2021-03-02,Glenn,021,27897,2264,2232,500,2732,15
2021-03-02,Humboldt,023,135768,3230,3184,22,3206,30
2021-03-02,Imperial,025,180216,27303,26926,2531,29457,637
2021-03-02,Inyo,027,18085,1318,1292,9,1301,35
2021-03-02,Kern,029,883053,93861,92313,9906,102219,1046
2021-03-02,Kings,031,150075,22351,21999,989,22988,217
2021-03-02,Lake,033,64148,3210,3169,6,3175,40
2021-03-02,Lassen,035,31185,5129,5115,97,5212,1
2021-03-02,Los Angeles,037,10098052,1174617,1156826,39549,1196375,21395
2021-03-02,Madera,039,155013,15751,15523,843,16366,194
2021-03-02,Marin,041,260295,13327,13186,167,13353,214
2021-03-02,Mariposa,043,17540,377,376,5,381,4
2021-03-02,Mendocino,045,87422,3661,3562,71,3633,41
2021-03-02,Merced,047,269075,28651,28598,948,29546,389
2021-03-02,Modoc,049,8938,347,332,117,449,3
2021-03-02,Mono,051,14174,1189,1191,16,1207,3
2021-03-02,Monterey,053,433212,42072,41716,1709,43425,325
2021-03-02,Napa,055,140530,9117,9080,34,9114,71
2021-03-02,Nevada,057,99092,4074,3983,162,4145,66
2021-03-02,Orange,059,3164182,247923,246004,10283,256287,4037
2021-03-02,Placer,061,380077,20740,19828,1129,20957,239
2021-03-02,Plumas,063,18699,643,628,10,638,4
2021-03-02,Riverside,065,2383286,286477,279486,13494,292980,3721
2021-03-02,Sacramento,067,1510023,95158,93690,1271,94961,1411
2021-03-02,San Benito,069,59416,5767,5770,92,5862,60
2021-03-02,San Bernardino,071,2135413,286691,281919,8586,290505,3604
2021-03-02,San Diego,073,3302833,265293,260998,13002,274000,3317
2021-03-02,San Francisco,075,870044,34394,34387,1095,35482,424
2021-03-02,San Joaquin,077,732212,67257,65769,2811,68580,1111
2021-03-02,San Luis Obispo,079,281455,19815,19452,568,20020,241
2021-03-02,San Mateo,081,765935,39781,39148,410,39558,317
2021-03-02,Santa Barbara,083,443738,32493,31964,1055,33019,416
2021-03-02,Santa Clara,085,1922200,111176,110832,601,111433,1706
2021-03-02,Santa Cruz,087,273765,15492,14611,788,15399,185
2021-03-02,Shasta,089,179085,11004,11012,1239,12251,149
2021-03-02,Sierra,091,2930,51,48,12,60,0
2021-03-02,Siskiyou,093,43540,1517,1412,241,1653,5
2021-03-02,Solano,095,438530,30021,29827,368,30195,167
2021-03-02,Sonoma,097,501317,28254,28261,224,28485,279
2021-03-02,Stanislaus,099,539301,51018,50359,5399,55758,724
2021-03-02,Sutter,101,95872,8879,8832,81,8913,99
2021-03-02,Tehama,103,63373,4623,4597,496,5093,32
2021-03-02,Trinity,105,12862,468,301,80,381,3
2021-03-02,Tulare,107,460477,48469,47326,8170,55496,783
2021-03-02,Tuolumne,109,53932,3843,3908,33,3941,53
2021-03-02,Ventura,111,848112,78330,77952,2800,80752,780
2021-03-02,Yolo,113,214977,12957,12867,222,13089,189
2021-03-02,Yuba,115,75493,5540,5475,89,5564,41
2021-03-01,Alameda,001,1643700,81374,80805,1748,82553,1105
2021-03-01,Alpine,003,1148,80,77,0,77,0
2021-03-01,Amador,005,37829,3490,3469,31,3500,42
2021-03-01,Butte,007,227075,11400,10981,1621,12602,180
2021-03-01,Calaveras,009,45235,1921,1885,12,1897,46
2021-03-01,Colusa,011,21464,1877,1871,267,2138,11
2021-03-01,Contra Costa,013,1133247,63581,62458,1086,63544,694
2021-03-01,Del Norte,015,27424,1024,982,5,987,5
2021-03-01,El Dorado,017,186661,9183,9085,595,9680,98
2021-03-01,Fresno,019,978130,96899,95677,7803,103480,1405
2021-03-01,Glenn,021,27897,2259,2232,499,2731,15
2021-03-01,Humboldt,023,135768,3211,3179,22,3201,30
2021-03-01,Imperial,025,180216,27293,26913,2523,29436,636
2021-03-01,Inyo,027,18085,1315,1285,9,1294,35
2021-03-01,Kern,029,883053,93772,92219,9880,102099,1041
2021-03-01,Kings,031,150075,22334,21988,983,22971,217
2021-03-01,Lake,033,64148,3205,3164,6,3170,40
2021-03-01,Lassen,035,31185,5127,5111,97,5208,1
2021-03-01,Los Angeles,037,10098052,1173959,1155984,39507,1195491,21293
2021-03-01,Madera,039,155013,15722,15505,832,16337,194
2021-03-01,Marin,041,260295,13299,13161,166,13327,214
2021-03-01,Mariposa,043,17540,377,375,5,380,4
2021-03-01,Mendocino,045,87422,3654,3561,71,3632,41
2021-03-01,Merced,047,269075,28606,28575,944,29519,385
2021-03-01,Modoc,049,8938,344,331,116,447,3
2021-03-01,Mono,051,14174,1188,1192,16,1208,3
2021-03-01,Monterey,053,433212,42047,41697,1707,43404,324
2021-03-01,Napa,055,140530,9108,9056,34,9090,70
2021-03-01,Nevada,057,99092,4055,3979,162,4141,66
2021-03-01,Orange,059,3164182,247728,245852,10268,256120,3976
2021-03-01,Placer,061,380077,20701,19803,1126,20929,239
2021-03-01,Plumas,063,18699,643,628,10,638,4
2021-03-01,Riverside,065,2383286,286260,279323,13487,292810,3680
2021-03-01,Sacramento,067,1510023,95013,93546,1269,94815,1401
2021-03-01,San Benito,069,59416,5762,5772,92,5864,57
2021-03-01,San Bernardino,071,2135413,286548,281685,8582,290267,3603
2021-03-01,San Diego,073,3302833,264974,260622,12969,273591,3303
2021-03-01,San Francisco,075,870044,34350,34318,1087,35405,424
2021-03-01,San Joaquin,077,732212,67148,65699,2800,68499,1097
2021-03-01,San Luis Obispo,079,281455,19793,19429,566,19995,239
2021-03-01,San Mateo,081,765935,39729,39096,409,39505,314
2021-03-01,Santa Barbara,083,443738,32450,31909,1054,32963,413
2021-03-01,Santa Clara,085,1922200,111017,110684,598,111282,1704
2021-03-01,Santa Cruz,087,273765,15473,14575,787,15362,185
2021-03-01,Shasta,089,179085,10992,10990,1236,12226,149
2021-03-01,Sierra,091,2930,51,48,12,60,0
2021-03-01,Siskiyou,093,43540,1513,1408,239,1647,5
2021-03-01,Solano,095,438530,29978,29779,367,30146,166
2021-03-01,Sonoma,097,501317,28206,28222,222,28444,278
2021-03-01,Stanislaus,099,539301,50942,50293,5393,55686,722
2021-03-01,Sutter,101,95872,8868,8825,81,8906,99
2021-03-01,Tehama,103,63373,4617,4595,496,5091,32
2021-03-01,Trinity,105,12862,468,298,79,377,3
2021-03-01,Tulare,107,460477,48431,47275,8137,55412,781
2021-03-01,Tuolumne,109,53932,3840,3907,33,3940,53
2021-03-01,Ventura,111,848112,78249,77849,2798,80647,775
2021-03-01,Yolo,113,214977,12940,12854,220,13074,188
2021-03-01,Yuba,115,75493,5528,5466,89,5555,41
2021-02-28,Alameda,001,1643700,81253,80727,1746,82473,1105
2021-02-28,Alpine,003,1148,80,77,0,77,0
2021-02-28,Amador,005,37829,3485,3466,30,3496,42
2021-02-28,Butte,007,227075,11385,10970,1621,12591,180
2021-02-28,Calaveras,009,45235,1917,1881,12,1893,46
2021-02-28,Colusa,011,21464,1877,1871,266,2137,11
2021-02-28,Contra Costa,013,1133247,63454,62386,1081,63467,694
2021-02-28,Del Norte,015,27424,1022,981,5,986,5
2021-02-28,El Dorado,017,186661,9172,9082,595,9677,98
2021-02-28,Fresno,019,978130,96717,95548,7769,103317,1405
2021-02-28,Glenn,021,27897,2257,2230,497,2727,15
2021-02-28,Humboldt,023,135768,3188,3179,22,3201,30
2021-02-28,Imperial,025,180216,27267,26909,2519,29428,636
2021-02-28,Inyo,027,18085,1310,1282,9,1291,35
2021-02-28,Kern,029,883053,93657,92169,9859,102028,1012
2021-02-28,Kings,031,150075,22313,21967,982,22949,217
2021-02-28,Lake,033,64148,3200,3164,6,3170,40
2021-02-28,Lassen,035,31185,5126,5106,97,5203,1
2021-02-28,Los Angeles,037,10098052,1173172,1155141,39445,1194586,21261
2021-02-28,Madera,039,155013,15680,15496,829,16325,199
2021-02-28,Marin,041,260295,13276,13152,164,13316,214
2021-02-28,Mariposa,043,17540,377,374,5,379,4
2021-02-28,Mendocino,045,87422,3648,3558,71,3629,41
2021-02-28,Merced,047,269075,28543,28546,943,29489,384
2021-02-28,Modoc,049,8938,344,331,116,447,3
2021-02-28,Mono,051,14174,1185,1192,16,1208,3
2021-02-28,Monterey,053,433212,42015,41683,1705,43388,323
2021-02-28,Napa,055,140530,9089,9053,34,9087,70
2021-02-28,Nevada,057,99092,4042,3972,162,4134,66
2021-02-28,Orange,059,3164182,247530,245706,10261,255967,3970
2021-02-28,Placer,061,380077,20655,19775,1124,20899,239
2021-02-28,Plumas,063,18699,643,628,10,638,4
2021-02-28,Riverside,065,2383286,286027,279214,13476,292690,3661
2021-02-28,Sacramento,067,1510023,94829,93463,1264,94727,1398
2021-02-28,San Benito,069,59416,5751,5772,92,5864,57
2021-02-28,San Bernardino,071,2135413,286407,281620,8570,290190,3595
2021-02-28,San Diego,073,3302833,264677,260353,12935,273288,3303
2021-02-28,San Francisco,075,870044,34308,34291,1081,35372,417
2021-02-28,San Joaquin,077,732212,67040,65662,2791,68453,1097
2021-02-28,San Luis Obispo,079,281455,19757,19422,564,19986,237
2021-02-28,San Mateo,081,765935,39676,39059,408,39467,314
2021-02-28,Santa Barbara,083,443738,32397,31877,1054,32931,413
2021-02-28,Santa Clara,085,1922200,110818,110556,595,111151,1704
2021-02-28,Santa Cruz,087,273765,15444,14571,784,15355,185
2021-02-28,Shasta,089,179085,10971,10990,1232,12222,149
2021-02-28,Sierra,091,2930,51,48,12,60,0
2021-02-28,Siskiyou,093,43540,1505,1408,239,1647,5
2021-02-28,Solano,095,438530,29923,29758,361,30119,166
2021-02-28,Sonoma,097,501317,28143,28193,221,28414,279
2021-02-28,Stanislaus,099,539301,50852,50228,5380,55608,728
2021-02-28,Sutter,101,95872,8853,8825,81,8906,99
2021-02-28,Tehama,103,63373,4611,4590,496,5086,32
2021-02-28,Trinity,105,12862,468,298,79,377,3
2021-02-28,Tulare,107,460477,48369,47258,8106,55364,780
2021-02-28,Tuolumne,109,53932,3835,3905,33,3938,53
2021-02-28,Ventura,111,848112,78137,77749,2795,80544,775
2021-02-28,Yolo,113,214977,12917,12851,220,13071,188
2021-02-28,Yuba,115,75493,5518,5461,89,5550,41
2021-02-27,Alameda,001,1643700,81181,80565,1744,82309,1108
2021-02-27,Alpine,003,1148,80,77,0,77,0
2021-02-27,Amador,005,37829,3483,3463,30,3493,42
2021-02-27,Butte,007,227075,11373,10962,1621,12583,180
2021-02-27,Calaveras,009,45235,1912,1875,12,1887,46
2021-02-27,Colusa,011,21464,1876,1869,266,2135,11
2021-02-27,Contra Costa,013,1133247,63384,62248,1078,63326,693
2021-02-27,Del Norte,015,27424,1020,978,5,983,5
2021-02-27,El Dorado,017,186661,9168,9072,595,9667,98
2021-02-27,Fresno,019,978130,96640,95393,7758,103151,1400
2021-02-27,Glenn,021,27897,2256,2225,496,2721,15
2021-02-27,Humboldt,023,135768,3182,3167,22,3189,30
2021-02-27,Imperial,025,180216,27259,26903,2517,29420,633
2021-02-27,Inyo,027,18085,1307,1275,9,1284,35
2021-02-27,Kern,029,883053,93596,92053,9844,101897,996
2021-02-27,Kings,031,150075,22303,21955,979,22934,216
2021-02-27,Lake,033,64148,3197,3156,6,3162,40
2021-02-27,Lassen,035,31185,5126,5106,97,5203,1
2021-02-27,Los Angeles,037,10098052,1172675,1154275,39418,1193693,21158
2021-02-27,Madera,039,155013,15663,15467,828,16295,199
2021-02-27,Marin,041,260295,13252,13134,164,13298,214
2021-02-27,Mariposa,043,17540,377,374,5,379,4
2021-02-27,Mendocino,045,87422,3645,3555,71,3626,41
2021-02-27,Merced,047,269075,28501,28501,935,29436,384
2021-02-27,Modoc,049,8938,344,331,115,446,3
2021-02-27,Mono,051,14174,1183,1191,16,1207,3
2021-02-27,Monterey,053,433212,42006,41665,1704,43369,322
2021-02-27,Napa,055,140530,9078,9038,34,9072,71
2021-02-27,Nevada,057,99092,4036,3960,162,4122,66
2021-02-27,Orange,059,3164182,247403,245542,10250,255792,3960
2021-02-27,Placer,061,380077,20619,19726,1121,20847,239
2021-02-27,Plumas,063,18699,643,628,10,638,4
2021-02-27,Riverside,065,2383286,285917,279048,13466,292514,3663
2021-02-27,Sacramento,067,1510023,94746,93281,1254,94535,1396
2021-02-27,San Benito,069,59416,5750,5767,91,5858,57
2021-02-27,San Bernardino,071,2135413,286328,281471,8563,290034,3527
2021-02-27,San Diego,073,3302833,264487,260091,12897,272988,3284
2021-02-27,San Francisco,075,870044,34274,34260,1078,35338,413
2021-02-27,San Joaquin,077,732212,66994,65578,2789,68367,1100
2021-02-27,San Luis Obispo,079,281455,19736,19411,563,19974,237
2021-02-27,San Mateo,081,765935,39635,38998,407,39405,313
2021-02-27,Santa Barbara,083,443738,32363,31805,1053,32858,411
2021-02-27,Santa Clara,085,1922200,110670,110361,593,110954,1703
2021-02-27,Santa Cruz,087,273765,15435,14552,783,15335,185
2021-02-27,Shasta,089,179085,10965,10985,1228,12213,149
2021-02-27,Sierra,091,2930,51,48,12,60,0
2021-02-27,Siskiyou,093,43540,1503,1407,238,1645,5
2021-02-27,Solano,095,438530,29895,29718,360,30078,165
2021-02-27,Sonoma,097,501317,28099,28141,215,28356,281
2021-02-27,Stanislaus,099,539301,50797,50147,5370,55517,733
2021-02-27,Sutter,101,95872,8848,8820,81,8901,99
2021-02-27,Tehama,103,63373,4607,4584,495,5079,32
2021-02-27,Trinity,105,12862,468,298,79,377,3
2021-02-27,Tulare,107,460477,48332,47209,8080,55289,770
2021-02-27,Tuolumne,109,53932,3832,3899,33,3932,53
2021-02-27,Ventura,111,848112,78064,77623,2792,80415,771
2021-02-27,Yolo,113,214977,12905,12834,220,13054,188
2021-02-27,Yuba,115,75493,5515,5450,89,5539,39
2021-02-26,Alameda,001,1643700,81086,80387,1739,82126,1106
2021-02-26,Alpine,003,1148,80,77,0,77,0
2021-02-26,Amador,005,37829,3477,3457,30,3487,42
2021-02-26,Butte,007,227075,11363,10941,1621,12562,180
2021-02-26,Calaveras,009,45235,1910,1873,12,1885,46
2021-02-26,Colusa,011,21464,1876,1865,266,2131,11
2021-02-26,Contra Costa,013,1133247,63301,62114,1078,63192,685
2021-02-26,Del Norte,015,27424,1016,968,5,973,5
2021-02-26,El Dorado,017,186661,9163,9038,593,9631,98
2021-02-26,Fresno,019,978130,96537,95202,7750,102952,1391
2021-02-26,Glenn,021,27897,2253,2220,496,2716,15
2021-02-26,Humboldt,023,135768,3176,3152,22,3174,30
2021-02-26,Imperial,025,180216,27252,26888,2515,29403,631
2021-02-26,Inyo,027,18085,1305,1271,9,1280,34
2021-02-26,Kern,029,883053,93517,91884,9828,101712,997
2021-02-26,Kings,031,150075,22287,21917,976,22893,216
2021-02-26,Lake,033,64148,3192,3153,6,3159,40
2021-02-26,Lassen,035,31185,5126,5102,97,5199,1
2021-02-26,Los Angeles,037,10098052,1172100,1153131,39354,1192485,21070
2021-02-26,Madera,039,155013,15647,15436,826,16262,199
2021-02-26,Marin,041,260295,13239,13091,164,13255,214
2021-02-26,Mariposa,043,17540,377,375,5,380,4
2021-02-26,Mendocino,045,87422,3640,3549,71,3620,41
2021-02-26,Merced,047,269075,28467,28455,934,29389,382
2021-02-26,Modoc,049,8938,343,330,115,445,3
2021-02-26,Mono,051,14174,1181,1191,16,1207,3
2021-02-26,Monterey,053,433212,41980,41607,1703,43310,322
2021-02-26,Napa,055,140530,9072,9014,34,9048,70
2021-02-26,Nevada,057,99092,4025,3952,162,4114,66
2021-02-26,Orange,059,3164182,247264,245278,10240,255518,3918
2021-02-26,Placer,061,380077,20593,19712,1115,20827,239
2021-02-26,Plumas,063,18699,643,628,10,638,4
2021-02-26,Riverside,065,2383286,285773,278772,13460,292232,3653
2021-02-26,Sacramento,067,1510023,94623,93180,1251,94431,1390
2021-02-26,San Benito,069,59416,5749,5759,91,5850,57
2021-02-26,San Bernardino,071,2135413,286228,281132,8561,289693,3461
2021-02-26,San Diego,073,3302833,264260,259641,12876,272517,3271
2021-02-26,San Francisco,075,870044,34244,34213,1074,35287,413
2021-02-26,San Joaquin,077,732212,66913,65492,2783,68275,1070
2021-02-26,San Luis Obispo,079,281455,19720,19359,561,19920,234
2021-02-26,San Mateo,081,765935,39589,38922,407,39329,313
2021-02-26,Santa Barbara,083,443738,32319,31724,1052,32776,410
2021-02-26,Santa Clara,085,1922200,110538,110168,591,110759,1700
2021-02-26,Santa Cruz,087,273765,15423,14528,782,15310,185
2021-02-26,Shasta,089,179085,10958,10972,1219,12191,149
2021-02-26,Sierra,091,2930,51,47,12,59,0
2021-02-26,Siskiyou,093,43540,1503,1401,237,1638,5
2021-02-26,Solano,095,438530,29861,29651,359,30010,165
2021-02-26,Sonoma,097,501317,28070,28063,214,28277,280
2021-02-26,Stanislaus,099,539301,50741,50054,5362,55416,737
2021-02-26,Sutter,101,95872,8839,8806,81,8887,99
2021-02-26,Tehama,103,63373,4605,4581,495,5076,32
2021-02-26,Trinity,105,12862,467,298,79,377,3
2021-02-26,Tulare,107,460477,48297,47135,8049,55184,770
2021-02-26,Tuolumne,109,53932,3831,3896,33,3929,53
2021-02-26,Ventura,111,848112,77964,77534,2788,80322,765
2021-02-26,Yolo,113,214977,12898,12816,220,13036,188
2021-02-26,Yuba,115,75493,5510,5438,89,5527,39
2021-02-25,Alameda,001,1643700,80964,80181,1738,81919,1093
2021-02-25,Alpine,003,1148,80,77,0,77,0
2021-02-25,Amador,005,37829,3474,3448,30,3478,41
2021-02-25,Butte,007,227075,11342,10922,1616,12538,178
2021-02-25,Calaveras,009,45235,1902,1868,12,1880,46
2021-02-25,Colusa,011,21464,1873,1863,265,2128,11
2021-02-25,Contra Costa,013,1133247,63199,61910,1078,62988,686
2021-02-25,Del Norte,015,27424,1006,966,5,971,5
2021-02-25,El Dorado,017,186661,9147,9012,593,9605,98
2021-02-25,Fresno,019,978130,96393,95015,7727,102742,1377
2021-02-25,Glenn,021,27897,2250,2219,495,2714,15
2021-02-25,Humboldt,023,135768,3169,3129,22,3151,30
2021-02-25,Imperial,025,180216,27245,26855,2511,29366,628
2021-02-25,Inyo,027,18085,1299,1264,9,1273,33
2021-02-25,Kern,029,883053,93401,91735,9803,101538,992
2021-02-25,Kings,031,150075,22278,21900,973,22873,216
2021-02-25,Lake,033,64148,3183,3141,6,3147,40
2021-02-25,Lassen,035,31185,5125,5097,96,5193,1
2021-02-25,Los Angeles,037,10098052,1171356,1151846,39296,1191142,20931
2021-02-25,Madera,039,155013,15612,15414,822,16236,194
2021-02-25,Marin,041,260295,13216,13067,164,13231,214
2021-02-25,Mariposa,043,17540,377,375,5,380,4
2021-02-25,Mendocino,045,87422,3635,3542,71,3613,41
2021-02-25,Merced,047,269075,28418,28383,932,29315,382
2021-02-25,Modoc,049,8938,343,329,115,444,3
2021-02-25,Mono,051,14174,1180,1190,16,1206,3
2021-02-25,Monterey,053,433212,41955,41564,1698,43262,321
2021-02-25,Napa,055,140530,9046,8998,34,9032,70
2021-02-25,Nevada,057,99092,4008,3940,161,4101,66
2021-02-25,Orange,059,3164182,247091,245000,10230,255230,3882
2021-02-25,Placer,061,380077,20554,19661,1113,20774,239
2021-02-25,Plumas,063,18699,643,626,10,636,4
2021-02-25,Riverside,065,2383286,285585,278544,13439,291983,3646
2021-02-25,Sacramento,067,1510023,94465,92961,1239,94200,1386
2021-02-25,San Benito,069,59416,5744,5752,91,5843,58
2021-02-25,San Bernardino,071,2135413,286093,280946,8553,289499,3409
2021-02-25,San Diego,073,3302833,263966,258979,12846,271825,3260
2021-02-25,San Francisco,075,870044,34201,34138,1071,35209,408
2021-02-25,San Joaquin,077,732212,66829,65389,2771,68160,1047
2021-02-25,San Luis Obispo,079,281455,19699,19335,559,19894,234
2021-02-25,San Mateo,081,765935,39542,38872,407,39279,300
2021-02-25,Santa Barbara,083,443738,32242,31631,1051,32682,408
2021-02-25,Santa Clara,085,1922200,110373,109923,590,110513,1677
2021-02-25,Santa Cruz,087,273765,15404,14492,781,15273,185
2021-02-25,Shasta,089,179085,10946,10947,1214,12161,148
2021-02-25,Sierra,091,2930,51,47,12,59,0
2021-02-25,Siskiyou,093,43540,1498,1390,234,1624,4
2021-02-25,Solano,095,438530,29829,29616,359,29975,161
2021-02-25,Sonoma,097,501317,28016,28004,211,28215,278
2021-02-25,Stanislaus,099,539301,50650,49964,5352,55316,738
2021-02-25,Sutter,101,95872,8825,8789,80,8869,99
2021-02-25,Tehama,103,63373,4602,4578,493,5071,32
2021-02-25,Trinity,105,12862,467,297,79,376,3
2021-02-25,Tulare,107,460477,48247,47052,8023,55075,765
2021-02-25,Tuolumne,109,53932,3828,3894,33,3927,53
2021-02-25,Ventura,111,848112,77856,77395,2782,80177,751
2021-02-25,Yolo,113,214977,12881,12787,220,13007,188
2021-02-25,Yuba,115,75493,5503,5429,89,5518,39
2021-02-24,Alameda,001,1643700,80843,80070,1734,81804,1082
2021-02-24,Alpine,003,1148,79,77,0,77,0
2021-02-24,Amador,005,37829,3469,3444,30,3474,41
2021-02-24,Butte,007,227075,11329,10915,1612,12527,178
2021-02-24,Calaveras,009,45235,1898,1864,12,1876,31
2021-02-24,Colusa,011,21464,1871,1863,265,2128,11
2021-02-24,Contra Costa,013,1133247,63091,61776,1078,62854,663
2021-02-24,Del Norte,015,27424,1005,960,4,964,5
2021-02-24,El Dorado,017,186661,9135,8993,593,9586,98
2021-02-24,Fresno,019,978130,96246,94794,7711,102505,1369
2021-02-24,Glenn,021,27897,2249,2210,495,2705,14
2021-02-24,Humboldt,023,135768,3157,3123,22,3145,29
2021-02-24,Imperial,025,180216,27232,26843,2506,29349,596
2021-02-24,Inyo,027,18085,1294,1253,9,1262,32
2021-02-24,Kern,029,883053,93268,91525,9787,101312,992
2021-02-24,Kings,031,150075,22253,21871,971,22842,216
2021-02-24,Lake,033,64148,3176,3134,6,3140,40
2021-02-24,Lassen,035,31185,5121,5095,95,5190,1
2021-02-24,Los Angeles,037,10098052,1170594,1150322,39252,1189574,20817
2021-02-24,Madera,039,155013,15585,15390,822,16212,194
2021-02-24,Marin,041,260295,13193,13044,163,13207,214
2021-02-24,Mariposa,043,17540,377,374,5,379,4
2021-02-24,Mendocino,045,87422,3628,3540,71,3611,41
2021-02-24,Merced,047,269075,28380,28295,927,29222,383
2021-02-24,Modoc,049,8938,342,329,115,444,3
2021-02-24,Mono,051,14174,1178,1189,16,1205,3
2021-02-24,Monterey,053,433212,41930,41495,1696,43191,320
2021-02-24,Napa,055,140530,9029,8976,33,9009,70
2021-02-24,Nevada,057,99092,3998,3927,161,4088,66
2021-02-24,Orange,059,3164182,246874,244743,10217,254960,3835
2021-02-24,Placer,061,380077,20515,19648,1107,20755,239
2021-02-24,Plumas,063,18699,641,626,10,636,4
2021-02-24,Riverside,065,2383286,285357,278293,13430,291723,3603
2021-02-24,Sacramento,067,1510023,94311,92742,1234,93976,1375
2021-02-24,San Benito,069,59416,5743,5743,91,5834,57
2021-02-24,San Bernardino,071,2135413,285941,280583,8549,289132,3360
2021-02-24,San Diego,073,3302833,263671,258460,12830,271290,3230
2021-02-24,San Francisco,075,870044,34155,34061,1068,35129,406
2021-02-24,San Joaquin,077,732212,66719,65274,2769,68043,1019
2021-02-24,San Luis Obispo,079,281455,19676,19309,557,19866,233
2021-02-24,San Mateo,081,765935,39505,38763,407,39170,300
2021-02-24,Santa Barbara,083,443738,32190,31563,1048,32611,405
2021-02-24,Santa Clara,085,1922200,110225,109671,589,110260,1674
2021-02-24,Santa Cruz,087,273765,15383,14458,781,15239,185
2021-02-24,Shasta,089,179085,10932,10922,1211,12133,148
2021-02-24,Sierra,091,2930,51,47,12,59,0
2021-02-24,Siskiyou,093,43540,1491,1385,230,1615,4
2021-02-24,Solano,095,438530,29789,29577,357,29934,158
2021-02-24,Sonoma,097,501317,27952,27954,207,28161,278
2021-02-24,Stanislaus,099,539301,50579,49851,5344,55195,732
2021-02-24,Sutter,101,95872,8815,8778,80,8858,99
2021-02-24,Tehama,103,63373,4600,4566,493,5059,31
2021-02-24,Trinity,105,12862,467,294,78,372,3
2021-02-24,Tulare,107,460477,48191,46976,7995,54971,759
2021-02-24,Tuolumne,109,53932,3825,3887,33,3920,53
2021-02-24,Ventura,111,848112,77748,77238,2781,80019,718
2021-02-24,Yolo,113,214977,12868,12760,216,12976,188
2021-02-24,Yuba,115,75493,5492,5425,87,5512,39
2021-02-23,Alameda,001,1643700,80705,79948,1732,81680,1070
2021-02-23,Alpine,003,1148,78,77,0,77,0
2021-02-23,Amador,005,37829,3467,3440,30,3470,41
2021-02-23,Butte,007,227075,11313,10887,1609,12496,176
2021-02-23,Calaveras,009,45235,1897,1863,12,1875,21
2021-02-23,Colusa,011,21464,1868,1862,265,2127,11
2021-02-23,Contra Costa,013,1133247,62957,61613,1075,62688,661
2021-02-23,Del Norte,015,27424,1003,953,4,957,3
2021-02-23,El Dorado,017,186661,9122,8969,593,9562,96
2021-02-23,Fresno,019,978130,96085,94741,7697,102438,1356
2021-02-23,Glenn,021,27897,2247,2209,495,2704,14
2021-02-23,Humboldt,023,135768,3140,3108,22,3130,29
2021-02-23,Imperial,025,180216,27212,26816,2501,29317,591
2021-02-23,Inyo,027,18085,1290,1250,9,1259,32
2021-02-23,Kern,029,883053,93129,91390,9758,101148,982
2021-02-23,Kings,031,150075,22238,21839,967,22806,216
2021-02-23,Lake,033,64148,3168,3121,6,3127,40
2021-02-23,Lassen,035,31185,5118,5092,95,5187,1
2021-02-23,Los Angeles,037,10098052,1169724,1148965,39198,1188163,19887
2021-02-23,Madera,039,155013,15571,15352,816,16168,193
2021-02-23,Marin,041,260295,13173,13015,162,13177,214
2021-02-23,Mariposa,043,17540,377,374,5,379,4
2021-02-23,Mendocino,045,87422,3626,3540,70,3610,41
2021-02-23,Merced,047,269075,28300,28209,920,29129,381
2021-02-23,Modoc,049,8938,341,328,114,442,3
2021-02-23,Mono,051,14174,1178,1189,16,1205,3
2021-02-23,Monterey,053,433212,41890,41439,1691,43130,317
2021-02-23,Napa,055,140530,9017,8967,33,9000,70
2021-02-23,Nevada,057,99092,3990,3912,161,4073,66
2021-02-23,Orange,059,3164182,246676,244566,10198,254764,3843
2021-02-23,Placer,061,380077,20490,19608,1103,20711,238
2021-02-23,Plumas,063,18699,640,626,10,636,4
2021-02-23,Riverside,065,2383286,285120,278075,13415,291490,3599
2021-02-23,Sacramento,067,1510023,94154,92632,1228,93860,1370
2021-02-23,San Benito,069,59416,5737,5731,90,5821,57
2021-02-23,San Bernardino,071,2135413,285751,280279,8544,288823,3283
2021-02-23,San Diego,073,3302833,263294,257802,12800,270602,3218
2021-02-23,San Francisco,075,870044,34107,33994,1067,35061,405
2021-02-23,San Joaquin,077,732212,66619,65141,2762,67903,1004
2021-02-23,San Luis Obispo,079,281455,19647,19233,556,19789,230
2021-02-23,San Mateo,081,765935,39444,38662,407,39069,299
2021-02-23,Santa Barbara,083,443738,32135,31483,1046,32529,402
2021-02-23,Santa Clara,085,1922200,110028,109449,586,110035,1661
2021-02-23,Santa Cruz,087,273765,15354,14435,779,15214,178
2021-02-23,Shasta,089,179085,10920,10903,1207,12110,146
2021-02-23,Sierra,091,2930,51,47,12,59,0
2021-02-23,Siskiyou,093,43540,1486,1380,228,1608,4
2021-02-23,Solano,095,438530,29749,29545,354,29899,154
2021-02-23,Sonoma,097,501317,27909,27882,204,28086,278
2021-02-23,Stanislaus,099,539301,50501,49749,5328,55077,722
2021-02-23,Sutter,101,95872,8802,8766,80,8846,98
2021-02-23,Tehama,103,63373,4594,4556,492,5048,30
2021-02-23,Trinity,105,12862,467,292,77,369,3
2021-02-23,Tulare,107,460477,48113,46937,7961,54898,757
2021-02-23,Tuolumne,109,53932,3821,3864,33,3897,53
2021-02-23,Ventura,111,848112,77632,77093,2772,79865,689
2021-02-23,Yolo,113,214977,12839,12729,216,12945,188
2021-02-23,Yuba,115,75493,5479,5417,86,5503,38
2021-02-22,Alameda,001,1643700,80554,79796,1728,81524,1062
2021-02-22,Alpine,003,1148,78,77,0,77,0
2021-02-22,Amador,005,37829,3462,3438,30,3468,39
2021-02-22,Butte,007,227075,11300,10855,1604,12459,176
2021-02-22,Calaveras,009,45235,1895,1862,12,1874,21
2021-02-22,Colusa,011,21464,1868,1860,265,2125,11
2021-02-22,Contra Costa,013,1133247,62828,61478,1074,62552,661
2021-02-22,Del Norte,015,27424,1002,948,4,952,3
2021-02-22,El Dorado,017,186661,9105,8940,593,9533,96
2021-02-22,Fresno,019,978130,95923,94584,7680,102264,1351
2021-02-22,Glenn,021,27897,2242,2207,493,2700,14
2021-02-22,Humboldt,023,135768,3128,3095,22,3117,29
2021-02-22,Imperial,025,180216,27190,26778,2494,29272,590
2021-02-22,Inyo,027,18085,1285,1248,9,1257,32
2021-02-22,Kern,029,883053,93012,91201,9736,100937,982
2021-02-22,Kings,031,150075,22215,21801,964,22765,214
2021-02-22,Lake,033,64148,3162,3107,6,3113,40
2021-02-22,Lassen,035,31185,5118,5088,94,5182,1
2021-02-22,Los Angeles,037,10098052,1168852,1147541,39141,1186682,19730
2021-02-22,Madera,039,155013,15546,15325,812,16137,193
2021-02-22,Marin,041,260295,13148,12991,159,13150,213
2021-02-22,Mariposa,043,17540,376,374,5,379,4
2021-02-22,Mendocino,045,87422,3620,3535,70,3605,41
2021-02-22,Merced,047,269075,28237,28166,917,29083,379
2021-02-22,Modoc,049,8938,341,329,114,443,3
2021-02-22,Mono,051,14174,1174,1189,16,1205,3
2021-02-22,Monterey,053,433212,41845,41397,1685,43082,311
2021-02-22,Napa,055,140530,8990,8950,33,8983,69
2021-02-22,Nevada,057,99092,3981,3900,159,4059,66
2021-02-22,Orange,059,3164182,246440,244118,10180,254298,3843
2021-02-22,Placer,061,380077,20453,19587,1095,20682,238
2021-02-22,Plumas,063,18699,640,625,10,635,4
2021-02-22,Riverside,065,2383286,284857,277730,13407,291137,3567
2021-02-22,Sacramento,067,1510023,93987,92476,1217,93693,1359
2021-02-22,San Benito,069,59416,5735,5723,90,5813,57
2021-02-22,San Bernardino,071,2135413,285572,279984,8531,288515,3259
2021-02-22,San Diego,073,3302833,262884,257348,12767,270115,3189
2021-02-22,San Francisco,075,870044,34047,33947,1062,35009,405
2021-02-22,San Joaquin,077,732212,66523,65060,2749,67809,1001
2021-02-22,San Luis Obispo,079,281455,19610,19198,554,19752,229
2021-02-22,San Mateo,081,765935,39387,38542,404,38946,282
2021-02-22,Santa Barbara,083,443738,32069,31421,1043,32464,399
2021-02-22,Santa Clara,085,1922200,109819,109213,575,109788,1655
2021-02-22,Santa Cruz,087,273765,15328,14417,779,15196,176
2021-02-22,Shasta,089,179085,10905,10872,1202,12074,145
2021-02-22,Sierra,091,2930,51,47,12,59,0
2021-02-22,Siskiyou,093,43540,1480,1373,227,1600,4
2021-02-22,Solano,095,438530,29710,29508,353,29861,150
2021-02-22,Sonoma,097,501317,27864,27845,203,28048,278
2021-02-22,Stanislaus,099,539301,50400,49630,5310,54940,722
2021-02-22,Sutter,101,95872,8794,8698,80,8778,98
2021-02-22,Tehama,103,63373,4590,4550,491,5041,30
2021-02-22,Trinity,105,12862,467,287,76,363,3
2021-02-22,Tulare,107,460477,48051,46879,7929,54808,751
2021-02-22,Tuolumne,109,53932,3817,3856,33,3889,53
2021-02-22,Ventura,111,848112,77504,76947,2767,79714,677
2021-02-22,Yolo,113,214977,12812,12689,216,12905,183
2021-02-22,Yuba,115,75493,5476,5404,85,5489,38
2021-02-21,Alameda,001,1643700,80362,79649,1723,81372,1061
2021-02-21,Alpine,003,1148,78,77,0,77,0
2021-02-21,Amador,005,37829,3454,3435,30,3465,39
2021-02-21,Butte,007,227075,11282,10855,1602,12457,176
2021-02-21,Calaveras,009,45235,1894,1860,12,1872,21
2021-02-21,Colusa,011,21464,1867,1860,261,2121,11
2021-02-21,Contra Costa,013,1133247,62672,61364,1071,62435,661
2021-02-21,Del Norte,015,27424,996,942,4,946,3
2021-02-21,El Dorado,017,186661,9087,8927,592,9519,96
2021-02-21,Fresno,019,978130,95781,94374,7662,102036,1349
2021-02-21,Glenn,021,27897,2240,2201,491,2692,14
2021-02-21,Humboldt,023,135768,3116,3096,22,3118,29
2021-02-21,Imperial,025,180216,27176,26779,2492,29271,590
2021-02-21,Inyo,027,18085,1279,1232,9,1241,32
2021-02-21,Kern,029,883053,92887,91141,9698,100839,980
2021-02-21,Kings,031,150075,22179,21784,962,22746,213
2021-02-21,Lake,033,64148,3154,3100,6,3106,40
2021-02-21,Lassen,035,31185,5110,5077,94,5171,1
2021-02-21,Los Angeles,037,10098052,1167816,1146756,39093,1185849,19711
2021-02-21,Madera,039,155013,15513,15298,809,16107,192
2021-02-21,Marin,041,260295,13119,12968,159,13127,212
2021-02-21,Mariposa,043,17540,376,373,5,378,4
2021-02-21,Mendocino,045,87422,3615,3535,70,3605,41
2021-02-21,Merced,047,269075,28163,28106,901,29007,379
2021-02-21,Modoc,049,8938,338,329,114,443,3
2021-02-21,Mono,051,14174,1174,1189,16,1205,3
2021-02-21,Monterey,053,433212,41789,41373,1678,43051,309
2021-02-21,Napa,055,140530,8976,8929,33,8962,69
2021-02-21,Nevada,057,99092,3968,3895,159,4054,66
2021-02-21,Orange,059,3164182,246143,243985,10163,254148,3801
2021-02-21,Placer,061,380077,20417,19553,1091,20644,238
2021-02-21,Plumas,063,18699,640,625,10,635,4
2021-02-21,Riverside,065,2383286,284623,277555,13394,290949,3564
2021-02-21,Sacramento,067,1510023,93777,92288,1204,93492,1354
2021-02-21,San Benito,069,59416,5725,5716,87,5803,57
2021-02-21,San Bernardino,071,2135413,285347,279870,8517,288387,3247
2021-02-21,San Diego,073,3302833,262450,257027,12721,269748,3190
2021-02-21,San Francisco,075,870044,33983,33891,1058,34949,405
2021-02-21,San Joaquin,077,732212,66383,64997,2737,67734,1001
2021-02-21,San Luis Obispo,079,281455,19577,19178,552,19730,229
2021-02-21,San Mateo,081,765935,39325,38448,400,38848,282
2021-02-21,Santa Barbara,083,443738,32007,31374,1040,32414,399
2021-02-21,Santa Clara,085,1922200,109593,108992,566,109558,1654
2021-02-21,Santa Cruz,087,273765,15305,14401,778,15179,176
2021-02-21,Shasta,089,179085,10891,10867,1197,12064,145
2021-02-21,Sierra,091,2930,51,47,12,59,0
2021-02-21,Siskiyou,093,43540,1474,1371,227,1598,4
2021-02-21,Solano,095,438530,29655,29471,352,29823,150
2021-02-21,Sonoma,097,501317,27800,27793,196,27989,278
2021-02-21,Stanislaus,099,539301,50287,49527,5296,54823,726
2021-02-21,Sutter,101,95872,8777,8687,79,8766,97
2021-02-21,Tehama,103,63373,4581,4547,491,5038,30
2021-02-21,Trinity,105,12862,465,286,76,362,3
2021-02-21,Tulare,107,460477,47983,46830,7894,54724,749
2021-02-21,Tuolumne,109,53932,3803,3828,33,3861,53
2021-02-21,Ventura,111,848112,77355,76862,2753,79615,677
2021-02-21,Yolo,113,214977,12781,12670,216,12886,183
2021-02-21,Yuba,115,75493,5468,5396,84,5480,38
2021-02-20,Alameda,001,1643700,80271,79496,1718,81214,1055
2021-02-20,Alpine,003,1148,78,77,0,77,0
2021-02-20,Amador,005,37829,3452,3432,30,3462,39
2021-02-20,Butte,007,227075,11274,10838,1601,12439,176
2021-02-20,Calaveras,009,45235,1893,1858,12,1870,21
2021-02-20,Colusa,011,21464,1866,1858,261,2119,11
2021-02-20,Contra Costa,013,1133247,62588,61205,1069,62274,663
2021-02-20,Del Norte,015,27424,992,937,4,941,3
2021-02-20,El Dorado,017,186661,9077,8911,592,9503,96
2021-02-20,Fresno,019,978130,95697,94234,7642,101876,1341
2021-02-20,Glenn,021,27897,2236,2199,490,2689,14
2021-02-20,Humboldt,023,135768,3108,3073,22,3095,29
2021-02-20,Imperial,025,180216,27166,26771,2492,29263,590
2021-02-20,Inyo,027,18085,1275,1226,9,1235,32
2021-02-20,Kern,029,883053,92816,91025,9666,100691,968
2021-02-20,Kings,031,150075,22161,21773,961,22734,212
2021-02-20,Lake,033,64148,3147,3089,6,3095,40
2021-02-20,Lassen,035,31185,5108,5067,94,5161,1
2021-02-20,Los Angeles,037,10098052,1167250,1145594,39049,1184643,19630
2021-02-20,Madera,039,155013,15493,15274,808,16082,191
2021-02-20,Marin,041,260295,13098,12945,157,13102,211
2021-02-20,Mariposa,043,17540,376,372,5,377,4
2021-02-20,Mendocino,045,87422,3613,3533,70,3603,40
2021-02-20,Merced,047,269075,28120,28066,898,28964,379
2021-02-20,Modoc,049,8938,338,328,114,442,3
2021-02-20,Mono,051,14174,1173,1187,16,1203,3
2021-02-20,Monterey,053,433212,41767,41313,1676,42989,309
2021-02-20,Napa,055,140530,8967,8910,33,8943,69
2021-02-20,Nevada,057,99092,3958,3887,158,4045,66
2021-02-20,Orange,059,3164182,245973,243761,10150,253911,3755
2021-02-20,Placer,061,380077,20376,19509,1087,20596,236
2021-02-20,Plumas,063,18699,640,626,10,636,4
2021-02-20,Riverside,065,2383286,284469,277267,13385,290652,3559
2021-02-20,Sacramento,067,1510023,93654,92057,1202,93259,1352
2021-02-20,San Benito,069,59416,5714,5709,87,5796,57
2021-02-20,San Bernardino,071,2135413,285245,279608,8512,288120,3203
2021-02-20,San Diego,073,3302833,262208,256510,12692,269202,3188
2021-02-20,San Francisco,075,870044,33941,33820,1049,34869,399
2021-02-20,San Joaquin,077,732212,66313,64916,2732,67648,1001
2021-02-20,San Luis Obispo,079,281455,19553,19138,551,19689,229
2021-02-20,San Mateo,081,765935,39281,38371,399,38770,282
2021-02-20,Santa Barbara,083,443738,31973,31289,1039,32328,396
2021-02-20,Santa Clara,085,1922200,109415,108728,563,109291,1649
2021-02-20,Santa Cruz,087,273765,15294,14378,776,15154,176
2021-02-20,Shasta,089,179085,10877,10850,1192,12042,146
2021-02-20,Sierra,091,2930,51,47,12,59,0
2021-02-20,Siskiyou,093,43540,1471,1366,227,1593,4
2021-02-20,Solano,095,438530,29641,29440,350,29790,150
2021-02-20,Sonoma,097,501317,27771,27703,194,27897,278
2021-02-20,Stanislaus,099,539301,50236,49445,5282,54727,733
2021-02-20,Sutter,101,95872,8771,8681,79,8760,97
2021-02-20,Tehama,103,63373,4577,4545,491,5036,30
2021-02-20,Trinity,105,12862,464,285,75,360,3
2021-02-20,Tulare,107,460477,47947,46769,7872,54641,739
2021-02-20,Tuolumne,109,53932,3798,3823,33,3856,53
2021-02-20,Ventura,111,848112,77260,76757,2750,79507,671
2021-02-20,Yolo,113,214977,12767,12639,215,12854,183
2021-02-20,Yuba,115,75493,5465,5386,84,5470,38
2021-02-19,Alameda,001,1643700,80170,79318,1714,81032,1047
2021-02-19,Alpine,003,1148,78,77,0,77,0
2021-02-19,Amador,005,37829,3448,3427,30,3457,39
2021-02-19,Butte,007,227075,11260,10823,1594,12417,176
2021-02-19,Calaveras,009,45235,1892,1856,12,1868,21
2021-02-19,Colusa,011,21464,1866,1858,261,2119,11
2021-02-19,Contra Costa,013,1133247,62476,61017,1066,62083,651
2021-02-19,Del Norte,015,27424,987,932,4,936,2
2021-02-19,El Dorado,017,186661,9068,8882,591,9473,96
2021-02-19,Fresno,019,978130,95566,93973,7626,101599,1330
2021-02-19,Glenn,021,27897,2231,2199,489,2688,14
2021-02-19,Humboldt,023,135768,3096,3037,22,3059,29
2021-02-19,Imperial,025,180216,27160,26751,2489,29240,589
2021-02-19,Inyo,027,18085,1270,1212,9,1221,32
2021-02-19,Kern,029,883053,92747,90807,9625,100432,963
2021-02-19,Kings,031,150075,22147,21724,959,22683,211
2021-02-19,Lake,033,64148,3141,3078,6,3084,40
2021-02-19,Lassen,035,31185,5107,5057,94,5151,1
2021-02-19,Los Angeles,037,10098052,1166502,1143828,39008,1182836,19498
2021-02-19,Madera,039,155013,15476,15222,806,16028,188
2021-02-19,Marin,041,260295,13080,12919,156,13075,210
2021-02-19,Mariposa,043,17540,376,371,5,376,4
2021-02-19,Mendocino,045,87422,3611,3526,70,3596,39
2021-02-19,Merced,047,269075,28090,27985,895,28880,376
2021-02-19,Modoc,049,8938,338,328,114,442,3
2021-02-19,Mono,051,14174,1173,1186,16,1202,3
2021-02-19,Monterey,053,433212,41740,41209,1672,42881,309
2021-02-19,Napa,055,140530,8954,8899,33,8932,69
2021-02-19,Nevada,057,99092,3952,3863,158,4021,66
2021-02-19,Orange,059,3164182,245797,243397,10137,253534,3715
2021-02-19,Placer,061,380077,20354,19457,1087,20544,236
2021-02-19,Plumas,063,18699,638,624,10,634,4
2021-02-19,Riverside,065,2383286,284300,276941,13368,290309,3541
2021-02-19,Sacramento,067,1510023,93533,91815,1198,93013,1351
2021-02-19,San Benito,069,59416,5709,5699,87,5786,57
2021-02-19,San Bernardino,071,2135413,285109,279209,8507,287716,3117
2021-02-19,San Diego,073,3302833,261917,255799,12669,268468,3169
2021-02-19,San Francisco,075,870044,33893,33746,1043,34789,387
2021-02-19,San Joaquin,077,732212,66237,64774,2723,67497,988
2021-02-19,San Luis Obispo,079,281455,19522,19061,549,19610,230
2021-02-19,San Mateo,081,765935,39223,38256,397,38653,282
2021-02-19,Santa Barbara,083,443738,31909,31204,1038,32242,392
2021-02-19,Santa Clara,085,1922200,109203,108400,561,108961,1634
2021-02-19,Santa Cruz,087,273765,15279,14354,776,15130,176
2021-02-19,Shasta,089,179085,10866,10833,1189,12022,140
2021-02-19,Sierra,091,2930,51,47,12,59,0
2021-02-19,Siskiyou,093,43540,1467,1363,225,1588,4
2021-02-19,Solano,095,438530,29616,29383,349,29732,150
2021-02-19,Sonoma,097,501317,27724,27595,192,27787,280
2021-02-19,Stanislaus,099,539301,50175,49282,5266,54548,739
2021-02-19,Sutter,101,95872,8761,8665,79,8744,96
2021-02-19,Tehama,103,63373,4575,4535,491,5026,30
2021-02-19,Trinity,105,12862,462,282,73,355,3
2021-02-19,Tulare,107,460477,47902,46662,7847,54509,736
2021-02-19,Tuolumne,109,53932,3791,3817,33,3850,52
2021-02-19,Ventura,111,848112,77181,76582,2747,79329,667
2021-02-19,Yolo,113,214977,12751,12606,215,12821,183
2021-02-19,Yuba,115,75493,5455,5376,84,5460,38
2021-02-18,Alameda,001,1643700,80036,79111,1706,80817,1012
2021-02-18,Alpine,003,1148,78,77,0,77,0
2021-02-18,Amador,005,37829,3444,3417,29,3446,38
2021-02-18,Butte,007,227075,11242,10791,1592,12383,175
2021-02-18,Calaveras,009,45235,1887,1873,12,1885,21
2021-02-18,Colusa,011,21464,1864,1856,259,2115,11
2021-02-18,Contra Costa,013,1133247,62361,60868,1064,61932,640
2021-02-18,Del Norte,015,27424,982,929,4,933,2
2021-02-18,El Dorado,017,186661,9053,8850,590,9440,94
2021-02-18,Fresno,019,978130,95396,93734,7601,101335,1323
2021-02-18,Glenn,021,27897,2225,2195,489,2684,14
2021-02-18,Humboldt,023,135768,3084,3023,22,3045,29
2021-02-18,Imperial,025,180216,27134,26731,2482,29213,591
2021-02-18,Inyo,027,18085,1266,1213,8,1221,32
2021-02-18,Kern,029,883053,92593,90655,9595,100250,961
2021-02-18,Kings,031,150075,22123,21648,958,22606,211
2021-02-18,Lake,033,64148,3136,3066,6,3072,40
2021-02-18,Lassen,035,31185,5098,5052,94,5146,1
2021-02-18,Los Angeles,037,10098052,1165544,1141930,38943,1180873,19358
2021-02-18,Madera,039,155013,15454,15175,801,15976,188
2021-02-18,Marin,041,260295,13067,12895,155,13050,209
2021-02-18,Mariposa,043,17540,375,369,5,374,4
2021-02-18,Mendocino,045,87422,3608,3519,69,3588,39
2021-02-18,Merced,047,269075,28041,27870,889,28759,372
2021-02-18,Modoc,049,8938,336,327,113,440,3
2021-02-18,Mono,051,14174,1173,1182,16,1198,3
2021-02-18,Monterey,053,433212,41682,41091,1663,42754,307
2021-02-18,Napa,055,140530,8937,8877,33,8910,68
2021-02-18,Nevada,057,99092,3943,3836,157,3993,66
2021-02-18,Orange,059,3164182,245574,243098,10120,253218,3673
2021-02-18,Placer,061,380077,20327,19429,1086,20515,232
2021-02-18,Plumas,063,18699,638,624,10,634,4
2021-02-18,Riverside,065,2383286,284012,276595,13347,289942,3510
2021-02-18,Sacramento,067,1510023,93371,91476,1192,92668,1334
2021-02-18,San Benito,069,59416,5706,5697,86,5783,58
2021-02-18,San Bernardino,071,2135413,284899,278887,8493,287380,3066
2021-02-18,San Diego,073,3302833,261563,254987,12646,267633,3135
2021-02-18,San Francisco,075,870044,33835,33650,1040,34690,386
2021-02-18,San Joaquin,077,732212,66154,64634,2713,67347,982
2021-02-18,San Luis Obispo,079,281455,19480,18987,546,19533,230
2021-02-18,San Mateo,081,765935,39161,38185,393,38578,282
2021-02-18,Santa Barbara,083,443738,31831,31054,1031,32085,387
2021-02-18,Santa Clara,085,1922200,108978,108210,558,108768,1605
2021-02-18,Santa Cruz,087,273765,15253,14314,776,15090,176
2021-02-18,Shasta,089,179085,10848,10811,1186,11997,139
2021-02-18,Sierra,091,2930,50,47,12,59,0
2021-02-18,Siskiyou,093,43540,1462,1359,224,1583,4
2021-02-18,Solano,095,438530,29590,29349,348,29697,150
2021-02-18,Sonoma,097,501317,27656,27512,191,27703,281
2021-02-18,Stanislaus,099,539301,50074,49150,5249,54399,738
2021-02-18,Sutter,101,95872,8753,8654,79,8733,96
2021-02-18,Tehama,103,63373,4572,4528,491,5019,30
2021-02-18,Trinity,105,12862,461,282,73,355,3
2021-02-18,Tulare,107,460477,47839,46591,7807,54398,728
2021-02-18,Tuolumne,109,53932,3754,3811,33,3844,52
2021-02-18,Ventura,111,848112,77049,76442,2739,79181,659
2021-02-18,Yolo,113,214977,12725,12549,212,12761,183
2021-02-18,Yuba,115,75493,5438,5358,84,5442,38
2021-02-17,Alameda,001,1643700,79875,78895,1704,80599,1002
2021-02-17,Alpine,003,1148,78,77,0,77,0
2021-02-17,Amador,005,37829,3440,3415,29,3444,38
2021-02-17,Butte,007,227075,11224,10770,1588,12358,174
2021-02-17,Calaveras,009,45235,1887,1876,12,1888,21
2021-02-17,Colusa,011,21464,1861,1854,259,2113,10
2021-02-17,Contra Costa,013,1133247,62223,60723,1061,61784,635
2021-02-17,Del Norte,015,27424,975,920,4,924,2
2021-02-17,El Dorado,017,186661,9042,8847,590,9437,94
2021-02-17,Fresno,019,978130,95257,93555,7574,101129,1307
2021-02-17,Glenn,021,27897,2224,2189,488,2677,14
2021-02-17,Humboldt,023,135768,3069,3006,22,3028,29
2021-02-17,Imperial,025,180216,27120,26726,2478,29204,580
2021-02-17,Inyo,027,18085,1258,1197,8,1205,32
2021-02-17,Kern,029,883053,92475,90454,9550,100004,962
2021-02-17,Kings,031,150075,22085,21617,954,22571,211
2021-02-17,Lake,033,64148,3126,3057,2,3059,38
2021-02-17,Lassen,035,31185,5093,5052,93,5145,1
2021-02-17,Los Angeles,037,10098052,1164492,1139786,38879,1178665,19213
2021-02-17,Madera,039,155013,15429,15135,792,15927,177
2021-02-17,Marin,041,260295,13042,12881,155,13036,207
2021-02-17,Mariposa,043,17540,375,368,4,372,4
2021-02-17,Mendocino,045,87422,3606,3494,68,3562,39
2021-02-17,Merced,047,269075,27986,27824,880,28704,372
2021-02-17,Modoc,049,8938,336,327,113,440,3
2021-02-17,Mono,051,14174,1173,1180,16,1196,3
2021-02-17,Monterey,053,433212,41627,41014,1651,42665,304
2021-02-17,Napa,055,140530,8923,8865,33,8898,68
2021-02-17,Nevada,057,99092,3924,3822,154,3976,52
2021-02-17,Orange,059,3164182,245311,242716,10087,252803,3626
2021-02-17,Placer,061,380077,20294,19405,1082,20487,230
2021-02-17,Plumas,063,18699,637,623,10,633,4
2021-02-17,Riverside,065,2383286,283724,276289,13326,289615,3491
2021-02-17,Sacramento,067,1510023,93212,91309,1185,92494,1326
2021-02-17,San Benito,069,59416,5700,5661,86,5747,57
2021-02-17,San Bernardino,071,2135413,284695,278461,8474,286935,3020
2021-02-17,San Diego,073,3302833,261185,254177,12625,266802,3099
2021-02-17,San Francisco,075,870044,33759,33558,1035,34593,379
2021-02-17,San Joaquin,077,732212,66048,64556,2707,67263,979
2021-02-17,San Luis Obispo,079,281455,19435,18964,546,19510,230
2021-02-17,San Mateo,081,765935,39095,38124,392,38516,282
2021-02-17,Santa Barbara,083,443738,31763,30927,1030,31957,384
2021-02-17,Santa Clara,085,1922200,108746,107949,556,108505,1592
2021-02-17,Santa Cruz,087,273765,15220,14268,773,15041,174
2021-02-17,Shasta,089,179085,10828,10770,1185,11955,139
2021-02-17,Sierra,091,2930,50,47,12,59,0
2021-02-17,Siskiyou,093,43540,1456,1352,221,1573,4
2021-02-17,Solano,095,438530,29533,29288,348,29636,149
2021-02-17,Sonoma,097,501317,27584,27408,186,27594,281
2021-02-17,Stanislaus,099,539301,49963,49050,5233,54283,730
2021-02-17,Sutter,101,95872,8743,8681,79,8760,95
2021-02-17,Tehama,103,63373,4569,4511,491,5002,30
2021-02-17,Trinity,105,12862,461,277,71,348,3
2021-02-17,Tulare,107,460477,47774,46495,7781,54276,726
2021-02-17,Tuolumne,109,53932,3745,3806,33,3839,49
2021-02-17,Ventura,111,848112,76927,76234,2733,78967,646
2021-02-17,Yolo,113,214977,12706,12506,210,12716,182
2021-02-17,Yuba,115,75493,5429,5345,84,5429,38
2021-02-16,Alameda,001,1643700,79705,78756,1701,80457,997
2021-02-16,Alpine,003,1148,78,76,0,76,0
2021-02-16,Amador,005,37829,3433,3413,29,3442,39
2021-02-16,Butte,007,227075,11198,10748,1585,12333,164
2021-02-16,Calaveras,009,45235,1885,1872,12,1884,21
2021-02-16,Colusa,011,21464,1858,1852,257,2109,10
2021-02-16,Contra Costa,013,1133247,62072,60564,1056,61620,631
2021-02-16,Del Norte,015,27424,967,913,4,917,2
2021-02-16,El Dorado,017,186661,9032,8836,589,9425,94
2021-02-16,Fresno,019,978130,95092,93363,7544,100907,1293
2021-02-16,Glenn,021,27897,2220,2189,484,2673,14
2021-02-16,Humboldt,023,135768,3046,2994,21,3015,29
2021-02-16,Imperial,025,180216,27107,26711,2474,29185,580
2021-02-16,Inyo,027,18085,1250,1191,8,1199,32
2021-02-16,Kern,029,883053,92343,90267,9520,99787,959
2021-02-16,Kings,031,150075,22039,21583,950,22533,206
2021-02-16,Lake,033,64148,3119,3041,2,3043,38
2021-02-16,Lassen,035,31185,5081,5047,93,5140,1
2021-02-16,Los Angeles,037,10098052,1163238,1138262,38818,1177080,19044
2021-02-16,Madera,039,155013,15391,15120,787,15907,172
2021-02-16,Marin,041,260295,13014,12832,155,12987,205
2021-02-16,Mariposa,043,17540,375,367,4,371,4
2021-02-16,Mendocino,045,87422,3602,3489,68,3557,39
2021-02-16,Merced,047,269075,27905,27724,874,28598,368
2021-02-16,Modoc,049,8938,336,326,113,439,3
2021-02-16,Mono,051,14174,1173,1180,16,1196,3
2021-02-16,Monterey,053,433212,41551,40962,1642,42604,303
2021-02-16,Napa,055,140530,8910,8854,33,8887,66
2021-02-16,Nevada,057,99092,3911,3774,153,3927,47
2021-02-16,Orange,059,3164182,244989,242382,10071,252453,3612
2021-02-16,Placer,061,380077,20261,19367,1079,20446,230
2021-02-16,Plumas,063,18699,637,619,10,629,4
2021-02-16,Riverside,065,2383286,283420,275954,13303,289257,3471
2021-02-16,Sacramento,067,1510023,92958,91246,1179,92425,1305
2021-02-16,San Benito,069,59416,5692,5659,85,5744,56
2021-02-16,San Bernardino,071,2135413,284473,277947,8463,286410,2978
2021-02-16,San Diego,073,3302833,260720,253638,12586,266224,3042
2021-02-16,San Francisco,075,870044,33688,33491,1030,34521,373
2021-02-16,San Joaquin,077,732212,65918,64448,2704,67152,979
2021-02-16,San Luis Obispo,079,281455,19390,18925,543,19468,229
2021-02-16,San Mateo,081,765935,39036,38041,390,38431,277
2021-02-16,Santa Barbara,083,443738,31689,30865,1027,31892,378
2021-02-16,Santa Clara,085,1922200,108494,107754,553,108307,1591
2021-02-16,Santa Cruz,087,273765,15200,14256,772,15028,174
2021-02-16,Shasta,089,179085,10813,10736,1183,11919,139
2021-02-16,Sierra,091,2930,50,47,12,59,0
2021-02-16,Siskiyou,093,43540,1452,1351,221,1572,4
2021-02-16,Solano,095,438530,29495,29246,347,29593,148
2021-02-16,Sonoma,097,501317,27525,27380,180,27560,279
2021-02-16,Stanislaus,099,539301,49839,48927,5219,54146,716
2021-02-16,Sutter,101,95872,8720,8671,79,8750,95
2021-02-16,Tehama,103,63373,4560,4501,489,4990,30
2021-02-16,Trinity,105,12862,457,275,71,346,3
2021-02-16,Tulare,107,460477,47710,46444,7737,54181,716
2021-02-16,Tuolumne,109,53932,3743,3796,33,3829,49
2021-02-16,Ventura,111,848112,76785,76043,2729,78772,631
2021-02-16,Yolo,113,214977,12677,12457,210,12667,175
2021-02-16,Yuba,115,75493,5422,5332,83,5415,38
2021-02-15,Alameda,001,1643700,79508,78647,1690,80337,996
2021-02-15,Alpine,003,1148,78,76,0,76,0
2021-02-15,Amador,005,37829,3429,3409,29,3438,39
2021-02-15,Butte,007,227075,11180,10723,1581,12304,155
2021-02-15,Calaveras,009,45235,1881,1871,12,1883,21
2021-02-15,Colusa,011,21464,1858,1849,253,2102,10
2021-02-15,Contra Costa,013,1133247,61900,60444,1050,61494,631
2021-02-15,Del Norte,015,27424,963,913,4,917,2
2021-02-15,El Dorado,017,186661,9015,8816,589,9405,94
2021-02-15,Fresno,019,978130,94893,93231,7505,100736,1288
2021-02-15,Glenn,021,27897,2218,2185,483,2668,14
2021-02-15,Humboldt,023,135768,3039,2997,21,3018,29
2021-02-15,Imperial,025,180216,27087,26700,2471,29171,580
2021-02-15,Inyo,027,18085,1231,1184,8,1192,32
2021-02-15,Kern,029,883053,92199,90181,9488,99669,959
2021-02-15,Kings,031,150075,21994,21574,946,22520,205
2021-02-15,Lake,033,64148,3105,3030,1,3031,38
2021-02-15,Lassen,035,31185,5079,5047,92,5139,1
2021-02-15,Los Angeles,037,10098052,1161848,1137164,38755,1175919,18925
2021-02-15,Madera,039,155013,15360,15108,785,15893,106
2021-02-15,Marin,041,260295,12993,12810,152,12962,203
2021-02-15,Mariposa,043,17540,373,367,4,371,4
2021-02-15,Mendocino,045,87422,3590,3481,68,3549,39
2021-02-15,Merced,047,269075,27831,27656,866,28522,368
2021-02-15,Modoc,049,8938,336,326,113,439,3
2021-02-15,Mono,051,14174,1170,1178,16,1194,3
2021-02-15,Monterey,053,433212,41487,40911,1629,42540,302
2021-02-15,Napa,055,140530,8896,8837,33,8870,57
2021-02-15,Nevada,057,99092,3894,3767,152,3919,47
2021-02-15,Orange,059,3164182,244669,242176,10043,252219,3586
2021-02-15,Placer,061,380077,20235,19361,1078,20439,230
2021-02-15,Plumas,063,18699,637,620,10,630,4
2021-02-15,Riverside,065,2383286,283066,275771,13284,289055,3468
2021-02-15,Sacramento,067,1510023,92631,91091,1174,92265,1304
2021-02-15,San Benito,069,59416,5686,5649,85,5734,56
2021-02-15,San Bernardino,071,2135413,284222,277869,8455,286324,2945
2021-02-15,San Diego,073,3302833,260205,252940,12555,265495,3037
2021-02-15,San Francisco,075,870044,33615,33454,1024,34478,373
2021-02-15,San Joaquin,077,732212,65754,64382,2697,67079,979
2021-02-15,San Luis Obispo,079,281455,19337,18891,541,19432,227
2021-02-15,San Mateo,081,765935,38957,37969,387,38356,277
2021-02-15,Santa Barbara,083,443738,31586,30810,1024,31834,378
2021-02-15,Santa Clara,085,1922200,108264,107630,551,108181,1588
2021-02-15,Santa Cruz,087,273765,15168,14239,769,15008,175
2021-02-15,Shasta,089,179085,10793,10730,1178,11908,139
2021-02-15,Sierra,091,2930,50,47,12,59,0
2021-02-15,Siskiyou,093,43540,1444,1345,220,1565,4
2021-02-15,Solano,095,438530,29440,29225,347,29572,148
2021-02-15,Sonoma,097,501317,27441,27359,176,27535,276
2021-02-15,Stanislaus,099,539301,49712,48808,5206,54014,716
2021-02-15,Sutter,101,95872,8705,8652,79,8731,95
2021-02-15,Tehama,103,63373,4551,4492,488,4980,30
2021-02-15,Trinity,105,12862,456,274,71,345,3
2021-02-15,Tulare,107,460477,47639,46344,7698,54042,715
2021-02-15,Tuolumne,109,53932,3733,3794,33,3827,49
2021-02-15,Ventura,111,848112,76630,75889,2726,78615,629
2021-02-15,Yolo,113,214977,12642,12412,204,12616,175
2021-02-15,Yuba,115,75493,5405,5320,82,5402,38
2021-02-14,Alameda,001,1643700,79357,78442,1689,80131,995
2021-02-14,Alpine,003,1148,78,76,0,76,0
2021-02-14,Amador,005,37829,3424,3398,29,3427,39
2021-02-14,Butte,007,227075,11156,10717,1578,12295,155
2021-02-14,Calaveras,009,45235,1877,1866,12,1878,21
2021-02-14,Colusa,011,21464,1854,1845,250,2095,10
2021-02-14,Contra Costa,013,1133247,61750,60272,1047,61319,631
2021-02-14,Del Norte,015,27424,959,911,4,915,2
2021-02-14,El Dorado,017,186661,8984,8790,588,9378,94
2021-02-14,Fresno,019,978130,94722,93065,7482,100547,1287
2021-02-14,Glenn,021,27897,2215,2184,483,2667,14
2021-02-14,Humboldt,023,135768,3026,2992,21,3013,29
2021-02-14,Imperial,025,180216,27080,26696,2470,29166,580
2021-02-14,Inyo,027,18085,1225,1177,8,1185,32
2021-02-14,Kern,029,883053,92039,90038,9435,99473,959
2021-02-14,Kings,031,150075,21968,21538,944,22482,205
2021-02-14,Lake,033,64148,3094,3030,1,3031,38
2021-02-14,Lassen,035,31185,5075,5037,92,5129,1
2021-02-14,Los Angeles,037,10098052,1160505,1135450,38669,1174119,18898
2021-02-14,Madera,039,155013,15328,15089,781,15870,106
2021-02-14,Marin,041,260295,12969,12784,152,12936,201
2021-02-14,Mariposa,043,17540,373,365,4,369,4
2021-02-14,Mendocino,045,87422,3584,3475,68,3543,39
2021-02-14,Merced,047,269075,27749,27601,861,28462,368
2021-02-14,Modoc,049,8938,336,326,113,439,3
2021-02-14,Mono,051,14174,1169,1180,16,1196,3
2021-02-14,Monterey,053,433212,41436,40842,1624,42466,302
2021-02-14,Napa,055,140530,8876,8826,33,8859,57
2021-02-14,Nevada,057,99092,3878,3761,152,3913,47
2021-02-14,Orange,059,3164182,244355,241859,10024,251883,3564
2021-02-14,Placer,061,380077,20196,19313,1073,20386,230
2021-02-14,Plumas,063,18699,636,620,10,630,4
2021-02-14,Riverside,065,2383286,282734,275518,13265,288783,3471
2021-02-14,Sacramento,067,1510023,92424,90856,1170,92026,1304
2021-02-14,San Benito,069,59416,5677,5641,84,5725,56
2021-02-14,San Bernardino,071,2135413,283915,277664,8435,286099,2929
2021-02-14,San Diego,073,3302833,259713,252247,12507,264754,3037
2021-02-14,San Francisco,075,870044,33541,33374,1016,34390,372
2021-02-14,San Joaquin,077,732212,65656,64243,2683,66926,979
2021-02-14,San Luis Obispo,079,281455,19299,18868,538,19406,225
2021-02-14,San Mateo,081,765935,38872,37859,387,38246,277
2021-02-14,Santa Barbara,083,443738,31494,30744,1020,31764,377
2021-02-14,Santa Clara,085,1922200,108065,107412,547,107959,1582
2021-02-14,Santa Cruz,087,273765,15140,14225,764,14989,175
2021-02-14,Shasta,089,179085,10761,10720,1173,11893,139
2021-02-14,Sierra,091,2930,50,47,12,59,0
2021-02-14,Siskiyou,093,43540,1440,1340,220,1560,4
2021-02-14,Solano,095,438530,29398,29150,344,29494,148
2021-02-14,Sonoma,097,501317,27366,27266,174,27440,276
2021-02-14,Stanislaus,099,539301,49602,48672,5191,53863,716
2021-02-14,Sutter,101,95872,8682,8642,79,8721,95
2021-02-14,Tehama,103,63373,4545,4490,485,4975,30
2021-02-14,Trinity,105,12862,456,272,71,343,3
2021-02-14,Tulare,107,460477,47554,46263,7649,53912,715
2021-02-14,Tuolumne,109,53932,3732,3764,33,3797,49
2021-02-14,Ventura,111,848112,76461,75742,2715,78457,629
2021-02-14,Yolo,113,214977,12613,12399,203,12602,175
2021-02-14,Yuba,115,75493,5395,5314,82,5396,38
2021-02-13,Alameda,001,1643700,79235,78246,1686,79932,995
2021-02-13,Alpine,003,1148,78,76,0,76,0
2021-02-13,Amador,005,37829,3421,3387,29,3416,38
2021-02-13,Butte,007,227075,11140,10699,1576,12275,155
2021-02-13,Calaveras,009,45235,1874,1863,12,1875,21
2021-02-13,Colusa,011,21464,1854,1837,250,2087,10
2021-02-13,Contra Costa,013,1133247,61629,60100,1047,61147,629
2021-02-13,Del Norte,015,27424,957,908,4,912,2
2021-02-13,El Dorado,017,186661,8972,8758,587,9345,93
2021-02-13,Fresno,019,978130,94608,92807,7460,100267,1287
2021-02-13,Glenn,021,27897,2214,2182,481,2663,14
2021-02-13,Humboldt,023,135768,3013,2974,20,2994,29
2021-02-13,Imperial,025,180216,27073,26680,2468,29148,580
2021-02-13,Inyo,027,18085,1221,1168,8,1176,32
2021-02-13,Kern,029,883053,91950,89915,9409,99324,957
2021-02-13,Kings,031,150075,21953,21513,942,22455,205
2021-02-13,Lake,033,64148,3085,3025,1,3026,37
2021-02-13,Lassen,035,31185,5072,5028,92,5120,1
2021-02-13,Los Angeles,037,10098052,1159646,1133752,38622,1172374,18822
2021-02-13,Madera,039,155013,15319,15053,777,15830,106
2021-02-13,Marin,041,260295,12945,12757,152,12909,201
2021-02-13,Mariposa,043,17540,373,365,4,369,4
2021-02-13,Mendocino,045,87422,3574,3466,68,3534,38
2021-02-13,Merced,047,269075,27705,27541,858,28399,368
2021-02-13,Modoc,049,8938,336,325,113,438,3
2021-02-13,Mono,051,14174,1169,1176,16,1192,3
2021-02-13,Monterey,053,433212,41404,40731,1623,42354,301
2021-02-13,Napa,055,140530,8867,8809,33,8842,57
2021-02-13,Nevada,057,99092,3869,3742,151,3893,47
2021-02-13,Orange,059,3164182,244149,241545,10005,251550,3520
2021-02-13,Placer,061,380077,20176,19214,1073,20287,230
2021-02-13,Plumas,063,18699,636,616,10,626,4
2021-02-13,Riverside,065,2383286,282506,275276,13256,288532,3462
2021-02-13,Sacramento,067,1510023,92257,90401,1167,91568,1302
2021-02-13,San Benito,069,59416,5660,5633,84,5717,56
2021-02-13,San Bernardino,071,2135413,283763,277405,8423,285828,2899
2021-02-13,San Diego,073,3302833,259381,251679,12495,264174,3009
2021-02-13,San Francisco,075,870044,33491,33291,1006,34297,364
2021-02-13,San Joaquin,077,732212,65587,64105,2673,66778,977
2021-02-13,San Luis Obispo,079,281455,19271,18803,532,19335,225
2021-02-13,San Mateo,081,765935,38819,37745,387,38132,277
2021-02-13,Santa Barbara,083,443738,31442,30594,1018,31612,374
2021-02-13,Santa Clara,085,1922200,107876,107125,543,107668,1570
2021-02-13,Santa Cruz,087,273765,15113,14198,763,14961,173
2021-02-13,Shasta,089,179085,10748,10713,1168,11881,139
2021-02-13,Sierra,091,2930,50,47,12,59,0
2021-02-13,Siskiyou,093,43540,1437,1336,220,1556,4
2021-02-13,Solano,095,438530,29362,29084,344,29428,148
2021-02-13,Sonoma,097,501317,27318,27157,172,27329,276
2021-02-13,Stanislaus,099,539301,49531,48568,5185,53753,697
2021-02-13,Sutter,101,95872,8670,8626,79,8705,94
2021-02-13,Tehama,103,63373,4534,4484,484,4968,30
2021-02-13,Trinity,105,12862,455,272,70,342,3
2021-02-13,Tulare,107,460477,47503,46162,7618,53780,709
2021-02-13,Tuolumne,109,53932,3731,3752,33,3785,49
2021-02-13,Ventura,111,848112,76321,75481,2709,78190,618
2021-02-13,Yolo,113,214977,12600,12374,202,12576,175
2021-02-13,Yuba,115,75493,5387,5289,82,5371,38
2021-02-12,Alameda,001,1643700,79088,77958,1680,79638,974
2021-02-12,Alpine,003,1148,78,76,0,76,0
2021-02-12,Amador,005,37829,3417,3381,29,3410,38
2021-02-12,Butte,007,227075,11127,10655,1569,12224,155
2021-02-12,Calaveras,009,45235,1871,1860,12,1872,21
2021-02-12,Colusa,011,21464,1854,1836,250,2086,10
2021-02-12,Contra Costa,013,1133247,61477,59878,1043,60921,620
2021-02-12,Del Norte,015,27424,947,901,4,905,2
2021-02-12,El Dorado,017,186661,8956,8725,584,9309,92
2021-02-12,Fresno,019,978130,94454,92520,7440,99960,1273
2021-02-12,Glenn,021,27897,2211,2175,481,2656,14
2021-02-12,Humboldt,023,135768,3005,2961,20,2981,29
2021-02-12,Imperial,025,180216,27065,26646,2465,29111,585
2021-02-12,Inyo,027,18085,1215,1156,8,1164,32
2021-02-12,Kern,029,883053,91836,89532,9375,98907,949
2021-02-12,Kings,031,150075,21921,21462,937,22399,202
2021-02-12,Lake,033,64148,3080,3012,1,3013,36
2021-02-12,Lassen,035,31185,5070,5015,92,5107,1
2021-02-12,Los Angeles,037,10098052,1158440,1131185,38553,1169738,18637
2021-02-12,Madera,039,155013,15292,15022,774,15796,106
2021-02-12,Marin,041,260295,12919,12720,152,12872,200
2021-02-12,Mariposa,043,17540,372,365,4,369,4
2021-02-12,Mendocino,045,87422,3572,3447,68,3515,38
2021-02-12,Merced,047,269075,27654,27453,855,28308,367
2021-02-12,Modoc,049,8938,336,324,113,437,3
2021-02-12,Mono,051,14174,1168,1172,16,1188,3
2021-02-12,Monterey,053,433212,41356,40633,1614,42247,297
2021-02-12,Napa,055,140530,8855,8785,33,8818,55
2021-02-12,Nevada,057,99092,3864,3728,151,3879,47
2021-02-12,Orange,059,3164182,243910,241075,9990,251065,3505
2021-02-12,Placer,061,380077,20134,19174,1068,20242,230
2021-02-12,Plumas,063,18699,635,614,10,624,4
2021-02-12,Riverside,065,2383286,282228,274792,13239,288031,3438
2021-02-12,Sacramento,067,1510023,92055,90252,1166,91418,1295
2021-02-12,San Benito,069,59416,5644,5622,83,5705,56
2021-02-12,San Bernardino,071,2135413,283573,276890,8412,285302,2827
2021-02-12,San Diego,073,3302833,258996,250788,12469,263257,2979
2021-02-12,San Francisco,075,870044,33431,33179,1002,34181,359
2021-02-12,San Joaquin,077,732212,65492,63966,2665,66631,975
2021-02-12,San Luis Obispo,079,281455,19230,18687,531,19218,224
2021-02-12,San Mateo,081,765935,38747,37560,387,37947,254
2021-02-12,Santa Barbara,083,443738,31371,30454,1013,31467,372
2021-02-12,Santa Clara,085,1922200,107704,106759,540,107299,1543
2021-02-12,Santa Cruz,087,273765,15093,14147,763,14910,170
2021-02-12,Shasta,089,179085,10730,10693,1158,11851,142
2021-02-12,Sierra,091,2930,49,45,12,57,0
2021-02-12,Siskiyou,093,43540,1433,1324,217,1541,4
2021-02-12,Solano,095,438530,29330,28996,341,29337,147
2021-02-12,Sonoma,097,501317,27263,27064,168,27232,275
2021-02-12,Stanislaus,099,539301,49444,48418,5163,53581,697
2021-02-12,Sutter,101,95872,8657,8609,79,8688,93
2021-02-12,Tehama,103,63373,4527,4470,483,4953,27
2021-02-12,Trinity,105,12862,455,269,70,339,3
2021-02-12,Tulare,107,460477,47425,46016,7591,53607,710
2021-02-12,Tuolumne,109,53932,3728,3736,32,3768,49
2021-02-12,Ventura,111,848112,76151,75210,2703,77913,605
2021-02-12,Yolo,113,214977,12579,12340,202,12542,175
2021-02-12,Yuba,115,75493,5379,5274,82,5356,38
2021-02-11,Alameda,001,1643700,78861,77564,1675,79239,960
2021-02-11,Alpine,003,1148,77,76,0,76,0
2021-02-11,Amador,005,37829,3413,3368,29,3397,35
2021-02-11,Butte,007,227075,11104,10624,1568,12192,155
2021-02-11,Calaveras,009,45235,1868,1856,12,1868,21
2021-02-11,Colusa,011,21464,1849,1823,248,2071,10
2021-02-11,Contra Costa,013,1133247,61310,59633,1039,60672,605
2021-02-11,Del Norte,015,27424,942,894,4,898,2
2021-02-11,El Dorado,017,186661,8935,8698,584,9282,92
2021-02-11,Fresno,019,978130,94301,92168,7415,99583,1255
2021-02-11,Glenn,021,27897,2206,2166,480,2646,14
2021-02-11,Humboldt,023,135768,2992,2954,19,2973,29
2021-02-11,Imperial,025,180216,27041,26545,2463,29008,578
2021-02-11,Inyo,027,18085,1206,1144,8,1152,32
2021-02-11,Kern,029,883053,91645,89224,9332,98556,941
2021-02-11,Kings,031,150075,21891,21373,934,22307,202
2021-02-11,Lake,033,64148,3070,3002,1,3003,36
2021-02-11,Lassen,035,31185,5059,5004,89,5093,1
2021-02-11,Los Angeles,037,10098052,1156809,1128437,38484,1166921,18500
2021-02-11,Madera,039,155013,15271,14984,772,15756,106
2021-02-11,Marin,041,260295,12882,12682,152,12834,200
2021-02-11,Mariposa,043,17540,372,361,4,365,4
2021-02-11,Mendocino,045,87422,3565,3420,68,3488,38
2021-02-11,Merced,047,269075,27588,27325,851,28176,363
2021-02-11,Modoc,049,8938,335,317,113,430,3
2021-02-11,Mono,051,14174,1164,1173,16,1189,3
2021-02-11,Monterey,053,433212,41250,40469,1608,42077,295
2021-02-11,Napa,055,140530,8834,8777,33,8810,55
2021-02-11,Nevada,057,99092,3848,3720,151,3871,47
2021-02-11,Orange,059,3164182,243544,240590,9967,250557,3476
2021-02-11,Placer,061,380077,20094,19118,1067,20185,224
2021-02-11,Plumas,063,18699,634,592,10,602,4
2021-02-11,Riverside,065,2383286,281862,274313,13224,287537,3394
2021-02-11,Sacramento,067,1510023,91812,89988,1160,91148,1286
2021-02-11,San Benito,069,59416,5635,5609,83,5692,56
2021-02-11,San Bernardino,071,2135413,283274,276349,8398,284747,2774
2021-02-11,San Diego,073,3302833,258443,249971,12435,262406,2955
2021-02-11,San Francisco,075,870044,33347,33076,993,34069,356
2021-02-11,San Joaquin,077,732212,65323,63719,2655,66374,971
2021-02-11,San Luis Obispo,079,281455,19165,18615,527,19142,219
2021-02-11,San Mateo,081,765935,38656,37439,385,37824,253
2021-02-11,Santa Barbara,083,443738,31274,30375,1008,31383,370
2021-02-11,Santa Clara,085,1922200,107444,106392,534,106926,1507
2021-02-11,Santa Cruz,087,273765,15070,14088,758,14846,165
2021-02-11,Shasta,089,179085,10706,10672,1154,11826,140
2021-02-11,Sierra,091,2930,49,45,12,57,0
2021-02-11,Siskiyou,093,43540,1418,1320,217,1537,4
2021-02-11,Solano,095,438530,29277,28885,341,29226,138
2021-02-11,Sonoma,097,501317,27178,26971,165,27136,272
2021-02-11,Stanislaus,099,539301,49299,48205,5151,53356,697
2021-02-11,Sutter,101,95872,8643,8590,78,8668,93
2021-02-11,Tehama,103,63373,4521,4463,483,4946,26
2021-02-11,Trinity,105,12862,455,269,70,339,3
2021-02-11,Tulare,107,460477,47330,45897,7550,53447,706
2021-02-11,Tuolumne,109,53932,3691,3716,32,3748,48
2021-02-11,Ventura,111,848112,75949,74959,2694,77653,590
2021-02-11,Yolo,113,214977,12555,12303,200,12503,173
2021-02-11,Yuba,115,75493,5365,5261,81,5342,38
2021-02-10,Alameda,001,1643700,78657,77344,1674,79018,944
2021-02-10,Alpine,003,1148,77,76,0,76,0
2021-02-10,Amador,005,37829,3401,3348,29,3377,35
2021-02-10,Butte,007,227075,11076,10594,1567,12161,155
2021-02-10,Calaveras,009,45235,1866,1850,12,1862,21
2021-02-10,Colusa,011,21464,1842,1815,246,2061,10
2021-02-10,Contra Costa,013,1133247,61136,59488,1037,60525,590
2021-02-10,Del Norte,015,27424,936,888,4,892,2
2021-02-10,El Dorado,017,186661,8904,8682,580,9262,87
2021-02-10,Fresno,019,978130,94126,91876,7389,99265,1247
2021-02-10,Glenn,021,27897,2202,2160,478,2638,14
2021-02-10,Humboldt,023,135768,2984,2924,19,2943,29
2021-02-10,Imperial,025,180216,27003,26522,2460,28982,578
2021-02-10,Inyo,027,18085,1194,1138,8,1146,30
2021-02-10,Kern,029,883053,91439,88933,9278,98211,926
2021-02-10,Kings,031,150075,21848,21294,932,22226,197
2021-02-10,Lake,033,64148,3057,2975,1,2976,36
2021-02-10,Lassen,035,31185,5055,4993,89,5082,1
2021-02-10,Los Angeles,037,10098052,1155063,1125437,38354,1163791,18338
2021-02-10,Madera,039,155013,15232,14925,770,15695,105
2021-02-10,Marin,041,260295,12845,12651,152,12803,199
2021-02-10,Mariposa,043,17540,370,360,4,364,4
2021-02-10,Mendocino,045,87422,3550,3395,68,3463,38
2021-02-10,Merced,047,269075,27505,27246,840,28086,359
2021-02-10,Modoc,049,8938,334,315,111,426,3
2021-02-10,Mono,051,14174,1159,1170,16,1186,3
2021-02-10,Monterey,053,433212,41173,40366,1593,41959,288
2021-02-10,Napa,055,140530,8815,8769,33,8802,55
2021-02-10,Nevada,057,99092,3833,3693,149,3842,47
2021-02-10,Orange,059,3164182,243127,239974,9936,249910,3439
2021-02-10,Placer,061,380077,20055,19062,1062,20124,220
2021-02-10,Plumas,063,18699,631,589,10,599,2
2021-02-10,Riverside,065,2383286,281435,273721,13214,286935,3374
2021-02-10,Sacramento,067,1510023,91561,89653,1156,90809,1275
2021-02-10,San Benito,069,59416,5621,5591,83,5674,55
2021-02-10,San Bernardino,071,2135413,282918,275616,8382,283998,2696
2021-02-10,San Diego,073,3302833,257861,248858,12397,261255,2904
2021-02-10,San Francisco,075,870044,33264,32955,990,33945,351
2021-02-10,San Joaquin,077,732212,65181,63484,2641,66125,954
2021-02-10,San Luis Obispo,079,281455,19086,18549,525,19074,216
2021-02-10,San Mateo,081,765935,38566,37323,385,37708,245
2021-02-10,Santa Barbara,083,443738,31183,30216,1003,31219,359
2021-02-10,Santa Clara,085,1922200,107204,106048,531,106579,1489
2021-02-10,Santa Cruz,087,273765,15034,14007,756,14763,165
2021-02-10,Shasta,089,179085,10683,10645,1151,11796,142
2021-02-10,Sierra,091,2930,49,45,12,57,0
2021-02-10,Siskiyou,093,43540,1413,1314,216,1530,4
2021-02-10,Solano,095,438530,29202,28835,339,29174,137
2021-02-10,Sonoma,097,501317,27083,26881,163,27044,271
2021-02-10,Stanislaus,099,539301,49180,48016,5135,53151,696
2021-02-10,Sutter,101,95872,8626,8571,78,8649,93
2021-02-10,Tehama,103,63373,4513,4445,483,4928,23
2021-02-10,Trinity,105,12862,452,268,70,338,3
2021-02-10,Tulare,107,460477,47213,45782,7511,53293,696
2021-02-10,Tuolumne,109,53932,3683,3691,32,3723,48
2021-02-10,Ventura,111,848112,75721,74651,2677,77328,580
2021-02-10,Yolo,113,214977,12531,12276,199,12475,174
2021-02-10,Yuba,115,75493,5347,5241,81,5322,38
2021-02-09,Alameda,001,1643700,78393,77018,1670,78688,936
2021-02-09,Alpine,003,1148,77,76,0,76,0
2021-02-09,Amador,005,37829,3393,3347,29,3376,35
2021-02-09,Butte,007,227075,11050,10563,1564,12127,153
2021-02-09,Calaveras,009,45235,1862,1847,12,1859,21
2021-02-09,Colusa,011,21464,1833,1812,241,2053,10
2021-02-09,Contra Costa,013,1133247,60946,59307,1031,60338,583
2021-02-09,Del Norte,015,27424,930,886,4,890,2
2021-02-09,El Dorado,017,186661,8877,8663,579,9242,87
2021-02-09,Fresno,019,978130,93884,91730,7361,99091,1211
2021-02-09,Glenn,021,27897,2198,2156,478,2634,14
2021-02-09,Humboldt,023,135768,2976,2904,19,2923,29
2021-02-09,Imperial,025,180216,26972,26509,2457,28966,568
2021-02-09,Inyo,027,18085,1186,1137,8,1145,30
2021-02-09,Kern,029,883053,91187,88684,9232,97916,920
2021-02-09,Kings,031,150075,21806,21275,930,22205,196
2021-02-09,Lake,033,64148,3046,2955,1,2956,36
2021-02-09,Lassen,035,31185,5048,4983,89,5072,1
2021-02-09,Los Angeles,037,10098052,1153092,1122745,38269,1161014,18198
2021-02-09,Madera,039,155013,15212,14912,767,15679,105
2021-02-09,Marin,041,260295,12812,12623,151,12774,197
2021-02-09,Mariposa,043,17540,368,355,4,359,4
2021-02-09,Mendocino,045,87422,3532,3369,68,3437,38
2021-02-09,Merced,047,269075,27407,27166,835,28001,354
2021-02-09,Modoc,049,8938,333,316,111,427,3
2021-02-09,Mono,051,14174,1158,1167,16,1183,3
2021-02-09,Monterey,053,433212,41065,40279,1580,41859,285
2021-02-09,Napa,055,140530,8802,8749,33,8782,55
2021-02-09,Nevada,057,99092,3817,3687,149,3836,44
2021-02-09,Orange,059,3164182,242715,239169,9905,249074,3406
2021-02-09,Placer,061,380077,19990,19008,1055,20063,220
2021-02-09,Plumas,063,18699,631,584,10,594,2
2021-02-09,Riverside,065,2383286,280941,273465,13197,286662,3334
2021-02-09,Sacramento,067,1510023,91250,89378,1155,90533,1265
2021-02-09,San Benito,069,59416,5609,5566,82,5648,54
2021-02-09,San Bernardino,071,2135413,282544,274998,8369,283367,2613
2021-02-09,San Diego,073,3302833,257203,248048,12354,260402,2853
2021-02-09,San Francisco,075,870044,33185,32782,980,33762,349
2021-02-09,San Joaquin,077,732212,65007,63341,2636,65977,937
2021-02-09,San Luis Obispo,079,281455,19027,18489,524,19013,216
2021-02-09,San Mateo,081,765935,38435,37227,384,37611,235
2021-02-09,Santa Barbara,083,443738,31071,30118,997,31115,351
2021-02-09,Santa Clara,085,1922200,106898,105762,528,106290,1463
2021-02-09,Santa Cruz,087,273765,14984,13958,751,14709,162
2021-02-09,Shasta,089,179085,10655,10595,1149,11744,139
2021-02-09,Sierra,091,2930,49,44,12,56,0
2021-02-09,Siskiyou,093,43540,1405,1306,214,1520,4
2021-02-09,Solano,095,438530,29123,28769,336,29105,131
2021-02-09,Sonoma,097,501317,26993,26826,161,26987,267
2021-02-09,Stanislaus,099,539301,49020,47906,5119,53025,679
2021-02-09,Sutter,101,95872,8610,8541,78,8619,92
2021-02-09,Tehama,103,63373,4506,4416,482,4898,22
2021-02-09,Trinity,105,12862,452,266,70,336,3
2021-02-09,Tulare,107,460477,47079,45704,7457,53161,686
2021-02-09,Tuolumne,109,53932,3664,3673,32,3705,48
2021-02-09,Ventura,111,848112,75469,74333,2669,77002,567
2021-02-09,Yolo,113,214977,12489,12220,199,12419,174
2021-02-09,Yuba,115,75493,5338,5235,81,5316,35
2021-02-08,Alameda,001,1643700,78129,76735,1665,78400,924
2021-02-08,Alpine,003,1148,77,73,0,73,0
2021-02-08,Amador,005,37829,3386,3344,28,3372,33
2021-02-08,Butte,007,227075,11028,10524,1560,12084,152
2021-02-08,Calaveras,009,45235,1861,1840,12,1852,21
2021-02-08,Colusa,011,21464,1825,1802,237,2039,10
2021-02-08,Contra Costa,013,1133247,60735,59039,1029,60068,567
2021-02-08,Del Norte,015,27424,927,885,4,889,2
2021-02-08,El Dorado,017,186661,8846,8627,577,9204,86
2021-02-08,Fresno,019,978130,93671,91430,7335,98765,1207
2021-02-08,Glenn,021,27897,2194,2148,476,2624,14
2021-02-08,Humboldt,023,135768,2968,2902,19,2921,29
2021-02-08,Imperial,025,180216,26950,26526,2455,28981,567
2021-02-08,Inyo,027,18085,1173,1126,8,1134,30
2021-02-08,Kern,029,883053,90970,88380,9172,97552,920
2021-02-08,Kings,031,150075,21744,21232,927,22159,195
2021-02-08,Lake,033,64148,3027,2949,1,2950,36
2021-02-08,Lassen,035,31185,5035,4976,89,5065,1
2021-02-08,Los Angeles,037,10098052,1150996,1120179,38147,1158326,17977
2021-02-08,Madera,039,155013,15176,14887,760,15647,93
2021-02-08,Marin,041,260295,12782,12591,151,12742,194
2021-02-08,Mariposa,043,17540,368,355,4,359,4
2021-02-08,Mendocino,045,87422,3518,3355,68,3423,38
2021-02-08,Merced,047,269075,27323,27082,830,27912,346
2021-02-08,Modoc,049,8938,331,318,111,429,3
2021-02-08,Mono,051,14174,1158,1165,16,1181,3
2021-02-08,Monterey,053,433212,40945,40186,1561,41747,283
2021-02-08,Napa,055,140530,8787,8719,33,8752,55
2021-02-08,Nevada,057,99092,3805,3671,149,3820,44
2021-02-08,Orange,059,3164182,242248,238715,9882,248597,3361
2021-02-08,Placer,061,380077,19948,18944,1049,19993,211
2021-02-08,Plumas,063,18699,630,584,10,594,2
2021-02-08,Riverside,065,2383286,280372,272904,13171,286075,3301
2021-02-08,Sacramento,067,1510023,90964,89267,1152,90419,1247
2021-02-08,San Benito,069,59416,5604,5553,81,5634,52
2021-02-08,San Bernardino,071,2135413,282141,274661,8363,283024,2587
2021-02-08,San Diego,073,3302833,256461,247259,12313,259572,2821
2021-02-08,San Francisco,075,870044,33091,32679,972,33651,348
2021-02-08,San Joaquin,077,732212,64845,63148,2626,65774,929
2021-02-08,San Luis Obispo,079,281455,18970,18421,519,18940,214
2021-02-08,San Mateo,081,765935,38326,37084,384,37468,232
2021-02-08,Santa Barbara,083,443738,30956,29978,990,30968,340
2021-02-08,Santa Clara,085,1922200,106574,105413,520,105933,1456
2021-02-08,Santa Cruz,087,273765,14945,13921,745,14666,161
2021-02-08,Shasta,089,179085,10628,10574,1143,11717,137
2021-02-08,Sierra,091,2930,49,44,12,56,0
2021-02-08,Siskiyou,093,43540,1402,1303,214,1517,4
2021-02-08,Solano,095,438530,29057,28644,334,28978,130
2021-02-08,Sonoma,097,501317,26902,26760,160,26920,259
2021-02-08,Stanislaus,099,539301,48865,47704,5091,52795,679
2021-02-08,Sutter,101,95872,8591,8526,78,8604,92
2021-02-08,Tehama,103,63373,4495,4403,479,4882,22
2021-02-08,Trinity,105,12862,450,266,70,336,3
2021-02-08,Tulare,107,460477,46971,45617,7417,53034,673
2021-02-08,Tuolumne,109,53932,3656,3647,32,3679,48
2021-02-08,Ventura,111,848112,75212,74068,2663,76731,565
2021-02-08,Yolo,113,214977,12457,12169,198,12367,162
2021-02-08,Yuba,115,75493,5322,5215,81,5296,35
2021-02-07,Alameda,001,1643700,77827,76500,1657,78157,924
2021-02-07,Alpine,003,1148,74,72,0,72,0
2021-02-07,Amador,005,37829,3365,3343,28,3371,33
2021-02-07,Butte,007,227075,10995,10513,1552,12065,152
2021-02-07,Calaveras,009,45235,1857,1837,12,1849,21
2021-02-07,Colusa,011,21464,1814,1795,235,2030,10
2021-02-07,Contra Costa,013,1133247,60490,58836,1024,59860,566
2021-02-07,Del Norte,015,27424,923,881,4,885,2
2021-02-07,El Dorado,017,186661,8817,8596,575,9171,86
2021-02-07,Fresno,019,978130,93441,91184,7296,98480,1207
2021-02-07,Glenn,021,27897,2190,2141,471,2612,14
2021-02-07,Humboldt,023,135768,2947,2895,19,2914,28
2021-02-07,Imperial,025,180216,26923,26518,2450,28968,567
2021-02-07,Inyo,027,18085,1162,1124,8,1132,27
2021-02-07,Kern,029,883053,90723,88146,9114,97260,920
2021-02-07,Kings,031,150075,21683,21180,924,22104,192
2021-02-07,Lake,033,64148,3012,2940,1,2941,36
2021-02-07,Lassen,035,31185,5024,4973,89,5062,1
2021-02-07,Los Angeles,037,10098052,1148238,1117551,38017,1155568,17889
2021-02-07,Madera,039,155013,15142,14850,756,15606,93
2021-02-07,Marin,041,260295,12749,12571,149,12720,194
2021-02-07,Mariposa,043,17540,367,355,4,359,4
2021-02-07,Mendocino,045,87422,3501,3348,68,3416,38
2021-02-07,Merced,047,269075,27211,26977,818,27795,346
2021-02-07,Modoc,049,8938,331,317,107,424,3
2021-02-07,Mono,051,14174,1155,1165,16,1181,3
2021-02-07,Monterey,053,433212,40809,40113,1542,41655,283
2021-02-07,Napa,055,140530,8764,8701,33,8734,55
2021-02-07,Nevada,057,99092,3794,3643,149,3792,44
2021-02-07,Orange,059,3164182,241648,238155,9849,248004,3336
2021-02-07,Placer,061,380077,19901,18903,1036,19939,211
2021-02-07,Plumas,063,18699,630,584,10,594,2
2021-02-07,Riverside,065,2383286,279844,272301,13150,285451,3267
2021-02-07,Sacramento,067,1510023,90632,88919,1145,90064,1246
2021-02-07,San Benito,069,59416,5585,5548,80,5628,52
2021-02-07,San Bernardino,071,2135413,281547,274316,8338,282654,2587
2021-02-07,San Diego,073,3302833,255675,246561,12249,258810,2821
2021-02-07,San Francisco,075,870044,32971,32609,960,33569,348
2021-02-07,San Joaquin,077,732212,64571,63051,2611,65662,929
2021-02-07,San Luis Obispo,079,281455,18898,18349,512,18861,214
2021-02-07,San Mateo,081,765935,38192,36984,382,37366,232
2021-02-07,Santa Barbara,083,443738,30816,29815,979,30794,340
2021-02-07,Santa Clara,085,1922200,106234,105118,510,105628,1450
2021-02-07,Santa Cruz,087,273765,14891,13887,740,14627,161
2021-02-07,Shasta,089,179085,10608,10570,1135,11705,137
2021-02-07,Sierra,091,2930,49,43,12,55,0
2021-02-07,Siskiyou,093,43540,1395,1295,212,1507,4
2021-02-07,Solano,095,438530,28946,28567,333,28900,130
2021-02-07,Sonoma,097,501317,26795,26684,156,26840,257
2021-02-07,Stanislaus,099,539301,48675,47551,5059,52610,679
2021-02-07,Sutter,101,95872,8563,8515,78,8593,92
2021-02-07,Tehama,103,63373,4479,4396,478,4874,22
2021-02-07,Trinity,105,12862,447,264,68,332,3
2021-02-07,Tulare,107,460477,46849,45520,7339,52859,671
2021-02-07,Tuolumne,109,53932,3632,3619,31,3650,48
2021-02-07,Ventura,111,848112,74901,73759,2651,76410,561
2021-02-07,Yolo,113,214977,12412,12135,198,12333,162
2021-02-07,Yuba,115,75493,5307,5198,79,5277,35
2021-02-06,Alameda,001,1643700,77673,76170,1646,77816,922
2021-02-06,Alpine,003,1148,74,72,0,72,0
2021-02-06,Amador,005,37829,3359,3306,28,3334,33
2021-02-06,Butte,007,227075,10978,10480,1548,12028,150
2021-02-06,Calaveras,009,45235,1855,1832,12,1844,21
2021-02-06,Colusa,011,21464,1812,1791,234,2025,10
2021-02-06,Contra Costa,013,1133247,60343,58567,1018,59585,566
2021-02-06,Del Norte,015,27424,919,879,4,883,2
2021-02-06,El Dorado,017,186661,8810,8575,571,9146,86
2021-02-06,Fresno,019,978130,93328,90944,7275,98219,1207
2021-02-06,Glenn,021,27897,2188,2136,470,2606,14
2021-02-06,Humboldt,023,135768,2936,2880,19,2899,28
2021-02-06,Imperial,025,180216,26911,26514,2449,28963,567
2021-02-06,Inyo,027,18085,1159,1113,8,1121,27
2021-02-06,Kern,029,883053,90569,87919,9068,96987,912
2021-02-06,Kings,031,150075,21653,21156,924,22080,190
2021-02-06,Lake,033,64148,3007,2920,1,2921,34
2021-02-06,Lassen,035,31185,5020,4964,88,5052,1
2021-02-06,Los Angeles,037,10098052,1146883,1114718,37919,1152637,17793
2021-02-06,Madera,039,155013,15121,14807,754,15561,93
2021-02-06,Marin,041,260295,12729,12531,149,12680,194
2021-02-06,Mariposa,043,17540,366,355,3,358,4
2021-02-06,Mendocino,045,87422,3483,3316,67,3383,38
2021-02-06,Merced,047,269075,27125,26881,810,27691,346
2021-02-06,Modoc,049,8938,331,313,107,420,3
2021-02-06,Mono,051,14174,1154,1159,16,1175,3
2021-02-06,Monterey,053,433212,40751,39995,1534,41529,282
2021-02-06,Napa,055,140530,8751,8639,33,8672,55
2021-02-06,Nevada,057,99092,3782,3624,149,3773,43
2021-02-06,Orange,059,3164182,241284,237391,9815,247206,3293
2021-02-06,Placer,061,380077,19864,18836,1033,19869,211
2021-02-06,Plumas,063,18699,630,584,10,594,2
2021-02-06,Riverside,065,2383286,279475,271741,13131,284872,3243
2021-02-06,Sacramento,067,1510023,90415,88532,1135,89667,1237
2021-02-06,San Benito,069,59416,5567,5516,80,5596,52
2021-02-06,San Bernardino,071,2135413,281237,273718,8315,282033,2564
2021-02-06,San Diego,073,3302833,255179,245331,12214,257545,2812
2021-02-06,San Francisco,075,870044,32897,32437,950,33387,346
2021-02-06,San Joaquin,077,732212,64492,62840,2600,65440,906
2021-02-06,San Luis Obispo,079,281455,18856,18284,508,18792,214
2021-02-06,San Mateo,081,765935,38124,36824,379,37203,232
2021-02-06,Santa Barbara,083,443738,30740,29645,977,30622,337
2021-02-06,Santa Clara,085,1922200,106012,104639,505,105144,1439
2021-02-06,Santa Cruz,087,273765,14860,13845,736,14581,161
2021-02-06,Shasta,089,179085,10597,10561,1133,11694,137
2021-02-06,Sierra,091,2930,49,43,12,55,0
2021-02-06,Siskiyou,093,43540,1392,1289,211,1500,4
2021-02-06,Solano,095,438530,28910,28446,332,28778,129
2021-02-06,Sonoma,097,501317,26758,26564,154,26718,257
2021-02-06,Stanislaus,099,539301,48579,47325,5043,52368,679
2021-02-06,Sutter,101,95872,8555,8485,78,8563,92
2021-02-06,Tehama,103,63373,4470,4380,477,4857,22
2021-02-06,Trinity,105,12862,447,263,68,331,3
2021-02-06,Tulare,107,460477,46781,45349,7292,52641,664
2021-02-06,Tuolumne,109,53932,3625,3612,31,3643,48
2021-02-06,Ventura,111,848112,74721,73431,2645,76076,552
2021-02-06,Yolo,113,214977,12389,12061,198,12259,161
2021-02-06,Yuba,115,75493,5297,5177,78,5255,35
2021-02-05,Alameda,001,1643700,77445,75716,1644,77360,916
2021-02-05,Alpine,003,1148,74,72,0,72,0
2021-02-05,Amador,005,37829,3354,3299,27,3326,33
2021-02-05,Butte,007,227075,10959,10421,1541,11962,150
2021-02-05,Calaveras,009,45235,1851,1818,12,1830,21
2021-02-05,Colusa,011,21464,1808,1785,234,2019,10
2021-02-05,Contra Costa,013,1133247,60182,58195,1016,59211,560
2021-02-05,Del Norte,015,27424,918,874,4,878,2
2021-02-05,El Dorado,017,186661,8790,8527,569,9096,86
2021-02-05,Fresno,019,978130,93126,90513,7254,97767,1194
2021-02-05,Glenn,021,27897,2185,2122,464,2586,14
2021-02-05,Humboldt,023,135768,2926,2857,19,2876,28
2021-02-05,Imperial,025,180216,26892,26474,2448,28922,557
2021-02-05,Inyo,027,18085,1155,1104,8,1112,27
2021-02-05,Kern,029,883053,90400,87470,9001,96471,906
2021-02-05,Kings,031,150075,21615,21021,921,21942,190
2021-02-05,Lake,033,64148,2995,2906,1,2907,33
2021-02-05,Lassen,035,31185,5016,4936,88,5024,1
2021-02-05,Los Angeles,037,10098052,1144784,1110384,37784,1148168,17608
2021-02-05,Madera,039,155013,15087,14752,749,15501,95
2021-02-05,Marin,041,260295,12694,12479,149,12628,193
2021-02-05,Mariposa,043,17540,366,352,3,355,4
2021-02-05,Mendocino,045,87422,3469,3272,67,3339,38
2021-02-05,Merced,047,269075,27065,26760,809,27569,345
2021-02-05,Modoc,049,8938,331,312,107,419,3
2021-02-05,Mono,051,14174,1153,1157,16,1173,3
2021-02-05,Monterey,053,433212,40684,39840,1523,41363,281
2021-02-05,Napa,055,140530,8737,8598,33,8631,55
2021-02-05,Nevada,057,99092,3779,3607,149,3756,43
2021-02-05,Orange,059,3164182,240857,236335,9788,246123,3260
2021-02-05,Placer,061,380077,19828,18756,1031,19787,211
2021-02-05,Plumas,063,18699,628,578,10,588,2
2021-02-05,Riverside,065,2383286,279061,270666,13112,283778,3235
2021-02-05,Sacramento,067,1510023,90235,87992,1128,89120,1231
2021-02-05,San Benito,069,59416,5556,5502,80,5582,51
2021-02-05,San Bernardino,071,2135413,280893,272938,8297,281235,2495
2021-02-05,San Diego,073,3302833,254603,244066,12179,256245,2777
2021-02-05,San Francisco,075,870044,32807,32229,939,33168,337
2021-02-05,San Joaquin,077,732212,64343,62565,2592,65157,902
2021-02-05,San Luis Obispo,079,281455,18795,18152,504,18656,213
2021-02-05,San Mateo,081,765935,38040,36582,378,36960,227
2021-02-05,Santa Barbara,083,443738,30643,29455,964,30419,334
2021-02-05,Santa Clara,085,1922200,105764,104112,503,104615,1421
2021-02-05,Santa Cruz,087,273765,14839,13776,734,14510,161
2021-02-05,Shasta,089,179085,10581,10507,1126,11633,136
2021-02-05,Sierra,091,2930,49,42,12,54,0
2021-02-05,Siskiyou,093,43540,1385,1276,209,1485,4
2021-02-05,Solano,095,438530,28860,28283,332,28615,127
2021-02-05,Sonoma,097,501317,26689,26423,151,26574,252
2021-02-05,Stanislaus,099,539301,48434,47024,5025,52049,678
2021-02-05,Sutter,101,95872,8535,8443,78,8521,92
2021-02-05,Tehama,103,63373,4461,4355,476,4831,22
2021-02-05,Trinity,105,12862,446,260,68,328,3
2021-02-05,Tulare,107,460477,46705,45138,7242,52380,663
2021-02-05,Tuolumne,109,53932,3599,3595,31,3626,45
2021-02-05,Ventura,111,848112,74476,72953,2633,75586,546
2021-02-05,Yolo,113,214977,12370,12025,193,12218,162
2021-02-05,Yuba,115,75493,5280,5145,78,5223,35
2021-02-04,Alameda,001,1643700,77160,75422,1638,77060,899
2021-02-04,Alpine,003,1148,73,72,0,72,0
2021-02-04,Amador,005,37829,3351,3288,27,3315,33
2021-02-04,Butte,007,227075,10926,10386,1533,11919,147
2021-02-04,Calaveras,009,45235,1849,1808,12,1820,21
2021-02-04,Colusa,011,21464,1804,1777,232,2009,10
2021-02-04,Contra Costa,013,1133247,59994,57991,1012,59003,550
2021-02-04,Del Norte,015,27424,912,870,4,874,2
2021-02-04,El Dorado,017,186661,8764,8490,566,9056,86
2021-02-04,Fresno,019,978130,92911,90126,7227,97353,1114
2021-02-04,Glenn,021,27897,2180,2102,463,2565,14
2021-02-04,Humboldt,023,135768,2916,2827,19,2846,28
2021-02-04,Imperial,025,180216,26846,26411,2446,28857,556
2021-02-04,Inyo,027,18085,1143,1084,8,1092,27
2021-02-04,Kern,029,883053,90126,87156,8923,96079,898
2021-02-04,Kings,031,150075,21564,20918,914,21832,187
2021-02-04,Lake,033,64148,2983,2882,1,2883,34
2021-02-04,Lassen,035,31185,5013,4927,88,5015,1
2021-02-04,Los Angeles,037,10098052,1141984,1106323,37657,1143980,17396
2021-02-04,Madera,039,155013,15057,14706,746,15452,95
2021-02-04,Marin,041,260295,12658,12431,149,12580,192
2021-02-04,Mariposa,043,17540,366,348,3,351,4
2021-02-04,Mendocino,045,87422,3451,3240,65,3305,38
2021-02-04,Merced,047,269075,26971,26629,806,27435,345
2021-02-04,Modoc,049,8938,331,309,107,416,3
2021-02-04,Mono,051,14174,1151,1153,16,1169,3
2021-02-04,Monterey,053,433212,40573,39619,1506,41125,279
2021-02-04,Napa,055,140530,8708,8573,33,8606,55
2021-02-04,Nevada,057,99092,3759,3590,148,3738,37
2021-02-04,Orange,059,3164182,240213,235677,9746,245423,3238
2021-02-04,Placer,061,380077,19768,18711,1022,19733,210
2021-02-04,Plumas,063,18699,625,562,10,572,2
2021-02-04,Riverside,065,2383286,278297,269851,13073,282924,3230
2021-02-04,Sacramento,067,1510023,89934,87658,1118,88776,1222
2021-02-04,San Benito,069,59416,5542,5488,79,5567,51
2021-02-04,San Bernardino,071,2135413,280344,272223,8277,280500,2409
2021-02-04,San Diego,073,3302833,253815,242613,12113,254726,2738
2021-02-04,San Francisco,075,870044,32693,32116,930,33046,326
2021-02-04,San Joaquin,077,732212,64118,62374,2584,64958,883
2021-02-04,San Luis Obispo,079,281455,18728,18058,502,18560,211
2021-02-04,San Mateo,081,765935,37919,36437,375,36812,226
2021-02-04,Santa Barbara,083,443738,30508,29344,947,30291,322
2021-02-04,Santa Clara,085,1922200,105421,103781,500,104281,1404
2021-02-04,Santa Cruz,087,273765,14806,13713,726,14439,156
2021-02-04,Shasta,089,179085,10555,10466,1121,11587,131
2021-02-04,Sierra,091,2930,49,42,12,54,0
2021-02-04,Siskiyou,093,43540,1376,1273,209,1482,4
2021-02-04,Solano,095,438530,28757,28192,331,28523,120
2021-02-04,Sonoma,097,501317,26607,26276,147,26423,249
2021-02-04,Stanislaus,099,539301,48272,46822,5006,51828,678
2021-02-04,Sutter,101,95872,8515,8401,78,8479,92
2021-02-04,Tehama,103,63373,4444,4327,475,4802,21
2021-02-04,Trinity,105,12862,445,260,67,327,3
2021-02-04,Tulare,107,460477,46578,44983,7180,52163,656
2021-02-04,Tuolumne,109,53932,3559,3585,31,3616,45
2021-02-04,Ventura,111,848112,74144,72595,2620,75215,537
2021-02-04,Yolo,113,214977,12336,11982,192,12174,161
2021-02-04,Yuba,115,75493,5254,5135,78,5213,34
2021-02-03,Alameda,001,1643700,76835,74968,1634,76602,880
2021-02-03,Alpine,003,1148,73,72,0,72,0
2021-02-03,Amador,005,37829,3347,3281,27,3308,33
2021-02-03,Butte,007,227075,10895,10355,1526,11881,144
2021-02-03,Calaveras,009,45235,1834,1799,11,1810,21
2021-02-03,Colusa,011,21464,1799,1773,231,2004,10
2021-02-03,Contra Costa,013,1133247,59754,57762,1000,58762,537
2021-02-03,Del Norte,015,27424,907,869,4,873,2
2021-02-03,El Dorado,017,186661,8744,8428,565,8993,86
2021-02-03,Fresno,019,978130,92690,89748,7188,96936,1015
2021-02-03,Glenn,021,27897,2170,2098,462,2560,14
2021-02-03,Humboldt,023,135768,2906,2800,19,2819,27
2021-02-03,Imperial,025,180216,26810,26363,2440,28803,547
2021-02-03,Inyo,027,18085,1133,1071,8,1079,27
2021-02-03,Kern,029,883053,89883,86771,8882,95653,877
2021-02-03,Kings,031,150075,21503,20831,912,21743,172
2021-02-03,Lake,033,64148,2965,2869,1,2870,33
2021-02-03,Lassen,035,31185,5001,4910,88,4998,1
2021-02-03,Los Angeles,037,10098052,1138902,1101890,37531,1139421,17163
2021-02-03,Madera,039,155013,15018,14605,744,15349,94
2021-02-03,Marin,041,260295,12623,12406,149,12555,190
2021-02-03,Mariposa,043,17540,365,347,3,350,4
2021-02-03,Mendocino,045,87422,3425,3236,64,3300,38
2021-02-03,Merced,047,269075,26856,26520,801,27321,343
2021-02-03,Modoc,049,8938,330,308,107,415,3
2021-02-03,Mono,051,14174,1144,1146,16,1162,3
2021-02-03,Monterey,053,433212,40446,39500,1489,40989,279
2021-02-03,Napa,055,140530,8673,8534,33,8567,54
2021-02-03,Nevada,057,99092,3745,3572,148,3720,35
2021-02-03,Orange,059,3164182,239470,234738,9714,244452,3189
2021-02-03,Placer,061,380077,19713,18646,1020,19666,210
2021-02-03,Plumas,063,18699,625,559,10,569,2
2021-02-03,Riverside,065,2383286,277556,269019,13042,282061,3195
2021-02-03,Sacramento,067,1510023,89611,87415,1114,88529,1212
2021-02-03,San Benito,069,59416,5524,5463,76,5539,51
2021-02-03,San Bernardino,071,2135413,279857,271477,8254,279731,2308
2021-02-03,San Diego,073,3302833,252914,241015,12066,253081,2683
2021-02-03,San Francisco,075,870044,32563,31983,925,32908,325
2021-02-03,San Joaquin,077,732212,63890,61976,2574,64550,880
2021-02-03,San Luis Obispo,079,281455,18650,17922,499,18421,206
2021-02-03,San Mateo,081,765935,37781,36227,371,36598,225
2021-02-03,Santa Barbara,083,443738,30359,29121,937,30058,315
2021-02-03,Santa Clara,085,1922200,105105,103278,498,103776,1364
2021-02-03,Santa Cruz,087,273765,14751,13611,720,14331,154
2021-02-03,Shasta,089,179085,10512,10422,1116,11538,130
2021-02-03,Sierra,091,2930,49,42,12,54,0
2021-02-03,Siskiyou,093,43540,1365,1268,208,1476,4
2021-02-03,Solano,095,438530,28635,28057,331,28388,119
2021-02-03,Sonoma,097,501317,26523,26155,146,26301,248
2021-02-03,Stanislaus,099,539301,48095,46598,4987,51585,662
2021-02-03,Sutter,101,95872,8490,8379,78,8457,90
2021-02-03,Tehama,103,63373,4426,4309,472,4781,21
2021-02-03,Trinity,105,12862,445,260,66,326,3
2021-02-03,Tulare,107,460477,46407,44838,7124,51962,640
2021-02-03,Tuolumne,109,53932,3548,3568,31,3599,45
2021-02-03,Ventura,111,848112,73807,72124,2610,74734,526
2021-02-03,Yolo,113,214977,12311,11933,191,12124,161
2021-02-03,Yuba,115,75493,5236,5124,78,5202,34
2021-02-02,Alameda,001,1643700,76490,74642,1622,76264,869
2021-02-02,Alpine,003,1148,73,72,0,72,0
2021-02-02,Amador,005,37829,3316,3275,27,3302,33
2021-02-02,Butte,007,227075,10869,10307,1517,11824,141
2021-02-02,Calaveras,009,45235,1825,1786,11,1797,21
2021-02-02,Colusa,011,21464,1791,1769,226,1995,9
2021-02-02,Contra Costa,013,1133247,59474,57551,996,58547,536
2021-02-02,Del Norte,015,27424,901,868,4,872,2
2021-02-02,El Dorado,017,186661,8704,8405,565,8970,84
2021-02-02,Fresno,019,978130,92389,89542,7152,96694,1009
2021-02-02,Glenn,021,27897,2158,2090,459,2549,14
2021-02-02,Humboldt,023,135768,2894,2784,19,2803,25
2021-02-02,Imperial,025,180216,26757,26317,2434,28751,535
2021-02-02,Inyo,027,18085,1130,1074,8,1082,27
2021-02-02,Kern,029,883053,89580,86485,8806,95291,867
2021-02-02,Kings,031,150075,21425,20785,904,21689,172
2021-02-02,Lake,033,64148,2945,2857,1,2858,33
2021-02-02,Lassen,035,31185,4994,4908,88,4996,1
2021-02-02,Los Angeles,037,10098052,1135519,1097573,37366,1134939,16913
2021-02-02,Madera,039,155013,14967,14595,739,15334,94
2021-02-02,Marin,041,260295,12594,12367,149,12516,189
2021-02-02,Mariposa,043,17540,362,345,3,348,4
2021-02-02,Mendocino,045,87422,3392,3210,64,3274,38
2021-02-02,Merced,047,269075,26759,26427,794,27221,340
2021-02-02,Modoc,049,8938,325,306,107,413,3
2021-02-02,Mono,051,14174,1142,1147,16,1163,3
2021-02-02,Monterey,053,433212,40311,39371,1475,40846,278
2021-02-02,Napa,055,140530,8644,8505,33,8538,53
2021-02-02,Nevada,057,99092,3730,3548,148,3696,20
2021-02-02,Orange,059,3164182,238668,233783,9679,243462,3152
2021-02-02,Placer,061,380077,19655,18615,1016,19631,205
2021-02-02,Plumas,063,18699,625,560,10,570,2
2021-02-02,Riverside,065,2383286,276697,267901,13008,280909,3169
2021-02-02,Sacramento,067,1510023,89321,87107,1103,88210,1202
2021-02-02,San Benito,069,59416,5510,5444,75,5519,50
2021-02-02,San Bernardino,071,2135413,279177,270486,8224,278710,2244
2021-02-02,San Diego,073,3302833,251875,240047,11979,252026,2629
2021-02-02,San Francisco,075,870044,32409,31788,915,32703,324
2021-02-02,San Joaquin,077,732212,63669,61708,2560,64268,878
2021-02-02,San Luis Obispo,079,281455,18556,17811,497,18308,201
2021-02-02,San Mateo,081,765935,37617,36004,365,36369,225
2021-02-02,Santa Barbara,083,443738,30188,28951,930,29881,304
2021-02-02,Santa Clara,085,1922200,104639,102872,493,103365,1349
2021-02-02,Santa Cruz,087,273765,14692,13572,716,14288,150
2021-02-02,Shasta,089,179085,10486,10371,1106,11477,128
2021-02-02,Sierra,091,2930,49,42,12,54,0
2021-02-02,Siskiyou,093,43540,1358,1252,205,1457,4
2021-02-02,Solano,095,438530,28539,27963,327,28290,118
2021-02-02,Sonoma,097,501317,26407,26054,146,26200,247
2021-02-02,Stanislaus,099,539301,47876,46306,4955,51261,641
2021-02-02,Sutter,101,95872,8467,8340,78,8418,89
2021-02-02,Tehama,103,63373,4412,4289,471,4760,21
2021-02-02,Trinity,105,12862,445,260,66,326,3
2021-02-02,Tulare,107,460477,46251,44720,7058,51778,625
2021-02-02,Tuolumne,109,53932,3536,3548,31,3579,39
2021-02-02,Ventura,111,848112,73389,71557,2600,74157,514
2021-02-02,Yolo,113,214977,12266,11886,184,12070,158
2021-02-02,Yuba,115,75493,5218,5111,77,5188,34
2021-02-01,Alameda,001,1643700,76133,74374,1617,75991,858
2021-02-01,Alpine,003,1148,73,72,0,72,0
2021-02-01,Amador,005,37829,3305,3234,27,3261,32
2021-02-01,Butte,007,227075,10825,10263,1513,11776,141
2021-02-01,Calaveras,009,45235,1818,1785,11,1796,21
2021-02-01,Colusa,011,21464,1786,1763,217,1980,9
2021-02-01,Contra Costa,013,1133247,59230,57324,995,58319,531
2021-02-01,Del Norte,015,27424,897,865,4,869,2
2021-02-01,El Dorado,017,186661,8665,8337,565,8902,83
2021-02-01,Fresno,019,978130,92057,89272,7117,96389,994
2021-02-01,Glenn,021,27897,2142,2086,451,2537,14
2021-02-01,Humboldt,023,135768,2873,2773,18,2791,25
2021-02-01,Imperial,025,180216,26713,26224,2432,28656,530
2021-02-01,Inyo,027,18085,1120,1072,8,1080,27
2021-02-01,Kern,029,883053,89183,86170,8737,94907,862
2021-02-01,Kings,031,150075,21334,20746,896,21642,172
2021-02-01,Lake,033,64148,2929,2843,1,2844,33
2021-02-01,Lassen,035,31185,4974,4907,88,4995,1
2021-02-01,Los Angeles,037,10098052,1131697,1094341,37196,1131537,16695
2021-02-01,Madera,039,155013,14932,14572,736,15308,94
2021-02-01,Marin,041,260295,12555,12341,148,12489,188
2021-02-01,Mariposa,043,17540,360,344,3,347,4
2021-02-01,Mendocino,045,87422,3359,3192,64,3256,37
2021-02-01,Merced,047,269075,26635,26282,785,27067,337
2021-02-01,Modoc,049,8938,319,303,103,406,1
2021-02-01,Mono,051,14174,1139,1145,16,1161,3
2021-02-01,Monterey,053,433212,40127,39196,1453,40649,278
2021-02-01,Napa,055,140530,8612,8449,33,8482,52
2021-02-01,Nevada,057,99092,3713,3535,147,3682,20
2021-02-01,Orange,059,3164182,237755,233155,9633,242788,3100
2021-02-01,Placer,061,380077,19589,18574,1009,19583,204
2021-02-01,Plumas,063,18699,623,554,10,564,2
2021-02-01,Riverside,065,2383286,275760,267025,12971,279996,3092
2021-02-01,Sacramento,067,1510023,88920,86856,1092,87948,1193
2021-02-01,San Benito,069,59416,5492,5432,75,5507,48
2021-02-01,San Bernardino,071,2135413,278482,270012,8184,278196,2172
2021-02-01,San Diego,073,3302833,250651,239121,11903,251024,2619
2021-02-01,San Francisco,075,870044,32274,31703,903,32606,324
2021-02-01,San Joaquin,077,732212,63463,61542,2549,64091,877
2021-02-01,San Luis Obispo,079,281455,18436,17690,490,18180,199
2021-02-01,San Mateo,081,765935,37468,35843,365,36208,220
2021-02-01,Santa Barbara,083,443738,30019,28837,922,29759,297
2021-02-01,Santa Clara,085,1922200,104222,102462,492,102954,1343
2021-02-01,Santa Cruz,087,273765,14639,13524,714,14238,149
2021-02-01,Shasta,089,179085,10461,10329,1100,11429,112
2021-02-01,Sierra,091,2930,49,42,12,54,0
2021-02-01,Siskiyou,093,43540,1351,1238,202,1440,4
2021-02-01,Solano,095,438530,28434,27844,326,28170,117
2021-02-01,Sonoma,097,501317,26319,26011,145,26156,243
2021-02-01,Stanislaus,099,539301,47619,46112,4927,51039,642
2021-02-01,Sutter,101,95872,8428,8313,78,8391,89
2021-02-01,Tehama,103,63373,4386,4263,471,4734,21
2021-02-01,Trinity,105,12862,443,260,66,326,3
2021-02-01,Tulare,107,460477,46106,44569,6977,51546,618
2021-02-01,Tuolumne,109,53932,3528,3534,31,3565,39
2021-02-01,Ventura,111,848112,72984,71104,2583,73687,502
2021-02-01,Yolo,113,214977,12219,11824,176,12000,151
2021-02-01,Yuba,115,75493,5204,5084,76,5160,33
2021-01-31,Alameda,001,1643700,75705,73979,1609,75588,857
2021-01-31,Alpine,003,1148,73,72,0,72,0
2021-01-31,Amador,005,37829,3295,3212,25,3237,32
2021-01-31,Butte,007,227075,10780,10215,1503,11718,140
2021-01-31,Calaveras,009,45235,1798,1778,11,1789,21
2021-01-31,Colusa,011,21464,1780,1754,212,1966,9
2021-01-31,Contra Costa,013,1133247,58898,57079,995,58074,531
2021-01-31,Del Norte,015,27424,895,865,4,869,2
2021-01-31,El Dorado,017,186661,8629,8317,563,8880,83
2021-01-31,Fresno,019,978130,91745,88852,7063,95915,994
2021-01-31,Glenn,021,27897,2131,2083,450,2533,14
2021-01-31,Humboldt,023,135768,2857,2767,18,2785,25
2021-01-31,Imperial,025,180216,26641,26206,2423,28629,530
2021-01-31,Inyo,027,18085,1107,1072,8,1080,27
2021-01-31,Kern,029,883053,88687,85872,8651,94523,861
2021-01-31,Kings,031,150075,21249,20709,884,21593,172
2021-01-31,Lake,033,64148,2908,2826,1,2827,33
2021-01-31,Lassen,035,31185,4958,4900,88,4988,1
2021-01-31,Los Angeles,037,10098052,1127071,1090304,36991,1127295,16609
2021-01-31,Madera,039,155013,14878,14496,728,15224,94
2021-01-31,Marin,041,260295,12508,12297,144,12441,185
2021-01-31,Mariposa,043,17540,358,344,3,347,4
2021-01-31,Mendocino,045,87422,3336,3181,63,3244,37
2021-01-31,Merced,047,269075,26491,26222,780,27002,337
2021-01-31,Modoc,049,8938,316,304,101,405,1
2021-01-31,Mono,051,14174,1136,1146,16,1162,3
2021-01-31,Monterey,053,433212,39948,39035,1426,40461,278
2021-01-31,Napa,055,140530,8570,8404,33,8437,52
2021-01-31,Nevada,057,99092,3691,3518,145,3663,20
2021-01-31,Orange,059,3164182,236738,232347,9592,241939,3053
2021-01-31,Placer,061,380077,19512,18506,998,19504,204
2021-01-31,Plumas,063,18699,622,554,10,564,2
2021-01-31,Riverside,065,2383286,274743,266145,12924,279069,3074
2021-01-31,Sacramento,067,1510023,88477,86560,1078,87638,1186
2021-01-31,San Benito,069,59416,5470,5425,73,5498,48
2021-01-31,San Bernardino,071,2135413,277452,269533,8153,277686,2156
2021-01-31,San Diego,073,3302833,249338,238039,11789,249828,2619
2021-01-31,San Francisco,075,870044,32083,31563,892,32455,323
2021-01-31,San Joaquin,077,732212,63062,61379,2540,63919,877
2021-01-31,San Luis Obispo,079,281455,18302,17615,485,18100,199
2021-01-31,San Mateo,081,765935,37278,35659,362,36021,219
2021-01-31,Santa Barbara,083,443738,29775,28570,913,29483,297
2021-01-31,Santa Clara,085,1922200,103673,101986,483,102469,1330
2021-01-31,Santa Cruz,087,273765,14544,13469,700,14169,149
2021-01-31,Shasta,089,179085,10416,10313,1091,11404,112
2021-01-31,Sierra,091,2930,48,43,12,55,0
2021-01-31,Siskiyou,093,43540,1341,1238,202,1440,4
2021-01-31,Solano,095,438530,28304,27678,325,28003,118
2021-01-31,Sonoma,097,501317,26216,25925,144,26069,243
2021-01-31,Stanislaus,099,539301,47335,45971,4894,50865,642
2021-01-31,Sutter,101,95872,8383,8289,78,8367,89
2021-01-31,Tehama,103,63373,4364,4256,470,4726,21
2021-01-31,Trinity,105,12862,441,260,66,326,3
2021-01-31,Tulare,107,460477,45938,44440,6896,51336,618
2021-01-31,Tuolumne,109,53932,3490,3519,31,3550,39
2021-01-31,Ventura,111,848112,72389,70635,2570,73205,502
2021-01-31,Yolo,113,214977,12157,11771,170,11941,151
2021-01-31,Yuba,115,75493,5184,5071,76,5147,33
2021-01-30,Alameda,001,1643700,75500,73622,1604,75226,850
2021-01-30,Alpine,003,1148,73,72,0,72,0
2021-01-30,Amador,005,37829,3291,3181,25,3206,32
2021-01-30,Butte,007,227075,10746,10177,1494,11671,139
2021-01-30,Calaveras,009,45235,1785,1763,11,1774,21
2021-01-30,Colusa,011,21464,1778,1748,212,1960,9
2021-01-30,Contra Costa,013,1133247,58715,56763,991,57754,531
2021-01-30,Del Norte,015,27424,894,865,4,869,2
2021-01-30,El Dorado,017,186661,8609,8299,562,8861,83
2021-01-30,Fresno,019,978130,91565,88476,7043,95519,964
2021-01-30,Glenn,021,27897,2128,2074,448,2522,14
2021-01-30,Humboldt,023,135768,2846,2742,18,2760,24
2021-01-30,Imperial,025,180216,26617,26160,2421,28581,530
2021-01-30,Inyo,027,18085,1103,1068,8,1076,27
2021-01-30,Kern,029,883053,88486,85572,8585,94157,848
2021-01-30,Kings,031,150075,21178,20605,879,21484,169
2021-01-30,Lake,033,64148,2902,2809,1,2810,33
2021-01-30,Lassen,035,31185,4954,4890,88,4978,1
2021-01-30,Los Angeles,037,10098052,1124672,1084763,36848,1121611,16484
2021-01-30,Madera,039,155013,14836,14443,723,15166,94
2021-01-30,Marin,041,260295,12480,12225,143,12368,185
2021-01-30,Mariposa,043,17540,356,344,3,347,4
2021-01-30,Mendocino,045,87422,3322,3153,62,3215,36
2021-01-30,Merced,047,269075,26417,26078,778,26856,335
2021-01-30,Modoc,049,8938,316,303,101,404,1
2021-01-30,Mono,051,14174,1136,1143,16,1159,3
2021-01-30,Monterey,053,433212,39888,38847,1423,40270,277
2021-01-30,Napa,055,140530,8554,8342,33,8375,52
2021-01-30,Nevada,057,99092,3672,3499,145,3644,20
2021-01-30,Orange,059,3164182,236193,231358,9555,240913,3013
2021-01-30,Placer,061,380077,19459,18430,992,19422,205
2021-01-30,Plumas,063,18699,620,554,10,564,2
2021-01-30,Riverside,065,2383286,274145,265137,12893,278030,3061
2021-01-30,Sacramento,067,1510023,88285,86388,1073,87461,1184
2021-01-30,San Benito,069,59416,5452,5401,72,5473,48
2021-01-30,San Bernardino,071,2135413,277027,268660,8134,276794,2122
2021-01-30,San Diego,073,3302833,248573,236765,11744,248509,2603
2021-01-30,San Francisco,075,870044,31982,31427,889,32316,316
2021-01-30,San Joaquin,077,732212,62930,61120,2531,63651,864
2021-01-30,San Luis Obispo,079,281455,18222,17522,483,18005,198
2021-01-30,San Mateo,081,765935,37139,35451,361,35812,219
2021-01-30,Santa Barbara,083,443738,29633,28342,911,29253,296
2021-01-30,Santa Clara,085,1922200,103326,101471,480,101951,1307
2021-01-30,Santa Cruz,087,273765,14504,13383,699,14082,149
2021-01-30,Shasta,089,179085,10397,10283,1088,11371,112
2021-01-30,Sierra,091,2930,48,43,12,55,0
2021-01-30,Siskiyou,093,43540,1338,1236,201,1437,4
2021-01-30,Solano,095,438530,28221,27511,323,27834,118
2021-01-30,Sonoma,097,501317,26168,25810,141,25951,243
2021-01-30,Stanislaus,099,539301,47205,45697,4867,50564,642
2021-01-30,Sutter,101,95872,8367,8226,78,8304,87
2021-01-30,Tehama,103,63373,4351,4229,469,4698,21
2021-01-30,Trinity,105,12862,441,259,66,325,3
2021-01-30,Tulare,107,460477,45802,44203,6859,51062,615
2021-01-30,Tuolumne,109,53932,3486,3508,31,3539,36
2021-01-30,Ventura,111,848112,72076,69931,2556,72487,493
2021-01-30,Yolo,113,214977,12143,11698,169,11867,151
2021-01-30,Yuba,115,75493,5174,5042,75,5117,33
2021-01-29,Alameda,001,1643700,75231,73210,1597,74807,841
2021-01-29,Alpine,003,1148,73,72,0,72,0
2021-01-29,Amador,005,37829,3279,3134,24,3158,32
2021-01-29,Butte,007,227075,10714,10122,1484,11606,138
2021-01-29,Calaveras,009,45235,1774,1757,11,1768,21
2021-01-29,Colusa,011,21464,1774,1734,211,1945,8
2021-01-29,Contra Costa,013,1133247,58544,56318,989,57307,529
2021-01-29,Del Norte,015,27424,893,865,4,869,2
2021-01-29,El Dorado,017,186661,8592,8231,561,8792,83
2021-01-29,Fresno,019,978130,91350,87936,7005,94941,962
2021-01-29,Glenn,021,27897,2123,2061,447,2508,14
2021-01-29,Humboldt,023,135768,2833,2707,18,2725,24
2021-01-29,Imperial,025,180216,26602,26045,2418,28463,521
2021-01-29,Inyo,027,18085,1091,1048,8,1056,27
2021-01-29,Kern,029,883053,88259,85044,8533,93577,836
2021-01-29,Kings,031,150075,21139,20466,874,21340,169
2021-01-29,Lake,033,64148,2893,2792,1,2793,32
2021-01-29,Lassen,035,31185,4951,4874,88,4962,1
2021-01-29,Los Angeles,037,10098052,1121183,1078329,36694,1115023,16190
2021-01-29,Madera,039,155013,14785,14377,723,15100,94
2021-01-29,Marin,041,260295,12435,12145,142,12287,185
2021-01-29,Mariposa,043,17540,355,342,3,345,4
2021-01-29,Mendocino,045,87422,3313,3131,61,3192,36
2021-01-29,Merced,047,269075,26343,25865,773,26638,334
2021-01-29,Modoc,049,8938,315,297,101,398,1
2021-01-29,Mono,051,14174,1134,1139,16,1155,3
2021-01-29,Monterey,053,433212,39773,38539,1415,39954,277
2021-01-29,Napa,055,140530,8523,8276,33,8309,52
2021-01-29,Nevada,057,99092,3663,3487,144,3631,20
2021-01-29,Orange,059,3164182,235516,229917,9517,239434,2967
2021-01-29,Placer,061,380077,19406,18367,988,19355,203
2021-01-29,Plumas,063,18699,619,548,10,558,2
2021-01-29,Riverside,065,2383286,273343,263504,12860,276364,3008
2021-01-29,Sacramento,067,1510023,88030,86320,1069,87389,1169
2021-01-29,San Benito,069,59416,5444,5386,72,5458,48
2021-01-29,San Bernardino,071,2135413,276513,267490,8094,275584,2095
2021-01-29,San Diego,073,3302833,247631,234637,11666,246303,2571
2021-01-29,San Francisco,075,870044,31843,31294,881,32175,307
2021-01-29,San Joaquin,077,732212,62785,60899,2517,63416,858
2021-01-29,San Luis Obispo,079,281455,18162,17440,478,17918,193
2021-01-29,San Mateo,081,765935,37005,35223,358,35581,218
2021-01-29,Santa Barbara,083,443738,29499,28105,905,29010,291
2021-01-29,Santa Clara,085,1922200,102963,101010,478,101488,1273
2021-01-29,Santa Cruz,087,273765,14451,13311,696,14007,148
2021-01-29,Shasta,089,179085,10380,10220,1084,11304,112
2021-01-29,Sierra,091,2930,48,43,12,55,0
2021-01-29,Siskiyou,093,43540,1337,1227,201,1428,4
2021-01-29,Solano,095,438530,28138,27352,321,27673,116
2021-01-29,Sonoma,097,501317,26112,25710,140,25850,243
2021-01-29,Stanislaus,099,539301,47062,45466,4845,50311,642
2021-01-29,Sutter,101,95872,8348,8181,78,8259,87
2021-01-29,Tehama,103,63373,4339,4191,467,4658,20
2021-01-29,Trinity,105,12862,441,260,66,326,3
2021-01-29,Tulare,107,460477,45695,43925,6820,50745,606
2021-01-29,Tuolumne,109,53932,3476,3483,31,3514,36
2021-01-29,Ventura,111,848112,71652,69511,2542,72053,484
2021-01-29,Yolo,113,214977,12105,11612,168,11780,151
2021-01-29,Yuba,115,75493,5158,5018,75,5093,32
2021-01-28,Alameda,001,1643700,74805,72758,1589,74347,833
2021-01-28,Alpine,003,1148,73,72,0,72,0
2021-01-28,Amador,005,37829,3242,3124,24,3148,31
2021-01-28,Butte,007,227075,10673,10037,1473,11510,138
2021-01-28,Calaveras,009,45235,1761,1747,10,1757,21
2021-01-28,Colusa,011,21464,1767,1731,207,1938,8
2021-01-28,Contra Costa,013,1133247,58301,55999,979,56978,525
2021-01-28,Del Norte,015,27424,892,862,4,866,2
2021-01-28,El Dorado,017,186661,8578,8198,556,8754,79
2021-01-28,Fresno,019,978130,91062,87401,6955,94356,949
2021-01-28,Glenn,021,27897,2118,2043,440,2483,14
2021-01-28,Humboldt,023,135768,2816,2686,18,2704,24
2021-01-28,Imperial,025,180216,26558,25984,2411,28395,517
2021-01-28,Inyo,027,18085,1086,1039,8,1047,27
2021-01-28,Kern,029,883053,87930,84708,8449,93157,817
2021-01-28,Kings,031,150075,21079,20328,870,21198,167
2021-01-28,Lake,033,64148,2878,2772,1,2773,32
2021-01-28,Lassen,035,31185,4945,4865,88,4953,1
2021-01-28,Los Angeles,037,10098052,1117274,1072412,36505,1108917,15967
2021-01-28,Madera,039,155013,14729,14301,719,15020,94
2021-01-28,Marin,041,260295,12382,12079,141,12220,183
2021-01-28,Mariposa,043,17540,355,334,3,337,4
2021-01-28,Mendocino,045,87422,3296,3110,61,3171,36
2021-01-28,Merced,047,269075,26221,25620,761,26381,328
2021-01-28,Modoc,049,8938,314,297,101,398,0
2021-01-28,Mono,051,14174,1132,1131,16,1147,3
2021-01-28,Monterey,053,433212,39580,38312,1396,39708,274
2021-01-28,Napa,055,140530,8476,8233,33,8266,50
2021-01-28,Nevada,057,99092,3648,3452,143,3595,19
2021-01-28,Orange,059,3164182,234536,228636,9487,238123,2860
2021-01-28,Placer,061,380077,19345,18246,985,19231,198
2021-01-28,Plumas,063,18699,618,547,10,557,2
2021-01-28,Riverside,065,2383286,272562,262342,12812,275154,2981
2021-01-28,Sacramento,067,1510023,87668,85698,1058,86756,1149
2021-01-28,San Benito,069,59416,5426,5344,71,5415,47
2021-01-28,San Bernardino,071,2135413,275811,266456,8073,274529,2057
2021-01-28,San Diego,073,3302833,246479,232967,11577,244544,2534
2021-01-28,San Francisco,075,870044,31706,31193,865,32058,290
2021-01-28,San Joaquin,077,732212,62518,60627,2502,63129,854
2021-01-28,San Luis Obispo,079,281455,18062,17279,476,17755,189
2021-01-28,San Mateo,081,765935,36836,34931,342,35273,218
2021-01-28,Santa Barbara,083,443738,29275,27674,892,28566,284
2021-01-28,Santa Clara,085,1922200,102496,100470,476,100946,1219
2021-01-28,Santa Cruz,087,273765,14362,13188,690,13878,145
2021-01-28,Shasta,089,179085,10346,10176,1076,11252,110
2021-01-28,Sierra,091,2930,48,43,12,55,0
2021-01-28,Siskiyou,093,43540,1330,1218,199,1417,4
2021-01-28,Solano,095,438530,27977,27163,320,27483,114
2021-01-28,Sonoma,097,501317,26021,25564,140,25704,236
2021-01-28,Stanislaus,099,539301,46853,45162,4825,49987,640
2021-01-28,Sutter,101,95872,8301,8136,78,8214,85
2021-01-28,Tehama,103,63373,4316,4163,464,4627,20
2021-01-28,Trinity,105,12862,439,260,66,326,3
2021-01-28,Tulare,107,460477,45538,43742,6742,50484,595
2021-01-28,Tuolumne,109,53932,3462,3472,31,3503,32
2021-01-28,Ventura,111,848112,71139,68896,2525,71421,475
2021-01-28,Yolo,113,214977,12063,11500,163,11663,151
2021-01-28,Yuba,115,75493,5142,4994,74,5068,32
2021-01-27,Alameda,001,1643700,74381,72188,1581,73769,815
2021-01-27,Alpine,003,1148,73,72,0,72,0
2021-01-27,Amador,005,37829,3226,3116,24,3140,31
2021-01-27,Butte,007,227075,10634,9988,1460,11448,138
2021-01-27,Calaveras,009,45235,1752,1737,10,1747,21
2021-01-27,Colusa,011,21464,1761,1724,205,1929,8
2021-01-27,Contra Costa,013,1133247,58002,55578,976,56554,507
2021-01-27,Del Norte,015,27424,891,859,4,863,2
2021-01-27,El Dorado,017,186661,8552,8141,555,8696,76
2021-01-27,Fresno,019,978130,90771,86886,6913,93799,938
2021-01-27,Glenn,021,27897,2114,2042,439,2481,14
2021-01-27,Humboldt,023,135768,2794,2630,18,2648,24
2021-01-27,Imperial,025,180216,26504,25861,2396,28257,504
2021-01-27,Inyo,027,18085,1082,1023,8,1031,27
2021-01-27,Kern,029,883053,87619,84244,8379,92623,809
2021-01-27,Kings,031,150075,20973,20211,862,21073,167
2021-01-27,Lake,033,64148,2858,2750,1,2751,32
2021-01-27,Lassen,035,31185,4939,4851,88,4939,1
2021-01-27,Los Angeles,037,10098052,1112467,1066569,36293,1102862,15757
2021-01-27,Madera,039,155013,14688,14194,714,14908,86
2021-01-27,Marin,041,260295,12345,12028,140,12168,180
2021-01-27,Mariposa,043,17540,355,333,3,336,4
2021-01-27,Mendocino,045,87422,3276,3095,61,3156,36
2021-01-27,Merced,047,269075,26062,25439,750,26189,315
2021-01-27,Modoc,049,8938,314,297,98,395,0
2021-01-27,Mono,051,14174,1130,1131,16,1147,3
2021-01-27,Monterey,053,433212,39372,38139,1377,39516,268
2021-01-27,Napa,055,140530,8403,8187,33,8220,46
2021-01-27,Nevada,057,99092,3626,3431,143,3574,18
2021-01-27,Orange,059,3164182,233416,227110,9433,236543,2832
2021-01-27,Placer,061,380077,19273,18106,974,19080,198
2021-01-27,Plumas,063,18699,618,544,10,554,2
2021-01-27,Riverside,065,2383286,271365,260796,12760,273556,2931
2021-01-27,Sacramento,067,1510023,87308,85428,1047,86475,1142
2021-01-27,San Benito,069,59416,5411,5284,71,5355,47
2021-01-27,San Bernardino,071,2135413,274962,265153,8042,273195,2019
2021-01-27,San Diego,073,3302833,245150,231478,11472,242950,2465
2021-01-27,San Francisco,075,870044,31562,31082,858,31940,287
2021-01-27,San Joaquin,077,732212,62248,60131,2479,62610,853
2021-01-27,San Luis Obispo,079,281455,17955,17119,472,17591,188
2021-01-27,San Mateo,081,765935,36681,34619,339,34958,216
2021-01-27,Santa Barbara,083,443738,29098,27435,886,28321,282
2021-01-27,Santa Clara,085,1922200,102092,99732,472,100204,1184
2021-01-27,Santa Cruz,087,273765,14292,13111,687,13798,143
2021-01-27,Shasta,089,179085,10312,10106,1070,11176,105
2021-01-27,Sierra,091,2930,48,44,12,56,0
2021-01-27,Siskiyou,093,43540,1325,1214,196,1410,4
2021-01-27,Solano,095,438530,27799,26982,313,27295,112
2021-01-27,Sonoma,097,501317,25922,25361,136,25497,237
2021-01-27,Stanislaus,099,539301,46670,44874,4799,49673,624
2021-01-27,Sutter,101,95872,8257,8093,77,8170,83
2021-01-27,Tehama,103,63373,4296,4133,460,4593,20
2021-01-27,Trinity,105,12862,439,260,66,326,3
2021-01-27,Tulare,107,460477,45351,43462,6671,50133,583
2021-01-27,Tuolumne,109,53932,3452,3464,31,3495,32
2021-01-27,Ventura,111,848112,70666,68291,2500,70791,468
2021-01-27,Yolo,113,214977,12016,11427,159,11586,151
2021-01-27,Yuba,115,75493,5126,4968,74,5042,32
2021-01-26,Alameda,001,1643700,74008,71851,1564,73415,789
2021-01-26,Alpine,003,1148,73,72,0,72,0
2021-01-26,Amador,005,37829,3215,3113,24,3137,31
2021-01-26,Butte,007,227075,10592,9943,1454,11397,136
2021-01-26,Calaveras,009,45235,1742,1723,10,1733,21
2021-01-26,Colusa,011,21464,1754,1719,202,1921,8
2021-01-26,Contra Costa,013,1133247,57723,55337,968,56305,491
2021-01-26,Del Norte,015,27424,890,856,4,860,2
2021-01-26,El Dorado,017,186661,8526,8115,552,8667,71
2021-01-26,Fresno,019,978130,90413,86673,6869,93542,923
2021-01-26,Glenn,021,27897,2104,2034,434,2468,13
2021-01-26,Humboldt,023,135768,2773,2612,17,2629,24
2021-01-26,Imperial,025,180216,26431,25812,2383,28195,498
2021-01-26,Inyo,027,18085,1075,1018,8,1026,27
2021-01-26,Kern,029,883053,87196,83868,8302,92170,790
2021-01-26,Kings,031,150075,20915,20156,857,21013,159
2021-01-26,Lake,033,64148,2849,2748,1,2749,32
2021-01-26,Lassen,035,31185,4933,4844,88,4932,1
2021-01-26,Los Angeles,037,10098052,1107185,1060492,36087,1096579,15458
2021-01-26,Madera,039,155013,14631,14130,708,14838,86
2021-01-26,Marin,041,260295,12300,11993,138,12131,179
2021-01-26,Mariposa,043,17540,353,332,3,335,3
2021-01-26,Mendocino,045,87422,3250,3076,60,3136,36
2021-01-26,Merced,047,269075,25922,25359,742,26101,309
2021-01-26,Modoc,049,8938,307,291,97,388,0
2021-01-26,Mono,051,14174,1128,1120,16,1136,3
2021-01-26,Monterey,053,433212,39178,37963,1357,39320,255
2021-01-26,Napa,055,140530,8346,8145,33,8178,43
2021-01-26,Nevada,057,99092,3619,3410,142,3552,18
2021-01-26,Orange,059,3164182,232294,225987,9388,235375,2760
2021-01-26,Placer,061,380077,19197,18016,972,18988,193
2021-01-26,Plumas,063,18699,616,536,10,546,2
2021-01-26,Riverside,065,2383286,269998,259399,12696,272095,2898
2021-01-26,Sacramento,067,1510023,86950,85062,1040,86102,1127
2021-01-26,San Benito,069,59416,5397,5251,70,5321,45
2021-01-26,San Bernardino,071,2135413,273960,263736,7998,271734,1970
2021-01-26,San Diego,073,3302833,243655,230063,11370,241433,2421
2021-01-26,San Francisco,075,870044,31430,30874,839,31713,286
2021-01-26,San Joaquin,077,732212,61994,59889,2463,62352,847
2021-01-26,San Luis Obispo,079,281455,17874,17016,469,17485,186
2021-01-26,San Mateo,081,765935,36487,34441,328,34769,213
2021-01-26,Santa Barbara,083,443738,28924,27321,874,28195,273
2021-01-26,Santa Clara,085,1922200,101613,99215,469,99684,1171
2021-01-26,Santa Cruz,087,273765,14226,13045,681,13726,134
2021-01-26,Shasta,089,179085,10277,10036,1062,11098,103
2021-01-26,Sierra,091,2930,48,43,12,55,0
2021-01-26,Siskiyou,093,43540,1310,1208,194,1402,4
2021-01-26,Solano,095,438530,27643,26858,307,27165,110
2021-01-26,Sonoma,097,501317,25804,25273,134,25407,236
2021-01-26,Stanislaus,099,539301,46488,44703,4757,49460,599
2021-01-26,Sutter,101,95872,8214,8067,77,8144,83
2021-01-26,Tehama,103,63373,4263,4115,460,4575,20
2021-01-26,Trinity,105,12862,439,260,66,326,3
2021-01-26,Tulare,107,460477,45148,43394,6601,49995,579
2021-01-26,Tuolumne,109,53932,3442,3451,31,3482,30
2021-01-26,Ventura,111,848112,70133,67526,2474,70000,448
2021-01-26,Yolo,113,214977,11971,11361,156,11517,148
2021-01-26,Yuba,115,75493,5101,4944,72,5016,31
2021-01-25,Alameda,001,1643700,73578,71255,1554,72809,780
2021-01-25,Alpine,003,1148,73,72,0,72,0
2021-01-25,Amador,005,37829,3175,3074,24,3098,30
2021-01-25,Butte,007,227075,10525,9865,1446,11311,133
2021-01-25,Calaveras,009,45235,1727,1713,10,1723,21
2021-01-25,Colusa,011,21464,1742,1709,198,1907,8
2021-01-25,Contra Costa,013,1133247,57366,54989,961,55950,488
2021-01-25,Del Norte,015,27424,889,855,4,859,2
2021-01-25,El Dorado,017,186661,8501,8060,552,8612,66
2021-01-25,Fresno,019,978130,90042,86336,6837,93173,913
2021-01-25,Glenn,021,27897,2095,2028,434,2462,13
2021-01-25,Humboldt,023,135768,2739,2587,17,2604,24
2021-01-25,Imperial,025,180216,26382,25745,2375,28120,491
2021-01-25,Inyo,027,18085,1069,1015,8,1023,27
2021-01-25,Kern,029,883053,86809,83401,8216,91617,787
2021-01-25,Kings,031,150075,20795,20067,853,20920,159
2021-01-25,Lake,033,64148,2830,2729,1,2730,32
2021-01-25,Lassen,035,31185,4906,4835,88,4923,1
2021-01-25,Los Angeles,037,10098052,1101229,1055181,35858,1091039,15163
2021-01-25,Madera,039,155013,14577,14068,703,14771,86
2021-01-25,Marin,041,260295,12248,11923,134,12057,177
2021-01-25,Mariposa,043,17540,350,331,3,334,3
2021-01-25,Mendocino,045,87422,3239,3054,60,3114,35
2021-01-25,Merced,047,269075,25783,25181,733,25914,305
2021-01-25,Modoc,049,8938,306,288,93,381,0
2021-01-25,Mono,051,14174,1125,1114,15,1129,3
2021-01-25,Monterey,053,433212,38925,37726,1338,39064,255
2021-01-25,Napa,055,140530,8312,8057,32,8089,43
2021-01-25,Nevada,057,99092,3605,3365,142,3507,18
2021-01-25,Orange,059,3164182,231084,225105,9346,234451,2696
2021-01-25,Placer,061,380077,19110,17936,957,18893,193
2021-01-25,Plumas,063,18699,613,533,10,543,2
2021-01-25,Riverside,065,2383286,268259,258082,12640,270722,2789
2021-01-25,Sacramento,067,1510023,86509,84653,1032,85685,1118
2021-01-25,San Benito,069,59416,5361,5238,69,5307,43
2021-01-25,San Bernardino,071,2135413,273015,263174,7962,271136,1947
2021-01-25,San Diego,073,3302833,242041,228630,11298,239928,2375
2021-01-25,San Francisco,075,870044,31280,30734,816,31550,288
2021-01-25,San Joaquin,077,732212,61700,59291,2438,61729,838
2021-01-25,San Luis Obispo,079,281455,17740,16868,464,17332,179
2021-01-25,San Mateo,081,765935,36253,34187,322,34509,213
2021-01-25,Santa Barbara,083,443738,28689,27065,864,27929,269
2021-01-25,Santa Clara,085,1922200,101043,98647,461,99108,1143
2021-01-25,Santa Cruz,087,273765,14139,12973,676,13649,133
2021-01-25,Shasta,089,179085,10236,9991,1051,11042,103
2021-01-25,Sierra,091,2930,48,42,12,54,0
2021-01-25,Siskiyou,093,43540,1302,1205,191,1396,4
2021-01-25,Solano,095,438530,27475,26648,306,26954,109
2021-01-25,Sonoma,097,501317,25697,25160,132,25292,233
2021-01-25,Stanislaus,099,539301,46242,44293,4714,49007,599
2021-01-25,Sutter,101,95872,8171,8023,77,8100,83
2021-01-25,Tehama,103,63373,4236,4082,456,4538,20
2021-01-25,Trinity,105,12862,439,262,66,328,3
2021-01-25,Tulare,107,460477,44932,43124,6496,49620,578
2021-01-25,Tuolumne,109,53932,3433,3422,31,3453,29
2021-01-25,Ventura,111,848112,69499,66910,2457,69367,439
2021-01-25,Yolo,113,214977,11885,11276,155,11431,140
2021-01-25,Yuba,115,75493,5079,4900,70,4970,31
2021-01-24,Alameda,001,1643700,73071,70823,1543,72366,780
2021-01-24,Alpine,003,1148,73,72,0,72,0
2021-01-24,Amador,005,37829,3142,3054,24,3078,30
2021-01-24,Butte,007,227075,10441,9820,1429,11249,133
2021-01-24,Calaveras,009,45235,1714,1704,10,1714,21
2021-01-24,Colusa,011,21464,1731,1689,192,1881,8
2021-01-24,Contra Costa,013,1133247,56978,54694,948,55642,488
2021-01-24,Del Norte,015,27424,885,855,4,859,2
2021-01-24,El Dorado,017,186661,8466,8003,548,8551,66
2021-01-24,Fresno,019,978130,89605,85808,6798,92606,911
2021-01-24,Glenn,021,27897,2087,2026,433,2459,13
2021-01-24,Humboldt,023,135768,2700,2562,17,2579,24
2021-01-24,Imperial,025,180216,26287,25707,2351,28058,488
2021-01-24,Inyo,027,18085,1053,1007,8,1015,27
2021-01-24,Kern,029,883053,86372,83125,8108,91233,785
2021-01-24,Kings,031,150075,20667,19988,837,20825,159
2021-01-24,Lake,033,64148,2812,2724,0,2724,32
2021-01-24,Lassen,035,31185,4895,4828,85,4913,1
2021-01-24,Los Angeles,037,10098052,1094825,1048757,35545,1084302,15119
2021-01-24,Madera,039,155013,14487,14000,697,14697,86
2021-01-24,Marin,041,260295,12181,11872,132,12004,177
2021-01-24,Mariposa,043,17540,346,322,3,325,3
2021-01-24,Mendocino,045,87422,3218,3037,59,3096,33
2021-01-24,Merced,047,269075,25572,25047,723,25770,305
2021-01-24,Modoc,049,8938,306,285,93,378,0
2021-01-24,Mono,051,14174,1118,1113,15,1128,3
2021-01-24,Monterey,053,433212,38653,37527,1304,38831,254
2021-01-24,Napa,055,140530,8270,8005,32,8037,43
2021-01-24,Nevada,057,99092,3563,3349,140,3489,18
2021-01-24,Orange,059,3164182,229655,223853,9276,233129,2632
2021-01-24,Placer,061,380077,18995,17839,937,18776,193
2021-01-24,Plumas,063,18699,610,532,10,542,2
2021-01-24,Riverside,065,2383286,266618,256767,12564,269331,2761
2021-01-24,Sacramento,067,1510023,85955,84110,1024,85134,1112
2021-01-24,San Benito,069,59416,5319,5223,66,5289,43
2021-01-24,San Bernardino,071,2135413,271688,262370,7908,270278,1935
2021-01-24,San Diego,073,3302833,240347,227193,11167,238360,2375
2021-01-24,San Francisco,075,870044,31092,30559,794,31353,275
2021-01-24,San Joaquin,077,732212,61272,59021,2422,61443,838
2021-01-24,San Luis Obispo,079,281455,17616,16758,462,17220,179
2021-01-24,San Mateo,081,765935,36008,33956,317,34273,213
2021-01-24,Santa Barbara,083,443738,28373,26735,854,27589,269
2021-01-24,Santa Clara,085,1922200,100394,98103,456,98559,1109
2021-01-24,Santa Cruz,087,273765,14053,12905,668,13573,133
2021-01-24,Shasta,089,179085,10165,9978,1042,11020,103
2021-01-24,Sierra,091,2930,47,42,12,54,0
2021-01-24,Siskiyou,093,43540,1295,1195,191,1386,4
2021-01-24,Solano,095,438530,27286,26515,302,26817,109
2021-01-24,Sonoma,097,501317,25534,25045,131,25176,233
2021-01-24,Stanislaus,099,539301,45933,44031,4652,48683,599
2021-01-24,Sutter,101,95872,8107,7980,77,8057,83
2021-01-24,Tehama,103,63373,4196,4062,451,4513,20
2021-01-24,Trinity,105,12862,439,262,66,328,3
2021-01-24,Tulare,107,460477,44713,43006,6403,49409,577
2021-01-24,Tuolumne,109,53932,3423,3416,31,3447,29
2021-01-24,Ventura,111,848112,68788,66347,2433,68780,439
2021-01-24,Yolo,113,214977,11801,11210,151,11361,140
2021-01-24,Yuba,115,75493,5039,4875,69,4944,31
2021-01-23,Alameda,001,1643700,72821,70080,1536,71616,780
2021-01-23,Alpine,003,1148,73,72,0,72,0
2021-01-23,Amador,005,37829,3139,3049,24,3073,30
2021-01-23,Butte,007,227075,10412,9757,1426,11183,133
2021-01-23,Calaveras,009,45235,1711,1695,10,1705,21
2021-01-23,Colusa,011,21464,1727,1672,191,1863,8
2021-01-23,Contra Costa,013,1133247,56765,54162,941,55103,487
2021-01-23,Del Norte,015,27424,884,855,4,859,2
2021-01-23,El Dorado,017,186661,8450,7984,546,8530,66
2021-01-23,Fresno,019,978130,89420,85274,6769,92043,910
2021-01-23,Glenn,021,27897,2084,2015,429,2444,13
2021-01-23,Humboldt,023,135768,2681,2493,16,2509,23
2021-01-23,Imperial,025,180216,26253,25581,2341,27922,487
2021-01-23,Inyo,027,18085,1044,987,8,995,27
2021-01-23,Kern,029,883053,86128,82602,8040,90642,783
2021-01-23,Kings,031,150075,20623,19904,835,20739,159
2021-01-23,Lake,033,64148,2804,2673,0,2673,32
2021-01-23,Lassen,035,31185,4894,4816,82,4898,1
2021-01-23,Los Angeles,037,10098052,1091598,1040961,35382,1076343,15034
2021-01-23,Madera,039,155013,14451,13858,694,14552,86
2021-01-23,Marin,041,260295,12125,11796,130,11926,177
2021-01-23,Mariposa,043,17540,346,323,3,326,3
2021-01-23,Mendocino,045,87422,3204,2991,59,3050,32
2021-01-23,Merced,047,269075,25480,24787,708,25495,303
2021-01-23,Modoc,049,8938,306,285,93,378,0
2021-01-23,Mono,051,14174,1116,1111,15,1126,3
2021-01-23,Monterey,053,433212,38570,37165,1299,38464,253
2021-01-23,Napa,055,140530,8245,7893,32,7925,43
2021-01-23,Nevada,057,99092,3552,3332,139,3471,18
2021-01-23,Orange,059,3164182,228887,221722,9236,230958,2618
2021-01-23,Placer,061,380077,18944,17617,932,18549,193
2021-01-23,Plumas,063,18699,609,528,10,538,2
2021-01-23,Riverside,065,2383286,265717,253636,12512,266148,2733
2021-01-23,Sacramento,067,1510023,85727,83408,1021,84429,1108
2021-01-23,San Benito,069,59416,5295,5166,65,5231,43
2021-01-23,San Bernardino,071,2135413,271139,260381,7876,268257,1922
2021-01-23,San Diego,073,3302833,239286,225556,11095,236651,2344
2021-01-23,San Francisco,075,870044,30988,30308,765,31073,268
2021-01-23,San Joaquin,077,732212,61146,58164,2412,60576,836
2021-01-23,San Luis Obispo,079,281455,17552,16652,459,17111,176
2021-01-23,San Mateo,081,765935,35832,33696,306,34002,213
2021-01-23,Santa Barbara,083,443738,28189,26234,845,27079,264
2021-01-23,Santa Clara,085,1922200,100038,97189,455,97644,1086
2021-01-23,Santa Cruz,087,273765,13995,12771,665,13436,127
2021-01-23,Shasta,089,179085,10136,9951,1041,10992,103
2021-01-23,Sierra,091,2930,47,41,12,53,0
2021-01-23,Siskiyou,093,43540,1285,1190,190,1380,4
2021-01-23,Solano,095,438530,27193,26261,300,26561,107
2021-01-23,Sonoma,097,501317,25454,24790,131,24921,232
2021-01-23,Stanislaus,099,539301,45766,43723,4621,48344,599
2021-01-23,Sutter,101,95872,8089,7943,76,8019,80
2021-01-23,Tehama,103,63373,4177,4006,450,4456,20
2021-01-23,Trinity,105,12862,439,262,66,328,3
2021-01-23,Tulare,107,460477,44560,42661,6343,49004,575
2021-01-23,Tuolumne,109,53932,3416,3407,31,3438,29
2021-01-23,Ventura,111,848112,68338,65581,2410,67991,438
2021-01-23,Yolo,113,214977,11759,11087,147,11234,141
2021-01-23,Yuba,115,75493,5027,4831,68,4899,30
2021-01-22,Alameda,001,1643700,72501,69693,1530,71223,751
2021-01-22,Alpine,003,1148,73,71,0,71,0
2021-01-22,Amador,005,37829,3134,3042,24,3066,30
2021-01-22,Butte,007,227075,10367,9711,1413,11124,133
2021-01-22,Calaveras,009,45235,1702,1672,10,1682,21
2021-01-22,Colusa,011,21464,1725,1668,191,1859,7
2021-01-22,Contra Costa,013,1133247,56530,53887,935,54822,485
2021-01-22,Del Norte,015,27424,883,852,4,856,2
2021-01-22,El Dorado,017,186661,8416,7877,543,8420,64
2021-01-22,Fresno,019,978130,89079,84744,6741,91485,892
2021-01-22,Glenn,021,27897,2079,1985,423,2408,13
2021-01-22,Humboldt,023,135768,2657,2452,16,2468,23
2021-01-22,Imperial,025,180216,26218,25562,2326,27888,474
2021-01-22,Inyo,027,18085,1033,961,8,969,26
2021-01-22,Kern,029,883053,85831,82101,7964,90065,771
2021-01-22,Kings,031,150075,20547,19760,831,20591,159
2021-01-22,Lake,033,64148,2792,2681,0,2681,32
2021-01-22,Lassen,035,31185,4885,4765,81,4846,1
2021-01-22,Los Angeles,037,10098052,1087136,1031177,35191,1066368,14777
2021-01-22,Madera,039,155013,14391,13781,693,14474,86
2021-01-22,Marin,041,260295,12088,11769,128,11897,177
2021-01-22,Mariposa,043,17540,346,323,3,326,3
2021-01-22,Mendocino,045,87422,3179,2994,58,3052,32
2021-01-22,Merced,047,269075,25357,24616,700,25316,290
2021-01-22,Modoc,049,8938,306,285,93,378,0
2021-01-22,Mono,051,14174,1116,1108,15,1123,3
2021-01-22,Monterey,053,433212,38418,36909,1294,38203,253
2021-01-22,Napa,055,140530,8199,7828,32,7860,40
2021-01-22,Nevada,057,99092,3527,3296,138,3434,18
2021-01-22,Orange,059,3164182,227933,220384,9189,229573,2542
2021-01-22,Placer,061,380077,18887,17636,917,18553,193
2021-01-22,Plumas,063,18699,607,522,10,532,2
2021-01-22,Riverside,065,2383286,264570,252440,12444,264884,2710
2021-01-22,Sacramento,067,1510023,85397,82861,1013,83874,1094
2021-01-22,San Benito,069,59416,5269,5143,65,5208,43
2021-01-22,San Bernardino,071,2135413,270317,259121,7843,266964,1849
2021-01-22,San Diego,073,3302833,238046,222576,11030,233606,2301
2021-01-22,San Francisco,075,870044,30875,30027,748,30775,266
2021-01-22,San Joaquin,077,732212,60965,58485,2399,60884,812
2021-01-22,San Luis Obispo,079,281455,17463,16336,456,16792,172
2021-01-22,San Mateo,081,765935,35610,33401,303,33704,211
2021-01-22,Santa Barbara,083,443738,27988,25989,834,26823,256
2021-01-22,Santa Clara,085,1922200,99600,96435,452,96887,1062
2021-01-22,Santa Cruz,087,273765,13937,12687,661,13348,123
2021-01-22,Shasta,089,179085,10116,9866,1039,10905,103
2021-01-22,Sierra,091,2930,47,40,12,52,0
2021-01-22,Siskiyou,093,43540,1281,1182,188,1370,4
2021-01-22,Solano,095,438530,27103,26048,298,26346,107
2021-01-22,Sonoma,097,501317,25369,24659,131,24790,232
2021-01-22,Stanislaus,099,539301,45600,43489,4595,48084,599
2021-01-22,Sutter,101,95872,8064,7878,76,7954,80
2021-01-22,Tehama,103,63373,4160,3993,448,4441,19
2021-01-22,Trinity,105,12862,438,263,66,329,3
2021-01-22,Tulare,107,460477,44380,42307,6273,48580,573
2021-01-22,Tuolumne,109,53932,3388,3379,31,3410,29
2021-01-22,Ventura,111,848112,67832,64404,2392,66796,426
2021-01-22,Yolo,113,214977,11725,11014,140,11154,141
2021-01-22,Yuba,115,75493,5003,4789,66,4855,29
2021-01-21,Alameda,001,1643700,72066,69314,1513,70827,739
2021-01-21,Alpine,003,1148,73,71,0,71,0
2021-01-21,Amador,005,37829,3112,3038,24,3062,29
2021-01-21,Butte,007,227075,10302,9643,1407,11050,130
2021-01-21,Calaveras,009,45235,1693,1647,10,1657,21
2021-01-21,Colusa,011,21464,1718,1662,188,1850,7
2021-01-21,Contra Costa,013,1133247,56116,53595,921,54516,478
2021-01-21,Del Norte,015,27424,881,850,3,853,2
2021-01-21,El Dorado,017,186661,8367,7823,540,8363,58
2021-01-21,Fresno,019,978130,88674,84137,6701,90838,889
2021-01-21,Glenn,021,27897,2071,1964,418,2382,13
2021-01-21,Humboldt,023,135768,2634,2423,16,2439,23
2021-01-21,Imperial,025,180216,26127,25509,2312,27821,463
2021-01-21,Inyo,027,18085,1024,946,8,954,26
2021-01-21,Kern,029,883053,85418,81328,7848,89176,769
2021-01-21,Kings,031,150075,20476,19633,813,20446,158
2021-01-21,Lake,033,64148,2776,2669,0,2669,32
2021-01-21,Lassen,035,31185,4878,4763,81,4844,1
2021-01-21,Los Angeles,037,10098052,1080475,1023055,34869,1057924,14537
2021-01-21,Madera,039,155013,14323,13664,685,14349,86
2021-01-21,Marin,041,260295,12032,11732,126,11858,173
2021-01-21,Mariposa,043,17540,342,322,3,325,3
2021-01-21,Mendocino,045,87422,3156,2967,56,3023,32
2021-01-21,Merced,047,269075,25202,24426,693,25119,245
2021-01-21,Modoc,049,8938,303,284,92,376,0
2021-01-21,Mono,051,14174,1111,1104,15,1119,3
2021-01-21,Monterey,053,433212,38137,36149,1284,37433,253
2021-01-21,Napa,055,140530,8135,7774,32,7806,40
2021-01-21,Nevada,057,99092,3498,3274,137,3411,18
2021-01-21,Orange,059,3164182,226555,218867,9134,228001,2540
2021-01-21,Placer,061,380077,18808,17553,913,18466,190
2021-01-21,Plumas,063,18699,603,518,10,528,2
2021-01-21,Riverside,065,2383286,262847,251007,12364,263371,2676
2021-01-21,Sacramento,067,1510023,84918,82303,992,83295,1084
2021-01-21,San Benito,069,59416,5238,5100,60,5160,43
2021-01-21,San Bernardino,071,2135413,268973,257754,7778,265532,1832
2021-01-21,San Diego,073,3302833,236271,219729,10923,230652,2222
2021-01-21,San Francisco,075,870044,30698,29801,714,30515,266
2021-01-21,San Joaquin,077,732212,60656,58270,2379,60649,806
2021-01-21,San Luis Obispo,079,281455,17377,16153,448,16601,169
2021-01-21,San Mateo,081,765935,35364,33156,290,33446,210
2021-01-21,Santa Barbara,083,443738,27700,25654,821,26475,253
2021-01-21,Santa Clara,085,1922200,98974,96028,445,96473,1062
2021-01-21,Santa Cruz,087,273765,13852,12548,651,13199,119
2021-01-21,Shasta,089,179085,10073,9795,1024,10819,98
2021-01-21,Sierra,091,2930,47,40,12,52,0
2021-01-21,Siskiyou,093,43540,1278,1178,185,1363,4
2021-01-21,Solano,095,438530,26923,25885,294,26179,106
2021-01-21,Sonoma,097,501317,25231,24440,129,24569,230
2021-01-21,Stanislaus,099,539301,45302,43223,4551,47774,599
2021-01-21,Sutter,101,95872,8030,7822,76,7898,80
2021-01-21,Tehama,103,63373,4122,3938,448,4386,19
2021-01-21,Trinity,105,12862,438,261,66,327,3
2021-01-21,Tulare,107,460477,44169,42082,6197,48279,569
2021-01-21,Tuolumne,109,53932,3378,3365,30,3395,29
2021-01-21,Ventura,111,848112,67138,63995,2371,66366,420
2021-01-21,Yolo,113,214977,11635,10940,132,11072,141
2021-01-21,Yuba,115,75493,4971,4757,65,4822,29
2021-01-20,Alameda,001,1643700,71584,68785,1499,70284,702
2021-01-20,Alpine,003,1148,73,71,0,71,0
2021-01-20,Amador,005,37829,3081,3036,24,3060,29
2021-01-20,Butte,007,227075,10246,9582,1396,10978,130
2021-01-20,Calaveras,009,45235,1671,1637,9,1646,21
2021-01-20,Colusa,011,21464,1701,1630,183,1813,7
2021-01-20,Contra Costa,013,1133247,55660,53108,914,54022,461
2021-01-20,Del Norte,015,27424,880,848,3,851,2
2021-01-20,El Dorado,017,186661,8317,7785,537,8322,53
2021-01-20,Fresno,019,978130,88254,83591,6648,90239,872
2021-01-20,Glenn,021,27897,2052,1955,416,2371,13
2021-01-20,Humboldt,023,135768,2591,2390,16,2406,22
2021-01-20,Imperial,025,180216,26055,25380,2277,27657,461
2021-01-20,Inyo,027,18085,1014,901,8,909,26
2021-01-20,Kern,029,883053,84969,80701,7740,88441,754
2021-01-20,Kings,031,150075,20386,19522,805,20327,146
2021-01-20,Lake,033,64148,2755,2646,0,2646,31
2021-01-20,Lassen,035,31185,4870,4758,79,4837,1
2021-01-20,Los Angeles,037,10098052,1072979,1015608,34581,1050189,14299
2021-01-20,Madera,039,155013,14259,13585,680,14265,86
2021-01-20,Marin,041,260295,11978,11684,124,11808,171
2021-01-20,Mariposa,043,17540,340,322,3,325,3
2021-01-20,Mendocino,045,87422,3141,2957,56,3013,32
2021-01-20,Merced,047,269075,25029,24220,671,24891,243
2021-01-20,Modoc,049,8938,302,282,92,374,0
2021-01-20,Mono,051,14174,1104,1105,14,1119,3
2021-01-20,Monterey,053,433212,37825,35960,1264,37224,249
2021-01-20,Napa,055,140530,8066,7731,31,7762,40
2021-01-20,Nevada,057,99092,3466,3238,137,3375,18
2021-01-20,Orange,059,3164182,225019,216893,9073,225966,2500
2021-01-20,Placer,061,380077,18715,17455,895,18350,186
2021-01-20,Plumas,063,18699,601,512,10,522,2
2021-01-20,Riverside,065,2383286,260801,248686,12277,260963,2615
2021-01-20,Sacramento,067,1510023,84358,81687,982,82669,1072
2021-01-20,San Benito,069,59416,5207,5036,59,5095,35
2021-01-20,San Bernardino,071,2135413,267618,255921,7731,263652,1801
2021-01-20,San Diego,073,3302833,234416,218553,10819,229372,2174
2021-01-20,San Francisco,075,870044,30510,29665,694,30359,262
2021-01-20,San Joaquin,077,732212,60251,58025,2370,60395,783
2021-01-20,San Luis Obispo,079,281455,17196,15936,439,16375,164
2021-01-20,San Mateo,081,765935,35137,32929,289,33218,210
2021-01-20,Santa Barbara,083,443738,27383,25312,809,26121,248
2021-01-20,Santa Clara,085,1922200,98292,94995,443,95438,1040
2021-01-20,Santa Cruz,087,273765,13745,12460,638,13098,107
2021-01-20,Shasta,089,179085,10021,9697,1014,10711,98
2021-01-20,Sierra,091,2930,47,40,12,52,0
2021-01-20,Siskiyou,093,43540,1271,1163,184,1347,4
2021-01-20,Solano,095,438530,26730,25659,290,25949,106
2021-01-20,Sonoma,097,501317,25094,24262,127,24389,223
2021-01-20,Stanislaus,099,539301,45021,42955,4513,47468,585
2021-01-20,Sutter,101,95872,7979,7772,74,7846,80
2021-01-20,Tehama,103,63373,4096,3892,446,4338,19
2021-01-20,Trinity,105,12862,438,260,66,326,3
2021-01-20,Tulare,107,460477,43911,41799,6104,47903,559
2021-01-20,Tuolumne,109,53932,3364,3355,29,3384,29
2021-01-20,Ventura,111,848112,66178,63413,2342,65755,395
2021-01-20,Yolo,113,214977,11567,10852,129,10981,141
2021-01-20,Yuba,115,75493,4944,4729,65,4794,29
2021-01-19,Alameda,001,1643700,70935,68434,1489,69923,680
2021-01-19,Alpine,003,1148,73,71,0,71,0
2021-01-19,Amador,005,37829,3072,3024,24,3048,28
2021-01-19,Butte,007,227075,10182,9528,1381,10909,129
2021-01-19,Calaveras,009,45235,1656,1621,8,1629,21
2021-01-19,Colusa,011,21464,1679,1617,175,1792,7
2021-01-19,Contra Costa,013,1133247,55163,52730,903,53633,448
2021-01-19,Del Norte,015,27424,878,843,3,846,2
2021-01-19,El Dorado,017,186661,8257,7743,529,8272,47
2021-01-19,Fresno,019,978130,87731,83200,6596,89796,857
2021-01-19,Glenn,021,27897,2040,1948,411,2359,13
2021-01-19,Humboldt,023,135768,2567,2359,13,2372,22
2021-01-19,Imperial,025,180216,25974,25333,2261,27594,452
2021-01-19,Inyo,027,18085,1007,891,8,899,26
2021-01-19,Kern,029,883053,84380,80272,7632,87904,742
2021-01-19,Kings,031,150075,20247,19375,794,20169,143
2021-01-19,Lake,033,64148,2740,2625,0,2625,31
2021-01-19,Lassen,035,31185,4863,4753,79,4832,1
2021-01-19,Los Angeles,037,10098052,1064304,1010375,34310,1044685,14014
2021-01-19,Madera,039,155013,14143,13528,673,14201,86
2021-01-19,Marin,041,260295,11921,11654,120,11774,169
2021-01-19,Mariposa,043,17540,340,322,3,325,3
2021-01-19,Mendocino,045,87422,3124,2930,56,2986,32
2021-01-19,Merced,047,269075,24817,24108,662,24770,242
2021-01-19,Modoc,049,8938,301,281,92,373,0
2021-01-19,Mono,051,14174,1103,1106,14,1120,3
2021-01-19,Monterey,053,433212,37522,35840,1243,37083,248
2021-01-19,Napa,055,140530,8007,7672,31,7703,38
2021-01-19,Nevada,057,99092,3448,3216,135,3351,18
2021-01-19,Orange,059,3164182,223280,215244,9004,224248,2468
2021-01-19,Placer,061,380077,18617,17348,885,18233,182
2021-01-19,Plumas,063,18699,594,509,10,519,2
2021-01-19,Riverside,065,2383286,258715,246248,12198,258446,2585
2021-01-19,Sacramento,067,1510023,83821,81183,962,82145,1053
2021-01-19,San Benito,069,59416,5161,4988,58,5046,35
2021-01-19,San Bernardino,071,2135413,265882,253651,7673,261324,1777
2021-01-19,San Diego,073,3302833,231993,216833,10721,227554,2109
2021-01-19,San Francisco,075,870044,30291,29502,663,30165,261
2021-01-19,San Joaquin,077,732212,59867,57655,2357,60012,782
2021-01-19,San Luis Obispo,079,281455,16932,15855,436,16291,161
2021-01-19,San Mateo,081,765935,34852,32730,278,33008,208
2021-01-19,Santa Barbara,083,443738,26999,24991,793,25784,236
2021-01-19,Santa Clara,085,1922200,97517,94483,441,94924,1010
2021-01-19,Santa Cruz,087,273765,13628,12410,630,13040,106
2021-01-19,Shasta,089,179085,9985,9614,1004,10618,93
2021-01-19,Sierra,091,2930,47,40,10,50,0
2021-01-19,Siskiyou,093,43540,1263,1149,183,1332,4
2021-01-19,Solano,095,438530,26483,25520,289,25809,106
2021-01-19,Sonoma,097,501317,24914,24133,125,24258,223
2021-01-19,Stanislaus,099,539301,44673,42723,4468,47191,561
2021-01-19,Sutter,101,95872,7929,7709,68,7777,80
2021-01-19,Tehama,103,63373,4063,3876,444,4320,19
2021-01-19,Trinity,105,12862,437,260,66,326,3
2021-01-19,Tulare,107,460477,43633,41559,6008,47567,549
2021-01-19,Tuolumne,109,53932,3337,3328,29,3357,29
2021-01-19,Ventura,111,848112,65499,62656,2315,64971,383
2021-01-19,Yolo,113,214977,11480,10789,128,10917,134
2021-01-19,Yuba,115,75493,4911,4695,64,4759,29
2021-01-18,Alameda,001,1643700,70298,67938,1471,69409,680
2021-01-18,Alpine,003,1148,73,71,0,71,0
2021-01-18,Amador,005,37829,3058,3016,24,3040,28
2021-01-18,Butte,007,227075,10097,9474,1369,10843,129
2021-01-18,Calaveras,009,45235,1635,1617,7,1624,21
2021-01-18,Colusa,011,21464,1662,1608,170,1778,7
2021-01-18,Contra Costa,013,1133247,54647,52323,895,53218,448
2021-01-18,Del Norte,015,27424,877,840,3,843,2
2021-01-18,El Dorado,017,186661,8188,7707,527,8234,47
2021-01-18,Fresno,019,978130,87119,82485,6529,89014,857
2021-01-18,Glenn,021,27897,2023,1935,407,2342,13
2021-01-18,Humboldt,023,135768,2529,2343,13,2356,22
2021-01-18,Imperial,025,180216,25905,25317,2236,27553,452
2021-01-18,Inyo,027,18085,995,872,8,880,26
2021-01-18,Kern,029,883053,83742,79930,7541,87471,740
2021-01-18,Kings,031,150075,20077,19267,782,20049,141
2021-01-18,Lake,033,64148,2723,2591,0,2591,30
2021-01-18,Lassen,035,31185,4827,4749,78,4827,1
2021-01-18,Los Angeles,037,10098052,1054808,1002614,34017,1036631,13828
2021-01-18,Madera,039,155013,14030,13443,665,14108,85
2021-01-18,Marin,041,260295,11874,11607,118,11725,165
2021-01-18,Mariposa,043,17540,337,320,2,322,3
2021-01-18,Mendocino,045,87422,3101,2919,56,2975,31
2021-01-18,Merced,047,269075,24572,23927,646,24573,242
2021-01-18,Modoc,049,8938,298,281,89,370,0
2021-01-18,Mono,051,14174,1100,1101,14,1115,3
2021-01-18,Monterey,053,433212,37079,35549,1229,36778,247
2021-01-18,Napa,055,140530,7933,7601,31,7632,38
2021-01-18,Nevada,057,99092,3410,3199,134,3333,17
2021-01-18,Orange,059,3164182,221377,213866,8948,222814,2405
2021-01-18,Placer,061,380077,18501,17263,876,18139,182
2021-01-18,Plumas,063,18699,590,506,10,516,2
2021-01-18,Riverside,065,2383286,256400,244151,12104,256255,2568
2021-01-18,Sacramento,067,1510023,83151,80546,946,81492,1046
2021-01-18,San Benito,069,59416,5111,4963,56,5019,35
2021-01-18,San Bernardino,071,2135413,264118,252808,7614,260422,1775
2021-01-18,San Diego,073,3302833,229345,214335,10592,224927,2103
2021-01-18,San Francisco,075,870044,30085,29321,639,29960,259
2021-01-18,San Joaquin,077,732212,59349,57405,2335,59740,782
2021-01-18,San Luis Obispo,079,281455,16745,15742,426,16168,158
2021-01-18,San Mateo,081,765935,34538,32515,259,32774,208
2021-01-18,Santa Barbara,083,443738,26620,24638,779,25417,235
2021-01-18,Santa Clara,085,1922200,96625,93688,437,94125,992
2021-01-18,Santa Cruz,087,273765,13495,12298,617,12915,106
2021-01-18,Shasta,089,179085,9946,9600,994,10594,92
2021-01-18,Sierra,091,2930,46,40,10,50,0
2021-01-18,Siskiyou,093,43540,1251,1144,182,1326,4
2021-01-18,Solano,095,438530,26206,25344,284,25628,105
2021-01-18,Sonoma,097,501317,24646,24068,124,24192,223
2021-01-18,Stanislaus,099,539301,44317,42413,4412,46825,562
2021-01-18,Sutter,101,95872,7872,7680,66,7746,78
2021-01-18,Tehama,103,63373,4019,3854,437,4291,19
2021-01-18,Trinity,105,12862,437,260,66,326,3
2021-01-18,Tulare,107,460477,43344,41196,5896,47092,549
2021-01-18,Tuolumne,109,53932,3314,3318,28,3346,28
2021-01-18,Ventura,111,848112,65069,61859,2292,64151,379
2021-01-18,Yolo,113,214977,11351,10620,125,10745,134
2021-01-18,Yuba,115,75493,4883,4671,62,4733,29
2021-01-17,Alameda,001,1643700,69735,67375,1453,68828,676
2021-01-17,Alpine,003,1148,73,71,0,71,0
2021-01-17,Amador,005,37829,3051,3001,24,3025,28
2021-01-17,Butte,007,227075,10022,9411,1345,10756,129
2021-01-17,Calaveras,009,45235,1622,1608,7,1615,21
2021-01-17,Colusa,011,21464,1648,1588,165,1753,7
2021-01-17,Contra Costa,013,1133247,54157,51932,885,52817,447
2021-01-17,Del Norte,015,27424,877,838,3,841,2
2021-01-17,El Dorado,017,186661,8132,7659,515,8174,47
2021-01-17,Fresno,019,978130,86566,82039,6453,88492,857
2021-01-17,Glenn,021,27897,2013,1924,401,2325,9
2021-01-17,Humboldt,023,135768,2492,2322,11,2333,22
2021-01-17,Imperial,025,180216,25835,25253,2192,27445,451
2021-01-17,Inyo,027,18085,989,864,8,872,26
2021-01-17,Kern,029,883053,83194,79489,7454,86943,738
2021-01-17,Kings,031,150075,19941,19201,768,19969,131
2021-01-17,Lake,033,64148,2707,2572,0,2572,30
2021-01-17,Lassen,035,31185,4819,4740,77,4817,1
2021-01-17,Los Angeles,037,10098052,1048160,993028,33615,1026643,13741
2021-01-17,Madera,039,155013,13938,13328,660,13988,85
2021-01-17,Marin,041,260295,11821,11552,116,11668,164
2021-01-17,Mariposa,043,17540,337,319,2,321,3
2021-01-17,Mendocino,045,87422,3073,2912,55,2967,31
2021-01-17,Merced,047,269075,24360,23800,628,24428,242
2021-01-17,Modoc,049,8938,297,279,89,368,0
2021-01-17,Mono,051,14174,1093,1091,13,1104,3
2021-01-17,Monterey,053,433212,36836,35340,1203,36543,244
2021-01-17,Napa,055,140530,7877,7521,31,7552,38
2021-01-17,Nevada,057,99092,3385,3176,132,3308,17
2021-01-17,Orange,059,3164182,219372,212389,8873,221262,2359
2021-01-17,Placer,061,380077,18396,17194,861,18055,181
2021-01-17,Plumas,063,18699,589,505,9,514,2
2021-01-17,Riverside,065,2383286,254290,242206,11986,254192,2534
2021-01-17,Sacramento,067,1510023,82550,80154,934,81088,1045
2021-01-17,San Benito,069,59416,5073,4941,56,4997,35
2021-01-17,San Bernardino,071,2135413,261994,251487,7526,259013,1775
2021-01-17,San Diego,073,3302833,227151,211785,10485,222270,2103
2021-01-17,San Francisco,075,870044,29899,29139,601,29740,255
2021-01-17,San Joaquin,077,732212,58991,57094,2320,59414,780
2021-01-17,San Luis Obispo,079,281455,16623,15658,417,16075,157
2021-01-17,San Mateo,081,765935,34285,32186,236,32422,208
2021-01-17,Santa Barbara,083,443738,26160,24401,766,25167,235
2021-01-17,Santa Clara,085,1922200,95877,92752,434,93186,976
2021-01-17,Santa Cruz,087,273765,13383,12196,614,12810,106
2021-01-17,Shasta,089,179085,9888,9588,986,10574,92
2021-01-17,Sierra,091,2930,46,38,9,47,0
2021-01-17,Siskiyou,093,43540,1244,1136,179,1315,4
2021-01-17,Solano,095,438530,25977,25216,282,25498,105
2021-01-17,Sonoma,097,501317,24472,23871,124,23995,223
2021-01-17,Stanislaus,099,539301,43996,42221,4348,46569,562
2021-01-17,Sutter,101,95872,7809,7604,65,7669,77
2021-01-17,Tehama,103,63373,3988,3837,433,4270,18
2021-01-17,Trinity,105,12862,437,261,66,327,3
2021-01-17,Tulare,107,460477,43052,41016,5780,46796,549
2021-01-17,Tuolumne,109,53932,3297,3287,28,3315,27
2021-01-17,Ventura,111,848112,64221,61257,2244,63501,376
2021-01-17,Yolo,113,214977,11252,10519,123,10642,134
2021-01-17,Yuba,115,75493,4833,4640,59,4699,28
2021-01-16,Alameda,001,1643700,69412,66583,1440,68023,673
2021-01-16,Alpine,003,1148,73,71,0,71,0
2021-01-16,Amador,005,37829,3048,2986,24,3010,28
2021-01-16,Butte,007,227075,9989,9359,1325,10684,129
2021-01-16,Calaveras,009,45235,1609,1596,7,1603,21
2021-01-16,Colusa,011,21464,1636,1578,165,1743,7
2021-01-16,Contra Costa,013,1133247,53893,51363,878,52241,443
2021-01-16,Del Norte,015,27424,872,833,3,836,2
2021-01-16,El Dorado,017,186661,8110,7575,514,8089,47
2021-01-16,Fresno,019,978130,86292,81294,6398,87692,846
2021-01-16,Glenn,021,27897,2009,1894,398,2292,9
2021-01-16,Humboldt,023,135768,2472,2294,9,2303,22
2021-01-16,Imperial,025,180216,25800,25140,2185,27325,451
2021-01-16,Inyo,027,18085,985,845,8,853,25
2021-01-16,Kern,029,883053,82827,78865,7400,86265,733
2021-01-16,Kings,031,150075,19885,19072,765,19837,131
2021-01-16,Lake,033,64148,2696,2504,0,2504,30
2021-01-16,Lassen,035,31185,4807,4719,77,4796,1
2021-01-16,Los Angeles,037,10098052,1044080,982684,33374,1016058,13654
2021-01-16,Madera,039,155013,13871,13193,656,13849,85
2021-01-16,Marin,041,260295,11778,11482,116,11598,164
2021-01-16,Mariposa,043,17540,336,317,2,319,3
2021-01-16,Mendocino,045,87422,3059,2890,52,2942,31
2021-01-16,Merced,047,269075,24272,23478,614,24092,242
2021-01-16,Modoc,049,8938,297,278,89,367,0
2021-01-16,Mono,051,14174,1091,1079,13,1092,3
2021-01-16,Monterey,053,433212,36725,34972,1185,36157,243
2021-01-16,Napa,055,140530,7838,7356,31,7387,39
2021-01-16,Nevada,057,99092,3352,3144,132,3276,17
2021-01-16,Orange,059,3164182,218336,210111,8816,218927,2312
2021-01-16,Placer,061,380077,18332,16995,859,17854,177
2021-01-16,Plumas,063,18699,587,502,9,511,2
2021-01-16,Riverside,065,2383286,252934,239412,11870,251282,2506
2021-01-16,Sacramento,067,1510023,82174,79122,917,80039,1033
2021-01-16,San Benito,069,59416,5041,4875,56,4931,35
2021-01-16,San Bernardino,071,2135413,261207,249401,7459,256860,1755
2021-01-16,San Diego,073,3302833,225853,209895,10388,220283,2065
2021-01-16,San Francisco,075,870044,29771,28853,570,29423,244
2021-01-16,San Joaquin,077,732212,58744,56642,2289,58931,776
2021-01-16,San Luis Obispo,079,281455,16522,15466,415,15881,152
2021-01-16,San Mateo,081,765935,34121,31805,230,32035,208
2021-01-16,Santa Barbara,083,443738,25960,24088,762,24850,229
2021-01-16,Santa Clara,085,1922200,95409,91584,427,92011,954
2021-01-16,Santa Cruz,087,273765,13324,12026,612,12638,106
2021-01-16,Shasta,089,179085,9855,9547,982,10529,92
2021-01-16,Sierra,091,2930,45,38,9,47,0
2021-01-16,Siskiyou,093,43540,1239,1124,179,1303,4
2021-01-16,Solano,095,438530,25868,24732,277,25009,103
2021-01-16,Sonoma,097,501317,24381,23607,123,23730,223
2021-01-16,Stanislaus,099,539301,43809,41809,4297,46106,562
2021-01-16,Sutter,101,95872,7777,7560,65,7625,76
2021-01-16,Tehama,103,63373,3974,3783,433,4216,18
2021-01-16,Trinity,105,12862,437,261,66,327,3
2021-01-16,Tulare,107,460477,42872,40655,5707,46362,542
2021-01-16,Tuolumne,109,53932,3289,3269,28,3297,27
2021-01-16,Ventura,111,848112,63669,60368,2214,62582,369
2021-01-16,Yolo,113,214977,11203,10406,122,10528,134
2021-01-16,Yuba,115,75493,4802,4602,59,4661,27
2021-01-15,Alameda,001,1643700,68986,65416,1429,66845,672
2021-01-15,Alpine,003,1148,73,71,0,71,0
2021-01-15,Amador,005,37829,3041,2953,24,2977,28
2021-01-15,Butte,007,227075,9948,9233,1310,10543,129
2021-01-15,Calaveras,009,45235,1602,1538,7,1545,21
2021-01-15,Colusa,011,21464,1625,1541,160,1701,7
2021-01-15,Contra Costa,013,1133247,53563,50408,871,51279,428
2021-01-15,Del Norte,015,27424,868,828,2,830,2
2021-01-15,El Dorado,017,186661,8061,7439,505,7944,47
2021-01-15,Fresno,019,978130,85755,79950,6362,86312,832
2021-01-15,Glenn,021,27897,2005,1824,395,2219,9
2021-01-15,Humboldt,023,135768,2445,2218,8,2226,22
2021-01-15,Imperial,025,180216,25766,24944,2179,27123,446
2021-01-15,Inyo,027,18085,967,814,8,822,25
2021-01-15,Kern,029,883053,82412,77873,7335,85208,719
2021-01-15,Kings,031,150075,19776,18661,759,19420,131
2021-01-15,Lake,033,64148,2670,2434,0,2434,28
2021-01-15,Lassen,035,31185,4796,4693,75,4768,1
2021-01-15,Los Angeles,037,10098052,1037036,968979,33083,1002062,13404
2021-01-15,Madera,039,155013,13786,12883,653,13536,85
2021-01-15,Marin,041,260295,11727,11310,116,11426,160
2021-01-15,Mariposa,043,17540,334,307,2,309,3
2021-01-15,Mendocino,045,87422,3048,2835,52,2887,31
2021-01-15,Merced,047,269075,24159,23060,610,23670,239
2021-01-15,Modoc,049,8938,297,278,87,365,0
2021-01-15,Mono,051,14174,1088,1057,13,1070,3
2021-01-15,Monterey,053,433212,36509,34460,1125,35585,243
2021-01-15,Napa,055,140530,7776,7231,31,7262,38
2021-01-15,Nevada,057,99092,3339,3099,129,3228,17
2021-01-15,Orange,059,3164182,216979,207129,8764,215893,2254
2021-01-15,Placer,061,380077,18228,16712,850,17562,173
2021-01-15,Plumas,063,18699,584,499,9,508,2
2021-01-15,Riverside,065,2383286,251069,235235,11791,247026,2458
2021-01-15,Sacramento,067,1510023,81753,80279,909,81188,1023
2021-01-15,San Benito,069,59416,5002,4766,54,4820,35
2021-01-15,San Bernardino,071,2135413,260039,246182,7401,253583,1726
2021-01-15,San Diego,073,3302833,224104,206868,10323,217191,2037
2021-01-15,San Francisco,075,870044,29597,28574,550,29124,242
2021-01-15,San Joaquin,077,732212,58510,55885,2275,58160,748
2021-01-15,San Luis Obispo,079,281455,16389,15129,410,15539,148
2021-01-15,San Mateo,081,765935,33876,31291,226,31517,208
2021-01-15,Santa Barbara,083,443738,25676,23487,758,24245,226
2021-01-15,Santa Clara,085,1922200,94757,90103,422,90525,942
2021-01-15,Santa Cruz,087,273765,13215,11776,598,12374,105
2021-01-15,Shasta,089,179085,9816,9459,975,10434,91
2021-01-15,Sierra,091,2930,44,36,7,43,0
2021-01-15,Siskiyou,093,43540,1235,1119,178,1297,4
2021-01-15,Solano,095,438530,25718,24222,274,24496,103
2021-01-15,Sonoma,097,501317,24250,23204,122,23326,222
2021-01-15,Stanislaus,099,539301,43559,41178,4255,45433,562
2021-01-15,Sutter,101,95872,7730,7484,64,7548,75
2021-01-15,Tehama,103,63373,3952,3714,432,4146,17
2021-01-15,Trinity,105,12862,437,262,66,328,3
2021-01-15,Tulare,107,460477,42627,39951,5623,45574,535
2021-01-15,Tuolumne,109,53932,3273,3231,28,3259,27
2021-01-15,Ventura,111,848112,62925,59061,2181,61242,353
2021-01-15,Yolo,113,214977,11147,10240,121,10361,134
2021-01-15,Yuba,115,75493,4781,4549,59,4608,27
2021-01-14,Alameda,001,1643700,68354,64364,1414,65778,686
2021-01-14,Alpine,003,1148,73,71,0,71,0
2021-01-14,Amador,005,37829,3035,2940,24,2964,28
2021-01-14,Butte,007,227075,9862,9127,1288,10415,129
2021-01-14,Calaveras,009,45235,1585,1513,7,1520,21
2021-01-14,Colusa,011,21464,1610,1535,157,1692,7
2021-01-14,Contra Costa,013,1133247,53008,49545,857,50402,415
2021-01-14,Del Norte,015,27424,862,821,2,823,2
2021-01-14,El Dorado,017,186661,7987,7321,497,7818,45
2021-01-14,Fresno,019,978130,85122,79033,6282,85315,814
2021-01-14,Glenn,021,27897,1993,1798,390,2188,9
2021-01-14,Humboldt,023,135768,2402,2169,8,2177,22
2021-01-14,Imperial,025,180216,25657,24882,2144,27026,447
2021-01-14,Inyo,027,18085,960,790,8,798,25
2021-01-14,Kern,029,883053,81740,77070,7234,84304,705
2021-01-14,Kings,031,150075,19646,18405,755,19160,108
2021-01-14,Lake,033,64148,2627,2378,0,2378,27
2021-01-14,Lassen,035,31185,4786,4673,73,4746,1
2021-01-14,Los Angeles,037,10098052,1027021,954652,32702,987354,13147
2021-01-14,Madera,039,155013,13672,12742,642,13384,85
2021-01-14,Marin,041,260295,11653,11155,115,11270,159
2021-01-14,Mariposa,043,17540,331,302,2,304,3
2021-01-14,Mendocino,045,87422,3034,2801,50,2851,31
2021-01-14,Merced,047,269075,23932,22780,600,23380,239
2021-01-14,Modoc,049,8938,297,273,87,360,0
2021-01-14,Mono,051,14174,1080,1020,13,1033,3
2021-01-14,Monterey,053,433212,36088,34105,1103,35208,242
2021-01-14,Napa,055,140530,7691,7117,31,7148,38
2021-01-14,Nevada,057,99092,3312,3075,127,3202,17
2021-01-14,Orange,059,3164182,215047,204442,8678,213120,2162
2021-01-14,Placer,061,380077,18066,16488,843,17331,169
2021-01-14,Plumas,063,18699,576,496,9,505,2
2021-01-14,Riverside,065,2383286,248420,231684,11691,243375,2357
2021-01-14,Sacramento,067,1510023,81114,79137,885,80022,1007
2021-01-14,San Benito,069,59416,4966,4678,53,4731,35
2021-01-14,San Bernardino,071,2135413,258073,243379,7331,250710,1750
2021-01-14,San Diego,073,3302833,221710,204173,10203,214376,2005
2021-01-14,San Francisco,075,870044,29352,28200,502,28702,238
2021-01-14,San Joaquin,077,732212,57994,55058,2261,57319,739
2021-01-14,San Luis Obispo,079,281455,16227,14851,401,15252,146
2021-01-14,San Mateo,081,765935,33507,30694,217,30911,208
2021-01-14,Santa Barbara,083,443738,25256,23126,740,23866,219
2021-01-14,Santa Clara,085,1922200,93823,88505,415,88920,910
2021-01-14,Santa Cruz,087,273765,13068,11583,582,12165,109
2021-01-14,Shasta,089,179085,9767,9334,959,10293,90
2021-01-14,Sierra,091,2930,44,35,6,41,0
2021-01-14,Siskiyou,093,43540,1223,1108,175,1283,3
2021-01-14,Solano,095,438530,25459,23782,270,24052,103
2021-01-14,Sonoma,097,501317,24010,22910,122,23032,202
2021-01-14,Stanislaus,099,539301,43233,40597,4214,44811,574
2021-01-14,Sutter,101,95872,7671,7416,61,7477,74
2021-01-14,Tehama,103,63373,3924,3664,428,4092,17
2021-01-14,Trinity,105,12862,437,261,65,326,3
2021-01-14,Tulare,107,460477,42243,39565,5514,45079,533
2021-01-14,Tuolumne,109,53932,3252,3215,28,3243,28
2021-01-14,Ventura,111,848112,62053,57941,2144,60085,347
2021-01-14,Yolo,113,214977,11038,10097,115,10212,135
2021-01-14,Yuba,115,75493,4749,4496,59,4555,27
2021-01-13,Alameda,001,1643700,67579,63568,1397,64965,690
2021-01-13,Alpine,003,1148,73,71,0,71,0
2021-01-13,Amador,005,37829,3021,2914,24,2938,26
2021-01-13,Butte,007,227075,9780,9013,1273,10286,126
2021-01-13,Calaveras,009,45235,1563,1493,7,1500,21
2021-01-13,Colusa,011,21464,1598,1524,152,1676,7
2021-01-13,Contra Costa,013,1133247,52428,48877,845,49722,403
2021-01-13,Del Norte,015,27424,858,820,2,822,2
2021-01-13,El Dorado,017,186661,7894,7247,489,7736,43
2021-01-13,Fresno,019,978130,84402,78278,6240,84518,804
2021-01-13,Glenn,021,27897,1977,1792,381,2173,9
2021-01-13,Humboldt,023,135768,2369,2114,8,2122,22
2021-01-13,Imperial,025,180216,25533,24717,2111,26828,463
2021-01-13,Inyo,027,18085,948,785,8,793,25
2021-01-13,Kern,029,883053,81079,76049,7144,83193,704
2021-01-13,Kings,031,150075,19479,18121,733,18854,108
2021-01-13,Lake,033,64148,2583,2305,0,2305,27
2021-01-13,Lassen,035,31185,4779,4663,72,4735,1
2021-01-13,Los Angeles,037,10098052,1016234,937985,32291,970276,12873
2021-01-13,Madera,039,155013,13546,12570,637,13207,85
2021-01-13,Marin,041,260295,11597,11039,115,11154,161
2021-01-13,Mariposa,043,17540,329,304,2,306,3
2021-01-13,Mendocino,045,87422,3014,2790,50,2840,31
2021-01-13,Merced,047,269075,23693,22497,586,23083,241
2021-01-13,Modoc,049,8938,296,274,84,358,0
2021-01-13,Mono,051,14174,1076,1017,13,1030,3
2021-01-13,Monterey,053,433212,35664,33748,1079,34827,241
2021-01-13,Napa,055,140530,7577,7028,31,7059,36
2021-01-13,Nevada,057,99092,3288,3037,124,3161,17
2021-01-13,Orange,059,3164182,212959,201158,8609,209767,2172
2021-01-13,Placer,061,380077,17939,16272,829,17101,172
2021-01-13,Plumas,063,18699,574,490,9,499,2
2021-01-13,Riverside,065,2383286,245273,228192,11573,239765,2278
2021-01-13,Sacramento,067,1510023,80454,78268,878,79146,996
2021-01-13,San Benito,069,59416,4909,4583,52,4635,35
2021-01-13,San Bernardino,071,2135413,255701,240191,7259,247450,1759
2021-01-13,San Diego,073,3302833,219096,201578,10100,211678,1952
2021-01-13,San Francisco,075,870044,29113,27863,480,28343,238
2021-01-13,San Joaquin,077,732212,57371,54373,2231,56604,738
2021-01-13,San Luis Obispo,079,281455,16072,14625,390,15015,140
2021-01-13,San Mateo,081,765935,33167,30195,215,30410,207
2021-01-13,Santa Barbara,083,443738,24814,22714,724,23438,216
2021-01-13,Santa Clara,085,1922200,92845,87187,412,87599,911
2021-01-13,Santa Cruz,087,273765,12895,11423,568,11991,110
2021-01-13,Shasta,089,179085,9703,9180,945,10125,93
2021-01-13,Sierra,091,2930,44,33,6,39,0
2021-01-13,Siskiyou,093,43540,1217,1102,171,1273,3
2021-01-13,Solano,095,438530,25174,23503,268,23771,105
2021-01-13,Sonoma,097,501317,23760,22610,121,22731,206
2021-01-13,Stanislaus,099,539301,42841,40167,4161,44328,574
2021-01-13,Sutter,101,95872,7625,7350,60,7410,73
2021-01-13,Tehama,103,63373,3874,3589,423,4012,17
2021-01-13,Trinity,105,12862,437,260,65,325,3
2021-01-13,Tulare,107,460477,41835,39129,5410,44539,522
2021-01-13,Tuolumne,109,53932,3238,3196,28,3224,28
2021-01-13,Ventura,111,848112,61041,56453,2104,58557,338
2021-01-13,Yolo,113,214977,10937,9933,111,10044,135
2021-01-13,Yuba,115,75493,4707,4448,56,4504,27
2021-01-12,Alameda,001,1643700,66743,62642,1377,64019,677
2021-01-12,Alpine,003,1148,73,71,0,71,0
2021-01-12,Amador,005,37829,3004,2897,24,2921,26
2021-01-12,Butte,007,227075,9692,8883,1256,10139,124
2021-01-12,Calaveras,009,45235,1526,1475,7,1482,21
2021-01-12,Colusa,011,21464,1586,1510,148,1658,7
2021-01-12,Contra Costa,013,1133247,51786,48242,831,49073,399
2021-01-12,Del Norte,015,27424,853,816,2,818,2
2021-01-12,El Dorado,017,186661,7811,7156,478,7634,41
2021-01-12,Fresno,019,978130,83530,77651,6171,83822,796
2021-01-12,Glenn,021,27897,1952,1781,377,2158,9
2021-01-12,Humboldt,023,135768,2315,2077,7,2084,22
2021-01-12,Imperial,025,180216,25443,24566,2070,26636,457
2021-01-12,Inyo,027,18085,931,773,8,781,25
2021-01-12,Kern,029,883053,80372,75320,7048,82368,689
2021-01-12,Kings,031,150075,19267,18072,723,18795,108
2021-01-12,Lake,033,64148,2536,2260,0,2260,27
2021-01-12,Lassen,035,31185,4757,4659,70,4729,1
2021-01-12,Los Angeles,037,10098052,1004583,926295,31878,958173,12610
2021-01-12,Madera,039,155013,13406,12485,628,13113,85
2021-01-12,Marin,041,260295,11488,10960,115,11075,157
2021-01-12,Mariposa,043,17540,326,302,2,304,3
2021-01-12,Mendocino,045,87422,2994,2762,46,2808,31
2021-01-12,Merced,047,269075,23442,22172,564,22736,239
2021-01-12,Modoc,049,8938,294,274,84,358,0
2021-01-12,Mono,051,14174,1066,1008,13,1021,3
2021-01-12,Monterey,053,433212,35173,33381,1062,34443,240
2021-01-12,Napa,055,140530,7494,6936,31,6967,36
2021-01-12,Nevada,057,99092,3260,3014,122,3136,17
2021-01-12,Orange,059,3164182,210668,198260,8522,206782,2142
2021-01-12,Placer,061,380077,17769,16087,823,16910,163
2021-01-12,Plumas,063,18699,568,483,9,492,2
2021-01-12,Riverside,065,2383286,242140,225580,11434,237014,2266
2021-01-12,Sacramento,067,1510023,79726,77201,870,78071,985
2021-01-12,San Benito,069,59416,4841,4515,52,4567,35
2021-01-12,San Bernardino,071,2135413,253137,237008,7190,244198,1739
2021-01-12,San Diego,073,3302833,216181,198317,9984,208301,1898
2021-01-12,San Francisco,075,870044,28838,27531,447,27978,238
2021-01-12,San Joaquin,077,732212,56730,53630,2204,55834,725
2021-01-12,San Luis Obispo,079,281455,15826,14367,381,14748,132
2021-01-12,San Mateo,081,765935,32776,29747,203,29950,206
2021-01-12,Santa Barbara,083,443738,24391,22182,704,22886,209
2021-01-12,Santa Clara,085,1922200,91770,86075,404,86479,904
2021-01-12,Santa Cruz,087,273765,12680,11267,552,11819,110
2021-01-12,Shasta,089,179085,9630,9086,932,10018,84
2021-01-12,Sierra,091,2930,43,33,6,39,0
2021-01-12,Siskiyou,093,43540,1207,1091,164,1255,3
2021-01-12,Solano,095,438530,24871,23160,263,23423,102
2021-01-12,Sonoma,097,501317,23455,22403,121,22524,205
2021-01-12,Stanislaus,099,539301,42401,39615,4125,43740,571
2021-01-12,Sutter,101,95872,7562,7276,59,7335,73
2021-01-12,Tehama,103,63373,3836,3567,418,3985,17
2021-01-12,Trinity,105,12862,437,258,65,323,3
2021-01-12,Tulare,107,460477,41377,38797,5294,44091,509
2021-01-12,Tuolumne,109,53932,3205,3178,28,3206,28
2021-01-12,Ventura,111,848112,60069,55342,2071,57413,324
2021-01-12,Yolo,113,214977,10801,9857,101,9958,133
2021-01-12,Yuba,115,75493,4665,4389,56,4445,27
2021-01-11,Alameda,001,1643700,65876,61949,1360,63309,652
2021-01-11,Alpine,003,1148,73,70,0,70,0
2021-01-11,Amador,005,37829,2990,2867,24,2891,24
2021-01-11,Butte,007,227075,9579,8757,1238,9995,119
2021-01-11,Calaveras,009,45235,1507,1460,7,1467,21
2021-01-11,Colusa,011,21464,1568,1494,144,1638,7
2021-01-11,Contra Costa,013,1133247,51106,47728,822,48550,398
2021-01-11,Del Norte,015,27424,849,810,2,812,2
2021-01-11,El Dorado,017,186661,7717,6987,470,7457,36
2021-01-11,Fresno,019,978130,82650,76581,6094,82675,775
2021-01-11,Glenn,021,27897,1925,1763,371,2134,9
2021-01-11,Humboldt,023,135768,2276,2069,7,2076,22
2021-01-11,Imperial,025,180216,25328,24418,2034,26452,453
2021-01-11,Inyo,027,18085,913,763,8,771,25
2021-01-11,Kern,029,883053,79512,74489,6949,81438,682
2021-01-11,Kings,031,150075,19004,17909,715,18624,108
2021-01-11,Lake,033,64148,2484,2205,0,2205,26
2021-01-11,Lassen,035,31185,4734,4647,69,4716,1
2021-01-11,Los Angeles,037,10098052,991367,914434,31406,945840,12304
2021-01-11,Madera,039,155013,13272,12366,617,12983,85
2021-01-11,Marin,041,260295,11391,10814,112,10926,156
2021-01-11,Mariposa,043,17540,319,296,2,298,3
2021-01-11,Mendocino,045,87422,2966,2728,46,2774,31
2021-01-11,Merced,047,269075,23119,21884,549,22433,238
2021-01-11,Modoc,049,8938,293,271,83,354,0
2021-01-11,Mono,051,14174,1060,1006,13,1019,3
2021-01-11,Monterey,053,433212,34634,32858,999,33857,239
2021-01-11,Napa,055,140530,7392,6822,31,6853,36
2021-01-11,Nevada,057,99092,3232,2980,122,3102,17
2021-01-11,Orange,059,3164182,208086,196340,8421,204761,2113
2021-01-11,Placer,061,380077,17589,15919,813,16732,163
2021-01-11,Plumas,063,18699,564,477,9,486,2
2021-01-11,Riverside,065,2383286,238626,222907,11287,234194,2222
2021-01-11,Sacramento,067,1510023,78795,76009,854,76863,974
2021-01-11,San Benito,069,59416,4767,4482,45,4527,34
2021-01-11,San Bernardino,071,2135413,250336,235543,7091,242634,1739
2021-01-11,San Diego,073,3302833,212912,194793,9824,204617,1857
2021-01-11,San Francisco,075,870044,28562,27264,426,27690,238
2021-01-11,San Joaquin,077,732212,56118,53002,2174,55176,725
2021-01-11,San Luis Obispo,079,281455,15455,14213,373,14586,126
2021-01-11,San Mateo,081,765935,32331,29355,191,29546,206
2021-01-11,Santa Barbara,083,443738,23941,21740,692,22432,200
2021-01-11,Santa Clara,085,1922200,90565,84851,395,85246,877
2021-01-11,Santa Cruz,087,273765,12500,11093,528,11621,106
2021-01-11,Shasta,089,179085,9532,8977,919,9896,81
2021-01-11,Sierra,091,2930,41,33,6,39,0
2021-01-11,Siskiyou,093,43540,1198,1087,162,1249,3
2021-01-11,Solano,095,438530,24551,22893,258,23151,101
2021-01-11,Sonoma,097,501317,23209,22191,121,22312,205
2021-01-11,Stanislaus,099,539301,41910,39149,4075,43224,571
2021-01-11,Sutter,101,95872,7503,7204,58,7262,71
2021-01-11,Tehama,103,63373,3773,3524,396,3920,17
2021-01-11,Trinity,105,12862,437,256,65,321,2
2021-01-11,Tulare,107,460477,40962,38380,5215,43595,497
2021-01-11,Tuolumne,109,53932,3194,3165,28,3193,27
2021-01-11,Ventura,111,848112,58933,54202,2048,56250,320
2021-01-11,Yolo,113,214977,10593,9699,99,9798,129
2021-01-11,Yuba,115,75493,4627,4349,49,4398,27
2021-01-10,Alameda,001,1643700,64874,61111,1332,62443,650
2021-01-10,Alpine,003,1148,73,70,0,70,0
2021-01-10,Amador,005,37829,2966,2861,24,2885,24
2021-01-10,Butte,007,227075,9458,8665,1212,9877,119
2021-01-10,Calaveras,009,45235,1483,1449,7,1456,21
2021-01-10,Colusa,011,21464,1544,1478,143,1621,7
2021-01-10,Contra Costa,013,1133247,50322,47109,804,47913,398
2021-01-10,Del Norte,015,27424,846,809,2,811,2
2021-01-10,El Dorado,017,186661,7630,6904,452,7356,36
2021-01-10,Fresno,019,978130,81839,75621,5971,81592,775
2021-01-10,Glenn,021,27897,1906,1746,363,2109,9
2021-01-10,Humboldt,023,135768,2215,2049,7,2056,22
2021-01-10,Imperial,025,180216,25167,24233,1983,26216,453
2021-01-10,Inyo,027,18085,885,748,8,756,25
2021-01-10,Kern,029,883053,78680,73712,6816,80528,679
2021-01-10,Kings,031,150075,18785,17812,708,18520,108
2021-01-10,Lake,033,64148,2431,2174,0,2174,26
2021-01-10,Lassen,035,31185,4712,4642,69,4711,1
2021-01-10,Los Angeles,037,10098052,976764,901783,30779,932562,12170
2021-01-10,Madera,039,155013,13083,12179,602,12781,85
2021-01-10,Marin,041,260295,11270,10737,111,10848,155
2021-01-10,Mariposa,043,17540,319,291,2,293,3
2021-01-10,Mendocino,045,87422,2935,2706,42,2748,31
2021-01-10,Merced,047,269075,22845,21691,537,22228,238
2021-01-10,Modoc,049,8938,293,271,81,352,0
2021-01-10,Mono,051,14174,1042,965,13,978,3
2021-01-10,Monterey,053,433212,34194,32571,966,33537,237
2021-01-10,Napa,055,140530,7288,6687,29,6716,36
2021-01-10,Nevada,057,99092,3213,2959,118,3077,17
2021-01-10,Orange,059,3164182,205322,193766,8297,202063,2104
2021-01-10,Placer,061,380077,17402,15779,793,16572,163
2021-01-10,Plumas,063,18699,554,477,9,486,2
2021-01-10,Riverside,065,2383286,235257,219486,11099,230585,2216
2021-01-10,Sacramento,067,1510023,77834,75394,826,76220,965
2021-01-10,San Benito,069,59416,4668,4434,44,4478,34
2021-01-10,San Bernardino,071,2135413,246803,232171,6987,239158,1736
2021-01-10,San Diego,073,3302833,209245,191886,9657,201543,1857
2021-01-10,San Francisco,075,870044,28177,27054,395,27449,238
2021-01-10,San Joaquin,077,732212,55260,52535,2140,54675,725
2021-01-10,San Luis Obispo,079,281455,15126,13968,361,14329,122
2021-01-10,San Mateo,081,765935,31839,28972,177,29149,206
2021-01-10,Santa Barbara,083,443738,23383,21290,677,21967,200
2021-01-10,Santa Clara,085,1922200,89392,83779,386,84165,858
2021-01-10,Santa Cruz,087,273765,12287,10951,507,11458,106
2021-01-10,Shasta,089,179085,9420,8936,904,9840,81
2021-01-10,Sierra,091,2930,40,32,6,38,0
2021-01-10,Siskiyou,093,43540,1192,1075,159,1234,3
2021-01-10,Solano,095,438530,24148,22621,255,22876,101
2021-01-10,Sonoma,097,501317,22933,21925,120,22045,204
2021-01-10,Stanislaus,099,539301,41337,38809,3996,42805,571
2021-01-10,Sutter,101,95872,7442,7133,55,7188,71
2021-01-10,Tehama,103,63373,3700,3504,383,3887,17
2021-01-10,Trinity,105,12862,437,253,63,316,2
2021-01-10,Tulare,107,460477,40546,38012,5093,43105,497
2021-01-10,Tuolumne,109,53932,3160,3143,27,3170,27
2021-01-10,Ventura,111,848112,57663,53095,2004,55099,319
2021-01-10,Yolo,113,214977,10440,9610,98,9708,129
2021-01-10,Yuba,115,75493,4575,4300,46,4346,27
2021-01-09,Alameda,001,1643700,64342,60125,1316,61441,649
2021-01-09,Alpine,003,1148,73,70,0,70,0
2021-01-09,Amador,005,37829,2959,2809,24,2833,24
2021-01-09,Butte,007,227075,9379,8552,1188,9740,118
2021-01-09,Calaveras,009,45235,1474,1425,7,1432,21
2021-01-09,Colusa,011,21464,1538,1468,142,1610,7
2021-01-09,Contra Costa,013,1133247,49970,46406,789,47195,393
2021-01-09,Del Norte,015,27424,844,802,2,804,2
2021-01-09,El Dorado,017,186661,7598,6800,449,7249,36
2021-01-09,Fresno,019,978130,81430,74816,5931,80747,773
2021-01-09,Glenn,021,27897,1891,1707,360,2067,9
2021-01-09,Humboldt,023,135768,2197,2026,7,2033,22
2021-01-09,Imperial,025,180216,25099,24028,1969,25997,448
2021-01-09,Inyo,027,18085,875,734,8,742,25
2021-01-09,Kern,029,883053,78212,73015,6739,79754,677
2021-01-09,Kings,031,150075,18690,17679,704,18383,108
2021-01-09,Lake,033,64148,2396,2144,0,2144,26
2021-01-09,Lassen,035,31185,4700,4613,68,4681,1
2021-01-09,Los Angeles,037,10098052,971195,887949,30338,918287,12011
2021-01-09,Madera,039,155013,12992,12063,597,12660,85
2021-01-09,Marin,041,260295,11209,10634,110,10744,154
2021-01-09,Mariposa,043,17540,316,287,2,289,3
2021-01-09,Mendocino,045,87422,2917,2664,42,2706,31
2021-01-09,Merced,047,269075,22703,21357,528,21885,237
2021-01-09,Modoc,049,8938,293,271,80,351,0
2021-01-09,Mono,051,14174,1037,964,13,977,3
2021-01-09,Monterey,053,433212,34043,31948,956,32904,235
2021-01-09,Napa,055,140530,7218,6594,26,6620,36
2021-01-09,Nevada,057,99092,3191,2932,115,3047,17
2021-01-09,Orange,059,3164182,203814,191004,8204,199208,2034
2021-01-09,Placer,061,380077,17294,15609,791,16400,162
2021-01-09,Plumas,063,18699,552,477,9,486,2
2021-01-09,Riverside,065,2383286,233501,216076,10962,227038,2201
2021-01-09,Sacramento,067,1510023,77301,74482,821,75303,953
2021-01-09,San Benito,069,59416,4617,4335,44,4379,34
2021-01-09,San Bernardino,071,2135413,245617,228857,6918,235775,1714
2021-01-09,San Diego,073,3302833,207552,188598,9537,198135,1824
2021-01-09,San Francisco,075,870044,28003,26708,352,27060,235
2021-01-09,San Joaquin,077,732212,54911,51927,2120,54047,724
2021-01-09,San Luis Obispo,079,281455,15002,13647,350,13997,121
2021-01-09,San Mateo,081,765935,31540,28512,170,28682,205
2021-01-09,Santa Barbara,083,443738,23170,20971,672,21643,197
2021-01-09,Santa Clara,085,1922200,88554,82269,374,82643,808
2021-01-09,Santa Cruz,087,273765,12191,10717,501,11218,107
2021-01-09,Shasta,089,179085,9387,8893,900,9793,81
2021-01-09,Sierra,091,2930,38,32,6,38,0
2021-01-09,Siskiyou,093,43540,1188,1062,155,1217,3
2021-01-09,Solano,095,438530,23990,22226,254,22480,101
2021-01-09,Sonoma,097,501317,22811,21393,120,21513,202
2021-01-09,Stanislaus,099,539301,41046,38403,3961,42364,567
2021-01-09,Sutter,101,95872,7406,7072,54,7126,69
2021-01-09,Tehama,103,63373,3668,3451,372,3823,15
2021-01-09,Trinity,105,12862,437,252,63,315,2
2021-01-09,Tulare,107,460477,40292,37684,5027,42711,496
2021-01-09,Tuolumne,109,53932,3152,3117,26,3143,26
2021-01-09,Ventura,111,848112,56834,51988,1978,53966,306
2021-01-09,Yolo,113,214977,10368,9524,95,9619,129
2021-01-09,Yuba,115,75493,4545,4265,46,4311,27
2021-01-08,Alameda,001,1643700,63784,59172,1306,60478,646
2021-01-08,Alpine,003,1148,73,70,0,70,0
2021-01-08,Amador,005,37829,2952,2792,24,2816,24
2021-01-08,Butte,007,227075,9319,8430,1174,9604,115
2021-01-08,Calaveras,009,45235,1460,1385,7,1392,21
2021-01-08,Colusa,011,21464,1525,1448,141,1589,7
2021-01-08,Contra Costa,013,1133247,49443,45667,785,46452,381
2021-01-08,Del Norte,015,27424,842,795,2,797,2
2021-01-08,El Dorado,017,186661,7528,6690,437,7127,36
2021-01-08,Fresno,019,978130,80615,73689,5870,79559,771
2021-01-08,Glenn,021,27897,1876,1680,355,2035,9
2021-01-08,Humboldt,023,135768,2173,1988,7,1995,22
2021-01-08,Imperial,025,180216,25033,23751,1954,25705,446
2021-01-08,Inyo,027,18085,861,682,8,690,24
2021-01-08,Kern,029,883053,77649,71978,6665,78643,674
2021-01-08,Kings,031,150075,18562,17441,699,18140,108
2021-01-08,Lake,033,64148,2371,2098,0,2098,26
2021-01-08,Lassen,035,31185,4692,4598,66,4664,1
2021-01-08,Los Angeles,037,10098052,960398,871188,29906,901094,11796
2021-01-08,Madera,039,155013,12841,11846,588,12434,85
2021-01-08,Marin,041,260295,11116,10531,109,10640,153
2021-01-08,Mariposa,043,17540,315,273,2,275,3
2021-01-08,Mendocino,045,87422,2898,2634,39,2673,31
2021-01-08,Merced,047,269075,22508,20862,523,21385,236
2021-01-08,Modoc,049,8938,293,266,80,346,0
2021-01-08,Mono,051,14174,1027,951,13,964,3
2021-01-08,Monterey,053,433212,33790,31543,945,32488,224
2021-01-08,Napa,055,140530,7148,6544,26,6570,32
2021-01-08,Nevada,057,99092,3169,2888,115,3003,17
2021-01-08,Orange,059,3164182,201822,186608,8117,194725,1991
2021-01-08,Placer,061,380077,17163,15401,784,16185,161
2021-01-08,Plumas,063,18699,546,465,9,474,2
2021-01-08,Riverside,065,2383286,231101,212122,10831,222953,2184
2021-01-08,Sacramento,067,1510023,76728,73245,815,74060,939
2021-01-08,San Benito,069,59416,4580,4225,43,4268,33
2021-01-08,San Bernardino,071,2135413,243738,224267,6848,231115,1703
2021-01-08,San Diego,073,3302833,205016,185060,9443,194503,1771
2021-01-08,San Francisco,075,870044,27755,26378,329,26707,207
2021-01-08,San Joaquin,077,732212,54575,50990,2091,53081,710
2021-01-08,San Luis Obispo,079,281455,14869,13286,338,13624,119
2021-01-08,San Mateo,081,765935,31190,28072,167,28239,204
2021-01-08,Santa Barbara,083,443738,22884,20461,667,21128,189
2021-01-08,Santa Clara,085,1922200,87547,80561,371,80932,789
2021-01-08,Santa Cruz,087,273765,12050,10486,493,10979,106
2021-01-08,Shasta,089,179085,9337,8772,885,9657,81
2021-01-08,Sierra,091,2930,38,31,6,37,0
2021-01-08,Siskiyou,093,43540,1185,1027,154,1181,3
2021-01-08,Solano,095,438530,23819,21832,251,22083,100
2021-01-08,Sonoma,097,501317,22669,21178,120,21298,201
2021-01-08,Stanislaus,099,539301,40748,37858,3926,41784,566
2021-01-08,Sutter,101,95872,7356,6982,54,7036,68
2021-01-08,Tehama,103,63373,3645,3406,368,3774,15
2021-01-08,Trinity,105,12862,437,247,63,310,2
2021-01-08,Tulare,107,460477,40020,36946,4926,41872,491
2021-01-08,Tuolumne,109,53932,3144,3099,26,3125,19
2021-01-08,Ventura,111,848112,55968,50553,1954,52507,294
2021-01-08,Yolo,113,214977,10280,9391,91,9482,129
2021-01-08,Yuba,115,75493,4503,4195,45,4240,26
2021-01-07,Alameda,001,1643700,62926,57921,1279,59200,632
2021-01-07,Alpine,003,1148,71,70,0,70,0
2021-01-07,Amador,005,37829,2939,2740,23,2763,24
2021-01-07,Butte,007,227075,9222,8278,1153,9431,112
2021-01-07,Calaveras,009,45235,1443,1342,6,1348,21
2021-01-07,Colusa,011,21464,1513,1420,134,1554,7
2021-01-07,Contra Costa,013,1133247,48667,44756,769,45525,376
2021-01-07,Del Norte,015,27424,840,791,2,793,2
2021-01-07,El Dorado,017,186661,7427,6545,425,6970,36
2021-01-07,Fresno,019,978130,79658,72557,5771,78328,765
2021-01-07,Glenn,021,27897,1858,1639,345,1984,9
2021-01-07,Humboldt,023,135768,2146,1954,7,1961,22
2021-01-07,Imperial,025,180216,24843,23608,1901,25509,431
2021-01-07,Inyo,027,18085,848,656,8,664,20
2021-01-07,Kern,029,883053,76787,70953,6514,77467,660
2021-01-07,Kings,031,150075,18434,17238,690,17928,108
2021-01-07,Lake,033,64148,2317,2054,0,2054,26
2021-01-07,Lassen,035,31185,4687,4581,64,4645,1
2021-01-07,Los Angeles,037,10098052,945493,853187,29363,882550,11480
2021-01-07,Madera,039,155013,12684,11644,577,12221,76
2021-01-07,Marin,041,260295,11027,10364,107,10471,153
2021-01-07,Mariposa,043,17540,313,264,2,266,3
2021-01-07,Mendocino,045,87422,2843,2585,34,2619,30
2021-01-07,Merced,047,269075,22187,20510,507,21017,234
2021-01-07,Modoc,049,8938,293,265,80,345,0
2021-01-07,Mono,051,14174,1016,905,13,918,3
2021-01-07,Monterey,053,433212,33285,30903,920,31823,222
2021-01-07,Napa,055,140530,7038,6408,26,6434,32
2021-01-07,Nevada,057,99092,3135,2847,110,2957,17
2021-01-07,Orange,059,3164182,198979,181922,8019,189941,1974
2021-01-07,Placer,061,380077,16984,15155,755,15910,144
2021-01-07,Plumas,063,18699,544,454,9,463,2
2021-01-07,Riverside,065,2383286,227638,208177,10675,218852,2156
2021-01-07,Sacramento,067,1510023,75820,72342,794,73136,919
2021-01-07,San Benito,069,59416,4519,4112,39,4151,33
2021-01-07,San Bernardino,071,2135413,240278,219691,6766,226457,1666
2021-01-07,San Diego,073,3302833,201710,180510,9264,189774,1738
2021-01-07,San Francisco,075,870044,27426,25885,314,26199,202
2021-01-07,San Joaquin,077,732212,53893,50156,2061,52217,689
2021-01-07,San Luis Obispo,079,281455,14630,12810,325,13135,118
2021-01-07,San Mateo,081,765935,30681,27494,163,27657,201
2021-01-07,Santa Barbara,083,443738,22457,19931,656,20587,187
2021-01-07,Santa Clara,085,1922200,86374,78808,368,79176,775
2021-01-07,Santa Cruz,087,273765,11841,10228,486,10714,104
2021-01-07,Shasta,089,179085,9249,8612,877,9489,81
2021-01-07,Sierra,091,2930,38,31,6,37,0
2021-01-07,Siskiyou,093,43540,1180,1010,152,1162,3
2021-01-07,Solano,095,438530,23427,21384,247,21631,100
2021-01-07,Sonoma,097,501317,22408,20857,119,20976,200
2021-01-07,Stanislaus,099,539301,40331,37296,3873,41169,553
2021-01-07,Sutter,101,95872,7297,6890,53,6943,65
2021-01-07,Tehama,103,63373,3621,3330,360,3690,15
2021-01-07,Trinity,105,12862,437,247,63,310,2
2021-01-07,Tulare,107,460477,39619,36397,4792,41189,482
2021-01-07,Tuolumne,109,53932,3124,3068,25,3093,14
2021-01-07,Ventura,111,848112,54807,49083,1926,51009,288
2021-01-07,Yolo,113,214977,10140,9207,89,9296,128
2021-01-07,Yuba,115,75493,4461,4128,45,4173,25
2021-01-06,Alameda,001,1643700,62072,57081,1249,58330,616
2021-01-06,Alpine,003,1148,71,70,0,70,0
2021-01-06,Amador,005,37829,2918,2717,22,2739,24
2021-01-06,Butte,007,227075,9107,8147,1133,9280,110
2021-01-06,Calaveras,009,45235,1420,1321,6,1327,21
2021-01-06,Colusa,011,21464,1492,1385,129,1514,7
2021-01-06,Contra Costa,013,1133247,47874,44054,753,44807,358
2021-01-06,Del Norte,015,27424,834,780,2,782,2
2021-01-06,El Dorado,017,186661,7315,6397,412,6809,35
2021-01-06,Fresno,019,978130,78815,71404,5669,77073,752
2021-01-06,Glenn,021,27897,1832,1622,340,1962,9
2021-01-06,Humboldt,023,135768,2120,1912,7,1919,22
2021-01-06,Imperial,025,180216,24598,23400,1859,25259,431
2021-01-06,Inyo,027,18085,832,630,8,638,20
2021-01-06,Kern,029,883053,75843,69893,6383,76276,646
2021-01-06,Kings,031,150075,18236,17019,670,17689,108
2021-01-06,Lake,033,64148,2280,2033,0,2033,26
2021-01-06,Lassen,035,31185,4675,4560,60,4620,1
2021-01-06,Los Angeles,037,10098052,929550,835052,28663,863715,11285
2021-01-06,Madera,039,155013,12548,11407,571,11978,67
2021-01-06,Marin,041,260295,10899,10282,106,10388,153
2021-01-06,Mariposa,043,17540,310,259,2,261,3
2021-01-06,Mendocino,045,87422,2813,2561,34,2595,30
2021-01-06,Merced,047,269075,21850,20258,491,20749,232
2021-01-06,Modoc,049,8938,293,263,80,343,0
2021-01-06,Mono,051,14174,985,905,13,918,3
2021-01-06,Monterey,053,433212,32685,30387,888,31275,222
2021-01-06,Napa,055,140530,6908,6342,26,6368,32
2021-01-06,Nevada,057,99092,3115,2805,109,2914,15
2021-01-06,Orange,059,3164182,195527,177686,7877,185563,1935
2021-01-06,Placer,061,380077,16796,14940,737,15677,134
2021-01-06,Plumas,063,18699,536,445,9,454,2
2021-01-06,Riverside,065,2383286,223615,203714,10489,214203,2121
2021-01-06,Sacramento,067,1510023,74795,71572,777,72349,909
2021-01-06,San Benito,069,59416,4443,4031,38,4069,32
2021-01-06,San Bernardino,071,2135413,236562,215286,6658,221944,1634
2021-01-06,San Diego,073,3302833,198212,176660,9093,185753,1691
2021-01-06,San Francisco,075,870044,27056,25424,306,25730,199
2021-01-06,San Joaquin,077,732212,53137,49286,2020,51306,673
2021-01-06,San Luis Obispo,079,281455,14237,12305,318,12623,115
2021-01-06,San Mateo,081,765935,30255,27050,160,27210,200
2021-01-06,Santa Barbara,083,443738,21968,19453,647,20100,177
2021-01-06,Santa Clara,085,1922200,85003,77485,361,77846,746
2021-01-06,Santa Cruz,087,273765,11622,9954,468,10422,97
2021-01-06,Shasta,089,179085,9178,8482,870,9352,78
2021-01-06,Sierra,091,2930,37,31,6,37,0
2021-01-06,Siskiyou,093,43540,1168,998,148,1146,3
2021-01-06,Solano,095,438530,23044,21102,244,21346,99
2021-01-06,Sonoma,097,501317,22101,20558,119,20677,196
2021-01-06,Stanislaus,099,539301,39764,36751,3814,40565,553
2021-01-06,Sutter,101,95872,7216,6839,52,6891,59
2021-01-06,Tehama,103,63373,3593,3306,354,3660,15
2021-01-06,Trinity,105,12862,437,246,63,309,2
2021-01-06,Tulare,107,460477,39066,35882,4695,40577,465
2021-01-06,Tuolumne,109,53932,3104,3008,25,3033,14
2021-01-06,Ventura,111,848112,53564,47428,1902,49330,280
2021-01-06,Yolo,113,214977,9977,9083,86,9169,127
2021-01-06,Yuba,115,75493,4412,4097,45,4142,25
2021-01-05,Alameda,001,1643700,60956,56432,1214,57646,602
2021-01-05,Alpine,003,1148,71,70,0,70,0
2021-01-05,Amador,005,37829,2878,2695,22,2717,24
2021-01-05,Butte,007,227075,8966,8008,1105,9113,107
2021-01-05,Calaveras,009,45235,1374,1292,6,1298,21
2021-01-05,Colusa,011,21464,1467,1376,123,1499,7
2021-01-05,Contra Costa,013,1133247,46999,43442,741,44183,353
2021-01-05,Del Norte,015,27424,827,770,2,772,2
2021-01-05,El Dorado,017,186661,7197,6270,391,6661,32
2021-01-05,Fresno,019,978130,77593,70971,5575,76546,741
2021-01-05,Glenn,021,27897,1809,1608,324,1932,9
2021-01-05,Humboldt,023,135768,2084,1884,7,1891,22
2021-01-05,Imperial,025,180216,24425,23165,1815,24980,421
2021-01-05,Inyo,027,18085,818,627,8,635,20
2021-01-05,Kern,029,883053,74765,68257,6244,74501,624
2021-01-05,Kings,031,150075,18037,16860,647,17507,108
2021-01-05,Lake,033,64148,2233,2015,0,2015,25
2021-01-05,Lassen,035,31185,4660,4554,56,4610,1
2021-01-05,Los Angeles,037,10098052,910822,823783,27987,851770,11028
2021-01-05,Madera,039,155013,12372,11359,558,11917,67
2021-01-05,Marin,041,260295,10746,10214,105,10319,151
2021-01-05,Mariposa,043,17540,304,257,2,259,3
2021-01-05,Mendocino,045,87422,2777,2501,34,2535,30
2021-01-05,Merced,047,269075,21499,20051,479,20530,230
2021-01-05,Modoc,049,8938,293,254,80,334,0
2021-01-05,Mono,051,14174,979,896,13,909,3
2021-01-05,Monterey,053,433212,32136,30045,855,30900,213
2021-01-05,Napa,055,140530,6821,6264,26,6290,29
2021-01-05,Nevada,057,99092,3087,2781,107,2888,15
2021-01-05,Orange,059,3164182,191891,174869,7682,182551,1918
2021-01-05,Placer,061,380077,16573,14723,714,15437,133
2021-01-05,Plumas,063,18699,529,428,9,437,2
2021-01-05,Riverside,065,2383286,219487,200439,10314,210753,2069
2021-01-05,Sacramento,067,1510023,73866,70677,751,71428,888
2021-01-05,San Benito,069,59416,4341,3961,36,3997,28
2021-01-05,San Bernardino,071,2135413,232619,212522,6543,219065,1615
2021-01-05,San Diego,073,3302833,194073,172845,8878,181723,1654
2021-01-05,San Francisco,075,870044,26689,24989,288,25277,196
2021-01-05,San Joaquin,077,732212,52264,48969,1973,50942,663
2021-01-05,San Luis Obispo,079,281455,13838,12027,308,12335,106
2021-01-05,San Mateo,081,765935,29771,26486,158,26644,198
2021-01-05,Santa Barbara,083,443738,21522,19063,638,19701,172
2021-01-05,Santa Clara,085,1922200,83472,76355,348,76703,729
2021-01-05,Santa Cruz,087,273765,11349,9753,444,10197,93
2021-01-05,Shasta,089,179085,9071,8345,852,9197,73
2021-01-05,Sierra,091,2930,37,31,6,37,0
2021-01-05,Siskiyou,093,43540,1156,985,146,1131,3
2021-01-05,Solano,095,438530,22636,20860,239,21099,97
2021-01-05,Sonoma,097,501317,21741,20247,118,20365,194
2021-01-05,Stanislaus,099,539301,39218,36363,3763,40126,553
2021-01-05,Sutter,101,95872,7119,6769,51,6820,59
2021-01-05,Tehama,103,63373,3537,3255,349,3604,9
2021-01-05,Trinity,105,12862,437,246,63,309,2
2021-01-05,Tulare,107,460477,38452,35585,4550,40135,455
2021-01-05,Tuolumne,109,53932,3080,2996,20,3016,13
2021-01-05,Ventura,111,848112,52318,46456,1880,48336,264
2021-01-05,Yolo,113,214977,9803,8980,85,9065,127
2021-01-05,Yuba,115,75493,4353,4053,44,4097,21
2021-01-04,Alameda,001,1643700,59728,55899,1180,57079,583
2021-01-04,Alpine,003,1148,71,68,0,68,0
2021-01-04,Amador,005,37829,2838,2596,22,2618,24
2021-01-04,Butte,007,227075,8807,7893,1084,8977,105
2021-01-04,Calaveras,009,45235,1333,1276,5,1281,21
2021-01-04,Colusa,011,21464,1442,1368,109,1477,7
2021-01-04,Contra Costa,013,1133247,46138,43019,715,43734,353
2021-01-04,Del Norte,015,27424,817,770,2,772,2
2021-01-04,El Dorado,017,186661,7063,6152,375,6527,27
2021-01-04,Fresno,019,978130,76325,69871,5477,75348,726
2021-01-04,Glenn,021,27897,1776,1590,319,1909,9
2021-01-04,Humboldt,023,135768,2048,1845,7,1852,22
2021-01-04,Imperial,025,180216,24273,23035,1762,24797,420
2021-01-04,Inyo,027,18085,791,623,8,631,20
2021-01-04,Kern,029,883053,73681,67418,6047,73465,623
2021-01-04,Kings,031,150075,17760,16801,622,17423,108
2021-01-04,Lake,033,64148,2194,1984,0,1984,25
2021-01-04,Lassen,035,31185,4638,4550,55,4605,1
2021-01-04,Los Angeles,037,10098052,890710,813022,27111,840133,10790
2021-01-04,Madera,039,155013,12152,11204,536,11740,67
2021-01-04,Marin,041,260295,10609,10115,102,10217,151
2021-01-04,Mariposa,043,17540,298,253,2,255,3
2021-01-04,Mendocino,045,87422,2737,2460,30,2490,28
2021-01-04,Merced,047,269075,21084,19804,460,20264,230
2021-01-04,Modoc,049,8938,277,250,78,328,0
2021-01-04,Mono,051,14174,968,895,13,908,3
2021-01-04,Monterey,053,433212,31516,29659,833,30492,212
2021-01-04,Napa,055,140530,6680,6187,26,6213,29
2021-01-04,Nevada,057,99092,3049,2765,104,2869,15
2021-01-04,Orange,059,3164182,188003,172458,7555,180013,1918
2021-01-04,Placer,061,380077,16314,14622,701,15323,133
2021-01-04,Plumas,063,18699,519,419,9,428,1
2021-01-04,Riverside,065,2383286,214934,196809,10123,206932,2066
2021-01-04,Sacramento,067,1510023,72812,70164,741,70905,870
2021-01-04,San Benito,069,59416,4228,3914,36,3950,28
2021-01-04,San Bernardino,071,2135413,228365,210868,6392,217260,1615
2021-01-04,San Diego,073,3302833,189499,171031,8682,179713,1598
2021-01-04,San Francisco,075,870044,26301,24753,282,25035,191
2021-01-04,San Joaquin,077,732212,51365,48644,1930,50574,661
2021-01-04,San Luis Obispo,079,281455,13352,11945,300,12245,96
2021-01-04,San Mateo,081,765935,29206,26150,153,26303,198
2021-01-04,Santa Barbara,083,443738,20999,18735,607,19342,165
2021-01-04,Santa Clara,085,1922200,81719,75297,340,75637,727
2021-01-04,Santa Cruz,087,273765,11061,9680,427,10107,85
2021-01-04,Shasta,089,179085,8966,8224,835,9059,72
2021-01-04,Sierra,091,2930,36,30,6,36,0
2021-01-04,Siskiyou,093,43540,1139,980,143,1123,3
2021-01-04,Solano,095,438530,22137,20588,232,20820,97
2021-01-04,Sonoma,097,501317,21403,20210,117,20327,194
2021-01-04,Stanislaus,099,539301,38655,36141,3706,39847,553
2021-01-04,Sutter,101,95872,7023,6712,50,6762,56
2021-01-04,Tehama,103,63373,3464,3190,344,3534,9
2021-01-04,Trinity,105,12862,434,245,63,308,2
2021-01-04,Tulare,107,460477,37892,35060,4447,39507,455
2021-01-04,Tuolumne,109,53932,3055,2987,20,3007,13
2021-01-04,Ventura,111,848112,50816,45014,1860,46874,255
2021-01-04,Yolo,113,214977,9609,8834,79,8913,121
2021-01-04,Yuba,115,75493,4295,4023,44,4067,21
2021-01-03,Alameda,001,1643700,58470,55082,1150,56232,580
2021-01-03,Alpine,003,1148,69,68,0,68,0
2021-01-03,Amador,005,37829,2774,2565,22,2587,24
2021-01-03,Butte,007,227075,8614,7837,1038,8875,105
2021-01-03,Calaveras,009,45235,1296,1249,3,1252,21
2021-01-03,Colusa,011,21464,1413,1337,103,1440,7
2021-01-03,Contra Costa,013,1133247,45249,42432,690,43122,352
2021-01-03,Del Norte,015,27424,805,768,2,770,2
2021-01-03,El Dorado,017,186661,6935,6034,358,6392,27
2021-01-03,Fresno,019,978130,75175,69326,5358,74684,719
2021-01-03,Glenn,021,27897,1750,1581,313,1894,9
2021-01-03,Humboldt,023,135768,2011,1833,7,1840,21
2021-01-03,Imperial,025,180216,24025,22951,1684,24635,419
2021-01-03,Inyo,027,18085,774,615,8,623,20
2021-01-03,Kern,029,883053,72421,66895,5869,72764,609
2021-01-03,Kings,031,150075,17484,16593,592,17185,108
2021-01-03,Lake,033,64148,2141,1976,0,1976,24
2021-01-03,Lassen,035,31185,4605,4531,54,4585,1
2021-01-03,Los Angeles,037,10098052,868682,792168,26038,818206,10633
2021-01-03,Madera,039,155013,11929,11152,513,11665,67
2021-01-03,Marin,041,260295,10458,10034,97,10131,150
2021-01-03,Mariposa,043,17540,291,248,2,250,3
2021-01-03,Mendocino,045,87422,2697,2445,29,2474,24
2021-01-03,Merced,047,269075,20616,19600,433,20033,230
2021-01-03,Modoc,049,8938,273,245,77,322,0
2021-01-03,Mono,051,14174,943,893,13,906,3
2021-01-03,Monterey,053,433212,30923,29357,798,30155,191
2021-01-03,Napa,055,140530,6579,6094,26,6120,29
2021-01-03,Nevada,057,99092,2988,2742,101,2843,15
2021-01-03,Orange,059,3164182,183813,169881,7361,177242,1919
2021-01-03,Placer,061,380077,16065,14319,677,14996,133
2021-01-03,Plumas,063,18699,506,416,9,425,1
2021-01-03,Riverside,065,2383286,210058,195048,9877,204925,2005
2021-01-03,Sacramento,067,1510023,71605,68558,720,69278,859
2021-01-03,San Benito,069,59416,4131,3882,35,3917,28
2021-01-03,San Bernardino,071,2135413,223048,208294,6219,214513,1592
2021-01-03,San Diego,073,3302833,184239,168018,8453,176471,1592
2021-01-03,San Francisco,075,870044,25805,24588,264,24852,193
2021-01-03,San Joaquin,077,732212,50245,47899,1873,49772,661
2021-01-03,San Luis Obispo,079,281455,12882,11636,291,11927,95
2021-01-03,San Mateo,081,765935,28611,25770,146,25916,196
2021-01-03,Santa Barbara,083,443738,20266,18267,590,18857,164
2021-01-03,Santa Clara,085,1922200,80132,74534,334,74868,720
2021-01-03,Santa Cruz,087,273765,10757,9528,411,9939,84
2021-01-03,Shasta,089,179085,8840,8192,795,8987,72
2021-01-03,Sierra,091,2930,36,30,6,36,0
2021-01-03,Siskiyou,093,43540,1106,976,134,1110,3
2021-01-03,Solano,095,438530,21608,20105,226,20331,97
2021-01-03,Sonoma,097,501317,21015,19982,113,20095,193
2021-01-03,Stanislaus,099,539301,37948,35762,3621,39383,553
2021-01-03,Sutter,101,95872,6926,6664,49,6713,53
2021-01-03,Tehama,103,63373,3407,3176,337,3513,9
2021-01-03,Trinity,105,12862,429,243,61,304,2
2021-01-03,Tulare,107,460477,37330,34747,4299,39046,455
2021-01-03,Tuolumne,109,53932,2995,2978,17,2995,13
2021-01-03,Ventura,111,848112,48992,43748,1842,45590,254
2021-01-03,Yolo,113,214977,9453,8674,75,8749,121
2021-01-03,Yuba,115,75493,4241,3966,43,4009,20
2021-01-02,Alameda,001,1643700,57839,54518,1121,55639,581
2021-01-02,Alpine,003,1148,69,68,0,68,0
2021-01-02,Amador,005,37829,2755,2540,22,2562,24
2021-01-02,Butte,007,227075,8508,7750,1016,8766,105
2021-01-02,Calaveras,009,45235,1276,1230,3,1233,21
2021-01-02,Colusa,011,21464,1403,1332,102,1434,7
2021-01-02,Contra Costa,013,1133247,44716,41993,679,42672,352
2021-01-02,Del Norte,015,27424,803,764,2,766,2
2021-01-02,El Dorado,017,186661,6880,5959,354,6313,27
2021-01-02,Fresno,019,978130,74631,68740,5244,73984,717
2021-01-02,Glenn,021,27897,1733,1546,312,1858,9
2021-01-02,Humboldt,023,135768,1984,1815,7,1822,21
2021-01-02,Imperial,025,180216,23938,22867,1648,24515,420
2021-01-02,Inyo,027,18085,761,609,8,617,20
2021-01-02,Kern,029,883053,71701,66457,5757,72214,610
2021-01-02,Kings,031,150075,17390,16515,588,17103,108
2021-01-02,Lake,033,64148,2105,1925,0,1925,24
2021-01-02,Lassen,035,31185,4594,4457,53,4510,1
2021-01-02,Los Angeles,037,10098052,860319,791892,25337,817229,10633
2021-01-02,Madera,039,155013,11818,11039,502,11541,67
2021-01-02,Marin,041,260295,10412,9924,94,10018,151
2021-01-02,Mariposa,043,17540,284,243,2,245,3
2021-01-02,Mendocino,045,87422,2654,2428,28,2456,24
2021-01-02,Merced,047,269075,20474,19395,416,19811,230
2021-01-02,Modoc,049,8938,272,245,77,322,0
2021-01-02,Mono,051,14174,932,884,13,897,3
2021-01-02,Monterey,053,433212,30710,28991,786,29777,191
2021-01-02,Napa,055,140530,6520,5994,26,6020,29
2021-01-02,Nevada,057,99092,2959,2706,97,2803,15
2021-01-02,Orange,059,3164182,181605,168457,7212,175669,1918
2021-01-02,Placer,061,380077,15892,14182,668,14850,133
2021-01-02,Plumas,063,18699,503,413,9,422,1
2021-01-02,Riverside,065,2383286,207415,192069,9651,201720,2008
2021-01-02,Sacramento,067,1510023,70970,67810,703,68513,858
2021-01-02,San Benito,069,59416,4048,3829,35,3864,28
2021-01-02,San Bernardino,071,2135413,221393,206939,6094,213033,1597
2021-01-02,San Diego,073,3302833,181640,164498,8256,172754,1592
2021-01-02,San Francisco,075,870044,25544,24414,257,24671,194
2021-01-02,San Joaquin,077,732212,49864,47310,1844,49154,662
2021-01-02,San Luis Obispo,079,281455,12746,11467,285,11752,95
2021-01-02,San Mateo,081,765935,28275,25483,138,25621,196
2021-01-02,Santa Barbara,083,443738,19977,18135,587,18722,164
2021-01-02,Santa Clara,085,1922200,78948,73662,327,73989,720
2021-01-02,Santa Cruz,087,273765,10602,9340,402,9742,85
2021-01-02,Shasta,089,179085,8774,8154,784,8938,72
2021-01-02,Sierra,091,2930,36,28,6,34,0
2021-01-02,Siskiyou,093,43540,1095,949,132,1081,3
2021-01-02,Solano,095,438530,21408,19805,216,20021,97
2021-01-02,Sonoma,097,501317,20846,19761,113,19874,194
2021-01-02,Stanislaus,099,539301,37615,35431,3556,38987,553
2021-01-02,Sutter,101,95872,6874,6621,49,6670,53
2021-01-02,Tehama,103,63373,3380,3146,333,3479,9
2021-01-02,Trinity,105,12862,426,243,61,304,2
2021-01-02,Tulare,107,460477,37010,34479,4224,38703,455
2021-01-02,Tuolumne,109,53932,2981,2942,15,2957,13
2021-01-02,Ventura,111,848112,47837,43397,1807,45204,254
2021-01-02,Yolo,113,214977,9355,8571,73,8644,122
2021-01-02,Yuba,115,75493,4202,3930,42,3972,21
2021-01-01,Alameda,001,1643700,57173,53518,1105,54623,579
2021-01-01,Alpine,003,1148,69,68,0,68,0
2021-01-01,Amador,005,37829,2729,2513,20,2533,24
2021-01-01,Butte,007,227075,8406,7589,994,8583,105
2021-01-01,Calaveras,009,45235,1261,1186,3,1189,21
2021-01-01,Colusa,011,21464,1394,1314,100,1414,7
2021-01-01,Contra Costa,013,1133247,44235,41412,660,42072,351
2021-01-01,Del Norte,015,27424,796,758,2,760,2
2021-01-01,El Dorado,017,186661,6788,5832,346,6178,27
2021-01-01,Fresno,019,978130,73558,67484,5158,72642,717
2021-01-01,Glenn,021,27897,1716,1520,303,1823,9
2021-01-01,Humboldt,023,135768,1945,1783,7,1790,21
2021-01-01,Imperial,025,180216,23848,22715,1597,24312,418
2021-01-01,Inyo,027,18085,737,606,8,614,20
2021-01-01,Kern,029,883053,70874,65571,5649,71220,609
2021-01-01,Kings,031,150075,17207,16358,581,16939,108
2021-01-01,Lake,033,64148,2072,1888,0,1888,24
2021-01-01,Lassen,035,31185,4588,4377,53,4430,1
2021-01-01,Los Angeles,037,10098052,846123,775578,24642,800220,10515
2021-01-01,Madera,039,155013,11658,10752,493,11245,66
2021-01-01,Marin,041,260295,10305,9821,93,9914,148
2021-01-01,Mariposa,043,17540,276,236,2,238,3
2021-01-01,Mendocino,045,87422,2600,2400,28,2428,24
2021-01-01,Merced,047,269075,20290,19118,400,19518,229
2021-01-01,Modoc,049,8938,272,241,77,318,0
2021-01-01,Mono,051,14174,914,884,12,896,3
2021-01-01,Monterey,053,433212,30470,28465,777,29242,191
2021-01-01,Napa,055,140530,6434,5899,26,5925,28
2021-01-01,Nevada,057,99092,2935,2663,97,2760,15
2021-01-01,Orange,059,3164182,178807,165440,7068,172508,1893
2021-01-01,Placer,061,380077,15702,13987,652,14639,133
2021-01-01,Plumas,063,18699,498,412,9,421,1
2021-01-01,Riverside,065,2383286,204227,188674,9393,198067,1990
2021-01-01,Sacramento,067,1510023,70372,66956,686,67642,848
2021-01-01,San Benito,069,59416,4010,3773,35,3808,28
2021-01-01,San Bernardino,071,2135413,218551,203651,5962,209613,1590
2021-01-01,San Diego,073,3302833,178567,160071,8077,168148,1592
2021-01-01,San Francisco,075,870044,25268,24145,246,24391,187
2021-01-01,San Joaquin,077,732212,49572,46640,1798,48438,657
2021-01-01,San Luis Obispo,079,281455,12518,11160,277,11437,94
2021-01-01,San Mateo,081,765935,27827,25041,134,25175,194
2021-01-01,Santa Barbara,083,443738,19657,17759,577,18336,164
2021-01-01,Santa Clara,085,1922200,77663,71904,322,72226,680
2021-01-01,Santa Cruz,087,273765,10422,9146,392,9538,84
2021-01-01,Shasta,089,179085,8693,8102,767,8869,72
2021-01-01,Sierra,091,2930,36,26,6,32,0
2021-01-01,Siskiyou,093,43540,1081,944,127,1071,3
2021-01-01,Solano,095,438530,21193,19393,214,19607,97
2021-01-01,Sonoma,097,501317,20650,19513,113,19626,189
2021-01-01,Stanislaus,099,539301,37327,34978,3493,38471,553
2021-01-01,Sutter,101,95872,6817,6553,48,6601,52
2021-01-01,Tehama,103,63373,3322,3079,326,3405,9
2021-01-01,Trinity,105,12862,426,243,61,304,2
2021-01-01,Tulare,107,460477,36600,33994,4129,38123,454
2021-01-01,Tuolumne,109,53932,2965,2909,15,2924,13
2021-01-01,Ventura,111,848112,46344,42026,1780,43806,253
2021-01-01,Yolo,113,214977,9244,8461,70,8531,120
2021-01-01,Yuba,115,75493,4148,3845,41,3886,19
2020-12-31,Alameda,001,1643700,56619,52475,1073,53548,579
2020-12-31,Alpine,003,1148,69,66,0,66,0
2020-12-31,Amador,005,37829,2715,2493,20,2513,24
2020-12-31,Butte,007,227075,8331,7405,975,8380,105
2020-12-31,Calaveras,009,45235,1250,1161,3,1164,21
2020-12-31,Colusa,011,21464,1386,1301,97,1398,7
2020-12-31,Contra Costa,013,1133247,43846,40512,645,41157,336
2020-12-31,Del Norte,015,27424,795,748,2,750,2
2020-12-31,El Dorado,017,186661,6736,5662,337,5999,26
2020-12-31,Fresno,019,978130,73124,66442,5095,71537,711
2020-12-31,Glenn,021,27897,1689,1484,295,1779,9
2020-12-31,Humboldt,023,135768,1928,1713,7,1720,21
2020-12-31,Imperial,025,180216,23777,22494,1581,24075,417
2020-12-31,Inyo,027,18085,729,591,8,599,20
2020-12-31,Kern,029,883053,70402,64904,5557,70461,609
2020-12-31,Kings,031,150075,17132,16077,573,16650,108
2020-12-31,Lake,033,64148,2057,1848,0,1848,23
2020-12-31,Lassen,035,31185,4582,4340,52,4392,1
2020-12-31,Los Angeles,037,10098052,840791,755844,24178,780022,10320
2020-12-31,Madera,039,155013,11585,10609,485,11094,64
2020-12-31,Marin,041,260295,10262,9731,92,9823,148
2020-12-31,Mariposa,043,17540,274,217,2,219,3
2020-12-31,Mendocino,045,87422,2585,2367,24,2391,24
2020-12-31,Merced,047,269075,20200,18808,390,19198,226
2020-12-31,Modoc,049,8938,272,238,77,315,0
2020-12-31,Mono,051,14174,906,868,12,880,3
2020-12-31,Monterey,053,433212,30241,27720,765,28485,188
2020-12-31,Napa,055,140530,6371,5801,26,5827,28
2020-12-31,Nevada,057,99092,2912,2619,95,2714,15
2020-12-31,Orange,059,3164182,176920,161586,6935,168521,1866
2020-12-31,Placer,061,380077,15546,13708,649,14357,126
2020-12-31,Plumas,063,18699,493,401,8,409,1
2020-12-31,Riverside,065,2383286,202553,184193,9260,193453,1958
2020-12-31,Sacramento,067,1510023,69842,65817,676,66493,830
2020-12-31,San Benito,069,59416,3986,3673,35,3708,28
2020-12-31,San Bernardino,071,2135413,216915,199115,5892,205007,1586
2020-12-31,San Diego,073,3302833,176804,155593,7978,163571,1534
2020-12-31,San Francisco,075,870044,25037,23740,239,23979,183
2020-12-31,San Joaquin,077,732212,49253,45764,1759,47523,646
2020-12-31,San Luis Obispo,079,281455,12404,10846,277,11123,89
2020-12-31,San Mateo,081,765935,27497,24570,128,24698,192
2020-12-31,Santa Barbara,083,443738,19413,17434,570,18004,161
2020-12-31,Santa Clara,085,1922200,76857,70032,317,70349,665
2020-12-31,Santa Cruz,087,273765,10304,8909,380,9289,84
2020-12-31,Shasta,089,179085,8627,7996,757,8753,69
2020-12-31,Sierra,091,2930,36,26,6,32,0
2020-12-31,Siskiyou,093,43540,1065,940,124,1064,3
2020-12-31,Solano,095,438530,20962,18942,213,19155,97
2020-12-31,Sonoma,097,501317,20529,19129,112,19241,188
2020-12-31,Stanislaus,099,539301,37019,34398,3445,37843,552
2020-12-31,Sutter,101,95872,6786,6432,48,6480,51
2020-12-31,Tehama,103,63373,3287,3036,325,3361,9
2020-12-31,Trinity,105,12862,425,241,61,302,2
2020-12-31,Tulare,107,460477,36427,33412,4066,37478,446
2020-12-31,Tuolumne,109,53932,2956,2902,15,2917,12
2020-12-31,Ventura,111,848112,45833,40854,1763,42617,251
2020-12-31,Yolo,113,214977,9157,8295,69,8364,117
2020-12-31,Yuba,115,75493,4107,3799,40,3839,18
2020-12-30,Alameda,001,1643700,55852,50158,1022,51180,573
2020-12-30,Alpine,003,1148,69,66,0,66,0
2020-12-30,Amador,005,37829,2695,2418,19,2437,24
2020-12-30,Butte,007,227075,8169,7140,954,8094,103
2020-12-30,Calaveras,009,45235,1225,1135,3,1138,21
2020-12-30,Colusa,011,21464,1370,1289,91,1380,7
2020-12-30,Contra Costa,013,1133247,43262,39601,633,40234,337
2020-12-30,Del Norte,015,27424,790,726,2,728,2
2020-12-30,El Dorado,017,186661,6635,5595,327,5922,27
2020-12-30,Fresno,019,978130,72277,65566,4941,70507,711
2020-12-30,Glenn,021,27897,1658,1471,282,1753,9
2020-12-30,Humboldt,023,135768,1894,1654,7,1661,22
2020-12-30,Imperial,025,180216,23608,22098,1504,23602,412
2020-12-30,Inyo,027,18085,722,572,8,580,20
2020-12-30,Kern,029,883053,69674,63292,5413,68705,604
2020-12-30,Kings,031,150075,17013,15862,565,16427,108
2020-12-30,Lake,033,64148,2034,1731,0,1731,23
2020-12-30,Lassen,035,31185,4573,4300,52,4352,1
2020-12-30,Los Angeles,037,10098052,829888,741907,23485,765392,10046
2020-12-30,Madera,039,155013,11475,10249,474,10723,65
2020-12-30,Marin,041,260295,10172,9569,85,9654,148
2020-12-30,Mariposa,043,17540,270,214,2,216,3
2020-12-30,Mendocino,045,87422,2567,2291,21,2312,24
2020-12-30,Merced,047,269075,19909,18519,380,18899,225
2020-12-30,Modoc,049,8938,269,234,77,311,0
2020-12-30,Mono,051,14174,903,868,12,880,3
2020-12-30,Monterey,053,433212,29611,26977,743,27720,186
2020-12-30,Napa,055,140530,6265,5754,26,5780,28
2020-12-30,Nevada,057,99092,2877,2595,93,2688,15
2020-12-30,Orange,059,3164182,174262,153951,6745,160696,1863
2020-12-30,Placer,061,380077,15315,13540,637,14177,127
2020-12-30,Plumas,063,18699,488,397,8,405,1
2020-12-30,Riverside,065,2383286,199604,176402,9075,185477,1919
2020-12-30,Sacramento,067,1510023,68969,64119,659,64778,847
2020-12-30,San Benito,069,59416,3905,3464,31,3495,29
2020-12-30,San Bernardino,071,2135413,214347,192648,5806,198454,1591
2020-12-30,San Diego,073,3302833,173171,152510,7803,160313,1472
2020-12-30,San Francisco,075,870044,24744,23099,234,23333,182
2020-12-30,San Joaquin,077,732212,48560,44465,1717,46182,634
2020-12-30,San Luis Obispo,079,281455,12136,10542,269,10811,89
2020-12-30,San Mateo,081,765935,27069,24150,124,24274,190
2020-12-30,Santa Barbara,083,443738,19011,16895,548,17443,161
2020-12-30,Santa Clara,085,1922200,75605,67218,313,67531,661
2020-12-30,Santa Cruz,087,273765,10108,8787,371,9158,86
2020-12-30,Shasta,089,179085,8513,7818,743,8561,69
2020-12-30,Sierra,091,2930,36,25,6,31,0
2020-12-30,Siskiyou,093,43540,1058,913,115,1028,3
2020-12-30,Solano,095,438530,20570,18300,210,18510,96
2020-12-30,Sonoma,097,501317,20272,18947,112,19059,191
2020-12-30,Stanislaus,099,539301,36554,33730,3370,37100,526
2020-12-30,Sutter,101,95872,6725,6328,46,6374,51
2020-12-30,Tehama,103,63373,3243,2969,321,3290,9
2020-12-30,Trinity,105,12862,424,231,60,291,2
2020-12-30,Tulare,107,460477,35877,32413,4001,36414,430
2020-12-30,Tuolumne,109,53932,2946,2772,13,2785,12
2020-12-30,Ventura,111,848112,44545,39039,1739,40778,251
2020-12-30,Yolo,113,214977,9049,8067,67,8134,117
2020-12-30,Yuba,115,75493,4036,3612,40,3652,18
2020-12-29,Alameda,001,1643700,54791,50946,987,51933,552
2020-12-29,Alpine,003,1148,69,65,0,65,0
2020-12-29,Amador,005,37829,2643,2388,18,2406,23
2020-12-29,Butte,007,227075,7996,7178,930,8108,98
2020-12-29,Calaveras,009,45235,1180,1111,2,1113,21
2020-12-29,Colusa,011,21464,1349,1272,86,1358,7
2020-12-29,Contra Costa,013,1133247,42463,39225,602,39827,325
2020-12-29,Del Norte,015,27424,783,724,2,726,2
2020-12-29,El Dorado,017,186661,6506,5551,314,5865,22
2020-12-29,Fresno,019,978130,70901,65149,4786,69935,688
2020-12-29,Glenn,021,27897,1624,1454,275,1729,9
2020-12-29,Humboldt,023,135768,1847,1616,7,1623,19
2020-12-29,Imperial,025,180216,23395,22105,1419,23524,407
2020-12-29,Inyo,027,18085,705,571,8,579,19
2020-12-29,Kern,029,883053,68508,63096,5241,68337,589
2020-12-29,Kings,031,150075,16844,15777,553,16330,108
2020-12-29,Lake,033,64148,2003,1805,0,1805,22
2020-12-29,Lassen,035,31185,4558,4288,52,4340,1
2020-12-29,Los Angeles,037,10098052,809704,731907,22619,754526,9786
2020-12-29,Madera,039,155013,11161,10251,459,10710,64
2020-12-29,Marin,041,260295,10020,9595,82,9677,146
2020-12-29,Mariposa,043,17540,262,212,2,214,3
2020-12-29,Mendocino,045,87422,2524,2249,20,2269,24
2020-12-29,Merced,047,269075,19559,18464,364,18828,221
2020-12-29,Modoc,049,8938,266,232,77,309,0
2020-12-29,Mono,051,14174,894,868,12,880,3
2020-12-29,Monterey,053,433212,28961,26894,716,27610,185
2020-12-29,Napa,055,140530,6147,5663,26,5689,28
2020-12-29,Nevada,057,99092,2829,2550,92,2642,15
2020-12-29,Orange,059,3164182,170467,154411,6577,160988,1839
2020-12-29,Placer,061,380077,15101,13392,615,14007,126
2020-12-29,Plumas,063,18699,479,395,8,403,1
2020-12-29,Riverside,065,2383286,195001,177624,8821,186445,1904
2020-12-29,Sacramento,067,1510023,67918,65078,645,65723,820
2020-12-29,San Benito,069,59416,3786,3474,30,3504,25
2020-12-29,San Bernardino,071,2135413,209522,190476,5669,196145,1557
2020-12-29,San Diego,073,3302833,168948,150062,7572,157634,1435
2020-12-29,San Francisco,075,870044,24405,22996,226,23222,178
2020-12-29,San Joaquin,077,732212,47638,44699,1662,46361,622
2020-12-29,San Luis Obispo,079,281455,11840,10387,261,10648,80
2020-12-29,San Mateo,081,765935,26526,23773,112,23885,189
2020-12-29,Santa Barbara,083,443738,18542,16797,522,17319,155
2020-12-29,Santa Clara,085,1922200,74056,67581,310,67891,621
2020-12-29,Santa Cruz,087,273765,9839,8492,362,8854,84
2020-12-29,Shasta,089,179085,8409,7782,728,8510,65
2020-12-29,Sierra,091,2930,34,24,5,29,0
2020-12-29,Siskiyou,093,43540,1043,926,113,1039,3
2020-12-29,Solano,095,438530,20188,18412,205,18617,96
2020-12-29,Sonoma,097,501317,19938,18790,110,18900,187
2020-12-29,Stanislaus,099,539301,36079,33775,3300,37075,508
2020-12-29,Sutter,101,95872,6658,6302,46,6348,50
2020-12-29,Tehama,103,63373,3175,2962,309,3271,9
2020-12-29,Trinity,105,12862,423,241,60,301,2
2020-12-29,Tulare,107,460477,35217,32545,3869,36414,419
2020-12-29,Tuolumne,109,53932,2905,2797,13,2810,12
2020-12-29,Ventura,111,848112,43290,38669,1713,40382,235
2020-12-29,Yolo,113,214977,8920,8124,65,8189,111
2020-12-29,Yuba,115,75493,3954,3723,40,3763,18
2020-12-28,Alameda,001,1643700,53763,50405,967,51372,551
2020-12-28,Alpine,003,1148,68,65,0,65,0
2020-12-28,Amador,005,37829,2573,2255,18,2273,23
2020-12-28,Butte,007,227075,7829,7053,899,7952,86
2020-12-28,Calaveras,009,45235,1157,1102,2,1104,21
2020-12-28,Colusa,011,21464,1324,1255,73,1328,7
2020-12-28,Contra Costa,013,1133247,41524,38872,575,39447,324
2020-12-28,Del Norte,015,27424,773,718,2,720,2
2020-12-28,El Dorado,017,186661,6350,5441,302,5743,18
2020-12-28,Fresno,019,978130,69630,64274,4635,68909,679
2020-12-28,Glenn,021,27897,1590,1435,263,1698,9
2020-12-28,Humboldt,023,135768,1812,1579,7,1586,19
2020-12-28,Imperial,025,180216,23134,22003,1346,23349,405
2020-12-28,Inyo,027,18085,698,569,8,577,19
2020-12-28,Kern,029,883053,67440,62392,5037,67429,579
2020-12-28,Kings,031,150075,16627,15733,536,16269,108
2020-12-28,Lake,033,64148,1962,1785,0,1785,22
2020-12-28,Lassen,035,31185,4451,4284,51,4335,1
2020-12-28,Los Angeles,037,10098052,787358,720699,21806,742505,9544
2020-12-28,Madera,039,155013,10987,10123,436,10559,64
2020-12-28,Marin,041,260295,9912,9546,76,9622,145
2020-12-28,Mariposa,043,17540,238,211,2,213,3
2020-12-28,Mendocino,045,87422,2489,2214,20,2234,23
2020-12-28,Merced,047,269075,19238,18245,345,18590,213
2020-12-28,Modoc,049,8938,261,220,76,296,0
2020-12-28,Mono,051,14174,890,848,12,860,3
2020-12-28,Monterey,053,433212,28111,26529,705,27234,182
2020-12-28,Napa,055,140530,6038,5576,26,5602,26
2020-12-28,Nevada,057,99092,2781,2532,88,2620,15
2020-12-28,Orange,059,3164182,166363,152089,6400,158489,1839
2020-12-28,Placer,061,380077,14762,13234,588,13822,126
2020-12-28,Plumas,063,18699,475,391,8,399,0
2020-12-28,Riverside,065,2383286,190101,174029,8531,182560,1855
2020-12-28,Sacramento,067,1510023,66682,64322,621,64943,813
2020-12-28,San Benito,069,59416,3717,3429,29,3458,24
2020-12-28,San Bernardino,071,2135413,204432,188919,5552,194471,1552
2020-12-28,San Diego,073,3302833,164204,147528,7390,154918,1404
2020-12-28,San Francisco,075,870044,24045,22726,221,22947,178
2020-12-28,San Joaquin,077,732212,46705,44172,1630,45802,618
2020-12-28,San Luis Obispo,079,281455,11488,10260,257,10517,76
2020-12-28,San Mateo,081,765935,26051,23467,108,23575,189
2020-12-28,Santa Barbara,083,443738,18074,16579,510,17089,155
2020-12-28,Santa Clara,085,1922200,72569,66418,303,66721,619
2020-12-28,Santa Cruz,087,273765,9571,8310,352,8662,81
2020-12-28,Shasta,089,179085,8292,7688,715,8403,65
2020-12-28,Sierra,091,2930,32,24,4,28,0
2020-12-28,Siskiyou,093,43540,1027,915,108,1023,3
2020-12-28,Solano,095,438530,19616,18171,199,18370,96
2020-12-28,Sonoma,097,501317,19591,18667,108,18775,185
2020-12-28,Stanislaus,099,539301,35530,33473,3236,36709,507
2020-12-28,Sutter,101,95872,6578,6253,46,6299,49
2020-12-28,Tehama,103,63373,3123,2934,302,3236,9
2020-12-28,Trinity,105,12862,421,240,60,300,2
2020-12-28,Tulare,107,460477,34533,32010,3762,35772,404
2020-12-28,Tuolumne,109,53932,2888,2777,13,2790,12
2020-12-28,Ventura,111,848112,41621,37151,1666,38817,230
2020-12-28,Yolo,113,214977,8765,8031,64,8095,111
2020-12-28,Yuba,115,75493,3893,3679,39,3718,18
2020-12-27,Alameda,001,1643700,52526,49764,940,50704,551
2020-12-27,Alpine,003,1148,66,65,0,65,0
2020-12-27,Amador,005,37829,2452,2218,18,2236,23
2020-12-27,Butte,007,227075,7674,7016,859,7875,86
2020-12-27,Calaveras,009,45235,1110,1097,2,1099,21
2020-12-27,Colusa,011,21464,1299,1253,70,1323,7
2020-12-27,Contra Costa,013,1133247,40589,38428,546,38974,324
2020-12-27,Del Norte,015,27424,750,712,2,714,2
2020-12-27,El Dorado,017,186661,6136,5388,279,5667,18
2020-12-27,Fresno,019,978130,68382,63811,4429,68240,679
2020-12-27,Glenn,021,27897,1562,1434,249,1683,9
2020-12-27,Humboldt,023,135768,1768,1575,7,1582,17
2020-12-27,Imperial,025,180216,22836,21934,1233,23167,405
2020-12-27,Inyo,027,18085,676,565,7,572,18
2020-12-27,Kern,029,883053,66159,61914,4864,66778,568
2020-12-27,Kings,031,150075,16391,15593,502,16095,108
2020-12-27,Lake,033,64148,1906,1769,0,1769,22
2020-12-27,Lassen,035,31185,4374,4230,44,4274,1
2020-12-27,Los Angeles,037,10098052,765864,707260,20914,728174,9476
2020-12-27,Madera,039,155013,10729,10005,426,10431,64
2020-12-27,Marin,041,260295,9789,9477,71,9548,144
2020-12-27,Mariposa,043,17540,231,208,2,210,3
2020-12-27,Mendocino,045,87422,2442,2209,20,2229,23
2020-12-27,Merced,047,269075,18870,18075,329,18404,213
2020-12-27,Modoc,049,8938,252,221,72,293,0
2020-12-27,Mono,051,14174,877,849,12,861,3
2020-12-27,Monterey,053,433212,27552,26322,688,27010,181
2020-12-27,Napa,055,140530,5904,5496,26,5522,26
2020-12-27,Nevada,057,99092,2745,2519,88,2607,15
2020-12-27,Orange,059,3164182,161966,149276,6212,155488,1839
2020-12-27,Placer,061,380077,14466,13017,556,13573,126
2020-12-27,Plumas,063,18699,469,390,8,398,0
2020-12-27,Riverside,065,2383286,185185,171995,8225,180220,1836
2020-12-27,Sacramento,067,1510023,65474,63416,599,64015,811
2020-12-27,San Benito,069,59416,3631,3394,29,3423,24
2020-12-27,San Bernardino,071,2135413,199354,186776,5415,192191,1551
2020-12-27,San Diego,073,3302833,159797,145777,7203,152980,1402
2020-12-27,San Francisco,075,870044,23698,22514,212,22726,178
2020-12-27,San Joaquin,077,732212,45667,43529,1580,45109,618
2020-12-27,San Luis Obispo,079,281455,11080,10154,252,10406,76
2020-12-27,San Mateo,081,765935,25486,23136,104,23240,187
2020-12-27,Santa Barbara,083,443738,17546,16364,483,16847,155
2020-12-27,Santa Clara,085,1922200,70947,65288,298,65586,619
2020-12-27,Santa Cruz,087,273765,9305,8234,343,8577,81
2020-12-27,Shasta,089,179085,8165,7671,693,8364,65
2020-12-27,Sierra,091,2930,32,24,3,27,0
2020-12-27,Siskiyou,093,43540,1017,914,103,1017,3
2020-12-27,Solano,095,438530,19121,17840,193,18033,96
2020-12-27,Sonoma,097,501317,19299,18487,107,18594,185
2020-12-27,Stanislaus,099,539301,34910,33076,3140,36216,506
2020-12-27,Sutter,101,95872,6497,6218,44,6262,48
2020-12-27,Tehama,103,63373,3054,2922,286,3208,9
2020-12-27,Trinity,105,12862,414,240,58,298,2
2020-12-27,Tulare,107,460477,33937,31864,3643,35507,400
2020-12-27,Tuolumne,109,53932,2783,2750,11,2761,12
2020-12-27,Ventura,111,848112,40558,36661,1613,38274,230
2020-12-27,Yolo,113,214977,8574,7919,60,7979,111
2020-12-27,Yuba,115,75493,3829,3665,37,3702,18
2020-12-26,Alameda,001,1643700,51915,49084,927,50011,551
2020-12-26,Alpine,003,1148,66,65,0,65,0
2020-12-26,Amador,005,37829,2438,2189,18,2207,23
2020-12-26,Butte,007,227075,7579,6968,834,7802,86
2020-12-26,Calaveras,009,45235,1104,1084,2,1086,21
2020-12-26,Colusa,011,21464,1289,1240,70,1310,7
2020-12-26,Contra Costa,013,1133247,40125,38008,532,38540,324
2020-12-26,Del Norte,015,27424,744,709,2,711,2
2020-12-26,El Dorado,017,186661,6081,5279,275,5554,18
2020-12-26,Fresno,019,978130,67912,63080,4365,67445,679
2020-12-26,Glenn,021,27897,1541,1413,243,1656,9
2020-12-26,Humboldt,023,135768,1730,1545,7,1552,17
2020-12-26,Imperial,025,180216,22744,21734,1181,22915,405
2020-12-26,Inyo,027,18085,663,554,7,561,18
2020-12-26,Kern,029,883053,65487,61174,4715,65889,564
2020-12-26,Kings,031,150075,16273,15517,498,16015,108
2020-12-26,Lake,033,64148,1864,1710,0,1710,22
2020-12-26,Lassen,035,31185,4353,3981,44,4025,1
2020-12-26,Los Angeles,037,10098052,757310,694149,20406,714555,9424
2020-12-26,Madera,039,155013,10652,9908,414,10322,64
2020-12-26,Marin,041,260295,9754,9413,70,9483,143
2020-12-26,Mariposa,043,17540,230,206,2,208,3
2020-12-26,Mendocino,045,87422,2396,2194,20,2214,23
2020-12-26,Merced,047,269075,18711,17890,324,18214,213
2020-12-26,Modoc,049,8938,249,222,72,294,0
2020-12-26,Mono,051,14174,871,850,12,862,3
2020-12-26,Monterey,053,433212,27415,26010,679,26689,182
2020-12-26,Napa,055,140530,5846,5427,26,5453,26
2020-12-26,Nevada,057,99092,2717,2480,88,2568,15
2020-12-26,Orange,059,3164182,159761,147304,6119,153423,1838
2020-12-26,Placer,061,380077,14296,12816,541,13357,122
2020-12-26,Plumas,063,18699,466,381,8,389,0
2020-12-26,Riverside,065,2383286,182700,169360,8064,177424,1834
2020-12-26,Sacramento,067,1510023,64851,62435,589,63024,807
2020-12-26,San Benito,069,59416,3558,3330,29,3359,24
2020-12-26,San Bernardino,071,2135413,197686,185111,5333,190444,1551
2020-12-26,San Diego,073,3302833,157272,142644,7056,149700,1402
2020-12-26,San Francisco,075,870044,23462,22319,212,22531,177
2020-12-26,San Joaquin,077,732212,45282,42887,1531,44418,618
2020-12-26,San Luis Obispo,079,281455,10993,9945,247,10192,76
2020-12-26,San Mateo,081,765935,25147,22908,99,23007,187
2020-12-26,Santa Barbara,083,443738,17307,16159,477,16636,155
2020-12-26,Santa Clara,085,1922200,69877,64185,296,64481,618
2020-12-26,Santa Cruz,087,273765,9179,8113,334,8447,81
2020-12-26,Shasta,089,179085,8106,7641,680,8321,65
2020-12-26,Sierra,091,2930,32,24,3,27,0
2020-12-26,Siskiyou,093,43540,1010,909,99,1008,2
2020-12-26,Solano,095,438530,18876,17528,193,17721,96
2020-12-26,Sonoma,097,501317,19096,18261,105,18366,184
2020-12-26,Stanislaus,099,539301,34612,32678,3088,35766,505
2020-12-26,Sutter,101,95872,6438,6121,44,6165,48
2020-12-26,Tehama,103,63373,3025,2884,280,3164,9
2020-12-26,Trinity,105,12862,412,237,57,294,2
2020-12-26,Tulare,107,460477,33635,31665,3587,35252,398
2020-12-26,Tuolumne,109,53932,2772,2703,11,2714,12
2020-12-26,Ventura,111,848112,39593,36064,1582,37646,230
2020-12-26,Yolo,113,214977,8471,7785,57,7842,111
2020-12-26,Yuba,115,75493,3801,3599,37,3636,18
2020-12-25,Alameda,001,1643700,51346,48365,912,49277,542
2020-12-25,Alpine,003,1148,66,64,0,64,0
2020-12-25,Amador,005,37829,2395,2172,18,2190,23
2020-12-25,Butte,007,227075,7480,6873,815,7688,85
2020-12-25,Calaveras,009,45235,1101,1062,2,1064,21
2020-12-25,Colusa,011,21464,1277,1219,69,1288,7
2020-12-25,Contra Costa,013,1133247,39653,37480,506,37986,324
2020-12-25,Del Norte,015,27424,741,692,2,694,2
2020-12-25,El Dorado,017,186661,6016,5170,262,5432,16
2020-12-25,Fresno,019,978130,67048,62251,4283,66534,679
2020-12-25,Glenn,021,27897,1525,1390,236,1626,9
2020-12-25,Humboldt,023,135768,1690,1532,7,1539,16
2020-12-25,Imperial,025,180216,22649,21646,1170,22816,405
2020-12-25,Inyo,027,18085,654,546,7,553,18
2020-12-25,Kern,029,883053,64758,60417,4568,64985,562
2020-12-25,Kings,031,150075,16162,15460,494,15954,108
2020-12-25,Lake,033,64148,1844,1669,0,1669,20
2020-12-25,Lassen,035,31185,4338,3926,44,3970,1
2020-12-25,Los Angeles,037,10098052,743665,665600,19728,685328,9292
2020-12-25,Madera,039,155013,10484,9770,407,10177,64
2020-12-25,Marin,041,260295,9705,9375,67,9442,143
2020-12-25,Mariposa,043,17540,224,203,2,205,3
2020-12-25,Mendocino,045,87422,2353,2176,20,2196,23
2020-12-25,Merced,047,269075,18550,17726,316,18042,213
2020-12-25,Modoc,049,8938,248,221,72,293,0
2020-12-25,Mono,051,14174,869,843,12,855,3
2020-12-25,Monterey,053,433212,27139,25788,670,26458,182
2020-12-25,Napa,055,140530,5769,5351,26,5377,26
2020-12-25,Nevada,057,99092,2691,2458,86,2544,15
2020-12-25,Orange,059,3164182,157082,144542,5927,150469,1814
2020-12-25,Placer,061,380077,14110,12660,519,13179,122
2020-12-25,Plumas,063,18699,459,381,8,389,0
2020-12-25,Riverside,065,2383286,179414,166690,7748,174438,1825
2020-12-25,Sacramento,067,1510023,64157,61630,563,62193,796
2020-12-25,San Benito,069,59416,3518,3281,27,3308,24
2020-12-25,San Bernardino,071,2135413,195056,181812,5217,187029,1546
2020-12-25,San Diego,073,3302833,154792,139958,6878,146836,1402
2020-12-25,San Francisco,075,870044,23186,22130,207,22337,175
2020-12-25,San Joaquin,077,732212,44975,42089,1476,43565,614
2020-12-25,San Luis Obispo,079,281455,10810,9749,240,9989,76
2020-12-25,San Mateo,081,765935,24825,22568,97,22665,187
2020-12-25,Santa Barbara,083,443738,17083,15936,470,16406,155
2020-12-25,Santa Clara,085,1922200,68762,63173,287,63460,612
2020-12-25,Santa Cruz,087,273765,9035,8018,312,8330,81
2020-12-25,Shasta,089,179085,8032,7612,657,8269,65
2020-12-25,Sierra,091,2930,32,24,3,27,0
2020-12-25,Siskiyou,093,43540,1004,905,96,1001,2
2020-12-25,Solano,095,438530,18704,17280,191,17471,96
2020-12-25,Sonoma,097,501317,18921,18035,103,18138,184
2020-12-25,Stanislaus,099,539301,34310,32290,3037,35327,498
2020-12-25,Sutter,101,95872,6379,6051,43,6094,47
2020-12-25,Tehama,103,63373,2976,2839,267,3106,9
2020-12-25,Trinity,105,12862,408,236,57,293,2
2020-12-25,Tulare,107,460477,33245,31323,3522,34845,398
2020-12-25,Tuolumne,109,53932,2753,2674,11,2685,12
2020-12-25,Ventura,111,848112,38437,35514,1534,37048,230
2020-12-25,Yolo,113,214977,8375,7700,55,7755,111
2020-12-25,Yuba,115,75493,3765,3549,36,3585,17
2020-12-24,Alameda,001,1643700,50997,47527,893,48420,541
2020-12-24,Alpine,003,1148,66,64,0,64,0
2020-12-24,Amador,005,37829,2383,2145,18,2163,23
2020-12-24,Butte,007,227075,7441,6716,800,7516,84
2020-12-24,Calaveras,009,45235,1098,1032,2,1034,21
2020-12-24,Colusa,011,21464,1272,1188,67,1255,7
2020-12-24,Contra Costa,013,1133247,39409,36623,495,37118,311
2020-12-24,Del Norte,015,27424,741,678,2,680,2
2020-12-24,El Dorado,017,186661,5990,5042,254,5296,16
2020-12-24,Fresno,019,978130,66825,61435,4269,65704,663
2020-12-24,Glenn,021,27897,1514,1363,228,1591,9
2020-12-24,Humboldt,023,135768,1667,1516,7,1523,16
2020-12-24,Imperial,025,180216,22599,21545,1161,22706,402
2020-12-24,Inyo,027,18085,652,532,7,539,17
2020-12-24,Kern,029,883053,64471,59601,4555,64156,556
2020-12-24,Kings,031,150075,16122,15211,493,15704,108
2020-12-24,Lake,033,64148,1829,1629,0,1629,20
2020-12-24,Lassen,035,31185,4325,3894,44,3938,1
2020-12-24,Los Angeles,037,10098052,739494,664840,19470,684310,9288
2020-12-24,Madera,039,155013,10444,9547,400,9947,63
2020-12-24,Marin,041,260295,9671,9287,67,9354,143
2020-12-24,Mariposa,043,17540,220,197,2,199,3
2020-12-24,Mendocino,045,87422,2342,2150,20,2170,23
2020-12-24,Merced,047,269075,18479,17485,312,17797,212
2020-12-24,Modoc,049,8938,248,220,71,291,0
2020-12-24,Mono,051,14174,867,817,12,829,3
2020-12-24,Monterey,053,433212,27027,25131,663,25794,180
2020-12-24,Napa,055,140530,5714,5265,26,5291,26
2020-12-24,Nevada,057,99092,2667,2429,86,2515,15
2020-12-24,Orange,059,3164182,155601,141205,5876,147081,1775
2020-12-24,Placer,061,380077,14021,12457,512,12969,121
2020-12-24,Plumas,063,18699,456,376,8,384,0
2020-12-24,Riverside,065,2383286,178480,162435,7708,170143,1816
2020-12-24,Sacramento,067,1510023,63882,60596,561,61157,788
2020-12-24,San Benito,069,59416,3487,3183,27,3210,24
2020-12-24,San Bernardino,071,2135413,194014,176866,5183,182049,1533
2020-12-24,San Diego,073,3302833,153708,136952,6846,143798,1382
2020-12-24,San Francisco,075,870044,23018,21830,204,22034,175
2020-12-24,San Joaquin,077,732212,44811,41324,1458,42782,611
2020-12-24,San Luis Obispo,079,281455,10741,9504,238,9742,77
2020-12-24,San Mateo,081,765935,24629,22093,97,22190,186
2020-12-24,Santa Barbara,083,443738,16978,15644,462,16106,153
2020-12-24,Santa Clara,085,1922200,68155,61742,280,62022,591
2020-12-24,Santa Cruz,087,273765,8964,7856,300,8156,82
2020-12-24,Shasta,089,179085,7991,7540,640,8180,65
2020-12-24,Sierra,091,2930,29,23,1,24,0
2020-12-24,Siskiyou,093,43540,999,900,90,990,2
2020-12-24,Solano,095,438530,18563,16872,186,17058,96
2020-12-24,Sonoma,097,501317,18821,17710,103,17813,183
2020-12-24,Stanislaus,099,539301,34106,31848,3011,34859,498
2020-12-24,Sutter,101,95872,6338,5960,42,6002,47
2020-12-24,Tehama,103,63373,2958,2779,265,3044,9
2020-12-24,Trinity,105,12862,407,235,57,292,2
2020-12-24,Tulare,107,460477,33126,30827,3496,34323,390
2020-12-24,Tuolumne,109,53932,2745,2653,11,2664,12
2020-12-24,Ventura,111,848112,38157,34400,1527,35927,224
2020-12-24,Yolo,113,214977,8333,7566,55,7621,113
2020-12-24,Yuba,115,75493,3740,3483,36,3519,16
2020-12-23,Alameda,001,1643700,50422,46753,867,47620,537
2020-12-23,Alpine,003,1148,66,64,0,64,0
2020-12-23,Amador,005,37829,2314,2108,17,2125,23
2020-12-23,Butte,007,227075,7352,6588,774,7362,84
2020-12-23,Calaveras,009,45235,1090,1002,1,1003,21
2020-12-23,Colusa,011,21464,1261,1167,67,1234,7
2020-12-23,Contra Costa,013,1133247,39009,36190,482,36672,311
2020-12-23,Del Norte,015,27424,734,670,2,672,2
2020-12-23,El Dorado,017,186661,5915,4967,246,5213,14
2020-12-23,Fresno,019,978130,66216,60488,4204,64692,654
2020-12-23,Glenn,021,27897,1500,1349,224,1573,9
2020-12-23,Humboldt,023,135768,1642,1458,7,1465,16
2020-12-23,Imperial,025,180216,22504,21323,1132,22455,399
2020-12-23,Inyo,027,18085,640,517,7,524,17
2020-12-23,Kern,029,883053,63954,58656,4461,63117,549
2020-12-23,Kings,031,150075,16044,14923,490,15413,105
2020-12-23,Lake,033,64148,1815,1595,0,1595,20
2020-12-23,Lassen,035,31185,4315,3865,41,3906,1
2020-12-23,Los Angeles,037,10098052,730436,651958,18938,670896,9146
2020-12-23,Madera,039,155013,10285,9371,386,9757,63
2020-12-23,Marin,041,260295,9613,9199,64,9263,142
2020-12-23,Mariposa,043,17540,218,194,2,196,3
2020-12-23,Mendocino,045,87422,2330,2121,20,2141,23
2020-12-23,Merced,047,269075,18323,17250,304,17554,203
2020-12-23,Modoc,049,8938,244,197,70,267,0
2020-12-23,Mono,051,14174,864,814,12,826,3
2020-12-23,Monterey,053,433212,26727,24856,656,25512,176
2020-12-23,Napa,055,140530,5646,5172,26,5198,25
2020-12-23,Nevada,057,99092,2622,2406,85,2491,15
2020-12-23,Orange,059,3164182,153150,138050,5709,143759,1771
2020-12-23,Placer,061,380077,13811,12213,504,12717,111
2020-12-23,Plumas,063,18699,449,369,8,377,0
2020-12-23,Riverside,065,2383286,176208,158110,7550,165660,1790
2020-12-23,Sacramento,067,1510023,63232,59661,548,60209,779
2020-12-23,San Benito,069,59416,3433,3073,25,3098,24
2020-12-23,San Bernardino,071,2135413,191971,172888,5114,178002,1509
2020-12-23,San Diego,073,3302833,151282,134695,6709,141404,1350
2020-12-23,San Francisco,075,870044,22796,21498,201,21699,174
2020-12-23,San Joaquin,077,732212,44286,35664,1416,37080,602
2020-12-23,San Luis Obispo,079,281455,10599,9267,233,9500,74
2020-12-23,San Mateo,081,765935,24327,21780,95,21875,186
2020-12-23,Santa Barbara,083,443738,16770,15399,436,15835,152
2020-12-23,Santa Clara,085,1922200,67244,60455,275,60730,579
2020-12-23,Santa Cruz,087,273765,8804,7637,282,7919,75
2020-12-23,Shasta,089,179085,7919,7487,634,8121,66
2020-12-23,Sierra,091,2930,27,23,1,24,0
2020-12-23,Siskiyou,093,43540,978,891,89,980,2
2020-12-23,Solano,095,438530,18355,16626,182,16808,95
2020-12-23,Sonoma,097,501317,18617,17397,103,17500,182
2020-12-23,Stanislaus,099,539301,33752,31492,2958,34450,499
2020-12-23,Sutter,101,95872,6272,5871,42,5913,46
2020-12-23,Tehama,103,63373,2940,2737,258,2995,9
2020-12-23,Trinity,105,12862,407,234,56,290,2
2020-12-23,Tulare,107,460477,32834,30315,3457,33772,385
2020-12-23,Tuolumne,109,53932,2706,2540,11,2551,12
2020-12-23,Ventura,111,848112,37760,33377,1498,34875,216
2020-12-23,Yolo,113,214977,8255,7508,55,7563,112
2020-12-23,Yuba,115,75493,3687,3438,36,3474,14
2020-12-22,Alameda,001,1643700,49538,45751,837,46588,534
2020-12-22,Alpine,003,1148,66,64,0,64,0
2020-12-22,Amador,005,37829,2303,1839,17,1856,23
2020-12-22,Butte,007,227075,7224,6467,759,7226,85
2020-12-22,Calaveras,009,45235,1063,988,0,988,21
2020-12-22,Colusa,011,21464,1238,1150,63,1213,7
2020-12-22,Contra Costa,013,1133247,38382,35681,470,36151,301
2020-12-22,Del Norte,015,27424,727,666,2,668,2
2020-12-22,El Dorado,017,186661,5792,4885,234,5119,12
2020-12-22,Fresno,019,978130,65182,59640,4098,63738,640
2020-12-22,Glenn,021,27897,1477,1337,213,1550,9
2020-12-22,Humboldt,023,135768,1609,1440,7,1447,16
2020-12-22,Imperial,025,180216,22316,21128,1088,22216,398
2020-12-22,Inyo,027,18085,620,506,7,513,17
2020-12-22,Kern,029,883053,63002,57816,4324,62140,547
2020-12-22,Kings,031,150075,15902,14855,484,15339,102
2020-12-22,Lake,033,64148,1791,1569,0,1569,20
2020-12-22,Lassen,035,31185,4173,3848,39,3887,1
2020-12-22,Los Angeles,037,10098052,713183,635931,18251,654182,9013
2020-12-22,Madera,039,155013,10167,9187,370,9557,63
2020-12-22,Marin,041,260295,9549,9115,63,9178,142
2020-12-22,Mariposa,043,17540,215,194,2,196,3
2020-12-22,Mendocino,045,87422,2297,2092,20,2112,23
2020-12-22,Merced,047,269075,18077,17012,299,17311,201
2020-12-22,Modoc,049,8938,236,182,69,251,0
2020-12-22,Mono,051,14174,858,786,12,798,3
2020-12-22,Monterey,053,433212,26057,24152,635,24787,176
2020-12-22,Napa,055,140530,5557,5059,26,5085,23
2020-12-22,Nevada,057,99092,2594,2367,84,2451,14
2020-12-22,Orange,059,3164182,149808,134850,5536,140386,1774
2020-12-22,Placer,061,380077,13567,11943,484,12427,105
2020-12-22,Plumas,063,18699,443,360,8,368,0
2020-12-22,Riverside,065,2383286,172396,155059,7281,162340,1777
2020-12-22,Sacramento,067,1510023,62304,57966,529,58495,772
2020-12-22,San Benito,069,59416,3355,2998,25,3023,24
2020-12-22,San Bernardino,071,2135413,187387,169266,4966,174232,1500
2020-12-22,San Diego,073,3302833,147923,132097,6547,138644,1311
2020-12-22,San Francisco,075,870044,22526,21232,197,21429,174
2020-12-22,San Joaquin,077,732212,43527,39423,1367,40790,592
2020-12-22,San Luis Obispo,079,281455,10254,9174,228,9402,69
2020-12-22,San Mateo,081,765935,24001,21382,79,21461,186
2020-12-22,Santa Barbara,083,443738,16505,15189,426,15615,150
2020-12-22,Santa Clara,085,1922200,66077,59192,267,59459,569
2020-12-22,Santa Cruz,087,273765,8625,7471,256,7727,72
2020-12-22,Shasta,089,179085,7840,7371,617,7988,64
2020-12-22,Sierra,091,2930,27,23,0,23,0
2020-12-22,Siskiyou,093,43540,972,880,88,968,2
2020-12-22,Solano,095,438530,17952,16229,179,16408,95
2020-12-22,Sonoma,097,501317,18297,17216,103,17319,180
2020-12-22,Stanislaus,099,539301,33368,30914,2886,33800,499
2020-12-22,Sutter,101,95872,6213,5791,41,5832,46
2020-12-22,Tehama,103,63373,2890,2688,252,2940,9
2020-12-22,Trinity,105,12862,406,231,56,287,2
2020-12-22,Tulare,107,460477,32369,30025,3390,33415,377
2020-12-22,Tuolumne,109,53932,2655,2526,11,2537,12
2020-12-22,Ventura,111,848112,36995,32488,1455,33943,213
2020-12-22,Yolo,113,214977,8142,7388,54,7442,113
2020-12-22,Yuba,115,75493,3636,3379,36,3415,14
2020-12-21,Alameda,001,1643700,48637,44756,810,45566,518
2020-12-21,Alpine,003,1148,65,64,0,64,0
2020-12-21,Amador,005,37829,2226,1815,17,1832,23
2020-12-21,Butte,007,227075,7069,6335,735,7070,81
2020-12-21,Calaveras,009,45235,1033,963,0,963,21
2020-12-21,Colusa,011,21464,1211,1135,58,1193,7
2020-12-21,Contra Costa,013,1133247,37630,35207,433,35640,300
2020-12-21,Del Norte,015,27424,712,660,2,662,2
2020-12-21,El Dorado,017,186661,5645,4805,221,5026,10
2020-12-21,Fresno,019,978130,64030,58568,3955,62523,634
2020-12-21,Glenn,021,27897,1445,1323,205,1528,9
2020-12-21,Humboldt,023,135768,1586,1419,7,1426,16
2020-12-21,Imperial,025,180216,22046,20994,1045,22039,395
2020-12-21,Inyo,027,18085,599,482,7,489,17
2020-12-21,Kern,029,883053,62112,56836,4187,61023,541
2020-12-21,Kings,031,150075,15652,14760,469,15229,100
2020-12-21,Lake,033,64148,1737,1538,0,1538,20
2020-12-21,Lassen,035,31185,4013,3798,37,3835,1
2020-12-21,Los Angeles,037,10098052,694102,624129,17572,641701,8918
2020-12-21,Madera,039,155013,9973,9069,350,9419,63
2020-12-21,Marin,041,260295,9480,9035,63,9098,142
2020-12-21,Mariposa,043,17540,210,186,2,188,3
2020-12-21,Mendocino,045,87422,2266,2066,20,2086,23
2020-12-21,Merced,047,269075,17827,16710,283,16993,198
2020-12-21,Modoc,049,8938,222,181,68,249,0
2020-12-21,Mono,051,14174,846,781,12,793,3
2020-12-21,Monterey,053,433212,25525,23673,621,24294,174
2020-12-21,Napa,055,140530,5470,4952,26,4978,23
2020-12-21,Nevada,057,99092,2561,2337,84,2421,13
2020-12-21,Orange,059,3164182,146396,130444,5382,135826,1772
2020-12-21,Placer,061,380077,13335,11715,465,12180,105
2020-12-21,Plumas,063,18699,439,353,8,361,0
2020-12-21,Riverside,065,2383286,168169,151713,6956,158669,1743
2020-12-21,Sacramento,067,1510023,61283,57064,512,57576,759
2020-12-21,San Benito,069,59416,3287,2921,25,2946,22
2020-12-21,San Bernardino,071,2135413,182597,165086,4801,169887,1476
2020-12-21,San Diego,073,3302833,144472,129716,6383,136099,1284
2020-12-21,San Francisco,075,870044,22240,21086,195,21281,174
2020-12-21,San Joaquin,077,732212,42731,38811,1316,40127,586
2020-12-21,San Luis Obispo,079,281455,10065,9006,223,9229,64
2020-12-21,San Mateo,081,765935,23596,21035,76,21111,185
2020-12-21,Santa Barbara,083,443738,16231,14988,421,15409,149
2020-12-21,Santa Clara,085,1922200,64883,57699,255,57954,570
2020-12-21,Santa Cruz,087,273765,8413,7315,243,7558,69
2020-12-21,Shasta,089,179085,7775,7299,607,7906,64
2020-12-21,Sierra,091,2930,24,23,0,23,0
2020-12-21,Siskiyou,093,43540,964,878,87,965,2
2020-12-21,Solano,095,438530,17482,15878,174,16052,95
2020-12-21,Sonoma,097,501317,18024,17075,99,17174,176
2020-12-21,Stanislaus,099,539301,32910,30437,2811,33248,499
2020-12-21,Sutter,101,95872,6118,5708,41,5749,46
2020-12-21,Tehama,103,63373,2825,2656,243,2899,9
2020-12-21,Trinity,105,12862,404,226,54,280,2
2020-12-21,Tulare,107,460477,31870,29482,3301,32783,373
2020-12-21,Tuolumne,109,53932,2630,2423,9,2432,12
2020-12-21,Ventura,111,848112,35915,31759,1418,33177,212
2020-12-21,Yolo,113,214977,7997,7266,50,7316,109
2020-12-21,Yuba,115,75493,3577,3329,36,3365,14
2020-12-20,Alameda,001,1643700,47758,44004,787,44791,516
2020-12-20,Alpine,003,1148,65,64,0,64,0
2020-12-20,Amador,005,37829,2168,1771,17,1788,23
2020-12-20,Butte,007,227075,6924,6228,699,6927,81
2020-12-20,Calaveras,009,45235,1009,926,0,926,21
2020-12-20,Colusa,011,21464,1183,1121,52,1173,7
2020-12-20,Contra Costa,013,1133247,37044,34798,416,35214,301
2020-12-20,Del Norte,015,27424,690,652,2,654,2
2020-12-20,El Dorado,017,186661,5520,4697,212,4909,10
2020-12-20,Fresno,019,978130,63039,57616,3818,61434,634
2020-12-20,Glenn,021,27897,1436,1295,198,1493,9
2020-12-20,Humboldt,023,135768,1549,1386,6,1392,15
2020-12-20,Imperial,025,180216,21804,20882,939,21821,395
2020-12-20,Inyo,027,18085,584,476,7,483,17
2020-12-20,Kern,029,883053,61014,55983,4032,60015,540
2020-12-20,Kings,031,150075,15432,14629,452,15081,100
2020-12-20,Lake,033,64148,1691,1463,0,1463,20
2020-12-20,Lassen,035,31185,3959,3669,35,3704,1
2020-12-20,Los Angeles,037,10098052,676019,612975,16831,629806,8862
2020-12-20,Madera,039,155013,9763,8871,341,9212,63
2020-12-20,Marin,041,260295,9382,8948,60,9008,142
2020-12-20,Mariposa,043,17540,209,179,2,181,3
2020-12-20,Mendocino,045,87422,2241,2033,20,2053,23
2020-12-20,Merced,047,269075,17511,16435,276,16711,198
2020-12-20,Modoc,049,8938,222,181,66,247,0
2020-12-20,Mono,051,14174,828,774,12,786,3
2020-12-20,Monterey,053,433212,25042,23250,580,23830,173
2020-12-20,Napa,055,140530,5349,4865,24,4889,23
2020-12-20,Nevada,057,99092,2515,2289,78,2367,13
2020-12-20,Orange,059,3164182,142892,128780,5233,134013,1763
2020-12-20,Placer,061,380077,13110,11496,446,11942,105
2020-12-20,Plumas,063,18699,431,347,8,355,0
2020-12-20,Riverside,065,2383286,163964,148714,6664,155378,1742
2020-12-20,Sacramento,067,1510023,60282,56017,492,56509,755
2020-12-20,San Benito,069,59416,3215,2885,24,2909,21
2020-12-20,San Bernardino,071,2135413,177608,162810,4643,167453,1458
2020-12-20,San Diego,073,3302833,140754,126465,6213,132678,1280
2020-12-20,San Francisco,075,870044,21925,20937,192,21129,174
2020-12-20,San Joaquin,077,732212,41889,38268,1255,39523,587
2020-12-20,San Luis Obispo,079,281455,9773,8881,217,9098,63
2020-12-20,San Mateo,081,765935,23162,20764,72,20836,185
2020-12-20,Santa Barbara,083,443738,15909,14817,401,15218,148
2020-12-20,Santa Clara,085,1922200,63473,56860,249,57109,566
2020-12-20,Santa Cruz,087,273765,8205,7178,230,7408,69
2020-12-20,Shasta,089,179085,7661,7256,593,7849,64
2020-12-20,Sierra,091,2930,24,22,0,22,0
2020-12-20,Siskiyou,093,43540,954,870,86,956,2
2020-12-20,Solano,095,438530,17104,15533,163,15696,95
2020-12-20,Sonoma,097,501317,17748,16802,98,16900,175
2020-12-20,Stanislaus,099,539301,32383,29995,2709,32704,498
2020-12-20,Sutter,101,95872,6031,5601,41,5642,43
2020-12-20,Tehama,103,63373,2775,2602,224,2826,9
2020-12-20,Trinity,105,12862,396,221,53,274,2
2020-12-20,Tulare,107,460477,31353,29078,3205,32283,373
2020-12-20,Tuolumne,109,53932,2520,2152,8,2160,12
2020-12-20,Ventura,111,848112,35213,31335,1385,32720,210
2020-12-20,Yolo,113,214977,7845,7121,47,7168,109
2020-12-20,Yuba,115,75493,3530,3254,34,3288,12
2020-12-19,Alameda,001,1643700,47311,43109,780,43889,516
2020-12-19,Alpine,003,1148,65,64,0,64,0
2020-12-19,Amador,005,37829,2144,1754,17,1771,23
2020-12-19,Butte,007,227075,6824,6118,676,6794,81
2020-12-19,Calaveras,009,45235,992,900,0,900,21
2020-12-19,Colusa,011,21464,1175,1096,50,1146,7
2020-12-19,Contra Costa,013,1133247,36730,34321,402,34723,301
2020-12-19,Del Norte,015,27424,688,641,1,642,2
2020-12-19,El Dorado,017,186661,5453,4588,204,4792,10
2020-12-19,Fresno,019,978130,62714,55428,3750,59178,634
2020-12-19,Glenn,021,27897,1401,1286,197,1483,9
2020-12-19,Humboldt,023,135768,1532,1357,6,1363,15
2020-12-19,Imperial,025,180216,21714,20711,893,21604,395
2020-12-19,Inyo,027,18085,577,475,7,482,17
2020-12-19,Kern,029,883053,60529,55118,3925,59043,540
2020-12-19,Kings,031,150075,15353,14474,450,14924,100
2020-12-19,Lake,033,64148,1656,1438,0,1438,20
2020-12-19,Lassen,035,31185,3931,3595,35,3630,1
2020-12-19,Los Angeles,037,10098052,668918,599888,16295,616183,8804
2020-12-19,Madera,039,155013,9671,8717,329,9046,63
2020-12-19,Marin,041,260295,9342,8864,60,8924,142
2020-12-19,Mariposa,043,17540,207,177,2,179,3
2020-12-19,Mendocino,045,87422,2216,2008,20,2028,23
2020-12-19,Merced,047,269075,17372,16230,268,16498,198
2020-12-19,Modoc,049,8938,219,181,66,247,0
2020-12-19,Mono,051,14174,821,766,12,778,3
2020-12-19,Monterey,053,433212,24927,22799,574,23373,172
2020-12-19,Napa,055,140530,5287,4772,24,4796,23
2020-12-19,Nevada,057,99092,2493,2260,78,2338,13
2020-12-19,Orange,059,3164182,140971,125574,5082,130656,1733
2020-12-19,Placer,061,380077,12955,11246,440,11686,105
2020-12-19,Plumas,063,18699,428,343,8,351,0
2020-12-19,Riverside,065,2383286,161977,146703,6428,153131,1737
2020-12-19,Sacramento,067,1510023,59750,55169,478,55647,746
2020-12-19,San Benito,069,59416,3169,2820,23,2843,21
2020-12-19,San Bernardino,071,2135413,176039,159883,4536,164419,1433
2020-12-19,San Diego,073,3302833,138987,122972,6074,129046,1280
2020-12-19,San Francisco,075,870044,21774,20643,192,20835,174
2020-12-19,San Joaquin,077,732212,41487,37340,1205,38545,586
2020-12-19,San Luis Obispo,079,281455,9702,8788,214,9002,63
2020-12-19,San Mateo,081,765935,22952,20393,65,20458,182
2020-12-19,Santa Barbara,083,443738,15753,14667,395,15062,148
2020-12-19,Santa Clara,085,1922200,62662,55540,245,55785,558
2020-12-19,Santa Cruz,087,273765,8101,7054,225,7279,68
2020-12-19,Shasta,089,179085,7609,7221,581,7802,63
2020-12-19,Sierra,091,2930,24,23,0,23,0
2020-12-19,Siskiyou,093,43540,950,853,85,938,2
2020-12-19,Solano,095,438530,16938,15204,159,15363,95
2020-12-19,Sonoma,097,501317,17639,16553,98,16651,175
2020-12-19,Stanislaus,099,539301,32064,29555,2636,32191,498
2020-12-19,Sutter,101,95872,5974,5506,41,5547,41
2020-12-19,Tehama,103,63373,2725,2574,222,2796,9
2020-12-19,Trinity,105,12862,395,219,53,272,2
2020-12-19,Tulare,107,460477,31131,28734,3139,31873,375
2020-12-19,Tuolumne,109,53932,2507,2107,8,2115,12
2020-12-19,Ventura,111,848112,34932,30843,1355,32198,209
2020-12-19,Yolo,113,214977,7776,7025,46,7071,109
2020-12-19,Yuba,115,75493,3498,3168,34,3202,11
2020-12-18,Alameda,001,1643700,46775,42196,763,42959,515
2020-12-18,Alpine,003,1148,65,64,0,64,0
2020-12-18,Amador,005,37829,2127,1727,15,1742,20
2020-12-18,Butte,007,227075,6739,5891,650,6541,81
2020-12-18,Calaveras,009,45235,982,870,0,870,21
2020-12-18,Colusa,011,21464,1166,1068,50,1118,7
2020-12-18,Contra Costa,013,1133247,36446,33610,390,34000,300
2020-12-18,Del Norte,015,27424,683,627,0,627,2
2020-12-18,El Dorado,017,186661,5391,4494,195,4689,10
2020-12-18,Fresno,019,978130,61887,52643,3686,56329,613
2020-12-18,Glenn,021,27897,1384,1264,192,1456,9
2020-12-18,Humboldt,023,135768,1517,1331,6,1337,15
2020-12-18,Imperial,025,180216,21636,20430,846,21276,393
2020-12-18,Inyo,027,18085,557,454,7,461,17
2020-12-18,Kern,029,883053,59868,54220,3840,58060,533
2020-12-18,Kings,031,150075,15227,14284,444,14728,98
2020-12-18,Lake,033,64148,1645,1397,0,1397,20
2020-12-18,Lassen,035,31185,3923,3486,35,3521,1
2020-12-18,Los Angeles,037,10098052,656778,586413,15794,602207,8744
2020-12-18,Madera,039,155013,9569,8609,324,8933,63
2020-12-18,Marin,041,260295,9258,8799,60,8859,142
2020-12-18,Mariposa,043,17540,204,176,2,178,3
2020-12-18,Mendocino,045,87422,2198,1977,20,1997,24
2020-12-18,Merced,047,269075,17291,15956,265,16221,195
2020-12-18,Modoc,049,8938,219,179,66,245,0
2020-12-18,Mono,051,14174,813,731,12,743,3
2020-12-18,Monterey,053,433212,24633,22336,568,22904,165
2020-12-18,Napa,055,140530,5238,4688,24,4712,23
2020-12-18,Nevada,057,99092,2476,2220,77,2297,13
2020-12-18,Orange,059,3164182,138535,121681,4933,126614,1725
2020-12-18,Placer,061,380077,12784,10995,431,11426,104
2020-12-18,Plumas,063,18699,422,336,8,344,0
2020-12-18,Riverside,065,2383286,159137,142375,6159,148534,1733
2020-12-18,Sacramento,067,1510023,59124,53980,462,54442,736
2020-12-18,San Benito,069,59416,3120,2744,23,2767,21
2020-12-18,San Bernardino,071,2135413,173740,154272,4402,158674,1430
2020-12-18,San Diego,073,3302833,136809,120463,5935,126398,1253
2020-12-18,San Francisco,075,870044,21607,20315,186,20501,173
2020-12-18,San Joaquin,077,732212,41128,36484,1174,37658,559
2020-12-18,San Luis Obispo,079,281455,9604,8598,209,8807,62
2020-12-18,San Mateo,081,765935,22639,19971,61,20032,182
2020-12-18,Santa Barbara,083,443738,15612,14361,382,14743,148
2020-12-18,Santa Clara,085,1922200,61789,53992,236,54228,539
2020-12-18,Santa Cruz,087,273765,7985,6838,217,7055,68
2020-12-18,Shasta,089,179085,7571,7114,570,7684,62
2020-12-18,Sierra,091,2930,24,23,0,23,0
2020-12-18,Siskiyou,093,43540,948,840,85,925,2
2020-12-18,Solano,095,438530,16785,14667,155,14822,95
2020-12-18,Sonoma,097,501317,17520,16261,98,16359,173
2020-12-18,Stanislaus,099,539301,31790,28967,2600,31567,490
2020-12-18,Sutter,101,95872,5890,5399,41,5440,39
2020-12-18,Tehama,103,63373,2710,2523,212,2735,9
2020-12-18,Trinity,105,12862,394,215,53,268,2
2020-12-18,Tulare,107,460477,30854,28322,3060,31382,370
2020-12-18,Tuolumne,109,53932,2496,2067,8,2075,12
2020-12-18,Ventura,111,848112,34428,29907,1312,31219,209
2020-12-18,Yolo,113,214977,7708,6901,45,6946,109
2020-12-18,Yuba,115,75493,3440,3097,34,3131,11
2020-12-17,Alameda,001,1643700,45966,41548,730,42278,508
2020-12-17,Alpine,003,1148,65,64,0,64,0
2020-12-17,Amador,005,37829,2079,1703,13,1716,19
2020-12-17,Butte,007,227075,6613,5746,632,6378,78
2020-12-17,Calaveras,009,45235,959,848,0,848,21
2020-12-17,Colusa,011,21464,1155,1053,48,1101,7
2020-12-17,Contra Costa,013,1133247,35922,33006,356,33362,293
2020-12-17,Del Norte,015,27424,678,583,0,583,1
2020-12-17,El Dorado,017,186661,5246,4327,183,4510,9
2020-12-17,Fresno,019,978130,61024,49918,3560,53478,597
2020-12-17,Glenn,021,27897,1360,1244,185,1429,9
2020-12-17,Humboldt,023,135768,1484,1322,6,1328,14
2020-12-17,Imperial,025,180216,21471,20208,777,20985,391
2020-12-17,Inyo,027,18085,539,450,6,456,16
2020-12-17,Kern,029,883053,58911,53683,3707,57390,526
2020-12-17,Kings,031,150075,15124,14057,429,14486,98
2020-12-17,Lake,033,64148,1620,1374,0,1374,20
2020-12-17,Lassen,035,31185,3887,3417,35,3452,1
2020-12-17,Los Angeles,037,10098052,641123,571093,15241,586334,8657
2020-12-17,Madera,039,155013,9452,8465,320,8785,62
2020-12-17,Marin,041,260295,9194,8721,58,8779,142
2020-12-17,Mariposa,043,17540,200,172,2,174,3
2020-12-17,Mendocino,045,87422,2164,1942,20,1962,23
2020-12-17,Merced,047,269075,17027,15648,257,15905,192
2020-12-17,Modoc,049,8938,216,179,66,245,0
2020-12-17,Mono,051,14174,800,718,12,730,3
2020-12-17,Monterey,053,433212,24114,21951,553,22504,163
2020-12-17,Napa,055,140530,5126,4612,24,4636,23
2020-12-17,Nevada,057,99092,2435,2173,74,2247,13
2020-12-17,Orange,059,3164182,135154,118367,4797,123164,1725
2020-12-17,Placer,061,380077,12510,10756,417,11173,99
2020-12-17,Plumas,063,18699,413,324,8,332,0
2020-12-17,Riverside,065,2383286,155252,139325,5944,145269,1696
2020-12-17,Sacramento,067,1510023,58218,53189,440,53629,721
2020-12-17,San Benito,069,59416,3051,2645,22,2667,20
2020-12-17,San Bernardino,071,2135413,169800,149838,4285,154123,1425
2020-12-17,San Diego,073,3302833,134008,116852,5779,122631,1239
2020-12-17,San Francisco,075,870044,21320,19939,181,20120,170
2020-12-17,San Joaquin,077,732212,40402,35894,1138,37032,554
2020-12-17,San Luis Obispo,079,281455,9484,8365,207,8572,59
2020-12-17,San Mateo,081,765935,22269,19647,61,19708,181
2020-12-17,Santa Barbara,083,443738,15379,14207,375,14582,147
2020-12-17,Santa Clara,085,1922200,60621,52559,230,52789,527
2020-12-17,Santa Cruz,087,273765,7830,6687,204,6891,64
2020-12-17,Shasta,089,179085,7494,7000,551,7551,62
2020-12-17,Sierra,091,2930,23,23,0,23,0
2020-12-17,Siskiyou,093,43540,941,827,84,911,2
2020-12-17,Solano,095,438530,16479,14361,153,14514,96
2020-12-17,Sonoma,097,501317,17248,15993,97,16090,171
2020-12-17,Stanislaus,099,539301,31365,28582,2541,31123,489
2020-12-17,Sutter,101,95872,5791,5309,40,5349,39
2020-12-17,Tehama,103,63373,2662,2480,206,2686,9
2020-12-17,Trinity,105,12862,389,213,53,266,2
2020-12-17,Tulare,107,460477,30460,27852,2982,30834,358
2020-12-17,Tuolumne,109,53932,2205,1992,8,2000,11
2020-12-17,Ventura,111,848112,33818,29404,1275,30679,208
2020-12-17,Yolo,113,214977,7583,6800,44,6844,105
2020-12-17,Yuba,115,75493,3381,3035,32,3067,12
2020-12-16,Alameda,001,1643700,45113,40751,705,41456,497
2020-12-16,Alpine,003,1148,65,64,0,64,0
2020-12-16,Amador,005,37829,2032,1693,12,1705,19
2020-12-16,Butte,007,227075,6424,5659,604,6263,76
2020-12-16,Calaveras,009,45235,924,821,0,821,21
2020-12-16,Colusa,011,21464,1142,1038,44,1082,7
2020-12-16,Contra Costa,013,1133247,35365,32429,336,32765,293
2020-12-16,Del Norte,015,27424,676,575,0,575,1
2020-12-16,El Dorado,017,186661,5125,4237,174,4411,9
2020-12-16,Fresno,019,978130,60066,49173,3464,52637,584
2020-12-16,Glenn,021,27897,1342,1236,174,1410,9
2020-12-16,Humboldt,023,135768,1452,1308,5,1313,12
2020-12-16,Imperial,025,180216,21287,19980,711,20691,388
2020-12-16,Inyo,027,18085,526,444,6,450,16
2020-12-16,Kern,029,883053,58034,52896,3575,56471,522
2020-12-16,Kings,031,150075,14944,13734,412,14146,99
2020-12-16,Lake,033,64148,1580,1363,0,1363,20
2020-12-16,Lassen,035,31185,3854,3396,34,3430,1
2020-12-16,Los Angeles,037,10098052,624600,557907,14553,572460,8561
2020-12-16,Madera,039,155013,9327,8278,312,8590,62
2020-12-16,Marin,041,260295,9123,8641,58,8699,142
2020-12-16,Mariposa,043,17540,197,175,2,177,3
2020-12-16,Mendocino,045,87422,2129,1929,20,1949,23
2020-12-16,Merced,047,269075,16741,15443,253,15696,190
2020-12-16,Modoc,049,8938,213,178,66,244,0
2020-12-16,Mono,051,14174,781,702,12,714,3
2020-12-16,Monterey,053,433212,23555,21107,542,21649,163
2020-12-16,Napa,055,140530,5029,4544,24,4568,23
2020-12-16,Nevada,057,99092,2399,2149,72,2221,13
2020-12-16,Orange,059,3164182,131676,115260,4630,119890,1712
2020-12-16,Placer,061,380077,12273,10554,396,10950,96
2020-12-16,Plumas,063,18699,404,319,8,327,0
2020-12-16,Riverside,065,2383286,151128,135751,5695,141446,1664
2020-12-16,Sacramento,067,1510023,57244,52166,415,52581,715
2020-12-16,San Benito,069,59416,2960,2582,22,2604,20
2020-12-16,San Bernardino,071,2135413,165193,143565,4150,147715,1403
2020-12-16,San Diego,073,3302833,130904,114248,5625,119873,1217
2020-12-16,San Francisco,075,870044,21061,19624,181,19805,170
2020-12-16,San Joaquin,077,732212,39576,35010,1098,36108,547
2020-12-16,San Luis Obispo,079,281455,9289,8252,198,8450,58
2020-12-16,San Mateo,081,765935,21943,19292,57,19349,179
2020-12-16,Santa Barbara,083,443738,15128,13966,363,14329,144
2020-12-16,Santa Clara,085,1922200,59378,51502,227,51729,523
2020-12-16,Santa Cruz,087,273765,7646,6536,193,6729,63
2020-12-16,Shasta,089,179085,7421,6914,529,7443,62
2020-12-16,Sierra,091,2930,23,23,0,23,0
2020-12-16,Siskiyou,093,43540,933,818,84,902,2
2020-12-16,Solano,095,438530,16012,14157,149,14306,96
2020-12-16,Sonoma,097,501317,16992,15768,97,15865,170
2020-12-16,Stanislaus,099,539301,30864,28279,2468,30747,489
2020-12-16,Sutter,101,95872,5711,5223,40,5263,39
2020-12-16,Tehama,103,63373,2629,2441,180,2621,9
2020-12-16,Trinity,105,12862,383,212,53,265,2
2020-12-16,Tulare,107,460477,30037,27500,2882,30382,352
2020-12-16,Tuolumne,109,53932,2162,1941,8,1949,11
2020-12-16,Ventura,111,848112,33044,28566,1232,29798,203
2020-12-16,Yolo,113,214977,7455,6649,43,6692,103
2020-12-16,Yuba,115,75493,3295,2980,31,3011,11
2020-12-15,Alameda,001,1643700,44257,40026,683,40709,492
2020-12-15,Alpine,003,1148,65,64,0,64,0
2020-12-15,Amador,005,37829,1919,1669,10,1679,19
2020-12-15,Butte,007,227075,6286,5565,575,6140,75
2020-12-15,Calaveras,009,45235,892,799,0,799,21
2020-12-15,Colusa,011,21464,1129,1026,43,1069,7
2020-12-15,Contra Costa,013,1133247,34707,31423,322,31745,281
2020-12-15,Del Norte,015,27424,665,564,0,564,1
2020-12-15,El Dorado,017,186661,5017,4113,160,4273,9
2020-12-15,Fresno,019,978130,58693,47316,3330,50646,574
2020-12-15,Glenn,021,27897,1329,1207,158,1365,9
2020-12-15,Humboldt,023,135768,1432,1276,5,1281,12
2020-12-15,Imperial,025,180216,21065,19756,631,20387,380
2020-12-15,Inyo,027,18085,513,394,6,400,16
2020-12-15,Kern,029,883053,57022,52002,3472,55474,511
2020-12-15,Kings,031,150075,14780,13652,393,14045,97
2020-12-15,Lake,033,64148,1555,1341,0,1341,21
2020-12-15,Lassen,035,31185,3682,3378,33,3411,1
2020-12-15,Los Angeles,037,10098052,608225,536258,13909,550167,8429
2020-12-15,Madera,039,155013,9173,8118,305,8423,60
2020-12-15,Marin,041,260295,9015,8528,56,8584,141
2020-12-15,Mariposa,043,17540,193,171,2,173,3
2020-12-15,Mendocino,045,87422,2102,1883,20,1903,24
2020-12-15,Merced,047,269075,16443,15120,249,15369,190
2020-12-15,Modoc,049,8938,211,179,66,245,0
2020-12-15,Mono,051,14174,765,702,12,714,3
2020-12-15,Monterey,053,433212,22957,19905,481,20386,161
2020-12-15,Napa,055,140530,4926,4440,24,4464,23
2020-12-15,Nevada,057,99092,2366,2117,70,2187,11
2020-12-15,Orange,059,3164182,128021,112893,4477,117370,1689
2020-12-15,Placer,061,380077,12039,10301,374,10675,95
2020-12-15,Plumas,063,18699,399,313,8,321,0
2020-12-15,Riverside,065,2383286,147070,131822,5416,137238,1624
2020-12-15,Sacramento,067,1510023,56227,51076,402,51478,703
2020-12-15,San Benito,069,59416,2881,2520,21,2541,19
2020-12-15,San Bernardino,071,2135413,160734,137548,3999,141547,1351
2020-12-15,San Diego,073,3302833,127338,111441,5462,116903,1194
2020-12-15,San Francisco,075,870044,20751,19283,178,19461,171
2020-12-15,San Joaquin,077,732212,38652,33849,1061,34910,537
2020-12-15,San Luis Obispo,079,281455,9180,8074,195,8269,55
2020-12-15,San Mateo,081,765935,21533,18907,55,18962,178
2020-12-15,Santa Barbara,083,443738,14901,13782,355,14137,144
2020-12-15,Santa Clara,085,1922200,57943,50311,224,50535,505
2020-12-15,Santa Cruz,087,273765,7461,6361,179,6540,59
2020-12-15,Shasta,089,179085,7362,6794,504,7298,54
2020-12-15,Sierra,091,2930,23,23,0,23,0
2020-12-15,Siskiyou,093,43540,924,812,83,895,2
2020-12-15,Solano,095,438530,15662,13796,149,13945,95
2020-12-15,Sonoma,097,501317,16771,15406,97,15503,167
2020-12-15,Stanislaus,099,539301,30351,27823,2387,30210,485
2020-12-15,Sutter,101,95872,5613,5080,39,5119,36
2020-12-15,Tehama,103,63373,2591,2392,175,2567,9
2020-12-15,Trinity,105,12862,375,213,51,264,1
2020-12-15,Tulare,107,460477,29548,27026,2792,29818,342
2020-12-15,Tuolumne,109,53932,2132,1874,8,1882,8
2020-12-15,Ventura,111,848112,32422,27936,1185,29121,201
2020-12-15,Yolo,113,214977,7332,6531,41,6572,104
2020-12-15,Yuba,115,75493,3201,2891,30,2921,11
2020-12-14,Alameda,001,1643700,43358,39252,664,39916,487
2020-12-14,Alpine,003,1148,65,63,0,63,0
2020-12-14,Amador,005,37829,1847,1609,10,1619,19
2020-12-14,Butte,007,227075,6118,5202,558,5760,75
2020-12-14,Calaveras,009,45235,854,718,0,718,21
2020-12-14,Colusa,011,21464,1105,949,42,991,7
2020-12-14,Contra Costa,013,1133247,34008,30594,308,30902,281
2020-12-14,Del Norte,015,27424,659,560,0,560,1
2020-12-14,El Dorado,017,186661,4861,4018,144,4162,9
2020-12-14,Fresno,019,978130,57669,44726,3150,47876,560
2020-12-14,Glenn,021,27897,1303,1186,150,1336,9
2020-12-14,Humboldt,023,135768,1419,1256,5,1261,9
2020-12-14,Imperial,025,180216,20827,19608,553,20161,379
2020-12-14,Inyo,027,18085,499,382,6,388,16
2020-12-14,Kern,029,883053,55985,50538,3351,53889,510
2020-12-14,Kings,031,150075,14595,13491,366,13857,97
2020-12-14,Lake,033,64148,1506,1301,0,1301,21
2020-12-14,Lassen,035,31185,3584,2905,30,2935,1
2020-12-14,Los Angeles,037,10098052,590602,524668,13264,537932,8340
2020-12-14,Madera,039,155013,8906,8011,296,8307,60
2020-12-14,Marin,041,260295,8932,8475,55,8530,141
2020-12-14,Mariposa,043,17540,192,171,2,173,3
2020-12-14,Mendocino,045,87422,2081,1845,20,1865,24
2020-12-14,Merced,047,269075,16035,14572,235,14807,189
2020-12-14,Modoc,049,8938,205,180,64,244,0
2020-12-14,Mono,051,14174,757,685,12,697,3
2020-12-14,Monterey,053,433212,22435,19154,475,19629,155
2020-12-14,Napa,055,140530,4833,4289,24,4313,22
2020-12-14,Nevada,057,99092,2327,2070,67,2137,11
2020-12-14,Orange,059,3164182,124131,108602,4341,112943,1688
2020-12-14,Placer,061,380077,11758,9551,363,9914,95
2020-12-14,Plumas,063,18699,387,309,8,317,0
2020-12-14,Riverside,065,2383286,142940,123715,5154,128869,1588
2020-12-14,Sacramento,067,1510023,55120,50304,377,50681,691
2020-12-14,San Benito,069,59416,2815,2467,20,2487,19
2020-12-14,San Bernardino,071,2135413,156287,129151,3871,133022,1347
2020-12-14,San Diego,073,3302833,123602,109578,5277,114855,1162
2020-12-14,San Francisco,075,870044,20374,18904,176,19080,171
2020-12-14,San Joaquin,077,732212,37808,32522,1015,33537,534
2020-12-14,San Luis Obispo,079,281455,8934,7791,191,7982,52
2020-12-14,San Mateo,081,765935,21035,18361,52,18413,178
2020-12-14,Santa Barbara,083,443738,14628,13587,347,13934,144
2020-12-14,Santa Clara,085,1922200,56381,49180,212,49392,502
2020-12-14,Santa Cruz,087,273765,7275,6049,164,6213,54
2020-12-14,Shasta,089,179085,7273,6665,485,7150,54
2020-12-14,Sierra,091,2930,23,21,0,21,0
2020-12-14,Siskiyou,093,43540,901,764,77,841,2
2020-12-14,Solano,095,438530,15300,13352,148,13500,93
2020-12-14,Sonoma,097,501317,16464,14807,96,14903,167
2020-12-14,Stanislaus,099,539301,29817,27311,2338,29649,485
2020-12-14,Sutter,101,95872,5509,5001,32,5033,35
2020-12-14,Tehama,103,63373,2548,2344,172,2516,9
2020-12-14,Trinity,105,12862,371,205,49,254,1
2020-12-14,Tulare,107,460477,29075,25735,2701,28436,341
2020-12-14,Tuolumne,109,53932,2079,1647,8,1655,8
2020-12-14,Ventura,111,848112,31499,27436,1126,28562,202
2020-12-14,Yolo,113,214977,7171,6389,40,6429,95
2020-12-14,Yuba,115,75493,3139,2851,30,2881,11
2020-12-13,Alameda,001,1643700,42161,38064,638,38702,486
2020-12-13,Alpine,003,1148,65,63,0,63,0
2020-12-13,Amador,005,37829,1791,1457,9,1466,19
2020-12-13,Butte,007,227075,5970,5103,517,5620,75
2020-12-13,Calaveras,009,45235,818,710,0,710,21
2020-12-13,Colusa,011,21464,1089,945,38,983,7
2020-12-13,Contra Costa,013,1133247,33280,29667,302,29969,281
2020-12-13,Del Norte,015,27424,606,542,0,542,1
2020-12-13,El Dorado,017,186661,4760,3770,133,3903,9
2020-12-13,Fresno,019,978130,56562,44114,2991,47105,559
2020-12-13,Glenn,021,27897,1290,1171,139,1310,9
2020-12-13,Humboldt,023,135768,1396,1238,4,1242,9
2020-12-13,Imperial,025,180216,20536,19472,430,19902,379
2020-12-13,Inyo,027,18085,478,380,6,386,16
2020-12-13,Kern,029,883053,54954,49051,3197,52248,510
2020-12-13,Kings,031,150075,14315,13357,348,13705,97
2020-12-13,Lake,033,64148,1463,1271,0,1271,21
2020-12-13,Lassen,035,31185,3477,2867,25,2892,1
2020-12-13,Los Angeles,037,10098052,572993,517472,12556,530028,8294
2020-12-13,Madera,039,155013,8724,7909,282,8191,60
2020-12-13,Marin,041,260295,8812,8409,55,8464,141
2020-12-13,Mariposa,043,17540,188,167,2,169,3
2020-12-13,Mendocino,045,87422,2047,1793,20,1813,24
2020-12-13,Merced,047,269075,15684,14384,232,14616,189
2020-12-13,Modoc,049,8938,192,179,58,237,0
2020-12-13,Mono,051,14174,741,675,12,687,3
2020-12-13,Monterey,053,433212,22013,18913,461,19374,153
2020-12-13,Napa,055,140530,4727,4194,24,4218,22
2020-12-13,Nevada,057,99092,2279,2030,65,2095,11
2020-12-13,Orange,059,3164182,120200,104768,4167,108935,1688
2020-12-13,Placer,061,380077,11443,9405,345,9750,95
2020-12-13,Plumas,063,18699,381,291,8,299,0
2020-12-13,Riverside,065,2383286,138810,119691,4891,124582,1581
2020-12-13,Sacramento,067,1510023,53851,49480,348,49828,682
2020-12-13,San Benito,069,59416,2745,2408,19,2427,19
2020-12-13,San Bernardino,071,2135413,151387,126718,3709,130427,1333
2020-12-13,San Diego,073,3302833,120002,107372,5108,112480,1162
2020-12-13,San Francisco,075,870044,20029,18686,167,18853,167
2020-12-13,San Joaquin,077,732212,37004,32170,975,33145,534
2020-12-13,San Luis Obispo,079,281455,8744,7625,183,7808,52
2020-12-13,San Mateo,081,765935,20544,18090,46,18136,177
2020-12-13,Santa Barbara,083,443738,14358,13249,332,13581,144
2020-12-13,Santa Clara,085,1922200,54954,47920,203,48123,499
2020-12-13,Santa Cruz,087,273765,7026,5986,153,6139,54
2020-12-13,Shasta,089,179085,7199,6647,459,7106,54
2020-12-13,Sierra,091,2930,23,21,0,21,0
2020-12-13,Siskiyou,093,43540,889,762,72,834,2
2020-12-13,Solano,095,438530,14862,13276,145,13421,93
2020-12-13,Sonoma,097,501317,16150,14495,95,14590,167
2020-12-13,Stanislaus,099,539301,29252,26569,2276,28845,485
2020-12-13,Sutter,101,95872,5382,4798,28,4826,34
2020-12-13,Tehama,103,63373,2503,2325,157,2482,9
2020-12-13,Trinity,105,12862,365,204,49,253,1
2020-12-13,Tulare,107,460477,28585,25496,2614,28110,340
2020-12-13,Tuolumne,109,53932,2017,1611,8,1619,8
2020-12-13,Ventura,111,848112,30496,26588,1063,27651,202
2020-12-13,Yolo,113,214977,6988,6265,34,6299,95
2020-12-13,Yuba,115,75493,3074,2754,27,2781,11
2020-12-12,Alameda,001,1643700,41717,37027,618,37645,486
2020-12-12,Alpine,003,1148,65,63,0,63,0
2020-12-12,Amador,005,37829,1763,1236,8,1244,19
2020-12-12,Butte,007,227075,5897,4972,505,5477,73
2020-12-12,Calaveras,009,45235,808,708,0,708,21
2020-12-12,Colusa,011,21464,1069,945,36,981,7
2020-12-12,Contra Costa,013,1133247,32936,29506,293,29799,281
2020-12-12,Del Norte,015,27424,598,529,0,529,1
2020-12-12,El Dorado,017,186661,4685,3706,116,3822,9
2020-12-12,Fresno,019,978130,56211,43756,2931,46687,559
2020-12-12,Glenn,021,27897,1282,1143,135,1278,8
2020-12-12,Humboldt,023,135768,1377,1208,4,1212,9
2020-12-12,Imperial,025,180216,20450,18947,372,19319,379
2020-12-12,Inyo,027,18085,474,380,6,386,16
2020-12-12,Kern,029,883053,54434,48194,3109,51303,507
2020-12-12,Kings,031,150075,14226,13205,344,13549,96
2020-12-12,Lake,033,64148,1447,1232,0,1232,21
2020-12-12,Lassen,035,31185,3454,2866,22,2888,1
2020-12-12,Los Angeles,037,10098052,566193,504317,12048,516365,8269
2020-12-12,Madera,039,155013,8597,7765,279,8044,59
2020-12-12,Marin,041,260295,8758,8363,54,8417,141
2020-12-12,Mariposa,043,17540,187,164,2,166,3
2020-12-12,Mendocino,045,87422,2011,1771,20,1791,24
2020-12-12,Merced,047,269075,15593,14181,228,14409,188
2020-12-12,Modoc,049,8938,191,169,55,224,0
2020-12-12,Mono,051,14174,734,640,12,652,3
2020-12-12,Monterey,053,433212,21902,18596,432,19028,151
2020-12-12,Napa,055,140530,4682,4113,24,4137,22
2020-12-12,Nevada,057,99092,2261,1981,63,2044,10
2020-12-12,Orange,059,3164182,118316,100468,4019,104487,1674
2020-12-12,Placer,061,380077,11278,9390,340,9730,95
2020-12-12,Plumas,063,18699,375,291,8,299,0
2020-12-12,Riverside,065,2383286,136753,118335,4686,123021,1579
2020-12-12,Sacramento,067,1510023,53267,48319,335,48654,673
2020-12-12,San Benito,069,59416,2689,2355,19,2374,19
2020-12-12,San Bernardino,071,2135413,149757,125741,3607,129348,1321
2020-12-12,San Diego,073,3302833,118381,104958,5011,109969,1151
2020-12-12,San Francisco,075,870044,19839,18413,163,18576,167
2020-12-12,San Joaquin,077,732212,36677,32200,944,33144,534
2020-12-12,San Luis Obispo,079,281455,8645,7462,177,7639,50
2020-12-12,San Mateo,081,765935,20323,17574,45,17619,177
2020-12-12,Santa Barbara,083,443738,14206,13174,324,13498,144
2020-12-12,Santa Clara,085,1922200,54004,45892,200,46092,498
2020-12-12,Santa Cruz,087,273765,6928,5905,144,6049,54
2020-12-12,Shasta,089,179085,7165,6551,441,6992,54
2020-12-12,Sierra,091,2930,23,21,0,21,0
2020-12-12,Siskiyou,093,43540,887,762,69,831,2
2020-12-12,Solano,095,438530,14664,12748,138,12886,93
2020-12-12,Sonoma,097,501317,16029,14466,95,14561,166
2020-12-12,Stanislaus,099,539301,28951,26246,2224,28470,483
2020-12-12,Sutter,101,95872,5320,4717,28,4745,32
2020-12-12,Tehama,103,63373,2485,2252,151,2403,9
2020-12-12,Trinity,105,12862,363,204,47,251,1
2020-12-12,Tulare,107,460477,28326,25333,2556,27889,341
2020-12-12,Tuolumne,109,53932,1974,1536,8,1544,8
2020-12-12,Ventura,111,848112,30052,25955,1030,26985,202
2020-12-12,Yolo,113,214977,6906,6116,32,6148,95
2020-12-12,Yuba,115,75493,3047,2692,26,2718,10
2020-12-11,Alameda,001,1643700,41150,36281,606,36887,482
2020-12-11,Alpine,003,1148,65,63,0,63,0
2020-12-11,Amador,005,37829,1747,1213,8,1221,19
2020-12-11,Butte,007,227075,5824,4941,487,5428,73
2020-12-11,Calaveras,009,45235,792,697,0,697,21
2020-12-11,Colusa,011,21464,1059,923,34,957,7
2020-12-11,Contra Costa,013,1133247,32513,29036,289,29325,282
2020-12-11,Del Norte,015,27424,592,505,0,505,1
2020-12-11,El Dorado,017,186661,4604,3669,101,3770,9
2020-12-11,Fresno,019,978130,55199,43071,2865,45936,550
2020-12-11,Glenn,021,27897,1266,1135,130,1265,8
2020-12-11,Humboldt,023,135768,1359,1190,4,1194,9
2020-12-11,Imperial,025,180216,20360,18599,328,18927,377
2020-12-11,Inyo,027,18085,462,372,6,378,16
2020-12-11,Kern,029,883053,53756,47664,3047,50711,502
2020-12-11,Kings,031,150075,14082,13118,340,13458,94
2020-12-11,Lake,033,64148,1434,1205,0,1205,21
2020-12-11,Lassen,035,31185,3442,2790,21,2811,1
2020-12-11,Los Angeles,037,10098052,554389,493592,11636,505228,8198
2020-12-11,Madera,039,155013,8506,7648,269,7917,59
2020-12-11,Marin,041,260295,8664,8317,53,8370,141
2020-12-11,Mariposa,043,17540,186,164,2,166,3
2020-12-11,Mendocino,045,87422,1987,1769,20,1789,24
2020-12-11,Merced,047,269075,15473,14038,220,14258,186
2020-12-11,Modoc,049,8938,191,168,54,222,0
2020-12-11,Mono,051,14174,724,631,12,643,3
2020-12-11,Monterey,053,433212,21601,18421,427,18848,150
2020-12-11,Napa,055,140530,4627,4054,24,4078,22
2020-12-11,Nevada,057,99092,2244,1959,60,2019,10
2020-12-11,Orange,059,3164182,116007,98357,3917,102274,1656
2020-12-11,Placer,061,380077,11116,8904,324,9228,93
2020-12-11,Plumas,063,18699,367,286,8,294,0
2020-12-11,Riverside,065,2383286,133685,115329,4466,119795,1573
2020-12-11,Sacramento,067,1510023,52605,47468,327,47795,669
2020-12-11,San Benito,069,59416,2638,2319,19,2338,19
2020-12-11,San Bernardino,071,2135413,147066,123092,3491,126583,1313
2020-12-11,San Diego,073,3302833,116421,102468,4928,107396,1137
2020-12-11,San Francisco,075,870044,19609,18246,162,18408,165
2020-12-11,San Joaquin,077,732212,36331,32044,916,32960,534
2020-12-11,San Luis Obispo,079,281455,8484,7415,175,7590,49
2020-12-11,San Mateo,081,765935,20052,17240,34,17274,177
2020-12-11,Santa Barbara,083,443738,14063,12997,316,13313,144
2020-12-11,Santa Clara,085,1922200,53000,45101,191,45292,494
2020-12-11,Santa Cruz,087,273765,6815,5764,135,5899,50
2020-12-11,Shasta,089,179085,7120,6459,434,6893,54
2020-12-11,Sierra,091,2930,23,19,0,19,0
2020-12-11,Siskiyou,093,43540,880,753,66,819,2
2020-12-11,Solano,095,438530,14478,12554,134,12688,92
2020-12-11,Sonoma,097,501317,15862,14298,93,14391,166
2020-12-11,Stanislaus,099,539301,28683,25928,2181,28109,464
2020-12-11,Sutter,101,95872,5257,4600,27,4627,30
2020-12-11,Tehama,103,63373,2454,2232,147,2379,9
2020-12-11,Trinity,105,12862,360,204,47,251,1
2020-12-11,Tulare,107,460477,27966,24953,2509,27462,338
2020-12-11,Tuolumne,109,53932,1960,1510,8,1518,8
2020-12-11,Ventura,111,848112,29446,24999,1008,26007,202
2020-12-11,Yolo,113,214977,6800,6006,31,6037,95
2020-12-11,Yuba,115,75493,2987,2649,25,2674,10
2020-12-10,Alameda,001,1643700,40380,35686,584,36270,477
2020-12-10,Alpine,003,1148,65,63,0,63,0
2020-12-10,Amador,005,37829,1690,1191,8,1199,18
2020-12-10,Butte,007,227075,5708,4863,460,5323,72
2020-12-10,Calaveras,009,45235,774,684,0,684,21
2020-12-10,Colusa,011,21464,1036,909,29,938,7
2020-12-10,Contra Costa,013,1133247,31832,28413,283,28696,276
2020-12-10,Del Norte,015,27424,582,501,0,501,1
2020-12-10,El Dorado,017,186661,4486,3557,96,3653,9
2020-12-10,Fresno,019,978130,54220,42461,2722,45183,540
2020-12-10,Glenn,021,27897,1246,1126,121,1247,8
2020-12-10,Humboldt,023,135768,1339,1140,4,1144,9
2020-12-10,Imperial,025,180216,20144,18333,251,18584,370
2020-12-10,Inyo,027,18085,441,365,6,371,15
2020-12-10,Kern,029,883053,52772,47176,2881,50057,499
2020-12-10,Kings,031,150075,13924,12993,334,13327,92
2020-12-10,Lake,033,64148,1393,1167,0,1167,21
2020-12-10,Lassen,035,31185,3420,2764,17,2781,0
2020-12-10,Los Angeles,037,10098052,540422,480354,11098,491452,8149
2020-12-10,Madera,039,155013,8400,7445,254,7699,59
2020-12-10,Marin,041,260295,8611,8245,52,8297,140
2020-12-10,Mariposa,043,17540,185,160,2,162,3
2020-12-10,Mendocino,045,87422,1961,1748,17,1765,24
2020-12-10,Merced,047,269075,15227,13756,217,13973,186
2020-12-10,Modoc,049,8938,186,165,52,217,0
2020-12-10,Mono,051,14174,719,601,12,613,3
2020-12-10,Monterey,053,433212,21120,18266,417,18683,145
2020-12-10,Napa,055,140530,4541,3974,23,3997,22
2020-12-10,Nevada,057,99092,2208,1919,60,1979,10
2020-12-10,Orange,059,3164182,112911,95297,3755,99052,1651
2020-12-10,Placer,061,380077,10863,8906,306,9212,90
2020-12-10,Plumas,063,18699,356,281,8,289,0
2020-12-10,Riverside,065,2383286,129998,112794,4197,116991,1552
2020-12-10,Sacramento,067,1510023,51706,46471,306,46777,664
2020-12-10,San Benito,069,59416,2578,2268,18,2286,19
2020-12-10,San Bernardino,071,2135413,142833,120186,3317,123503,1306
2020-12-10,San Diego,073,3302833,113896,99601,4779,104380,1114
2020-12-10,San Francisco,075,870044,19297,17945,154,18099,164
2020-12-10,San Joaquin,077,732212,35696,31228,886,32114,534
2020-12-10,San Luis Obispo,079,281455,8321,7245,164,7409,49
2020-12-10,San Mateo,081,765935,19607,16701,24,16725,177
2020-12-10,Santa Barbara,083,443738,13884,12788,307,13095,143
2020-12-10,Santa Clara,085,1922200,51862,43939,176,44115,491
2020-12-10,Santa Cruz,087,273765,6648,5645,122,5767,48
2020-12-10,Shasta,089,179085,7052,6312,409,6721,53
2020-12-10,Sierra,091,2930,23,18,0,18,0
2020-12-10,Siskiyou,093,43540,870,712,65,777,2
2020-12-10,Solano,095,438530,14111,12017,128,12145,90
2020-12-10,Sonoma,097,501317,15607,14282,91,14373,167
2020-12-10,Stanislaus,099,539301,28220,25582,2112,27694,464
2020-12-10,Sutter,101,95872,5127,4528,25,4553,27
2020-12-10,Tehama,103,63373,2410,2190,137,2327,9
2020-12-10,Trinity,105,12862,356,202,45,247,1
2020-12-10,Tulare,107,460477,27510,24506,2443,26949,337
2020-12-10,Tuolumne,109,53932,1718,1451,8,1459,8
2020-12-10,Ventura,111,848112,28595,24075,964,25039,202
2020-12-10,Yolo,113,214977,6680,5896,30,5926,95
2020-12-10,Yuba,115,75493,2923,2604,24,2628,10
2020-12-09,Alameda,001,1643700,39538,35047,562,35609,470
2020-12-09,Alpine,003,1148,65,58,0,58,0
2020-12-09,Amador,005,37829,1647,1121,8,1129,19
2020-12-09,Butte,007,227075,5565,4733,440,5173,70
2020-12-09,Calaveras,009,45235,747,670,0,670,21
2020-12-09,Colusa,011,21464,1021,896,28,924,7
2020-12-09,Contra Costa,013,1133247,31126,28308,272,28580,273
2020-12-09,Del Norte,015,27424,569,481,0,481,2
2020-12-09,El Dorado,017,186661,4351,3449,88,3537,8
2020-12-09,Fresno,019,978130,53218,41954,2568,44522,533
2020-12-09,Glenn,021,27897,1232,1107,115,1222,8
2020-12-09,Humboldt,023,135768,1307,1086,4,1090,10
2020-12-09,Imperial,025,180216,19890,17757,214,17971,368
2020-12-09,Inyo,027,18085,428,356,6,362,15
2020-12-09,Kern,029,883053,51613,46379,2739,49118,494
2020-12-09,Kings,031,150075,13779,12716,326,13042,92
2020-12-09,Lake,033,64148,1366,1158,0,1158,20
2020-12-09,Lassen,035,31185,3351,2331,15,2346,0
2020-12-09,Los Angeles,037,10098052,526944,467971,10546,478517,8075
2020-12-09,Madera,039,155013,8287,7216,251,7467,59
2020-12-09,Marin,041,260295,8549,8182,51,8233,138
2020-12-09,Mariposa,043,17540,183,154,2,156,3
2020-12-09,Mendocino,045,87422,1935,1703,16,1719,24
2020-12-09,Merced,047,269075,14986,13588,210,13798,183
2020-12-09,Modoc,049,8938,181,146,43,189,0
2020-12-09,Mono,051,14174,707,601,12,613,3
2020-12-09,Monterey,053,433212,20719,17891,409,18300,143
2020-12-09,Napa,055,140530,4455,3858,22,3880,21
2020-12-09,Nevada,057,99092,2155,1864,60,1924,10
2020-12-09,Orange,059,3164182,109821,93763,3582,97345,1629
2020-12-09,Placer,061,380077,10601,8588,292,8880,85
2020-12-09,Plumas,063,18699,348,271,8,279,0
2020-12-09,Riverside,065,2383286,126300,110376,3990,114366,1543
2020-12-09,Sacramento,067,1510023,50643,45284,279,45563,659
2020-12-09,San Benito,069,59416,2505,2217,16,2233,19
2020-12-09,San Bernardino,071,2135413,138552,114516,3124,117640,1305
2020-12-09,San Diego,073,3302833,110916,97551,4640,102191,1103
2020-12-09,San Francisco,075,870044,18996,17628,153,17781,163
2020-12-09,San Joaquin,077,732212,34878,30539,861,31400,531
2020-12-09,San Luis Obispo,079,281455,8102,7105,156,7261,47
2020-12-09,San Mateo,081,765935,19157,16422,23,16445,175
2020-12-09,Santa Barbara,083,443738,13684,12630,297,12927,142
2020-12-09,Santa Clara,085,1922200,50714,42912,160,43072,489
2020-12-09,Santa Cruz,087,273765,6489,5527,107,5634,47
2020-12-09,Shasta,089,179085,6987,6105,395,6500,52
2020-12-09,Sierra,091,2930,23,18,0,18,0
2020-12-09,Siskiyou,093,43540,859,713,64,777,2
2020-12-09,Solano,095,438530,13763,11862,120,11982,90
2020-12-09,Sonoma,097,501317,15351,13994,88,14082,164
2020-12-09,Stanislaus,099,539301,27722,25157,2051,27208,463
2020-12-09,Sutter,101,95872,5009,4418,21,4439,24
2020-12-09,Tehama,103,63373,2374,2102,133,2235,9
2020-12-09,Trinity,105,12862,348,199,42,241,0
2020-12-09,Tulare,107,460477,26914,24124,2365,26489,334
2020-12-09,Tuolumne,109,53932,1685,1319,8,1327,8
2020-12-09,Ventura,111,848112,27732,23830,922,24752,201
2020-12-09,Yolo,113,214977,6555,5760,28,5788,95
2020-12-09,Yuba,115,75493,2855,2513,23,2536,10
2020-12-08,Alameda,001,1643700,38640,34373,546,34919,469
2020-12-08,Alpine,003,1148,64,53,0,53,0
2020-12-08,Amador,005,37829,1361,1043,8,1051,17
2020-12-08,Butte,007,227075,5407,4651,399,5050,70
2020-12-08,Calaveras,009,45235,723,657,0,657,21
2020-12-08,Colusa,011,21464,1005,875,27,902,6
2020-12-08,Contra Costa,013,1133247,30423,27926,255,28181,270
2020-12-08,Del Norte,015,27424,553,465,0,465,2
2020-12-08,El Dorado,017,186661,4227,3296,75,3371,8
2020-12-08,Fresno,019,978130,51955,41574,2412,43986,529
2020-12-08,Glenn,021,27897,1212,1094,107,1201,8
2020-12-08,Humboldt,023,135768,1281,1059,4,1063,10
2020-12-08,Imperial,025,180216,19374,17568,206,17774,363
2020-12-08,Inyo,027,18085,405,333,6,339,15
2020-12-08,Kern,029,883053,50319,45116,2582,47698,487
2020-12-08,Kings,031,150075,13625,12623,317,12940,90
2020-12-08,Lake,033,64148,1324,1127,0,1127,20
2020-12-08,Lassen,035,31185,3195,2165,15,2180,0
2020-12-08,Los Angeles,037,10098052,514255,459738,10062,469800,8004
2020-12-08,Madera,039,155013,8156,7082,238,7320,59
2020-12-08,Marin,041,260295,8469,8099,50,8149,137
2020-12-08,Mariposa,043,17540,179,150,2,152,2
2020-12-08,Mendocino,045,87422,1893,1666,16,1682,23
2020-12-08,Merced,047,269075,14674,13380,209,13589,181
2020-12-08,Modoc,049,8938,173,138,40,178,0
2020-12-08,Mono,051,14174,693,597,12,609,3
2020-12-08,Monterey,053,433212,20145,17752,402,18154,134
2020-12-08,Napa,055,140530,4368,3778,21,3799,22
2020-12-08,Nevada,057,99092,2101,1809,57,1866,11
2020-12-08,Orange,059,3164182,106600,91406,3417,94823,1629
2020-12-08,Placer,061,380077,10333,8224,287,8511,82
2020-12-08,Plumas,063,18699,338,258,8,266,0
2020-12-08,Riverside,065,2383286,122937,107620,3810,111430,1514
2020-12-08,Sacramento,067,1510023,49579,44635,264,44899,649
2020-12-08,San Benito,069,59416,2452,2180,16,2196,18
2020-12-08,San Bernardino,071,2135413,134202,110676,2998,113674,1301
2020-12-08,San Diego,073,3302833,107545,95447,4483,99930,1088
2020-12-08,San Francisco,075,870044,18686,17384,151,17535,162
2020-12-08,San Joaquin,077,732212,33983,30225,828,31053,530
2020-12-08,San Luis Obispo,079,281455,7973,6903,145,7048,45
2020-12-08,San Mateo,081,765935,18757,16305,23,16328,175
2020-12-08,Santa Barbara,083,443738,13500,12516,288,12804,141
2020-12-08,Santa Clara,085,1922200,49409,41309,151,41460,484
2020-12-08,Santa Cruz,087,273765,6311,5374,105,5479,45
2020-12-08,Shasta,089,179085,6878,5946,387,6333,50
2020-12-08,Sierra,091,2930,22,18,0,18,0
2020-12-08,Siskiyou,093,43540,845,704,62,766,2
2020-12-08,Solano,095,438530,13361,11669,118,11787,89
2020-12-08,Sonoma,097,501317,15092,13601,87,13688,164
2020-12-08,Stanislaus,099,539301,27232,24793,1986,26779,461
2020-12-08,Sutter,101,95872,4914,4342,20,4362,24
2020-12-08,Tehama,103,63373,2294,2057,125,2182,9
2020-12-08,Trinity,105,12862,339,198,41,239,0
2020-12-08,Tulare,107,460477,26309,23607,2304,25911,330
2020-12-08,Tuolumne,109,53932,1661,1264,8,1272,7
2020-12-08,Ventura,111,848112,27069,23665,879,24544,195
2020-12-08,Yolo,113,214977,6424,5560,28,5588,90
2020-12-08,Yuba,115,75493,2778,2477,23,2500,10
2020-12-07,Alameda,001,1643700,37774,33887,511,34398,466
2020-12-07,Alpine,003,1148,63,53,0,53,0
2020-12-07,Amador,005,37829,1286,993,7,1000,17
2020-12-07,Butte,007,227075,5272,4604,377,4981,67
2020-12-07,Calaveras,009,45235,691,606,0,606,21
2020-12-07,Colusa,011,21464,980,825,24,849,6
2020-12-07,Contra Costa,013,1133247,29809,27307,242,27549,270
2020-12-07,Del Norte,015,27424,541,424,0,424,2
2020-12-07,El Dorado,017,186661,4048,3275,68,3343,8
2020-12-07,Fresno,019,978130,50480,41098,2289,43387,526
2020-12-07,Glenn,021,27897,1193,1085,101,1186,8
2020-12-07,Humboldt,023,135768,1246,1023,4,1027,9
2020-12-07,Imperial,025,180216,18952,17234,194,17428,364
2020-12-07,Inyo,027,18085,390,333,6,339,15
2020-12-07,Kern,029,883053,49294,44409,2446,46855,486
2020-12-07,Kings,031,150075,13482,12412,307,12719,90
2020-12-07,Lake,033,64148,1297,1090,0,1090,20
2020-12-07,Lassen,035,31185,3098,2167,15,2182,0
2020-12-07,Los Angeles,037,10098052,500592,451052,9621,460673,7937
2020-12-07,Madera,039,155013,7891,6935,233,7168,59
2020-12-07,Marin,041,260295,8411,8049,49,8098,136
2020-12-07,Mariposa,043,17540,176,146,2,148,2
2020-12-07,Mendocino,045,87422,1857,1638,14,1652,23
2020-12-07,Merced,047,269075,14315,13250,199,13449,179
2020-12-07,Modoc,049,8938,166,128,37,165,0
2020-12-07,Mono,051,14174,680,590,12,602,3
2020-12-07,Monterey,053,433212,19664,17746,390,18136,132
2020-12-07,Napa,055,140530,4277,3684,21,3705,21
2020-12-07,Nevada,057,99092,2052,1777,56,1833,11
2020-12-07,Orange,059,3164182,103338,89793,3298,93091,1628
2020-12-07,Placer,061,380077,10006,7911,273,8184,82
2020-12-07,Plumas,063,18699,326,256,5,261,0
2020-12-07,Riverside,065,2383286,119738,102363,3627,105990,1491
2020-12-07,Sacramento,067,1510023,48484,43419,247,43666,638
2020-12-07,San Benito,069,59416,2401,2165,15,2180,18
2020-12-07,San Bernardino,071,2135413,130251,108161,2879,111040,1295
2020-12-07,San Diego,073,3302833,104756,94171,4302,98473,1062
2020-12-07,San Francisco,075,870044,18395,17220,144,17364,161
2020-12-07,San Joaquin,077,732212,33108,28188,801,28989,530
2020-12-07,San Luis Obispo,079,281455,7791,6782,138,6920,45
2020-12-07,San Mateo,081,765935,18316,16029,22,16051,175
2020-12-07,Santa Barbara,083,443738,13259,12362,278,12640,141
2020-12-07,Santa Clara,085,1922200,48022,40621,142,40763,484
2020-12-07,Santa Cruz,087,273765,6146,5152,99,5251,41
2020-12-07,Shasta,089,179085,6755,5742,372,6114,50
2020-12-07,Sierra,091,2930,20,18,0,18,0
2020-12-07,Siskiyou,093,43540,818,652,62,714,2
2020-12-07,Solano,095,438530,13021,11354,114,11468,89
2020-12-07,Sonoma,097,501317,14808,13376,87,13463,164
2020-12-07,Stanislaus,099,539301,26674,24479,1934,26413,454
2020-12-07,Sutter,101,95872,4773,4106,20,4126,24
2020-12-07,Tehama,103,63373,2240,2030,120,2150,9
2020-12-07,Trinity,105,12862,335,194,41,235,0
2020-12-07,Tulare,107,460477,25774,22760,2247,25007,328
2020-12-07,Tuolumne,109,53932,1576,1256,7,1263,7
2020-12-07,Ventura,111,848112,26482,23354,843,24197,191
2020-12-07,Yolo,113,214977,6260,5537,27,5564,90
2020-12-07,Yuba,115,75493,2710,2428,21,2449,10
2020-12-06,Alameda,001,1643700,36784,33477,491,33968,465
2020-12-06,Alpine,003,1148,59,53,0,53,0
2020-12-06,Amador,005,37829,1223,952,6,958,17
2020-12-06,Butte,007,227075,5119,4527,344,4871,67
2020-12-06,Calaveras,009,45235,672,606,0,606,21
2020-12-06,Colusa,011,21464,963,824,21,845,6
2020-12-06,Contra Costa,013,1133247,29203,26566,235,26801,270
2020-12-06,Del Norte,015,27424,486,414,0,414,2
2020-12-06,El Dorado,017,186661,3911,3086,63,3149,8
2020-12-06,Fresno,019,978130,49524,40869,2173,43042,526
2020-12-06,Glenn,021,27897,1183,1067,97,1164,8
2020-12-06,Humboldt,023,135768,1221,1004,4,1008,9
2020-12-06,Imperial,025,180216,18640,16922,185,17107,364
2020-12-06,Inyo,027,18085,377,333,6,339,15
2020-12-06,Kern,029,883053,48305,43899,2276,46175,486
2020-12-06,Kings,031,150075,13210,12056,290,12346,90
2020-12-06,Lake,033,64148,1259,1075,0,1075,20
2020-12-06,Lassen,035,31185,2993,2168,13,2181,0
2020-12-06,Los Angeles,037,10098052,487005,443230,9174,452404,7910
2020-12-06,Madera,039,155013,7719,6826,224,7050,59
2020-12-06,Marin,041,260295,8330,8013,47,8060,136
2020-12-06,Mariposa,043,17540,175,144,2,146,2
2020-12-06,Mendocino,045,87422,1817,1614,14,1628,23
2020-12-06,Merced,047,269075,13980,12928,190,13118,179
2020-12-06,Modoc,049,8938,153,125,29,154,0
2020-12-06,Mono,051,14174,658,586,10,596,3
2020-12-06,Monterey,053,433212,19045,17426,380,17806,130
2020-12-06,Napa,055,140530,4165,3644,21,3665,21
2020-12-06,Nevada,057,99092,1993,1710,53,1763,10
2020-12-06,Orange,059,3164182,100271,87737,3168,90905,1627
2020-12-06,Placer,061,380077,9725,7837,252,8089,82
2020-12-06,Plumas,063,18699,313,254,4,258,0
2020-12-06,Riverside,065,2383286,116644,100088,3403,103491,1482
2020-12-06,Sacramento,067,1510023,47244,42808,231,43039,638
2020-12-06,San Benito,069,59416,2364,2135,15,2150,18
2020-12-06,San Bernardino,071,2135413,126103,106927,2722,109649,1286
2020-12-06,San Diego,073,3302833,101724,92173,4148,96321,1062
2020-12-06,San Francisco,075,870044,18073,17107,137,17244,161
2020-12-06,San Joaquin,077,732212,32274,28188,772,28960,530
2020-12-06,San Luis Obispo,079,281455,7625,6723,133,6856,45
2020-12-06,San Mateo,081,765935,17811,15855,19,15874,175
2020-12-06,Santa Barbara,083,443738,13027,12252,269,12521,141
2020-12-06,Santa Clara,085,1922200,46646,39112,136,39248,482
2020-12-06,Santa Cruz,087,273765,5972,5069,93,5162,40
2020-12-06,Shasta,089,179085,6614,5743,351,6094,49
2020-12-06,Sierra,091,2930,20,17,0,17,0
2020-12-06,Siskiyou,093,43540,800,652,60,712,2
2020-12-06,Solano,095,438530,12734,11354,104,11458,88
2020-12-06,Sonoma,097,501317,14519,13238,86,13324,164
2020-12-06,Stanislaus,099,539301,26121,24036,1870,25906,454
2020-12-06,Sutter,101,95872,4657,4009,19,4028,21
2020-12-06,Tehama,103,63373,2181,1982,111,2093,9
2020-12-06,Trinity,105,12862,328,181,39,220,0
2020-12-06,Tulare,107,460477,25248,22756,2178,24934,327
2020-12-06,Tuolumne,109,53932,1480,1210,7,1217,7
2020-12-06,Ventura,111,848112,25940,23035,816,23851,191
2020-12-06,Yolo,113,214977,6099,5465,22,5487,90
2020-12-06,Yuba,115,75493,2666,2340,20,2360,10
2020-12-05,Alameda,001,1643700,36425,32781,480,33261,465
2020-12-05,Alpine,003,1148,58,53,0,53,0
2020-12-05,Amador,005,37829,1199,847,6,853,17
2020-12-05,Butte,007,227075,5051,4455,325,4780,66
2020-12-05,Calaveras,009,45235,660,606,0,606,21
2020-12-05,Colusa,011,21464,945,825,18,843,6
2020-12-05,Contra Costa,013,1133247,28911,26217,228,26445,270
2020-12-05,Del Norte,015,27424,480,408,0,408,2
2020-12-05,El Dorado,017,186661,3846,3061,58,3119,8
2020-12-05,Fresno,019,978130,49205,40568,2118,42686,525
2020-12-05,Glenn,021,27897,1170,1056,91,1147,8
2020-12-05,Humboldt,023,135768,1188,979,4,983,9
2020-12-05,Imperial,025,180216,18474,16544,183,16727,362
2020-12-05,Inyo,027,18085,372,332,6,338,15
2020-12-05,Kern,029,883053,47841,43332,2191,45523,484
2020-12-05,Kings,031,150075,13129,11898,287,12185,90
2020-12-05,Lake,033,64148,1233,1069,0,1069,20
2020-12-05,Lassen,035,31185,2802,2168,11,2179,0
2020-12-05,Los Angeles,037,10098052,481206,433120,8856,441976,7888
2020-12-05,Madera,039,155013,7626,6619,217,6836,59
2020-12-05,Marin,041,260295,8303,7961,47,8008,136
2020-12-05,Mariposa,043,17540,170,143,2,145,2
2020-12-05,Mendocino,045,87422,1778,1585,14,1599,23
2020-12-05,Merced,047,269075,13873,12747,179,12926,180
2020-12-05,Modoc,049,8938,153,118,28,146,0
2020-12-05,Mono,051,14174,653,554,10,564,3
2020-12-05,Monterey,053,433212,18899,17077,376,17453,127
2020-12-05,Napa,055,140530,4094,3565,21,3586,21
2020-12-05,Nevada,057,99092,1978,1642,51,1693,10
2020-12-05,Orange,059,3164182,98812,85735,3072,88807,1612
2020-12-05,Placer,061,380077,9605,7811,243,8054,78
2020-12-05,Plumas,063,18699,306,246,1,247,0
2020-12-05,Riverside,065,2383286,115032,98612,3225,101837,1477
2020-12-05,Sacramento,067,1510023,46576,41878,216,42094,625
2020-12-05,San Benito,069,59416,2320,2073,15,2088,18
2020-12-05,San Bernardino,071,2135413,124580,105382,2593,107975,1283
2020-12-05,San Diego,073,3302833,100372,90470,4067,94537,1055
2020-12-05,San Francisco,075,870044,17889,16786,133,16919,161
2020-12-05,San Joaquin,077,732212,32010,28105,739,28844,523
2020-12-05,San Luis Obispo,079,281455,7558,6623,130,6753,44
2020-12-05,San Mateo,081,765935,17553,15512,19,15531,175
2020-12-05,Santa Barbara,083,443738,12927,12107,263,12370,141
2020-12-05,Santa Clara,085,1922200,45905,38339,131,38470,474
2020-12-05,Santa Cruz,087,273765,5898,4997,91,5088,40
2020-12-05,Shasta,089,179085,6553,5653,340,5993,49
2020-12-05,Sierra,091,2930,20,17,0,17,0
2020-12-05,Siskiyou,093,43540,792,649,59,708,2
2020-12-05,Solano,095,438530,12565,11351,102,11453,87
2020-12-05,Sonoma,097,501317,14423,13137,86,13223,164
2020-12-05,Stanislaus,099,539301,25808,23662,1835,25497,454
2020-12-05,Sutter,101,95872,4592,3937,19,3956,20
2020-12-05,Tehama,103,63373,2165,1926,109,2035,9
2020-12-05,Trinity,105,12862,327,177,39,216,0
2020-12-05,Tulare,107,460477,25032,22660,2120,24780,324
2020-12-05,Tuolumne,109,53932,1423,1180,7,1187,7
2020-12-05,Ventura,111,848112,25569,22710,802,23512,191
2020-12-05,Yolo,113,214977,6022,5351,21,5372,90
2020-12-05,Yuba,115,75493,2629,2275,20,2295,10
2020-12-04,Alameda,001,1643700,35878,31871,467,32338,465
2020-12-04,Alpine,003,1148,58,53,0,53,0
2020-12-04,Amador,005,37829,1185,766,3,769,16
2020-12-04,Butte,007,227075,4979,4336,305,4641,65
2020-12-04,Calaveras,009,45235,655,585,0,585,21
2020-12-04,Colusa,011,21464,931,790,17,807,6
2020-12-04,Contra Costa,013,1133247,28566,25705,216,25921,264
2020-12-04,Del Norte,015,27424,469,401,0,401,2
2020-12-04,El Dorado,017,186661,3758,2933,55,2988,7
2020-12-04,Fresno,019,978130,48496,40108,2050,42158,522
2020-12-04,Glenn,021,27897,1164,1017,83,1100,8
2020-12-04,Humboldt,023,135768,1170,960,4,964,9
2020-12-04,Imperial,025,180216,18232,16484,183,16667,362
2020-12-04,Inyo,027,18085,364,324,6,330,15
2020-12-04,Kern,029,883053,47290,42497,2088,44585,485
2020-12-04,Kings,031,150075,13036,11767,281,12048,88
2020-12-04,Lake,033,64148,1205,1018,0,1018,20
2020-12-04,Lassen,035,31185,2795,2167,10,2177,0
2020-12-04,Los Angeles,037,10098052,472589,424164,8557,432721,7845
2020-12-04,Madera,039,155013,7535,6479,214,6693,58
2020-12-04,Marin,041,260295,8252,7896,44,7940,136
2020-12-04,Mariposa,043,17540,170,136,2,138,2
2020-12-04,Mendocino,045,87422,1759,1563,13,1576,23
2020-12-04,Merced,047,269075,13758,12474,171,12645,177
2020-12-04,Modoc,049,8938,153,115,28,143,0
2020-12-04,Mono,051,14174,648,549,10,559,3
2020-12-04,Monterey,053,433212,18689,16737,367,17104,127
2020-12-04,Napa,055,140530,4040,3432,21,3453,19
2020-12-04,Nevada,057,99092,1953,1560,48,1608,10
2020-12-04,Orange,059,3164182,96891,83738,3007,86745,1597
2020-12-04,Placer,061,380077,9480,7461,229,7690,76
2020-12-04,Plumas,063,18699,299,232,0,232,0
2020-12-04,Riverside,065,2383286,112833,95255,3068,98323,1475
2020-12-04,Sacramento,067,1510023,45811,41061,199,41260,618
2020-12-04,San Benito,069,59416,2287,2006,15,2021,17
2020-12-04,San Bernardino,071,2135413,122307,102418,2485,104903,1290
2020-12-04,San Diego,073,3302833,98888,88183,3980,92163,1047
2020-12-04,San Francisco,075,870044,17698,16499,133,16632,161
2020-12-04,San Joaquin,077,732212,31572,27806,702,28508,522
2020-12-04,San Luis Obispo,079,281455,7473,6473,127,6600,42
2020-12-04,San Mateo,081,765935,17265,15112,18,15130,173
2020-12-04,Santa Barbara,083,443738,12821,11947,256,12203,141
2020-12-04,Santa Clara,085,1922200,44983,37465,125,37590,468
2020-12-04,Santa Cruz,087,273765,5811,4985,89,5074,32
2020-12-04,Shasta,089,179085,6465,5439,330,5769,49
2020-12-04,Sierra,091,2930,19,17,0,17,0
2020-12-04,Siskiyou,093,43540,785,639,56,695,2
2020-12-04,Solano,095,438530,12419,11037,99,11136,87
2020-12-04,Sonoma,097,501317,14275,12962,85,13047,164
2020-12-04,Stanislaus,099,539301,25538,23206,1790,24996,448
2020-12-04,Sutter,101,95872,4520,3791,14,3805,20
2020-12-04,Tehama,103,63373,2125,1876,104,1980,9
2020-12-04,Trinity,105,12862,325,172,39,211,0
2020-12-04,Tulare,107,460477,24749,22273,2048,24321,322
2020-12-04,Tuolumne,109,53932,1392,1134,7,1141,7
2020-12-04,Ventura,111,848112,25192,22024,785,22809,189
2020-12-04,Yolo,113,214977,5948,5294,20,5314,87
2020-12-04,Yuba,115,75493,2586,2225,19,2244,10
2020-12-03,Alameda,001,1643700,35112,31184,448,31632,465
2020-12-03,Alpine,003,1148,57,53,0,53,0
2020-12-03,Amador,005,37829,1134,653,3,656,16
2020-12-03,Butte,007,227075,4883,4305,286,4591,65
2020-12-03,Calaveras,009,45235,636,572,0,572,21
2020-12-03,Colusa,011,21464,918,774,17,791,6
2020-12-03,Contra Costa,013,1133247,28066,25464,209,25673,265
2020-12-03,Del Norte,015,27424,465,388,0,388,2
2020-12-03,El Dorado,017,186661,3632,2740,53,2793,6
2020-12-03,Fresno,019,978130,47743,39680,1978,41658,516
2020-12-03,Glenn,021,27897,1146,997,75,1072,8
2020-12-03,Humboldt,023,135768,1140,923,4,927,9
2020-12-03,Imperial,025,180216,18026,16436,171,16607,359
2020-12-03,Inyo,027,18085,361,321,6,327,15
2020-12-03,Kern,029,883053,46444,42062,1987,44049,483
2020-12-03,Kings,031,150075,12936,11658,269,11927,87
2020-12-03,Lake,033,64148,1190,991,0,991,20
2020-12-03,Lassen,035,31185,2755,2128,9,2137,0
2020-12-03,Los Angeles,037,10098052,462494,415805,8195,424000,7787
2020-12-03,Madera,039,155013,7412,6398,209,6607,58
2020-12-03,Marin,041,260295,8192,7861,40,7901,136
2020-12-03,Mariposa,043,17540,166,132,2,134,2
2020-12-03,Mendocino,045,87422,1742,1547,10,1557,23
2020-12-03,Merced,047,269075,13513,12310,163,12473,177
2020-12-03,Modoc,049,8938,151,114,28,142,0
2020-12-03,Mono,051,14174,626,527,10,537,3
2020-12-03,Monterey,053,433212,18227,16218,356,16574,125
2020-12-03,Napa,055,140530,3926,3360,21,3381,19
2020-12-03,Nevada,057,99092,1875,1472,47,1519,10
2020-12-03,Orange,059,3164182,94357,82187,2937,85124,1591
2020-12-03,Placer,061,380077,9279,7270,213,7483,73
2020-12-03,Plumas,063,18699,284,223,0,223,0
2020-12-03,Riverside,065,2383286,110069,92489,2906,95395,1461
2020-12-03,Sacramento,067,1510023,44752,40280,185,40465,614
2020-12-03,San Benito,069,59416,2241,1967,15,1982,16
2020-12-03,San Bernardino,071,2135413,118980,100787,2401,103188,1283
2020-12-03,San Diego,073,3302833,97073,86144,3862,90006,1040
2020-12-03,San Francisco,075,870044,17476,16236,132,16368,161
2020-12-03,San Joaquin,077,732212,30848,27239,657,27896,522
2020-12-03,San Luis Obispo,079,281455,7305,6388,126,6514,42
2020-12-03,San Mateo,081,765935,16912,14909,18,14927,173
2020-12-03,Santa Barbara,083,443738,12692,11829,250,12079,141
2020-12-03,Santa Clara,085,1922200,43787,36621,119,36740,465
2020-12-03,Santa Cruz,087,273765,5668,4850,85,4935,28
2020-12-03,Shasta,089,179085,6356,5330,323,5653,48
2020-12-03,Sierra,091,2930,19,17,0,17,0
2020-12-03,Siskiyou,093,43540,770,629,53,682,2
2020-12-03,Solano,095,438530,12205,10857,96,10953,87
2020-12-03,Sonoma,097,501317,14032,12772,84,12856,164
2020-12-03,Stanislaus,099,539301,25129,22821,1742,24563,447
2020-12-03,Sutter,101,95872,4436,3727,14,3741,20
2020-12-03,Tehama,103,63373,2073,1832,97,1929,9
2020-12-03,Trinity,105,12862,322,166,39,205,0
2020-12-03,Tulare,107,460477,24350,21993,1955,23948,321
2020-12-03,Tuolumne,109,53932,1350,1105,7,1112,7
2020-12-03,Ventura,111,848112,24489,21555,772,22327,187
2020-12-03,Yolo,113,214977,5810,5069,20,5089,87
2020-12-03,Yuba,115,75493,2516,2182,18,2200,10
2020-12-02,Alameda,001,1643700,34486,30697,438,31135,463
2020-12-02,Alpine,003,1148,56,52,0,52,0
2020-12-02,Amador,005,37829,1062,585,3,588,16
2020-12-02,Butte,007,227075,4760,4243,276,4519,65
2020-12-02,Calaveras,009,45235,620,553,0,553,21
2020-12-02,Colusa,011,21464,902,756,16,772,6
2020-12-02,Contra Costa,013,1133247,27607,25147,197,25344,264
2020-12-02,Del Norte,015,27424,451,384,0,384,2
2020-12-02,El Dorado,017,186661,3530,2638,49,2687,5
2020-12-02,Fresno,019,978130,46987,39324,1877,41201,507
2020-12-02,Glenn,021,27897,1129,995,67,1062,7
2020-12-02,Humboldt,023,135768,1114,899,4,903,9
2020-12-02,Imperial,025,180216,17604,16360,163,16523,356
2020-12-02,Inyo,027,18085,354,314,6,320,15
2020-12-02,Kern,029,883053,45547,41660,1890,43550,479
2020-12-02,Kings,031,150075,12583,11531,255,11786,86
2020-12-02,Lake,033,64148,1159,971,0,971,20
2020-12-02,Lassen,035,31185,2696,2115,9,2124,0
2020-12-02,Los Angeles,037,10098052,452446,408289,7856,416145,7739
2020-12-02,Madera,039,155013,7288,6370,203,6573,57
2020-12-02,Marin,041,260295,8145,7819,38,7857,136
2020-12-02,Mariposa,043,17540,163,131,2,133,2
2020-12-02,Mendocino,045,87422,1709,1524,10,1534,23
2020-12-02,Merced,047,269075,13270,12168,155,12323,173
2020-12-02,Modoc,049,8938,148,113,28,141,0
2020-12-02,Mono,051,14174,617,520,10,530,3
2020-12-02,Monterey,053,433212,17747,16064,317,16381,121
2020-12-02,Napa,055,140530,3823,3298,20,3318,19
2020-12-02,Nevada,057,99092,1813,1430,46,1476,9
2020-12-02,Orange,059,3164182,92160,81046,2857,83903,1569
2020-12-02,Placer,061,380077,9047,6941,199,7140,73
2020-12-02,Plumas,063,18699,271,218,0,218,0
2020-12-02,Riverside,065,2383286,107349,90089,2725,92814,1451
2020-12-02,Sacramento,067,1510023,43712,39334,174,39508,597
2020-12-02,San Benito,069,59416,2176,1921,15,1936,16
2020-12-02,San Bernardino,071,2135413,115408,98567,2293,100860,1240
2020-12-02,San Diego,073,3302833,95157,84640,3747,88387,1035
2020-12-02,San Francisco,075,870044,17240,16058,130,16188,157
2020-12-02,San Joaquin,077,732212,30227,26740,633,27373,519
2020-12-02,San Luis Obispo,079,281455,7206,6324,124,6448,42
2020-12-02,San Mateo,081,765935,16549,14757,17,14774,170
2020-12-02,Santa Barbara,083,443738,12541,11705,238,11943,140
2020-12-02,Santa Clara,085,1922200,42672,35878,119,35997,458
2020-12-02,Santa Cruz,087,273765,5536,4766,82,4848,27
2020-12-02,Shasta,089,179085,6233,5188,306,5494,47
2020-12-02,Sierra,091,2930,19,17,0,17,0
2020-12-02,Siskiyou,093,43540,754,624,51,675,1
2020-12-02,Solano,095,438530,11959,10701,92,10793,87
2020-12-02,Sonoma,097,501317,13793,12635,83,12718,163
2020-12-02,Stanislaus,099,539301,24628,22615,1687,24302,448
2020-12-02,Sutter,101,95872,4276,3604,14,3618,18
2020-12-02,Tehama,103,63373,2030,1800,82,1882,9
2020-12-02,Trinity,105,12862,312,165,38,203,0
2020-12-02,Tulare,107,460477,23970,21789,1876,23665,321
2020-12-02,Tuolumne,109,53932,1309,1076,7,1083,7
2020-12-02,Ventura,111,848112,24078,21208,754,21962,186
2020-12-02,Yolo,113,214977,5701,5053,19,5072,87
2020-12-02,Yuba,115,75493,2439,2119,17,2136,10
2020-12-01,Alameda,001,1643700,33796,30252,428,30680,460
2020-12-01,Alpine,003,1148,56,41,0,41,0
2020-12-01,Amador,005,37829,915,575,2,577,16
2020-12-01,Butte,007,227075,4654,4177,262,4439,65
2020-12-01,Calaveras,009,45235,602,544,0,544,21
2020-12-01,Colusa,011,21464,885,747,16,763,6
2020-12-01,Contra Costa,013,1133247,27035,24788,189,24977,264
2020-12-01,Del Norte,015,27424,423,357,0,357,2
2020-12-01,El Dorado,017,186661,3385,2542,44,2586,4
2020-12-01,Fresno,019,978130,46085,39004,1799,40803,505
2020-12-01,Glenn,021,27897,1108,989,62,1051,7
2020-12-01,Humboldt,023,135768,1084,886,4,890,9
2020-12-01,Imperial,025,180216,17288,16278,160,16438,356
2020-12-01,Inyo,027,18085,347,304,6,310,15
2020-12-01,Kern,029,883053,44744,41345,1759,43104,478
2020-12-01,Kings,031,150075,12268,11415,241,11656,86
2020-12-01,Lake,033,64148,1141,969,0,969,19
2020-12-01,Lassen,035,31185,2530,2047,8,2055,0
2020-12-01,Los Angeles,037,10098052,442080,403266,7532,410798,7704
2020-12-01,Madera,039,155013,7171,6270,193,6463,57
2020-12-01,Marin,041,260295,8075,7787,37,7824,136
2020-12-01,Mariposa,043,17540,158,128,2,130,2
2020-12-01,Mendocino,045,87422,1675,1497,10,1507,23
2020-12-01,Merced,047,269075,13027,12032,146,12178,172
2020-12-01,Modoc,049,8938,143,113,24,137,0
2020-12-01,Mono,051,14174,604,520,10,530,3
2020-12-01,Monterey,053,433212,17240,15835,306,16141,121
2020-12-01,Napa,055,140530,3739,3124,19,3143,19
2020-12-01,Nevada,057,99092,1751,1411,45,1456,9
2020-12-01,Orange,059,3164182,90061,79468,2769,82237,1567
2020-12-01,Placer,061,380077,8722,6794,192,6986,72
2020-12-01,Plumas,063,18699,259,201,0,201,0
2020-12-01,Riverside,065,2383286,104540,88530,2563,91093,1448
2020-12-01,Sacramento,067,1510023,42664,38966,170,39136,589
2020-12-01,San Benito,069,59416,2121,1888,15,1903,15
2020-12-01,San Bernardino,071,2135413,111933,95854,2169,98023,1220
2020-12-01,San Diego,073,3302833,92900,83423,3637,87060,1019
2020-12-01,San Francisco,075,870044,16957,15797,126,15923,157
2020-12-01,San Joaquin,077,732212,29427,26432,611,27043,514
2020-12-01,San Luis Obispo,079,281455,7064,6264,119,6383,40
2020-12-01,San Mateo,081,765935,16224,14495,17,14512,170
2020-12-01,Santa Barbara,083,443738,12402,11611,228,11839,140
2020-12-01,Santa Clara,085,1922200,41415,35397,113,35510,452
2020-12-01,Santa Cruz,087,273765,5378,4638,74,4712,27
2020-12-01,Shasta,089,179085,6108,5077,286,5363,47
2020-12-01,Sierra,091,2930,19,17,0,17,0
2020-12-01,Siskiyou,093,43540,740,608,47,655,1
2020-12-01,Solano,095,438530,11699,10604,87,10691,87
2020-12-01,Sonoma,097,501317,13588,12491,80,12571,163
2020-12-01,Stanislaus,099,539301,24171,22351,1630,23981,447
2020-12-01,Sutter,101,95872,4134,3538,14,3552,17
2020-12-01,Tehama,103,63373,1965,1773,72,1845,9
2020-12-01,Trinity,105,12862,298,165,32,197,0
2020-12-01,Tulare,107,460477,23515,21645,1807,23452,319
2020-12-01,Tuolumne,109,53932,1273,1052,5,1057,7
2020-12-01,Ventura,111,848112,23465,20604,732,21336,186
2020-12-01,Yolo,113,214977,5561,4928,19,4947,86
2020-12-01,Yuba,115,75493,2373,2088,16,2104,10
2020-11-30,Alameda,001,1643700,32978,29972,411,30383,457
2020-11-30,Alpine,003,1148,54,41,0,41,0
2020-11-30,Amador,005,37829,874,559,2,561,16
2020-11-30,Butte,007,227075,4536,4148,246,4394,65
2020-11-30,Calaveras,009,45235,580,478,0,478,21
2020-11-30,Colusa,011,21464,858,737,12,749,6
2020-11-30,Contra Costa,013,1133247,26452,24365,185,24550,264
2020-11-30,Del Norte,015,27424,400,339,0,339,2
2020-11-30,El Dorado,017,186661,3211,2488,39,2527,4
2020-11-30,Fresno,019,978130,44974,38712,1685,40397,500
2020-11-30,Glenn,021,27897,1085,954,57,1011,5
2020-11-30,Humboldt,023,135768,1037,870,4,874,9
2020-11-30,Imperial,025,180216,17034,16212,139,16351,356
2020-11-30,Inyo,027,18085,342,304,5,309,15
2020-11-30,Kern,029,883053,43981,40941,1623,42564,473
2020-11-30,Kings,031,150075,12120,11346,226,11572,85
2020-11-30,Lake,033,64148,1109,939,0,939,18
2020-11-30,Lassen,035,31185,2437,1793,8,1801,0
2020-11-30,Los Angeles,037,10098052,431415,396202,7199,403401,7658
2020-11-30,Madera,039,155013,7005,6210,179,6389,57
2020-11-30,Marin,041,260295,8032,7764,36,7800,136
2020-11-30,Mariposa,043,17540,151,123,2,125,2
2020-11-30,Mendocino,045,87422,1647,1482,10,1492,23
2020-11-30,Merced,047,269075,12752,11913,135,12048,172
2020-11-30,Modoc,049,8938,133,113,24,137,0
2020-11-30,Mono,051,14174,582,519,10,529,3
2020-11-30,Monterey,053,433212,16809,15837,298,16135,119
2020-11-30,Napa,055,140530,3639,3091,19,3110,18
2020-11-30,Nevada,057,99092,1665,1347,42,1389,9
2020-11-30,Orange,059,3164182,87950,78711,2673,81384,1568
2020-11-30,Placer,061,380077,8427,6575,179,6754,72
2020-11-30,Plumas,063,18699,248,192,0,192,0
2020-11-30,Riverside,065,2383286,101546,87722,2416,90138,1446
2020-11-30,Sacramento,067,1510023,41584,37834,161,37995,586
2020-11-30,San Benito,069,59416,2074,1875,14,1889,15
2020-11-30,San Bernardino,071,2135413,108203,92704,2057,94761,1220
2020-11-30,San Diego,073,3302833,90537,82045,3510,85555,997
2020-11-30,San Francisco,075,870044,16657,15638,123,15761,157
2020-11-30,San Joaquin,077,732212,28721,25742,585,26327,509
2020-11-30,San Luis Obispo,079,281455,6930,6224,117,6341,36
2020-11-30,San Mateo,081,765935,15864,14276,17,14293,170
2020-11-30,Santa Barbara,083,443738,12224,11572,220,11792,140
2020-11-30,Santa Clara,085,1922200,40207,35019,112,35131,451
2020-11-30,Santa Cruz,087,273765,5240,4558,70,4628,26
2020-11-30,Shasta,089,179085,5963,4933,257,5190,44
2020-11-30,Sierra,091,2930,19,16,0,16,0
2020-11-30,Siskiyou,093,43540,731,605,43,648,1
2020-11-30,Solano,095,438530,11437,10392,82,10474,87
2020-11-30,Sonoma,097,501317,13343,12232,76,12308,163
2020-11-30,Stanislaus,099,539301,23709,22110,1586,23696,446
2020-11-30,Sutter,101,95872,3977,3430,13,3443,16
2020-11-30,Tehama,103,63373,1918,1724,65,1789,9
2020-11-30,Trinity,105,12862,292,162,32,194,0
2020-11-30,Tulare,107,460477,23128,20833,1712,22545,319
2020-11-30,Tuolumne,109,53932,1229,1027,5,1032,7
2020-11-30,Ventura,111,848112,22709,20308,716,21024,180
2020-11-30,Yolo,113,214977,5449,4894,19,4913,81
2020-11-30,Yuba,115,75493,2312,2028,14,2042,10
2020-11-29,Alameda,001,1643700,32193,29918,388,30306,457
2020-11-29,Alpine,003,1148,51,41,0,41,0
2020-11-29,Amador,005,37829,723,548,2,550,16
2020-11-29,Butte,007,227075,4434,4008,229,4237,65
2020-11-29,Calaveras,009,45235,548,478,0,478,21
2020-11-29,Colusa,011,21464,829,723,8,731,6
2020-11-29,Contra Costa,013,1133247,25950,24165,179,24344,264
2020-11-29,Del Norte,015,27424,394,339,0,339,2
2020-11-29,El Dorado,017,186661,3080,2447,38,2485,4
2020-11-29,Fresno,019,978130,44022,38568,1613,40181,500
2020-11-29,Glenn,021,27897,1062,951,55,1006,4
2020-11-29,Humboldt,023,135768,1008,856,4,860,9
2020-11-29,Imperial,025,180216,16805,16138,111,16249,356
2020-11-29,Inyo,027,18085,327,289,5,294,15
2020-11-29,Kern,029,883053,43218,40596,1475,42071,473
2020-11-29,Kings,031,150075,11969,11247,208,11455,85
2020-11-29,Lake,033,64148,1085,927,0,927,18
2020-11-29,Lassen,035,31185,2334,1793,8,1801,0
2020-11-29,Los Angeles,037,10098052,421011,391162,6900,398062,7642
2020-11-29,Madera,039,155013,6862,6184,173,6357,57
2020-11-29,Marin,041,260295,7966,7739,33,7772,135
2020-11-29,Mariposa,043,17540,147,123,2,125,2
2020-11-29,Mendocino,045,87422,1613,1473,10,1483,23
2020-11-29,Merced,047,269075,12513,11773,126,11899,172
2020-11-29,Modoc,049,8938,129,105,22,127,0
2020-11-29,Mono,051,14174,559,515,9,524,3
2020-11-29,Monterey,053,433212,16497,15621,291,15912,119
2020-11-29,Napa,055,140530,3534,3090,18,3108,18
2020-11-29,Nevada,057,99092,1584,1311,40,1351,9
2020-11-29,Orange,059,3164182,85931,78057,2626,80683,1567
2020-11-29,Placer,061,380077,8130,6535,167,6702,72
2020-11-29,Plumas,063,18699,243,191,0,191,0
2020-11-29,Riverside,065,2383286,99153,87383,2263,89646,1442
2020-11-29,Sacramento,067,1510023,40505,37415,152,37567,585
2020-11-29,San Benito,069,59416,2030,1860,14,1874,15
2020-11-29,San Bernardino,071,2135413,104849,92052,1941,93993,1223
2020-11-29,San Diego,073,3302833,88126,81086,3357,84443,997
2020-11-29,San Francisco,075,870044,16376,15571,116,15687,153
2020-11-29,San Joaquin,077,732212,27979,25740,579,26319,509
2020-11-29,San Luis Obispo,079,281455,6807,6145,117,6262,36
2020-11-29,San Mateo,081,765935,15531,14177,17,14194,169
2020-11-29,Santa Barbara,083,443738,12069,11520,216,11736,140
2020-11-29,Santa Clara,085,1922200,39002,34234,106,34340,451
2020-11-29,Santa Cruz,087,273765,5081,4490,68,4558,26
2020-11-29,Shasta,089,179085,5791,4935,229,5164,43
2020-11-29,Sierra,091,2930,19,16,0,16,0
2020-11-29,Siskiyou,093,43540,708,590,41,631,1
2020-11-29,Solano,095,438530,11205,10393,78,10471,87
2020-11-29,Sonoma,097,501317,13091,12052,72,12124,163
2020-11-29,Stanislaus,099,539301,23213,21701,1552,23253,446
2020-11-29,Sutter,101,95872,3862,3297,13,3310,16
2020-11-29,Tehama,103,63373,1868,1710,49,1759,9
2020-11-29,Trinity,105,12862,289,159,30,189,0
2020-11-29,Tulare,107,460477,22759,20793,1636,22429,319
2020-11-29,Tuolumne,109,53932,1192,988,5,993,7
2020-11-29,Ventura,111,848112,22024,19952,703,20655,179
2020-11-29,Yolo,113,214977,5311,4830,18,4848,80
2020-11-29,Yuba,115,75493,2256,1959,14,1973,10
2020-11-28,Alameda,001,1643700,31883,29368,383,29751,456
2020-11-28,Alpine,003,1148,51,41,0,41,0
2020-11-28,Amador,005,37829,646,536,2,538,16
2020-11-28,Butte,007,227075,4376,3894,225,4119,65
2020-11-28,Calaveras,009,45235,544,478,0,478,21
2020-11-28,Colusa,011,21464,820,711,6,717,6
2020-11-28,Contra Costa,013,1133247,25617,23798,175,23973,264
2020-11-28,Del Norte,015,27424,384,328,0,328,2
2020-11-28,El Dorado,017,186661,3012,2415,32,2447,4
2020-11-28,Fresno,019,978130,43675,38288,1574,39862,500
2020-11-28,Glenn,021,27897,1051,925,51,976,4
2020-11-28,Humboldt,023,135768,973,844,4,848,9
2020-11-28,Imperial,025,180216,16740,16019,109,16128,356
2020-11-28,Inyo,027,18085,319,289,5,294,15
2020-11-28,Kern,029,883053,42855,40255,1387,41642,473
2020-11-28,Kings,031,150075,11904,11070,201,11271,85
2020-11-28,Lake,033,64148,1070,920,0,920,18
2020-11-28,Lassen,035,31185,2267,1714,8,1722,0
2020-11-28,Los Angeles,037,10098052,416095,386194,6742,392936,7625
2020-11-28,Madera,039,155013,6760,6119,166,6285,57
2020-11-28,Marin,041,260295,7936,7696,29,7725,135
2020-11-28,Mariposa,043,17540,144,120,2,122,2
2020-11-28,Mendocino,045,87422,1582,1458,10,1468,22
2020-11-28,Merced,047,269075,12415,11688,120,11808,172
2020-11-28,Modoc,049,8938,126,103,22,125,0
2020-11-28,Mono,051,14174,553,505,9,514,3
2020-11-28,Monterey,053,433212,16331,15328,287,15615,118
2020-11-28,Napa,055,140530,3482,3033,18,3051,18
2020-11-28,Nevada,057,99092,1556,1272,38,1310,9
2020-11-28,Orange,059,3164182,84834,76882,2579,79461,1568
2020-11-28,Placer,061,380077,7969,6497,164,6661,70
2020-11-28,Plumas,063,18699,236,188,0,188,0
2020-11-28,Riverside,065,2383286,97743,86854,2161,89015,1440
2020-11-28,Sacramento,067,1510023,39927,36905,148,37053,580
2020-11-28,San Benito,069,59416,1983,1835,14,1849,15
2020-11-28,San Bernardino,071,2135413,103450,91183,1843,93026,1224
2020-11-28,San Diego,073,3302833,86872,80020,3273,83293,997
2020-11-28,San Francisco,075,870044,16200,15450,108,15558,153
2020-11-28,San Joaquin,077,732212,27780,25742,564,26306,509
2020-11-28,San Luis Obispo,079,281455,6737,6106,113,6219,36
2020-11-28,San Mateo,081,765935,15340,14040,17,14057,169
2020-11-28,Santa Barbara,083,443738,11967,11481,211,11692,140
2020-11-28,Santa Clara,085,1922200,38258,33701,104,33805,449
2020-11-28,Santa Cruz,087,273765,5004,4426,68,4494,26
2020-11-28,Shasta,089,179085,5714,4882,222,5104,43
2020-11-28,Sierra,091,2930,19,16,0,16,0
2020-11-28,Siskiyou,093,43540,698,558,38,596,1
2020-11-28,Solano,095,438530,11086,10252,76,10328,87
2020-11-28,Sonoma,097,501317,12987,12008,63,12071,162
2020-11-28,Stanislaus,099,539301,22974,21574,1517,23091,446
2020-11-28,Sutter,101,95872,3778,3244,13,3257,15
2020-11-28,Tehama,103,63373,1851,1678,44,1722,9
2020-11-28,Trinity,105,12862,286,157,28,185,0
2020-11-28,Tulare,107,460477,22562,20701,1594,22295,319
2020-11-28,Tuolumne,109,53932,1170,976,5,981,7
2020-11-28,Ventura,111,848112,21726,19510,693,20203,179
2020-11-28,Yolo,113,214977,5237,4739,16,4755,80
2020-11-28,Yuba,115,75493,2203,1912,14,1926,10
2020-11-27,Alameda,001,1643700,31444,29064,372,29436,450
2020-11-27,Alpine,003,1148,51,41,0,41,0
2020-11-27,Amador,005,37829,599,498,1,499,16
2020-11-27,Butte,007,227075,4335,3894,219,4113,65
2020-11-27,Calaveras,009,45235,535,478,0,478,21
2020-11-27,Colusa,011,21464,803,694,4,698,6
2020-11-27,Contra Costa,013,1133247,25357,23463,169,23632,264
2020-11-27,Del Norte,015,27424,378,307,0,307,2
2020-11-27,El Dorado,017,186661,2941,2238,29,2267,4
2020-11-27,Fresno,019,978130,43269,37994,1516,39510,500
2020-11-27,Glenn,021,27897,1038,891,46,937,4
2020-11-27,Humboldt,023,135768,954,795,3,798,9
2020-11-27,Imperial,025,180216,16672,15960,100,16060,356
2020-11-27,Inyo,027,18085,313,289,5,294,15
2020-11-27,Kern,029,883053,42431,39707,1317,41024,473
2020-11-27,Kings,031,150075,11818,10667,183,10850,85
2020-11-27,Lake,033,64148,1034,909,0,909,18
2020-11-27,Lassen,035,31185,2255,1714,8,1722,0
2020-11-27,Los Angeles,037,10098052,409589,382740,6586,389326,7606
2020-11-27,Madera,039,155013,6688,6050,160,6210,57
2020-11-27,Marin,041,260295,7893,7660,29,7689,135
2020-11-27,Mariposa,043,17540,142,118,2,120,2
2020-11-27,Mendocino,045,87422,1568,1387,9,1396,22
2020-11-27,Merced,047,269075,12309,11550,113,11663,172
2020-11-27,Modoc,049,8938,125,100,22,122,0
2020-11-27,Mono,051,14174,549,498,9,507,3
2020-11-27,Monterey,053,433212,16163,14753,287,15040,113
2020-11-27,Napa,055,140530,3442,2988,18,3006,18
2020-11-27,Nevada,057,99092,1526,1184,36,1220,9
2020-11-27,Orange,059,3164182,83545,75151,2540,77691,1568
2020-11-27,Placer,061,380077,7808,6283,154,6437,68
2020-11-27,Plumas,063,18699,233,188,0,188,0
2020-11-27,Riverside,065,2383286,96132,85769,2008,87777,1440
2020-11-27,Sacramento,067,1510023,39305,36579,144,36723,579
2020-11-27,San Benito,069,59416,1949,1805,13,1818,15
2020-11-27,San Bernardino,071,2135413,101940,90254,1762,92016,1224
2020-11-27,San Diego,073,3302833,85678,78161,3184,81345,996
2020-11-27,San Francisco,075,870044,16044,15377,106,15483,153
2020-11-27,San Joaquin,077,732212,27559,25741,544,26285,509
2020-11-27,San Luis Obispo,079,281455,6654,6039,110,6149,36
2020-11-27,San Mateo,081,765935,15137,13872,16,13888,169
2020-11-27,Santa Barbara,083,443738,11874,11340,208,11548,140
2020-11-27,Santa Clara,085,1922200,37582,32935,97,33032,449
2020-11-27,Santa Cruz,087,273765,4933,4358,66,4424,26
2020-11-27,Shasta,089,179085,5637,4710,209,4919,43
2020-11-27,Sierra,091,2930,18,16,0,16,0
2020-11-27,Siskiyou,093,43540,683,554,35,589,1
2020-11-27,Solano,095,438530,10967,10044,73,10117,87
2020-11-27,Sonoma,097,501317,12854,11924,61,11985,162
2020-11-27,Stanislaus,099,539301,22746,21185,1487,22672,446
2020-11-27,Sutter,101,95872,3712,3101,13,3114,15
2020-11-27,Tehama,103,63373,1822,1649,40,1689,9
2020-11-27,Trinity,105,12862,282,151,28,179,0
2020-11-27,Tulare,107,460477,22374,20634,1537,22171,319
2020-11-27,Tuolumne,109,53932,1138,881,5,886,7
2020-11-27,Ventura,111,848112,21402,19379,671,20050,179
2020-11-27,Yolo,113,214977,5188,4737,16,4753,79
2020-11-27,Yuba,115,75493,2174,1864,13,1877,10
2020-11-26,Alameda,001,1643700,31033,28797,354,29151,447
2020-11-26,Alpine,003,1148,51,41,0,41,0
2020-11-26,Amador,005,37829,591,488,1,489,16
2020-11-26,Butte,007,227075,4272,3894,213,4107,65
2020-11-26,Calaveras,009,45235,507,478,0,478,21
2020-11-26,Colusa,011,21464,789,694,4,698,6
2020-11-26,Contra Costa,013,1133247,25023,23468,163,23631,264
2020-11-26,Del Norte,015,27424,367,307,0,307,2
2020-11-26,El Dorado,017,186661,2860,2217,27,2244,4
2020-11-26,Fresno,019,978130,42863,37724,1471,39195,500
2020-11-26,Glenn,021,27897,1022,892,44,936,4
2020-11-26,Humboldt,023,135768,931,795,2,797,9
2020-11-26,Imperial,025,180216,16563,15722,96,15818,355
2020-11-26,Inyo,027,18085,312,289,5,294,15
2020-11-26,Kern,029,883053,41981,39123,1255,40378,471
2020-11-26,Kings,031,150075,11763,10475,171,10646,85
2020-11-26,Lake,033,64148,1021,890,0,890,18
2020-11-26,Lassen,035,31185,2240,1714,8,1722,0
2020-11-26,Los Angeles,037,10098052,404435,378340,6350,384690,7581
2020-11-26,Madera,039,155013,6613,6003,154,6157,57
2020-11-26,Marin,041,260295,7856,7610,29,7639,135
2020-11-26,Mariposa,043,17540,137,116,2,118,2
2020-11-26,Mendocino,045,87422,1554,1387,7,1394,22
2020-11-26,Merced,047,269075,12161,11440,111,11551,172
2020-11-26,Modoc,049,8938,123,100,22,122,0
2020-11-26,Mono,051,14174,541,485,9,494,2
2020-11-26,Monterey,053,433212,15927,14750,279,15029,113
2020-11-26,Napa,055,140530,3378,2988,18,3006,18
2020-11-26,Nevada,057,99092,1480,1184,36,1220,9
2020-11-26,Orange,059,3164182,82157,74264,2478,76742,1563
2020-11-26,Placer,061,380077,7646,6278,145,6423,68
2020-11-26,Plumas,063,18699,225,188,0,188,0
2020-11-26,Riverside,065,2383286,94528,85774,1884,87658,1440
2020-11-26,Sacramento,067,1510023,38663,35854,136,35990,580
2020-11-26,San Benito,069,59416,1922,1769,13,1782,15
2020-11-26,San Bernardino,071,2135413,100292,89727,1670,91397,1223
2020-11-26,San Diego,073,3302833,84068,76359,3080,79439,996
2020-11-26,San Francisco,075,870044,15907,15156,103,15259,153
2020-11-26,San Joaquin,077,732212,27303,25738,532,26270,509
2020-11-26,San Luis Obispo,079,281455,6561,5964,107,6071,36
2020-11-26,San Mateo,081,765935,14948,13715,15,13730,169
2020-11-26,Santa Barbara,083,443738,11793,11277,207,11484,139
2020-11-26,Santa Clara,085,1922200,36940,32411,89,32500,446
2020-11-26,Santa Cruz,087,273765,4802,4269,60,4329,26
2020-11-26,Shasta,089,179085,5554,4712,198,4910,43
2020-11-26,Sierra,091,2930,18,15,0,15,0
2020-11-26,Siskiyou,093,43540,673,526,34,560,1
2020-11-26,Solano,095,438530,10824,9941,71,10012,87
2020-11-26,Sonoma,097,501317,12706,11922,59,11981,162
2020-11-26,Stanislaus,099,539301,22513,21186,1446,22632,445
2020-11-26,Sutter,101,95872,3618,3101,12,3113,15
2020-11-26,Tehama,103,63373,1780,1612,37,1649,9
2020-11-26,Trinity,105,12862,278,139,28,167,0
2020-11-26,Tulare,107,460477,22135,20649,1473,22122,319
2020-11-26,Tuolumne,109,53932,1110,871,5,876,7
2020-11-26,Ventura,111,848112,20906,19058,657,19715,179
2020-11-26,Yolo,113,214977,5101,4566,16,4582,76
2020-11-26,Yuba,115,75493,2114,1865,11,1876,10
2020-11-25,Alameda,001,1643700,30818,28378,346,28724,447
2020-11-25,Alpine,003,1148,51,41,0,41,0
2020-11-25,Amador,005,37829,581,484,1,485,16
2020-11-25,Butte,007,227075,4241,3848,210,4058,64
2020-11-25,Calaveras,009,45235,504,475,0,475,21
2020-11-25,Colusa,011,21464,772,693,4,697,6
2020-11-25,Contra Costa,013,1133247,24868,23307,162,23469,263
2020-11-25,Del Norte,015,27424,366,304,0,304,2
2020-11-25,El Dorado,017,186661,2824,2154,27,2181,4
2020-11-25,Fresno,019,978130,42630,37349,1449,38798,494
2020-11-25,Glenn,021,27897,1005,891,42,933,4
2020-11-25,Humboldt,023,135768,923,777,2,779,9
2020-11-25,Imperial,025,180216,16493,15640,94,15734,355
2020-11-25,Inyo,027,18085,310,289,5,294,15
2020-11-25,Kern,029,883053,41825,38878,1236,40114,467
2020-11-25,Kings,031,150075,11728,10417,167,10584,85
2020-11-25,Lake,033,64148,1004,878,0,878,18
2020-11-25,Lassen,035,31185,2197,1701,8,1709,0
2020-11-25,Los Angeles,037,10098052,401405,373919,6247,380166,7545
2020-11-25,Madera,039,155013,6591,5989,151,6140,57
2020-11-25,Marin,041,260295,7829,7601,28,7629,135
2020-11-25,Mariposa,043,17540,136,114,2,116,2
2020-11-25,Mendocino,045,87422,1535,1373,7,1380,22
2020-11-25,Merced,047,269075,12103,11346,111,11457,172
2020-11-25,Modoc,049,8938,123,96,22,118,0
2020-11-25,Mono,051,14174,536,487,9,496,2
2020-11-25,Monterey,053,433212,15810,14695,277,14972,113
2020-11-25,Napa,055,140530,3345,2945,18,2963,17
2020-11-25,Nevada,057,99092,1462,1170,34,1204,9
2020-11-25,Orange,059,3164182,81402,73014,2458,75472,1551
2020-11-25,Placer,061,380077,7570,6221,144,6365,68
2020-11-25,Plumas,063,18699,220,183,0,183,0
2020-11-25,Riverside,065,2383286,93984,85077,1866,86943,1438
2020-11-25,Sacramento,067,1510023,38326,35687,133,35820,574
2020-11-25,San Benito,069,59416,1899,1764,13,1777,15
2020-11-25,San Bernardino,071,2135413,99452,88469,1642,90111,1225
2020-11-25,San Diego,073,3302833,83411,75307,3044,78351,988
2020-11-25,San Francisco,075,870044,15802,15053,101,15154,153
2020-11-25,San Joaquin,077,732212,27176,25556,520,26076,515
2020-11-25,San Luis Obispo,079,281455,6518,5913,106,6019,34
2020-11-25,San Mateo,081,765935,14833,13614,15,13629,170
2020-11-25,Santa Barbara,083,443738,11743,11183,207,11390,138
2020-11-25,Santa Clara,085,1922200,36494,32032,88,32120,442
2020-11-25,Santa Cruz,087,273765,4750,4202,59,4261,25
2020-11-25,Shasta,089,179085,5508,4588,191,4779,43
2020-11-25,Sierra,091,2930,18,15,0,15,0
2020-11-25,Siskiyou,093,43540,666,499,34,533,1
2020-11-25,Solano,095,438530,10719,9832,70,9902,87
2020-11-25,Sonoma,097,501317,12643,11775,58,11833,162
2020-11-25,Stanislaus,099,539301,22382,21022,1419,22441,445
2020-11-25,Sutter,101,95872,3574,3064,12,3076,14
2020-11-25,Tehama,103,63373,1768,1587,32,1619,9
2020-11-25,Trinity,105,12862,276,135,28,163,0
2020-11-25,Tulare,107,460477,22045,20528,1442,21970,318
2020-11-25,Tuolumne,109,53932,1093,842,5,847,7
2020-11-25,Ventura,111,848112,20811,18914,651,19565,179
2020-11-25,Yolo,113,214977,5065,4527,16,4543,76
2020-11-25,Yuba,115,75493,2088,1840,11,1851,10
2020-11-24,Alameda,001,1643700,30339,28030,335,28365,444
2020-11-24,Alpine,003,1148,51,41,0,41,0
2020-11-24,Amador,005,37829,556,470,1,471,16
2020-11-24,Butte,007,227075,4156,3798,202,4000,63
2020-11-24,Calaveras,009,45235,497,466,0,466,21
2020-11-24,Colusa,011,21464,754,682,4,686,6
2020-11-24,Contra Costa,013,1133247,24515,23072,156,23228,259
2020-11-24,Del Norte,015,27424,357,298,0,298,2
2020-11-24,El Dorado,017,186661,2719,2005,26,2031,4
2020-11-24,Fresno,019,978130,42227,37021,1373,38394,493
2020-11-24,Glenn,021,27897,987,883,38,921,4
2020-11-24,Humboldt,023,135768,904,774,2,776,9
2020-11-24,Imperial,025,180216,16390,15600,89,15689,355
2020-11-24,Inyo,027,18085,309,282,5,287,15
2020-11-24,Kern,029,883053,41351,38551,1158,39709,465
2020-11-24,Kings,031,150075,11461,10338,154,10492,85
2020-11-24,Lake,033,64148,988,872,0,872,18
2020-11-24,Lassen,035,31185,2174,1657,8,1665,0
2020-11-24,Los Angeles,037,10098052,395095,370008,6010,376018,7501
2020-11-24,Madera,039,155013,6506,5881,145,6026,57
2020-11-24,Marin,041,260295,7782,7591,28,7619,135
2020-11-24,Mariposa,043,17540,126,114,1,115,2
2020-11-24,Mendocino,045,87422,1513,1346,6,1352,22
2020-11-24,Merced,047,269075,11914,11268,105,11373,171
2020-11-24,Modoc,049,8938,119,91,22,113,0
2020-11-24,Mono,051,14174,532,483,9,492,2
2020-11-24,Monterey,053,433212,15549,14354,265,14619,113
2020-11-24,Napa,055,140530,3279,2904,18,2922,17
2020-11-24,Nevada,057,99092,1398,1156,32,1188,9
2020-11-24,Orange,059,3164182,79959,71975,2378,74353,1547
2020-11-24,Placer,061,380077,7389,6147,137,6284,67
2020-11-24,Plumas,063,18699,217,180,0,180,0
2020-11-24,Riverside,065,2383286,92225,83685,1737,85422,1420
2020-11-24,Sacramento,067,1510023,37646,35097,126,35223,568
2020-11-24,San Benito,069,59416,1867,1740,12,1752,15
2020-11-24,San Bernardino,071,2135413,97115,86645,1541,88186,1226
2020-11-24,San Diego,073,3302833,82001,74363,2973,77336,984
2020-11-24,San Francisco,075,870044,15607,14874,97,14971,153
2020-11-24,San Joaquin,077,732212,26860,25318,492,25810,517
2020-11-24,San Luis Obispo,079,281455,6455,5805,105,5910,34
2020-11-24,San Mateo,081,765935,14624,13558,14,13572,170
2020-11-24,Santa Barbara,083,443738,11637,11154,205,11359,138
2020-11-24,Santa Clara,085,1922200,35703,31564,84,31648,438
2020-11-24,Santa Cruz,087,273765,4637,4132,58,4190,25
2020-11-24,Shasta,089,179085,5408,4410,172,4582,43
2020-11-24,Sierra,091,2930,18,15,0,15,0
2020-11-24,Siskiyou,093,43540,648,473,31,504,1
2020-11-24,Solano,095,438530,10548,9716,69,9785,86
2020-11-24,Sonoma,097,501317,12463,11644,55,11699,162
2020-11-24,Stanislaus,099,539301,22140,20830,1376,22206,438
2020-11-24,Sutter,101,95872,3468,2974,12,2986,14
2020-11-24,Tehama,103,63373,1718,1565,27,1592,9
2020-11-24,Trinity,105,12862,269,129,27,156,0
2020-11-24,Tulare,107,460477,21796,20319,1378,21697,315
2020-11-24,Tuolumne,109,53932,1064,832,5,837,7
2020-11-24,Ventura,111,848112,20429,18637,641,19278,179
2020-11-24,Yolo,113,214977,4981,4420,16,4436,76
2020-11-24,Yuba,115,75493,2037,1804,9,1813,10
2020-11-23,Alameda,001,1643700,29923,27718,323,28041,444
2020-11-23,Alpine,003,1148,49,41,0,41,0
2020-11-23,Amador,005,37829,515,457,1,458,16
2020-11-23,Butte,007,227075,4092,3765,196,3961,61
2020-11-23,Calaveras,009,45235,480,434,0,434,21
2020-11-23,Colusa,011,21464,740,662,4,666,6
2020-11-23,Contra Costa,013,1133247,24243,22674,151,22825,260
2020-11-23,Del Norte,015,27424,335,296,0,296,2
2020-11-23,El Dorado,017,186661,2599,2005,25,2030,4
2020-11-23,Fresno,019,978130,41778,36688,1310,37998,488
2020-11-23,Glenn,021,27897,961,853,38,891,4
2020-11-23,Humboldt,023,135768,891,746,2,748,9
2020-11-23,Imperial,025,180216,16220,15104,84,15188,355
2020-11-23,Inyo,027,18085,301,279,5,284,15
2020-11-23,Kern,029,883053,40838,38245,1095,39340,463
2020-11-23,Kings,031,150075,11041,10204,147,10351,85
2020-11-23,Lake,033,64148,965,840,0,840,18
2020-11-23,Lassen,035,31185,2094,1271,7,1278,0
2020-11-23,Los Angeles,037,10098052,388998,366374,5761,372135,7447
2020-11-23,Madera,039,155013,6380,5787,141,5928,56
2020-11-23,Marin,041,260295,7740,7543,28,7571,135
2020-11-23,Mariposa,043,17540,125,97,1,98,2
2020-11-23,Mendocino,045,87422,1483,1330,6,1336,22
2020-11-23,Merced,047,269075,11726,11148,102,11250,169
2020-11-23,Modoc,049,8938,105,91,21,112,0
2020-11-23,Mono,051,14174,519,480,9,489,2
2020-11-23,Monterey,053,433212,15270,14265,259,14524,112
2020-11-23,Napa,055,140530,3213,2811,17,2828,17
2020-11-23,Nevada,057,99092,1309,1087,32,1119,9
2020-11-23,Orange,059,3164182,78556,71074,2332,73406,1546
2020-11-23,Placer,061,380077,7187,5999,136,6135,66
2020-11-23,Plumas,063,18699,213,172,0,172,0
2020-11-23,Riverside,065,2383286,90446,82175,1672,83847,1415
2020-11-23,Sacramento,067,1510023,37076,34141,119,34260,556
2020-11-23,San Benito,069,59416,1839,1729,11,1740,15
2020-11-23,San Bernardino,071,2135413,95008,84387,1478,85865,1224
2020-11-23,San Diego,073,3302833,80539,72817,2885,75702,968
2020-11-23,San Francisco,075,870044,15449,14646,95,14741,153
2020-11-23,San Joaquin,077,732212,26511,24622,488,25110,517
2020-11-23,San Luis Obispo,079,281455,6373,5772,103,5875,34
2020-11-23,San Mateo,081,765935,14432,13364,14,13378,170
2020-11-23,Santa Barbara,083,443738,11530,10944,201,11145,137
2020-11-23,Santa Clara,085,1922200,35053,31064,81,31145,435
2020-11-23,Santa Cruz,087,273765,4527,4003,54,4057,25
2020-11-23,Shasta,089,179085,5290,4100,160,4260,43
2020-11-23,Sierra,091,2930,17,15,0,15,0
2020-11-23,Siskiyou,093,43540,621,460,30,490,0
2020-11-23,Solano,095,438530,10391,9394,66,9460,86
2020-11-23,Sonoma,097,501317,12290,11507,51,11558,160
2020-11-23,Stanislaus,099,539301,21847,20487,1343,21830,436
2020-11-23,Sutter,101,95872,3331,2840,11,2851,14
2020-11-23,Tehama,103,63373,1670,1526,24,1550,9
2020-11-23,Trinity,105,12862,260,120,25,145,0
2020-11-23,Tulare,107,460477,21502,19818,1312,21130,315
2020-11-23,Tuolumne,109,53932,1024,774,5,779,7
2020-11-23,Ventura,111,848112,20054,18480,628,19108,179
2020-11-23,Yolo,113,214977,4901,4265,15,4280,75
2020-11-23,Yuba,115,75493,1970,1702,9,1711,10
2020-11-22,Alameda,001,1643700,29486,27472,312,27784,444
2020-11-22,Alpine,003,1148,46,41,0,41,0
2020-11-22,Amador,005,37829,503,450,1,451,16
2020-11-22,Butte,007,227075,4041,3712,189,3901,61
2020-11-22,Calaveras,009,45235,468,434,0,434,21
2020-11-22,Colusa,011,21464,722,642,3,645,6
2020-11-22,Contra Costa,013,1133247,23938,22407,146,22553,260
2020-11-22,Del Norte,015,27424,311,271,0,271,2
2020-11-22,El Dorado,017,186661,2489,1917,22,1939,4
2020-11-22,Fresno,019,978130,41295,36315,1255,37570,488
2020-11-22,Glenn,021,27897,939,832,34,866,4
2020-11-22,Humboldt,023,135768,875,729,2,731,9
2020-11-22,Imperial,025,180216,16015,15109,39,15148,355
2020-11-22,Inyo,027,18085,295,279,5,284,15
2020-11-22,Kern,029,883053,40259,37904,1061,38965,463
2020-11-22,Kings,031,150075,10940,10035,138,10173,85
2020-11-22,Lake,033,64148,943,834,0,834,18
2020-11-22,Lassen,035,31185,1929,1211,6,1217,0
2020-11-22,Los Angeles,037,10098052,382719,360341,5512,365853,7438
2020-11-22,Madera,039,155013,6300,5745,130,5875,56
2020-11-22,Marin,041,260295,7705,7506,27,7533,135
2020-11-22,Mariposa,043,17540,124,95,1,96,2
2020-11-22,Mendocino,045,87422,1459,1285,5,1290,22
2020-11-22,Merced,047,269075,11577,10939,102,11041,169
2020-11-22,Modoc,049,8938,104,87,19,106,0
2020-11-22,Mono,051,14174,504,481,9,490,2
2020-11-22,Monterey,053,433212,15028,13887,253,14140,111
2020-11-22,Napa,055,140530,3132,2778,17,2795,17
2020-11-22,Nevada,057,99092,1251,1052,32,1084,9
2020-11-22,Orange,059,3164182,77143,69913,2293,72206,1546
2020-11-22,Placer,061,380077,6960,5880,126,6006,66
2020-11-22,Plumas,063,18699,200,172,0,172,0
2020-11-22,Riverside,065,2383286,88851,81565,1611,83176,1409
2020-11-22,Sacramento,067,1510023,36344,33421,106,33527,555
2020-11-22,San Benito,069,59416,1810,1704,11,1715,15
2020-11-22,San Bernardino,071,2135413,92665,83505,1408,84913,1224
2020-11-22,San Diego,073,3302833,78802,71649,2810,74459,968
2020-11-22,San Francisco,075,870044,15278,14515,94,14609,153
2020-11-22,San Joaquin,077,732212,26212,24619,476,25095,517
2020-11-22,San Luis Obispo,079,281455,6265,5664,102,5766,34
2020-11-22,San Mateo,081,765935,14226,13228,14,13242,170
2020-11-22,Santa Barbara,083,443738,11395,10946,196,11142,137
2020-11-22,Santa Clara,085,1922200,34375,30633,79,30712,434
2020-11-22,Santa Cruz,087,273765,4445,3896,47,3943,25
2020-11-22,Shasta,089,179085,5134,4100,142,4242,43
2020-11-22,Sierra,091,2930,17,13,0,13,0
2020-11-22,Siskiyou,093,43540,589,411,30,441,0
2020-11-22,Solano,095,438530,10220,9363,62,9425,86
2020-11-22,Sonoma,097,501317,12132,11415,49,11464,159
2020-11-22,Stanislaus,099,539301,21520,20223,1313,21536,436
2020-11-22,Sutter,101,95872,3214,2677,11,2688,13
2020-11-22,Tehama,103,63373,1637,1457,19,1476,9
2020-11-22,Trinity,105,12862,254,114,25,139,0
2020-11-22,Tulare,107,460477,21250,19818,1242,21060,314
2020-11-22,Tuolumne,109,53932,998,689,5,694,7
2020-11-22,Ventura,111,848112,19693,18105,614,18719,179
2020-11-22,Yolo,113,214977,4801,4206,15,4221,75
2020-11-22,Yuba,115,75493,1917,1672,9,1681,10
2020-11-21,Alameda,001,1643700,29299,27424,310,27734,444
2020-11-21,Alpine,003,1148,46,41,0,41,0
2020-11-21,Amador,005,37829,489,450,1,451,16
2020-11-21,Butte,007,227075,3993,3664,186,3850,61
2020-11-21,Calaveras,009,45235,462,434,0,434,21
2020-11-21,Colusa,011,21464,713,642,3,645,6
2020-11-21,Contra Costa,013,1133247,23785,22338,144,22482,260
2020-11-21,Del Norte,015,27424,306,271,0,271,2
2020-11-21,El Dorado,017,186661,2440,1900,21,1921,4
2020-11-21,Fresno,019,978130,41039,35973,1221,37194,482
2020-11-21,Glenn,021,27897,934,829,32,861,4
2020-11-21,Humboldt,023,135768,865,728,2,730,9
2020-11-21,Imperial,025,180216,15938,15053,39,15092,355
2020-11-21,Inyo,027,18085,293,283,5,288,15
2020-11-21,Kern,029,883053,40003,37403,1026,38429,463
2020-11-21,Kings,031,150075,10892,10019,134,10153,85
2020-11-21,Lake,033,64148,930,832,0,832,18
2020-11-21,Lassen,035,31185,1862,1211,6,1217,0
2020-11-21,Los Angeles,037,10098052,379539,357754,5366,363120,7428
2020-11-21,Madera,039,155013,6263,5706,130,5836,56
2020-11-21,Marin,041,260295,7682,7488,26,7514,134
2020-11-21,Mariposa,043,17540,124,92,1,93,2
2020-11-21,Mendocino,045,87422,1428,1282,5,1287,22
2020-11-21,Merced,047,269075,11516,10849,101,10950,169
2020-11-21,Modoc,049,8938,100,87,18,105,0
2020-11-21,Mono,051,14174,499,469,9,478,2
2020-11-21,Monterey,053,433212,14930,13886,248,14134,110
2020-11-21,Napa,055,140530,3098,2757,17,2774,17
2020-11-21,Nevada,057,99092,1239,1018,31,1049,9
2020-11-21,Orange,059,3164182,76341,69021,2263,71284,1543
2020-11-21,Placer,061,380077,6846,5778,123,5901,65
2020-11-21,Plumas,063,18699,195,172,0,172,0
2020-11-21,Riverside,065,2383286,88074,80676,1565,82241,1407
2020-11-21,Sacramento,067,1510023,35948,33133,98,33231,548
2020-11-21,San Benito,069,59416,1791,1691,11,1702,15
2020-11-21,San Bernardino,071,2135413,91789,83206,1332,84538,1222
2020-11-21,San Diego,073,3302833,78023,70711,2755,73466,966
2020-11-21,San Francisco,075,870044,15175,14445,93,14538,153
2020-11-21,San Joaquin,077,732212,26079,24620,461,25081,517
2020-11-21,San Luis Obispo,079,281455,6212,5618,99,5717,34
2020-11-21,San Mateo,081,765935,14124,13138,14,13152,170
2020-11-21,Santa Barbara,083,443738,11343,10922,193,11115,137
2020-11-21,Santa Clara,085,1922200,33991,30377,76,30453,433
2020-11-21,Santa Cruz,087,273765,4388,3898,47,3945,25
2020-11-21,Shasta,089,179085,5060,4095,139,4234,42
2020-11-21,Sierra,091,2930,17,13,0,13,0
2020-11-21,Siskiyou,093,43540,573,403,30,433,0
2020-11-21,Solano,095,438530,10130,9290,59,9349,86
2020-11-21,Sonoma,097,501317,12057,11394,47,11441,158
2020-11-21,Stanislaus,099,539301,21377,20111,1288,21399,435
2020-11-21,Sutter,101,95872,3154,2615,10,2625,13
2020-11-21,Tehama,103,63373,1617,1435,18,1453,9
2020-11-21,Trinity,105,12862,251,110,24,134,0
2020-11-21,Tulare,107,460477,21124,19752,1208,20960,313
2020-11-21,Tuolumne,109,53932,979,690,5,695,7
2020-11-21,Ventura,111,848112,19529,18040,604,18644,177
2020-11-21,Yolo,113,214977,4727,4147,14,4161,75
2020-11-21,Yuba,115,75493,1885,1643,9,1652,10
2020-11-20,Alameda,001,1643700,29085,27221,303,27524,444
2020-11-20,Alpine,003,1148,46,20,0,20,0
2020-11-20,Amador,005,37829,485,446,1,447,16
2020-11-20,Butte,007,227075,3961,3618,182,3800,60
2020-11-20,Calaveras,009,45235,450,424,0,424,21
2020-11-20,Colusa,011,21464,705,631,2,633,6
2020-11-20,Contra Costa,013,1133247,23599,22116,140,22256,260
2020-11-20,Del Norte,015,27424,302,264,0,264,2
2020-11-20,El Dorado,017,186661,2344,1868,19,1887,4
2020-11-20,Fresno,019,978130,40745,35635,1191,36826,480
2020-11-20,Glenn,021,27897,922,826,30,856,4
2020-11-20,Humboldt,023,135768,856,714,1,715,9
2020-11-20,Imperial,025,180216,15876,14864,35,14899,353
2020-11-20,Inyo,027,18085,291,262,5,267,15
2020-11-20,Kern,029,883053,39709,37143,1000,38143,462
2020-11-20,Kings,031,150075,10844,9903,133,10036,85
2020-11-20,Lake,033,64148,921,820,0,820,18
2020-11-20,Lassen,035,31185,1777,1212,5,1217,0
2020-11-20,Los Angeles,037,10098052,375655,353554,5203,358757,7398
2020-11-20,Madera,039,155013,6170,5635,129,5764,54
2020-11-20,Marin,041,260295,7658,7467,25,7492,134
2020-11-20,Mariposa,043,17540,116,89,1,90,2
2020-11-20,Mendocino,045,87422,1408,1269,5,1274,22
2020-11-20,Merced,047,269075,11430,10729,101,10830,167
2020-11-20,Modoc,049,8938,100,83,18,101,0
2020-11-20,Mono,051,14174,497,469,9,478,2
2020-11-20,Monterey,053,433212,14805,13738,239,13977,110
2020-11-20,Napa,055,140530,3068,2718,17,2735,17
2020-11-20,Nevada,057,99092,1221,990,30,1020,9
2020-11-20,Orange,059,3164182,75504,68212,2225,70437,1532
2020-11-20,Placer,061,380077,6711,5687,108,5795,66
2020-11-20,Plumas,063,18699,193,163,0,163,0
2020-11-20,Riverside,065,2383286,87063,79613,1502,81115,1405
2020-11-20,Sacramento,067,1510023,35572,32832,91,32923,549
2020-11-20,San Benito,069,59416,1779,1668,11,1679,15
2020-11-20,San Bernardino,071,2135413,90423,81203,1251,82454,1220
2020-11-20,San Diego,073,3302833,77025,69233,2673,71906,960
2020-11-20,San Francisco,075,870044,15071,14327,92,14419,153
2020-11-20,San Joaquin,077,732212,25926,24460,448,24908,515
2020-11-20,San Luis Obispo,079,281455,6156,5524,96,5620,34
2020-11-20,San Mateo,081,765935,13991,12980,13,12993,169
2020-11-20,Santa Barbara,083,443738,11287,10825,187,11012,136
2020-11-20,Santa Clara,085,1922200,33569,30002,71,30073,431
2020-11-20,Santa Cruz,087,273765,4322,3815,47,3862,25
2020-11-20,Shasta,089,179085,4987,3861,134,3995,42
2020-11-20,Sierra,091,2930,17,12,0,12,0
2020-11-20,Siskiyou,093,43540,560,387,29,416,0
2020-11-20,Solano,095,438530,10038,9216,57,9273,85
2020-11-20,Sonoma,097,501317,11973,11316,46,11362,158
2020-11-20,Stanislaus,099,539301,21222,19889,1262,21151,433
2020-11-20,Sutter,101,95872,3104,2580,10,2590,13
2020-11-20,Tehama,103,63373,1602,1410,15,1425,9
2020-11-20,Trinity,105,12862,250,102,24,126,0
2020-11-20,Tulare,107,460477,20991,19568,1169,20737,311
2020-11-20,Tuolumne,109,53932,940,662,5,667,7
2020-11-20,Ventura,111,848112,19361,17741,576,18317,175
2020-11-20,Yolo,113,214977,4649,4081,13,4094,74
2020-11-20,Yuba,115,75493,1857,1611,9,1620,10
2020-11-19,Alameda,001,1643700,28739,26971,295,27266,441
2020-11-19,Alpine,003,1148,43,20,0,20,0
2020-11-19,Amador,005,37829,481,436,1,437,16
2020-11-19,Butte,007,227075,3912,3576,175,3751,60
2020-11-19,Calaveras,009,45235,440,417,0,417,21
2020-11-19,Colusa,011,21464,687,621,2,623,6
2020-11-19,Contra Costa,013,1133247,23327,21886,137,22023,259
2020-11-19,Del Norte,015,27424,294,251,0,251,2
2020-11-19,El Dorado,017,186661,2270,1825,18,1843,4
2020-11-19,Fresno,019,978130,40295,35278,1134,36412,478
2020-11-19,Glenn,021,27897,900,806,29,835,4
2020-11-19,Humboldt,023,135768,836,693,1,694,9
2020-11-19,Imperial,025,180216,15667,14507,35,14542,349
2020-11-19,Inyo,027,18085,289,262,5,267,15
2020-11-19,Kern,029,883053,39288,36779,958,37737,459
2020-11-19,Kings,031,150075,10696,9763,125,9888,85
2020-11-19,Lake,033,64148,907,809,0,809,18
2020-11-19,Lassen,035,31185,1660,1201,3,1204,0
2020-11-19,Los Angeles,037,10098052,370633,349493,5033,354526,7365
2020-11-19,Madera,039,155013,6098,5540,121,5661,54
2020-11-19,Marin,041,260295,7627,7451,25,7476,134
2020-11-19,Mariposa,043,17540,109,88,0,88,2
2020-11-19,Mendocino,045,87422,1387,1237,5,1242,23
2020-11-19,Merced,047,269075,11289,10634,95,10729,167
2020-11-19,Modoc,049,8938,97,82,18,100,0
2020-11-19,Mono,051,14174,489,468,9,477,2
2020-11-19,Monterey,053,433212,14590,13369,227,13596,108
2020-11-19,Napa,055,140530,3014,2641,17,2658,17
2020-11-19,Nevada,057,99092,1180,945,29,974,9
2020-11-19,Orange,059,3164182,74241,66998,2180,69178,1530
2020-11-19,Placer,061,380077,6520,5612,107,5719,65
2020-11-19,Plumas,063,18699,188,158,0,158,0
2020-11-19,Riverside,065,2383286,85578,78535,1431,79966,1402
2020-11-19,Sacramento,067,1510023,35058,32367,89,32456,546
2020-11-19,San Benito,069,59416,1756,1643,11,1654,15
2020-11-19,San Bernardino,071,2135413,88525,79244,1171,80415,1215
2020-11-19,San Diego,073,3302833,75775,68142,2569,70711,952
2020-11-19,San Francisco,075,870044,14914,14178,86,14264,153
2020-11-19,San Joaquin,077,732212,25606,24270,437,24707,516
2020-11-19,San Luis Obispo,079,281455,6079,5410,92,5502,34
2020-11-19,San Mateo,081,765935,13853,12714,13,12727,169
2020-11-19,Santa Barbara,083,443738,11207,10741,184,10925,136
2020-11-19,Santa Clara,085,1922200,33011,29630,70,29700,424
2020-11-19,Santa Cruz,087,273765,4232,3679,45,3724,25
2020-11-19,Shasta,089,179085,4849,3685,124,3809,42
2020-11-19,Sierra,091,2930,17,11,0,11,0
2020-11-19,Siskiyou,093,43540,535,360,28,388,0
2020-11-19,Solano,095,438530,9901,9093,53,9146,84
2020-11-19,Sonoma,097,501317,11803,11205,44,11249,156
2020-11-19,Stanislaus,099,539301,20982,19736,1220,20956,433
2020-11-19,Sutter,101,95872,3005,2509,10,2519,13
2020-11-19,Tehama,103,63373,1569,1373,12,1385,9
2020-11-19,Trinity,105,12862,244,97,24,121,0
2020-11-19,Tulare,107,460477,20769,19384,1104,20488,304
2020-11-19,Tuolumne,109,53932,907,602,5,607,7
2020-11-19,Ventura,111,848112,19008,17300,563,17863,174
2020-11-19,Yolo,113,214977,4554,3973,13,3986,72
2020-11-19,Yuba,115,75493,1817,1568,9,1577,10
2020-11-18,Alameda,001,1643700,28476,26610,290,26900,440
2020-11-18,Alpine,003,1148,42,16,0,16,0
2020-11-18,Amador,005,37829,476,430,1,431,16
2020-11-18,Butte,007,227075,3859,3537,162,3699,59
2020-11-18,Calaveras,009,45235,436,409,0,409,21
2020-11-18,Colusa,011,21464,674,611,2,613,6
2020-11-18,Contra Costa,013,1133247,23060,21685,133,21818,258
2020-11-18,Del Norte,015,27424,281,240,0,240,2
2020-11-18,El Dorado,017,186661,2182,1799,17,1816,4
2020-11-18,Fresno,019,978130,39855,34997,1083,36080,474
2020-11-18,Glenn,021,27897,883,803,27,830,4
2020-11-18,Humboldt,023,135768,822,690,1,691,9
2020-11-18,Imperial,025,180216,15445,14428,35,14463,348
2020-11-18,Inyo,027,18085,287,262,5,267,15
2020-11-18,Kern,029,883053,38899,36537,908,37445,456
2020-11-18,Kings,031,150075,10548,9696,122,9818,85
2020-11-18,Lake,033,64148,894,802,0,802,18
2020-11-18,Lassen,035,31185,1560,1124,3,1127,0
2020-11-18,Los Angeles,037,10098052,365767,344675,4848,349523,7338
2020-11-18,Madera,039,155013,6011,5519,109,5628,54
2020-11-18,Marin,041,260295,7603,7435,25,7460,134
2020-11-18,Mariposa,043,17540,106,88,0,88,2
2020-11-18,Mendocino,045,87422,1367,1237,5,1242,23
2020-11-18,Merced,047,269075,11173,10536,94,10630,166
2020-11-18,Modoc,049,8938,94,77,18,95,0
2020-11-18,Mono,051,14174,484,468,9,477,2
2020-11-18,Monterey,053,433212,14395,13340,213,13553,108
2020-11-18,Napa,055,140530,2968,2607,17,2624,17
2020-11-18,Nevada,057,99092,1140,933,27,960,9
2020-11-18,Orange,059,3164182,73143,66381,2155,68536,1521
2020-11-18,Placer,061,380077,6342,5543,102,5645,64
2020-11-18,Plumas,063,18699,183,143,0,143,0
2020-11-18,Riverside,065,2383286,84113,77739,1328,79067,1387
2020-11-18,Sacramento,067,1510023,34433,31816,81,31897,541
2020-11-18,San Benito,069,59416,1731,1632,10,1642,15
2020-11-18,San Bernardino,071,2135413,86767,77400,1091,78491,1206
2020-11-18,San Diego,073,3302833,74481,67243,2509,69752,945
2020-11-18,San Francisco,075,870044,14770,14057,84,14141,153
2020-11-18,San Joaquin,077,732212,25340,24146,422,24568,517
2020-11-18,San Luis Obispo,079,281455,6003,5322,91,5413,34
2020-11-18,San Mateo,081,765935,13700,12631,12,12643,169
2020-11-18,Santa Barbara,083,443738,11128,10684,177,10861,136
2020-11-18,Santa Clara,085,1922200,32546,29285,65,29350,421
2020-11-18,Santa Cruz,087,273765,4140,3618,43,3661,25
2020-11-18,Shasta,089,179085,4715,3547,120,3667,42
2020-11-18,Sierra,091,2930,17,11,0,11,0
2020-11-18,Siskiyou,093,43540,503,351,27,378,0
2020-11-18,Solano,095,438530,9769,8994,51,9045,84
2020-11-18,Sonoma,097,501317,11696,11129,41,11170,155
2020-11-18,Stanislaus,099,539301,20739,19609,1195,20804,431
2020-11-18,Sutter,101,95872,2887,2442,10,2452,13
2020-11-18,Tehama,103,63373,1531,1338,12,1350,8
2020-11-18,Trinity,105,12862,230,95,23,118,0
2020-11-18,Tulare,107,460477,20559,19286,1053,20339,306
2020-11-18,Tuolumne,109,53932,872,590,5,595,7
2020-11-18,Ventura,111,848112,18683,17169,548,17717,173
2020-11-18,Yolo,113,214977,4480,3929,13,3942,71
2020-11-18,Yuba,115,75493,1763,1540,9,1549,10
2020-11-17,Alameda,001,1643700,28149,26425,280,26705,439
2020-11-17,Alpine,003,1148,40,12,0,12,0
2020-11-17,Amador,005,37829,465,423,1,424,16
2020-11-17,Butte,007,227075,3817,3500,152,3652,59
2020-11-17,Calaveras,009,45235,421,405,0,405,21
2020-11-17,Colusa,011,21464,663,606,1,607,6
2020-11-17,Contra Costa,013,1133247,22787,21557,128,21685,256
2020-11-17,Del Norte,015,27424,275,233,0,233,2
2020-11-17,El Dorado,017,186661,2123,1758,17,1775,4
2020-11-17,Fresno,019,978130,39257,34765,1024,35789,472
2020-11-17,Glenn,021,27897,872,795,26,821,4
2020-11-17,Humboldt,023,135768,800,685,1,686,9
2020-11-17,Imperial,025,180216,15209,14204,33,14237,346
2020-11-17,Inyo,027,18085,286,263,5,268,15
2020-11-17,Kern,029,883053,38449,36164,855,37019,455
2020-11-17,Kings,031,150075,10475,9653,115,9768,85
2020-11-17,Lake,033,64148,874,792,0,792,18
2020-11-17,Lassen,035,31185,1481,1124,3,1127,0
2020-11-17,Los Angeles,037,10098052,360823,340933,4684,345617,7302
2020-11-17,Madera,039,155013,5922,5485,102,5587,54
2020-11-17,Marin,041,260295,7571,7404,24,7428,134
2020-11-17,Mariposa,043,17540,103,87,0,87,2
2020-11-17,Mendocino,045,87422,1346,1216,5,1221,23
2020-11-17,Merced,047,269075,11029,10457,87,10544,162
2020-11-17,Modoc,049,8938,88,71,17,88,0
2020-11-17,Mono,051,14174,479,459,9,468,2
2020-11-17,Monterey,053,433212,14166,13220,203,13423,108
2020-11-17,Napa,055,140530,2914,2568,17,2585,17
2020-11-17,Nevada,057,99092,1099,918,26,944,9
2020-11-17,Orange,059,3164182,71993,65757,2128,67885,1519
2020-11-17,Placer,061,380077,6180,5435,96,5531,63
2020-11-17,Plumas,063,18699,175,142,0,142,0
2020-11-17,Riverside,065,2383286,82726,77079,1237,78316,1379
2020-11-17,Sacramento,067,1510023,33834,31341,77,31418,538
2020-11-17,San Benito,069,59416,1715,1611,4,1615,15
2020-11-17,San Bernardino,071,2135413,84953,76134,1001,77135,1188
2020-11-17,San Diego,073,3302833,73228,66321,2453,68774,933
2020-11-17,San Francisco,075,870044,14604,13952,83,14035,153
2020-11-17,San Joaquin,077,732212,25068,23997,402,24399,516
2020-11-17,San Luis Obispo,079,281455,5907,5235,91,5326,34
2020-11-17,San Mateo,081,765935,13538,12491,11,12502,169
2020-11-17,Santa Barbara,083,443738,11043,10597,172,10769,136
2020-11-17,Santa Clara,085,1922200,31999,29013,64,29077,419
2020-11-17,Santa Cruz,087,273765,4055,3548,40,3588,25
2020-11-17,Shasta,089,179085,4557,3457,108,3565,40
2020-11-17,Sierra,091,2930,15,11,0,11,0
2020-11-17,Siskiyou,093,43540,455,333,26,359,0
2020-11-17,Solano,095,438530,9624,8905,50,8955,84
2020-11-17,Sonoma,097,501317,11562,11084,40,11124,155
2020-11-17,Stanislaus,099,539301,20515,19466,1167,20633,425
2020-11-17,Sutter,101,95872,2804,2370,9,2379,12
2020-11-17,Tehama,103,63373,1480,1290,12,1302,7
2020-11-17,Trinity,105,12862,213,83,23,106,0
2020-11-17,Tulare,107,460477,20328,19176,991,20167,305
2020-11-17,Tuolumne,109,53932,834,568,5,573,7
2020-11-17,Ventura,111,848112,18411,16797,530,17327,173
2020-11-17,Yolo,113,214977,4303,3887,12,3899,70
2020-11-17,Yuba,115,75493,1715,1519,9,1528,10
2020-11-16,Alameda,001,1643700,27802,26063,275,26338,436
2020-11-16,Alpine,003,1148,37,12,0,12,0
2020-11-16,Amador,005,37829,457,414,1,415,16
2020-11-16,Butte,007,227075,3778,3490,144,3634,58
2020-11-16,Calaveras,009,45235,413,402,0,402,21
2020-11-16,Colusa,011,21464,654,601,1,602,6
2020-11-16,Contra Costa,013,1133247,22520,21386,123,21509,256
2020-11-16,Del Norte,015,27424,268,225,0,225,2
2020-11-16,El Dorado,017,186661,2063,1694,15,1709,4
2020-11-16,Fresno,019,978130,38767,34593,970,35563,471
2020-11-16,Glenn,021,27897,860,786,25,811,4
2020-11-16,Humboldt,023,135768,784,660,1,661,9
2020-11-16,Imperial,025,180216,14961,14111,33,14144,346
2020-11-16,Inyo,027,18085,283,263,5,268,15
2020-11-16,Kern,029,883053,38055,36049,812,36861,455
2020-11-16,Kings,031,150075,10208,9569,111,9680,85
2020-11-16,Lake,033,64148,862,784,0,784,18
2020-11-16,Lassen,035,31185,1300,1124,3,1127,0
2020-11-16,Los Angeles,037,10098052,356077,338778,4510,343288,7277
2020-11-16,Madera,039,155013,5835,5433,96,5529,54
2020-11-16,Marin,041,260295,7542,7359,24,7383,134
2020-11-16,Mariposa,043,17540,100,86,0,86,2
2020-11-16,Mendocino,045,87422,1321,1209,5,1214,23
2020-11-16,Merced,047,269075,10891,10399,84,10483,162
2020-11-16,Modoc,049,8938,86,71,17,88,0
2020-11-16,Mono,051,14174,477,453,9,462,2
2020-11-16,Monterey,053,433212,13920,13089,193,13282,107
2020-11-16,Napa,055,140530,2838,2536,17,2553,17
2020-11-16,Nevada,057,99092,1056,889,24,913,9
2020-11-16,Orange,059,3164182,70896,65396,2114,67510,1519
2020-11-16,Placer,061,380077,6060,5387,87,5474,63
2020-11-16,Plumas,063,18699,168,127,0,127,0
2020-11-16,Riverside,065,2383286,81351,76449,1172,77621,1379
2020-11-16,Sacramento,067,1510023,33196,30954,70,31024,534
2020-11-16,San Benito,069,59416,1697,1603,3,1606,15
2020-11-16,San Bernardino,071,2135413,83124,74401,932,75333,1186
2020-11-16,San Diego,073,3302833,71917,65603,2381,67984,926
2020-11-16,San Francisco,075,870044,14445,13847,80,13927,153
2020-11-16,San Joaquin,077,732212,24780,23515,393,23908,513
2020-11-16,San Luis Obispo,079,281455,5804,5161,86,5247,34
2020-11-16,San Mateo,081,765935,13378,12398,11,12409,169
2020-11-16,Santa Barbara,083,443738,10978,10565,168,10733,135
2020-11-16,Santa Clara,085,1922200,31433,28673,63,28736,419
2020-11-16,Santa Cruz,087,273765,3982,3520,40,3560,25
2020-11-16,Shasta,089,179085,4409,3284,103,3387,37
2020-11-16,Sierra,091,2930,15,11,0,11,0
2020-11-16,Siskiyou,093,43540,428,294,26,320,0
2020-11-16,Solano,095,438530,9425,8827,50,8877,84
2020-11-16,Sonoma,097,501317,11471,10961,39,11000,155
2020-11-16,Stanislaus,099,539301,20279,19333,1140,20473,425
2020-11-16,Sutter,101,95872,2698,2322,9,2331,12
2020-11-16,Tehama,103,63373,1435,1261,8,1269,7
2020-11-16,Trinity,105,12862,201,67,23,90,0
2020-11-16,Tulare,107,460477,20149,18891,937,19828,305
2020-11-16,Tuolumne,109,53932,798,543,5,548,7
2020-11-16,Ventura,111,848112,18073,16691,522,17213,172
2020-11-16,Yolo,113,214977,4207,3858,12,3870,70
2020-11-16,Yuba,115,75493,1679,1500,8,1508,10
2020-11-15,Alameda,001,1643700,27484,25879,269,26148,436
2020-11-15,Alpine,003,1148,35,12,0,12,0
2020-11-15,Amador,005,37829,445,409,1,410,16
2020-11-15,Butte,007,227075,3724,3452,135,3587,58
2020-11-15,Calaveras,009,45235,399,386,0,386,21
2020-11-15,Colusa,011,21464,645,601,1,602,6
2020-11-15,Contra Costa,013,1133247,22221,21179,122,21301,256
2020-11-15,Del Norte,015,27424,253,224,0,224,2
2020-11-15,El Dorado,017,186661,2001,1683,14,1697,4
2020-11-15,Fresno,019,978130,38253,34297,932,35229,471
2020-11-15,Glenn,021,27897,848,783,24,807,4
2020-11-15,Humboldt,023,135768,755,653,1,654,9
2020-11-15,Imperial,025,180216,14724,13940,33,13973,346
2020-11-15,Inyo,027,18085,273,263,5,268,15
2020-11-15,Kern,029,883053,37650,35911,777,36688,455
2020-11-15,Kings,031,150075,10015,9533,107,9640,85
2020-11-15,Lake,033,64148,853,777,0,777,17
2020-11-15,Lassen,035,31185,1253,1124,3,1127,0
2020-11-15,Los Angeles,037,10098052,351034,336035,4338,340373,7271
2020-11-15,Madera,039,155013,5738,5391,90,5481,54
2020-11-15,Marin,041,260295,7516,7347,24,7371,133
2020-11-15,Mariposa,043,17540,97,86,0,86,2
2020-11-15,Mendocino,045,87422,1302,1197,5,1202,22
2020-11-15,Merced,047,269075,10758,10350,84,10434,162
2020-11-15,Modoc,049,8938,85,68,17,85,0
2020-11-15,Mono,051,14174,475,453,9,462,2
2020-11-15,Monterey,053,433212,13723,12999,180,13179,107
2020-11-15,Napa,055,140530,2779,2509,15,2524,17
2020-11-15,Nevada,057,99092,1001,859,24,883,9
2020-11-15,Orange,059,3164182,69856,65008,2098,67106,1519
2020-11-15,Placer,061,380077,5905,5330,79,5409,63
2020-11-15,Plumas,063,18699,162,127,0,127,0
2020-11-15,Riverside,065,2383286,80027,75531,1113,76644,1374
2020-11-15,Sacramento,067,1510023,32570,30601,65,30666,534
2020-11-15,San Benito,069,59416,1672,1589,2,1591,15
2020-11-15,San Bernardino,071,2135413,80971,73769,857,74626,1185
2020-11-15,San Diego,073,3302833,70416,64770,2324,67094,926
2020-11-15,San Francisco,075,870044,14269,13757,79,13836,153
2020-11-15,San Joaquin,077,732212,24570,23516,377,23893,513
2020-11-15,San Luis Obispo,079,281455,5681,5120,84,5204,34
2020-11-15,San Mateo,081,765935,13201,12348,11,12359,169
2020-11-15,Santa Barbara,083,443738,10883,10516,166,10682,135
2020-11-15,Santa Clara,085,1922200,30979,28289,62,28351,418
2020-11-15,Santa Cruz,087,273765,3844,3439,39,3478,25
2020-11-15,Shasta,089,179085,4236,3290,94,3384,37
2020-11-15,Sierra,091,2930,15,11,0,11,0
2020-11-15,Siskiyou,093,43540,409,294,26,320,0
2020-11-15,Solano,095,438530,9264,8713,47,8760,84
2020-11-15,Sonoma,097,501317,11351,10833,38,10871,154
2020-11-15,Stanislaus,099,539301,20007,19228,1115,20343,425
2020-11-15,Sutter,101,95872,2608,2230,9,2239,12
2020-11-15,Tehama,103,63373,1384,1222,7,1229,7
2020-11-15,Trinity,105,12862,191,67,21,88,0
2020-11-15,Tulare,107,460477,19932,18891,884,19775,305
2020-11-15,Tuolumne,109,53932,756,486,5,491,7
2020-11-15,Ventura,111,848112,17799,16564,514,17078,172
2020-11-15,Yolo,113,214977,4104,3819,11,3830,67
2020-11-15,Yuba,115,75493,1638,1470,7,1477,10
2020-11-14,Alameda,001,1643700,27217,25714,267,25981,435
2020-11-14,Alpine,003,1148,35,12,0,12,0
2020-11-14,Amador,005,37829,436,404,0,404,16
2020-11-14,Butte,007,227075,3688,3434,121,3555,58
2020-11-14,Calaveras,009,45235,398,386,0,386,21
2020-11-14,Colusa,011,21464,633,601,1,602,6
2020-11-14,Contra Costa,013,1133247,22082,20975,115,21090,256
2020-11-14,Del Norte,015,27424,247,219,0,219,2
2020-11-14,El Dorado,017,186661,1957,1648,14,1662,4
2020-11-14,Fresno,019,978130,38003,33969,895,34864,471
2020-11-14,Glenn,021,27897,839,772,21,793,3
2020-11-14,Humboldt,023,135768,740,643,1,644,9
2020-11-14,Imperial,025,180216,14631,13932,32,13964,346
2020-11-14,Inyo,027,18085,272,263,5,268,15
2020-11-14,Kern,029,883053,37441,35626,758,36384,454
2020-11-14,Kings,031,150075,9980,9490,104,9594,85
2020-11-14,Lake,033,64148,844,773,0,773,17
2020-11-14,Lassen,035,31185,1239,833,3,836,0
2020-11-14,Los Angeles,037,10098052,348326,333021,4229,337250,7269
2020-11-14,Madera,039,155013,5708,5371,88,5459,54
2020-11-14,Marin,041,260295,7500,7325,24,7349,133
2020-11-14,Mariposa,043,17540,96,86,0,86,2
2020-11-14,Mendocino,045,87422,1286,1181,5,1186,22
2020-11-14,Merced,047,269075,10702,10286,82,10368,161
2020-11-14,Modoc,049,8938,84,64,16,80,0
2020-11-14,Mono,051,14174,475,453,9,462,2
2020-11-14,Monterey,053,433212,13627,12854,170,13024,105
2020-11-14,Napa,055,140530,2745,2473,15,2488,17
2020-11-14,Nevada,057,99092,985,835,24,859,9
2020-11-14,Orange,059,3164182,69235,64340,2087,66427,1517
2020-11-14,Placer,061,380077,5829,5215,73,5288,63
2020-11-14,Plumas,063,18699,157,128,0,128,0
2020-11-14,Riverside,065,2383286,79286,74910,1074,75984,1373
2020-11-14,Sacramento,067,1510023,32244,30298,65,30363,532
2020-11-14,San Benito,069,59416,1657,1573,2,1575,15
2020-11-14,San Bernardino,071,2135413,80037,72868,825,73693,1184
2020-11-14,San Diego,073,3302833,69651,63715,2272,65987,926
2020-11-14,San Francisco,075,870044,14181,13661,78,13739,153
2020-11-14,San Joaquin,077,732212,24479,23516,369,23885,511
2020-11-14,San Luis Obispo,079,281455,5617,5073,79,5152,34
2020-11-14,San Mateo,081,765935,13093,12293,11,12304,169
2020-11-14,Santa Barbara,083,443738,10829,10482,164,10646,135
2020-11-14,Santa Clara,085,1922200,30694,27962,60,28022,416
2020-11-14,Santa Cruz,087,273765,3789,3402,39,3441,25
2020-11-14,Shasta,089,179085,4155,3195,92,3287,37
2020-11-14,Sierra,091,2930,15,11,0,11,0
2020-11-14,Siskiyou,093,43540,396,292,26,318,0
2020-11-14,Solano,095,438530,9184,8655,46,8701,84
2020-11-14,Sonoma,097,501317,11298,10769,38,10807,154
2020-11-14,Stanislaus,099,539301,19864,19068,1093,20161,424
2020-11-14,Sutter,101,95872,2563,2182,9,2191,12
2020-11-14,Tehama,103,63373,1363,1206,6,1212,7
2020-11-14,Trinity,105,12862,186,67,21,88,0
2020-11-14,Tulare,107,460477,19837,18853,856,19709,305
2020-11-14,Tuolumne,109,53932,728,448,5,453,7
2020-11-14,Ventura,111,848112,17653,16297,503,16800,172
2020-11-14,Yolo,113,214977,4061,3765,9,3774,65
2020-11-14,Yuba,115,75493,1609,1453,7,1460,10
2020-11-13,Alameda,001,1643700,27001,25515,262,25777,434
2020-11-13,Alpine,003,1148,35,12,0,12,0
2020-11-13,Amador,005,37829,433,397,0,397,16
2020-11-13,Butte,007,227075,3664,3402,112,3514,58
2020-11-13,Calaveras,009,45235,394,378,0,378,21
2020-11-13,Colusa,011,21464,625,598,1,599,6
2020-11-13,Contra Costa,013,1133247,21909,20799,115,20914,256
2020-11-13,Del Norte,015,27424,244,208,0,208,2
2020-11-13,El Dorado,017,186661,1912,1611,13,1624,4
2020-11-13,Fresno,019,978130,37756,33693,881,34574,470
2020-11-13,Glenn,021,27897,825,755,17,772,3
2020-11-13,Humboldt,023,135768,725,638,1,639,9
2020-11-13,Imperial,025,180216,14561,13790,31,13821,341
2020-11-13,Inyo,027,18085,271,262,5,267,15
2020-11-13,Kern,029,883053,37239,35431,741,36172,453
2020-11-13,Kings,031,150075,9921,9428,103,9531,85
2020-11-13,Lake,033,64148,838,770,0,770,17
2020-11-13,Lassen,035,31185,1230,832,3,835,0
2020-11-13,Los Angeles,037,10098052,345200,329364,4122,333486,7248
2020-11-13,Madera,039,155013,5668,5340,87,5427,54
2020-11-13,Marin,041,260295,7487,7307,23,7330,133
2020-11-13,Mariposa,043,17540,94,86,0,86,2
2020-11-13,Mendocino,045,87422,1274,1173,5,1178,22
2020-11-13,Merced,047,269075,10646,10185,79,10264,159
2020-11-13,Modoc,049,8938,84,63,14,77,0
2020-11-13,Mono,051,14174,475,448,8,456,2
2020-11-13,Monterey,053,433212,13431,12681,158,12839,104
2020-11-13,Napa,055,140530,2706,2440,15,2455,17
2020-11-13,Nevada,057,99092,966,798,24,822,9
2020-11-13,Orange,059,3164182,68636,63804,2067,65871,1514
2020-11-13,Placer,061,380077,5724,5122,67,5189,63
2020-11-13,Plumas,063,18699,151,125,0,125,0
2020-11-13,Riverside,065,2383286,78547,74138,1045,75183,1372
2020-11-13,Sacramento,067,1510023,31926,29787,60,29847,524
2020-11-13,San Benito,069,59416,1645,1553,1,1554,15
2020-11-13,San Bernardino,071,2135413,78989,71895,804,72699,1184
2020-11-13,San Diego,073,3302833,68804,62978,2234,65212,921
2020-11-13,San Francisco,075,870044,14088,13516,76,13592,146
2020-11-13,San Joaquin,077,732212,24384,23314,363,23677,510
2020-11-13,San Luis Obispo,079,281455,5550,4960,76,5036,34
2020-11-13,San Mateo,081,765935,12999,12182,11,12193,169
2020-11-13,Santa Barbara,083,443738,10777,10405,162,10567,134
2020-11-13,Santa Clara,085,1922200,30367,27609,58,27667,415
2020-11-13,Santa Cruz,087,273765,3716,3343,39,3382,25
2020-11-13,Shasta,089,179085,4071,2983,88,3071,37
2020-11-13,Sierra,091,2930,15,11,0,11,0
2020-11-13,Siskiyou,093,43540,391,280,25,305,0
2020-11-13,Solano,095,438530,9093,8525,46,8571,84
2020-11-13,Sonoma,097,501317,11237,10685,36,10721,151
2020-11-13,Stanislaus,099,539301,19739,18936,1065,20001,422
2020-11-13,Sutter,101,95872,2517,2121,8,2129,12
2020-11-13,Tehama,103,63373,1335,1167,6,1173,7
2020-11-13,Trinity,105,12862,184,64,21,85,0
2020-11-13,Tulare,107,460477,19713,18714,815,19529,305
2020-11-13,Tuolumne,109,53932,695,427,5,432,7
2020-11-13,Ventura,111,848112,17507,16172,489,16661,171
2020-11-13,Yolo,113,214977,4010,3716,9,3725,65
2020-11-13,Yuba,115,75493,1582,1435,7,1442,10
2020-11-12,Alameda,001,1643700,26734,25345,262,25607,432
2020-11-12,Alpine,003,1148,34,12,0,12,0
2020-11-12,Amador,005,37829,432,392,0,392,16
2020-11-12,Butte,007,227075,3615,3347,109,3456,58
2020-11-12,Calaveras,009,45235,389,373,0,373,21
2020-11-12,Colusa,011,21464,620,591,1,592,6
2020-11-12,Contra Costa,013,1133247,21702,20619,113,20732,255
2020-11-12,Del Norte,015,27424,237,203,0,203,2
2020-11-12,El Dorado,017,186661,1866,1573,9,1582,4
2020-11-12,Fresno,019,978130,37407,33459,839,34298,468
2020-11-12,Glenn,021,27897,806,727,17,744,3
2020-11-12,Humboldt,023,135768,712,625,1,626,9
2020-11-12,Imperial,025,180216,14396,13619,31,13650,341
2020-11-12,Inyo,027,18085,270,255,5,260,15
2020-11-12,Kern,029,883053,36975,35207,726,35933,451
2020-11-12,Kings,031,150075,9854,9335,102,9437,85
2020-11-12,Lake,033,64148,829,764,0,764,17
2020-11-12,Lassen,035,31185,1161,832,2,834,0
2020-11-12,Los Angeles,037,10098052,341459,327001,4021,331022,7223
2020-11-12,Madera,039,155013,5633,5273,82,5355,54
2020-11-12,Marin,041,260295,7458,7268,23,7291,133
2020-11-12,Mariposa,043,17540,92,84,0,84,2
2020-11-12,Mendocino,045,87422,1255,1142,5,1147,22
2020-11-12,Merced,047,269075,10532,10107,76,10183,158
2020-11-12,Modoc,049,8938,84,63,14,77,0
2020-11-12,Mono,051,14174,474,442,8,450,2
2020-11-12,Monterey,053,433212,13310,12489,144,12633,100
2020-11-12,Napa,055,140530,2644,2398,15,2413,16
2020-11-12,Nevada,057,99092,943,780,23,803,9
2020-11-12,Orange,059,3164182,67891,63232,2048,65280,1514
2020-11-12,Placer,061,380077,5614,5044,58,5102,62
2020-11-12,Plumas,063,18699,147,121,0,121,0
2020-11-12,Riverside,065,2383286,77615,73381,1002,74383,1362
2020-11-12,Sacramento,067,1510023,31435,29459,53,29512,520
2020-11-12,San Benito,069,59416,1625,1525,1,1526,15
2020-11-12,San Bernardino,071,2135413,77623,70758,765,71523,1183
2020-11-12,San Diego,073,3302833,67824,62336,2183,64519,918
2020-11-12,San Francisco,075,870044,13990,13289,75,13364,146
2020-11-12,San Joaquin,077,732212,24191,23002,342,23344,509
2020-11-12,San Luis Obispo,079,281455,5486,4898,75,4973,33
2020-11-12,San Mateo,081,765935,12874,12086,10,12096,169
2020-11-12,Santa Barbara,083,443738,10715,10325,157,10482,134
2020-11-12,Santa Clara,085,1922200,29991,27261,57,27318,414
2020-11-12,Santa Cruz,087,273765,3633,3317,37,3354,25
2020-11-12,Shasta,089,179085,3934,2825,77,2902,37
2020-11-12,Sierra,091,2930,15,11,0,11,0
2020-11-12,Siskiyou,093,43540,374,275,20,295,0
2020-11-12,Solano,095,438530,8993,8417,45,8462,85
2020-11-12,Sonoma,097,501317,11135,10602,35,10637,151
2020-11-12,Stanislaus,099,539301,19570,18787,1036,19823,422
2020-11-12,Sutter,101,95872,2434,2075,7,2082,12
2020-11-12,Tehama,103,63373,1308,1117,6,1123,7
2020-11-12,Trinity,105,12862,176,62,20,82,0
2020-11-12,Tulare,107,460477,19601,18545,777,19322,305
2020-11-12,Tuolumne,109,53932,656,353,5,358,7
2020-11-12,Ventura,111,848112,17257,16013,483,16496,158
2020-11-12,Yolo,113,214977,3966,3646,9,3655,63
2020-11-12,Yuba,115,75493,1547,1410,7,1417,10
2020-11-11,Alameda,001,1643700,26491,25140,260,25400,429
2020-11-11,Alpine,003,1148,29,12,0,12,0
2020-11-11,Amador,005,37829,425,389,0,389,16
2020-11-11,Butte,007,227075,3589,3348,96,3444,58
2020-11-11,Calaveras,009,45235,379,373,0,373,21
2020-11-11,Colusa,011,21464,614,591,1,592,6
2020-11-11,Contra Costa,013,1133247,21484,20452,111,20563,255
2020-11-11,Del Norte,015,27424,230,203,0,203,2
2020-11-11,El Dorado,017,186661,1820,1564,8,1572,4
2020-11-11,Fresno,019,978130,37088,33287,804,34091,468
2020-11-11,Glenn,021,27897,790,722,16,738,3
2020-11-11,Humboldt,023,135768,698,623,1,624,9
2020-11-11,Imperial,025,180216,14225,13623,29,13652,340
2020-11-11,Inyo,027,18085,268,255,5,260,15
2020-11-11,Kern,029,883053,36700,35014,709,35723,449
2020-11-11,Kings,031,150075,9748,9263,99,9362,85
2020-11-11,Lake,033,64148,819,763,0,763,17
2020-11-11,Lassen,035,31185,1136,831,2,833,0
2020-11-11,Los Angeles,037,10098052,338094,324567,3937,328504,7220
2020-11-11,Madera,039,155013,5598,5248,80,5328,54
2020-11-11,Marin,041,260295,7435,7268,23,7291,133
2020-11-11,Mariposa,043,17540,92,84,0,84,2
2020-11-11,Mendocino,045,87422,1243,1142,5,1147,22
2020-11-11,Merced,047,269075,10461,10074,74,10148,157
2020-11-11,Modoc,049,8938,80,62,13,75,0
2020-11-11,Mono,051,14174,472,443,8,451,2
2020-11-11,Monterey,053,433212,13166,12417,140,12557,100
2020-11-11,Napa,055,140530,2595,2365,12,2377,15
2020-11-11,Nevada,057,99092,901,741,23,764,9
2020-11-11,Orange,059,3164182,67253,62929,2025,64954,1506
2020-11-11,Placer,061,380077,5530,4981,50,5031,60
2020-11-11,Plumas,063,18699,145,111,0,111,0
2020-11-11,Riverside,065,2383286,76711,72953,956,73909,1361
2020-11-11,Sacramento,067,1510023,30978,28968,51,29019,520
2020-11-11,San Benito,069,59416,1611,1512,1,1513,15
2020-11-11,San Bernardino,071,2135413,76336,70374,738,71112,1182
2020-11-11,San Diego,073,3302833,66889,61746,2122,63868,918
2020-11-11,San Francisco,075,870044,13882,13287,74,13361,146
2020-11-11,San Joaquin,077,732212,24031,23001,336,23337,509
2020-11-11,San Luis Obispo,079,281455,5410,4832,72,4904,33
2020-11-11,San Mateo,081,765935,12759,12008,10,12018,169
2020-11-11,Santa Barbara,083,443738,10649,10278,157,10435,134
2020-11-11,Santa Clara,085,1922200,29638,27075,56,27131,413
2020-11-11,Santa Cruz,087,273765,3565,3247,37,3284,25
2020-11-11,Shasta,089,179085,3810,2766,67,2833,36
2020-11-11,Sierra,091,2930,13,11,0,11,0
2020-11-11,Siskiyou,093,43540,343,261,17,278,0
2020-11-11,Solano,095,438530,8875,8353,43,8396,85
2020-11-11,Sonoma,097,501317,11061,10498,35,10533,150
2020-11-11,Stanislaus,099,539301,19433,18671,1006,19677,422
2020-11-11,Sutter,101,95872,2386,2049,6,2055,12
2020-11-11,Tehama,103,63373,1266,1105,5,1110,7
2020-11-11,Trinity,105,12862,165,62,20,82,0
2020-11-11,Tulare,107,460477,19470,18500,746,19246,305
2020-11-11,Tuolumne,109,53932,600,354,4,358,7
2020-11-11,Ventura,111,848112,17042,15801,470,16271,158
2020-11-11,Yolo,113,214977,3915,3606,9,3615,63
2020-11-11,Yuba,115,75493,1532,1400,7,1407,10
2020-11-10,Alameda,001,1643700,26261,25008,257,25265,424
2020-11-10,Alpine,003,1148,29,9,0,9,0
2020-11-10,Amador,005,37829,419,384,0,384,16
2020-11-10,Butte,007,227075,3553,3327,92,3419,58
2020-11-10,Calaveras,009,45235,374,367,0,367,21
2020-11-10,Colusa,011,21464,606,590,1,591,6
2020-11-10,Contra Costa,013,1133247,21277,20326,109,20435,255
2020-11-10,Del Norte,015,27424,224,196,0,196,2
2020-11-10,El Dorado,017,186661,1759,1551,8,1559,4
2020-11-10,Fresno,019,978130,36818,33024,766,33790,465
2020-11-10,Glenn,021,27897,782,719,12,731,3
2020-11-10,Humboldt,023,135768,681,610,1,611,9
2020-11-10,Imperial,025,180216,14096,13570,29,13599,338
2020-11-10,Inyo,027,18085,267,252,5,257,14
2020-11-10,Kern,029,883053,36423,34858,690,35548,448
2020-11-10,Kings,031,150075,9701,9236,92,9328,85
2020-11-10,Lake,033,64148,809,762,0,762,16
2020-11-10,Lassen,035,31185,1121,830,2,832,0
2020-11-10,Los Angeles,037,10098052,334842,322569,3823,326392,7205
2020-11-10,Madera,039,155013,5556,5229,74,5303,54
2020-11-10,Marin,041,260295,7416,7259,23,7282,133
2020-11-10,Mariposa,043,17540,90,84,0,84,2
2020-11-10,Mendocino,045,87422,1235,1137,5,1142,22
2020-11-10,Merced,047,269075,10399,9992,68,10060,157
2020-11-10,Modoc,049,8938,78,61,13,74,0
2020-11-10,Mono,051,14174,470,443,8,451,2
2020-11-10,Monterey,053,433212,13031,12335,132,12467,100
2020-11-10,Napa,055,140530,2557,2341,10,2351,15
2020-11-10,Nevada,057,99092,885,734,23,757,9
2020-11-10,Orange,059,3164182,66702,62597,2015,64612,1504
2020-11-10,Placer,061,380077,5450,4902,49,4951,60
2020-11-10,Plumas,063,18699,141,108,0,108,0
2020-11-10,Riverside,065,2383286,76069,72316,929,73245,1359
2020-11-10,Sacramento,067,1510023,30571,28677,48,28725,519
2020-11-10,San Benito,069,59416,1596,1508,1,1509,15
2020-11-10,San Bernardino,071,2135413,75166,69666,705,70371,1182
2020-11-10,San Diego,073,3302833,65998,61085,2085,63170,915
2020-11-10,San Francisco,075,870044,13765,13210,74,13284,146
2020-11-10,San Joaquin,077,732212,23866,22865,329,23194,508
2020-11-10,San Luis Obispo,079,281455,5347,4780,69,4849,33
2020-11-10,San Mateo,081,765935,12658,11939,10,11949,169
2020-11-10,Santa Barbara,083,443738,10582,10252,153,10405,134
2020-11-10,Santa Clara,085,1922200,29294,26917,55,26972,409
2020-11-10,Santa Cruz,087,273765,3501,3221,37,3258,25
2020-11-10,Shasta,089,179085,3667,2686,59,2745,36
2020-11-10,Sierra,091,2930,12,10,0,10,0
2020-11-10,Siskiyou,093,43540,326,263,16,279,0
2020-11-10,Solano,095,438530,8777,8299,43,8342,85
2020-11-10,Sonoma,097,501317,10974,10414,35,10449,150
2020-11-10,Stanislaus,099,539301,19299,18592,982,19574,420
2020-11-10,Sutter,101,95872,2291,2035,5,2040,12
2020-11-10,Tehama,103,63373,1240,1099,4,1103,7
2020-11-10,Trinity,105,12862,156,62,18,80,0
2020-11-10,Tulare,107,460477,19355,18430,722,19152,305
2020-11-10,Tuolumne,109,53932,552,353,4,357,7
2020-11-10,Ventura,111,848112,16859,15625,468,16093,158
2020-11-10,Yolo,113,214977,3854,3573,9,3582,63
2020-11-10,Yuba,115,75493,1509,1392,7,1399,10
2020-11-09,Alameda,001,1643700,26012,24899,253,25152,424
2020-11-09,Alpine,003,1148,27,6,0,6,0
2020-11-09,Amador,005,37829,410,380,0,380,16
2020-11-09,Butte,007,227075,3508,3301,83,3384,57
2020-11-09,Calaveras,009,45235,370,360,0,360,21
2020-11-09,Colusa,011,21464,600,583,1,584,6
2020-11-09,Contra Costa,013,1133247,21104,20193,107,20300,255
2020-11-09,Del Norte,015,27424,218,195,0,195,2
2020-11-09,El Dorado,017,186661,1718,1515,8,1523,4
2020-11-09,Fresno,019,978130,36507,32755,726,33481,465
2020-11-09,Glenn,021,27897,776,714,9,723,3
2020-11-09,Humboldt,023,135768,668,607,1,608,9
2020-11-09,Imperial,025,180216,13979,13508,28,13536,338
2020-11-09,Inyo,027,18085,267,252,5,257,14
2020-11-09,Kern,029,883053,36192,34764,654,35418,448
2020-11-09,Kings,031,150075,9631,9141,90,9231,84
2020-11-09,Lake,033,64148,800,755,0,755,16
2020-11-09,Lassen,035,31185,1025,799,2,801,0
2020-11-09,Los Angeles,037,10098052,331745,320370,3747,324117,7180
2020-11-09,Madera,039,155013,5510,5209,71,5280,54
2020-11-09,Marin,041,260295,7390,7237,22,7259,131
2020-11-09,Mariposa,043,17540,90,84,0,84,2
2020-11-09,Mendocino,045,87422,1223,1132,5,1137,22
2020-11-09,Merced,047,269075,10296,9922,65,9987,157
2020-11-09,Modoc,049,8938,74,54,12,66,0
2020-11-09,Mono,051,14174,467,352,8,360,2
2020-11-09,Monterey,053,433212,12884,12148,124,12272,98
2020-11-09,Napa,055,140530,2514,2309,10,2319,15
2020-11-09,Nevada,057,99092,848,729,22,751,9
2020-11-09,Orange,059,3164182,66061,62335,2003,64338,1501
2020-11-09,Placer,061,380077,5365,4843,37,4880,60
2020-11-09,Plumas,063,18699,134,102,0,102,0
2020-11-09,Riverside,065,2383286,75285,72059,895,72954,1346
2020-11-09,Sacramento,067,1510023,30100,28200,48,28248,516
2020-11-09,San Benito,069,59416,1587,1506,1,1507,15
2020-11-09,San Bernardino,071,2135413,74112,69015,663,69678,1182
2020-11-09,San Diego,073,3302833,65143,60572,2045,62617,908
2020-11-09,San Francisco,075,870044,13645,12984,71,13055,146
2020-11-09,San Joaquin,077,732212,23701,22512,324,22836,505
2020-11-09,San Luis Obispo,079,281455,5260,4746,67,4813,32
2020-11-09,San Mateo,081,765935,12551,11857,10,11867,169
2020-11-09,Santa Barbara,083,443738,10525,10214,147,10361,134
2020-11-09,Santa Clara,085,1922200,28899,26693,55,26748,409
2020-11-09,Santa Cruz,087,273765,3443,3194,37,3231,25
2020-11-09,Shasta,089,179085,3513,2581,50,2631,36
2020-11-09,Sierra,091,2930,10,10,0,10,0
2020-11-09,Siskiyou,093,43540,315,257,14,271,0
2020-11-09,Solano,095,438530,8661,8254,42,8296,85
2020-11-09,Sonoma,097,501317,10866,10310,35,10345,150
2020-11-09,Stanislaus,099,539301,19146,18482,965,19447,418
2020-11-09,Sutter,101,95872,2224,2010,4,2014,12
2020-11-09,Tehama,103,63373,1204,1071,3,1074,7
2020-11-09,Trinity,105,12862,149,46,18,64,0
2020-11-09,Tulare,107,460477,19235,18272,690,18962,304
2020-11-09,Tuolumne,109,53932,498,346,4,350,7
2020-11-09,Ventura,111,848112,16657,15568,465,16033,156
2020-11-09,Yolo,113,214977,3794,3522,9,3531,62
2020-11-09,Yuba,115,75493,1476,1380,7,1387,10
2020-11-08,Alameda,001,1643700,25782,24731,253,24984,424
2020-11-08,Alpine,003,1148,24,6,0,6,0
2020-11-08,Amador,005,37829,403,376,0,376,16
2020-11-08,Butte,007,227075,3470,3285,76,3361,57
2020-11-08,Calaveras,009,45235,368,360,0,360,21
2020-11-08,Colusa,011,21464,597,583,1,584,6
2020-11-08,Contra Costa,013,1133247,20934,20031,105,20136,254
2020-11-08,Del Norte,015,27424,210,195,0,195,2
2020-11-08,El Dorado,017,186661,1680,1502,8,1510,4
2020-11-08,Fresno,019,978130,36171,32619,688,33307,465
2020-11-08,Glenn,021,27897,770,707,8,715,3
2020-11-08,Humboldt,023,135768,652,605,1,606,9
2020-11-08,Imperial,025,180216,13863,13428,28,13456,338
2020-11-08,Inyo,027,18085,263,252,5,257,14
2020-11-08,Kern,029,883053,35973,34644,637,35281,448
2020-11-08,Kings,031,150075,9498,9026,87,9113,84
2020-11-08,Lake,033,64148,792,754,0,754,16
2020-11-08,Lassen,035,31185,877,799,2,801,0
2020-11-08,Los Angeles,037,10098052,328618,318960,3679,322639,7176
2020-11-08,Madera,039,155013,5441,5196,68,5264,54
2020-11-08,Marin,041,260295,7370,7227,22,7249,131
2020-11-08,Mariposa,043,17540,90,83,0,83,2
2020-11-08,Mendocino,045,87422,1214,1129,5,1134,22
2020-11-08,Merced,047,269075,10221,9885,63,9948,157
2020-11-08,Modoc,049,8938,70,54,12,66,0
2020-11-08,Mono,051,14174,461,352,8,360,2
2020-11-08,Monterey,053,433212,12739,12122,113,12235,98
2020-11-08,Napa,055,140530,2474,2274,10,2284,15
2020-11-08,Nevada,057,99092,832,715,22,737,9
2020-11-08,Orange,059,3164182,65472,62034,1989,64023,1501
2020-11-08,Placer,061,380077,5262,4800,32,4832,60
2020-11-08,Plumas,063,18699,129,102,0,102,0
2020-11-08,Riverside,065,2383286,74630,71442,853,72295,1345
2020-11-08,Sacramento,067,1510023,29540,28059,45,28104,515
2020-11-08,San Benito,069,59416,1572,1496,1,1497,15
2020-11-08,San Bernardino,071,2135413,72859,68412,624,69036,1182
2020-11-08,San Diego,073,3302833,64298,60199,2001,62200,908
2020-11-08,San Francisco,075,870044,13514,12985,66,13051,146
2020-11-08,San Joaquin,077,732212,23507,22514,320,22834,505
2020-11-08,San Luis Obispo,079,281455,5194,4698,62,4760,32
2020-11-08,San Mateo,081,765935,12432,11783,10,11793,169
2020-11-08,Santa Barbara,083,443738,10455,10180,145,10325,134
2020-11-08,Santa Clara,085,1922200,28525,26442,54,26496,410
2020-11-08,Santa Cruz,087,273765,3386,3134,37,3171,25
2020-11-08,Shasta,089,179085,3377,2582,44,2626,36
2020-11-08,Sierra,091,2930,10,7,0,7,0
2020-11-08,Siskiyou,093,43540,303,246,13,259,0
2020-11-08,Solano,095,438530,8540,8132,41,8173,85
2020-11-08,Sonoma,097,501317,10759,10229,35,10264,149
2020-11-08,Stanislaus,099,539301,18971,18413,944,19357,418
2020-11-08,Sutter,101,95872,2166,1980,4,1984,12
2020-11-08,Tehama,103,63373,1180,1054,3,1057,7
2020-11-08,Trinity,105,12862,146,46,17,63,0
2020-11-08,Tulare,107,460477,19092,18272,660,18932,304
2020-11-08,Tuolumne,109,53932,471,341,4,345,7
2020-11-08,Ventura,111,848112,16462,15504,457,15961,156
2020-11-08,Yolo,113,214977,3733,3492,9,3501,61
2020-11-08,Yuba,115,75493,1455,1369,7,1376,10
2020-11-07,Alameda,001,1643700,25672,24578,251,24829,424
2020-11-07,Alpine,003,1148,24,6,0,6,0
2020-11-07,Amador,005,37829,400,375,0,375,16
2020-11-07,Butte,007,227075,3458,3277,71,3348,57
2020-11-07,Calaveras,009,45235,366,360,0,360,21
2020-11-07,Colusa,011,21464,597,583,1,584,6
2020-11-07,Contra Costa,013,1133247,20833,19943,104,20047,254
2020-11-07,Del Norte,015,27424,206,194,0,194,2
2020-11-07,El Dorado,017,186661,1655,1495,7,1502,4
2020-11-07,Fresno,019,978130,36017,32497,665,33162,465
2020-11-07,Glenn,021,27897,762,707,8,715,3
2020-11-07,Humboldt,023,135768,641,590,1,591,9
2020-11-07,Imperial,025,180216,13805,13388,27,13415,338
2020-11-07,Inyo,027,18085,261,252,5,257,14
2020-11-07,Kern,029,883053,35818,34513,627,35140,448
2020-11-07,Kings,031,150075,9465,9005,81,9086,84
2020-11-07,Lake,033,64148,788,751,0,751,16
2020-11-07,Lassen,035,31185,861,799,2,801,0
2020-11-07,Los Angeles,037,10098052,327110,316756,3611,320367,7174
2020-11-07,Madera,039,155013,5419,5177,66,5243,54
2020-11-07,Marin,041,260295,7359,7215,22,7237,131
2020-11-07,Mariposa,043,17540,90,81,0,81,2
2020-11-07,Mendocino,045,87422,1203,1118,5,1123,22
2020-11-07,Merced,047,269075,10189,9855,59,9914,157
2020-11-07,Modoc,049,8938,70,51,12,63,0
2020-11-07,Mono,051,14174,458,352,8,360,2
2020-11-07,Monterey,053,433212,12670,12030,109,12139,98
2020-11-07,Napa,055,140530,2444,2260,9,2269,15
2020-11-07,Nevada,057,99092,815,710,22,732,9
2020-11-07,Orange,059,3164182,65185,62038,1983,64021,1505
2020-11-07,Placer,061,380077,5199,4745,32,4777,60
2020-11-07,Plumas,063,18699,127,94,0,94,0
2020-11-07,Riverside,065,2383286,74235,71153,825,71978,1345
2020-11-07,Sacramento,067,1510023,29289,27773,45,27818,515
2020-11-07,San Benito,069,59416,1560,1489,1,1490,15
2020-11-07,San Bernardino,071,2135413,72344,67935,613,68548,1182
2020-11-07,San Diego,073,3302833,63786,59682,1969,61651,909
2020-11-07,San Francisco,075,870044,13453,12980,65,13045,146
2020-11-07,San Joaquin,077,732212,23398,22517,314,22831,505
2020-11-07,San Luis Obispo,079,281455,5145,4668,59,4727,32
2020-11-07,San Mateo,081,765935,12369,11711,10,11721,169
2020-11-07,Santa Barbara,083,443738,10413,10157,143,10300,134
2020-11-07,Santa Clara,085,1922200,28320,26244,53,26297,410
2020-11-07,Santa Cruz,087,273765,3348,3130,37,3167,25
2020-11-07,Shasta,089,179085,3310,2547,42,2589,36
2020-11-07,Sierra,091,2930,10,7,0,7,0
2020-11-07,Siskiyou,093,43540,299,241,13,254,0
2020-11-07,Solano,095,438530,8488,8066,41,8107,85
2020-11-07,Sonoma,097,501317,10713,10200,35,10235,149
2020-11-07,Stanislaus,099,539301,18862,18386,927,19313,418
2020-11-07,Sutter,101,95872,2126,1973,4,1977,12
2020-11-07,Tehama,103,63373,1156,1043,3,1046,7
2020-11-07,Trinity,105,12862,146,42,16,58,0
2020-11-07,Tulare,107,460477,19036,18229,643,18872,304
2020-11-07,Tuolumne,109,53932,460,327,4,331,7
2020-11-07,Ventura,111,848112,16402,15364,452,15816,156
2020-11-07,Yolo,113,214977,3702,3486,9,3495,61
2020-11-07,Yuba,115,75493,1440,1349,7,1356,10
2020-11-06,Alameda,001,1643700,25540,24389,249,24638,420
2020-11-06,Alpine,003,1148,24,6,0,6,0
2020-11-06,Amador,005,37829,398,369,0,369,16
2020-11-06,Butte,007,227075,3433,3254,63,3317,57
2020-11-06,Calaveras,009,45235,365,359,0,359,21
2020-11-06,Colusa,011,21464,595,580,1,581,6
2020-11-06,Contra Costa,013,1133247,20684,19744,104,19848,252
2020-11-06,Del Norte,015,27424,203,194,0,194,2
2020-11-06,El Dorado,017,186661,1629,1475,7,1482,4
2020-11-06,Fresno,019,978130,35829,32278,649,32927,460
2020-11-06,Glenn,021,27897,756,707,7,714,3
2020-11-06,Humboldt,023,135768,638,587,1,588,9
2020-11-06,Imperial,025,180216,13752,13230,27,13257,338
2020-11-06,Inyo,027,18085,259,246,5,251,14
2020-11-06,Kern,029,883053,35653,34360,609,34969,443
2020-11-06,Kings,031,150075,9441,8883,79,8962,83
2020-11-06,Lake,033,64148,787,741,0,741,16
2020-11-06,Lassen,035,31185,853,794,2,796,0
2020-11-06,Los Angeles,037,10098052,325137,314356,3558,317914,7160
2020-11-06,Madera,039,155013,5403,5136,65,5201,54
2020-11-06,Marin,041,260295,7338,7184,22,7206,131
2020-11-06,Mariposa,043,17540,89,79,0,79,2
2020-11-06,Mendocino,045,87422,1198,1113,5,1118,22
2020-11-06,Merced,047,269075,10149,9778,56,9834,157
2020-11-06,Modoc,049,8938,70,48,12,60,0
2020-11-06,Mono,051,14174,452,308,8,316,1
2020-11-06,Monterey,053,433212,12553,11914,108,12022,96
2020-11-06,Napa,055,140530,2419,2189,9,2198,15
2020-11-06,Nevada,057,99092,802,692,21,713,9
2020-11-06,Orange,059,3164182,64882,61049,1973,63022,1494
2020-11-06,Placer,061,380077,5126,4680,32,4712,60
2020-11-06,Plumas,063,18699,122,90,0,90,0
2020-11-06,Riverside,065,2383286,73785,70409,784,71193,1341
2020-11-06,Sacramento,067,1510023,28997,27489,43,27532,514
2020-11-06,San Benito,069,59416,1551,1479,1,1480,15
2020-11-06,San Bernardino,071,2135413,71747,66740,592,67332,1179
2020-11-06,San Diego,073,3302833,63262,59143,1937,61080,907
2020-11-06,San Francisco,075,870044,13383,12825,64,12889,146
2020-11-06,San Joaquin,077,732212,23313,22424,304,22728,502
2020-11-06,San Luis Obispo,079,281455,5080,4531,53,4584,32
2020-11-06,San Mateo,081,765935,12294,11587,10,11597,168
2020-11-06,Santa Barbara,083,443738,10377,10118,138,10256,133
2020-11-06,Santa Clara,085,1922200,28078,25831,53,25884,402
2020-11-06,Santa Cruz,087,273765,3311,3063,37,3100,25
2020-11-06,Shasta,089,179085,3237,2475,41,2516,35
2020-11-06,Sierra,091,2930,9,7,0,7,0
2020-11-06,Siskiyou,093,43540,286,237,12,249,0
2020-11-06,Solano,095,438530,8423,7959,41,8000,85
2020-11-06,Sonoma,097,501317,10663,10142,35,10177,149
2020-11-06,Stanislaus,099,539301,18775,18250,918,19168,417
2020-11-06,Sutter,101,95872,2099,1937,2,1939,12
2020-11-06,Tehama,103,63373,1135,1024,3,1027,6
2020-11-06,Trinity,105,12862,143,41,16,57,0
2020-11-06,Tulare,107,460477,18972,18136,618,18754,300
2020-11-06,Tuolumne,109,53932,439,316,4,320,5
2020-11-06,Ventura,111,848112,16316,15222,449,15671,154
2020-11-06,Yolo,113,214977,3673,3420,9,3429,62
2020-11-06,Yuba,115,75493,1427,1335,7,1342,10
2020-11-05,Alameda,001,1643700,25362,24270,249,24519,420
2020-11-05,Alpine,003,1148,24,6,0,6,0
2020-11-05,Amador,005,37829,395,363,0,363,16
2020-11-05,Butte,007,227075,3410,3239,57,3296,57
2020-11-05,Calaveras,009,45235,358,333,0,333,19
2020-11-05,Colusa,011,21464,591,574,1,575,6
2020-11-05,Contra Costa,013,1133247,20502,19656,102,19758,252
2020-11-05,Del Norte,015,27424,201,192,0,192,2
2020-11-05,El Dorado,017,186661,1605,1466,7,1473,4
2020-11-05,Fresno,019,978130,35586,32056,624,32680,460
2020-11-05,Glenn,021,27897,736,702,7,709,3
2020-11-05,Humboldt,023,135768,627,581,1,582,9
2020-11-05,Imperial,025,180216,13660,13178,26,13204,337
2020-11-05,Inyo,027,18085,259,247,5,252,14
2020-11-05,Kern,029,883053,35451,34232,595,34827,443
2020-11-05,Kings,031,150075,9286,8846,76,8922,83
2020-11-05,Lake,033,64148,783,739,0,739,16
2020-11-05,Lassen,035,31185,822,782,2,784,0
2020-11-05,Los Angeles,037,10098052,322781,312381,3505,315886,7146
2020-11-05,Madera,039,155013,5364,5129,62,5191,54
2020-11-05,Marin,041,260295,7316,7171,22,7193,131
2020-11-05,Mariposa,043,17540,88,79,0,79,2
2020-11-05,Mendocino,045,87422,1186,1112,5,1117,22
2020-11-05,Merced,047,269075,10090,9753,51,9804,155
2020-11-05,Modoc,049,8938,69,47,11,58,0
2020-11-05,Mono,051,14174,450,307,8,315,1
2020-11-05,Monterey,053,433212,12445,11784,104,11888,96
2020-11-05,Napa,055,140530,2392,2158,9,2167,15
2020-11-05,Nevada,057,99092,780,687,20,707,9
2020-11-05,Orange,059,3164182,64435,60740,1963,62703,1484
2020-11-05,Placer,061,380077,5057,4627,27,4654,60
2020-11-05,Plumas,063,18699,114,90,0,90,0
2020-11-05,Riverside,065,2383286,73074,70094,726,70820,1338
2020-11-05,Sacramento,067,1510023,28616,27232,42,27274,512
2020-11-05,San Benito,069,59416,1536,1477,1,1478,15
2020-11-05,San Bernardino,071,2135413,70918,66407,579,66986,1174
2020-11-05,San Diego,073,3302833,62636,58659,1911,60570,904
2020-11-05,San Francisco,075,870044,13271,12726,63,12789,146
2020-11-05,San Joaquin,077,732212,23149,22318,300,22618,502
2020-11-05,San Luis Obispo,079,281455,5013,4459,51,4510,32
2020-11-05,San Mateo,081,765935,12200,11535,10,11545,168
2020-11-05,Santa Barbara,083,443738,10333,10080,135,10215,133
2020-11-05,Santa Clara,085,1922200,27811,25651,53,25704,402
2020-11-05,Santa Cruz,087,273765,3273,3023,37,3060,25
2020-11-05,Shasta,089,179085,3147,2401,40,2441,34
2020-11-05,Sierra,091,2930,9,6,0,6,0
2020-11-05,Siskiyou,093,43540,275,228,12,240,0
2020-11-05,Solano,095,438530,8340,7842,41,7883,85
2020-11-05,Sonoma,097,501317,10551,10064,34,10098,145
2020-11-05,Stanislaus,099,539301,18661,18194,905,19099,417
2020-11-05,Sutter,101,95872,2067,1925,2,1927,12
2020-11-05,Tehama,103,63373,1113,1015,2,1017,6
2020-11-05,Trinity,105,12862,127,41,15,56,0
2020-11-05,Tulare,107,460477,18884,18049,592,18641,301
2020-11-05,Tuolumne,109,53932,410,312,4,316,5
2020-11-05,Ventura,111,848112,16150,15113,438,15551,155
2020-11-05,Yolo,113,214977,3623,3391,9,3400,61
2020-11-05,Yuba,115,75493,1409,1322,7,1329,10
2020-11-04,Alameda,001,1643700,25185,24172,247,24419,418
2020-11-04,Alpine,003,1148,20,5,0,5,0
2020-11-04,Amador,005,37829,392,362,0,362,16
2020-11-04,Butte,007,227075,3384,3218,54,3272,57
2020-11-04,Calaveras,009,45235,355,290,0,290,19
2020-11-04,Colusa,011,21464,589,571,1,572,6
2020-11-04,Contra Costa,013,1133247,20335,19472,99,19571,251
2020-11-04,Del Norte,015,27424,197,188,0,188,2
2020-11-04,El Dorado,017,186661,1590,1448,4,1452,4
2020-11-04,Fresno,019,978130,35353,31952,596,32548,457
2020-11-04,Glenn,021,27897,732,701,6,707,3
2020-11-04,Humboldt,023,135768,618,571,1,572,9
2020-11-04,Imperial,025,180216,13562,13087,26,13113,335
2020-11-04,Inyo,027,18085,258,247,5,252,14
2020-11-04,Kern,029,883053,35296,34027,584,34611,439
2020-11-04,Kings,031,150075,9252,8817,74,8891,83
2020-11-04,Lake,033,64148,776,735,0,735,16
2020-11-04,Lassen,035,31185,817,781,2,783,0
2020-11-04,Los Angeles,037,10098052,320471,310456,3425,313881,7124
2020-11-04,Madera,039,155013,5344,5083,58,5141,54
2020-11-04,Marin,041,260295,7304,7157,22,7179,131
2020-11-04,Mariposa,043,17540,88,79,0,79,2
2020-11-04,Mendocino,045,87422,1168,1089,5,1094,22
2020-11-04,Merced,047,269075,10040,9717,49,9766,153
2020-11-04,Modoc,049,8938,59,47,11,58,0
2020-11-04,Mono,051,14174,447,237,7,244,1
2020-11-04,Monterey,053,433212,12241,11743,98,11841,96
2020-11-04,Napa,055,140530,2338,2133,9,2142,15
2020-11-04,Nevada,057,99092,761,675,20,695,9
2020-11-04,Orange,059,3164182,64001,60463,1940,62403,1483
2020-11-04,Placer,061,380077,4978,4526,24,4550,60
2020-11-04,Plumas,063,18699,112,88,0,88,0
2020-11-04,Riverside,065,2383286,72457,69562,667,70229,1335
2020-11-04,Sacramento,067,1510023,28265,27005,41,27046,510
2020-11-04,San Benito,069,59416,1521,1464,1,1465,15
2020-11-04,San Bernardino,071,2135413,70119,65891,556,66447,1169
2020-11-04,San Diego,073,3302833,61990,58126,1885,60011,904
2020-11-04,San Francisco,075,870044,13187,12649,60,12709,146
2020-11-04,San Joaquin,077,732212,23012,22197,287,22484,500
2020-11-04,San Luis Obispo,079,281455,4946,4389,49,4438,32
2020-11-04,San Mateo,081,765935,12105,11456,10,11466,168
2020-11-04,Santa Barbara,083,443738,10295,10026,134,10160,132
2020-11-04,Santa Clara,085,1922200,27548,25487,53,25540,393
2020-11-04,Santa Cruz,087,273765,3236,2997,37,3034,25
2020-11-04,Shasta,089,179085,3016,2321,35,2356,34
2020-11-04,Sierra,091,2930,9,6,0,6,0
2020-11-04,Siskiyou,093,43540,266,222,12,234,0
2020-11-04,Solano,095,438530,8241,7733,41,7774,85
2020-11-04,Sonoma,097,501317,10457,9965,34,9999,142
2020-11-04,Stanislaus,099,539301,18544,18114,890,19004,416
2020-11-04,Sutter,101,95872,2033,1916,2,1918,12
2020-11-04,Tehama,103,63373,1088,997,2,999,6
2020-11-04,Trinity,105,12862,123,37,15,52,0
2020-11-04,Tulare,107,460477,18775,17952,564,18516,298
2020-11-04,Tuolumne,109,53932,388,310,4,314,5
2020-11-04,Ventura,111,848112,16009,14936,435,15371,155
2020-11-04,Yolo,113,214977,3582,3361,9,3370,62
2020-11-04,Yuba,115,75493,1388,1312,7,1319,10
2020-11-03,Alameda,001,1643700,25001,24055,245,24300,418
2020-11-03,Alpine,003,1148,19,4,0,4,0
2020-11-03,Amador,005,37829,387,361,0,361,16
2020-11-03,Butte,007,227075,3360,3211,49,3260,57
2020-11-03,Calaveras,009,45235,351,287,0,287,19
2020-11-03,Colusa,011,21464,584,572,1,573,6
2020-11-03,Contra Costa,013,1133247,20180,19416,99,19515,250
2020-11-03,Del Norte,015,27424,196,187,0,187,2
2020-11-03,El Dorado,017,186661,1568,1445,3,1448,4
2020-11-03,Fresno,019,978130,35083,31856,573,32429,457
2020-11-03,Glenn,021,27897,726,698,6,704,3
2020-11-03,Humboldt,023,135768,612,570,1,571,8
2020-11-03,Imperial,025,180216,13473,13044,25,13069,335
2020-11-03,Inyo,027,18085,257,244,5,249,14
2020-11-03,Kern,029,883053,35105,33957,573,34530,439
2020-11-03,Kings,031,150075,9089,8783,69,8852,83
2020-11-03,Lake,033,64148,766,732,0,732,16
2020-11-03,Lassen,035,31185,808,782,2,784,0
2020-11-03,Los Angeles,037,10098052,318015,308812,3357,312169,7104
2020-11-03,Madera,039,155013,5307,5058,57,5115,54
2020-11-03,Marin,041,260295,7284,7147,21,7168,131
2020-11-03,Mariposa,043,17540,87,79,0,79,2
2020-11-03,Mendocino,045,87422,1153,1084,5,1089,22
2020-11-03,Merced,047,269075,9987,9713,48,9761,153
2020-11-03,Modoc,049,8938,57,47,9,56,0
2020-11-03,Mono,051,14174,443,210,7,217,1
2020-11-03,Monterey,053,433212,12172,11703,91,11794,94
2020-11-03,Napa,055,140530,2302,2130,9,2139,15
2020-11-03,Nevada,057,99092,741,670,19,689,9
2020-11-03,Orange,059,3164182,63571,60283,1929,62212,1477
2020-11-03,Placer,061,380077,4904,4514,24,4538,60
2020-11-03,Plumas,063,18699,109,86,0,86,0
2020-11-03,Riverside,065,2383286,71838,69300,642,69942,1325
2020-11-03,Sacramento,067,1510023,27885,26841,40,26881,510
2020-11-03,San Benito,069,59416,1511,1463,1,1464,15
2020-11-03,San Bernardino,071,2135413,69307,65320,548,65868,1159
2020-11-03,San Diego,073,3302833,61314,57722,1841,59563,901
2020-11-03,San Francisco,075,870044,13064,12585,60,12645,146
2020-11-03,San Joaquin,077,732212,22877,22109,281,22390,500
2020-11-03,San Luis Obispo,079,281455,4862,4371,47,4418,32
2020-11-03,San Mateo,081,765935,12010,11406,10,11416,162
2020-11-03,Santa Barbara,083,443738,10241,10008,129,10137,132
2020-11-03,Santa Clara,085,1922200,27276,25386,52,25438,393
2020-11-03,Santa Cruz,087,273765,3186,2980,36,3016,25
2020-11-03,Shasta,089,179085,2922,2288,28,2316,33
2020-11-03,Sierra,091,2930,7,6,0,6,0
2020-11-03,Siskiyou,093,43540,262,219,11,230,0
2020-11-03,Solano,095,438530,8158,7691,41,7732,85
2020-11-03,Sonoma,097,501317,10355,9906,34,9940,142
2020-11-03,Stanislaus,099,539301,18423,18080,879,18959,416
2020-11-03,Sutter,101,95872,2000,1914,2,1916,12
2020-11-03,Tehama,103,63373,1067,988,2,990,6
2020-11-03,Trinity,105,12862,116,36,14,50,0
2020-11-03,Tulare,107,460477,18669,17890,539,18429,297
2020-11-03,Tuolumne,109,53932,365,302,4,306,5
2020-11-03,Ventura,111,848112,15882,14816,428,15244,155
2020-11-03,Yolo,113,214977,3531,3343,9,3352,61
2020-11-03,Yuba,115,75493,1375,1295,7,1302,10
2020-11-02,Alameda,001,1643700,24805,23991,242,24233,419
2020-11-02,Alpine,003,1148,16,4,0,4,0
2020-11-02,Amador,005,37829,379,357,0,357,16
2020-11-02,Butte,007,227075,3340,3198,46,3244,57
2020-11-02,Calaveras,009,45235,351,282,0,282,18
2020-11-02,Colusa,011,21464,579,571,1,572,6
2020-11-02,Contra Costa,013,1133247,20026,19339,98,19437,250
2020-11-02,Del Norte,015,27424,193,175,0,175,2
2020-11-02,El Dorado,017,186661,1544,1405,3,1408,4
2020-11-02,Fresno,019,978130,34814,31738,556,32294,451
2020-11-02,Glenn,021,27897,720,692,5,697,3
2020-11-02,Humboldt,023,135768,603,569,1,570,8
2020-11-02,Imperial,025,180216,13393,13004,24,13028,334
2020-11-02,Inyo,027,18085,254,243,5,248,14
2020-11-02,Kern,029,883053,34947,33834,563,34397,437
2020-11-02,Kings,031,150075,9059,8654,66,8720,82
2020-11-02,Lake,033,64148,760,728,0,728,17
2020-11-02,Lassen,035,31185,800,782,2,784,0
2020-11-02,Los Angeles,037,10098052,315671,307620,3279,310899,7079
2020-11-02,Madera,039,155013,5276,5033,56,5089,54
2020-11-02,Marin,041,260295,7266,7132,20,7152,125
2020-11-02,Mariposa,043,17540,87,79,0,79,2
2020-11-02,Mendocino,045,87422,1139,1076,5,1081,21
2020-11-02,Merced,047,269075,9925,9664,42,9706,152
2020-11-02,Modoc,049,8938,54,45,5,50,0
2020-11-02,Mono,051,14174,441,211,7,218,1
2020-11-02,Monterey,053,433212,12065,11602,88,11690,93
2020-11-02,Napa,055,140530,2260,2081,9,2090,15
2020-11-02,Nevada,057,99092,725,656,19,675,9
2020-11-02,Orange,059,3164182,63166,59996,1913,61909,1474
2020-11-02,Placer,061,380077,4836,4461,22,4483,60
2020-11-02,Plumas,063,18699,101,86,0,86,0
2020-11-02,Riverside,065,2383286,71207,68833,601,69434,1321
2020-11-02,Sacramento,067,1510023,27543,26676,38,26714,508
2020-11-02,San Benito,069,59416,1499,1459,1,1460,15
2020-11-02,San Bernardino,071,2135413,68452,64629,537,65166,1157
2020-11-02,San Diego,073,3302833,60591,57429,1796,59225,891
2020-11-02,San Francisco,075,870044,12967,12436,59,12495,145
2020-11-02,San Joaquin,077,732212,22737,21919,273,22192,500
2020-11-02,San Luis Obispo,079,281455,4762,4303,44,4347,31
2020-11-02,San Mateo,081,765935,11901,11328,10,11338,161
2020-11-02,Santa Barbara,083,443738,10200,9985,124,10109,130
2020-11-02,Santa Clara,085,1922200,26986,25222,52,25274,387
2020-11-02,Santa Cruz,087,273765,3144,2943,36,2979,25
2020-11-02,Shasta,089,179085,2819,2174,24,2198,33
2020-11-02,Sierra,091,2930,7,6,0,6,0
2020-11-02,Siskiyou,093,43540,252,216,11,227,0
2020-11-02,Solano,095,438530,8040,7665,41,7706,84
2020-11-02,Sonoma,097,501317,10273,9796,33,9829,140
2020-11-02,Stanislaus,099,539301,18327,18005,870,18875,412
2020-11-02,Sutter,101,95872,1976,1895,2,1897,12
2020-11-02,Tehama,103,63373,1044,971,2,973,6
2020-11-02,Trinity,105,12862,110,30,14,44,0
2020-11-02,Tulare,107,460477,18576,17774,518,18292,299
2020-11-02,Tuolumne,109,53932,344,302,4,306,5
2020-11-02,Ventura,111,848112,15741,14767,414,15181,156
2020-11-02,Yolo,113,214977,3482,3318,9,3327,61
2020-11-02,Yuba,115,75493,1362,1280,7,1287,10
2020-11-01,Alameda,001,1643700,24642,23892,240,24132,419
2020-11-01,Alpine,003,1148,10,4,0,4,0
2020-11-01,Amador,005,37829,376,352,0,352,16
2020-11-01,Butte,007,227075,3316,3185,45,3230,57
2020-11-01,Calaveras,009,45235,350,282,0,282,18
2020-11-01,Colusa,011,21464,577,567,1,568,6
2020-11-01,Contra Costa,013,1133247,19852,19246,97,19343,250
2020-11-01,Del Norte,015,27424,189,175,0,175,2
2020-11-01,El Dorado,017,186661,1528,1394,3,1397,4
2020-11-01,Fresno,019,978130,34557,31613,536,32149,451
2020-11-01,Glenn,021,27897,711,688,3,691,3
2020-11-01,Humboldt,023,135768,595,568,1,569,8
2020-11-01,Imperial,025,180216,13302,12969,22,12991,334
2020-11-01,Inyo,027,18085,252,241,5,246,14
2020-11-01,Kern,029,883053,34766,33760,468,34228,437
2020-11-01,Kings,031,150075,9021,8641,65,8706,82
2020-11-01,Lake,033,64148,754,727,0,727,17
2020-11-01,Lassen,035,31185,800,782,2,784,0
2020-11-01,Los Angeles,037,10098052,313105,306217,3186,309403,7077
2020-11-01,Madera,039,155013,5228,5019,54,5073,54
2020-11-01,Marin,041,260295,7249,7124,20,7144,125
2020-11-01,Mariposa,043,17540,83,79,0,79,2
2020-11-01,Mendocino,045,87422,1126,1074,5,1079,21
2020-11-01,Merced,047,269075,9864,9626,42,9668,152
2020-11-01,Modoc,049,8938,53,45,5,50,0
2020-11-01,Mono,051,14174,412,211,6,217,1
2020-11-01,Monterey,053,433212,11957,11587,85,11672,93
2020-11-01,Napa,055,140530,2226,2067,9,2076,15
2020-11-01,Nevada,057,99092,709,646,18,664,9
2020-11-01,Orange,059,3164182,62764,59733,1886,61619,1475
2020-11-01,Placer,061,380077,4770,4422,21,4443,58
2020-11-01,Plumas,063,18699,96,86,0,86,0
2020-11-01,Riverside,065,2383286,70577,68493,565,69058,1319
2020-11-01,Sacramento,067,1510023,27222,26442,38,26480,508
2020-11-01,San Benito,069,59416,1484,1451,1,1452,15
2020-11-01,San Bernardino,071,2135413,67609,64339,516,64855,1157
2020-11-01,San Diego,073,3302833,59903,57122,1756,58878,891
2020-11-01,San Francisco,075,870044,12844,12436,54,12490,145
2020-11-01,San Joaquin,077,732212,22609,21919,267,22186,500
2020-11-01,San Luis Obispo,079,281455,4682,4303,43,4346,31
2020-11-01,San Mateo,081,765935,11820,11280,10,11290,160
2020-11-01,Santa Barbara,083,443738,10149,9969,108,10077,130
2020-11-01,Santa Clara,085,1922200,26706,25090,52,25142,386
2020-11-01,Santa Cruz,087,273765,3091,2921,36,2957,25
2020-11-01,Shasta,089,179085,2684,2172,23,2195,33
2020-11-01,Sierra,091,2930,7,6,0,6,0
2020-11-01,Siskiyou,093,43540,247,205,11,216,0
2020-11-01,Solano,095,438530,7950,7591,41,7632,84
2020-11-01,Sonoma,097,501317,10181,9688,33,9721,140
2020-11-01,Stanislaus,099,539301,18226,17961,850,18811,412
2020-11-01,Sutter,101,95872,1950,1888,1,1889,12
2020-11-01,Tehama,103,63373,1027,965,2,967,5
2020-11-01,Trinity,105,12862,108,30,13,43,0
2020-11-01,Tulare,107,460477,18464,17774,487,18261,299
2020-11-01,Tuolumne,109,53932,322,295,4,299,5
2020-11-01,Ventura,111,848112,15592,14686,383,15069,156
2020-11-01,Yolo,113,214977,3434,3303,9,3312,60
2020-11-01,Yuba,115,75493,1345,1273,7,1280,10
2020-10-31,Alameda,001,1643700,24526,23780,236,24016,416
2020-10-31,Alpine,003,1148,10,4,0,4,0
2020-10-31,Amador,005,37829,372,347,0,347,16
2020-10-31,Butte,007,227075,3303,3172,43,3215,57
2020-10-31,Calaveras,009,45235,350,280,0,280,18
2020-10-31,Colusa,011,21464,575,555,1,556,6
2020-10-31,Contra Costa,013,1133247,19746,19161,97,19258,249
2020-10-31,Del Norte,015,27424,188,175,0,175,2
2020-10-31,El Dorado,017,186661,1519,1390,3,1393,4
2020-10-31,Fresno,019,978130,34420,31558,533,32091,451
2020-10-31,Glenn,021,27897,709,678,3,681,3
2020-10-31,Humboldt,023,135768,592,561,1,562,8
2020-10-31,Imperial,025,180216,13260,12912,22,12934,334
2020-10-31,Inyo,027,18085,251,241,5,246,14
2020-10-31,Kern,029,883053,34663,33666,458,34124,437
2020-10-31,Kings,031,150075,9000,8612,64,8676,82
2020-10-31,Lake,033,64148,750,724,0,724,16
2020-10-31,Lassen,035,31185,795,782,2,784,0
2020-10-31,Los Angeles,037,10098052,311731,304704,3142,307846,7073
2020-10-31,Madera,039,155013,5210,5013,51,5064,54
2020-10-31,Marin,041,260295,7233,7112,20,7132,125
2020-10-31,Mariposa,043,17540,83,79,0,79,2
2020-10-31,Mendocino,045,87422,1118,1066,5,1071,21
2020-10-31,Merced,047,269075,9831,9597,41,9638,151
2020-10-31,Modoc,049,8938,52,34,4,38,0
2020-10-31,Mono,051,14174,263,194,5,199,1
2020-10-31,Monterey,053,433212,11889,11539,81,11620,93
2020-10-31,Napa,055,140530,2207,2040,9,2049,15
2020-10-31,Nevada,057,99092,691,644,18,662,9
2020-10-31,Orange,059,3164182,62506,59488,1868,61356,1473
2020-10-31,Placer,061,380077,4720,4374,20,4394,58
2020-10-31,Plumas,063,18699,95,85,0,85,0
2020-10-31,Riverside,065,2383286,70220,68178,542,68720,1319
2020-10-31,Sacramento,067,1510023,27023,26316,36,26352,507
2020-10-31,San Benito,069,59416,1477,1448,1,1449,15
2020-10-31,San Bernardino,071,2135413,67184,64016,506,64522,1157
2020-10-31,San Diego,073,3302833,59450,56769,1728,58497,891
2020-10-31,San Francisco,075,870044,12770,12438,53,12491,145
2020-10-31,San Joaquin,077,732212,22534,21918,258,22176,500
2020-10-31,San Luis Obispo,079,281455,4613,4285,40,4325,31
2020-10-31,San Mateo,081,765935,11768,11253,10,11263,160
2020-10-31,Santa Barbara,083,443738,10120,9957,100,10057,130
2020-10-31,Santa Clara,085,1922200,26537,24957,52,25009,379
2020-10-31,Santa Cruz,087,273765,3056,2895,35,2930,25
2020-10-31,Shasta,089,179085,2630,2122,22,2144,33
2020-10-31,Sierra,091,2930,7,6,0,6,0
2020-10-31,Siskiyou,093,43540,245,200,11,211,0
2020-10-31,Solano,095,438530,7886,7545,41,7586,84
2020-10-31,Sonoma,097,501317,10128,9648,33,9681,140
2020-10-31,Stanislaus,099,539301,18163,17920,834,18754,412
2020-10-31,Sutter,101,95872,1941,1876,1,1877,12
2020-10-31,Tehama,103,63373,1017,953,2,955,5
2020-10-31,Trinity,105,12862,105,30,13,43,0
2020-10-31,Tulare,107,460477,18415,17758,479,18237,299
2020-10-31,Tuolumne,109,53932,315,290,4,294,5
2020-10-31,Ventura,111,848112,15508,14635,365,15000,155
2020-10-31,Yolo,113,214977,3399,3290,9,3299,60
2020-10-31,Yuba,115,75493,1329,1260,6,1266,10
2020-10-30,Alameda,001,1643700,24446,23676,234,23910,401
2020-10-30,Alpine,003,1148,10,4,0,4,0
2020-10-30,Amador,005,37829,372,344,0,344,16
2020-10-30,Butte,007,227075,3298,3160,43,3203,57
2020-10-30,Calaveras,009,45235,349,279,0,279,18
2020-10-30,Colusa,011,21464,573,554,1,555,6
2020-10-30,Contra Costa,013,1133247,19674,19074,97,19171,249
2020-10-30,Del Norte,015,27424,187,175,0,175,2
2020-10-30,El Dorado,017,186661,1506,1386,3,1389,4
2020-10-30,Fresno,019,978130,34298,31409,524,31933,446
2020-10-30,Glenn,021,27897,703,674,2,676,3
2020-10-30,Humboldt,023,135768,591,561,1,562,7
2020-10-30,Imperial,025,180216,13219,12853,22,12875,334
2020-10-30,Inyo,027,18085,250,241,5,246,14
2020-10-30,Kern,029,883053,34570,33583,457,34040,437
2020-10-30,Kings,031,150075,8990,8564,62,8626,82
2020-10-30,Lake,033,64148,750,720,0,720,16
2020-10-30,Lassen,035,31185,789,777,2,779,0
2020-10-30,Los Angeles,037,10098052,310295,303425,3107,306532,7060
2020-10-30,Madera,039,155013,5198,4991,49,5040,54
2020-10-30,Marin,041,260295,7213,7097,20,7117,125
2020-10-30,Mariposa,043,17540,83,78,0,78,2
2020-10-30,Mendocino,045,87422,1116,1062,5,1067,21
2020-10-30,Merced,047,269075,9799,9539,41,9580,150
2020-10-30,Modoc,049,8938,51,34,3,37,0
2020-10-30,Mono,051,14174,262,193,5,198,1
2020-10-30,Monterey,053,433212,11826,11491,76,11567,92
2020-10-30,Napa,055,140530,2189,2028,9,2037,15
2020-10-30,Nevada,057,99092,685,634,18,652,9
2020-10-30,Orange,059,3164182,62264,59334,1856,61190,1469
2020-10-30,Placer,061,380077,4673,4335,20,4355,58
2020-10-30,Plumas,063,18699,92,80,0,80,0
2020-10-30,Riverside,065,2383286,69880,67752,522,68274,1317
2020-10-30,Sacramento,067,1510023,26875,26147,36,26183,505
2020-10-30,San Benito,069,59416,1471,1440,1,1441,15
2020-10-30,San Bernardino,071,2135413,66768,63512,503,64015,1156
2020-10-30,San Diego,073,3302833,59045,56387,1706,58093,888
2020-10-30,San Francisco,075,870044,12715,12384,53,12437,145
2020-10-30,San Joaquin,077,732212,22467,21849,252,22101,500
2020-10-30,San Luis Obispo,079,281455,4570,4256,40,4296,31
2020-10-30,San Mateo,081,765935,11709,11207,10,11217,159
2020-10-30,Santa Barbara,083,443738,10097,9937,100,10037,128
2020-10-30,Santa Clara,085,1922200,26388,24811,52,24863,378
2020-10-30,Santa Cruz,087,273765,3038,2874,35,2909,25
2020-10-30,Shasta,089,179085,2586,2048,21,2069,32
2020-10-30,Sierra,091,2930,7,6,0,6,0
2020-10-30,Siskiyou,093,43540,245,192,11,203,0
2020-10-30,Solano,095,438530,7825,7497,41,7538,84
2020-10-30,Sonoma,097,501317,10053,9602,33,9635,140
2020-10-30,Stanislaus,099,539301,18115,17861,818,18679,410
2020-10-30,Sutter,101,95872,1928,1860,1,1861,12
2020-10-30,Tehama,103,63373,1013,932,2,934,5
2020-10-30,Trinity,105,12862,105,29,13,42,0
2020-10-30,Tulare,107,460477,18370,17682,464,18146,299
2020-10-30,Tuolumne,109,53932,308,286,4,290,4
2020-10-30,Ventura,111,848112,15435,14578,353,14931,154
2020-10-30,Yolo,113,214977,3382,3263,9,3272,60
2020-10-30,Yuba,115,75493,1321,1256,6,1262,10
2020-10-29,Alameda,001,1643700,24282,23530,233,23763,401
2020-10-29,Alpine,003,1148,7,4,0,4,0
2020-10-29,Amador,005,37829,368,338,0,338,16
2020-10-29,Butte,007,227075,3280,3143,42,3185,57
2020-10-29,Calaveras,009,45235,347,278,0,278,13
2020-10-29,Colusa,011,21464,569,552,1,553,6
2020-10-29,Contra Costa,013,1133247,19575,18933,96,19029,249
2020-10-29,Del Norte,015,27424,185,174,0,174,2
2020-10-29,El Dorado,017,186661,1484,1370,3,1373,4
2020-10-29,Fresno,019,978130,34141,31321,517,31838,445
2020-10-29,Glenn,021,27897,701,673,2,675,3
2020-10-29,Humboldt,023,135768,586,559,1,560,7
2020-10-29,Imperial,025,180216,13175,12769,22,12791,334
2020-10-29,Inyo,027,18085,248,238,5,243,14
2020-10-29,Kern,029,883053,34469,33460,453,33913,437
2020-10-29,Kings,031,150075,8836,8502,61,8563,82
2020-10-29,Lake,033,64148,747,702,0,702,16
2020-10-29,Lassen,035,31185,788,772,2,774,0
2020-10-29,Los Angeles,037,10098052,308666,302246,3061,305307,7046
2020-10-29,Madera,039,155013,5168,4970,47,5017,53
2020-10-29,Marin,041,260295,7199,7083,20,7103,125
2020-10-29,Mariposa,043,17540,81,78,0,78,2
2020-10-29,Mendocino,045,87422,1110,1058,5,1063,21
2020-10-29,Merced,047,269075,9747,9496,41,9537,150
2020-10-29,Modoc,049,8938,49,31,3,34,0
2020-10-29,Mono,051,14174,255,176,5,181,1
2020-10-29,Monterey,053,433212,11745,11425,74,11499,92
2020-10-29,Napa,055,140530,2165,2009,9,2018,15
2020-10-29,Nevada,057,99092,678,632,18,650,9
2020-10-29,Orange,059,3164182,61996,59046,1836,60882,1464
2020-10-29,Placer,061,380077,4628,4270,18,4288,58
2020-10-29,Plumas,063,18699,90,69,0,69,0
2020-10-29,Riverside,065,2383286,69503,67268,492,67760,1304
2020-10-29,Sacramento,067,1510023,26663,25978,35,26013,507
2020-10-29,San Benito,069,59416,1466,1431,1,1432,15
2020-10-29,San Bernardino,071,2135413,66200,62968,493,63461,1150
2020-10-29,San Diego,073,3302833,58579,55916,1677,57593,885
2020-10-29,San Francisco,075,870044,12636,12312,53,12365,145
2020-10-29,San Joaquin,077,732212,22383,21736,240,21976,498
2020-10-29,San Luis Obispo,079,281455,4540,4223,39,4262,31
2020-10-29,San Mateo,081,765935,11663,11145,10,11155,157
2020-10-29,Santa Barbara,083,443738,10064,9902,98,10000,128
2020-10-29,Santa Clara,085,1922200,26236,24614,52,24666,377
2020-10-29,Santa Cruz,087,273765,3013,2850,35,2885,24
2020-10-29,Shasta,089,179085,2523,2008,21,2029,32
2020-10-29,Sierra,091,2930,6,6,0,6,0
2020-10-29,Siskiyou,093,43540,229,185,11,196,0
2020-10-29,Solano,095,438530,7763,7453,41,7494,78
2020-10-29,Sonoma,097,501317,9989,9533,33,9566,140
2020-10-29,Stanislaus,099,539301,18062,17790,797,18587,410
2020-10-29,Sutter,101,95872,1920,1852,1,1853,12
2020-10-29,Tehama,103,63373,995,925,2,927,5
2020-10-29,Trinity,105,12862,100,28,12,40,0
2020-10-29,Tulare,107,460477,18292,17627,445,18072,299
2020-10-29,Tuolumne,109,53932,303,279,4,283,4
2020-10-29,Ventura,111,848112,15344,14486,349,14835,154
2020-10-29,Yolo,113,214977,3353,3246,9,3255,60
2020-10-29,Yuba,115,75493,1310,1248,6,1254,10
2020-10-28,Alameda,001,1643700,24182,23468,232,23700,400
2020-10-28,Alpine,003,1148,6,4,0,4,0
2020-10-28,Amador,005,37829,365,337,0,337,16
2020-10-28,Butte,007,227075,3264,3134,39,3173,56
2020-10-28,Calaveras,009,45235,346,278,0,278,13
2020-10-28,Colusa,011,21464,566,551,1,552,6
2020-10-28,Contra Costa,013,1133247,19488,18828,95,18923,246
2020-10-28,Del Norte,015,27424,182,173,0,173,2
2020-10-28,El Dorado,017,186661,1472,1363,3,1366,4
2020-10-28,Fresno,019,978130,34019,31195,511,31706,444
2020-10-28,Glenn,021,27897,697,673,2,675,3
2020-10-28,Humboldt,023,135768,582,559,1,560,7
2020-10-28,Imperial,025,180216,13126,12730,22,12752,333
2020-10-28,Inyo,027,18085,248,238,5,243,14
2020-10-28,Kern,029,883053,34367,33424,434,33858,436
2020-10-28,Kings,031,150075,8814,8486,60,8546,82
2020-10-28,Lake,033,64148,744,700,0,700,15
2020-10-28,Lassen,035,31185,784,771,2,773,0
2020-10-28,Los Angeles,037,10098052,307207,300726,3019,303745,7031
2020-10-28,Madera,039,155013,5151,4954,46,5000,53
2020-10-28,Marin,041,260295,7188,7079,20,7099,126
2020-10-28,Mariposa,043,17540,81,78,0,78,2
2020-10-28,Mendocino,045,87422,1109,1037,5,1042,20
2020-10-28,Merced,047,269075,9721,9480,40,9520,150
2020-10-28,Modoc,049,8938,48,31,2,33,0
2020-10-28,Mono,051,14174,237,176,5,181,1
2020-10-28,Monterey,053,433212,11687,11330,72,11402,89
2020-10-28,Napa,055,140530,2139,1998,8,2006,15
2020-10-28,Nevada,057,99092,670,629,18,647,9
2020-10-28,Orange,059,3164182,61732,58801,1820,60621,1459
2020-10-28,Placer,061,380077,4572,4236,18,4254,57
2020-10-28,Plumas,063,18699,89,67,0,67,0
2020-10-28,Riverside,065,2383286,69105,67003,468,67471,1302
2020-10-28,Sacramento,067,1510023,26467,25838,34,25872,506
2020-10-28,San Benito,069,59416,1458,1429,1,1430,15
2020-10-28,San Bernardino,071,2135413,65740,62778,484,63262,1154
2020-10-28,San Diego,073,3302833,58196,55556,1648,57204,881
2020-10-28,San Francisco,075,870044,12578,12261,52,12313,145
2020-10-28,San Joaquin,077,732212,22299,21707,229,21936,498
2020-10-28,San Luis Obispo,079,281455,4496,4197,36,4233,31
2020-10-28,San Mateo,081,765935,11596,11101,10,11111,157
2020-10-28,Santa Barbara,083,443738,10040,9872,96,9968,127
2020-10-28,Santa Clara,085,1922200,26092,24503,52,24555,375
2020-10-28,Santa Cruz,087,273765,2982,2836,35,2871,24
2020-10-28,Shasta,089,179085,2443,1996,20,2016,31
2020-10-28,Sierra,091,2930,6,6,0,6,0
2020-10-28,Siskiyou,093,43540,226,182,10,192,0
2020-10-28,Solano,095,438530,7704,7362,41,7403,77
2020-10-28,Sonoma,097,501317,9899,9457,28,9485,140
2020-10-28,Stanislaus,099,539301,17997,17765,787,18552,409
2020-10-28,Sutter,101,95872,1911,1840,1,1841,12
2020-10-28,Tehama,103,63373,984,921,2,923,5
2020-10-28,Trinity,105,12862,93,28,11,39,0
2020-10-28,Tulare,107,460477,18235,17569,429,17998,297
2020-10-28,Tuolumne,109,53932,300,277,4,281,4
2020-10-28,Ventura,111,848112,15271,14409,340,14749,153
2020-10-28,Yolo,113,214977,3329,3230,9,3239,60
2020-10-28,Yuba,115,75493,1298,1245,6,1251,10
2020-10-27,Alameda,001,1643700,24066,23365,230,23595,400
2020-10-27,Alpine,003,1148,6,3,0,3,0
2020-10-27,Amador,005,37829,362,335,0,335,16
2020-10-27,Butte,007,227075,3248,3107,36,3143,56
2020-10-27,Calaveras,009,45235,344,277,0,277,13
2020-10-27,Colusa,011,21464,561,549,1,550,6
2020-10-27,Contra Costa,013,1133247,19383,18766,95,18861,246
2020-10-27,Del Norte,015,27424,179,173,0,173,2
2020-10-27,El Dorado,017,186661,1459,1351,3,1354,4
2020-10-27,Fresno,019,978130,33900,31096,506,31602,442
2020-10-27,Glenn,021,27897,695,667,1,668,3
2020-10-27,Humboldt,023,135768,579,559,1,560,7
2020-10-27,Imperial,025,180216,13077,12680,21,12701,333
2020-10-27,Inyo,027,18085,248,231,5,236,14
2020-10-27,Kern,029,883053,34250,33328,430,33758,436
2020-10-27,Kings,031,150075,8783,8411,60,8471,83
2020-10-27,Lake,033,64148,741,700,0,700,15
2020-10-27,Lassen,035,31185,782,764,2,766,0
2020-10-27,Los Angeles,037,10098052,305823,299438,2990,302428,7008
2020-10-27,Madera,039,155013,5121,4942,45,4987,53
2020-10-27,Marin,041,260295,7172,7070,20,7090,126
2020-10-27,Mariposa,043,17540,80,78,0,78,2
2020-10-27,Mendocino,045,87422,1103,1033,4,1037,20
2020-10-27,Merced,047,269075,9680,9449,40,9489,150
2020-10-27,Modoc,049,8938,46,31,2,33,0
2020-10-27,Mono,051,14174,223,169,5,174,1
2020-10-27,Monterey,053,433212,11631,11261,70,11331,88
2020-10-27,Napa,055,140530,2123,1979,8,1987,15
2020-10-27,Nevada,057,99092,664,622,18,640,8
2020-10-27,Orange,059,3164182,61461,58550,1804,60354,1448
2020-10-27,Placer,061,380077,4523,4197,16,4213,57
2020-10-27,Plumas,063,18699,86,63,0,63,0
2020-10-27,Riverside,065,2383286,68752,66699,423,67122,1299
2020-10-27,Sacramento,067,1510023,26280,25701,33,25734,501
2020-10-27,San Benito,069,59416,1453,1428,1,1429,15
2020-10-27,San Bernardino,071,2135413,65277,62357,471,62828,1154
2020-10-27,San Diego,073,3302833,57723,55226,1625,56851,877
2020-10-27,San Francisco,075,870044,12503,12218,51,12269,140
2020-10-27,San Joaquin,077,732212,22208,21637,220,21857,496
2020-10-27,San Luis Obispo,079,281455,4469,4148,32,4180,31
2020-10-27,San Mateo,081,765935,11547,11074,10,11084,156
2020-10-27,Santa Barbara,083,443738,10010,9874,95,9969,125
2020-10-27,Santa Clara,085,1922200,25950,24368,52,24420,367
2020-10-27,Santa Cruz,087,273765,2952,2815,34,2849,24
2020-10-27,Shasta,089,179085,2357,1962,20,1982,29
2020-10-27,Sierra,091,2930,6,6,0,6,0
2020-10-27,Siskiyou,093,43540,217,181,10,191,0
2020-10-27,Solano,095,438530,7635,7298,41,7339,77
2020-10-27,Sonoma,097,501317,9832,9389,28,9417,140
2020-10-27,Stanislaus,099,539301,17929,17720,780,18500,408
2020-10-27,Sutter,101,95872,1898,1832,1,1833,12
2020-10-27,Tehama,103,63373,970,913,2,915,5
2020-10-27,Trinity,105,12862,90,28,11,39,0
2020-10-27,Tulare,107,460477,18172,17520,406,17926,296
2020-10-27,Tuolumne,109,53932,296,275,4,279,4
2020-10-27,Ventura,111,848112,15188,14347,333,14680,153
2020-10-27,Yolo,113,214977,3315,3216,9,3225,58
2020-10-27,Yuba,115,75493,1285,1235,6,1241,10
2020-10-26,Alameda,001,1643700,23953,23284,229,23513,398
2020-10-26,Alpine,003,1148,4,3,0,3,0
2020-10-26,Amador,005,37829,358,331,0,331,16
2020-10-26,Butte,007,227075,3237,3095,34,3129,56
2020-10-26,Calaveras,009,45235,340,274,0,274,13
2020-10-26,Colusa,011,21464,559,548,1,549,6
2020-10-26,Contra Costa,013,1133247,19287,18718,94,18812,245
2020-10-26,Del Norte,015,27424,179,171,0,171,2
2020-10-26,El Dorado,017,186661,1445,1336,3,1339,4
2020-10-26,Fresno,019,978130,33787,30969,499,31468,441
2020-10-26,Glenn,021,27897,688,660,1,661,3
2020-10-26,Humboldt,023,135768,571,554,1,555,7
2020-10-26,Imperial,025,180216,13023,12654,18,12672,333
2020-10-26,Inyo,027,18085,248,226,5,231,14
2020-10-26,Kern,029,883053,34166,33233,425,33658,432
2020-10-26,Kings,031,150075,8761,8264,58,8322,82
2020-10-26,Lake,033,64148,739,697,0,697,15
2020-10-26,Lassen,035,31185,779,764,2,766,0
2020-10-26,Los Angeles,037,10098052,304395,297961,2948,300909,6979
2020-10-26,Madera,039,155013,5100,4922,44,4966,53
2020-10-26,Marin,041,260295,7166,7064,19,7083,104
2020-10-26,Mariposa,043,17540,80,77,0,77,2
2020-10-26,Mendocino,045,87422,1095,1026,4,1030,20
2020-10-26,Merced,047,269075,9633,9375,39,9414,150
2020-10-26,Modoc,049,8938,44,28,0,28,0
2020-10-26,Mono,051,14174,217,167,5,172,1
2020-10-26,Monterey,053,433212,11581,11207,66,11273,87
2020-10-26,Napa,055,140530,2091,1966,8,1974,14
2020-10-26,Nevada,057,99092,657,618,18,636,8
2020-10-26,Orange,059,3164182,61258,58377,1785,60162,1442
2020-10-26,Placer,061,380077,4481,4161,15,4176,57
2020-10-26,Plumas,063,18699,84,63,0,63,0
2020-10-26,Riverside,065,2383286,68300,66475,397,66872,1294
2020-10-26,Sacramento,067,1510023,26099,25555,31,25586,496
2020-10-26,San Benito,069,59416,1445,1424,1,1425,15
2020-10-26,San Bernardino,071,2135413,64806,61871,468,62339,1153
2020-10-26,San Diego,073,3302833,57330,54957,1587,56544,870
2020-10-26,San Francisco,075,870044,12443,12072,51,12123,138
2020-10-26,San Joaquin,077,732212,22125,21459,214,21673,495
2020-10-26,San Luis Obispo,079,281455,4444,4133,32,4165,31
2020-10-26,San Mateo,081,765935,11503,11037,10,11047,156
2020-10-26,Santa Barbara,083,443738,9987,9827,95,9922,122
2020-10-26,Santa Clara,085,1922200,25760,24258,51,24309,365
2020-10-26,Santa Cruz,087,273765,2926,2808,34,2842,24
2020-10-26,Shasta,089,179085,2303,1889,20,1909,29
2020-10-26,Sierra,091,2930,6,6,0,6,0
2020-10-26,Siskiyou,093,43540,209,179,10,189,0
2020-10-26,Solano,095,438530,7555,7271,41,7312,62
2020-10-26,Sonoma,097,501317,9753,9315,28,9343,140
2020-10-26,Stanislaus,099,539301,17879,17666,770,18436,400
2020-10-26,Sutter,101,95872,1890,1817,1,1818,12
2020-10-26,Tehama,103,63373,950,892,2,894,5
2020-10-26,Trinity,105,12862,89,26,11,37,0
2020-10-26,Tulare,107,460477,18095,17432,383,17815,296
2020-10-26,Tuolumne,109,53932,287,271,4,275,4
2020-10-26,Ventura,111,848112,15118,14330,330,14660,154
2020-10-26,Yolo,113,214977,3296,3206,9,3215,58
2020-10-26,Yuba,115,75493,1269,1226,6,1232,10
2020-10-25,Alameda,001,1643700,23847,23192,229,23421,398
2020-10-25,Alpine,003,1148,3,3,0,3,0
2020-10-25,Amador,005,37829,347,330,0,330,16
2020-10-25,Butte,007,227075,3218,3087,34,3121,56
2020-10-25,Calaveras,009,45235,339,274,0,274,13
2020-10-25,Colusa,011,21464,555,548,1,549,6
2020-10-25,Contra Costa,013,1133247,19186,18640,94,18734,245
2020-10-25,Del Norte,015,27424,175,171,0,171,2
2020-10-25,El Dorado,017,186661,1430,1328,3,1331,4
2020-10-25,Fresno,019,978130,33653,30858,486,31344,441
2020-10-25,Glenn,021,27897,685,652,1,653,3
2020-10-25,Humboldt,023,135768,568,554,1,555,7
2020-10-25,Imperial,025,180216,12973,12572,18,12590,333
2020-10-25,Inyo,027,18085,245,226,5,231,14
2020-10-25,Kern,029,883053,34059,33185,421,33606,432
2020-10-25,Kings,031,150075,8728,8246,56,8302,82
2020-10-25,Lake,033,64148,722,695,0,695,15
2020-10-25,Lassen,035,31185,776,764,2,766,0
2020-10-25,Los Angeles,037,10098052,302833,297110,2911,300021,6973
2020-10-25,Madera,039,155013,5070,4909,39,4948,53
2020-10-25,Marin,041,260295,7156,7052,19,7071,102
2020-10-25,Mariposa,043,17540,80,77,0,77,2
2020-10-25,Mendocino,045,87422,1088,1024,4,1028,20
2020-10-25,Merced,047,269075,9568,9352,37,9389,150
2020-10-25,Modoc,049,8938,39,28,0,28,0
2020-10-25,Mono,051,14174,209,167,5,172,1
2020-10-25,Monterey,053,433212,11498,11182,61,11243,87
2020-10-25,Napa,055,140530,2061,1962,8,1970,14
2020-10-25,Nevada,057,99092,649,616,18,634,8
2020-10-25,Orange,059,3164182,60970,58185,1776,59961,1443
2020-10-25,Placer,061,380077,4429,4140,15,4155,57
2020-10-25,Plumas,063,18699,84,63,0,63,0
2020-10-25,Riverside,065,2383286,67848,66192,381,66573,1289
2020-10-25,Sacramento,067,1510023,25883,25445,28,25473,496
2020-10-25,San Benito,069,59416,1438,1423,1,1424,15
2020-10-25,San Bernardino,071,2135413,64265,61551,456,62007,1153
2020-10-25,San Diego,073,3302833,56867,54599,1555,56154,870
2020-10-25,San Francisco,075,870044,12370,12072,51,12123,137
2020-10-25,San Joaquin,077,732212,22017,21459,206,21665,495
2020-10-25,San Luis Obispo,079,281455,4402,4126,30,4156,31
2020-10-25,San Mateo,081,765935,11458,10987,10,10997,156
2020-10-25,Santa Barbara,083,443738,9967,9814,95,9909,122
2020-10-25,Santa Clara,085,1922200,25572,24087,51,24138,365
2020-10-25,Santa Cruz,087,273765,2899,2789,34,2823,24
2020-10-25,Shasta,089,179085,2239,1889,20,1909,29
2020-10-25,Sierra,091,2930,6,6,0,6,0
2020-10-25,Siskiyou,093,43540,206,176,10,186,0
2020-10-25,Solano,095,438530,7477,7197,41,7238,60
2020-10-25,Sonoma,097,501317,9660,9235,27,9262,140
2020-10-25,Stanislaus,099,539301,17822,17641,760,18401,400
2020-10-25,Sutter,101,95872,1872,1811,1,1812,12
2020-10-25,Tehama,103,63373,933,880,2,882,5
2020-10-25,Trinity,105,12862,85,26,11,37,0
2020-10-25,Tulare,107,460477,18022,17431,373,17804,296
2020-10-25,Tuolumne,109,53932,282,271,4,275,4
2020-10-25,Ventura,111,848112,15025,14300,324,14624,154
2020-10-25,Yolo,113,214977,3275,3190,9,3199,58
2020-10-25,Yuba,115,75493,1261,1219,6,1225,10
2020-10-24,Alameda,001,1643700,23776,23099,226,23325,398
2020-10-24,Alpine,003,1148,3,3,0,3,0
2020-10-24,Amador,005,37829,346,328,0,328,16
2020-10-24,Butte,007,227075,3209,3078,34,3112,56
2020-10-24,Calaveras,009,45235,337,274,0,274,13
2020-10-24,Colusa,011,21464,550,548,1,549,6
2020-10-24,Contra Costa,013,1133247,19119,18567,94,18661,244
2020-10-24,Del Norte,015,27424,174,171,0,171,2
2020-10-24,El Dorado,017,186661,1414,1317,3,1320,4
2020-10-24,Fresno,019,978130,33592,30752,481,31233,441
2020-10-24,Glenn,021,27897,682,650,1,651,3
2020-10-24,Humboldt,023,135768,566,553,1,554,7
2020-10-24,Imperial,025,180216,12946,12469,18,12487,333
2020-10-24,Inyo,027,18085,245,226,5,231,14
2020-10-24,Kern,029,883053,34001,33105,415,33520,432
2020-10-24,Kings,031,150075,8718,8228,55,8283,82
2020-10-24,Lake,033,64148,717,696,0,696,15
2020-10-24,Lassen,035,31185,775,764,2,766,0
2020-10-24,Los Angeles,037,10098052,302014,296323,2889,299212,6969
2020-10-24,Madera,039,155013,5057,4898,38,4936,53
2020-10-24,Marin,041,260295,7147,7042,19,7061,102
2020-10-24,Mariposa,043,17540,80,77,0,77,2
2020-10-24,Mendocino,045,87422,1076,1022,4,1026,20
2020-10-24,Merced,047,269075,9544,9351,37,9388,150
2020-10-24,Modoc,049,8938,38,28,0,28,0
2020-10-24,Mono,051,14174,195,167,5,172,1
2020-10-24,Monterey,053,433212,11429,11153,60,11213,87
2020-10-24,Napa,055,140530,2044,1957,8,1965,14
2020-10-24,Nevada,057,99092,645,608,18,626,8
2020-10-24,Orange,059,3164182,60815,57928,1766,59694,1441
2020-10-24,Placer,061,380077,4398,4093,15,4108,57
2020-10-24,Plumas,063,18699,78,63,0,63,0
2020-10-24,Riverside,065,2383286,67640,65902,366,66268,1288
2020-10-24,Sacramento,067,1510023,25802,25372,28,25400,496
2020-10-24,San Benito,069,59416,1433,1417,1,1418,15
2020-10-24,San Bernardino,071,2135413,64025,61351,447,61798,1153
2020-10-24,San Diego,073,3302833,56590,54330,1542,55872,868
2020-10-24,San Francisco,075,870044,12312,12073,50,12123,137
2020-10-24,San Joaquin,077,732212,21965,21458,201,21659,495
2020-10-24,San Luis Obispo,079,281455,4377,4119,29,4148,31
2020-10-24,San Mateo,081,765935,11419,10942,10,10952,155
2020-10-24,Santa Barbara,083,443738,9950,9781,95,9876,122
2020-10-24,Santa Clara,085,1922200,25485,23978,51,24029,365
2020-10-24,Santa Cruz,087,273765,2880,2775,34,2809,24
2020-10-24,Shasta,089,179085,2194,1878,20,1898,29
2020-10-24,Sierra,091,2930,6,6,0,6,0
2020-10-24,Siskiyou,093,43540,205,174,10,184,0
2020-10-24,Solano,095,438530,7424,7189,41,7230,60
2020-10-24,Sonoma,097,501317,9626,9179,27,9206,140
2020-10-24,Stanislaus,099,539301,17778,17574,744,18318,400
2020-10-24,Sutter,101,95872,1863,1804,1,1805,12
2020-10-24,Tehama,103,63373,925,872,2,874,5
2020-10-24,Trinity,105,12862,85,25,11,36,0
2020-10-24,Tulare,107,460477,17999,17406,362,17768,295
2020-10-24,Tuolumne,109,53932,279,269,4,273,4
2020-10-24,Ventura,111,848112,14972,14240,323,14563,154
2020-10-24,Yolo,113,214977,3263,3164,9,3173,57
2020-10-24,Yuba,115,75493,1258,1210,6,1216,10
2020-10-23,Alameda,001,1643700,23703,23047,224,23271,393
2020-10-23,Alpine,003,1148,3,3,0,3,0
2020-10-23,Amador,005,37829,345,324,0,324,16
2020-10-23,Butte,007,227075,3200,3059,34,3093,55
2020-10-23,Calaveras,009,45235,336,273,0,273,13
2020-10-23,Colusa,011,21464,550,547,1,548,6
2020-10-23,Contra Costa,013,1133247,19049,18483,93,18576,244
2020-10-23,Del Norte,015,27424,174,171,0,171,2
2020-10-23,El Dorado,017,186661,1405,1310,3,1313,4
2020-10-23,Fresno,019,978130,33525,30590,477,31067,441
2020-10-23,Glenn,021,27897,679,644,1,645,3
2020-10-23,Humboldt,023,135768,564,553,1,554,7
2020-10-23,Imperial,025,180216,12915,12398,17,12415,333
2020-10-23,Inyo,027,18085,244,226,5,231,14
2020-10-23,Kern,029,883053,33933,33077,410,33487,431
2020-10-23,Kings,031,150075,8709,8218,55,8273,82
2020-10-23,Lake,033,64148,715,689,0,689,15
2020-10-23,Lassen,035,31185,774,764,2,766,0
2020-10-23,Los Angeles,037,10098052,300932,294287,2861,297148,6956
2020-10-23,Madera,039,155013,5052,4888,38,4926,53
2020-10-23,Marin,041,260295,7134,7029,19,7048,102
2020-10-23,Mariposa,043,17540,80,77,0,77,2
2020-10-23,Mendocino,045,87422,1073,1019,4,1023,20
2020-10-23,Merced,047,269075,9530,9327,37,9364,149
2020-10-23,Modoc,049,8938,38,28,0,28,0
2020-10-23,Mono,051,14174,194,159,5,164,1
2020-10-23,Monterey,053,433212,11382,11099,56,11155,86
2020-10-23,Napa,055,140530,2036,1942,8,1950,14
2020-10-23,Nevada,057,99092,642,604,18,622,8
2020-10-23,Orange,059,3164182,60645,57595,1751,59346,1430
2020-10-23,Placer,061,380077,4351,4073,15,4088,57
2020-10-23,Plumas,063,18699,75,63,0,63,0
2020-10-23,Riverside,065,2383286,67401,65512,358,65870,1279
2020-10-23,Sacramento,067,1510023,25696,25224,28,25252,496
2020-10-23,San Benito,069,59416,1431,1412,1,1413,15
2020-10-23,San Bernardino,071,2135413,63738,60854,433,61287,1150
2020-10-23,San Diego,073,3302833,56284,53944,1515,55459,867
2020-10-23,San Francisco,075,870044,12281,12015,50,12065,137
2020-10-23,San Joaquin,077,732212,21909,21361,195,21556,495
2020-10-23,San Luis Obispo,079,281455,4351,4102,29,4131,31
2020-10-23,San Mateo,081,765935,11370,10872,10,10882,155
2020-10-23,Santa Barbara,083,443738,9934,9751,95,9846,121
2020-10-23,Santa Clara,085,1922200,25383,23822,51,23873,364
2020-10-23,Santa Cruz,087,273765,2866,2757,34,2791,24
2020-10-23,Shasta,089,179085,2157,1846,19,1865,29
2020-10-23,Sierra,091,2930,6,6,0,6,0
2020-10-23,Siskiyou,093,43540,201,172,10,182,0
2020-10-23,Solano,095,438530,7393,7174,41,7215,59
2020-10-23,Sonoma,097,501317,9569,9112,27,9139,139
2020-10-23,Stanislaus,099,539301,17741,17496,737,18233,395
2020-10-23,Sutter,101,95872,1856,1797,1,1798,12
2020-10-23,Tehama,103,63373,916,862,2,864,5
2020-10-23,Trinity,105,12862,85,26,11,37,0
2020-10-23,Tulare,107,460477,17954,17334,350,17684,295
2020-10-23,Tuolumne,109,53932,277,254,4,258,4
2020-10-23,Ventura,111,848112,14943,14192,323,14515,155
2020-10-23,Yolo,113,214977,3251,3140,9,3149,57
2020-10-23,Yuba,115,75493,1254,1206,6,1212,10
2020-10-22,Alameda,001,1643700,23601,22915,224,23139,393
2020-10-22,Alpine,003,1148,3,3,0,3,0
2020-10-22,Amador,005,37829,341,317,0,317,16
2020-10-22,Butte,007,227075,3190,3046,32,3078,55
2020-10-22,Calaveras,009,45235,333,273,0,273,13
2020-10-22,Colusa,011,21464,550,547,1,548,6
2020-10-22,Contra Costa,013,1133247,18977,18393,93,18486,243
2020-10-22,Del Norte,015,27424,173,168,0,168,2
2020-10-22,El Dorado,017,186661,1395,1308,3,1311,4
2020-10-22,Fresno,019,978130,33415,30471,469,30940,438
2020-10-22,Glenn,021,27897,672,643,1,644,3
2020-10-22,Humboldt,023,135768,562,548,1,549,7
2020-10-22,Imperial,025,180216,12862,12311,17,12328,333
2020-10-22,Inyo,027,18085,241,220,5,225,14
2020-10-22,Kern,029,883053,33852,32991,407,33398,431
2020-10-22,Kings,031,150075,8458,8201,55,8256,82
2020-10-22,Lake,033,64148,711,678,0,678,15
2020-10-22,Lassen,035,31185,771,764,2,766,0
2020-10-22,Los Angeles,037,10098052,299557,291599,2802,294401,6935
2020-10-22,Madera,039,155013,5031,4847,38,4885,52
2020-10-22,Marin,041,260295,7127,7014,19,7033,102
2020-10-22,Mariposa,043,17540,80,77,0,77,2
2020-10-22,Mendocino,045,87422,1068,1016,4,1020,20
2020-10-22,Merced,047,269075,9502,9323,37,9360,149
2020-10-22,Modoc,049,8938,34,26,0,26,0
2020-10-22,Mono,051,14174,189,156,5,161,1
2020-10-22,Monterey,053,433212,11323,11059,53,11112,84
2020-10-22,Napa,055,140530,2021,1928,8,1936,14
2020-10-22,Nevada,057,99092,636,600,18,618,8
2020-10-22,Orange,059,3164182,60430,57418,1734,59152,1422
2020-10-22,Placer,061,380077,4302,4036,15,4051,57
2020-10-22,Plumas,063,18699,72,62,0,62,0
2020-10-22,Riverside,065,2383286,67065,65104,338,65442,1279
2020-10-22,Sacramento,067,1510023,25556,25054,28,25082,492
2020-10-22,San Benito,069,59416,1427,1403,1,1404,15
2020-10-22,San Bernardino,071,2135413,63337,60402,418,60820,1149
2020-10-22,San Diego,073,3302833,55897,53514,1496,55010,866
2020-10-22,San Francisco,075,870044,12223,11991,48,12039,137
2020-10-22,San Joaquin,077,732212,21836,21282,189,21471,495
2020-10-22,San Luis Obispo,079,281455,4335,4081,29,4110,31
2020-10-22,San Mateo,081,765935,11314,10796,10,10806,155
2020-10-22,Santa Barbara,083,443738,9900,9710,93,9803,120
2020-10-22,Santa Clara,085,1922200,25229,23621,51,23672,363
2020-10-22,Santa Cruz,087,273765,2848,2738,33,2771,24
2020-10-22,Shasta,089,179085,2111,1799,19,1818,29
2020-10-22,Sierra,091,2930,6,6,0,6,0
2020-10-22,Siskiyou,093,43540,201,169,10,179,0
2020-10-22,Solano,095,438530,7347,7116,41,7157,59
2020-10-22,Sonoma,097,501317,9503,9052,26,9078,139
2020-10-22,Stanislaus,099,539301,17687,17440,725,18165,395
2020-10-22,Sutter,101,95872,1842,1794,1,1795,12
2020-10-22,Tehama,103,63373,905,852,2,854,5
2020-10-22,Trinity,105,12862,84,26,11,37,0
2020-10-22,Tulare,107,460477,17888,17265,337,17602,293
2020-10-22,Tuolumne,109,53932,275,252,4,256,4
2020-10-22,Ventura,111,848112,14896,14124,321,14445,154
2020-10-22,Yolo,113,214977,3239,3116,9,3125,58
2020-10-22,Yuba,115,75493,1247,1199,5,1204,10
2020-10-21,Alameda,001,1643700,23513,22853,222,23075,392
2020-10-21,Alpine,003,1148,3,3,0,3,0
2020-10-21,Amador,005,37829,336,313,0,313,16
2020-10-21,Butte,007,227075,3178,3041,32,3073,55
2020-10-21,Calaveras,009,45235,332,272,0,272,13
2020-10-21,Colusa,011,21464,550,546,1,547,6
2020-10-21,Contra Costa,013,1133247,18903,18299,93,18392,243
2020-10-21,Del Norte,015,27424,173,169,0,169,2
2020-10-21,El Dorado,017,186661,1383,1305,2,1307,4
2020-10-21,Fresno,019,978130,33319,30328,464,30792,433
2020-10-21,Glenn,021,27897,667,640,1,641,3
2020-10-21,Humboldt,023,135768,561,548,1,549,7
2020-10-21,Imperial,025,180216,12805,12210,17,12227,331
2020-10-21,Inyo,027,18085,237,220,5,225,14
2020-10-21,Kern,029,883053,33777,32956,406,33362,430
2020-10-21,Kings,031,150075,8431,8186,55,8241,80
2020-10-21,Lake,033,64148,710,676,0,676,15
2020-10-21,Lassen,035,31185,770,764,2,766,0
2020-10-21,Los Angeles,037,10098052,298217,288096,2760,290856,6923
2020-10-21,Madera,039,155013,5006,4831,38,4869,52
2020-10-21,Marin,041,260295,7118,7002,19,7021,102
2020-10-21,Mariposa,043,17540,80,77,0,77,2
2020-10-21,Mendocino,045,87422,1066,1011,4,1015,21
2020-10-21,Merced,047,269075,9478,9319,35,9354,149
2020-10-21,Modoc,049,8938,33,26,0,26,0
2020-10-21,Mono,051,14174,187,156,5,161,1
2020-10-21,Monterey,053,433212,11285,11005,52,11057,83
2020-10-21,Napa,055,140530,2006,1918,8,1926,13
2020-10-21,Nevada,057,99092,630,597,18,615,8
2020-10-21,Orange,059,3164182,60217,57189,1725,58914,1409
2020-10-21,Placer,061,380077,4265,4007,15,4022,56
2020-10-21,Plumas,063,18699,69,58,0,58,0
2020-10-21,Riverside,065,2383286,66769,64778,314,65092,1278
2020-10-21,Sacramento,067,1510023,25363,24908,28,24936,490
2020-10-21,San Benito,069,59416,1426,1401,1,1402,14
2020-10-21,San Bernardino,071,2135413,62928,59948,411,60359,1141
2020-10-21,San Diego,073,3302833,55545,53279,1468,54747,863
2020-10-21,San Francisco,075,870044,12174,11976,47,12023,137
2020-10-21,San Joaquin,077,732212,21760,21201,183,21384,495
2020-10-21,San Luis Obispo,079,281455,4320,4055,27,4082,31
2020-10-21,San Mateo,081,765935,11265,10730,10,10740,155
2020-10-21,Santa Barbara,083,443738,9882,9681,92,9773,121
2020-10-21,Santa Clara,085,1922200,25103,23537,51,23588,361
2020-10-21,Santa Cruz,087,273765,2825,2729,33,2762,24
2020-10-21,Shasta,089,179085,2075,1777,19,1796,27
2020-10-21,Sierra,091,2930,6,6,0,6,0
2020-10-21,Siskiyou,093,43540,197,169,10,179,0
2020-10-21,Solano,095,438530,7301,7088,41,7129,59
2020-10-21,Sonoma,097,501317,9423,8987,26,9013,138
2020-10-21,Stanislaus,099,539301,17637,17419,717,18136,392
2020-10-21,Sutter,101,95872,1828,1786,1,1787,12
2020-10-21,Tehama,103,63373,889,824,2,826,5
2020-10-21,Trinity,105,12862,78,25,10,35,0
2020-10-21,Tulare,107,460477,17850,17204,323,17527,292
2020-10-21,Tuolumne,109,53932,274,251,4,255,4
2020-10-21,Ventura,111,848112,14833,14050,318,14368,153
2020-10-21,Yolo,113,214977,3220,3095,9,3104,58
2020-10-21,Yuba,115,75493,1238,1194,5,1199,10
2020-10-20,Alameda,001,1643700,23410,22750,218,22968,391
2020-10-20,Alpine,003,1148,3,3,0,3,0
2020-10-20,Amador,005,37829,335,313,0,313,16
2020-10-20,Butte,007,227075,3166,3027,32,3059,56
2020-10-20,Calaveras,009,45235,331,273,0,273,13
2020-10-20,Colusa,011,21464,547,546,1,547,6
2020-10-20,Contra Costa,013,1133247,18811,18246,93,18339,241
2020-10-20,Del Norte,015,27424,172,169,0,169,2
2020-10-20,El Dorado,017,186661,1377,1295,2,1297,4
2020-10-20,Fresno,019,978130,33216,30220,458,30678,431
2020-10-20,Glenn,021,27897,662,638,1,639,3
2020-10-20,Humboldt,023,135768,557,545,1,546,7
2020-10-20,Imperial,025,180216,12736,12114,17,12131,330
2020-10-20,Inyo,027,18085,237,218,5,223,14
2020-10-20,Kern,029,883053,33702,32889,393,33282,429
2020-10-20,Kings,031,150075,8413,8178,54,8232,80
2020-10-20,Lake,033,64148,708,675,0,675,15
2020-10-20,Lassen,035,31185,769,757,2,759,0
2020-10-20,Los Angeles,037,10098052,296726,287727,2709,290436,6891
2020-10-20,Madera,039,155013,4989,4823,38,4861,52
2020-10-20,Marin,041,260295,7103,6994,19,7013,101
2020-10-20,Mariposa,043,17540,79,77,0,77,2
2020-10-20,Mendocino,045,87422,1064,1004,4,1008,21
2020-10-20,Merced,047,269075,9456,9323,35,9358,149
2020-10-20,Modoc,049,8938,32,26,0,26,0
2020-10-20,Mono,051,14174,187,156,5,161,1
2020-10-20,Monterey,053,433212,11242,10942,49,10991,81
2020-10-20,Napa,055,140530,1987,1912,8,1920,13
2020-10-20,Nevada,057,99092,620,596,18,614,8
2020-10-20,Orange,059,3164182,59953,56914,1715,58629,1397
2020-10-20,Placer,061,380077,4227,3997,15,4012,56
2020-10-20,Plumas,063,18699,66,53,0,53,0
2020-10-20,Riverside,065,2383286,66389,64452,302,64754,1275
2020-10-20,Sacramento,067,1510023,25235,24767,27,24794,485
2020-10-20,San Benito,069,59416,1423,1398,1,1399,14
2020-10-20,San Bernardino,071,2135413,62546,59571,409,59980,1109
2020-10-20,San Diego,073,3302833,55209,53004,1448,54452,857
2020-10-20,San Francisco,075,870044,12127,12013,46,12059,126
2020-10-20,San Joaquin,077,732212,21681,21173,173,21346,490
2020-10-20,San Luis Obispo,079,281455,4302,4043,26,4069,31
2020-10-20,San Mateo,081,765935,11218,10659,10,10669,155
2020-10-20,Santa Barbara,083,443738,9853,9664,90,9754,121
2020-10-20,Santa Clara,085,1922200,24966,23406,51,23457,358
2020-10-20,Santa Cruz,087,273765,2802,2710,33,2743,23
2020-10-20,Shasta,089,179085,2052,1747,19,1766,20
2020-10-20,Sierra,091,2930,6,6,0,6,0
2020-10-20,Siskiyou,093,43540,189,168,10,178,0
2020-10-20,Solano,095,438530,7252,7044,41,7085,57
2020-10-20,Sonoma,097,501317,9360,8904,24,8928,135
2020-10-20,Stanislaus,099,539301,17583,17367,713,18080,393
2020-10-20,Sutter,101,95872,1819,1783,1,1784,12
2020-10-20,Tehama,103,63373,874,813,2,815,5
2020-10-20,Trinity,105,12862,77,25,10,35,0
2020-10-20,Tulare,107,460477,17783,17156,318,17474,289
2020-10-20,Tuolumne,109,53932,272,250,4,254,4
2020-10-20,Ventura,111,848112,14769,13980,316,14296,152
2020-10-20,Yolo,113,214977,3197,3083,9,3092,56
2020-10-20,Yuba,115,75493,1228,1191,5,1196,10
2020-10-19,Alameda,001,1643700,23299,22647,217,22864,392
2020-10-19,Alpine,003,1148,3,3,0,3,0
2020-10-19,Amador,005,37829,329,313,0,313,16
2020-10-19,Butte,007,227075,3155,3026,32,3058,55
2020-10-19,Calaveras,009,45235,330,268,0,268,13
2020-10-19,Colusa,011,21464,547,544,1,545,6
2020-10-19,Contra Costa,013,1133247,18713,18173,93,18266,239
2020-10-19,Del Norte,015,27424,169,167,0,167,2
2020-10-19,El Dorado,017,186661,1356,1287,2,1289,4
2020-10-19,Fresno,019,978130,33107,30152,452,30604,431
2020-10-19,Glenn,021,27897,657,635,0,635,3
2020-10-19,Humboldt,023,135768,557,543,1,544,7
2020-10-19,Imperial,025,180216,12682,12036,16,12052,330
2020-10-19,Inyo,027,18085,236,218,5,223,14
2020-10-19,Kern,029,883053,33626,32840,390,33230,428
2020-10-19,Kings,031,150075,8395,8173,54,8227,80
2020-10-19,Lake,033,64148,705,673,0,673,15
2020-10-19,Lassen,035,31185,768,757,2,759,0
2020-10-19,Los Angeles,037,10098052,295239,287119,2671,289790,6858
2020-10-19,Madera,039,155013,4974,4787,38,4825,52
2020-10-19,Marin,041,260295,7085,6981,19,7000,100
2020-10-19,Mariposa,043,17540,79,77,0,77,2
2020-10-19,Mendocino,045,87422,1059,1001,4,1005,21
2020-10-19,Merced,047,269075,9431,9305,31,9336,148
2020-10-19,Modoc,049,8938,31,26,0,26,0
2020-10-19,Mono,051,14174,182,156,5,161,1
2020-10-19,Monterey,053,433212,11181,10907,49,10956,80
2020-10-19,Napa,055,140530,1975,1892,8,1900,12
2020-10-19,Nevada,057,99092,617,590,18,608,8
2020-10-19,Orange,059,3164182,59669,56652,1700,58352,1396
2020-10-19,Placer,061,380077,4178,3962,15,3977,49
2020-10-19,Plumas,063,18699,64,52,0,52,0
2020-10-19,Riverside,065,2383286,65958,64016,286,64302,1272
2020-10-19,Sacramento,067,1510023,25096,24542,27,24569,483
2020-10-19,San Benito,069,59416,1416,1395,1,1396,14
2020-10-19,San Bernardino,071,2135413,62095,59265,397,59662,1100
2020-10-19,San Diego,073,3302833,54823,52739,1423,54162,853
2020-10-19,San Francisco,075,870044,12083,11879,46,11925,126
2020-10-19,San Joaquin,077,732212,21606,20930,165,21095,489
2020-10-19,San Luis Obispo,079,281455,4286,4016,26,4042,31
2020-10-19,San Mateo,081,765935,11172,10568,10,10578,154
2020-10-19,Santa Barbara,083,443738,9818,9632,90,9722,121
2020-10-19,Santa Clara,085,1922200,24816,23301,51,23352,352
2020-10-19,Santa Cruz,087,273765,2785,2705,33,2738,19
2020-10-19,Shasta,089,179085,2008,1709,18,1727,20
2020-10-19,Sierra,091,2930,6,6,0,6,0
2020-10-19,Siskiyou,093,43540,182,167,10,177,0
2020-10-19,Solano,095,438530,7211,7003,41,7044,57
2020-10-19,Sonoma,097,501317,9273,8830,24,8854,135
2020-10-19,Stanislaus,099,539301,17532,17342,703,18045,390
2020-10-19,Sutter,101,95872,1814,1773,1,1774,12
2020-10-19,Tehama,103,63373,871,793,2,795,5
2020-10-19,Trinity,105,12862,75,23,10,33,0
2020-10-19,Tulare,107,460477,17733,17047,311,17358,291
2020-10-19,Tuolumne,109,53932,270,247,4,251,4
2020-10-19,Ventura,111,848112,14703,13930,313,14243,152
2020-10-19,Yolo,113,214977,3184,3069,9,3078,56
2020-10-19,Yuba,115,75493,1221,1183,5,1188,10
2020-10-18,Alameda,001,1643700,23195,22546,216,22762,392
2020-10-18,Alpine,003,1148,3,3,0,3,0
2020-10-18,Amador,005,37829,317,313,0,313,16
2020-10-18,Butte,007,227075,3142,3019,32,3051,55
2020-10-18,Calaveras,009,45235,329,267,0,267,13
2020-10-18,Colusa,011,21464,545,544,1,545,6
2020-10-18,Contra Costa,013,1133247,18614,18120,93,18213,237
2020-10-18,Del Norte,015,27424,169,167,0,167,2
2020-10-18,El Dorado,017,186661,1347,1283,2,1285,4
2020-10-18,Fresno,019,978130,32978,30051,444,30495,430
2020-10-18,Glenn,021,27897,655,634,0,634,3
2020-10-18,Humboldt,023,135768,554,540,1,541,7
2020-10-18,Imperial,025,180216,12620,11987,15,12002,330
2020-10-18,Inyo,027,18085,233,215,5,220,14
2020-10-18,Kern,029,883053,33553,32799,383,33182,428
2020-10-18,Kings,031,150075,8380,8159,54,8213,80
2020-10-18,Lake,033,64148,698,670,0,670,15
2020-10-18,Lassen,035,31185,768,757,2,759,0
2020-10-18,Los Angeles,037,10098052,293531,286187,2628,288815,6857
2020-10-18,Madera,039,155013,4949,4770,37,4807,52
2020-10-18,Marin,041,260295,7064,6969,19,6988,99
2020-10-18,Mariposa,043,17540,79,77,0,77,2
2020-10-18,Mendocino,045,87422,1057,988,4,992,21
2020-10-18,Merced,047,269075,9396,9292,31,9323,148
2020-10-18,Modoc,049,8938,30,26,0,26,0
2020-10-18,Mono,051,14174,177,155,5,160,1
2020-10-18,Monterey,053,433212,11128,10872,49,10921,80
2020-10-18,Napa,055,140530,1962,1882,8,1890,12
2020-10-18,Nevada,057,99092,611,582,18,600,8
2020-10-18,Orange,059,3164182,59372,56394,1684,58078,1396
2020-10-18,Placer,061,380077,4130,3938,15,3953,49
2020-10-18,Plumas,063,18699,62,52,0,52,0
2020-10-18,Riverside,065,2383286,65645,63765,265,64030,1270
2020-10-18,Sacramento,067,1510023,24940,24425,27,24452,482
2020-10-18,San Benito,069,59416,1409,1395,1,1396,14
2020-10-18,San Bernardino,071,2135413,61595,58893,389,59282,1098
2020-10-18,San Diego,073,3302833,54434,52359,1402,53761,853
2020-10-18,San Francisco,075,870044,12044,11878,46,11924,126
2020-10-18,San Joaquin,077,732212,21523,20931,152,21083,489
2020-10-18,San Luis Obispo,079,281455,4255,4009,24,4033,31
2020-10-18,San Mateo,081,765935,11113,10503,10,10513,154
2020-10-18,Santa Barbara,083,443738,9779,9608,89,9697,121
2020-10-18,Santa Clara,085,1922200,24643,23169,51,23220,352
2020-10-18,Santa Cruz,087,273765,2771,2692,33,2725,19
2020-10-18,Shasta,089,179085,1983,1708,18,1726,20
2020-10-18,Sierra,091,2930,6,6,0,6,0
2020-10-18,Siskiyou,093,43540,182,167,10,177,0
2020-10-18,Solano,095,438530,7164,6962,41,7003,57
2020-10-18,Sonoma,097,501317,9196,8781,23,8804,134
2020-10-18,Stanislaus,099,539301,17476,17290,694,17984,390
2020-10-18,Sutter,101,95872,1805,1764,1,1765,12
2020-10-18,Tehama,103,63373,839,774,2,776,5
2020-10-18,Trinity,105,12862,75,20,10,30,0
2020-10-18,Tulare,107,460477,17639,17048,302,17350,290
2020-10-18,Tuolumne,109,53932,265,245,4,249,4
2020-10-18,Ventura,111,848112,14623,13901,312,14213,151
2020-10-18,Yolo,113,214977,3145,3059,9,3068,55
2020-10-18,Yuba,115,75493,1210,1176,5,1181,10
2020-10-17,Alameda,001,1643700,23149,22394,214,22608,398
2020-10-17,Alpine,003,1148,3,3,0,3,0
2020-10-17,Amador,005,37829,315,309,0,309,16
2020-10-17,Butte,007,227075,3134,3012,30,3042,55
2020-10-17,Calaveras,009,45235,329,267,0,267,13
2020-10-17,Colusa,011,21464,544,544,1,545,6
2020-10-17,Contra Costa,013,1133247,18561,18005,93,18098,237
2020-10-17,Del Norte,015,27424,169,167,0,167,2
2020-10-17,El Dorado,017,186661,1343,1277,2,1279,4
2020-10-17,Fresno,019,978130,32924,29911,442,30353,430
2020-10-17,Glenn,021,27897,652,633,0,633,3
2020-10-17,Humboldt,023,135768,551,535,1,536,7
2020-10-17,Imperial,025,180216,12592,11962,15,11977,330
2020-10-17,Inyo,027,18085,228,212,5,217,14
2020-10-17,Kern,029,883053,33502,32710,380,33090,428
2020-10-17,Kings,031,150075,8374,8151,53,8204,80
2020-10-17,Lake,033,64148,695,663,0,663,15
2020-10-17,Lassen,035,31185,768,757,2,759,0
2020-10-17,Los Angeles,037,10098052,292778,285858,2601,288459,6844
2020-10-17,Madera,039,155013,4943,4759,37,4796,53
2020-10-17,Marin,041,260295,7061,6958,19,6977,99
2020-10-17,Mariposa,043,17540,78,77,0,77,2
2020-10-17,Mendocino,045,87422,1050,977,4,981,21
2020-10-17,Merced,047,269075,9382,9275,31,9306,148
2020-10-17,Modoc,049,8938,30,26,0,26,0
2020-10-17,Mono,051,14174,176,155,5,160,1
2020-10-17,Monterey,053,433212,11088,10807,48,10855,80
2020-10-17,Napa,055,140530,1953,1866,8,1874,12
2020-10-17,Nevada,057,99092,610,580,18,598,8
2020-10-17,Orange,059,3164182,59230,56197,1677,57874,1396
2020-10-17,Placer,061,380077,4103,3898,15,3913,49
2020-10-17,Plumas,063,18699,62,52,0,52,0
2020-10-17,Riverside,065,2383286,65447,63171,255,63426,1270
2020-10-17,Sacramento,067,1510023,24856,24304,27,24331,482
2020-10-17,San Benito,069,59416,1405,1389,1,1390,14
2020-10-17,San Bernardino,071,2135413,61324,58415,382,58797,1097
2020-10-17,San Diego,073,3302833,54209,51986,1391,53377,853
2020-10-17,San Francisco,075,870044,12016,11877,45,11922,126
2020-10-17,San Joaquin,077,732212,21469,20932,146,21078,489
2020-10-17,San Luis Obispo,079,281455,4240,3979,24,4003,31
2020-10-17,San Mateo,081,765935,11085,10423,10,10433,153
2020-10-17,Santa Barbara,083,443738,9760,9588,87,9675,121
2020-10-17,Santa Clara,085,1922200,24554,22997,51,23048,349
2020-10-17,Santa Cruz,087,273765,2757,2680,33,2713,19
2020-10-17,Shasta,089,179085,1957,1679,18,1697,20
2020-10-17,Sierra,091,2930,6,6,0,6,0
2020-10-17,Siskiyou,093,43540,181,167,10,177,0
2020-10-17,Solano,095,438530,7138,6929,41,6970,57
2020-10-17,Sonoma,097,501317,9153,8725,23,8748,134
2020-10-17,Stanislaus,099,539301,17436,17232,685,17917,390
2020-10-17,Sutter,101,95872,1803,1762,1,1763,12
2020-10-17,Tehama,103,63373,823,764,2,766,5
2020-10-17,Trinity,105,12862,75,20,10,30,0
2020-10-17,Tulare,107,460477,17609,16995,293,17288,290
2020-10-17,Tuolumne,109,53932,265,241,4,245,4
2020-10-17,Ventura,111,848112,14578,13845,309,14154,151
2020-10-17,Yolo,113,214977,3130,3045,8,3053,55
2020-10-17,Yuba,115,75493,1205,1164,5,1169,10
2020-10-16,Alameda,001,1643700,23095,22315,214,22529,397
2020-10-16,Alpine,003,1148,3,3,0,3,0
2020-10-16,Amador,005,37829,315,309,0,309,16
2020-10-16,Butte,007,227075,3123,3004,30,3034,54
2020-10-16,Calaveras,009,45235,329,267,0,267,13
2020-10-16,Colusa,011,21464,543,544,1,545,6
2020-10-16,Contra Costa,013,1133247,18508,17956,93,18049,237
2020-10-16,Del Norte,015,27424,169,166,0,166,2
2020-10-16,El Dorado,017,186661,1337,1273,2,1275,4
2020-10-16,Fresno,019,978130,32848,29796,441,30237,427
2020-10-16,Glenn,021,27897,647,632,0,632,3
2020-10-16,Humboldt,023,135768,551,533,1,534,7
2020-10-16,Imperial,025,180216,12552,11885,15,11900,330
2020-10-16,Inyo,027,18085,224,212,5,217,14
2020-10-16,Kern,029,883053,33459,32660,378,33038,428
2020-10-16,Kings,031,150075,8365,8146,52,8198,80
2020-10-16,Lake,033,64148,693,644,0,644,14
2020-10-16,Lassen,035,31185,768,757,2,759,0
2020-10-16,Los Angeles,037,10098052,291716,284988,2580,287568,6835
2020-10-16,Madera,039,155013,4931,4736,36,4772,53
2020-10-16,Marin,041,260295,7051,6933,19,6952,99
2020-10-16,Mariposa,043,17540,78,76,0,76,2
2020-10-16,Mendocino,045,87422,1043,974,4,978,21
2020-10-16,Merced,047,269075,9365,9246,31,9277,148
2020-10-16,Modoc,049,8938,30,26,0,26,0
2020-10-16,Mono,051,14174,174,155,5,160,1
2020-10-16,Monterey,053,433212,11053,10727,48,10775,79
2020-10-16,Napa,055,140530,1944,1855,8,1863,12
2020-10-16,Nevada,057,99092,608,579,18,597,8
2020-10-16,Orange,059,3164182,59052,56091,1671,57762,1388
2020-10-16,Placer,061,380077,4083,3864,15,3879,49
2020-10-16,Plumas,063,18699,61,52,0,52,0
2020-10-16,Riverside,065,2383286,65221,62986,254,63240,1267
2020-10-16,Sacramento,067,1510023,24762,24144,27,24171,479
2020-10-16,San Benito,069,59416,1402,1388,1,1389,14
2020-10-16,San Bernardino,071,2135413,61055,58233,382,58615,1069
2020-10-16,San Diego,073,3302833,53967,51785,1377,53162,850
2020-10-16,San Francisco,075,870044,11994,11840,44,11884,126
2020-10-16,San Joaquin,077,732212,21424,20910,145,21055,489
2020-10-16,San Luis Obispo,079,281455,4224,3952,24,3976,32
2020-10-16,San Mateo,081,765935,11059,10405,10,10415,153
2020-10-16,Santa Barbara,083,443738,9741,9549,87,9636,119
2020-10-16,Santa Clara,085,1922200,24467,22920,51,22971,345
2020-10-16,Santa Cruz,087,273765,2744,2666,33,2699,20
2020-10-16,Shasta,089,179085,1935,1660,18,1678,20
2020-10-16,Sierra,091,2930,6,6,0,6,0
2020-10-16,Siskiyou,093,43540,179,167,10,177,0
2020-10-16,Solano,095,438530,7115,6879,41,6920,55
2020-10-16,Sonoma,097,501317,9097,8652,23,8675,133
2020-10-16,Stanislaus,099,539301,17402,17201,677,17878,366
2020-10-16,Sutter,101,95872,1795,1756,1,1757,12
2020-10-16,Tehama,103,63373,822,737,2,739,3
2020-10-16,Trinity,105,12862,75,20,10,30,0
2020-10-16,Tulare,107,460477,17577,16965,285,17250,290
2020-10-16,Tuolumne,109,53932,263,237,4,241,4
2020-10-16,Ventura,111,848112,14535,13805,304,14109,152
2020-10-16,Yolo,113,214977,3121,3030,8,3038,55
2020-10-16,Yuba,115,75493,1205,1155,5,1160,10
2020-10-15,Alameda,001,1643700,23027,22267,213,22480,390
2020-10-15,Alpine,003,1148,3,3,0,3,0
2020-10-15,Amador,005,37829,315,309,0,309,16
2020-10-15,Butte,007,227075,3111,3000,29,3029,54
2020-10-15,Calaveras,009,45235,328,267,0,267,13
2020-10-15,Colusa,011,21464,542,543,1,544,6
2020-10-15,Contra Costa,013,1133247,18441,17893,92,17985,237
2020-10-15,Del Norte,015,27424,169,164,0,164,2
2020-10-15,El Dorado,017,186661,1332,1265,2,1267,4
2020-10-15,Fresno,019,978130,32751,29727,438,30165,425
2020-10-15,Glenn,021,27897,642,632,0,632,3
2020-10-15,Humboldt,023,135768,547,531,1,532,7
2020-10-15,Imperial,025,180216,12511,11820,14,11834,330
2020-10-15,Inyo,027,18085,224,210,5,215,14
2020-10-15,Kern,029,883053,33378,32593,375,32968,427
2020-10-15,Kings,031,150075,8350,8134,52,8186,80
2020-10-15,Lake,033,64148,691,642,0,642,14
2020-10-15,Lassen,035,31185,767,752,2,754,0
2020-10-15,Los Angeles,037,10098052,290431,284019,2546,286565,6807
2020-10-15,Madera,039,155013,4919,4723,35,4758,50
2020-10-15,Marin,041,260295,7043,6912,19,6931,99
2020-10-15,Mariposa,043,17540,78,76,0,76,2
2020-10-15,Mendocino,045,87422,1037,963,4,967,21
2020-10-15,Merced,047,269075,9338,9213,31,9244,147
2020-10-15,Modoc,049,8938,30,26,0,26,0
2020-10-15,Mono,051,14174,174,155,5,160,1
2020-10-15,Monterey,053,433212,10986,10677,47,10724,79
2020-10-15,Napa,055,140530,1931,1842,8,1850,12
2020-10-15,Nevada,057,99092,604,575,18,593,8
2020-10-15,Orange,059,3164182,58836,55952,1659,57611,1379
2020-10-15,Placer,061,380077,4054,3848,15,3863,48
2020-10-15,Plumas,063,18699,58,52,0,52,0
2020-10-15,Riverside,065,2383286,64889,62819,251,63070,1266
2020-10-15,Sacramento,067,1510023,24646,24068,27,24095,474
2020-10-15,San Benito,069,59416,1399,1384,1,1385,14
2020-10-15,San Bernardino,071,2135413,60716,58068,379,58447,1067
2020-10-15,San Diego,073,3302833,53683,51472,1361,52833,847
2020-10-15,San Francisco,075,870044,11966,11808,41,11849,126
2020-10-15,San Joaquin,077,732212,21351,20880,139,21019,487
2020-10-15,San Luis Obispo,079,281455,4207,3934,24,3958,32
2020-10-15,San Mateo,081,765935,11019,10340,10,10350,152
2020-10-15,Santa Barbara,083,443738,9717,9526,86,9612,117
2020-10-15,Santa Clara,085,1922200,24351,22808,51,22859,343
2020-10-15,Santa Cruz,087,273765,2730,2656,33,2689,13
2020-10-15,Shasta,089,179085,1924,1635,18,1653,20
2020-10-15,Sierra,091,2930,6,6,0,6,0
2020-10-15,Siskiyou,093,43540,175,166,10,176,0
2020-10-15,Solano,095,438530,7076,6830,41,6871,55
2020-10-15,Sonoma,097,501317,9005,8571,23,8594,133
2020-10-15,Stanislaus,099,539301,17364,17151,663,17814,366
2020-10-15,Sutter,101,95872,1792,1752,1,1753,12
2020-10-15,Tehama,103,63373,795,726,2,728,3
2020-10-15,Trinity,105,12862,75,20,10,30,0
2020-10-15,Tulare,107,460477,17517,16918,270,17188,289
2020-10-15,Tuolumne,109,53932,261,236,4,240,4
2020-10-15,Ventura,111,848112,14479,13750,299,14049,152
2020-10-15,Yolo,113,214977,3101,3014,8,3022,55
2020-10-15,Yuba,115,75493,1198,1151,5,1156,10
2020-10-14,Alameda,001,1643700,22928,22227,212,22439,398
2020-10-14,Alpine,003,1148,3,3,0,3,0
2020-10-14,Amador,005,37829,313,308,0,308,16
2020-10-14,Butte,007,227075,3103,2995,29,3024,54
2020-10-14,Calaveras,009,45235,328,266,0,266,12
2020-10-14,Colusa,011,21464,542,543,1,544,6
2020-10-14,Contra Costa,013,1133247,18384,17820,90,17910,236
2020-10-14,Del Norte,015,27424,168,163,0,163,2
2020-10-14,El Dorado,017,186661,1326,1264,2,1266,4
2020-10-14,Fresno,019,978130,32636,29650,432,30082,424
2020-10-14,Glenn,021,27897,641,629,0,629,3
2020-10-14,Humboldt,023,135768,544,531,1,532,7
2020-10-14,Imperial,025,180216,12474,11765,12,11777,330
2020-10-14,Inyo,027,18085,223,209,4,213,14
2020-10-14,Kern,029,883053,33303,32528,373,32901,425
2020-10-14,Kings,031,150075,8332,8118,52,8170,80
2020-10-14,Lake,033,64148,690,642,0,642,14
2020-10-14,Lassen,035,31185,765,752,2,754,0
2020-10-14,Los Angeles,037,10098052,289118,282918,2502,285420,6786
2020-10-14,Madera,039,155013,4904,4713,34,4747,50
2020-10-14,Marin,041,260295,7037,6907,19,6926,99
2020-10-14,Mariposa,043,17540,77,76,0,76,2
2020-10-14,Mendocino,045,87422,1031,955,4,959,21
2020-10-14,Merced,047,269075,9313,9201,29,9230,147
2020-10-14,Modoc,049,8938,30,27,0,27,0
2020-10-14,Mono,051,14174,174,155,5,160,1
2020-10-14,Monterey,053,433212,10935,10616,47,10663,78
2020-10-14,Napa,055,140530,1914,1837,8,1845,12
2020-10-14,Nevada,057,99092,602,573,18,591,7
2020-10-14,Orange,059,3164182,58622,55756,1650,57406,1348
2020-10-14,Placer,061,380077,4031,3829,15,3844,48
2020-10-14,Plumas,063,18699,54,52,0,52,0
2020-10-14,Riverside,065,2383286,64606,62607,250,62857,1261
2020-10-14,Sacramento,067,1510023,24502,24013,27,24040,472
2020-10-14,San Benito,069,59416,1397,1381,0,1381,14
2020-10-14,San Bernardino,071,2135413,60389,57774,375,58149,1063
2020-10-14,San Diego,073,3302833,53364,51329,1337,52666,844
2020-10-14,San Francisco,075,870044,11934,11783,40,11823,123
2020-10-14,San Joaquin,077,732212,21272,20845,125,20970,487
2020-10-14,San Luis Obispo,079,281455,4184,3901,23,3924,32
2020-10-14,San Mateo,081,765935,10968,10309,10,10319,132
2020-10-14,Santa Barbara,083,443738,9683,9509,86,9595,117
2020-10-14,Santa Clara,085,1922200,24202,22735,51,22786,343
2020-10-14,Santa Cruz,087,273765,2720,2618,33,2651,13
2020-10-14,Shasta,089,179085,1886,1553,18,1571,20
2020-10-14,Sierra,091,2930,6,6,0,6,0
2020-10-14,Siskiyou,093,43540,175,166,10,176,0
2020-10-14,Solano,095,438530,7020,6786,41,6827,55
2020-10-14,Sonoma,097,501317,8952,8514,23,8537,133
2020-10-14,Stanislaus,099,539301,17319,17105,660,17765,365
2020-10-14,Sutter,101,95872,1783,1747,1,1748,12
2020-10-14,Tehama,103,63373,784,721,2,723,3
2020-10-14,Trinity,105,12862,74,20,10,30,0
2020-10-14,Tulare,107,460477,17455,16863,257,17120,287
2020-10-14,Tuolumne,109,53932,260,236,4,240,4
2020-10-14,Ventura,111,848112,14426,13697,295,13992,152
2020-10-14,Yolo,113,214977,3083,3007,7,3014,55
2020-10-14,Yuba,115,75493,1190,1147,5,1152,10
2020-10-13,Alameda,001,1643700,22824,22185,210,22395,389
2020-10-13,Alpine,003,1148,3,3,0,3,0
2020-10-13,Amador,005,37829,311,306,0,306,16
2020-10-13,Butte,007,227075,3094,2992,29,3021,54
2020-10-13,Calaveras,009,45235,324,262,0,262,12
2020-10-13,Colusa,011,21464,542,541,1,542,6
2020-10-13,Contra Costa,013,1133247,18326,17783,90,17873,234
2020-10-13,Del Norte,015,27424,168,163,0,163,2
2020-10-13,El Dorado,017,186661,1317,1262,2,1264,4
2020-10-13,Fresno,019,978130,32514,29579,428,30007,424
2020-10-13,Glenn,021,27897,640,629,0,629,3
2020-10-13,Humboldt,023,135768,542,523,1,524,7
2020-10-13,Imperial,025,180216,12439,11727,11,11738,327
2020-10-13,Inyo,027,18085,220,207,4,211,14
2020-10-13,Kern,029,883053,33228,32497,371,32868,419
2020-10-13,Kings,031,150075,8323,8111,52,8163,80
2020-10-13,Lake,033,64148,687,639,0,639,12
2020-10-13,Lassen,035,31185,763,752,2,754,0
2020-10-13,Los Angeles,037,10098052,287840,281716,2459,284175,6767
2020-10-13,Madera,039,155013,4886,4700,34,4734,50
2020-10-13,Marin,041,260295,7015,6900,18,6918,97
2020-10-13,Mariposa,043,17540,77,76,0,76,2
2020-10-13,Mendocino,045,87422,1022,950,4,954,21
2020-10-13,Merced,047,269075,9296,9181,29,9210,146
2020-10-13,Modoc,049,8938,29,28,0,28,0
2020-10-13,Mono,051,14174,174,155,4,159,1
2020-10-13,Monterey,053,433212,10874,10574,46,10620,78
2020-10-13,Napa,055,140530,1905,1825,8,1833,12
2020-10-13,Nevada,057,99092,595,572,18,590,7
2020-10-13,Orange,059,3164182,58409,55515,1637,57152,1326
2020-10-13,Placer,061,380077,3993,3825,15,3840,48
2020-10-13,Plumas,063,18699,52,51,0,51,0
2020-10-13,Riverside,065,2383286,64286,62279,248,62527,1254
2020-10-13,Sacramento,067,1510023,24425,23930,27,23957,466
2020-10-13,San Benito,069,59416,1389,1380,0,1380,14
2020-10-13,San Bernardino,071,2135413,60050,57411,373,57784,1061
2020-10-13,San Diego,073,3302833,53071,51026,1320,52346,840
2020-10-13,San Francisco,075,870044,11899,11659,40,11699,122
2020-10-13,San Joaquin,077,732212,21211,20822,121,20943,481
2020-10-13,San Luis Obispo,079,281455,4168,3892,22,3914,32
2020-10-13,San Mateo,081,765935,10925,10286,10,10296,130
2020-10-13,Santa Barbara,083,443738,9652,9489,86,9575,117
2020-10-13,Santa Clara,085,1922200,24075,22678,51,22729,343
2020-10-13,Santa Cruz,087,273765,2702,2603,33,2636,13
2020-10-13,Shasta,089,179085,1862,1606,18,1624,20
2020-10-13,Sierra,091,2930,6,6,0,6,0
2020-10-13,Siskiyou,093,43540,174,163,10,173,0
2020-10-13,Solano,095,438530,6985,6761,41,6802,55
2020-10-13,Sonoma,097,501317,8869,8456,23,8479,133
2020-10-13,Stanislaus,099,539301,17274,17082,655,17737,362
2020-10-13,Sutter,101,95872,1774,1748,1,1749,12
2020-10-13,Tehama,103,63373,776,717,2,719,3
2020-10-13,Trinity,105,12862,70,19,9,28,0
2020-10-13,Tulare,107,460477,17396,16822,249,17071,286
2020-10-13,Tuolumne,109,53932,258,235,4,239,4
2020-10-13,Ventura,111,848112,14371,13645,291,13936,151
2020-10-13,Yolo,113,214977,3075,2983,6,2989,55
2020-10-13,Yuba,115,75493,1185,1143,5,1148,10
2020-10-12,Alameda,001,1643700,22744,22126,209,22335,389
2020-10-12,Alpine,003,1148,3,3,0,3,0
2020-10-12,Amador,005,37829,310,305,0,305,16
2020-10-12,Butte,007,227075,3088,2975,29,3004,54
2020-10-12,Calaveras,009,45235,324,262,0,262,12
2020-10-12,Colusa,011,21464,542,541,1,542,6
2020-10-12,Contra Costa,013,1133247,18251,17728,90,17818,233
2020-10-12,Del Norte,015,27424,168,161,0,161,2
2020-10-12,El Dorado,017,186661,1314,1254,2,1256,4
2020-10-12,Fresno,019,978130,32381,29523,424,29947,421
2020-10-12,Glenn,021,27897,639,626,0,626,3
2020-10-12,Humboldt,023,135768,539,522,1,523,7
2020-10-12,Imperial,025,180216,12400,11689,11,11700,328
2020-10-12,Inyo,027,18085,217,201,4,205,14
2020-10-12,Kern,029,883053,33135,32425,368,32793,419
2020-10-12,Kings,031,150075,8317,8106,51,8157,80
2020-10-12,Lake,033,64148,681,633,0,633,12
2020-10-12,Lassen,035,31185,763,752,2,754,0
2020-10-12,Los Angeles,037,10098052,286622,280961,2432,283393,6747
2020-10-12,Madera,039,155013,4867,4689,34,4723,50
2020-10-12,Marin,041,260295,6998,6886,18,6904,97
2020-10-12,Mariposa,043,17540,77,76,0,76,2
2020-10-12,Mendocino,045,87422,1016,947,4,951,21
2020-10-12,Merced,047,269075,9275,9141,29,9170,146
2020-10-12,Modoc,049,8938,29,27,0,27,0
2020-10-12,Mono,051,14174,174,154,4,158,1
2020-10-12,Monterey,053,433212,10808,10473,46,10519,77
2020-10-12,Napa,055,140530,1897,1819,8,1827,11
2020-10-12,Nevada,057,99092,591,570,18,588,7
2020-10-12,Orange,059,3164182,58179,55373,1627,57000,1326
2020-10-12,Placer,061,380077,3961,3808,14,3822,48
2020-10-12,Plumas,063,18699,52,51,0,51,0
2020-10-12,Riverside,065,2383286,63975,62279,244,62523,1254
2020-10-12,Sacramento,067,1510023,24319,23807,27,23834,466
2020-10-12,San Benito,069,59416,1386,1376,0,1376,13
2020-10-12,San Bernardino,071,2135413,59675,57235,372,57607,1061
2020-10-12,San Diego,073,3302833,52781,50748,1293,52041,826
2020-10-12,San Francisco,075,870044,11867,11659,40,11699,122
2020-10-12,San Joaquin,077,732212,21148,20701,115,20816,480
2020-10-12,San Luis Obispo,079,281455,4140,3874,22,3896,32
2020-10-12,San Mateo,081,765935,10877,10262,10,10272,130
2020-10-12,Santa Barbara,083,443738,9614,9462,86,9548,117
2020-10-12,Santa Clara,085,1922200,23959,22578,51,22629,343
2020-10-12,Santa Cruz,087,273765,2685,2590,33,2623,13
2020-10-12,Shasta,089,179085,1837,1515,18,1533,20
2020-10-12,Sierra,091,2930,6,6,0,6,0
2020-10-12,Siskiyou,093,43540,173,162,10,172,0
2020-10-12,Solano,095,438530,6946,6742,41,6783,55
2020-10-12,Sonoma,097,501317,8798,8377,23,8400,133
2020-10-12,Stanislaus,099,539301,17225,17051,646,17697,361
2020-10-12,Sutter,101,95872,1766,1741,1,1742,12
2020-10-12,Tehama,103,63373,760,708,2,710,3
2020-10-12,Trinity,105,12862,69,19,9,28,0
2020-10-12,Tulare,107,460477,17344,16742,242,16984,286
2020-10-12,Tuolumne,109,53932,253,234,4,238,4
2020-10-12,Ventura,111,848112,14309,13617,287,13904,151
2020-10-12,Yolo,113,214977,3060,2964,6,2970,55
2020-10-12,Yuba,115,75493,1174,1141,5,1146,10
2020-10-11,Alameda,001,1643700,22654,22057,205,22262,392
2020-10-11,Alpine,003,1148,3,3,0,3,0
2020-10-11,Amador,005,37829,308,305,0,305,16
2020-10-11,Butte,007,227075,3080,2967,28,2995,54
2020-10-11,Calaveras,009,45235,322,262,0,262,12
2020-10-11,Colusa,011,21464,540,541,1,542,6
2020-10-11,Contra Costa,013,1133247,18167,17678,90,17768,233
2020-10-11,Del Norte,015,27424,166,161,0,161,2
2020-10-11,El Dorado,017,186661,1305,1242,2,1244,4
2020-10-11,Fresno,019,978130,32243,29419,416,29835,421
2020-10-11,Glenn,021,27897,637,625,0,625,3
2020-10-11,Humboldt,023,135768,538,521,1,522,7
2020-10-11,Imperial,025,180216,12340,11614,11,11625,328
2020-10-11,Inyo,027,18085,213,201,4,205,14
2020-10-11,Kern,029,883053,33048,32399,361,32760,418
2020-10-11,Kings,031,150075,8300,8094,50,8144,80
2020-10-11,Lake,033,64148,668,631,0,631,12
2020-10-11,Lassen,035,31185,762,752,2,754,0
2020-10-11,Los Angeles,037,10098052,285182,280190,2391,282581,6745
2020-10-11,Madera,039,155013,4839,4680,33,4713,50
2020-10-11,Marin,041,260295,6989,6870,18,6888,97
2020-10-11,Mariposa,043,17540,77,76,0,76,2
2020-10-11,Mendocino,045,87422,1009,944,4,948,21
2020-10-11,Merced,047,269075,9257,9124,29,9153,146
2020-10-11,Modoc,049,8938,29,27,0,27,0
2020-10-11,Mono,051,14174,174,154,4,158,1
2020-10-11,Monterey,053,433212,10757,10445,44,10489,77
2020-10-11,Napa,055,140530,1881,1811,8,1819,11
2020-10-11,Nevada,057,99092,589,569,18,587,7
2020-10-11,Orange,059,3164182,57949,55202,1621,56823,1326
2020-10-11,Placer,061,380077,3940,3787,14,3801,48
2020-10-11,Plumas,063,18699,52,51,0,51,0
2020-10-11,Riverside,065,2383286,63686,62112,240,62352,1254
2020-10-11,Sacramento,067,1510023,24177,23778,27,23805,466
2020-10-11,San Benito,069,59416,1385,1374,0,1374,13
2020-10-11,San Bernardino,071,2135413,59221,56997,370,57367,1061
2020-10-11,San Diego,073,3302833,52431,50553,1271,51824,826
2020-10-11,San Francisco,075,870044,11824,11659,40,11699,122
2020-10-11,San Joaquin,077,732212,21073,20700,105,20805,480
2020-10-11,San Luis Obispo,079,281455,4123,3874,21,3895,32
2020-10-11,San Mateo,081,765935,10845,10240,10,10250,130
2020-10-11,Santa Barbara,083,443738,9583,9440,85,9525,117
2020-10-11,Santa Clara,085,1922200,23816,22487,50,22537,336
2020-10-11,Santa Cruz,087,273765,2671,2578,33,2611,13
2020-10-11,Shasta,089,179085,1807,1515,17,1532,20
2020-10-11,Sierra,091,2930,6,6,0,6,0
2020-10-11,Siskiyou,093,43540,172,162,10,172,0
2020-10-11,Solano,095,438530,6892,6685,41,6726,53
2020-10-11,Sonoma,097,501317,8741,8319,23,8342,133
2020-10-11,Stanislaus,099,539301,17161,17007,630,17637,360
2020-10-11,Sutter,101,95872,1763,1742,1,1743,12
2020-10-11,Tehama,103,63373,736,702,2,704,3
2020-10-11,Trinity,105,12862,69,19,9,28,0
2020-10-11,Tulare,107,460477,17280,16741,234,16975,286
2020-10-11,Tuolumne,109,53932,248,234,4,238,4
2020-10-11,Ventura,111,848112,14248,13604,282,13886,151
2020-10-11,Yolo,113,214977,3030,2952,6,2958,55
2020-10-11,Yuba,115,75493,1162,1137,5,1142,10
2020-10-10,Alameda,001,1643700,22604,21979,204,22183,398
2020-10-10,Alpine,003,1148,3,3,0,3,0
2020-10-10,Amador,005,37829,307,304,0,304,16
2020-10-10,Butte,007,227075,3075,2962,27,2989,54
2020-10-10,Calaveras,009,45235,321,262,0,262,12
2020-10-10,Colusa,011,21464,540,541,1,542,6
2020-10-10,Contra Costa,013,1133247,18131,17566,89,17655,233
2020-10-10,Del Norte,015,27424,166,161,0,161,2
2020-10-10,El Dorado,017,186661,1303,1240,2,1242,4
2020-10-10,Fresno,019,978130,32179,29286,414,29700,421
2020-10-10,Glenn,021,27897,637,623,0,623,3
2020-10-10,Humboldt,023,135768,535,518,1,519,7
2020-10-10,Imperial,025,180216,12325,11591,11,11602,327
2020-10-10,Inyo,027,18085,210,201,4,205,14
2020-10-10,Kern,029,883053,33011,32338,361,32699,418
2020-10-10,Kings,031,150075,8296,8078,50,8128,80
2020-10-10,Lake,033,64148,667,630,0,630,11
2020-10-10,Lassen,035,31185,762,752,2,754,0
2020-10-10,Los Angeles,037,10098052,284462,279213,2357,281570,6743
2020-10-10,Madera,039,155013,4826,4662,33,4695,50
2020-10-10,Marin,041,260295,6980,6852,18,6870,97
2020-10-10,Mariposa,043,17540,77,76,0,76,2
2020-10-10,Mendocino,045,87422,1002,935,4,939,21
2020-10-10,Merced,047,269075,9251,9105,28,9133,146
2020-10-10,Modoc,049,8938,29,27,0,27,0
2020-10-10,Mono,051,14174,174,154,4,158,1
2020-10-10,Monterey,053,433212,10724,10410,44,10454,75
2020-10-10,Napa,055,140530,1874,1804,8,1812,11
2020-10-10,Nevada,057,99092,586,564,18,582,6
2020-10-10,Orange,059,3164182,57828,54965,1616,56581,1324
2020-10-10,Placer,061,380077,3923,3757,14,3771,48
2020-10-10,Plumas,063,18699,52,51,0,51,0
2020-10-10,Riverside,065,2383286,63482,61845,238,62083,1254
2020-10-10,Sacramento,067,1510023,24110,23689,27,23716,466
2020-10-10,San Benito,069,59416,1383,1370,0,1370,13
2020-10-10,San Bernardino,071,2135413,59058,56683,368,57051,1061
2020-10-10,San Diego,073,3302833,52201,50145,1253,51398,825
2020-10-10,San Francisco,075,870044,11803,11663,40,11703,122
2020-10-10,San Joaquin,077,732212,21045,20700,101,20801,481
2020-10-10,San Luis Obispo,079,281455,4103,3832,21,3853,32
2020-10-10,San Mateo,081,765935,10808,10218,10,10228,130
2020-10-10,Santa Barbara,083,443738,9572,9417,85,9502,116
2020-10-10,Santa Clara,085,1922200,23725,22354,50,22404,330
2020-10-10,Santa Cruz,087,273765,2657,2572,33,2605,13
2020-10-10,Shasta,089,179085,1790,1473,17,1490,20
2020-10-10,Sierra,091,2930,6,6,0,6,0
2020-10-10,Siskiyou,093,43540,172,161,10,171,0
2020-10-10,Solano,095,438530,6866,6655,41,6696,53
2020-10-10,Sonoma,097,501317,8721,8235,23,8258,133
2020-10-10,Stanislaus,099,539301,17126,16960,622,17582,360
2020-10-10,Sutter,101,95872,1760,1735,1,1736,12
2020-10-10,Tehama,103,63373,729,693,2,695,3
2020-10-10,Trinity,105,12862,69,19,9,28,0
2020-10-10,Tulare,107,460477,17245,16709,229,16938,286
2020-10-10,Tuolumne,109,53932,248,233,4,237,4
2020-10-10,Ventura,111,848112,14223,13520,282,13802,151
2020-10-10,Yolo,113,214977,3021,2939,6,2945,55
2020-10-10,Yuba,115,75493,1160,1134,5,1139,10
2020-10-09,Alameda,001,1643700,22556,21924,204,22128,399
2020-10-09,Alpine,003,1148,3,3,0,3,0
2020-10-09,Amador,005,37829,307,303,0,303,16
2020-10-09,Butte,007,227075,3072,2956,27,2983,51
2020-10-09,Calaveras,009,45235,319,262,0,262,11
2020-10-09,Colusa,011,21464,540,541,1,542,6
2020-10-09,Contra Costa,013,1133247,18081,17487,89,17576,229
2020-10-09,Del Norte,015,27424,165,161,0,161,2
2020-10-09,El Dorado,017,186661,1299,1234,2,1236,4
2020-10-09,Fresno,019,978130,32106,29208,412,29620,417
2020-10-09,Glenn,021,27897,632,617,0,617,3
2020-10-09,Humboldt,023,135768,533,516,1,517,7
2020-10-09,Imperial,025,180216,12298,11516,11,11527,330
2020-10-09,Inyo,027,18085,207,200,4,204,14
2020-10-09,Kern,029,883053,32968,32237,359,32596,417
2020-10-09,Kings,031,150075,8289,7993,48,8041,80
2020-10-09,Lake,033,64148,657,610,0,610,11
2020-10-09,Lassen,035,31185,762,751,2,753,0
2020-10-09,Los Angeles,037,10098052,283328,278039,2332,280371,6715
2020-10-09,Madera,039,155013,4816,4646,33,4679,50
2020-10-09,Marin,041,260295,6966,6838,18,6856,96
2020-10-09,Mariposa,043,17540,77,76,0,76,2
2020-10-09,Mendocino,045,87422,992,933,4,937,20
2020-10-09,Merced,047,269075,9237,9095,28,9123,145
2020-10-09,Modoc,049,8938,29,27,0,27,0
2020-10-09,Mono,051,14174,174,154,4,158,1
2020-10-09,Monterey,053,433212,10690,10369,44,10413,75
2020-10-09,Napa,055,140530,1864,1795,8,1803,11
2020-10-09,Nevada,057,99092,581,561,18,579,6
2020-10-09,Orange,059,3164182,57656,54746,1611,56357,1305
2020-10-09,Placer,061,380077,3909,3737,14,3751,48
2020-10-09,Plumas,063,18699,52,50,0,50,0
2020-10-09,Riverside,065,2383286,63246,61529,237,61766,1252
2020-10-09,Sacramento,067,1510023,24040,23606,27,23633,457
2020-10-09,San Benito,069,59416,1378,1367,0,1367,13
2020-10-09,San Bernardino,071,2135413,58818,56434,366,56800,1057
2020-10-09,San Diego,073,3302833,51925,49825,1242,51067,821
2020-10-09,San Francisco,075,870044,11773,11620,40,11660,120
2020-10-09,San Joaquin,077,732212,21015,20648,92,20740,481
2020-10-09,San Luis Obispo,079,281455,4084,3810,21,3831,32
2020-10-09,San Mateo,081,765935,10780,10140,10,10150,130
2020-10-09,Santa Barbara,083,443738,9544,9396,85,9481,116
2020-10-09,Santa Clara,085,1922200,23623,22251,49,22300,328
2020-10-09,Santa Cruz,087,273765,2648,2555,33,2588,13
2020-10-09,Shasta,089,179085,1764,1353,16,1369,20
2020-10-09,Sierra,091,2930,6,6,0,6,0
2020-10-09,Siskiyou,093,43540,170,156,10,166,0
2020-10-09,Solano,095,438530,6827,6614,41,6655,53
2020-10-09,Sonoma,097,501317,8667,8133,23,8156,133
2020-10-09,Stanislaus,099,539301,17102,16904,613,17517,362
2020-10-09,Sutter,101,95872,1756,1732,1,1733,12
2020-10-09,Tehama,103,63373,723,682,2,684,3
2020-10-09,Trinity,105,12862,69,25,9,34,0
2020-10-09,Tulare,107,460477,17205,16644,220,16864,286
2020-10-09,Tuolumne,109,53932,245,230,4,234,4
2020-10-09,Ventura,111,848112,14187,13469,279,13748,151
2020-10-09,Yolo,113,214977,3014,2928,6,2934,55
2020-10-09,Yuba,115,75493,1159,1129,5,1134,10
2020-10-08,Alameda,001,1643700,22475,21826,203,22029,395
2020-10-08,Alpine,003,1148,3,3,0,3,0
2020-10-08,Amador,005,37829,306,302,0,302,16
2020-10-08,Butte,007,227075,3062,2935,27,2962,51
2020-10-08,Calaveras,009,45235,318,262,0,262,11
2020-10-08,Colusa,011,21464,540,539,1,540,6
2020-10-08,Contra Costa,013,1133247,18021,17418,88,17506,228
2020-10-08,Del Norte,015,27424,165,151,0,151,2
2020-10-08,El Dorado,017,186661,1298,1230,2,1232,4
2020-10-08,Fresno,019,978130,32001,29111,412,29523,416
2020-10-08,Glenn,021,27897,629,616,0,616,3
2020-10-08,Humboldt,023,135768,529,515,1,516,7
2020-10-08,Imperial,025,180216,12259,11405,11,11416,330
2020-10-08,Inyo,027,18085,204,199,4,203,14
2020-10-08,Kern,029,883053,32910,32169,354,32523,411
2020-10-08,Kings,031,150075,8283,7968,48,8016,80
2020-10-08,Lake,033,64148,652,604,0,604,11
2020-10-08,Lassen,035,31185,757,751,2,753,0
2020-10-08,Los Angeles,037,10098052,282128,276763,2292,279055,6699
2020-10-08,Madera,039,155013,4797,4637,33,4670,50
2020-10-08,Marin,041,260295,6952,6810,18,6828,96
2020-10-08,Mariposa,043,17540,77,76,0,76,2
2020-10-08,Mendocino,045,87422,987,930,4,934,20
2020-10-08,Merced,047,269075,9217,9069,28,9097,144
2020-10-08,Modoc,049,8938,29,27,0,27,0
2020-10-08,Mono,051,14174,174,153,4,157,1
2020-10-08,Monterey,053,433212,10623,10343,44,10387,75
2020-10-08,Napa,055,140530,1849,1779,8,1787,11
2020-10-08,Nevada,057,99092,578,556,18,574,6
2020-10-08,Orange,059,3164182,57463,54523,1600,56123,1293
2020-10-08,Placer,061,380077,3891,3715,14,3729,48
2020-10-08,Plumas,063,18699,52,50,0,50,0
2020-10-08,Riverside,065,2383286,62977,61105,235,61340,1244
2020-10-08,Sacramento,067,1510023,23932,23482,27,23509,454
2020-10-08,San Benito,069,59416,1373,1367,0,1367,13
2020-10-08,San Bernardino,071,2135413,58452,56152,365,56517,1048
2020-10-08,San Diego,073,3302833,51645,49468,1210,50678,819
2020-10-08,San Francisco,075,870044,11735,11608,40,11648,115
2020-10-08,San Joaquin,077,732212,20963,20576,87,20663,478
2020-10-08,San Luis Obispo,079,281455,4068,3785,21,3806,32
2020-10-08,San Mateo,081,765935,10748,10044,10,10054,130
2020-10-08,Santa Barbara,083,443738,9516,9374,85,9459,116
2020-10-08,Santa Clara,085,1922200,23521,22095,49,22144,323
2020-10-08,Santa Cruz,087,273765,2636,2535,33,2568,13
2020-10-08,Shasta,089,179085,1730,1305,16,1321,20
2020-10-08,Sierra,091,2930,6,6,0,6,0
2020-10-08,Siskiyou,093,43540,170,156,10,166,0
2020-10-08,Solano,095,438530,6803,6556,41,6597,53
2020-10-08,Sonoma,097,501317,8601,8063,23,8086,132
2020-10-08,Stanislaus,099,539301,17056,16821,605,17426,360
2020-10-08,Sutter,101,95872,1756,1725,1,1726,12
2020-10-08,Tehama,103,63373,714,676,2,678,3
2020-10-08,Trinity,105,12862,68,25,9,34,0
2020-10-08,Tulare,107,460477,17144,16573,211,16784,283
2020-10-08,Tuolumne,109,53932,244,230,4,234,4
2020-10-08,Ventura,111,848112,14139,13399,277,13676,151
2020-10-08,Yolo,113,214977,2997,2914,6,2920,55
2020-10-08,Yuba,115,75493,1154,1126,5,1131,10
2020-10-07,Alameda,001,1643700,22398,21736,203,21939,395
2020-10-07,Alpine,003,1148,3,3,0,3,0
2020-10-07,Amador,005,37829,306,302,0,302,16
2020-10-07,Butte,007,227075,3050,2927,27,2954,47
2020-10-07,Calaveras,009,45235,316,262,0,262,11
2020-10-07,Colusa,011,21464,539,539,0,539,6
2020-10-07,Contra Costa,013,1133247,17951,17346,87,17433,225
2020-10-07,Del Norte,015,27424,164,149,0,149,2
2020-10-07,El Dorado,017,186661,1290,1219,2,1221,4
2020-10-07,Fresno,019,978130,31880,29069,407,29476,413
2020-10-07,Glenn,021,27897,629,615,0,615,3
2020-10-07,Humboldt,023,135768,526,512,1,513,7
2020-10-07,Imperial,025,180216,12222,11289,10,11299,330
2020-10-07,Inyo,027,18085,204,199,4,203,14
2020-10-07,Kern,029,883053,32837,32068,353,32421,410
2020-10-07,Kings,031,150075,8268,7948,48,7996,80
2020-10-07,Lake,033,64148,651,599,0,599,11
2020-10-07,Lassen,035,31185,757,751,2,753,0
2020-10-07,Los Angeles,037,10098052,280947,275559,2258,277817,6681
2020-10-07,Madera,039,155013,4777,4618,33,4651,50
2020-10-07,Marin,041,260295,6925,6790,18,6808,95
2020-10-07,Mariposa,043,17540,77,75,0,75,2
2020-10-07,Mendocino,045,87422,981,927,4,931,19
2020-10-07,Merced,047,269075,9180,9045,27,9072,144
2020-10-07,Modoc,049,8938,29,27,0,27,0
2020-10-07,Mono,051,14174,173,153,3,156,1
2020-10-07,Monterey,053,433212,10564,10272,44,10316,75
2020-10-07,Napa,055,140530,1836,1774,8,1782,11
2020-10-07,Nevada,057,99092,574,552,18,570,6
2020-10-07,Orange,059,3164182,57245,54332,1590,55922,1277
2020-10-07,Placer,061,380077,3875,3693,14,3707,48
2020-10-07,Plumas,063,18699,52,50,0,50,0
2020-10-07,Riverside,065,2383286,62630,60857,231,61088,1241
2020-10-07,Sacramento,067,1510023,23835,23380,27,23407,452
2020-10-07,San Benito,069,59416,1370,1363,0,1363,13
2020-10-07,San Bernardino,071,2135413,58103,55738,364,56102,1043
2020-10-07,San Diego,073,3302833,51329,49177,1186,50363,813
2020-10-07,San Francisco,075,870044,11700,11551,40,11591,115
2020-10-07,San Joaquin,077,732212,20911,20527,80,20607,478
2020-10-07,San Luis Obispo,079,281455,4038,3749,21,3770,32
2020-10-07,San Mateo,081,765935,10705,9980,10,9990,130
2020-10-07,Santa Barbara,083,443738,9490,9350,84,9434,116
2020-10-07,Santa Clara,085,1922200,23393,21993,49,22042,320
2020-10-07,Santa Cruz,087,273765,2624,2518,33,2551,14
2020-10-07,Shasta,089,179085,1687,1268,16,1284,20
2020-10-07,Sierra,091,2930,6,6,0,6,0
2020-10-07,Siskiyou,093,43540,168,154,10,164,0
2020-10-07,Solano,095,438530,6768,6526,41,6567,53
2020-10-07,Sonoma,097,501317,8526,7993,22,8015,130
2020-10-07,Stanislaus,099,539301,17021,16786,599,17385,357
2020-10-07,Sutter,101,95872,1753,1723,1,1724,12
2020-10-07,Tehama,103,63373,705,666,2,668,3
2020-10-07,Trinity,105,12862,64,25,8,33,0
2020-10-07,Tulare,107,460477,17101,16483,202,16685,282
2020-10-07,Tuolumne,109,53932,244,227,4,231,3
2020-10-07,Ventura,111,848112,14089,13333,271,13604,150
2020-10-07,Yolo,113,214977,2971,2904,6,2910,55
2020-10-07,Yuba,115,75493,1148,1120,5,1125,10
2020-10-06,Alameda,001,1643700,22307,21698,201,21899,385
2020-10-06,Alpine,003,1148,3,3,0,3,0
2020-10-06,Amador,005,37829,304,301,0,301,16
2020-10-06,Butte,007,227075,3043,2925,27,2952,47
2020-10-06,Calaveras,009,45235,316,261,0,261,11
2020-10-06,Colusa,011,21464,538,538,0,538,6
2020-10-06,Contra Costa,013,1133247,17872,17295,87,17382,219
2020-10-06,Del Norte,015,27424,164,144,0,144,2
2020-10-06,El Dorado,017,186661,1286,1211,2,1213,4
2020-10-06,Fresno,019,978130,31736,29022,404,29426,412
2020-10-06,Glenn,021,27897,626,604,0,604,3
2020-10-06,Humboldt,023,135768,523,508,1,509,7
2020-10-06,Imperial,025,180216,12184,11196,10,11206,327
2020-10-06,Inyo,027,18085,202,198,4,202,14
2020-10-06,Kern,029,883053,32760,32006,351,32357,407
2020-10-06,Kings,031,150075,8252,7943,48,7991,81
2020-10-06,Lake,033,64148,645,596,0,596,11
2020-10-06,Lassen,035,31185,757,743,2,745,0
2020-10-06,Los Angeles,037,10098052,279711,274115,2208,276323,6657
2020-10-06,Madera,039,155013,4765,4608,33,4641,50
2020-10-06,Marin,041,260295,6910,6766,18,6784,91
2020-10-06,Mariposa,043,17540,77,75,0,75,2
2020-10-06,Mendocino,045,87422,974,920,4,924,19
2020-10-06,Merced,047,269075,9144,9034,26,9060,143
2020-10-06,Modoc,049,8938,29,26,0,26,0
2020-10-06,Mono,051,14174,173,153,3,156,1
2020-10-06,Monterey,053,433212,10508,10235,42,10277,72
2020-10-06,Napa,055,140530,1830,1770,8,1778,11
2020-10-06,Nevada,057,99092,571,551,18,569,6
2020-10-06,Orange,059,3164182,57030,54203,1581,55784,1273
2020-10-06,Placer,061,380077,3853,3680,14,3694,48
2020-10-06,Plumas,063,18699,52,49,0,49,0
2020-10-06,Riverside,065,2383286,62365,60593,228,60821,1238
2020-10-06,Sacramento,067,1510023,23748,23322,27,23349,442
2020-10-06,San Benito,069,59416,1369,1358,0,1358,12
2020-10-06,San Bernardino,071,2135413,57786,55416,360,55776,1040
2020-10-06,San Diego,073,3302833,50992,48823,1169,49992,806
2020-10-06,San Francisco,075,870044,11674,11513,39,11552,115
2020-10-06,San Joaquin,077,732212,20871,20481,77,20558,477
2020-10-06,San Luis Obispo,079,281455,4004,3723,21,3744,32
2020-10-06,San Mateo,081,765935,10672,9934,10,9944,129
2020-10-06,Santa Barbara,083,443738,9461,9331,83,9414,116
2020-10-06,Santa Clara,085,1922200,23298,21914,49,21963,320
2020-10-06,Santa Cruz,087,273765,2602,2510,33,2543,12
2020-10-06,Shasta,089,179085,1647,1242,16,1258,18
2020-10-06,Sierra,091,2930,6,6,0,6,0
2020-10-06,Siskiyou,093,43540,168,154,10,164,0
2020-10-06,Solano,095,438530,6722,6506,41,6547,52
2020-10-06,Sonoma,097,501317,8433,7895,22,7917,130
2020-10-06,Stanislaus,099,539301,16976,16759,593,17352,354
2020-10-06,Sutter,101,95872,1751,1722,1,1723,12
2020-10-06,Tehama,103,63373,696,660,2,662,3
2020-10-06,Trinity,105,12862,64,25,8,33,0
2020-10-06,Tulare,107,460477,17059,16456,194,16650,280
2020-10-06,Tuolumne,109,53932,243,227,4,231,2
2020-10-06,Ventura,111,848112,14022,13242,266,13508,150
2020-10-06,Yolo,113,214977,2957,2899,6,2905,56
2020-10-06,Yuba,115,75493,1147,1114,5,1119,10
2020-10-05,Alameda,001,1643700,22219,21637,198,21835,383
2020-10-05,Alpine,003,1148,3,2,0,2,0
2020-10-05,Amador,005,37829,304,299,0,299,16
2020-10-05,Butte,007,227075,3033,2910,27,2937,46
2020-10-05,Calaveras,009,45235,316,259,0,259,11
2020-10-05,Colusa,011,21464,538,537,0,537,6
2020-10-05,Contra Costa,013,1133247,17795,17250,87,17337,216
2020-10-05,Del Norte,015,27424,161,142,0,142,2
2020-10-05,El Dorado,017,186661,1282,1202,2,1204,4
2020-10-05,Fresno,019,978130,31619,29136,404,29540,408
2020-10-05,Glenn,021,27897,624,603,0,603,3
2020-10-05,Humboldt,023,135768,522,506,1,507,6
2020-10-05,Imperial,025,180216,12144,11169,10,11179,327
2020-10-05,Inyo,027,18085,202,197,4,201,14
2020-10-05,Kern,029,883053,32681,31933,347,32280,404
2020-10-05,Kings,031,150075,8155,7932,48,7980,80
2020-10-05,Lake,033,64148,641,592,0,592,10
2020-10-05,Lassen,035,31185,756,743,2,745,0
2020-10-05,Los Angeles,037,10098052,278624,273200,2166,275366,6632
2020-10-05,Madera,039,155013,4757,4598,31,4629,50
2020-10-05,Marin,041,260295,6893,6751,18,6769,91
2020-10-05,Mariposa,043,17540,77,75,0,75,2
2020-10-05,Mendocino,045,87422,966,913,4,917,19
2020-10-05,Merced,047,269075,9125,9021,25,9046,143
2020-10-05,Modoc,049,8938,29,26,0,26,0
2020-10-05,Mono,051,14174,173,152,3,155,1
2020-10-05,Monterey,053,433212,10461,10187,42,10229,72
2020-10-05,Napa,055,140530,1819,1760,8,1768,11
2020-10-05,Nevada,057,99092,568,550,17,567,6
2020-10-05,Orange,059,3164182,56814,54103,1568,55671,1271
2020-10-05,Placer,061,380077,3827,3670,14,3684,46
2020-10-05,Plumas,063,18699,51,49,0,49,0
2020-10-05,Riverside,065,2383286,62045,60454,224,60678,1232
2020-10-05,Sacramento,067,1510023,23644,23207,27,23234,438
2020-10-05,San Benito,069,59416,1366,1356,0,1356,12
2020-10-05,San Bernardino,071,2135413,57478,55100,359,55459,1031
2020-10-05,San Diego,073,3302833,50656,48662,1145,49807,803
2020-10-05,San Francisco,075,870044,11635,11476,36,11512,110
2020-10-05,San Joaquin,077,732212,20800,20319,74,20393,476
2020-10-05,San Luis Obispo,079,281455,3977,3710,21,3731,32
2020-10-05,San Mateo,081,765935,10645,9896,10,9906,128
2020-10-05,Santa Barbara,083,443738,9439,9309,83,9392,116
2020-10-05,Santa Clara,085,1922200,23181,21861,49,21910,319
2020-10-05,Santa Cruz,087,273765,2590,2492,33,2525,9
2020-10-05,Shasta,089,179085,1615,1158,16,1174,18
2020-10-05,Sierra,091,2930,6,6,0,6,0
2020-10-05,Siskiyou,093,43540,168,153,10,163,0
2020-10-05,Solano,095,438530,6683,6475,41,6516,52
2020-10-05,Sonoma,097,501317,8341,7817,22,7839,130
2020-10-05,Stanislaus,099,539301,16941,16730,586,17316,351
2020-10-05,Sutter,101,95872,1743,1719,1,1720,12
2020-10-05,Tehama,103,63373,688,642,2,644,3
2020-10-05,Trinity,105,12862,62,22,8,30,0
2020-10-05,Tulare,107,460477,17000,16343,189,16532,278
2020-10-05,Tuolumne,109,53932,240,226,4,230,2
2020-10-05,Ventura,111,848112,13953,13224,246,13470,149
2020-10-05,Yolo,113,214977,2938,2889,6,2895,56
2020-10-05,Yuba,115,75493,1134,1108,5,1113,9
2020-10-04,Alameda,001,1643700,22123,21597,198,21795,383
2020-10-04,Alpine,003,1148,3,2,0,2,0
2020-10-04,Amador,005,37829,302,297,0,297,16
2020-10-04,Butte,007,227075,3019,2903,27,2930,46
2020-10-04,Calaveras,009,45235,316,259,0,259,11
2020-10-04,Colusa,011,21464,537,537,0,537,6
2020-10-04,Contra Costa,013,1133247,17730,17192,87,17279,214
2020-10-04,Del Norte,015,27424,157,142,0,142,2
2020-10-04,El Dorado,017,186661,1278,1196,2,1198,4
2020-10-04,Fresno,019,978130,31496,29065,404,29469,408
2020-10-04,Glenn,021,27897,622,601,0,601,3
2020-10-04,Humboldt,023,135768,521,506,1,507,6
2020-10-04,Imperial,025,180216,12105,11127,10,11137,327
2020-10-04,Inyo,027,18085,199,195,4,199,14
2020-10-04,Kern,029,883053,32607,31906,344,32250,404
2020-10-04,Kings,031,150075,8140,7919,48,7967,80
2020-10-04,Lake,033,64148,627,589,0,589,10
2020-10-04,Lassen,035,31185,756,743,2,745,0
2020-10-04,Los Angeles,037,10098052,277235,272822,2118,274940,6625
2020-10-04,Madera,039,155013,4741,4587,31,4618,50
2020-10-04,Marin,041,260295,6873,6741,18,6759,91
2020-10-04,Mariposa,043,17540,77,75,0,75,2
2020-10-04,Mendocino,045,87422,953,905,4,909,18
2020-10-04,Merced,047,269075,9100,9006,25,9031,140
2020-10-04,Modoc,049,8938,29,26,0,26,0
2020-10-04,Mono,051,14174,172,152,2,154,1
2020-10-04,Monterey,053,433212,10420,10141,41,10182,72
2020-10-04,Napa,055,140530,1807,1759,8,1767,11
2020-10-04,Nevada,057,99092,564,547,16,563,6
2020-10-04,Orange,059,3164182,56578,53966,1559,55525,1270
2020-10-04,Placer,061,380077,3806,3664,14,3678,46
2020-10-04,Plumas,063,18699,51,49,0,49,0
2020-10-04,Riverside,065,2383286,61759,60251,220,60471,1226
2020-10-04,Sacramento,067,1510023,23531,23162,27,23189,438
2020-10-04,San Benito,069,59416,1366,1355,0,1355,12
2020-10-04,San Bernardino,071,2135413,57031,55100,357,55457,1031
2020-10-04,San Diego,073,3302833,50289,48438,1120,49558,803
2020-10-04,San Francisco,075,870044,11603,11474,34,11508,110
2020-10-04,San Joaquin,077,732212,20723,20320,68,20388,476
2020-10-04,San Luis Obispo,079,281455,3952,3688,21,3709,31
2020-10-04,San Mateo,081,765935,10585,9858,10,9868,128
2020-10-04,Santa Barbara,083,443738,9413,9276,81,9357,116
2020-10-04,Santa Clara,085,1922200,23044,21780,49,21829,316
2020-10-04,Santa Cruz,087,273765,2574,2483,33,2516,9
2020-10-04,Shasta,089,179085,1517,1158,15,1173,18
2020-10-04,Sierra,091,2930,6,6,0,6,0
2020-10-04,Siskiyou,093,43540,168,153,10,163,0
2020-10-04,Solano,095,438530,6632,6445,41,6486,52
2020-10-04,Sonoma,097,501317,8253,7794,22,7816,129
2020-10-04,Stanislaus,099,539301,16891,16711,577,17288,351
2020-10-04,Sutter,101,95872,1740,1711,1,1712,11
2020-10-04,Tehama,103,63373,673,637,2,639,3
2020-10-04,Trinity,105,12862,61,21,8,29,0
2020-10-04,Tulare,107,460477,16923,16343,178,16521,278
2020-10-04,Tuolumne,109,53932,238,226,4,230,2
2020-10-04,Ventura,111,848112,13871,13197,229,13426,149
2020-10-04,Yolo,113,214977,2927,2875,6,2881,56
2020-10-04,Yuba,115,75493,1130,1103,5,1108,9
2020-10-03,Alameda,001,1643700,22077,21510,197,21707,386
2020-10-03,Alpine,003,1148,3,2,0,2,0
2020-10-03,Amador,005,37829,301,296,0,296,16
2020-10-03,Butte,007,227075,3013,2894,27,2921,46
2020-10-03,Calaveras,009,45235,316,259,0,259,11
2020-10-03,Colusa,011,21464,536,537,0,537,6
2020-10-03,Contra Costa,013,1133247,17680,17087,85,17172,213
2020-10-03,Del Norte,015,27424,153,142,0,142,2
2020-10-03,El Dorado,017,186661,1271,1188,2,1190,4
2020-10-03,Fresno,019,978130,31436,28975,403,29378,408
2020-10-03,Glenn,021,27897,620,601,0,601,3
2020-10-03,Humboldt,023,135768,520,504,1,505,6
2020-10-03,Imperial,025,180216,12082,11090,10,11100,327
2020-10-03,Inyo,027,18085,199,194,4,198,14
2020-10-03,Kern,029,883053,32557,31864,341,32205,403
2020-10-03,Kings,031,150075,8136,7887,48,7935,80
2020-10-03,Lake,033,64148,617,588,0,588,10
2020-10-03,Lassen,035,31185,756,743,2,745,0
2020-10-03,Los Angeles,037,10098052,276530,271869,2089,273958,6620
2020-10-03,Madera,039,155013,4724,4565,31,4596,50
2020-10-03,Marin,041,260295,6867,6728,18,6746,91
2020-10-03,Mariposa,043,17540,77,75,0,75,2
2020-10-03,Mendocino,045,87422,951,898,4,902,18
2020-10-03,Merced,047,269075,9087,8986,25,9011,139
2020-10-03,Modoc,049,8938,29,26,0,26,0
2020-10-03,Mono,051,14174,171,152,2,154,1
2020-10-03,Monterey,053,433212,10386,10092,38,10130,72
2020-10-03,Napa,055,140530,1803,1752,8,1760,11
2020-10-03,Nevada,057,99092,563,544,16,560,6
2020-10-03,Orange,059,3164182,56461,53573,1554,55127,1268
2020-10-03,Placer,061,380077,3795,3648,14,3662,47
2020-10-03,Plumas,063,18699,51,48,0,48,0
2020-10-03,Riverside,065,2383286,61607,59991,218,60209,1226
2020-10-03,Sacramento,067,1510023,23480,23076,27,23103,437
2020-10-03,San Benito,069,59416,1366,1351,0,1351,12
2020-10-03,San Bernardino,071,2135413,56858,55004,354,55358,1031
2020-10-03,San Diego,073,3302833,50058,48202,1103,49305,798
2020-10-03,San Francisco,075,870044,11578,11475,32,11507,110
2020-10-03,San Joaquin,077,732212,20697,20322,68,20390,476
2020-10-03,San Luis Obispo,079,281455,3928,3670,21,3691,31
2020-10-03,San Mateo,081,765935,10559,9822,9,9831,128
2020-10-03,Santa Barbara,083,443738,9400,9256,81,9337,116
2020-10-03,Santa Clara,085,1922200,22964,21672,49,21721,309
2020-10-03,Santa Cruz,087,273765,2566,2476,33,2509,9
2020-10-03,Shasta,089,179085,1489,1117,14,1131,18
2020-10-03,Sierra,091,2930,6,6,0,6,0
2020-10-03,Siskiyou,093,43540,168,152,10,162,0
2020-10-03,Solano,095,438530,6606,6419,41,6460,52
2020-10-03,Sonoma,097,501317,8210,7747,22,7769,129
2020-10-03,Stanislaus,099,539301,16858,16645,573,17218,351
2020-10-03,Sutter,101,95872,1736,1705,1,1706,11
2020-10-03,Tehama,103,63373,667,630,2,632,3
2020-10-03,Trinity,105,12862,61,15,8,23,0
2020-10-03,Tulare,107,460477,16879,16322,174,16496,278
2020-10-03,Tuolumne,109,53932,237,224,4,228,2
2020-10-03,Ventura,111,848112,13832,13150,225,13375,148
2020-10-03,Yolo,113,214977,2920,2863,6,2869,56
2020-10-03,Yuba,115,75493,1122,1097,5,1102,8
2020-10-02,Alameda,001,1643700,22022,21404,196,21600,382
2020-10-02,Alpine,003,1148,3,2,0,2,0
2020-10-02,Amador,005,37829,300,296,0,296,16
2020-10-02,Butte,007,227075,3003,2879,27,2906,46
2020-10-02,Calaveras,009,45235,315,259,0,259,11
2020-10-02,Colusa,011,21464,535,537,0,537,6
2020-10-02,Contra Costa,013,1133247,17637,17002,84,17086,213
2020-10-02,Del Norte,015,27424,152,141,0,141,2
2020-10-02,El Dorado,017,186661,1264,1168,2,1170,4
2020-10-02,Fresno,019,978130,31353,28855,403,29258,403
2020-10-02,Glenn,021,27897,615,594,0,594,3
2020-10-02,Humboldt,023,135768,519,503,1,504,6
2020-10-02,Imperial,025,180216,12060,11024,10,11034,327
2020-10-02,Inyo,027,18085,197,191,4,195,14
2020-10-02,Kern,029,883053,32505,31790,339,32129,399
2020-10-02,Kings,031,150075,8127,7716,48,7764,79
2020-10-02,Lake,033,64148,611,579,0,579,10
2020-10-02,Lassen,035,31185,756,742,2,744,0
2020-10-02,Los Angeles,037,10098052,275628,270935,2062,272997,6602
2020-10-02,Madera,039,155013,4715,4537,31,4568,49
2020-10-02,Marin,041,260295,6850,6717,18,6735,91
2020-10-02,Mariposa,043,17540,77,75,0,75,2
2020-10-02,Mendocino,045,87422,946,883,4,887,18
2020-10-02,Merced,047,269075,9077,8961,25,8986,139
2020-10-02,Modoc,049,8938,29,26,0,26,0
2020-10-02,Mono,051,14174,171,150,2,152,1
2020-10-02,Monterey,053,433212,10352,9997,38,10035,71
2020-10-02,Napa,055,140530,1797,1737,8,1745,11
2020-10-02,Nevada,057,99092,560,543,16,559,6
2020-10-02,Orange,059,3164182,56330,53299,1547,54846,1262
2020-10-02,Placer,061,380077,3775,3612,14,3626,46
2020-10-02,Plumas,063,18699,51,48,0,48,0
2020-10-02,Riverside,065,2383286,61386,59673,215,59888,1223
2020-10-02,Sacramento,067,1510023,23415,22818,27,22845,436
2020-10-02,San Benito,069,59416,1362,1347,0,1347,12
2020-10-02,San Bernardino,071,2135413,56670,54613,354,54967,1028
2020-10-02,San Diego,073,3302833,49805,47793,1088,48881,794
2020-10-02,San Francisco,075,870044,11555,11398,32,11430,110
2020-10-02,San Joaquin,077,732212,20663,20235,67,20302,474
2020-10-02,San Luis Obispo,079,281455,3905,3654,21,3675,31
2020-10-02,San Mateo,081,765935,10518,9745,9,9754,128
2020-10-02,Santa Barbara,083,443738,9377,9234,81,9315,116
2020-10-02,Santa Clara,085,1922200,22878,21545,48,21593,305
2020-10-02,Santa Cruz,087,273765,2549,2463,33,2496,9
2020-10-02,Shasta,089,179085,1454,1046,14,1060,18
2020-10-02,Sierra,091,2930,6,6,0,6,0
2020-10-02,Siskiyou,093,43540,168,151,10,161,0
2020-10-02,Solano,095,438530,6576,6385,41,6426,52
2020-10-02,Sonoma,097,501317,8153,7662,22,7684,125
2020-10-02,Stanislaus,099,539301,16817,16609,564,17173,349
2020-10-02,Sutter,101,95872,1735,1693,1,1694,11
2020-10-02,Tehama,103,63373,662,619,2,621,3
2020-10-02,Trinity,105,12862,61,15,8,23,0
2020-10-02,Tulare,107,460477,16838,16245,167,16412,278
2020-10-02,Tuolumne,109,53932,235,225,4,229,2
2020-10-02,Ventura,111,848112,13793,13120,221,13341,146
2020-10-02,Yolo,113,214977,2915,2845,6,2851,55
2020-10-02,Yuba,115,75493,1120,1090,5,1095,8
2020-10-01,Alameda,001,1643700,21961,21349,192,21541,383
2020-10-01,Alpine,003,1148,3,2,0,2,0
2020-10-01,Amador,005,37829,300,294,0,294,16
2020-10-01,Butte,007,227075,2995,2865,27,2892,45
2020-10-01,Calaveras,009,45235,315,257,0,257,11
2020-10-01,Colusa,011,21464,535,536,0,536,6
2020-10-01,Contra Costa,013,1133247,17574,16898,84,16982,211
2020-10-01,Del Norte,015,27424,147,140,0,140,2
2020-10-01,El Dorado,017,186661,1260,1162,1,1163,4
2020-10-01,Fresno,019,978130,31272,28796,401,29197,397
2020-10-01,Glenn,021,27897,611,593,0,593,3
2020-10-01,Humboldt,023,135768,519,499,1,500,6
2020-10-01,Imperial,025,180216,12017,10928,10,10938,325
2020-10-01,Inyo,027,18085,197,191,4,195,14
2020-10-01,Kern,029,883053,32442,31678,334,32012,399
2020-10-01,Kings,031,150075,8116,7688,45,7733,79
2020-10-01,Lake,033,64148,605,572,0,572,11
2020-10-01,Lassen,035,31185,753,742,2,744,0
2020-10-01,Los Angeles,037,10098052,274586,271513,2028,273541,6621
2020-10-01,Madera,039,155013,4692,4508,31,4539,48
2020-10-01,Marin,041,260295,6836,6710,18,6728,92
2020-10-01,Mariposa,043,17540,77,76,0,76,2
2020-10-01,Mendocino,045,87422,941,874,4,878,19
2020-10-01,Merced,047,269075,9049,8942,25,8967,138
2020-10-01,Modoc,049,8938,29,26,0,26,0
2020-10-01,Mono,051,14174,169,150,2,152,1
2020-10-01,Monterey,053,433212,10276,9958,38,9996,71
2020-10-01,Napa,055,140530,1789,1729,8,1737,11
2020-10-01,Nevada,057,99092,559,543,16,559,6
2020-10-01,Orange,059,3164182,56165,53088,1534,54622,1257
2020-10-01,Placer,061,380077,3748,3599,14,3613,45
2020-10-01,Plumas,063,18699,51,48,0,48,0
2020-10-01,Riverside,065,2383286,61134,59293,209,59502,1223
2020-10-01,Sacramento,067,1510023,23303,22714,26,22740,433
2020-10-01,San Benito,069,59416,1360,1346,0,1346,12
2020-10-01,San Bernardino,071,2135413,56376,54350,351,54701,1021
2020-10-01,San Diego,073,3302833,49523,47487,1068,48555,792
2020-10-01,San Francisco,075,870044,11524,11284,30,11314,110
2020-10-01,San Joaquin,077,732212,20616,20204,64,20268,471
2020-10-01,San Luis Obispo,079,281455,3878,3625,21,3646,31
2020-10-01,San Mateo,081,765935,10473,9681,9,9690,128
2020-10-01,Santa Barbara,083,443738,9337,9215,81,9296,118
2020-10-01,Santa Clara,085,1922200,22777,21398,48,21446,305
2020-10-01,Santa Cruz,087,273765,2534,2418,33,2451,10
2020-10-01,Shasta,089,179085,1403,991,14,1005,18
2020-10-01,Sierra,091,2930,6,6,0,6,0
2020-10-01,Siskiyou,093,43540,165,150,10,160,0
2020-10-01,Solano,095,438530,6538,6352,41,6393,52
2020-10-01,Sonoma,097,501317,8086,7569,22,7591,125
2020-10-01,Stanislaus,099,539301,16784,16555,558,17113,346
2020-10-01,Sutter,101,95872,1730,1684,1,1685,11
2020-10-01,Tehama,103,63373,652,606,2,608,3
2020-10-01,Trinity,105,12862,61,15,8,23,0
2020-10-01,Tulare,107,460477,16763,16182,164,16346,275
2020-10-01,Tuolumne,109,53932,235,223,4,227,2
2020-10-01,Ventura,111,848112,13741,13057,207,13264,146
2020-10-01,Yolo,113,214977,2897,2833,6,2839,55
2020-10-01,Yuba,115,75493,1116,1082,5,1087,8
2020-09-30,Alameda,001,1643700,21882,21271,189,21460,380
2020-09-30,Alpine,003,1148,3,2,0,2,0
2020-09-30,Amador,005,37829,300,294,0,294,16
2020-09-30,Butte,007,227075,2987,2858,27,2885,44
2020-09-30,Calaveras,009,45235,314,258,0,258,11
2020-09-30,Colusa,011,21464,534,534,0,534,6
2020-09-30,Contra Costa,013,1133247,17506,16819,84,16903,211
2020-09-30,Del Norte,015,27424,146,140,0,140,2
2020-09-30,El Dorado,017,186661,1248,1157,1,1158,4
2020-09-30,Fresno,019,978130,31181,28706,398,29104,395
2020-09-30,Glenn,021,27897,606,592,0,592,3
2020-09-30,Humboldt,023,135768,517,497,1,498,6
2020-09-30,Imperial,025,180216,11992,10868,10,10878,287
2020-09-30,Inyo,027,18085,196,189,4,193,14
2020-09-30,Kern,029,883053,32367,31601,333,31934,398
2020-09-30,Kings,031,150075,8087,7685,45,7730,79
2020-09-30,Lake,033,64148,599,567,0,567,10
2020-09-30,Lassen,035,31185,750,742,2,744,0
2020-09-30,Los Angeles,037,10098052,273361,270260,1995,272255,6568
2020-09-30,Madera,039,155013,4683,4477,31,4508,47
2020-09-30,Marin,041,260295,6812,6700,17,6717,91
2020-09-30,Mariposa,043,17540,77,76,0,76,2
2020-09-30,Mendocino,045,87422,935,867,4,871,17
2020-09-30,Merced,047,269075,9029,8926,25,8951,136
2020-09-30,Modoc,049,8938,29,26,0,26,0
2020-09-30,Mono,051,14174,169,150,2,152,1
2020-09-30,Monterey,053,433212,10226,9898,37,9935,70
2020-09-30,Napa,055,140530,1775,1728,8,1736,11
2020-09-30,Nevada,057,99092,557,540,16,556,6
2020-09-30,Orange,059,3164182,55974,52916,1518,54434,1251
2020-09-30,Placer,061,380077,3727,3585,14,3599,43
2020-09-30,Plumas,063,18699,51,48,0,48,0
2020-09-30,Riverside,065,2383286,60779,59074,205,59279,1220
2020-09-30,Sacramento,067,1510023,23199,22613,26,22639,429
2020-09-30,San Benito,069,59416,1357,1342,0,1342,12
2020-09-30,San Bernardino,071,2135413,56096,53988,349,54337,1018
2020-09-30,San Diego,073,3302833,49219,47182,1047,48229,783
2020-09-30,San Francisco,075,870044,11494,11247,30,11277,106
2020-09-30,San Joaquin,077,732212,20533,20150,62,20212,461
2020-09-30,San Luis Obispo,079,281455,3853,3597,21,3618,31
2020-09-30,San Mateo,081,765935,10431,9634,9,9643,128
2020-09-30,Santa Barbara,083,443738,9311,9186,81,9267,115
2020-09-30,Santa Clara,085,1922200,22672,21318,48,21366,302
2020-09-30,Santa Cruz,087,273765,2521,2405,33,2438,10
2020-09-30,Shasta,089,179085,1347,976,13,989,17
2020-09-30,Sierra,091,2930,6,6,0,6,0
2020-09-30,Siskiyou,093,43540,163,150,10,160,0
2020-09-30,Solano,095,438530,6496,6315,41,6356,51
2020-09-30,Sonoma,097,501317,7997,7494,22,7516,125
2020-09-30,Stanislaus,099,539301,16737,16531,552,17083,343
2020-09-30,Sutter,101,95872,1714,1680,1,1681,10
2020-09-30,Tehama,103,63373,646,594,2,596,3
2020-09-30,Trinity,105,12862,58,15,8,23,0
2020-09-30,Tulare,107,460477,16697,16117,157,16274,274
2020-09-30,Tuolumne,109,53932,233,224,4,228,2
2020-09-30,Ventura,111,848112,13706,12968,191,13159,145
2020-09-30,Yolo,113,214977,2884,2822,6,2828,55
2020-09-30,Yuba,115,75493,1113,1075,5,1080,8
2020-09-29,Alameda,001,1643700,21805,21241,185,21426,374
2020-09-29,Alpine,003,1148,3,2,0,2,0
2020-09-29,Amador,005,37829,298,294,0,294,16
2020-09-29,Butte,007,227075,2973,2848,27,2875,44
2020-09-29,Calaveras,009,45235,312,261,0,261,11
2020-09-29,Colusa,011,21464,534,534,0,534,6
2020-09-29,Contra Costa,013,1133247,17451,16716,82,16798,209
2020-09-29,Del Norte,015,27424,142,142,0,142,2
2020-09-29,El Dorado,017,186661,1239,1151,1,1152,4
2020-09-29,Fresno,019,978130,31086,28621,397,29018,394
2020-09-29,Glenn,021,27897,602,589,0,589,3
2020-09-29,Humboldt,023,135768,515,497,1,498,6
2020-09-29,Imperial,025,180216,11958,10811,10,10821,283
2020-09-29,Inyo,027,18085,195,188,4,192,14
2020-09-29,Kern,029,883053,32312,31534,332,31866,397
2020-09-29,Kings,031,150075,8031,7681,45,7726,78
2020-09-29,Lake,033,64148,597,566,0,566,11
2020-09-29,Lassen,035,31185,750,741,2,743,0
2020-09-29,Los Angeles,037,10098052,272146,269246,1966,271212,6545
2020-09-29,Madera,039,155013,4659,4453,31,4484,47
2020-09-29,Marin,041,260295,6791,6692,17,6709,91
2020-09-29,Mariposa,043,17540,77,74,0,74,2
2020-09-29,Mendocino,045,87422,925,854,4,858,17
2020-09-29,Merced,047,269075,9016,8892,23,8915,136
2020-09-29,Modoc,049,8938,29,26,0,26,0
2020-09-29,Mono,051,14174,169,149,2,151,1
2020-09-29,Monterey,053,433212,10171,9826,35,9861,70
2020-09-29,Napa,055,140530,1772,1727,8,1735,11
2020-09-29,Nevada,057,99092,552,539,16,555,6
2020-09-29,Orange,059,3164182,55788,52755,1507,54262,1231
2020-09-29,Placer,061,380077,3705,3570,14,3584,42
2020-09-29,Plumas,063,18699,51,48,0,48,0
2020-09-29,Riverside,065,2383286,60449,58863,198,59061,1208
2020-09-29,Sacramento,067,1510023,23078,22547,26,22573,425
2020-09-29,San Benito,069,59416,1352,1341,0,1341,12
2020-09-29,San Bernardino,071,2135413,55785,53753,348,54101,1012
2020-09-29,San Diego,073,3302833,48942,46987,1024,48011,781
2020-09-29,San Francisco,075,870044,11458,11142,30,11172,104
2020-09-29,San Joaquin,077,732212,20467,20094,60,20154,454
2020-09-29,San Luis Obispo,079,281455,3831,3581,21,3602,31
2020-09-29,San Mateo,081,765935,10384,9619,9,9628,127
2020-09-29,Santa Barbara,083,443738,9291,9149,80,9229,114
2020-09-29,Santa Clara,085,1922200,22536,21233,47,21280,302
2020-09-29,Santa Cruz,087,273765,2506,2383,32,2415,10
2020-09-29,Shasta,089,179085,1286,943,13,956,17
2020-09-29,Sierra,091,2930,6,6,0,6,0
2020-09-29,Siskiyou,093,43540,157,150,10,160,0
2020-09-29,Solano,095,438530,6462,6303,41,6344,51
2020-09-29,Sonoma,097,501317,7925,7426,22,7448,125
2020-09-29,Stanislaus,099,539301,16707,16505,546,17051,341
2020-09-29,Sutter,101,95872,1708,1677,1,1678,10
2020-09-29,Tehama,103,63373,628,585,2,587,2
2020-09-29,Trinity,105,12862,56,16,8,24,0
2020-09-29,Tulare,107,460477,16633,16055,150,16205,270
2020-09-29,Tuolumne,109,53932,233,224,4,228,2
2020-09-29,Ventura,111,848112,13649,12875,188,13063,145
2020-09-29,Yolo,113,214977,2871,2818,6,2824,55
2020-09-29,Yuba,115,75493,1111,1071,5,1076,8
2020-09-28,Alameda,001,1643700,21718,21133,185,21318,370
2020-09-28,Alpine,003,1148,3,2,0,2,0
2020-09-28,Amador,005,37829,296,294,0,294,16
2020-09-28,Butte,007,227075,2958,2837,27,2864,44
2020-09-28,Calaveras,009,45235,312,257,0,257,11
2020-09-28,Colusa,011,21464,533,531,0,531,6
2020-09-28,Contra Costa,013,1133247,17386,16653,82,16735,195
2020-09-28,Del Norte,015,27424,142,138,0,138,2
2020-09-28,El Dorado,017,186661,1232,1144,1,1145,4
2020-09-28,Fresno,019,978130,31004,28517,389,28906,389
2020-09-28,Glenn,021,27897,600,585,0,585,3
2020-09-28,Humboldt,023,135768,509,495,1,496,6
2020-09-28,Imperial,025,180216,11923,10777,10,10787,283
2020-09-28,Inyo,027,18085,194,188,4,192,14
2020-09-28,Kern,029,883053,32247,31481,328,31809,395
2020-09-28,Kings,031,150075,7890,7661,43,7704,78
2020-09-28,Lake,033,64148,593,559,0,559,10
2020-09-28,Lassen,035,31185,749,737,2,739,0
2020-09-28,Los Angeles,037,10098052,271040,268404,1936,270340,6508
2020-09-28,Madera,039,155013,4638,4438,31,4469,47
2020-09-28,Marin,041,260295,6775,6676,17,6693,91
2020-09-28,Mariposa,043,17540,77,74,0,74,2
2020-09-28,Mendocino,045,87422,910,850,4,854,17
2020-09-28,Merced,047,269075,8988,8869,23,8892,136
2020-09-28,Modoc,049,8938,29,26,0,26,0
2020-09-28,Mono,051,14174,169,148,2,150,1
2020-09-28,Monterey,053,433212,10106,9780,33,9813,69
2020-09-28,Napa,055,140530,1760,1705,8,1713,11
2020-09-28,Nevada,057,99092,544,538,16,554,6
2020-09-28,Orange,059,3164182,55582,52633,1498,54131,1196
2020-09-28,Placer,061,380077,3684,3572,14,3586,42
2020-09-28,Plumas,063,18699,50,48,0,48,0
2020-09-28,Riverside,065,2383286,60151,58570,189,58759,1198
2020-09-28,Sacramento,067,1510023,22931,22392,26,22418,423
2020-09-28,San Benito,069,59416,1349,1336,0,1336,11
2020-09-28,San Bernardino,071,2135413,55436,53501,348,53849,988
2020-09-28,San Diego,073,3302833,48624,46736,1004,47740,776
2020-09-28,San Francisco,075,870044,11424,11114,30,11144,100
2020-09-28,San Joaquin,077,732212,20418,19982,59,20041,448
2020-09-28,San Luis Obispo,079,281455,3810,3567,21,3588,31
2020-09-28,San Mateo,081,765935,10333,9582,9,9591,127
2020-09-28,Santa Barbara,083,443738,9273,9121,80,9201,114
2020-09-28,Santa Clara,085,1922200,22419,21180,47,21227,271
2020-09-28,Santa Cruz,087,273765,2496,2359,32,2391,9
2020-09-28,Shasta,089,179085,1232,883,10,893,17
2020-09-28,Sierra,091,2930,6,6,0,6,0
2020-09-28,Siskiyou,093,43540,157,149,10,159,0
2020-09-28,Solano,095,438530,6426,6254,41,6295,51
2020-09-28,Sonoma,097,501317,7849,7369,22,7391,125
2020-09-28,Stanislaus,099,539301,16667,16467,539,17006,336
2020-09-28,Sutter,101,95872,1701,1676,1,1677,10
2020-09-28,Tehama,103,63373,620,579,2,581,2
2020-09-28,Trinity,105,12862,56,16,8,24,0
2020-09-28,Tulare,107,460477,16580,15918,145,16063,270
2020-09-28,Tuolumne,109,53932,233,225,4,229,2
2020-09-28,Ventura,111,848112,13571,12812,181,12993,139
2020-09-28,Yolo,113,214977,2854,2809,6,2815,55
2020-09-28,Yuba,115,75493,1108,1062,5,1067,7
2020-09-27,Alameda,001,1643700,21637,21077,181,21258,370
2020-09-27,Alpine,003,1148,3,2,0,2,0
2020-09-27,Amador,005,37829,296,291,0,291,16
2020-09-27,Butte,007,227075,2946,2833,27,2860,44
2020-09-27,Calaveras,009,45235,311,257,0,257,11
2020-09-27,Colusa,011,21464,532,531,0,531,6
2020-09-27,Contra Costa,013,1133247,17284,16596,81,16677,195
2020-09-27,Del Norte,015,27424,142,138,0,138,2
2020-09-27,El Dorado,017,186661,1217,1130,1,1131,4
2020-09-27,Fresno,019,978130,30898,28441,389,28830,389
2020-09-27,Glenn,021,27897,596,576,0,576,3
2020-09-27,Humboldt,023,135768,507,492,1,493,6
2020-09-27,Imperial,025,180216,11889,10743,10,10753,283
2020-09-27,Inyo,027,18085,192,188,4,192,14
2020-09-27,Kern,029,883053,32128,31462,325,31787,395
2020-09-27,Kings,031,150075,7870,7641,43,7684,78
2020-09-27,Lake,033,64148,589,555,0,555,10
2020-09-27,Lassen,035,31185,749,737,2,739,0
2020-09-27,Los Angeles,037,10098052,269864,267754,1915,269669,6507
2020-09-27,Madera,039,155013,4609,4416,31,4447,47
2020-09-27,Marin,041,260295,6765,6663,17,6680,91
2020-09-27,Mariposa,043,17540,77,74,0,74,2
2020-09-27,Mendocino,045,87422,904,846,4,850,17
2020-09-27,Merced,047,269075,8954,8853,23,8876,136
2020-09-27,Modoc,049,8938,29,26,0,26,0
2020-09-27,Mono,051,14174,169,148,2,150,1
2020-09-27,Monterey,053,433212,10046,9724,32,9756,69
2020-09-27,Napa,055,140530,1755,1690,8,1698,11
2020-09-27,Nevada,057,99092,543,537,16,553,6
2020-09-27,Orange,059,3164182,55307,52458,1489,53947,1195
2020-09-27,Placer,061,380077,3671,3562,14,3576,42
2020-09-27,Plumas,063,18699,50,48,0,48,0
2020-09-27,Riverside,065,2383286,59855,58509,181,58690,1191
2020-09-27,Sacramento,067,1510023,22833,22356,26,22382,422
2020-09-27,San Benito,069,59416,1349,1331,0,1331,11
2020-09-27,San Bernardino,071,2135413,55000,53127,348,53475,988
2020-09-27,San Diego,073,3302833,48280,46612,987,47599,776
2020-09-27,San Francisco,075,870044,11372,11114,30,11144,100
2020-09-27,San Joaquin,077,732212,20358,19981,59,20040,448
2020-09-27,San Luis Obispo,079,281455,3789,3562,21,3583,31
2020-09-27,San Mateo,081,765935,10265,9566,9,9575,127
2020-09-27,Santa Barbara,083,443738,9252,9090,79,9169,114
2020-09-27,Santa Clara,085,1922200,22310,21091,47,21138,271
2020-09-27,Santa Cruz,087,273765,2474,2359,32,2391,9
2020-09-27,Shasta,089,179085,1189,883,9,892,17
2020-09-27,Sierra,091,2930,6,6,0,6,0
2020-09-27,Siskiyou,093,43540,156,149,10,159,0
2020-09-27,Solano,095,438530,6391,6211,41,6252,51
2020-09-27,Sonoma,097,501317,7768,7336,22,7358,124
2020-09-27,Stanislaus,099,539301,16616,16448,533,16981,336
2020-09-27,Sutter,101,95872,1694,1672,1,1673,10
2020-09-27,Tehama,103,63373,603,573,2,575,2
2020-09-27,Trinity,105,12862,56,16,8,24,0
2020-09-27,Tulare,107,460477,16502,15918,136,16054,270
2020-09-27,Tuolumne,109,53932,232,224,4,228,2
2020-09-27,Ventura,111,848112,13482,12775,172,12947,139
2020-09-27,Yolo,113,214977,2840,2796,6,2802,55
2020-09-27,Yuba,115,75493,1098,1059,5,1064,7
2020-09-26,Alameda,001,1643700,21579,21019,180,21199,370
2020-09-26,Alpine,003,1148,3,2,0,2,0
2020-09-26,Amador,005,37829,295,291,0,291,16
2020-09-26,Butte,007,227075,2938,2827,27,2854,44
2020-09-26,Calaveras,009,45235,311,257,0,257,11
2020-09-26,Colusa,011,21464,532,529,0,529,6
2020-09-26,Contra Costa,013,1133247,17241,16508,81,16589,194
2020-09-26,Del Norte,015,27424,142,138,0,138,2
2020-09-26,El Dorado,017,186661,1212,1127,1,1128,4
2020-09-26,Fresno,019,978130,30831,28336,389,28725,389
2020-09-26,Glenn,021,27897,596,576,0,576,3
2020-09-26,Humboldt,023,135768,507,491,1,492,6
2020-09-26,Imperial,025,180216,11872,10721,10,10731,283
2020-09-26,Inyo,027,18085,191,187,4,191,14
2020-09-26,Kern,029,883053,32077,31410,325,31735,394
2020-09-26,Kings,031,150075,7858,7537,43,7580,78
2020-09-26,Lake,033,64148,586,549,0,549,10
2020-09-26,Lassen,035,31185,749,737,2,739,0
2020-09-26,Los Angeles,037,10098052,269230,266931,1900,268831,6497
2020-09-26,Madera,039,155013,4593,4410,31,4441,47
2020-09-26,Marin,041,260295,6752,6641,17,6658,91
2020-09-26,Mariposa,043,17540,76,74,0,74,2
2020-09-26,Mendocino,045,87422,899,836,4,840,17
2020-09-26,Merced,047,269075,8942,8841,22,8863,136
2020-09-26,Modoc,049,8938,29,26,0,26,0
2020-09-26,Mono,051,14174,169,148,2,150,1
2020-09-26,Monterey,053,433212,10019,9651,32,9683,68
2020-09-26,Napa,055,140530,1753,1681,8,1689,11
2020-09-26,Nevada,057,99092,543,534,16,550,6
2020-09-26,Orange,059,3164182,55167,52203,1483,53686,1194
2020-09-26,Placer,061,380077,3658,3551,14,3565,42
2020-09-26,Plumas,063,18699,49,48,0,48,0
2020-09-26,Riverside,065,2383286,59720,58076,179,58255,1190
2020-09-26,Sacramento,067,1510023,22777,22269,26,22295,421
2020-09-26,San Benito,069,59416,1347,1325,0,1325,11
2020-09-26,San Bernardino,071,2135413,54867,53122,348,53470,988
2020-09-26,San Diego,073,3302833,48075,46333,973,47306,775
2020-09-26,San Francisco,075,870044,11344,11113,30,11143,100
2020-09-26,San Joaquin,077,732212,20323,19982,57,20039,449
2020-09-26,San Luis Obispo,079,281455,3773,3546,21,3567,31
2020-09-26,San Mateo,081,765935,10231,9509,9,9518,127
2020-09-26,Santa Barbara,083,443738,9241,9061,79,9140,114
2020-09-26,Santa Clara,085,1922200,22239,20967,46,21013,270
2020-09-26,Santa Cruz,087,273765,2466,2336,32,2368,9
2020-09-26,Shasta,089,179085,1139,856,8,864,17
2020-09-26,Sierra,091,2930,6,6,0,6,0
2020-09-26,Siskiyou,093,43540,155,149,10,159,0
2020-09-26,Solano,095,438530,6372,6209,41,6250,51
2020-09-26,Sonoma,097,501317,7743,7285,21,7306,124
2020-09-26,Stanislaus,099,539301,16591,16421,524,16945,336
2020-09-26,Sutter,101,95872,1689,1662,1,1663,10
2020-09-26,Tehama,103,63373,591,560,2,562,2
2020-09-26,Trinity,105,12862,54,16,8,24,0
2020-09-26,Tulare,107,460477,16476,15881,134,16015,270
2020-09-26,Tuolumne,109,53932,232,223,4,227,2
2020-09-26,Ventura,111,848112,13447,12729,171,12900,137
2020-09-26,Yolo,113,214977,2838,2789,6,2795,55
2020-09-26,Yuba,115,75493,1094,1056,5,1061,7
2020-09-25,Alameda,001,1643700,21525,20911,180,21091,367
2020-09-25,Alpine,003,1148,3,2,0,2,0
2020-09-25,Amador,005,37829,295,289,0,289,16
2020-09-25,Butte,007,227075,2933,2819,27,2846,43
2020-09-25,Calaveras,009,45235,311,257,0,257,11
2020-09-25,Colusa,011,21464,532,528,0,528,6
2020-09-25,Contra Costa,013,1133247,17182,16401,81,16482,194
2020-09-25,Del Norte,015,27424,142,138,0,138,2
2020-09-25,El Dorado,017,186661,1208,1104,1,1105,4
2020-09-25,Fresno,019,978130,30771,28199,388,28587,385
2020-09-25,Glenn,021,27897,594,570,0,570,3
2020-09-25,Humboldt,023,135768,506,489,1,490,5
2020-09-25,Imperial,025,180216,11854,10681,10,10691,283
2020-09-25,Inyo,027,18085,189,187,4,191,14
2020-09-25,Kern,029,883053,32024,31333,323,31656,393
2020-09-25,Kings,031,150075,7853,7450,43,7493,77
2020-09-25,Lake,033,64148,585,539,0,539,9
2020-09-25,Lassen,035,31185,749,737,2,739,0
2020-09-25,Los Angeles,037,10098052,268441,265713,1886,267599,6483
2020-09-25,Madera,039,155013,4574,4369,31,4400,48
2020-09-25,Marin,041,260295,6749,6622,17,6639,90
2020-09-25,Mariposa,043,17540,76,74,0,74,2
2020-09-25,Mendocino,045,87422,884,819,3,822,17
2020-09-25,Merced,047,269075,8926,8830,22,8852,135
2020-09-25,Modoc,049,8938,29,26,0,26,0
2020-09-25,Mono,051,14174,169,149,2,151,1
2020-09-25,Monterey,053,433212,9967,9581,32,9613,68
2020-09-25,Napa,055,140530,1751,1669,8,1677,11
2020-09-25,Nevada,057,99092,541,529,16,545,6
2020-09-25,Orange,059,3164182,55040,52031,1475,53506,1184
2020-09-25,Placer,061,380077,3647,3527,14,3541,41
2020-09-25,Plumas,063,18699,49,48,0,48,0
2020-09-25,Riverside,065,2383286,59544,57783,174,57957,1183
2020-09-25,Sacramento,067,1510023,22700,22132,26,22158,418
2020-09-25,San Benito,069,59416,1346,1318,0,1318,11
2020-09-25,San Bernardino,071,2135413,54713,52814,348,53162,987
2020-09-25,San Diego,073,3302833,47873,46003,957,46960,775
2020-09-25,San Francisco,075,870044,11310,11066,29,11095,100
2020-09-25,San Joaquin,077,732212,20271,19909,57,19966,449
2020-09-25,San Luis Obispo,079,281455,3761,3512,21,3533,31
2020-09-25,San Mateo,081,765935,10195,9447,9,9456,127
2020-09-25,Santa Barbara,083,443738,9217,9026,79,9105,114
2020-09-25,Santa Clara,085,1922200,22175,20812,45,20857,265
2020-09-25,Santa Cruz,087,273765,2454,2309,31,2340,9
2020-09-25,Shasta,089,179085,1105,806,8,814,16
2020-09-25,Sierra,091,2930,6,6,0,6,0
2020-09-25,Siskiyou,093,43540,155,149,10,159,0
2020-09-25,Solano,095,438530,6356,6179,41,6220,50
2020-09-25,Sonoma,097,501317,7703,7202,21,7223,124
2020-09-25,Stanislaus,099,539301,16573,16381,522,16903,326
2020-09-25,Sutter,101,95872,1686,1655,1,1656,10
2020-09-25,Tehama,103,63373,583,546,2,548,2
2020-09-25,Trinity,105,12862,54,15,8,23,0
2020-09-25,Tulare,107,460477,16436,15815,132,15947,267
2020-09-25,Tuolumne,109,53932,232,223,4,227,2
2020-09-25,Ventura,111,848112,13404,12664,168,12832,137
2020-09-25,Yolo,113,214977,2830,2784,6,2790,55
2020-09-25,Yuba,115,75493,1089,1049,5,1054,5
2020-09-24,Alameda,001,1643700,21450,20838,177,21015,364
2020-09-24,Alpine,003,1148,3,2,0,2,0
2020-09-24,Amador,005,37829,295,288,0,288,16
2020-09-24,Butte,007,227075,2922,2803,27,2830,43
2020-09-24,Calaveras,009,45235,311,258,0,258,11
2020-09-24,Colusa,011,21464,532,523,0,523,6
2020-09-24,Contra Costa,013,1133247,17100,16252,81,16333,192
2020-09-24,Del Norte,015,27424,138,137,0,137,2
2020-09-24,El Dorado,017,186661,1199,1093,1,1094,4
2020-09-24,Fresno,019,978130,30665,28106,384,28490,375
2020-09-24,Glenn,021,27897,590,567,0,567,3
2020-09-24,Humboldt,023,135768,503,482,1,483,5
2020-09-24,Imperial,025,180216,11830,10622,10,10632,283
2020-09-24,Inyo,027,18085,189,187,4,191,13
2020-09-24,Kern,029,883053,31961,31273,321,31594,388
2020-09-24,Kings,031,150075,7837,7428,43,7471,76
2020-09-24,Lake,033,64148,576,531,0,531,9
2020-09-24,Lassen,035,31185,748,737,2,739,0
2020-09-24,Los Angeles,037,10098052,267399,264374,1868,266242,6452
2020-09-24,Madera,039,155013,4555,4344,31,4375,48
2020-09-24,Marin,041,260295,6721,6588,17,6605,85
2020-09-24,Mariposa,043,17540,76,74,0,74,2
2020-09-24,Mendocino,045,87422,880,810,3,813,17
2020-09-24,Merced,047,269075,8897,8813,21,8834,135
2020-09-24,Modoc,049,8938,29,24,0,24,0
2020-09-24,Mono,051,14174,169,149,2,151,1
2020-09-24,Monterey,053,433212,9901,9544,30,9574,67
2020-09-24,Napa,055,140530,1739,1661,8,1669,11
2020-09-24,Nevada,057,99092,540,527,16,543,6
2020-09-24,Orange,059,3164182,54832,51749,1457,53206,1164
2020-09-24,Placer,061,380077,3632,3514,14,3528,41
2020-09-24,Plumas,063,18699,49,48,0,48,0
2020-09-24,Riverside,065,2383286,59278,57491,168,57659,1172
2020-09-24,Sacramento,067,1510023,22574,21985,25,22010,417
2020-09-24,San Benito,069,59416,1344,1308,0,1308,11
2020-09-24,San Bernardino,071,2135413,54377,52455,347,52802,988
2020-09-24,San Diego,073,3302833,47604,45598,942,46540,773
2020-09-24,San Francisco,075,870044,11263,10992,29,11021,99
2020-09-24,San Joaquin,077,732212,20233,19851,55,19906,444
2020-09-24,San Luis Obispo,079,281455,3745,3480,21,3501,31
2020-09-24,San Mateo,081,765935,10147,9376,9,9385,127
2020-09-24,Santa Barbara,083,443738,9164,8988,77,9065,114
2020-09-24,Santa Clara,085,1922200,22087,20689,45,20734,262
2020-09-24,Santa Cruz,087,273765,2434,2300,29,2329,9
2020-09-24,Shasta,089,179085,1068,773,5,778,14
2020-09-24,Sierra,091,2930,6,6,0,6,0
2020-09-24,Siskiyou,093,43540,155,149,10,159,0
2020-09-24,Solano,095,438530,6323,6137,41,6178,49
2020-09-24,Sonoma,097,501317,7622,7163,21,7184,122
2020-09-24,Stanislaus,099,539301,16536,16326,517,16843,326
2020-09-24,Sutter,101,95872,1683,1646,1,1647,10
2020-09-24,Tehama,103,63373,580,540,2,542,2
2020-09-24,Trinity,105,12862,54,15,8,23,0
2020-09-24,Tulare,107,460477,16371,15754,131,15885,267
2020-09-24,Tuolumne,109,53932,232,224,4,228,2
2020-09-24,Ventura,111,848112,13322,12617,167,12784,138
2020-09-24,Yolo,113,214977,2823,2776,6,2782,55
2020-09-24,Yuba,115,75493,1084,1042,5,1047,5
2020-09-23,Alameda,001,1643700,21382,20718,175,20893,361
2020-09-23,Alpine,003,1148,3,2,0,2,0
2020-09-23,Amador,005,37829,294,288,0,288,16
2020-09-23,Butte,007,227075,2914,2790,27,2817,43
2020-09-23,Calaveras,009,45235,310,258,0,258,11
2020-09-23,Colusa,011,21464,531,521,0,521,6
2020-09-23,Contra Costa,013,1133247,17037,16167,80,16247,192
2020-09-23,Del Norte,015,27424,136,137,0,137,2
2020-09-23,El Dorado,017,186661,1185,1088,1,1089,4
2020-09-23,Fresno,019,978130,30570,28019,382,28401,371
2020-09-23,Glenn,021,27897,583,561,0,561,3
2020-09-23,Humboldt,023,135768,499,477,1,478,5
2020-09-23,Imperial,025,180216,11804,10587,10,10597,284
2020-09-23,Inyo,027,18085,188,177,4,181,13
2020-09-23,Kern,029,883053,31917,31172,319,31491,387
2020-09-23,Kings,031,150075,7815,7406,43,7449,76
2020-09-23,Lake,033,64148,571,519,0,519,9
2020-09-23,Lassen,035,31185,748,736,2,738,0
2020-09-23,Los Angeles,037,10098052,266383,263318,1839,265157,6421
2020-09-23,Madera,039,155013,4540,4311,31,4342,48
2020-09-23,Marin,041,260295,6702,6567,17,6584,85
2020-09-23,Mariposa,043,17540,76,74,0,74,2
2020-09-23,Mendocino,045,87422,879,801,2,803,17
2020-09-23,Merced,047,269075,8876,8785,19,8804,134
2020-09-23,Modoc,049,8938,29,24,0,24,0
2020-09-23,Mono,051,14174,169,149,2,151,1
2020-09-23,Monterey,053,433212,9832,9452,29,9481,67
2020-09-23,Napa,055,140530,1730,1653,8,1661,11
2020-09-23,Nevada,057,99092,539,523,16,539,6
2020-09-23,Orange,059,3164182,54605,51658,1449,53107,1155
2020-09-23,Placer,061,380077,3620,3506,14,3520,41
2020-09-23,Plumas,063,18699,49,48,0,48,0
2020-09-23,Riverside,065,2383286,58972,57257,165,57422,1165
2020-09-23,Sacramento,067,1510023,22497,21821,25,21846,415
2020-09-23,San Benito,069,59416,1338,1305,0,1305,10
2020-09-23,San Bernardino,071,2135413,54083,52132,345,52477,973
2020-09-23,San Diego,073,3302833,47328,45427,923,46350,767
2020-09-23,San Francisco,075,870044,11214,10926,29,10955,95
2020-09-23,San Joaquin,077,732212,20180,19785,55,19840,439
2020-09-23,San Luis Obispo,079,281455,3727,3447,21,3468,31
2020-09-23,San Mateo,081,765935,10107,9351,9,9360,127
2020-09-23,Santa Barbara,083,443738,9135,8952,77,9029,112
2020-09-23,Santa Clara,085,1922200,21976,20575,42,20617,260
2020-09-23,Santa Cruz,087,273765,2415,2283,29,2312,9
2020-09-23,Shasta,089,179085,1029,756,4,760,14
2020-09-23,Sierra,091,2930,6,6,0,6,0
2020-09-23,Siskiyou,093,43540,155,149,10,159,0
2020-09-23,Solano,095,438530,6298,6123,41,6164,50
2020-09-23,Sonoma,097,501317,7546,7091,21,7112,122
2020-09-23,Stanislaus,099,539301,16506,16271,514,16785,317
2020-09-23,Sutter,101,95872,1679,1646,1,1647,10
2020-09-23,Tehama,103,63373,574,533,2,535,2
2020-09-23,Trinity,105,12862,53,15,8,23,0
2020-09-23,Tulare,107,460477,16306,15664,130,15794,266
2020-09-23,Tuolumne,109,53932,232,223,4,227,2
2020-09-23,Ventura,111,848112,13266,12591,164,12755,137
2020-09-23,Yolo,113,214977,2805,2766,6,2772,55
2020-09-23,Yuba,115,75493,1082,1038,5,1043,5
2020-09-22,Alameda,001,1643700,21302,20607,173,20780,355
2020-09-22,Alpine,003,1148,2,2,0,2,0
2020-09-22,Amador,005,37829,293,287,0,287,16
2020-09-22,Butte,007,227075,2909,2776,27,2803,43
2020-09-22,Calaveras,009,45235,310,258,0,258,11
2020-09-22,Colusa,011,21464,529,518,0,518,6
2020-09-22,Contra Costa,013,1133247,16947,16090,80,16170,190
2020-09-22,Del Norte,015,27424,136,137,0,137,2
2020-09-22,El Dorado,017,186661,1166,1076,1,1077,4
2020-09-22,Fresno,019,978130,30475,27944,379,28323,369
2020-09-22,Glenn,021,27897,580,560,0,560,3
2020-09-22,Humboldt,023,135768,498,476,1,477,5
2020-09-22,Imperial,025,180216,11775,10529,10,10539,284
2020-09-22,Inyo,027,18085,188,177,4,181,13
2020-09-22,Kern,029,883053,31849,31110,312,31422,383
2020-09-22,Kings,031,150075,7758,7395,42,7437,76
2020-09-22,Lake,033,64148,563,516,0,516,9
2020-09-22,Lassen,035,31185,747,736,2,738,0
2020-09-22,Los Angeles,037,10098052,265318,262117,1813,263930,6394
2020-09-22,Madera,039,155013,4524,4303,31,4334,47
2020-09-22,Marin,041,260295,6688,6561,17,6578,84
2020-09-22,Mariposa,043,17540,76,74,0,74,2
2020-09-22,Mendocino,045,87422,859,794,1,795,18
2020-09-22,Merced,047,269075,8846,8769,19,8788,132
2020-09-22,Modoc,049,8938,29,24,0,24,0
2020-09-22,Mono,051,14174,168,149,2,151,1
2020-09-22,Monterey,053,433212,9774,9393,29,9422,67
2020-09-22,Napa,055,140530,1713,1652,8,1660,11
2020-09-22,Nevada,057,99092,539,523,16,539,6
2020-09-22,Orange,059,3164182,54355,51528,1440,52968,1132
2020-09-22,Placer,061,380077,3608,3492,14,3506,40
2020-09-22,Plumas,063,18699,49,48,0,48,0
2020-09-22,Riverside,065,2383286,58488,57066,161,57227,1162
2020-09-22,Sacramento,067,1510023,22377,21745,25,21770,410
2020-09-22,San Benito,069,59416,1333,1305,0,1305,10
2020-09-22,San Bernardino,071,2135413,53809,51899,345,52244,971
2020-09-22,San Diego,073,3302833,47021,45149,904,46053,765
2020-09-22,San Francisco,075,870044,11170,10893,28,10921,95
2020-09-22,San Joaquin,077,732212,20133,19755,54,19809,426
2020-09-22,San Luis Obispo,079,281455,3705,3420,21,3441,31
2020-09-22,San Mateo,081,765935,10069,9291,9,9300,127
2020-09-22,Santa Barbara,083,443738,9105,8927,76,9003,111
2020-09-22,Santa Clara,085,1922200,21857,20514,42,20556,253
2020-09-22,Santa Cruz,087,273765,2392,2264,29,2293,8
2020-09-22,Shasta,089,179085,994,723,4,727,14
2020-09-22,Sierra,091,2930,6,6,0,6,0
2020-09-22,Siskiyou,093,43540,155,149,10,159,0
2020-09-22,Solano,095,438530,6267,6107,41,6148,48
2020-09-22,Sonoma,097,501317,7467,7068,20,7088,117
2020-09-22,Stanislaus,099,539301,16483,16231,507,16738,316
2020-09-22,Sutter,101,95872,1673,1638,1,1639,10
2020-09-22,Tehama,103,63373,566,529,2,531,2
2020-09-22,Trinity,105,12862,53,15,8,23,0
2020-09-22,Tulare,107,460477,16239,15616,126,15742,263
2020-09-22,Tuolumne,109,53932,231,224,4,228,1
2020-09-22,Ventura,111,848112,13214,12507,160,12667,136
2020-09-22,Yolo,113,214977,2798,2763,6,2769,54
2020-09-22,Yuba,115,75493,1073,1035,5,1040,5
2020-09-21,Alameda,001,1643700,21223,20501,172,20673,343
2020-09-21,Alpine,003,1148,2,2,0,2,0
2020-09-21,Amador,005,37829,291,286,0,286,16
2020-09-21,Butte,007,227075,2895,2769,27,2796,41
2020-09-21,Calaveras,009,45235,308,256,0,256,10
2020-09-21,Colusa,011,21464,528,517,0,517,6
2020-09-21,Contra Costa,013,1133247,16860,16008,80,16088,189
2020-09-21,Del Norte,015,27424,136,132,0,132,2
2020-09-21,El Dorado,017,186661,1157,1074,1,1075,4
2020-09-21,Fresno,019,978130,30373,27843,372,28215,362
2020-09-21,Glenn,021,27897,576,556,0,556,3
2020-09-21,Humboldt,023,135768,494,473,1,474,5
2020-09-21,Imperial,025,180216,11744,10521,10,10531,284
2020-09-21,Inyo,027,18085,187,177,4,181,12
2020-09-21,Kern,029,883053,31777,31031,310,31341,379
2020-09-21,Kings,031,150075,7645,7297,41,7338,76
2020-09-21,Lake,033,64148,558,508,0,508,8
2020-09-21,Lassen,035,31185,745,735,2,737,0
2020-09-21,Los Angeles,037,10098052,264231,261418,1768,263186,6360
2020-09-21,Madera,039,155013,4513,4275,30,4305,47
2020-09-21,Marin,041,260295,6677,6538,16,6554,84
2020-09-21,Mariposa,043,17540,75,74,0,74,2
2020-09-21,Mendocino,045,87422,844,778,0,778,18
2020-09-21,Merced,047,269075,8827,8749,17,8766,128
2020-09-21,Modoc,049,8938,29,22,0,22,0
2020-09-21,Mono,051,14174,168,147,2,149,1
2020-09-21,Monterey,053,433212,9710,9331,26,9357,66
2020-09-21,Napa,055,140530,1702,1641,8,1649,11
2020-09-21,Nevada,057,99092,537,515,16,531,6
2020-09-21,Orange,059,3164182,54133,51363,1433,52796,1110
2020-09-21,Placer,061,380077,3598,3473,14,3487,40
2020-09-21,Plumas,063,18699,49,47,0,47,0
2020-09-21,Riverside,065,2383286,58216,57001,154,57155,1153
2020-09-21,Sacramento,067,1510023,22196,21568,25,21593,404
2020-09-21,San Benito,069,59416,1331,1298,0,1298,10
2020-09-21,San Bernardino,071,2135413,53523,51654,345,51999,970
2020-09-21,San Diego,073,3302833,46737,44927,883,45810,760
2020-09-21,San Francisco,075,870044,11122,10743,28,10771,95
2020-09-21,San Joaquin,077,732212,20075,19579,54,19633,423
2020-09-21,San Luis Obispo,079,281455,3679,3406,21,3427,27
2020-09-21,San Mateo,081,765935,10017,9239,9,9248,127
2020-09-21,Santa Barbara,083,443738,9077,8911,76,8987,110
2020-09-21,Santa Clara,085,1922200,21756,20432,42,20474,252
2020-09-21,Santa Cruz,087,273765,2375,2257,27,2284,8
2020-09-21,Shasta,089,179085,944,696,4,700,14
2020-09-21,Sierra,091,2930,6,6,0,6,0
2020-09-21,Siskiyou,093,43540,155,146,10,156,0
2020-09-21,Solano,095,438530,6243,6019,41,6060,46
2020-09-21,Sonoma,097,501317,7391,7017,20,7037,117
2020-09-21,Stanislaus,099,539301,16453,16186,507,16693,310
2020-09-21,Sutter,101,95872,1666,1634,1,1635,10
2020-09-21,Tehama,103,63373,547,513,2,515,2
2020-09-21,Trinity,105,12862,53,15,8,23,0
2020-09-21,Tulare,107,460477,16165,15528,117,15645,260
2020-09-21,Tuolumne,109,53932,231,221,4,225,1
2020-09-21,Ventura,111,848112,13130,12477,154,12631,133
2020-09-21,Yolo,113,214977,2792,2752,6,2758,54
2020-09-21,Yuba,115,75493,1069,1033,5,1038,1
2020-09-20,Alameda,001,1643700,21123,20425,169,20594,343
2020-09-20,Alpine,003,1148,2,2,0,2,0
2020-09-20,Amador,005,37829,290,286,0,286,16
2020-09-20,Butte,007,227075,2883,2764,27,2791,39
2020-09-20,Calaveras,009,45235,304,256,0,256,10
2020-09-20,Colusa,011,21464,526,510,0,510,6
2020-09-20,Contra Costa,013,1133247,16726,15917,79,15996,189
2020-09-20,Del Norte,015,27424,134,132,0,132,2
2020-09-20,El Dorado,017,186661,1142,1073,1,1074,4
2020-09-20,Fresno,019,978130,30259,27769,367,28136,362
2020-09-20,Glenn,021,27897,572,550,0,550,3
2020-09-20,Humboldt,023,135768,494,472,1,473,5
2020-09-20,Imperial,025,180216,11717,10496,9,10505,284
2020-09-20,Inyo,027,18085,187,177,4,181,12
2020-09-20,Kern,029,883053,31694,30992,307,31299,379
2020-09-20,Kings,031,150075,7598,7159,40,7199,76
2020-09-20,Lake,033,64148,546,492,0,492,8
2020-09-20,Lassen,035,31185,745,735,2,737,0
2020-09-20,Los Angeles,037,10098052,263001,260770,1743,262513,6347
2020-09-20,Madera,039,155013,4493,4257,30,4287,47
2020-09-20,Marin,041,260295,6651,6533,16,6549,83
2020-09-20,Mariposa,043,17540,75,74,0,74,2
2020-09-20,Mendocino,045,87422,832,765,0,765,18
2020-09-20,Merced,047,269075,8800,8745,17,8762,128
2020-09-20,Modoc,049,8938,27,22,0,22,0
2020-09-20,Mono,051,14174,167,147,2,149,1
2020-09-20,Monterey,053,433212,9632,9312,26,9338,65
2020-09-20,Napa,055,140530,1693,1626,8,1634,11
2020-09-20,Nevada,057,99092,534,511,16,527,6
2020-09-20,Orange,059,3164182,53892,51233,1423,52656,1110
2020-09-20,Placer,061,380077,3583,3452,14,3466,40
2020-09-20,Plumas,063,18699,49,47,0,47,0
2020-09-20,Riverside,065,2383286,58015,56783,148,56931,1147
2020-09-20,Sacramento,067,1510023,22009,21394,24,21418,401
2020-09-20,San Benito,069,59416,1320,1291,0,1291,9
2020-09-20,San Bernardino,071,2135413,53203,51559,343,51902,970
2020-09-20,San Diego,073,3302833,46364,44579,854,45433,760
2020-09-20,San Francisco,075,870044,11068,10743,28,10771,95
2020-09-20,San Joaquin,077,732212,20010,19578,47,19625,423
2020-09-20,San Luis Obispo,079,281455,3651,3393,21,3414,27
2020-09-20,San Mateo,081,765935,9950,9198,9,9207,127
2020-09-20,Santa Barbara,083,443738,9041,8880,75,8955,110
2020-09-20,Santa Clara,085,1922200,21635,20330,41,20371,252
2020-09-20,Santa Cruz,087,273765,2355,2199,27,2226,8
2020-09-20,Shasta,089,179085,903,696,3,699,14
2020-09-20,Sierra,091,2930,6,6,0,6,0
2020-09-20,Siskiyou,093,43540,155,146,10,156,0
2020-09-20,Solano,095,438530,6199,6020,41,6061,46
2020-09-20,Sonoma,097,501317,7287,6954,20,6974,117
2020-09-20,Stanislaus,099,539301,16422,16159,500,16659,310
2020-09-20,Sutter,101,95872,1660,1624,1,1625,10
2020-09-20,Tehama,103,63373,534,509,2,511,2
2020-09-20,Trinity,105,12862,53,15,8,23,0
2020-09-20,Tulare,107,460477,16079,15528,111,15639,260
2020-09-20,Tuolumne,109,53932,231,221,4,225,1
2020-09-20,Ventura,111,848112,13064,12406,150,12556,133
2020-09-20,Yolo,113,214977,2784,2745,6,2751,54
2020-09-20,Yuba,115,75493,1062,1029,5,1034,1
2020-09-19,Alameda,001,1643700,21072,20349,166,20515,343
2020-09-19,Alpine,003,1148,2,2,0,2,0
2020-09-19,Amador,005,37829,290,285,0,285,16
2020-09-19,Butte,007,227075,2877,2748,27,2775,38
2020-09-19,Calaveras,009,45235,304,256,0,256,10
2020-09-19,Colusa,011,21464,526,507,0,507,6
2020-09-19,Contra Costa,013,1133247,16663,15783,79,15862,186
2020-09-19,Del Norte,015,27424,133,132,0,132,2
2020-09-19,El Dorado,017,186661,1136,1068,0,1068,4
2020-09-19,Fresno,019,978130,30186,27668,367,28035,362
2020-09-19,Glenn,021,27897,569,547,0,547,3
2020-09-19,Humboldt,023,135768,493,471,1,472,5
2020-09-19,Imperial,025,180216,11702,10496,9,10505,284
2020-09-19,Inyo,027,18085,187,177,4,181,12
2020-09-19,Kern,029,883053,31640,30886,304,31190,379
2020-09-19,Kings,031,150075,7592,7130,40,7170,76
2020-09-19,Lake,033,64148,546,465,0,465,8
2020-09-19,Lassen,035,31185,745,731,2,733,0
2020-09-19,Los Angeles,037,10098052,262375,259801,1729,261530,6325
2020-09-19,Madera,039,155013,4470,4237,30,4267,47
2020-09-19,Marin,041,260295,6644,6513,15,6528,81
2020-09-19,Mariposa,043,17540,75,74,0,74,2
2020-09-19,Mendocino,045,87422,829,750,0,750,18
2020-09-19,Merced,047,269075,8789,8717,16,8733,128
2020-09-19,Modoc,049,8938,27,22,0,22,0
2020-09-19,Mono,051,14174,167,147,2,149,1
2020-09-19,Monterey,053,433212,9590,9237,26,9263,65
2020-09-19,Napa,055,140530,1685,1614,8,1622,11
2020-09-19,Nevada,057,99092,532,505,16,521,6
2020-09-19,Orange,059,3164182,53763,50999,1416,52415,1105
2020-09-19,Placer,061,380077,3574,3412,14,3426,40
2020-09-19,Plumas,063,18699,49,47,0,47,0
2020-09-19,Riverside,065,2383286,57888,56562,147,56709,1147
2020-09-19,Sacramento,067,1510023,21955,21297,24,21321,396
2020-09-19,San Benito,069,59416,1316,1276,0,1276,9
2020-09-19,San Bernardino,071,2135413,53047,51353,340,51693,971
2020-09-19,San Diego,073,3302833,46136,44295,831,45126,773
2020-09-19,San Francisco,075,870044,11035,10741,28,10769,95
2020-09-19,San Joaquin,077,732212,19973,19580,47,19627,424
2020-09-19,San Luis Obispo,079,281455,3630,3369,21,3390,27
2020-09-19,San Mateo,081,765935,9919,9158,9,9167,127
2020-09-19,Santa Barbara,083,443738,9021,8862,75,8937,106
2020-09-19,Santa Clara,085,1922200,21546,20170,41,20211,251
2020-09-19,Santa Cruz,087,273765,2341,2198,26,2224,8
2020-09-19,Shasta,089,179085,876,687,3,690,14
2020-09-19,Sierra,091,2930,6,6,0,6,0
2020-09-19,Siskiyou,093,43540,155,146,10,156,0
2020-09-19,Solano,095,438530,6183,5998,41,6039,46
2020-09-19,Sonoma,097,501317,7254,6905,20,6925,117
2020-09-19,Stanislaus,099,539301,16382,16109,493,16602,313
2020-09-19,Sutter,101,95872,1659,1602,1,1603,10
2020-09-19,Tehama,103,63373,529,498,2,500,2
2020-09-19,Trinity,105,12862,53,15,8,23,0
2020-09-19,Tulare,107,460477,16030,15485,108,15593,260
2020-09-19,Tuolumne,109,53932,231,217,4,221,1
2020-09-19,Ventura,111,848112,13032,12328,150,12478,133
2020-09-19,Yolo,113,214977,2776,2739,6,2745,54
2020-09-19,Yuba,115,75493,1055,1023,5,1028,1
2020-09-18,Alameda,001,1643700,21007,20222,160,20382,341
2020-09-18,Alpine,003,1148,2,2,0,2,0
2020-09-18,Amador,005,37829,290,285,0,285,16
2020-09-18,Butte,007,227075,2875,2738,27,2765,37
2020-09-18,Calaveras,009,45235,304,255,0,255,9
2020-09-18,Colusa,011,21464,526,504,0,504,6
2020-09-18,Contra Costa,013,1133247,16578,15667,79,15746,185
2020-09-18,Del Norte,015,27424,133,131,0,131,2
2020-09-18,El Dorado,017,186661,1123,1063,0,1063,4
2020-09-18,Fresno,019,978130,30121,27560,367,27927,359
2020-09-18,Glenn,021,27897,566,541,0,541,3
2020-09-18,Humboldt,023,135768,490,470,1,471,5
2020-09-18,Imperial,025,180216,11687,10460,9,10469,283
2020-09-18,Inyo,027,18085,187,177,4,181,12
2020-09-18,Kern,029,883053,31582,30742,301,31043,373
2020-09-18,Kings,031,150075,7582,7062,40,7102,74
2020-09-18,Lake,033,64148,540,458,0,458,8
2020-09-18,Lassen,035,31185,744,731,2,733,0
2020-09-18,Los Angeles,037,10098052,261614,258488,1711,260199,6324
2020-09-18,Madera,039,155013,4458,4211,30,4241,45
2020-09-18,Marin,041,260295,6629,6475,15,6490,81
2020-09-18,Mariposa,043,17540,75,74,0,74,2
2020-09-18,Mendocino,045,87422,821,739,0,739,18
2020-09-18,Merced,047,269075,8777,8691,15,8706,127
2020-09-18,Modoc,049,8938,27,22,0,22,0
2020-09-18,Mono,051,14174,165,147,2,149,1
2020-09-18,Monterey,053,433212,9548,9183,26,9209,64
2020-09-18,Napa,055,140530,1679,1604,8,1612,11
2020-09-18,Nevada,057,99092,529,504,16,520,6
2020-09-18,Orange,059,3164182,53616,50733,1404,52137,1107
2020-09-18,Placer,061,380077,3563,3389,14,3403,40
2020-09-18,Plumas,063,18699,49,45,0,45,0
2020-09-18,Riverside,065,2383286,57766,56248,143,56391,1143
2020-09-18,Sacramento,067,1510023,21872,21105,24,21129,391
2020-09-18,San Benito,069,59416,1308,1257,0,1257,8
2020-09-18,San Bernardino,071,2135413,52902,51106,337,51443,970
2020-09-18,San Diego,073,3302833,45886,44009,826,44835,757
2020-09-18,San Francisco,075,870044,10997,10644,27,10671,95
2020-09-18,San Joaquin,077,732212,19929,19531,46,19577,423
2020-09-18,San Luis Obispo,079,281455,3606,3328,21,3349,27
2020-09-18,San Mateo,081,765935,9879,9062,9,9071,127
2020-09-18,Santa Barbara,083,443738,9000,8824,75,8899,107
2020-09-18,Santa Clara,085,1922200,21448,20058,41,20099,252
2020-09-18,Santa Cruz,087,273765,2320,2180,25,2205,8
2020-09-18,Shasta,089,179085,841,668,3,671,14
2020-09-18,Sierra,091,2930,6,6,0,6,0
2020-09-18,Siskiyou,093,43540,154,146,10,156,0
2020-09-18,Solano,095,438530,6167,5961,41,6002,46
2020-09-18,Sonoma,097,501317,7206,6856,20,6876,114
2020-09-18,Stanislaus,099,539301,16354,16042,487,16529,277
2020-09-18,Sutter,101,95872,1652,1586,1,1587,10
2020-09-18,Tehama,103,63373,529,490,2,492,2
2020-09-18,Trinity,105,12862,53,15,7,22,0
2020-09-18,Tulare,107,460477,15997,15435,104,15539,259
2020-09-18,Tuolumne,109,53932,230,216,4,220,1
2020-09-18,Ventura,111,848112,12971,12236,146,12382,133
2020-09-18,Yolo,113,214977,2770,2732,6,2738,54
2020-09-18,Yuba,115,75493,1051,1020,5,1025,1
2020-09-17,Alameda,001,1643700,20908,20146,160,20306,339
2020-09-17,Alpine,003,1148,2,2,0,2,0
2020-09-17,Amador,005,37829,288,284,0,284,16
2020-09-17,Butte,007,227075,2857,2720,27,2747,38
2020-09-17,Calaveras,009,45235,304,254,0,254,9
2020-09-17,Colusa,011,21464,524,499,0,499,6
2020-09-17,Contra Costa,013,1133247,16488,15576,79,15655,184
2020-09-17,Del Norte,015,27424,133,131,0,131,2
2020-09-17,El Dorado,017,186661,1114,1057,0,1057,4
2020-09-17,Fresno,019,978130,30011,27487,362,27849,355
2020-09-17,Glenn,021,27897,565,541,0,541,3
2020-09-17,Humboldt,023,135768,484,466,1,467,5
2020-09-17,Imperial,025,180216,11670,10436,9,10445,281
2020-09-17,Inyo,027,18085,187,176,4,180,12
2020-09-17,Kern,029,883053,31521,30627,294,30921,372
2020-09-17,Kings,031,150075,7511,7015,40,7055,72
2020-09-17,Lake,033,64148,530,433,0,433,8
2020-09-17,Lassen,035,31185,742,731,2,733,0
2020-09-17,Los Angeles,037,10098052,260672,257246,1696,258942,6318
2020-09-17,Madera,039,155013,4424,4152,30,4182,45
2020-09-17,Marin,041,260295,6608,6457,15,6472,81
2020-09-17,Mariposa,043,17540,75,74,0,74,2
2020-09-17,Mendocino,045,87422,810,737,0,737,18
2020-09-17,Merced,047,269075,8758,8671,15,8686,119
2020-09-17,Modoc,049,8938,27,22,0,22,0
2020-09-17,Mono,051,14174,165,147,2,149,1
2020-09-17,Monterey,053,433212,9486,9113,25,9138,62
2020-09-17,Napa,055,140530,1668,1592,8,1600,11
2020-09-17,Nevada,057,99092,527,494,16,510,6
2020-09-17,Orange,059,3164182,53435,50537,1392,51929,1098
2020-09-17,Placer,061,380077,3542,3368,14,3382,40
2020-09-17,Plumas,063,18699,49,45,0,45,0
2020-09-17,Riverside,065,2383286,57540,56007,142,56149,1134
2020-09-17,Sacramento,067,1510023,21637,20895,24,20919,385
2020-09-17,San Benito,069,59416,1305,1252,0,1252,8
2020-09-17,San Bernardino,071,2135413,52700,50770,337,51107,904
2020-09-17,San Diego,073,3302833,45606,43621,814,44435,754
2020-09-17,San Francisco,075,870044,10902,10564,27,10591,95
2020-09-17,San Joaquin,077,732212,19870,19439,46,19485,416
2020-09-17,San Luis Obispo,079,281455,3576,3299,21,3320,27
2020-09-17,San Mateo,081,765935,9837,8984,9,8993,127
2020-09-17,Santa Barbara,083,443738,8976,8779,75,8854,107
2020-09-17,Santa Clara,085,1922200,21331,19825,41,19866,254
2020-09-17,Santa Cruz,087,273765,2304,2155,25,2180,7
2020-09-17,Shasta,089,179085,802,660,3,663,12
2020-09-17,Sierra,091,2930,6,6,0,6,0
2020-09-17,Siskiyou,093,43540,154,146,10,156,0
2020-09-17,Solano,095,438530,6144,5915,41,5956,44
2020-09-17,Sonoma,097,501317,7142,6754,20,6774,114
2020-09-17,Stanislaus,099,539301,16321,15984,483,16467,277
2020-09-17,Sutter,101,95872,1647,1572,1,1573,10
2020-09-17,Tehama,103,63373,515,487,2,489,2
2020-09-17,Trinity,105,12862,53,15,7,22,0
2020-09-17,Tulare,107,460477,15944,15344,102,15446,258
2020-09-17,Tuolumne,109,53932,229,214,4,218,1
2020-09-17,Ventura,111,848112,12884,12167,142,12309,130
2020-09-17,Yolo,113,214977,2761,2724,6,2730,53
2020-09-17,Yuba,115,75493,1047,1015,5,1020,1
2020-09-16,Alameda,001,1643700,20810,20009,158,20167,333
2020-09-16,Alpine,003,1148,2,2,0,2,0
2020-09-16,Amador,005,37829,288,284,0,284,16
2020-09-16,Butte,007,227075,2847,2704,26,2730,38
2020-09-16,Calaveras,009,45235,304,254,0,254,9
2020-09-16,Colusa,011,21464,522,497,0,497,6
2020-09-16,Contra Costa,013,1133247,16402,15473,79,15552,183
2020-09-16,Del Norte,015,27424,133,131,0,131,2
2020-09-16,El Dorado,017,186661,1106,1049,0,1049,4
2020-09-16,Fresno,019,978130,29904,27381,360,27741,343
2020-09-16,Glenn,021,27897,563,539,0,539,3
2020-09-16,Humboldt,023,135768,483,455,1,456,4
2020-09-16,Imperial,025,180216,11647,10401,9,10410,277
2020-09-16,Inyo,027,18085,186,176,4,180,12
2020-09-16,Kern,029,883053,31461,30570,293,30863,371
2020-09-16,Kings,031,150075,7486,7002,37,7039,71
2020-09-16,Lake,033,64148,519,417,0,417,6
2020-09-16,Lassen,035,31185,741,730,2,732,0
2020-09-16,Los Angeles,037,10098052,259693,256101,1678,257779,6299
2020-09-16,Madera,039,155013,4401,4138,30,4168,45
2020-09-16,Marin,041,260295,6580,6430,15,6445,77
2020-09-16,Mariposa,043,17540,75,74,0,74,2
2020-09-16,Mendocino,045,87422,801,727,0,727,18
2020-09-16,Merced,047,269075,8737,8646,15,8661,118
2020-09-16,Modoc,049,8938,27,22,0,22,0
2020-09-16,Mono,051,14174,165,147,2,149,1
2020-09-16,Monterey,053,433212,9432,8997,25,9022,62
2020-09-16,Napa,055,140530,1654,1587,8,1595,11
2020-09-16,Nevada,057,99092,522,495,15,510,6
2020-09-16,Orange,059,3164182,53234,50414,1383,51797,1096
2020-09-16,Placer,061,380077,3524,3351,14,3365,39
2020-09-16,Plumas,063,18699,49,45,0,45,0
2020-09-16,Riverside,065,2383286,57346,55811,134,55945,1127
2020-09-16,Sacramento,067,1510023,21542,20610,24,20634,377
2020-09-16,San Benito,069,59416,1297,1244,0,1244,8
2020-09-16,San Bernardino,071,2135413,52475,50509,336,50845,907
2020-09-16,San Diego,073,3302833,45314,43447,793,44240,748
2020-09-16,San Francisco,075,870044,10855,10502,27,10529,90
2020-09-16,San Joaquin,077,732212,19816,19377,45,19422,409
2020-09-16,San Luis Obispo,079,281455,3545,3285,21,3306,28
2020-09-16,San Mateo,081,765935,9772,8944,9,8953,127
2020-09-16,Santa Barbara,083,443738,8943,8764,75,8839,107
2020-09-16,Santa Clara,085,1922200,21212,19684,41,19725,253
2020-09-16,Santa Cruz,087,273765,2263,2089,24,2113,7
2020-09-16,Shasta,089,179085,776,635,3,638,11
2020-09-16,Sierra,091,2930,6,6,0,6,0
2020-09-16,Siskiyou,093,43540,153,145,10,155,0
2020-09-16,Solano,095,438530,6114,5899,41,5940,44
2020-09-16,Sonoma,097,501317,7081,6731,20,6751,104
2020-09-16,Stanislaus,099,539301,16273,15897,475,16372,263
2020-09-16,Sutter,101,95872,1634,1567,1,1568,10
2020-09-16,Tehama,103,63373,507,485,2,487,2
2020-09-16,Trinity,105,12862,53,15,7,22,0
2020-09-16,Tulare,107,460477,15900,15314,95,15409,258
2020-09-16,Tuolumne,109,53932,228,210,4,214,1
2020-09-16,Ventura,111,848112,12813,12073,140,12213,130
2020-09-16,Yolo,113,214977,2754,2709,6,2715,53
2020-09-16,Yuba,115,75493,1045,1000,5,1005,1
2020-09-15,Alameda,001,1643700,20703,19931,155,20086,327
2020-09-15,Alpine,003,1148,2,2,0,2,0
2020-09-15,Amador,005,37829,287,282,0,282,16
2020-09-15,Butte,007,227075,2834,2695,24,2719,38
2020-09-15,Calaveras,009,45235,304,248,0,248,5
2020-09-15,Colusa,011,21464,516,497,0,497,6
2020-09-15,Contra Costa,013,1133247,16299,15423,78,15501,180
2020-09-15,Del Norte,015,27424,133,129,0,129,2
2020-09-15,El Dorado,017,186661,1101,1046,0,1046,4
2020-09-15,Fresno,019,978130,29797,27312,355,27667,343
2020-09-15,Glenn,021,27897,562,531,0,531,3
2020-09-15,Humboldt,023,135768,481,456,1,457,4
2020-09-15,Imperial,025,180216,11622,10376,9,10385,277
2020-09-15,Inyo,027,18085,186,176,4,180,12
2020-09-15,Kern,029,883053,31348,30429,290,30719,368
2020-09-15,Kings,031,150075,7328,6977,37,7014,70
2020-09-15,Lake,033,64148,505,416,0,416,4
2020-09-15,Lassen,035,31185,737,719,2,721,0
2020-09-15,Los Angeles,037,10098052,258583,255048,1656,256704,6269
2020-09-15,Madera,039,155013,4382,4122,30,4152,45
2020-09-15,Marin,041,260295,6549,6423,15,6438,77
2020-09-15,Mariposa,043,17540,75,74,0,74,2
2020-09-15,Mendocino,045,87422,783,724,0,724,18
2020-09-15,Merced,047,269075,8707,8633,15,8648,114
2020-09-15,Modoc,049,8938,26,21,0,21,0
2020-09-15,Mono,051,14174,165,147,2,149,1
2020-09-15,Monterey,053,433212,9383,8943,25,8968,62
2020-09-15,Napa,055,140530,1640,1580,8,1588,11
2020-09-15,Nevada,057,99092,517,494,15,509,6
2020-09-15,Orange,059,3164182,53052,50294,1368,51662,1088
2020-09-15,Placer,061,380077,3500,3331,14,3345,38
2020-09-15,Plumas,063,18699,49,44,0,44,0
2020-09-15,Riverside,065,2383286,57052,55569,124,55693,1118
2020-09-15,Sacramento,067,1510023,21399,20487,24,20511,372
2020-09-15,San Benito,069,59416,1290,1237,0,1237,7
2020-09-15,San Bernardino,071,2135413,52259,50333,335,50668,904
2020-09-15,San Diego,073,3302833,44995,43183,773,43956,742
2020-09-15,San Francisco,075,870044,10797,10414,27,10441,90
2020-09-15,San Joaquin,077,732212,19764,19313,45,19358,401
2020-09-15,San Luis Obispo,079,281455,3525,3262,21,3283,28
2020-09-15,San Mateo,081,765935,9702,8895,9,8904,127
2020-09-15,Santa Barbara,083,443738,8918,8724,74,8798,104
2020-09-15,Santa Clara,085,1922200,21076,19610,41,19651,252
2020-09-15,Santa Cruz,087,273765,2237,2079,23,2102,7
2020-09-15,Shasta,089,179085,764,627,3,630,11
2020-09-15,Sierra,091,2930,6,6,0,6,0
2020-09-15,Siskiyou,093,43540,153,143,10,153,0
2020-09-15,Solano,095,438530,6080,5878,41,5919,45
2020-09-15,Sonoma,097,501317,7042,6701,20,6721,104
2020-09-15,Stanislaus,099,539301,16225,15880,473,16353,260
2020-09-15,Sutter,101,95872,1623,1556,1,1557,10
2020-09-15,Tehama,103,63373,495,484,2,486,2
2020-09-15,Trinity,105,12862,53,15,7,22,0
2020-09-15,Tulare,107,460477,15823,15203,93,15296,254
2020-09-15,Tuolumne,109,53932,228,209,4,213,1
2020-09-15,Ventura,111,848112,12760,11932,139,12071,128
2020-09-15,Yolo,113,214977,2750,2708,6,2714,53
2020-09-15,Yuba,115,75493,1039,991,4,995,1
2020-09-14,Alameda,001,1643700,20576,19851,154,20005,306
2020-09-14,Alpine,003,1148,2,2,0,2,0
2020-09-14,Amador,005,37829,285,281,0,281,16
2020-09-14,Butte,007,227075,2817,2642,24,2666,37
2020-09-14,Calaveras,009,45235,304,244,0,244,3
2020-09-14,Colusa,011,21464,515,486,0,486,6
2020-09-14,Contra Costa,013,1133247,16175,15354,77,15431,174
2020-09-14,Del Norte,015,27424,130,116,0,116,2
2020-09-14,El Dorado,017,186661,1097,1039,0,1039,3
2020-09-14,Fresno,019,978130,29712,27232,352,27584,344
2020-09-14,Glenn,021,27897,554,521,0,521,3
2020-09-14,Humboldt,023,135768,478,437,1,438,4
2020-09-14,Imperial,025,180216,11602,10340,9,10349,273
2020-09-14,Inyo,027,18085,186,176,4,180,12
2020-09-14,Kern,029,883053,31260,30344,289,30633,368
2020-09-14,Kings,031,150075,7246,6950,37,6987,70
2020-09-14,Lake,033,64148,485,407,0,407,4
2020-09-14,Lassen,035,31185,737,719,2,721,0
2020-09-14,Los Angeles,037,10098052,257556,254622,1631,256253,6226
2020-09-14,Madera,039,155013,4368,4104,30,4134,45
2020-09-14,Marin,041,260295,6528,6409,15,6424,70
2020-09-14,Mariposa,043,17540,75,74,0,74,2
2020-09-14,Mendocino,045,87422,766,710,0,710,17
2020-09-14,Merced,047,269075,8688,8593,15,8608,112
2020-09-14,Modoc,049,8938,26,21,0,21,0
2020-09-14,Mono,051,14174,165,147,2,149,1
2020-09-14,Monterey,053,433212,9312,8845,24,8869,61
2020-09-14,Napa,055,140530,1623,1576,8,1584,11
2020-09-14,Nevada,057,99092,512,489,15,504,6
2020-09-14,Orange,059,3164182,52891,50149,1352,51501,1079
2020-09-14,Placer,061,380077,3479,3302,14,3316,38
2020-09-14,Plumas,063,18699,48,42,0,42,0
2020-09-14,Riverside,065,2383286,56833,55488,119,55607,1113
2020-09-14,Sacramento,067,1510023,21204,20377,23,20400,367
2020-09-14,San Benito,069,59416,1275,1233,0,1233,7
2020-09-14,San Bernardino,071,2135413,52034,50163,334,50497,895
2020-09-14,San Diego,073,3302833,44684,42889,753,43642,734
2020-09-14,San Francisco,075,870044,10730,10255,25,10280,90
2020-09-14,San Joaquin,077,732212,19690,19111,44,19155,397
2020-09-14,San Luis Obispo,079,281455,3500,3248,21,3269,25
2020-09-14,San Mateo,081,765935,9640,8847,9,8856,127
2020-09-14,Santa Barbara,083,443738,8892,8692,74,8766,104
2020-09-14,Santa Clara,085,1922200,20887,19545,41,19586,247
2020-09-14,Santa Cruz,087,273765,2216,2016,22,2038,7
2020-09-14,Shasta,089,179085,741,584,3,587,10
2020-09-14,Sierra,091,2930,6,6,0,6,0
2020-09-14,Siskiyou,093,43540,152,143,10,153,0
2020-09-14,Solano,095,438530,6045,5834,41,5875,44
2020-09-14,Sonoma,097,501317,6979,6630,20,6650,102
2020-09-14,Stanislaus,099,539301,16180,15812,470,16282,253
2020-09-14,Sutter,101,95872,1612,1549,1,1550,10
2020-09-14,Tehama,103,63373,493,475,2,477,1
2020-09-14,Trinity,105,12862,52,14,7,21,0
2020-09-14,Tulare,107,460477,15753,15096,87,15183,254
2020-09-14,Tuolumne,109,53932,227,208,4,212,1
2020-09-14,Ventura,111,848112,12658,11903,136,12039,125
2020-09-14,Yolo,113,214977,2739,2687,6,2693,53
2020-09-14,Yuba,115,75493,1031,977,4,981,1
2020-09-13,Alameda,001,1643700,20470,19815,151,19966,306
2020-09-13,Alpine,003,1148,2,2,0,2,0
2020-09-13,Amador,005,37829,282,279,0,279,16
2020-09-13,Butte,007,227075,2795,2640,24,2664,37
2020-09-13,Calaveras,009,45235,303,246,0,246,3
2020-09-13,Colusa,011,21464,511,486,0,486,6
2020-09-13,Contra Costa,013,1133247,16067,15284,77,15361,172
2020-09-13,Del Norte,015,27424,127,116,0,116,1
2020-09-13,El Dorado,017,186661,1092,1035,0,1035,2
2020-09-13,Fresno,019,978130,29604,27196,343,27539,345
2020-09-13,Glenn,021,27897,550,517,0,517,3
2020-09-13,Humboldt,023,135768,478,434,1,435,4
2020-09-13,Imperial,025,180216,11565,10304,8,10312,273
2020-09-13,Inyo,027,18085,186,176,4,180,12
2020-09-13,Kern,029,883053,31167,30277,282,30559,368
2020-09-13,Kings,031,150075,7227,6937,37,6974,70
2020-09-13,Lake,033,64148,466,397,0,397,4
2020-09-13,Lassen,035,31185,734,719,2,721,0
2020-09-13,Los Angeles,037,10098052,256407,253950,1615,255565,6203
2020-09-13,Madera,039,155013,4311,4090,30,4120,45
2020-09-13,Marin,041,260295,6507,6395,15,6410,70
2020-09-13,Mariposa,043,17540,75,74,0,74,2
2020-09-13,Mendocino,045,87422,759,707,0,707,17
2020-09-13,Merced,047,269075,8654,8575,14,8589,112
2020-09-13,Modoc,049,8938,26,21,0,21,0
2020-09-13,Mono,051,14174,165,147,2,149,1
2020-09-13,Monterey,053,433212,9230,8826,23,8849,61
2020-09-13,Napa,055,140530,1616,1563,8,1571,11
2020-09-13,Nevada,057,99092,504,486,15,501,6
2020-09-13,Orange,059,3164182,52675,50061,1345,51406,1075
2020-09-13,Placer,061,380077,3449,3291,14,3305,38
2020-09-13,Plumas,063,18699,48,42,0,42,0
2020-09-13,Riverside,065,2383286,56626,55235,108,55343,1108
2020-09-13,Sacramento,067,1510023,20858,20279,23,20302,367
2020-09-13,San Benito,069,59416,1267,1217,0,1217,7
2020-09-13,San Bernardino,071,2135413,51748,49968,332,50300,895
2020-09-13,San Diego,073,3302833,44358,42681,719,43400,734
2020-09-13,San Francisco,075,870044,10652,10254,25,10279,90
2020-09-13,San Joaquin,077,732212,19618,19110,43,19153,396
2020-09-13,San Luis Obispo,079,281455,3463,3240,21,3261,24
2020-09-13,San Mateo,081,765935,9579,8811,9,8820,127
2020-09-13,Santa Barbara,083,443738,8855,8690,74,8764,104
2020-09-13,Santa Clara,085,1922200,20751,19456,40,19496,245
2020-09-13,Santa Cruz,087,273765,2183,2016,20,2036,7
2020-09-13,Shasta,089,179085,729,583,3,586,10
2020-09-13,Sierra,091,2930,6,6,0,6,0
2020-09-13,Siskiyou,093,43540,152,143,9,152,0
2020-09-13,Solano,095,438530,5999,5810,41,5851,43
2020-09-13,Sonoma,097,501317,6914,6592,20,6612,95
2020-09-13,Stanislaus,099,539301,16117,15759,458,16217,253
2020-09-13,Sutter,101,95872,1600,1539,1,1540,10
2020-09-13,Tehama,103,63373,489,476,2,478,1
2020-09-13,Trinity,105,12862,52,14,7,21,0
2020-09-13,Tulare,107,460477,15682,15098,86,15184,254
2020-09-13,Tuolumne,109,53932,224,208,4,212,1
2020-09-13,Ventura,111,848112,12550,11855,135,11990,123
2020-09-13,Yolo,113,214977,2727,2675,6,2681,53
2020-09-13,Yuba,115,75493,1026,967,4,971,1
2020-09-12,Alameda,001,1643700,20411,19758,151,19909,307
2020-09-12,Alpine,003,1148,2,2,0,2,0
2020-09-12,Amador,005,37829,281,278,0,278,16
2020-09-12,Butte,007,227075,2788,2629,23,2652,37
2020-09-12,Calaveras,009,45235,301,246,0,246,3
2020-09-12,Colusa,011,21464,507,486,0,486,6
2020-09-12,Contra Costa,013,1133247,15991,15135,76,15211,174
2020-09-12,Del Norte,015,27424,126,116,0,116,1
2020-09-12,El Dorado,017,186661,1085,1034,0,1034,2
2020-09-12,Fresno,019,978130,29533,27076,343,27419,345
2020-09-12,Glenn,021,27897,549,517,0,517,3
2020-09-12,Humboldt,023,135768,477,430,1,431,4
2020-09-12,Imperial,025,180216,11553,10305,8,10313,273
2020-09-12,Inyo,027,18085,186,177,4,181,12
2020-09-12,Kern,029,883053,31101,30202,282,30484,368
2020-09-12,Kings,031,150075,7217,6895,37,6932,70
2020-09-12,Lake,033,64148,460,393,0,393,4
2020-09-12,Lassen,035,31185,734,719,2,721,0
2020-09-12,Los Angeles,037,10098052,255848,253156,1594,254750,6193
2020-09-12,Madera,039,155013,4300,4058,30,4088,43
2020-09-12,Marin,041,260295,6498,6393,15,6408,69
2020-09-12,Mariposa,043,17540,75,72,0,72,2
2020-09-12,Mendocino,045,87422,756,700,0,700,17
2020-09-12,Merced,047,269075,8645,8533,14,8547,112
2020-09-12,Modoc,049,8938,25,21,0,21,0
2020-09-12,Mono,051,14174,165,147,2,149,1
2020-09-12,Monterey,053,433212,9194,8743,23,8766,61
2020-09-12,Napa,055,140530,1613,1556,8,1564,11
2020-09-12,Nevada,057,99092,503,482,15,497,6
2020-09-12,Orange,059,3164182,52560,49895,1342,51237,1078
2020-09-12,Placer,061,380077,3432,3280,14,3294,38
2020-09-12,Plumas,063,18699,48,42,0,42,0
2020-09-12,Riverside,065,2383286,56497,55058,104,55162,1108
2020-09-12,Sacramento,067,1510023,20789,20184,23,20207,367
2020-09-12,San Benito,069,59416,1264,1208,0,1208,7
2020-09-12,San Bernardino,071,2135413,51657,49945,330,50275,896
2020-09-12,San Diego,073,3302833,44163,42416,710,43126,747
2020-09-12,San Francisco,075,870044,10607,10257,25,10282,90
2020-09-12,San Joaquin,077,732212,19590,19108,43,19151,396
2020-09-12,San Luis Obispo,079,281455,3436,3220,21,3241,24
2020-09-12,San Mateo,081,765935,9534,8759,9,8768,127
2020-09-12,Santa Barbara,083,443738,8841,8642,74,8716,104
2020-09-12,Santa Clara,085,1922200,20667,19330,40,19370,237
2020-09-12,Santa Cruz,087,273765,2171,2016,20,2036,7
2020-09-12,Shasta,089,179085,717,569,3,572,10
2020-09-12,Sierra,091,2930,6,6,0,6,0
2020-09-12,Siskiyou,093,43540,152,141,9,150,0
2020-09-12,Solano,095,438530,5975,5772,41,5813,43
2020-09-12,Sonoma,097,501317,6890,6531,20,6551,95
2020-09-12,Stanislaus,099,539301,16085,15675,455,16130,253
2020-09-12,Sutter,101,95872,1594,1529,1,1530,10
2020-09-12,Tehama,103,63373,486,471,2,473,1
2020-09-12,Trinity,105,12862,52,15,7,22,0
2020-09-12,Tulare,107,460477,15636,15018,85,15103,254
2020-09-12,Tuolumne,109,53932,224,208,4,212,1
2020-09-12,Ventura,111,848112,12499,11759,133,11892,123
2020-09-12,Yolo,113,214977,2720,2646,6,2652,53
2020-09-12,Yuba,115,75493,1022,963,4,967,1
2020-09-11,Alameda,001,1643700,20356,19625,150,19775,298
2020-09-11,Alpine,003,1148,2,2,0,2,0
2020-09-11,Amador,005,37829,281,277,0,277,16
2020-09-11,Butte,007,227075,2777,2605,23,2628,37
2020-09-11,Calaveras,009,45235,300,242,0,242,1
2020-09-11,Colusa,011,21464,506,484,0,484,6
2020-09-11,Contra Costa,013,1133247,15939,15001,73,15074,173
2020-09-11,Del Norte,015,27424,126,115,0,115,1
2020-09-11,El Dorado,017,186661,1082,1024,0,1024,2
2020-09-11,Fresno,019,978130,29453,26917,342,27259,344
2020-09-11,Glenn,021,27897,544,515,0,515,3
2020-09-11,Humboldt,023,135768,475,426,1,427,4
2020-09-11,Imperial,025,180216,11535,10286,8,10294,273
2020-09-11,Inyo,027,18085,186,176,4,180,12
2020-09-11,Kern,029,883053,31033,30059,281,30340,365
2020-09-11,Kings,031,150075,7200,6770,37,6807,70
2020-09-11,Lake,033,64148,453,382,0,382,4
2020-09-11,Lassen,035,31185,734,719,2,721,0
2020-09-11,Los Angeles,037,10098052,255167,252057,1583,253640,6172
2020-09-11,Madera,039,155013,4281,4018,30,4048,43
2020-09-11,Marin,041,260295,6495,6364,15,6379,69
2020-09-11,Mariposa,043,17540,75,72,0,72,2
2020-09-11,Mendocino,045,87422,745,700,0,700,17
2020-09-11,Merced,047,269075,8624,8489,14,8503,109
2020-09-11,Modoc,049,8938,25,21,0,21,0
2020-09-11,Mono,051,14174,165,145,2,147,1
2020-09-11,Monterey,053,433212,9146,8595,23,8618,61
2020-09-11,Napa,055,140530,1602,1543,8,1551,11
2020-09-11,Nevada,057,99092,496,483,15,498,6
2020-09-11,Orange,059,3164182,52431,49755,1330,51085,1068
2020-09-11,Placer,061,380077,3417,3254,14,3268,37
2020-09-11,Plumas,063,18699,48,42,0,42,0
2020-09-11,Riverside,065,2383286,56362,54717,101,54818,1099
2020-09-11,Sacramento,067,1510023,20704,20012,23,20035,358
2020-09-11,San Benito,069,59416,1254,1202,0,1202,7
2020-09-11,San Bernardino,071,2135413,51558,49682,330,50012,871
2020-09-11,San Diego,073,3302833,43943,41971,704,42675,730
2020-09-11,San Francisco,075,870044,10559,10133,24,10157,89
2020-09-11,San Joaquin,077,732212,19542,19019,43,19062,391
2020-09-11,San Luis Obispo,079,281455,3418,3190,21,3211,24
2020-09-11,San Mateo,081,765935,9492,8611,9,8620,127
2020-09-11,Santa Barbara,083,443738,8808,8592,73,8665,103
2020-09-11,Santa Clara,085,1922200,20578,19065,40,19105,234
2020-09-11,Santa Cruz,087,273765,2154,1997,20,2017,7
2020-09-11,Shasta,089,179085,707,568,3,571,10
2020-09-11,Sierra,091,2930,6,6,0,6,0
2020-09-11,Siskiyou,093,43540,151,139,9,148,0
2020-09-11,Solano,095,438530,5958,5742,41,5783,42
2020-09-11,Sonoma,097,501317,6845,6469,20,6489,91
2020-09-11,Stanislaus,099,539301,16047,15613,452,16065,253
2020-09-11,Sutter,101,95872,1584,1505,1,1506,11
2020-09-11,Tehama,103,63373,483,466,2,468,1
2020-09-11,Trinity,105,12862,52,16,7,23,0
2020-09-11,Tulare,107,460477,15605,14932,83,15015,251
2020-09-11,Tuolumne,109,53932,224,208,4,212,1
2020-09-11,Ventura,111,848112,12445,11700,131,11831,123
2020-09-11,Yolo,113,214977,2709,2632,6,2638,53
2020-09-11,Yuba,115,75493,1014,946,4,950,1
2020-09-10,Alameda,001,1643700,20282,19509,150,19659,292
2020-09-10,Alpine,003,1148,2,2,0,2,0
2020-09-10,Amador,005,37829,280,277,0,277,16
2020-09-10,Butte,007,227075,2760,2590,23,2613,37
2020-09-10,Calaveras,009,45235,300,244,0,244,1
2020-09-10,Colusa,011,21464,504,482,0,482,6
2020-09-10,Contra Costa,013,1133247,15869,14909,73,14982,172
2020-09-10,Del Norte,015,27424,125,112,0,112,1
2020-09-10,El Dorado,017,186661,1079,1020,0,1020,2
2020-09-10,Fresno,019,978130,29331,26783,342,27125,338
2020-09-10,Glenn,021,27897,534,511,0,511,3
2020-09-10,Humboldt,023,135768,464,422,1,423,4
2020-09-10,Imperial,025,180216,11519,10251,8,10259,270
2020-09-10,Inyo,027,18085,185,176,4,180,11
2020-09-10,Kern,029,883053,30951,29988,277,30265,363
2020-09-10,Kings,031,150075,7170,6739,37,6776,70
2020-09-10,Lake,033,64148,446,377,0,377,4
2020-09-10,Lassen,035,31185,733,716,2,718,0
2020-09-10,Los Angeles,037,10098052,254188,251003,1562,252565,6132
2020-09-10,Madera,039,155013,4263,3979,30,4009,43
2020-09-10,Marin,041,260295,6483,6344,15,6359,68
2020-09-10,Mariposa,043,17540,75,72,0,72,2
2020-09-10,Mendocino,045,87422,735,697,0,697,16
2020-09-10,Merced,047,269075,8578,8461,14,8475,109
2020-09-10,Modoc,049,8938,25,21,0,21,0
2020-09-10,Mono,051,14174,165,145,2,147,1
2020-09-10,Monterey,053,433212,9076,8570,23,8593,59
2020-09-10,Napa,055,140530,1596,1536,8,1544,11
2020-09-10,Nevada,057,99092,492,478,15,493,6
2020-09-10,Orange,059,3164182,52268,49617,1324,50941,1057
2020-09-10,Placer,061,380077,3397,3233,14,3247,37
2020-09-10,Plumas,063,18699,48,42,0,42,0
2020-09-10,Riverside,065,2383286,56043,54417,98,54515,1091
2020-09-10,Sacramento,067,1510023,20582,19618,22,19640,354
2020-09-10,San Benito,069,59416,1248,1201,0,1201,5
2020-09-10,San Bernardino,071,2135413,51369,49467,328,49795,867
2020-09-10,San Diego,073,3302833,43677,41610,677,42287,725
2020-09-10,San Francisco,075,870044,10482,10082,24,10106,89
2020-09-10,San Joaquin,077,732212,19489,18854,43,18897,389
2020-09-10,San Luis Obispo,079,281455,3404,3161,20,3181,24
2020-09-10,San Mateo,081,765935,9446,8529,9,8538,125
2020-09-10,Santa Barbara,083,443738,8763,8552,73,8625,100
2020-09-10,Santa Clara,085,1922200,20464,18870,40,18910,231
2020-09-10,Santa Cruz,087,273765,2139,1986,18,2004,7
2020-09-10,Shasta,089,179085,696,566,3,569,10
2020-09-10,Sierra,091,2930,6,6,0,6,0
2020-09-10,Siskiyou,093,43540,151,137,9,146,0
2020-09-10,Solano,095,438530,5918,5696,41,5737,42
2020-09-10,Sonoma,097,501317,6796,6424,20,6444,91
2020-09-10,Stanislaus,099,539301,15993,15509,447,15956,243
2020-09-10,Sutter,101,95872,1572,1494,1,1495,11
2020-09-10,Tehama,103,63373,476,466,2,468,1
2020-09-10,Trinity,105,12862,52,15,7,22,0
2020-09-10,Tulare,107,460477,15550,14860,80,14940,250
2020-09-10,Tuolumne,109,53932,223,205,4,209,1
2020-09-10,Ventura,111,848112,12351,11600,124,11724,122
2020-09-10,Yolo,113,214977,2704,2612,6,2618,53
2020-09-10,Yuba,115,75493,1008,941,4,945,1
2020-09-09,Alameda,001,1643700,20203,19399,149,19548,289
2020-09-09,Alpine,003,1148,2,2,0,2,0
2020-09-09,Amador,005,37829,279,276,0,276,16
2020-09-09,Butte,007,227075,2743,2561,23,2584,37
2020-09-09,Calaveras,009,45235,300,242,0,242,1
2020-09-09,Colusa,011,21464,499,479,0,479,6
2020-09-09,Contra Costa,013,1133247,15783,14816,73,14889,171
2020-09-09,Del Norte,015,27424,121,109,0,109,1
2020-09-09,El Dorado,017,186661,1076,1020,0,1020,2
2020-09-09,Fresno,019,978130,29228,26724,337,27061,329
2020-09-09,Glenn,021,27897,531,508,0,508,3
2020-09-09,Humboldt,023,135768,462,420,1,421,4
2020-09-09,Imperial,025,180216,11498,10233,8,10241,268
2020-09-09,Inyo,027,18085,184,173,4,177,2
2020-09-09,Kern,029,883053,30853,29925,274,30199,355
2020-09-09,Kings,031,150075,7152,6721,37,6758,72
2020-09-09,Lake,033,64148,438,371,0,371,4
2020-09-09,Lassen,035,31185,732,714,2,716,0
2020-09-09,Los Angeles,037,10098052,253314,249876,1544,251420,6091
2020-09-09,Madera,039,155013,4237,3926,30,3956,43
2020-09-09,Marin,041,260295,6464,6321,15,6336,68
2020-09-09,Mariposa,043,17540,74,72,0,72,2
2020-09-09,Mendocino,045,87422,727,695,0,695,16
2020-09-09,Merced,047,269075,8554,8441,14,8455,107
2020-09-09,Modoc,049,8938,24,20,0,20,0
2020-09-09,Mono,051,14174,165,145,2,147,1
2020-09-09,Monterey,053,433212,9004,8527,23,8550,59
2020-09-09,Napa,055,140530,1586,1531,8,1539,11
2020-09-09,Nevada,057,99092,488,476,15,491,6
2020-09-09,Orange,059,3164182,52088,49394,1316,50710,1054
2020-09-09,Placer,061,380077,3377,3222,14,3236,36
2020-09-09,Plumas,063,18699,46,42,0,42,0
2020-09-09,Riverside,065,2383286,55813,54320,95,54415,1081
2020-09-09,Sacramento,067,1510023,20476,19474,21,19495,347
2020-09-09,San Benito,069,59416,1244,1199,0,1199,5
2020-09-09,San Bernardino,071,2135413,51171,49264,327,49591,866
2020-09-09,San Diego,073,3302833,43388,41326,665,41991,721
2020-09-09,San Francisco,075,870044,10432,9996,23,10019,86
2020-09-09,San Joaquin,077,732212,19425,18799,42,18841,388
2020-09-09,San Luis Obispo,079,281455,3386,3131,20,3151,24
2020-09-09,San Mateo,081,765935,9385,8478,9,8487,125
2020-09-09,Santa Barbara,083,443738,8720,8528,73,8601,97
2020-09-09,Santa Clara,085,1922200,20332,18759,40,18799,228
2020-09-09,Santa Cruz,087,273765,2116,1967,18,1985,7
2020-09-09,Shasta,089,179085,684,562,3,565,10
2020-09-09,Sierra,091,2930,6,6,0,6,0
2020-09-09,Siskiyou,093,43540,149,137,9,146,0
2020-09-09,Solano,095,438530,5886,5680,41,5721,36
2020-09-09,Sonoma,097,501317,6729,6397,20,6417,92
2020-09-09,Stanislaus,099,539301,15954,15469,436,15905,243
2020-09-09,Sutter,101,95872,1564,1487,1,1488,11
2020-09-09,Tehama,103,63373,473,462,2,464,1
2020-09-09,Trinity,105,12862,52,14,7,21,0
2020-09-09,Tulare,107,460477,15501,14787,75,14862,249
2020-09-09,Tuolumne,109,53932,222,204,3,207,1
2020-09-09,Ventura,111,848112,12260,11497,121,11618,121
2020-09-09,Yolo,113,214977,2693,2604,6,2610,53
2020-09-09,Yuba,115,75493,1003,936,4,940,1
2020-09-08,Alameda,001,1643700,20095,19293,149,19442,288
2020-09-08,Alpine,003,1148,2,2,0,2,0
2020-09-08,Amador,005,37829,279,276,0,276,16
2020-09-08,Butte,007,227075,2725,2453,23,2476,36
2020-09-08,Calaveras,009,45235,298,233,0,233,1
2020-09-08,Colusa,011,21464,497,475,0,475,6
2020-09-08,Contra Costa,013,1133247,15655,14740,70,14810,171
2020-09-08,Del Norte,015,27424,121,109,0,109,2
2020-09-08,El Dorado,017,186661,1073,1011,0,1011,2
2020-09-08,Fresno,019,978130,29108,26640,333,26973,329
2020-09-08,Glenn,021,27897,527,492,0,492,3
2020-09-08,Humboldt,023,135768,460,420,1,421,4
2020-09-08,Imperial,025,180216,11482,10198,8,10206,267
2020-09-08,Inyo,027,18085,184,169,4,173,2
2020-09-08,Kern,029,883053,30767,29850,272,30122,351
2020-09-08,Kings,031,150075,7114,6658,37,6695,72
2020-09-08,Lake,033,64148,428,370,0,370,4
2020-09-08,Lassen,035,31185,732,710,2,712,0
2020-09-08,Los Angeles,037,10098052,252385,249217,1516,250733,6034
2020-09-08,Madera,039,155013,4213,3904,30,3934,43
2020-09-08,Marin,041,260295,6433,6313,15,6328,68
2020-09-08,Mariposa,043,17540,74,72,0,72,2
2020-09-08,Mendocino,045,87422,720,690,0,690,16
2020-09-08,Merced,047,269075,8531,8381,14,8395,104
2020-09-08,Modoc,049,8938,24,20,0,20,0
2020-09-08,Mono,051,14174,165,145,2,147,1
2020-09-08,Monterey,053,433212,8919,8491,23,8514,59
2020-09-08,Napa,055,140530,1582,1518,8,1526,11
2020-09-08,Nevada,057,99092,488,470,15,485,6
2020-09-08,Orange,059,3164182,51947,49214,1312,50526,1044
2020-09-08,Placer,061,380077,3363,3205,14,3219,36
2020-09-08,Plumas,063,18699,46,42,0,42,0
2020-09-08,Riverside,065,2383286,55599,54168,92,54260,1069
2020-09-08,Sacramento,067,1510023,20241,19411,20,19431,347
2020-09-08,San Benito,069,59416,1237,1188,0,1188,5
2020-09-08,San Bernardino,071,2135413,50981,49034,326,49360,856
2020-09-08,San Diego,073,3302833,43072,41079,653,41732,709
2020-09-08,San Francisco,075,870044,10359,9821,23,9844,86
2020-09-08,San Joaquin,077,732212,19347,18550,42,18592,388
2020-09-08,San Luis Obispo,079,281455,3371,3120,20,3140,23
2020-09-08,San Mateo,081,765935,9309,8460,9,8469,125
2020-09-08,Santa Barbara,083,443738,8686,8488,72,8560,96
2020-09-08,Santa Clara,085,1922200,20156,18645,40,18685,228
2020-09-08,Santa Cruz,087,273765,2088,1903,18,1921,7
2020-09-08,Shasta,089,179085,676,556,3,559,10
2020-09-08,Sierra,091,2930,6,6,0,6,0
2020-09-08,Siskiyou,093,43540,147,136,9,145,0
2020-09-08,Solano,095,438530,5849,5654,41,5695,36
2020-09-08,Sonoma,097,501317,6660,6356,20,6376,92
2020-09-08,Stanislaus,099,539301,15890,15415,424,15839,238
2020-09-08,Sutter,101,95872,1548,1473,1,1474,11
2020-09-08,Tehama,103,63373,469,458,2,460,1
2020-09-08,Trinity,105,12862,51,13,7,20,0
2020-09-08,Tulare,107,460477,15421,14635,74,14709,249
2020-09-08,Tuolumne,109,53932,221,197,3,200,1
2020-09-08,Ventura,111,848112,12191,11475,118,11593,118
2020-09-08,Yolo,113,214977,2683,2580,6,2586,53
2020-09-08,Yuba,115,75493,991,923,4,927,1
2020-09-07,Alameda,001,1643700,19973,19188,143,19331,281
2020-09-07,Alpine,003,1148,2,2,0,2,0
2020-09-07,Amador,005,37829,279,276,0,276,16
2020-09-07,Butte,007,227075,2692,2450,22,2472,30
2020-09-07,Calaveras,009,45235,288,234,0,234,1
2020-09-07,Colusa,011,21464,496,475,0,475,6
2020-09-07,Contra Costa,013,1133247,15542,14637,67,14704,172
2020-09-07,Del Norte,015,27424,121,109,0,109,2
2020-09-07,El Dorado,017,186661,1062,1011,0,1011,2
2020-09-07,Fresno,019,978130,29014,26565,330,26895,329
2020-09-07,Glenn,021,27897,522,488,0,488,3
2020-09-07,Humboldt,023,135768,451,416,1,417,4
2020-09-07,Imperial,025,180216,11451,10199,8,10207,267
2020-09-07,Inyo,027,18085,184,169,4,173,2
2020-09-07,Kern,029,883053,30646,29790,267,30057,348
2020-09-07,Kings,031,150075,6989,6630,37,6667,72
2020-09-07,Lake,033,64148,405,367,0,367,2
2020-09-07,Lassen,035,31185,732,709,2,711,0
2020-09-07,Los Angeles,037,10098052,251339,248804,1494,250298,6030
2020-09-07,Madera,039,155013,4182,3889,29,3918,43
2020-09-07,Marin,041,260295,6403,6296,15,6311,67
2020-09-07,Mariposa,043,17540,74,72,0,72,2
2020-09-07,Mendocino,045,87422,712,687,0,687,16
2020-09-07,Merced,047,269075,8484,8381,14,8395,104
2020-09-07,Modoc,049,8938,23,20,0,20,0
2020-09-07,Mono,051,14174,165,145,2,147,1
2020-09-07,Monterey,053,433212,8840,8463,23,8486,57
2020-09-07,Napa,055,140530,1570,1514,8,1522,11
2020-09-07,Nevada,057,99092,486,469,15,484,6
2020-09-07,Orange,059,3164182,51774,49132,1308,50440,1042
2020-09-07,Placer,061,380077,3333,3188,13,3201,36
2020-09-07,Plumas,063,18699,45,42,0,42,0
2020-09-07,Riverside,065,2383286,55324,54178,86,54264,1069
2020-09-07,Sacramento,067,1510023,19998,19292,19,19311,345
2020-09-07,San Benito,069,59416,1231,1180,0,1180,4
2020-09-07,San Bernardino,071,2135413,50753,49043,324,49367,821
2020-09-07,San Diego,073,3302833,42672,40868,626,41494,708
2020-09-07,San Francisco,075,870044,10308,9813,22,9835,85
2020-09-07,San Joaquin,077,732212,19266,18552,40,18592,386
2020-09-07,San Luis Obispo,079,281455,3334,3116,20,3136,23
2020-09-07,San Mateo,081,765935,9227,8409,9,8418,125
2020-09-07,Santa Barbara,083,443738,8642,8479,72,8551,95
2020-09-07,Santa Clara,085,1922200,19998,18596,39,18635,226
2020-09-07,Santa Cruz,087,273765,2060,1902,18,1920,7
2020-09-07,Shasta,089,179085,666,556,3,559,10
2020-09-07,Sierra,091,2930,6,6,0,6,0
2020-09-07,Siskiyou,093,43540,146,133,9,142,0
2020-09-07,Solano,095,438530,5784,5640,41,5681,36
2020-09-07,Sonoma,097,501317,6593,6268,20,6288,85
2020-09-07,Stanislaus,099,539301,15825,15343,412,15755,236
2020-09-07,Sutter,101,95872,1531,1468,1,1469,11
2020-09-07,Tehama,103,63373,466,453,2,455,1
2020-09-07,Trinity,105,12862,51,13,7,20,0
2020-09-07,Tulare,107,460477,15315,14637,72,14709,249
2020-09-07,Tuolumne,109,53932,220,196,3,199,1
2020-09-07,Ventura,111,848112,12096,11463,115,11578,118
2020-09-07,Yolo,113,214977,2666,2565,5,2570,53
2020-09-07,Yuba,115,75493,975,923,3,926,1
2020-09-06,Alameda,001,1643700,19915,19029,141,19170,281
2020-09-06,Alpine,003,1148,2,2,0,2,0
2020-09-06,Amador,005,37829,277,275,0,275,16
2020-09-06,Butte,007,227075,2683,2446,22,2468,30
2020-09-06,Calaveras,009,45235,288,235,0,235,1
2020-09-06,Colusa,011,21464,492,475,0,475,6
2020-09-06,Contra Costa,013,1133247,15462,14565,66,14631,171
2020-09-06,Del Norte,015,27424,121,109,0,109,2
2020-09-06,El Dorado,017,186661,1060,1008,0,1008,2
2020-09-06,Fresno,019,978130,28950,26471,328,26799,329
2020-09-06,Glenn,021,27897,516,474,0,474,3
2020-09-06,Humboldt,023,135768,448,404,1,405,4
2020-09-06,Imperial,025,180216,11434,10152,8,10160,267
2020-09-06,Inyo,027,18085,184,169,4,173,2
2020-09-06,Kern,029,883053,30590,29699,263,29962,348
2020-09-06,Kings,031,150075,6969,6561,36,6597,72
2020-09-06,Lake,033,64148,402,362,0,362,2
2020-09-06,Lassen,035,31185,732,709,2,711,0
2020-09-06,Los Angeles,037,10098052,250707,248316,1480,249796,6004
2020-09-06,Madera,039,155013,4138,3867,29,3896,42
2020-09-06,Marin,041,260295,6391,6276,15,6291,67
2020-09-06,Mariposa,043,17540,74,72,0,72,2
2020-09-06,Mendocino,045,87422,711,672,0,672,16
2020-09-06,Merced,047,269075,8464,8327,14,8341,104
2020-09-06,Modoc,049,8938,23,20,0,20,0
2020-09-06,Mono,051,14174,164,145,2,147,1
2020-09-06,Monterey,053,433212,8800,8403,22,8425,56
2020-09-06,Napa,055,140530,1566,1501,6,1507,11
2020-09-06,Nevada,057,99092,486,467,14,481,6
2020-09-06,Orange,059,3164182,51661,48931,1304,50235,1042
2020-09-06,Placer,061,380077,3316,3169,13,3182,36
2020-09-06,Plumas,063,18699,44,42,0,42,0
2020-09-06,Riverside,065,2383286,55208,53970,84,54054,1069
2020-09-06,Sacramento,067,1510023,19903,19128,19,19147,340
2020-09-06,San Benito,069,59416,1229,1178,0,1178,4
2020-09-06,San Bernardino,071,2135413,50644,48923,324,49247,823
2020-09-06,San Diego,073,3302833,42424,40652,620,41272,707
2020-09-06,San Francisco,075,870044,10234,9813,22,9835,85
2020-09-06,San Joaquin,077,732212,19217,18558,40,18598,386
2020-09-06,San Luis Obispo,079,281455,3323,3101,20,3121,23
2020-09-06,San Mateo,081,765935,9174,8387,9,8396,125
2020-09-06,Santa Barbara,083,443738,8613,8434,72,8506,95
2020-09-06,Santa Clara,085,1922200,19897,18495,39,18534,207
2020-09-06,Santa Cruz,087,273765,2053,1902,18,1920,7
2020-09-06,Shasta,089,179085,660,550,3,553,10
2020-09-06,Sierra,091,2930,6,6,0,6,0
2020-09-06,Siskiyou,093,43540,146,132,9,141,0
2020-09-06,Solano,095,438530,5758,5619,41,5660,37
2020-09-06,Sonoma,097,501317,6564,6212,20,6232,85
2020-09-06,Stanislaus,099,539301,15781,15288,408,15696,236
2020-09-06,Sutter,101,95872,1518,1451,1,1452,11
2020-09-06,Tehama,103,63373,465,455,2,457,1
2020-09-06,Trinity,105,12862,50,13,7,20,0
2020-09-06,Tulare,107,460477,15272,14636,71,14707,249
2020-09-06,Tuolumne,109,53932,217,194,3,197,1
2020-09-06,Ventura,111,848112,12051,11315,115,11430,118
2020-09-06,Yolo,113,214977,2652,2556,5,2561,53
2020-09-06,Yuba,115,75493,966,913,3,916,1
2020-09-05,Alameda,001,1643700,19868,18973,139,19112,279
2020-09-05,Alpine,003,1148,2,2,0,2,0
2020-09-05,Amador,005,37829,277,274,0,274,16
2020-09-05,Butte,007,227075,2667,2406,21,2427,30
2020-09-05,Calaveras,009,45235,288,237,0,237,1
2020-09-05,Colusa,011,21464,488,472,0,472,6
2020-09-05,Contra Costa,013,1133247,15385,14456,64,14520,173
2020-09-05,Del Norte,015,27424,121,109,0,109,2
2020-09-05,El Dorado,017,186661,1060,1007,0,1007,2
2020-09-05,Fresno,019,978130,28882,26325,328,26653,331
2020-09-05,Glenn,021,27897,515,474,0,474,3
2020-09-05,Humboldt,023,135768,446,402,1,403,4
2020-09-05,Imperial,025,180216,11417,10151,8,10159,268
2020-09-05,Inyo,027,18085,184,169,4,173,2
2020-09-05,Kern,029,883053,30530,29645,259,29904,347
2020-09-05,Kings,031,150075,6960,6518,36,6554,66
2020-09-05,Lake,033,64148,399,359,0,359,2
2020-09-05,Lassen,035,31185,732,709,2,711,0
2020-09-05,Los Angeles,037,10098052,250172,247572,1468,249040,6001
2020-09-05,Madera,039,155013,4097,3851,29,3880,42
2020-09-05,Marin,041,260295,6384,6259,15,6274,66
2020-09-05,Mariposa,043,17540,74,72,0,72,2
2020-09-05,Mendocino,045,87422,710,658,0,658,16
2020-09-05,Merced,047,269075,8432,8297,12,8309,104
2020-09-05,Modoc,049,8938,23,19,0,19,0
2020-09-05,Mono,051,14174,164,145,2,147,1
2020-09-05,Monterey,053,433212,8770,8301,22,8323,56
2020-09-05,Napa,055,140530,1560,1484,6,1490,11
2020-09-05,Nevada,057,99092,483,461,14,475,6
2020-09-05,Orange,059,3164182,51559,48726,1299,50025,1039
2020-09-05,Placer,061,380077,3306,3141,13,3154,35
2020-09-05,Plumas,063,18699,44,42,0,42,0
2020-09-05,Riverside,065,2383286,55102,53780,84,53864,1066
2020-09-05,Sacramento,067,1510023,19812,18955,19,18974,339
2020-09-05,San Benito,069,59416,1227,1153,0,1153,4
2020-09-05,San Bernardino,071,2135413,50569,48800,323,49123,825
2020-09-05,San Diego,073,3302833,42231,40344,608,40952,717
2020-09-05,San Francisco,075,870044,10201,9812,21,9833,85
2020-09-05,San Joaquin,077,732212,19189,18557,40,18597,386
2020-09-05,San Luis Obispo,079,281455,3313,3083,20,3103,23
2020-09-05,San Mateo,081,765935,9129,8352,9,8361,124
2020-09-05,Santa Barbara,083,443738,8597,8404,72,8476,96
2020-09-05,Santa Clara,085,1922200,19813,18311,39,18350,207
2020-09-05,Santa Cruz,087,273765,2045,1904,18,1922,7
2020-09-05,Shasta,089,179085,659,544,3,547,10
2020-09-05,Sierra,091,2930,6,6,0,6,0
2020-09-05,Siskiyou,093,43540,145,131,9,140,0
2020-09-05,Solano,095,438530,5746,5579,41,5620,37
2020-09-05,Sonoma,097,501317,6531,6149,20,6169,85
2020-09-05,Stanislaus,099,539301,15733,15198,404,15602,236
2020-09-05,Sutter,101,95872,1511,1445,1,1446,11
2020-09-05,Tehama,103,63373,464,447,2,449,1
2020-09-05,Trinity,105,12862,50,13,7,20,0
2020-09-05,Tulare,107,460477,15215,14576,69,14645,249
2020-09-05,Tuolumne,109,53932,217,194,3,197,1
2020-09-05,Ventura,111,848112,12008,11254,115,11369,118
2020-09-05,Yolo,113,214977,2642,2534,5,2539,53
2020-09-05,Yuba,115,75493,960,902,3,905,1
2020-09-04,Alameda,001,1643700,19800,18843,137,18980,276
2020-09-04,Alpine,003,1148,2,2,0,2,0
2020-09-04,Amador,005,37829,276,274,0,274,16
2020-09-04,Butte,007,227075,2644,2325,21,2346,28
2020-09-04,Calaveras,009,45235,286,237,0,237,1
2020-09-04,Colusa,011,21464,486,467,0,467,6
2020-09-04,Contra Costa,013,1133247,15305,14355,63,14418,164
2020-09-04,Del Norte,015,27424,121,109,0,109,2
2020-09-04,El Dorado,017,186661,1056,992,0,992,2
2020-09-04,Fresno,019,978130,28777,26147,327,26474,321
2020-09-04,Glenn,021,27897,507,463,0,463,3
2020-09-04,Humboldt,023,135768,441,390,1,391,4
2020-09-04,Imperial,025,180216,11408,10136,8,10144,267
2020-09-04,Inyo,027,18085,184,169,4,173,2
2020-09-04,Kern,029,883053,30462,29526,256,29782,345
2020-09-04,Kings,031,150075,6947,6259,36,6295,66
2020-09-04,Lake,033,64148,399,347,0,347,2
2020-09-04,Lassen,035,31185,732,708,2,710,0
2020-09-04,Los Angeles,037,10098052,249606,246396,1448,247844,5977
2020-09-04,Madera,039,155013,4084,3838,29,3867,42
2020-09-04,Marin,041,260295,6372,6251,15,6266,66
2020-09-04,Mariposa,043,17540,74,72,0,72,2
2020-09-04,Mendocino,045,87422,708,646,0,646,16
2020-09-04,Merced,047,269075,8412,8214,12,8226,104
2020-09-04,Modoc,049,8938,23,15,0,15,0
2020-09-04,Mono,051,14174,164,145,2,147,1
2020-09-04,Monterey,053,433212,8725,8208,22,8230,56
2020-09-04,Napa,055,140530,1551,1475,6,1481,11
2020-09-04,Nevada,057,99092,480,455,14,469,6
2020-09-04,Orange,059,3164182,51435,48488,1292,49780,1031
2020-09-04,Placer,061,380077,3294,3101,13,3114,35
2020-09-04,Plumas,063,18699,44,42,0,42,0
2020-09-04,Riverside,065,2383286,54989,53606,79,53685,1066
2020-09-04,Sacramento,067,1510023,19724,18765,19,18784,337
2020-09-04,San Benito,069,59416,1218,1137,0,1137,4
2020-09-04,San Bernardino,071,2135413,50476,48497,321,48818,800
2020-09-04,San Diego,073,3302833,42001,39901,599,40500,701
2020-09-04,San Francisco,075,870044,10161,9694,20,9714,85
2020-09-04,San Joaquin,077,732212,19135,18438,40,18478,376
2020-09-04,San Luis Obispo,079,281455,3298,3049,19,3068,21
2020-09-04,San Mateo,081,765935,9085,8275,9,8284,122
2020-09-04,Santa Barbara,083,443738,8567,8340,72,8412,96
2020-09-04,Santa Clara,085,1922200,19705,18074,39,18113,209
2020-09-04,Santa Cruz,087,273765,2028,1896,17,1913,7
2020-09-04,Shasta,089,179085,656,536,3,539,10
2020-09-04,Sierra,091,2930,6,6,0,6,0
2020-09-04,Siskiyou,093,43540,145,129,9,138,0
2020-09-04,Solano,095,438530,5733,5552,41,5593,37
2020-09-04,Sonoma,097,501317,6466,6050,20,6070,85
2020-09-04,Stanislaus,099,539301,15699,15074,395,15469,233
2020-09-04,Sutter,101,95872,1495,1425,1,1426,11
2020-09-04,Tehama,103,63373,460,442,2,444,1
2020-09-04,Trinity,105,12862,50,13,7,20,0
2020-09-04,Tulare,107,460477,15187,14501,65,14566,247
2020-09-04,Tuolumne,109,53932,217,193,3,196,1
2020-09-04,Ventura,111,848112,11966,11171,115,11286,114
2020-09-04,Yolo,113,214977,2628,2495,5,2500,53
2020-09-04,Yuba,115,75493,955,884,3,887,1
2020-09-03,Alameda,001,1643700,19697,18687,137,18824,275
2020-09-03,Alpine,003,1148,2,2,0,2,0
2020-09-03,Amador,005,37829,276,274,0,274,16
2020-09-03,Butte,007,227075,2599,2274,21,2295,27
2020-09-03,Calaveras,009,45235,285,238,0,238,1
2020-09-03,Colusa,011,21464,484,464,0,464,6
2020-09-03,Contra Costa,013,1133247,15198,14206,60,14266,159
2020-09-03,Del Norte,015,27424,118,109,0,109,2
2020-09-03,El Dorado,017,186661,1052,983,0,983,2
2020-09-03,Fresno,019,978130,28658,25978,322,26300,313
2020-09-03,Glenn,021,27897,503,460,0,460,3
2020-09-03,Humboldt,023,135768,436,390,1,391,4
2020-09-03,Imperial,025,180216,11387,10083,8,10091,255
2020-09-03,Inyo,027,18085,182,171,4,175,3
2020-09-03,Kern,029,883053,30370,29426,242,29668,340
2020-09-03,Kings,031,150075,6867,6200,36,6236,64
2020-09-03,Lake,033,64148,390,347,0,347,2
2020-09-03,Lassen,035,31185,732,707,2,709,0
2020-09-03,Los Angeles,037,10098052,248747,245026,1427,246453,5931
2020-09-03,Madera,039,155013,4065,3780,29,3809,43
2020-09-03,Marin,041,260295,6353,6175,15,6190,66
2020-09-03,Mariposa,043,17540,74,71,0,71,2
2020-09-03,Mendocino,045,87422,699,638,0,638,16
2020-09-03,Merced,047,269075,8370,8136,12,8148,105
2020-09-03,Modoc,049,8938,23,14,0,14,0
2020-09-03,Mono,051,14174,163,144,2,146,1
2020-09-03,Monterey,053,433212,8671,8128,22,8150,56
2020-09-03,Napa,055,140530,1544,1466,6,1472,10
2020-09-03,Nevada,057,99092,477,453,14,467,6
2020-09-03,Orange,059,3164182,51248,48226,1277,49503,1009
2020-09-03,Placer,061,380077,3276,3069,13,3082,34
2020-09-03,Plumas,063,18699,44,39,0,39,0
2020-09-03,Riverside,065,2383286,54809,53341,75,53416,1052
2020-09-03,Sacramento,067,1510023,19596,18553,18,18571,328
2020-09-03,San Benito,069,59416,1207,1121,0,1121,4
2020-09-03,San Bernardino,071,2135413,50310,48165,320,48485,800
2020-09-03,San Diego,073,3302833,41687,39448,583,40031,700
2020-09-03,San Francisco,075,870044,10095,9636,18,9654,84
2020-09-03,San Joaquin,077,732212,19058,18331,40,18371,371
2020-09-03,San Luis Obispo,079,281455,3281,3023,19,3042,21
2020-09-03,San Mateo,081,765935,9011,8211,9,8220,122
2020-09-03,Santa Barbara,083,443738,8519,8277,72,8349,96
2020-09-03,Santa Clara,085,1922200,19525,17879,39,17918,208
2020-09-03,Santa Cruz,087,273765,2013,1870,17,1887,7
2020-09-03,Shasta,089,179085,651,535,3,538,10
2020-09-03,Sierra,091,2930,6,6,0,6,0
2020-09-03,Siskiyou,093,43540,145,128,9,137,0
2020-09-03,Solano,095,438530,5713,5499,40,5539,36
2020-09-03,Sonoma,097,501317,6405,5997,20,6017,62
2020-09-03,Stanislaus,099,539301,15647,14985,391,15376,217
2020-09-03,Sutter,101,95872,1485,1412,1,1413,11
2020-09-03,Tehama,103,63373,456,436,2,438,1
2020-09-03,Trinity,105,12862,48,13,7,20,0
2020-09-03,Tulare,107,460477,15121,14408,64,14472,244
2020-09-03,Tuolumne,109,53932,217,193,3,196,1
2020-09-03,Ventura,111,848112,11848,11109,112,11221,112
2020-09-03,Yolo,113,214977,2612,2475,5,2480,53
2020-09-03,Yuba,115,75493,948,867,3,870,1
2020-09-02,Alameda,001,1643700,19577,18522,134,18656,260
2020-09-02,Alpine,003,1148,2,2,0,2,0
2020-09-02,Amador,005,37829,276,245,0,245,14
2020-09-02,Butte,007,227075,2553,2241,21,2262,27
2020-09-02,Calaveras,009,45235,284,235,0,235,1
2020-09-02,Colusa,011,21464,480,460,0,460,6
2020-09-02,Contra Costa,013,1133247,15109,14097,58,14155,159
2020-09-02,Del Norte,015,27424,117,109,0,109,2
2020-09-02,El Dorado,017,186661,1048,975,0,975,2
2020-09-02,Fresno,019,978130,28510,25785,319,26104,292
2020-09-02,Glenn,021,27897,498,457,0,457,3
2020-09-02,Humboldt,023,135768,433,381,1,382,4
2020-09-02,Imperial,025,180216,11371,9832,8,9840,255
2020-09-02,Inyo,027,18085,182,171,4,175,3
2020-09-02,Kern,029,883053,30278,29288,236,29524,335
2020-09-02,Kings,031,150075,6782,6142,36,6178,64
2020-09-02,Lake,033,64148,386,342,0,342,2
2020-09-02,Lassen,035,31185,730,706,2,708,0
2020-09-02,Los Angeles,037,10098052,247816,243999,1399,245398,5887
2020-09-02,Madera,039,155013,4045,3735,29,3764,41
2020-09-02,Marin,041,260295,6338,6131,15,6146,66
2020-09-02,Mariposa,043,17540,74,71,0,71,2
2020-09-02,Mendocino,045,87422,689,636,0,636,15
2020-09-02,Merced,047,269075,8339,8097,11,8108,103
2020-09-02,Modoc,049,8938,22,11,0,11,0
2020-09-02,Mono,051,14174,163,145,2,147,1
2020-09-02,Monterey,053,433212,8607,8070,22,8092,56
2020-09-02,Napa,055,140530,1532,1454,6,1460,10
2020-09-02,Nevada,057,99092,471,452,13,465,6
2020-09-02,Orange,059,3164182,51067,47871,1267,49138,994
2020-09-02,Placer,061,380077,3251,3047,12,3059,33
2020-09-02,Plumas,063,18699,44,39,0,39,0
2020-09-02,Riverside,065,2383286,54607,52923,72,52995,1032
2020-09-02,Sacramento,067,1510023,19363,18355,17,18372,316
2020-09-02,San Benito,069,59416,1194,1107,0,1107,4
2020-09-02,San Bernardino,071,2135413,50147,47766,317,48083,794
2020-09-02,San Diego,073,3302833,41367,39123,569,39692,695
2020-09-02,San Francisco,075,870044,10026,9587,18,9605,84
2020-09-02,San Joaquin,077,732212,18977,18194,39,18233,352
2020-09-02,San Luis Obispo,079,281455,3255,3002,18,3020,21
2020-09-02,San Mateo,081,765935,8954,8148,9,8157,122
2020-09-02,Santa Barbara,083,443738,8464,8206,71,8277,94
2020-09-02,Santa Clara,085,1922200,19371,17673,39,17712,206
2020-09-02,Santa Cruz,087,273765,1990,1850,17,1867,7
2020-09-02,Shasta,089,179085,650,531,3,534,10
2020-09-02,Sierra,091,2930,6,6,0,6,0
2020-09-02,Siskiyou,093,43540,144,127,9,136,0
2020-09-02,Solano,095,438530,5685,5463,40,5503,36
2020-09-02,Sonoma,097,501317,6343,5846,20,5866,62
2020-09-02,Stanislaus,099,539301,15577,14854,384,15238,220
2020-09-02,Sutter,101,95872,1470,1401,1,1402,10
2020-09-02,Tehama,103,63373,453,429,2,431,1
2020-09-02,Trinity,105,12862,48,13,7,20,0
2020-09-02,Tulare,107,460477,15054,14298,63,14361,244
2020-09-02,Tuolumne,109,53932,217,190,3,193,1
2020-09-02,Ventura,111,848112,11761,11031,111,11142,111
2020-09-02,Yolo,113,214977,2591,2449,5,2454,54
2020-09-02,Yuba,115,75493,941,856,3,859,1
2020-09-01,Alameda,001,1643700,19438,18382,131,18513,248
2020-09-01,Alpine,003,1148,2,2,0,2,0
2020-09-01,Amador,005,37829,275,244,0,244,13
2020-09-01,Butte,007,227075,2496,2146,21,2167,26
2020-09-01,Calaveras,009,45235,276,228,0,228,1
2020-09-01,Colusa,011,21464,476,454,0,454,6
2020-09-01,Contra Costa,013,1133247,15015,13998,56,14054,158
2020-09-01,Del Norte,015,27424,116,108,0,108,2
2020-09-01,El Dorado,017,186661,1040,972,0,972,2
2020-09-01,Fresno,019,978130,28363,25542,316,25858,290
2020-09-01,Glenn,021,27897,491,449,0,449,3
2020-09-01,Humboldt,023,135768,427,378,1,379,4
2020-09-01,Imperial,025,180216,11345,9782,8,9790,250
2020-09-01,Inyo,027,18085,182,171,4,175,3
2020-09-01,Kern,029,883053,30187,29162,231,29393,332
2020-09-01,Kings,031,150075,6751,6088,36,6124,62
2020-09-01,Lake,033,64148,383,341,0,341,2
2020-09-01,Lassen,035,31185,727,706,2,708,0
2020-09-01,Los Angeles,037,10098052,246725,242633,1375,244008,5832
2020-09-01,Madera,039,155013,4016,3703,28,3731,41
2020-09-01,Marin,041,260295,6323,6102,15,6117,67
2020-09-01,Mariposa,043,17540,73,72,0,72,2
2020-09-01,Mendocino,045,87422,674,626,0,626,15
2020-09-01,Merced,047,269075,8286,8046,10,8056,103
2020-09-01,Modoc,049,8938,20,10,0,10,0
2020-09-01,Mono,051,14174,163,145,2,147,1
2020-09-01,Monterey,053,433212,8500,7926,22,7948,56
2020-09-01,Napa,055,140530,1517,1446,6,1452,10
2020-09-01,Nevada,057,99092,465,450,13,463,6
2020-09-01,Orange,059,3164182,50903,47671,1248,48919,976
2020-09-01,Placer,061,380077,3229,3013,12,3025,33
2020-09-01,Plumas,063,18699,44,39,0,39,0
2020-09-01,Riverside,065,2383286,54389,52785,71,52856,1027
2020-09-01,Sacramento,067,1510023,19179,18217,16,18233,305
2020-09-01,San Benito,069,59416,1182,1089,0,1089,4
2020-09-01,San Bernardino,071,2135413,49940,47371,316,47687,786
2020-09-01,San Diego,073,3302833,41009,38873,531,39404,688
2020-09-01,San Francisco,075,870044,9957,9492,18,9510,83
2020-09-01,San Joaquin,077,732212,18895,17915,38,17953,341
2020-09-01,San Luis Obispo,079,281455,3229,2970,18,2988,21
2020-09-01,San Mateo,081,765935,8874,8132,9,8141,122
2020-09-01,Santa Barbara,083,443738,8414,8142,70,8212,93
2020-09-01,Santa Clara,085,1922200,19192,17319,39,17358,204
2020-09-01,Santa Cruz,087,273765,1966,1752,17,1769,7
2020-09-01,Shasta,089,179085,642,527,3,530,9
2020-09-01,Sierra,091,2930,6,6,0,6,0
2020-09-01,Siskiyou,093,43540,141,128,8,136,0
2020-09-01,Solano,095,438530,5659,5438,40,5478,34
2020-09-01,Sonoma,097,501317,6253,5733,20,5753,60
2020-09-01,Stanislaus,099,539301,15501,14784,374,15158,212
2020-09-01,Sutter,101,95872,1459,1389,1,1390,10
2020-09-01,Tehama,103,63373,449,422,2,424,1
2020-09-01,Trinity,105,12862,47,13,6,19,0
2020-09-01,Tulare,107,460477,14971,14156,63,14219,241
2020-09-01,Tuolumne,109,53932,211,183,3,186,1
2020-09-01,Ventura,111,848112,11683,10899,106,11005,108
2020-09-01,Yolo,113,214977,2575,2440,5,2445,51
2020-09-01,Yuba,115,75493,932,841,3,844,1
2020-08-31,Alameda,001,1643700,19293,18148,131,18279,248
2020-08-31,Alpine,003,1148,2,2,0,2,0
2020-08-31,Amador,005,37829,275,243,0,243,13
2020-08-31,Butte,007,227075,2432,2069,21,2090,26
2020-08-31,Calaveras,009,45235,271,212,0,212,1
2020-08-31,Colusa,011,21464,475,443,0,443,6
2020-08-31,Contra Costa,013,1133247,14888,13902,53,13955,153
2020-08-31,Del Norte,015,27424,116,108,0,108,2
2020-08-31,El Dorado,017,186661,1033,965,0,965,2
2020-08-31,Fresno,019,978130,28142,25185,310,25495,290
2020-08-31,Glenn,021,27897,479,437,0,437,3
2020-08-31,Humboldt,023,135768,425,374,1,375,4
2020-08-31,Imperial,025,180216,11314,9759,8,9767,250
2020-08-31,Inyo,027,18085,181,160,4,164,3
2020-08-31,Kern,029,883053,30089,29067,230,29297,318
2020-08-31,Kings,031,150075,6483,6037,36,6073,62
2020-08-31,Lake,033,64148,367,341,0,341,2
2020-08-31,Lassen,035,31185,724,706,2,708,0
2020-08-31,Los Angeles,037,10098052,245624,241793,1347,243140,5787
2020-08-31,Madera,039,155013,3993,3662,27,3689,35
2020-08-31,Marin,041,260295,6287,6074,15,6089,67
2020-08-31,Mariposa,043,17540,73,69,0,69,2
2020-08-31,Mendocino,045,87422,662,618,0,618,15
2020-08-31,Merced,047,269075,8224,7991,10,8001,79
2020-08-31,Modoc,049,8938,18,10,0,10,0
2020-08-31,Mono,051,14174,163,145,2,147,1
2020-08-31,Monterey,053,433212,8393,7839,22,7861,56
2020-08-31,Napa,055,140530,1509,1434,6,1440,10
2020-08-31,Nevada,057,99092,463,447,13,460,6
2020-08-31,Orange,059,3164182,50703,47392,1220,48612,965
2020-08-31,Placer,061,380077,3180,2989,12,3001,33
2020-08-31,Plumas,063,18699,43,39,0,39,0
2020-08-31,Riverside,065,2383286,54167,52508,69,52577,1020
2020-08-31,Sacramento,067,1510023,18942,17999,16,18015,303
2020-08-31,San Benito,069,59416,1166,1080,0,1080,4
2020-08-31,San Bernardino,071,2135413,49728,47370,315,47685,755
2020-08-31,San Diego,073,3302833,40642,38606,498,39104,682
2020-08-31,San Francisco,075,870044,9878,9293,15,9308,83
2020-08-31,San Joaquin,077,732212,18808,17807,37,17844,338
2020-08-31,San Luis Obispo,079,281455,3206,2951,17,2968,21
2020-08-31,San Mateo,081,765935,8804,8065,9,8074,122
2020-08-31,Santa Barbara,083,443738,8368,8124,70,8194,94
2020-08-31,Santa Clara,085,1922200,19003,17211,39,17250,202
2020-08-31,Santa Cruz,087,273765,1941,1742,17,1759,7
2020-08-31,Shasta,089,179085,637,528,3,531,9
2020-08-31,Sierra,091,2930,6,6,0,6,0
2020-08-31,Siskiyou,093,43540,140,127,8,135,0
2020-08-31,Solano,095,438530,5627,5302,39,5341,34
2020-08-31,Sonoma,097,501317,6178,5650,20,5670,60
2020-08-31,Stanislaus,099,539301,15426,14685,365,15050,213
2020-08-31,Sutter,101,95872,1444,1365,1,1366,10
2020-08-31,Tehama,103,63373,446,421,2,423,1
2020-08-31,Trinity,105,12862,47,13,6,19,0
2020-08-31,Tulare,107,460477,14884,13985,61,14046,237
2020-08-31,Tuolumne,109,53932,211,178,3,181,1
2020-08-31,Ventura,111,848112,11595,10866,105,10971,108
2020-08-31,Yolo,113,214977,2557,2423,5,2428,51
2020-08-31,Yuba,115,75493,918,830,3,833,1
2020-08-30,Alameda,001,1643700,19169,18099,129,18228,248
2020-08-30,Alpine,003,1148,2,2,0,2,0
2020-08-30,Amador,005,37829,274,240,0,240,13
2020-08-30,Butte,007,227075,2351,1988,21,2009,26
2020-08-30,Calaveras,009,45235,262,211,0,211,1
2020-08-30,Colusa,011,21464,474,440,0,440,6
2020-08-30,Contra Costa,013,1133247,14750,13780,53,13833,150
2020-08-30,Del Norte,015,27424,115,108,0,108,2
2020-08-30,El Dorado,017,186661,1023,962,0,962,2
2020-08-30,Fresno,019,978130,28016,24963,309,25272,291
2020-08-30,Glenn,021,27897,472,437,0,437,3
2020-08-30,Humboldt,023,135768,414,362,1,363,4
2020-08-30,Imperial,025,180216,11296,9703,8,9711,250
2020-08-30,Inyo,027,18085,181,160,4,164,3
2020-08-30,Kern,029,883053,29996,28987,230,29217,317
2020-08-30,Kings,031,150075,6437,6000,36,6036,62
2020-08-30,Lake,033,64148,362,334,0,334,2
2020-08-30,Lassen,035,31185,722,706,2,708,0
2020-08-30,Los Angeles,037,10098052,244488,240775,1314,242089,5772
2020-08-30,Madera,039,155013,3964,3626,27,3653,33
2020-08-30,Marin,041,260295,6257,6060,15,6075,66
2020-08-30,Mariposa,043,17540,73,69,0,69,2
2020-08-30,Mendocino,045,87422,656,611,0,611,13
2020-08-30,Merced,047,269075,8149,7960,10,7970,79
2020-08-30,Modoc,049,8938,13,10,0,10,0
2020-08-30,Mono,051,14174,163,145,2,147,1
2020-08-30,Monterey,053,433212,8309,7816,22,7838,54
2020-08-30,Napa,055,140530,1497,1423,6,1429,10
2020-08-30,Nevada,057,99092,460,445,13,458,6
2020-08-30,Orange,059,3164182,50507,47283,1206,48489,965
2020-08-30,Placer,061,380077,3147,2961,12,2973,32
2020-08-30,Plumas,063,18699,42,39,0,39,0
2020-08-30,Riverside,065,2383286,53988,52227,67,52294,1017
2020-08-30,Sacramento,067,1510023,18764,17751,16,17767,300
2020-08-30,San Benito,069,59416,1156,1071,0,1071,4
2020-08-30,San Bernardino,071,2135413,49471,47201,315,47516,755
2020-08-30,San Diego,073,3302833,40244,38302,477,38779,682
2020-08-30,San Francisco,075,870044,9780,9294,12,9306,83
2020-08-30,San Joaquin,077,732212,18691,17637,36,17673,338
2020-08-30,San Luis Obispo,079,281455,3181,2934,17,2951,21
2020-08-30,San Mateo,081,765935,8727,8013,8,8021,122
2020-08-30,Santa Barbara,083,443738,8308,8088,70,8158,93
2020-08-30,Santa Clara,085,1922200,18827,17045,39,17084,202
2020-08-30,Santa Cruz,087,273765,1915,1743,17,1760,7
2020-08-30,Shasta,089,179085,634,525,3,528,9
2020-08-30,Sierra,091,2930,6,6,0,6,0
2020-08-30,Siskiyou,093,43540,138,125,8,133,0
2020-08-30,Solano,095,438530,5583,5303,39,5342,34
2020-08-30,Sonoma,097,501317,6120,5590,20,5610,60
2020-08-30,Stanislaus,099,539301,15355,14580,356,14936,209
2020-08-30,Sutter,101,95872,1422,1351,1,1352,10
2020-08-30,Tehama,103,63373,437,419,2,421,1
2020-08-30,Trinity,105,12862,47,13,6,19,0
2020-08-30,Tulare,107,460477,14789,13985,60,14045,236
2020-08-30,Tuolumne,109,53932,207,178,3,181,1
2020-08-30,Ventura,111,848112,11482,10775,100,10875,108
2020-08-30,Yolo,113,214977,2529,2391,4,2395,51
2020-08-30,Yuba,115,75493,904,832,3,835,1
2020-08-29,Alameda,001,1643700,19102,17888,129,18017,250
2020-08-29,Alpine,003,1148,2,2,0,2,0
2020-08-29,Amador,005,37829,274,239,0,239,13
2020-08-29,Butte,007,227075,2320,1948,21,1969,26
2020-08-29,Calaveras,009,45235,258,211,0,211,1
2020-08-29,Colusa,011,21464,471,440,0,440,6
2020-08-29,Contra Costa,013,1133247,14677,13663,52,13715,159
2020-08-29,Del Norte,015,27424,115,108,0,108,1
2020-08-29,El Dorado,017,186661,1020,958,0,958,2
2020-08-29,Fresno,019,978130,27961,24821,309,25130,291
2020-08-29,Glenn,021,27897,466,437,0,437,3
2020-08-29,Humboldt,023,135768,411,363,1,364,4
2020-08-29,Imperial,025,180216,11281,9698,8,9706,250
2020-08-29,Inyo,027,18085,181,160,4,164,3
2020-08-29,Kern,029,883053,29955,28947,229,29176,317
2020-08-29,Kings,031,150075,6422,5906,36,5942,62
2020-08-29,Lake,033,64148,361,329,0,329,2
2020-08-29,Lassen,035,31185,722,706,2,708,0
2020-08-29,Los Angeles,037,10098052,243858,239815,1301,241116,5762
2020-08-29,Madera,039,155013,3955,3605,26,3631,33
2020-08-29,Marin,041,260295,6245,6007,15,6022,64
2020-08-29,Mariposa,043,17540,73,69,0,69,2
2020-08-29,Mendocino,045,87422,651,596,0,596,13
2020-08-29,Merced,047,269075,8119,7867,10,7877,79
2020-08-29,Modoc,049,8938,13,9,0,9,0
2020-08-29,Mono,051,14174,163,145,2,147,1
2020-08-29,Monterey,053,433212,8264,7680,22,7702,53
2020-08-29,Napa,055,140530,1494,1413,6,1419,10
2020-08-29,Nevada,057,99092,460,442,13,455,5
2020-08-29,Orange,059,3164182,50397,47007,1196,48203,960
2020-08-29,Placer,061,380077,3130,2935,12,2947,32
2020-08-29,Plumas,063,18699,41,39,0,39,0
2020-08-29,Riverside,065,2383286,53876,51918,65,51983,1016
2020-08-29,Sacramento,067,1510023,18692,17588,16,17604,291
2020-08-29,San Benito,069,59416,1147,1045,0,1045,4
2020-08-29,San Bernardino,071,2135413,49356,46849,315,47164,755
2020-08-29,San Diego,073,3302833,39978,38049,459,38508,694
2020-08-29,San Francisco,075,870044,9752,9291,11,9302,83
2020-08-29,San Joaquin,077,732212,18647,17493,36,17529,335
2020-08-29,San Luis Obispo,079,281455,3156,2917,17,2934,21
2020-08-29,San Mateo,081,765935,8685,7928,8,7936,122
2020-08-29,Santa Barbara,083,443738,8282,8052,69,8121,93
2020-08-29,Santa Clara,085,1922200,18730,16898,38,16936,202
2020-08-29,Santa Cruz,087,273765,1903,1746,17,1763,7
2020-08-29,Shasta,089,179085,626,522,3,525,9
2020-08-29,Sierra,091,2930,6,6,0,6,0
2020-08-29,Siskiyou,093,43540,138,121,8,129,0
2020-08-29,Solano,095,438530,5562,5303,39,5342,34
2020-08-29,Sonoma,097,501317,6085,5537,20,5557,60
2020-08-29,Stanislaus,099,539301,15306,14479,346,14825,208
2020-08-29,Sutter,101,95872,1417,1333,1,1334,9
2020-08-29,Tehama,103,63373,436,417,2,419,1
2020-08-29,Trinity,105,12862,46,11,6,17,0
2020-08-29,Tulare,107,460477,14751,13890,59,13949,236
2020-08-29,Tuolumne,109,53932,207,178,3,181,1
2020-08-29,Ventura,111,848112,11440,10705,100,10805,108
2020-08-29,Yolo,113,214977,2511,2357,4,2361,51
2020-08-29,Yuba,115,75493,895,822,3,825,1
2020-08-28,Alameda,001,1643700,19019,17729,128,17857,237
2020-08-28,Alpine,003,1148,2,2,0,2,0
2020-08-28,Amador,005,37829,274,234,0,234,13
2020-08-28,Butte,007,227075,2290,1886,21,1907,25
2020-08-28,Calaveras,009,45235,256,207,0,207,1
2020-08-28,Colusa,011,21464,470,441,0,441,6
2020-08-28,Contra Costa,013,1133247,14606,13522,51,13573,158
2020-08-28,Del Norte,015,27424,115,107,0,107,1
2020-08-28,El Dorado,017,186661,1014,949,0,949,2
2020-08-28,Fresno,019,978130,27827,24612,309,24921,282
2020-08-28,Glenn,021,27897,459,429,0,429,3
2020-08-28,Humboldt,023,135768,407,362,1,363,4
2020-08-28,Imperial,025,180216,11267,9656,8,9664,241
2020-08-28,Inyo,027,18085,180,160,4,164,2
2020-08-28,Kern,029,883053,29907,28744,229,28973,306
2020-08-28,Kings,031,150075,6415,5829,35,5864,62
2020-08-28,Lake,033,64148,356,320,0,320,2
2020-08-28,Lassen,035,31185,722,704,2,706,0
2020-08-28,Los Angeles,037,10098052,243048,238544,1276,239820,5740
2020-08-28,Madera,039,155013,3936,3552,26,3578,33
2020-08-28,Marin,041,260295,6223,5991,15,6006,63
2020-08-28,Mariposa,043,17540,73,67,0,67,2
2020-08-28,Mendocino,045,87422,646,588,0,588,11
2020-08-28,Merced,047,269075,8089,7803,10,7813,77
2020-08-28,Modoc,049,8938,13,6,0,6,0
2020-08-28,Mono,051,14174,163,145,2,147,1
2020-08-28,Monterey,053,433212,8207,7591,22,7613,53
2020-08-28,Napa,055,140530,1486,1403,5,1408,10
2020-08-28,Nevada,057,99092,459,438,13,451,5
2020-08-28,Orange,059,3164182,50297,46696,1181,47877,942
2020-08-28,Placer,061,380077,3119,2891,12,2903,32
2020-08-28,Plumas,063,18699,41,39,0,39,0
2020-08-28,Riverside,065,2383286,53745,51510,61,51571,1008
2020-08-28,Sacramento,067,1510023,18595,17119,16,17135,283
2020-08-28,San Benito,069,59416,1131,1016,0,1016,3
2020-08-28,San Bernardino,071,2135413,49238,46553,311,46864,754
2020-08-28,San Diego,073,3302833,39748,37786,444,38230,676
2020-08-28,San Francisco,075,870044,9699,9135,11,9146,83
2020-08-28,San Joaquin,077,732212,18594,17114,35,17149,314
2020-08-28,San Luis Obispo,079,281455,3139,2849,17,2866,20
2020-08-28,San Mateo,081,765935,8638,7783,8,7791,121
2020-08-28,Santa Barbara,083,443738,8250,8001,69,8070,92
2020-08-28,Santa Clara,085,1922200,18599,16696,38,16734,201
2020-08-28,Santa Cruz,087,273765,1891,1747,17,1764,7
2020-08-28,Shasta,089,179085,622,516,3,519,9
2020-08-28,Sierra,091,2930,6,6,0,6,0
2020-08-28,Siskiyou,093,43540,136,119,8,127,0
2020-08-28,Solano,095,438530,5543,5219,39,5258,34
2020-08-28,Sonoma,097,501317,6050,5425,19,5444,58
2020-08-28,Stanislaus,099,539301,15264,14176,342,14518,190
2020-08-28,Sutter,101,95872,1407,1308,1,1309,9
2020-08-28,Tehama,103,63373,431,410,2,412,1
2020-08-28,Trinity,105,12862,46,11,6,17,0
2020-08-28,Tulare,107,460477,14705,13776,59,13835,236
2020-08-28,Tuolumne,109,53932,207,176,3,179,1
2020-08-28,Ventura,111,848112,11404,10606,98,10704,103
2020-08-28,Yolo,113,214977,2502,2323,4,2327,51
2020-08-28,Yuba,115,75493,886,810,3,813,1
2020-08-27,Alameda,001,1643700,18874,17584,125,17709,234
2020-08-27,Alpine,003,1148,2,2,0,2,0
2020-08-27,Amador,005,37829,273,233,0,233,13
2020-08-27,Butte,007,227075,2224,1803,20,1823,25
2020-08-27,Calaveras,009,45235,250,204,0,204,1
2020-08-27,Colusa,011,21464,468,438,0,438,6
2020-08-27,Contra Costa,013,1133247,14505,13379,50,13429,158
2020-08-27,Del Norte,015,27424,115,107,0,107,1
2020-08-27,El Dorado,017,186661,1010,942,0,942,2
2020-08-27,Fresno,019,978130,27644,24367,304,24671,272
2020-08-27,Glenn,021,27897,451,429,0,429,3
2020-08-27,Humboldt,023,135768,399,358,1,359,4
2020-08-27,Imperial,025,180216,11240,9608,8,9616,235
2020-08-27,Inyo,027,18085,180,157,3,160,2
2020-08-27,Kern,029,883053,29835,28635,220,28855,294
2020-08-27,Kings,031,150075,6393,5759,35,5794,62
2020-08-27,Lake,033,64148,354,314,0,314,2
2020-08-27,Lassen,035,31185,722,703,2,705,0
2020-08-27,Los Angeles,037,10098052,242045,237103,1260,238363,5704
2020-08-27,Madera,039,155013,3910,3465,26,3491,33
2020-08-27,Marin,041,260295,6199,5929,15,5944,62
2020-08-27,Mariposa,043,17540,73,67,0,67,2
2020-08-27,Mendocino,045,87422,637,581,0,581,10
2020-08-27,Merced,047,269075,8045,7765,10,7775,75
2020-08-27,Modoc,049,8938,11,5,0,5,0
2020-08-27,Mono,051,14174,163,145,2,147,1
2020-08-27,Monterey,053,433212,8113,7501,22,7523,52
2020-08-27,Napa,055,140530,1480,1397,5,1402,10
2020-08-27,Nevada,057,99092,456,435,13,448,5
2020-08-27,Orange,059,3164182,50140,46449,1170,47619,935
2020-08-27,Placer,061,380077,3088,2869,12,2881,32
2020-08-27,Plumas,063,18699,40,39,0,39,0
2020-08-27,Riverside,065,2383286,53536,51306,58,51364,999
2020-08-27,Sacramento,067,1510023,18397,16875,16,16891,281
2020-08-27,San Benito,069,59416,1115,987,0,987,3
2020-08-27,San Bernardino,071,2135413,49012,46345,305,46650,751
2020-08-27,San Diego,073,3302833,39477,37501,424,37925,673
2020-08-27,San Francisco,075,870044,9633,9014,11,9025,83
2020-08-27,San Joaquin,077,732212,18514,16989,35,17024,314
2020-08-27,San Luis Obispo,079,281455,3114,2808,17,2825,20
2020-08-27,San Mateo,081,765935,8529,7728,8,7736,121
2020-08-27,Santa Barbara,083,443738,8212,7934,69,8003,92
2020-08-27,Santa Clara,085,1922200,18416,16495,38,16533,199
2020-08-27,Santa Cruz,087,273765,1874,1734,17,1751,7
2020-08-27,Shasta,089,179085,616,512,3,515,9
2020-08-27,Sierra,091,2930,6,6,0,6,0
2020-08-27,Siskiyou,093,43540,136,118,8,126,0
2020-08-27,Solano,095,438530,5505,5167,39,5206,34
2020-08-27,Sonoma,097,501317,5938,5357,19,5376,58
2020-08-27,Stanislaus,099,539301,15183,14080,339,14419,186
2020-08-27,Sutter,101,95872,1387,1296,1,1297,9
2020-08-27,Tehama,103,63373,427,398,2,400,1
2020-08-27,Trinity,105,12862,46,11,6,17,0
2020-08-27,Tulare,107,460477,14613,13666,58,13724,231
2020-08-27,Tuolumne,109,53932,202,174,3,177,1
2020-08-27,Ventura,111,848112,11341,10483,94,10577,102
2020-08-27,Yolo,113,214977,2478,2293,4,2297,51
2020-08-27,Yuba,115,75493,875,807,3,810,1
2020-08-26,Alameda,001,1643700,18712,17373,125,17498,233
2020-08-26,Alpine,003,1148,2,2,0,2,0
2020-08-26,Amador,005,37829,273,229,0,229,13
2020-08-26,Butte,007,227075,2156,1765,18,1783,25
2020-08-26,Calaveras,009,45235,243,201,0,201,1
2020-08-26,Colusa,011,21464,462,433,0,433,5
2020-08-26,Contra Costa,013,1133247,14368,13248,50,13298,157
2020-08-26,Del Norte,015,27424,114,86,0,86,1
2020-08-26,El Dorado,017,186661,1008,938,0,938,2
2020-08-26,Fresno,019,978130,27496,24071,302,24373,255
2020-08-26,Glenn,021,27897,449,429,0,429,3
2020-08-26,Humboldt,023,135768,387,357,1,358,4
2020-08-26,Imperial,025,180216,11218,9453,8,9461,227
2020-08-26,Inyo,027,18085,177,157,3,160,2
2020-08-26,Kern,029,883053,29696,28507,217,28724,286
2020-08-26,Kings,031,150075,6372,5720,35,5755,62
2020-08-26,Lake,033,64148,349,308,0,308,2
2020-08-26,Lassen,035,31185,722,702,2,704,0
2020-08-26,Los Angeles,037,10098052,241032,235499,1229,236728,5665
2020-08-26,Madera,039,155013,3881,3458,26,3484,32
2020-08-26,Marin,041,260295,6182,5887,15,5902,56
2020-08-26,Mariposa,043,17540,73,68,0,68,2
2020-08-26,Mendocino,045,87422,626,581,0,581,10
2020-08-26,Merced,047,269075,8012,7720,10,7730,74
2020-08-26,Modoc,049,8938,8,5,0,5,0
2020-08-26,Mono,051,14174,163,141,2,143,1
2020-08-26,Monterey,053,433212,8020,7439,22,7461,51
2020-08-26,Napa,055,140530,1467,1382,5,1387,10
2020-08-26,Nevada,057,99092,453,432,13,445,2
2020-08-26,Orange,059,3164182,49956,46157,1155,47312,905
2020-08-26,Placer,061,380077,3066,2846,10,2856,32
2020-08-26,Plumas,063,18699,39,39,0,39,0
2020-08-26,Riverside,065,2383286,53294,51138,58,51196,987
2020-08-26,Sacramento,067,1510023,18234,16708,16,16724,271
2020-08-26,San Benito,069,59416,1100,978,0,978,3
2020-08-26,San Bernardino,071,2135413,48804,45840,301,46141,743
2020-08-26,San Diego,073,3302833,39139,37224,397,37621,668
2020-08-26,San Francisco,075,870044,9558,8938,11,8949,81
2020-08-26,San Joaquin,077,732212,18425,16845,34,16879,309
2020-08-26,San Luis Obispo,079,281455,3086,2761,17,2778,20
2020-08-26,San Mateo,081,765935,8462,7655,8,7663,121
2020-08-26,Santa Barbara,083,443738,8178,7904,69,7973,90
2020-08-26,Santa Clara,085,1922200,18240,16283,38,16321,198
2020-08-26,Santa Cruz,087,273765,1863,1726,17,1743,7
2020-08-26,Shasta,089,179085,611,511,3,514,9
2020-08-26,Sierra,091,2930,6,6,0,6,0
2020-08-26,Siskiyou,093,43540,133,109,8,117,0
2020-08-26,Solano,095,438530,5481,5131,38,5169,34
2020-08-26,Sonoma,097,501317,5865,5283,19,5302,58
2020-08-26,Stanislaus,099,539301,15106,13964,333,14297,186
2020-08-26,Sutter,101,95872,1369,1275,1,1276,9
2020-08-26,Tehama,103,63373,424,396,2,398,1
2020-08-26,Trinity,105,12862,45,10,6,16,0
2020-08-26,Tulare,107,460477,14546,13568,58,13626,232
2020-08-26,Tuolumne,109,53932,201,172,3,175,1
2020-08-26,Ventura,111,848112,11269,10412,87,10499,100
2020-08-26,Yolo,113,214977,2456,2279,4,2283,49
2020-08-26,Yuba,115,75493,860,779,3,782,1
2020-08-25,Alameda,001,1643700,18555,17278,125,17403,232
2020-08-25,Alpine,003,1148,2,2,0,2,0
2020-08-25,Amador,005,37829,273,227,0,227,13
2020-08-25,Butte,007,227075,2089,1718,18,1736,24
2020-08-25,Calaveras,009,45235,241,196,0,196,1
2020-08-25,Colusa,011,21464,455,430,0,430,5
2020-08-25,Contra Costa,013,1133247,14230,13181,49,13230,156
2020-08-25,Del Norte,015,27424,113,83,0,83,1
2020-08-25,El Dorado,017,186661,1005,928,0,928,2
2020-08-25,Fresno,019,978130,27308,23932,301,24233,250
2020-08-25,Glenn,021,27897,446,429,0,429,3
2020-08-25,Humboldt,023,135768,382,342,1,343,4
2020-08-25,Imperial,025,180216,11190,9381,8,9389,217
2020-08-25,Inyo,027,18085,175,144,3,147,1
2020-08-25,Kern,029,883053,29559,28416,217,28633,285
2020-08-25,Kings,031,150075,6215,5702,35,5737,59
2020-08-25,Lake,033,64148,344,304,0,304,2
2020-08-25,Lassen,035,31185,721,692,2,694,0
2020-08-25,Los Angeles,037,10098052,239737,233961,1179,235140,5612
2020-08-25,Madera,039,155013,3866,3446,25,3471,32
2020-08-25,Marin,041,260295,6144,5860,15,5875,56
2020-08-25,Mariposa,043,17540,73,67,0,67,2
2020-08-25,Mendocino,045,87422,618,571,0,571,10
2020-08-25,Merced,047,269075,7946,7693,9,7702,69
2020-08-25,Modoc,049,8938,8,5,0,5,0
2020-08-25,Mono,051,14174,163,129,2,131,1
2020-08-25,Monterey,053,433212,7940,7333,22,7355,51
2020-08-25,Napa,055,140530,1460,1374,5,1379,10
2020-08-25,Nevada,057,99092,449,430,13,443,2
2020-08-25,Orange,059,3164182,49762,45737,1139,46876,902
2020-08-25,Placer,061,380077,3047,2829,7,2836,31
2020-08-25,Plumas,063,18699,39,39,0,39,0
2020-08-25,Riverside,065,2383286,53062,50889,58,50947,981
2020-08-25,Sacramento,067,1510023,18081,16601,16,16617,265
2020-08-25,San Benito,069,59416,1084,973,0,973,3
2020-08-25,San Bernardino,071,2135413,48570,45544,298,45842,727
2020-08-25,San Diego,073,3302833,38860,36996,375,37371,665
2020-08-25,San Francisco,075,870044,9480,8848,11,8859,81
2020-08-25,San Joaquin,077,732212,18298,16795,34,16829,306
2020-08-25,San Luis Obispo,079,281455,3027,2731,16,2747,20
2020-08-25,San Mateo,081,765935,8402,7636,8,7644,120
2020-08-25,Santa Barbara,083,443738,8126,7854,69,7923,90
2020-08-25,Santa Clara,085,1922200,18068,16199,38,16237,194
2020-08-25,Santa Cruz,087,273765,1844,1708,17,1725,7
2020-08-25,Shasta,089,179085,607,511,3,514,9
2020-08-25,Sierra,091,2930,6,6,0,6,0
2020-08-25,Siskiyou,093,43540,132,109,8,117,0
2020-08-25,Solano,095,438530,5420,5114,38,5152,34
2020-08-25,Sonoma,097,501317,5779,5148,19,5167,56
2020-08-25,Stanislaus,099,539301,14998,13886,322,14208,182
2020-08-25,Sutter,101,95872,1352,1259,1,1260,9
2020-08-25,Tehama,103,63373,421,394,2,396,1
2020-08-25,Trinity,105,12862,44,10,6,16,0
2020-08-25,Tulare,107,460477,14443,13514,57,13571,224
2020-08-25,Tuolumne,109,53932,199,172,3,175,1
2020-08-25,Ventura,111,848112,11184,10313,82,10395,99
2020-08-25,Yolo,113,214977,2443,2254,4,2258,50
2020-08-25,Yuba,115,75493,850,775,3,778,1
2020-08-24,Alameda,001,1643700,18360,16913,124,17037,231
2020-08-24,Alpine,003,1148,2,2,0,2,0
2020-08-24,Amador,005,37829,271,227,0,227,13
2020-08-24,Butte,007,227075,2005,1649,18,1667,23
2020-08-24,Calaveras,009,45235,231,187,0,187,1
2020-08-24,Colusa,011,21464,451,425,0,425,5
2020-08-24,Contra Costa,013,1133247,14115,12906,47,12953,153
2020-08-24,Del Norte,015,27424,113,80,0,80,1
2020-08-24,El Dorado,017,186661,997,908,0,908,2
2020-08-24,Fresno,019,978130,27120,23618,294,23912,235
2020-08-24,Glenn,021,27897,444,421,0,421,2
2020-08-24,Humboldt,023,135768,378,340,1,341,4
2020-08-24,Imperial,025,180216,11157,9323,8,9331,210
2020-08-24,Inyo,027,18085,171,144,3,147,2
2020-08-24,Kern,029,883053,29461,28157,211,28368,277
2020-08-24,Kings,031,150075,6127,5652,35,5687,60
2020-08-24,Lake,033,64148,329,302,0,302,2
2020-08-24,Lassen,035,31185,721,693,2,695,0
2020-08-24,Los Angeles,037,10098052,238374,233036,1160,234196,5562
2020-08-24,Madera,039,155013,3839,3418,25,3443,32
2020-08-24,Marin,041,260295,6081,5834,15,5849,56
2020-08-24,Mariposa,043,17540,71,66,0,66,2
2020-08-24,Mendocino,045,87422,603,550,0,550,10
2020-08-24,Merced,047,269075,7868,7605,9,7614,69
2020-08-24,Modoc,049,8938,8,5,0,5,0
2020-08-24,Mono,051,14174,163,129,2,131,1
2020-08-24,Monterey,053,433212,7831,7212,21,7233,50
2020-08-24,Napa,055,140530,1447,1358,5,1363,10
2020-08-24,Nevada,057,99092,444,423,13,436,2
2020-08-24,Orange,059,3164182,49569,45536,1129,46665,887
2020-08-24,Placer,061,380077,3001,2793,7,2800,31
2020-08-24,Plumas,063,18699,39,37,0,37,0
2020-08-24,Riverside,065,2383286,52784,50496,58,50554,975
2020-08-24,Sacramento,067,1510023,17884,16318,16,16334,249
2020-08-24,San Benito,069,59416,1063,961,0,961,3
2020-08-24,San Bernardino,071,2135413,48307,45199,296,45495,720
2020-08-24,San Diego,073,3302833,38572,36729,347,37076,660
2020-08-24,San Francisco,075,870044,9397,8621,10,8631,81
2020-08-24,San Joaquin,077,732212,18157,16565,33,16598,305
2020-08-24,San Luis Obispo,079,281455,2999,2705,16,2721,20
2020-08-24,San Mateo,081,765935,8335,7502,8,7510,120
2020-08-24,Santa Barbara,083,443738,8085,7784,69,7853,90
2020-08-24,Santa Clara,085,1922200,17863,16049,38,16087,192
2020-08-24,Santa Cruz,087,273765,1824,1627,16,1643,6
2020-08-24,Shasta,089,179085,605,505,3,508,9
2020-08-24,Sierra,091,2930,6,6,0,6,0
2020-08-24,Siskiyou,093,43540,128,107,8,115,0
2020-08-24,Solano,095,438530,5371,4979,36,5015,32
2020-08-24,Sonoma,097,501317,5677,5071,19,5090,56
2020-08-24,Stanislaus,099,539301,14900,13521,308,13829,171
2020-08-24,Sutter,101,95872,1333,1219,1,1220,9
2020-08-24,Tehama,103,63373,416,388,2,390,1
2020-08-24,Trinity,105,12862,44,10,6,16,0
2020-08-24,Tulare,107,460477,14336,13360,56,13416,223
2020-08-24,Tuolumne,109,53932,198,170,3,173,1
2020-08-24,Ventura,111,848112,11104,10261,78,10339,99
2020-08-24,Yolo,113,214977,2409,2239,4,2243,47
2020-08-24,Yuba,115,75493,833,750,3,753,1
2020-08-23,Alameda,001,1643700,18137,16786,123,16909,231
2020-08-23,Alpine,003,1148,2,2,0,2,0
2020-08-23,Amador,005,37829,268,227,0,227,13
2020-08-23,Butte,007,227075,1891,1637,18,1655,23
2020-08-23,Calaveras,009,45235,221,187,0,187,1
2020-08-23,Colusa,011,21464,444,424,0,424,5
2020-08-23,Contra Costa,013,1133247,13955,12642,47,12689,153
2020-08-23,Del Norte,015,27424,113,80,0,80,1
2020-08-23,El Dorado,017,186661,984,901,0,901,2
2020-08-23,Fresno,019,978130,26915,23414,290,23704,235
2020-08-23,Glenn,021,27897,437,421,0,421,2
2020-08-23,Humboldt,023,135768,376,341,1,342,4
2020-08-23,Imperial,025,180216,11128,9243,8,9251,210
2020-08-23,Inyo,027,18085,168,144,3,147,2
2020-08-23,Kern,029,883053,29312,28028,206,28234,277
2020-08-23,Kings,031,150075,6084,5628,35,5663,60
2020-08-23,Lake,033,64148,325,299,0,299,2
2020-08-23,Lassen,035,31185,720,693,2,695,0
2020-08-23,Los Angeles,037,10098052,236779,231833,1090,232923,5549
2020-08-23,Madera,039,155013,3807,3401,24,3425,32
2020-08-23,Marin,041,260295,6042,5807,14,5821,50
2020-08-23,Mariposa,043,17540,71,66,0,66,2
2020-08-23,Mendocino,045,87422,599,550,0,550,10
2020-08-23,Merced,047,269075,7799,7574,8,7582,69
2020-08-23,Modoc,049,8938,7,5,0,5,0
2020-08-23,Mono,051,14174,163,129,2,131,1
2020-08-23,Monterey,053,433212,7741,7173,21,7194,50
2020-08-23,Napa,055,140530,1435,1348,5,1353,10
2020-08-23,Nevada,057,99092,439,421,13,434,2
2020-08-23,Orange,059,3164182,49331,45267,1118,46385,887
2020-08-23,Placer,061,380077,2962,2772,7,2779,31
2020-08-23,Plumas,063,18699,39,37,0,37,0
2020-08-23,Riverside,065,2383286,52514,50293,56,50349,955
2020-08-23,Sacramento,067,1510023,17660,16084,15,16099,243
2020-08-23,San Benito,069,59416,1050,938,0,938,3
2020-08-23,San Bernardino,071,2135413,48038,45010,286,45296,719
2020-08-23,San Diego,073,3302833,38251,36542,320,36862,660
2020-08-23,San Francisco,075,870044,9302,8564,9,8573,80
2020-08-23,San Joaquin,077,732212,18024,16069,32,16101,305
2020-08-23,San Luis Obispo,079,281455,2957,2679,16,2695,20
2020-08-23,San Mateo,081,765935,8240,7450,8,7458,120
2020-08-23,Santa Barbara,083,443738,8017,7725,69,7794,90
2020-08-23,Santa Clara,085,1922200,17668,15912,36,15948,191
2020-08-23,Santa Cruz,087,273765,1798,1627,16,1643,6
2020-08-23,Shasta,089,179085,600,501,3,504,9
2020-08-23,Sierra,091,2930,6,6,0,6,0
2020-08-23,Siskiyou,093,43540,123,107,8,115,0
2020-08-23,Solano,095,438530,5313,4977,34,5011,32
2020-08-23,Sonoma,097,501317,5589,5018,19,5037,56
2020-08-23,Stanislaus,099,539301,14765,13483,285,13768,171
2020-08-23,Sutter,101,95872,1311,1203,1,1204,9
2020-08-23,Tehama,103,63373,406,381,2,383,1
2020-08-23,Trinity,105,12862,44,10,6,16,0
2020-08-23,Tulare,107,460477,14204,13303,53,13356,223
2020-08-23,Tuolumne,109,53932,195,164,3,167,1
2020-08-23,Ventura,111,848112,11003,10126,74,10200,99
2020-08-23,Yolo,113,214977,2381,2210,4,2214,47
2020-08-23,Yuba,115,75493,812,750,3,753,1
2020-08-22,Alameda,001,1643700,18043,16648,122,16770,231
2020-08-22,Alpine,003,1148,2,2,0,2,0
2020-08-22,Amador,005,37829,267,224,0,224,13
2020-08-22,Butte,007,227075,1840,1618,18,1636,22
2020-08-22,Calaveras,009,45235,218,187,0,187,1
2020-08-22,Colusa,011,21464,440,419,0,419,5
2020-08-22,Contra Costa,013,1133247,13868,12522,47,12569,153
2020-08-22,Del Norte,015,27424,112,80,0,80,1
2020-08-22,El Dorado,017,186661,982,900,0,900,2
2020-08-22,Fresno,019,978130,26818,23197,289,23486,235
2020-08-22,Glenn,021,27897,436,421,0,421,2
2020-08-22,Humboldt,023,135768,366,334,1,335,4
2020-08-22,Imperial,025,180216,11120,9244,8,9252,210
2020-08-22,Inyo,027,18085,168,144,3,147,1
2020-08-22,Kern,029,883053,29258,27807,206,28013,277
2020-08-22,Kings,031,150075,6075,5447,35,5482,60
2020-08-22,Lake,033,64148,323,291,0,291,2
2020-08-22,Lassen,035,31185,720,693,2,695,0
2020-08-22,Los Angeles,037,10098052,236120,230858,1072,231930,5540
2020-08-22,Madera,039,155013,3788,3330,24,3354,32
2020-08-22,Marin,041,260295,6030,5789,14,5803,49
2020-08-22,Mariposa,043,17540,71,66,0,66,2
2020-08-22,Mendocino,045,87422,596,529,0,529,10
2020-08-22,Merced,047,269075,7771,7493,8,7501,69
2020-08-22,Modoc,049,8938,7,5,0,5,0
2020-08-22,Mono,051,14174,163,129,2,131,1
2020-08-22,Monterey,053,433212,7693,7081,21,7102,50
2020-08-22,Napa,055,140530,1430,1328,5,1333,11
2020-08-22,Nevada,057,99092,439,411,13,424,2
2020-08-22,Orange,059,3164182,49190,45131,1112,46243,885
2020-08-22,Placer,061,380077,2948,2734,7,2741,30
2020-08-22,Plumas,063,18699,39,37,0,37,0
2020-08-22,Riverside,065,2383286,52366,49944,55,49999,953
2020-08-22,Sacramento,067,1510023,17548,15516,15,15531,239
2020-08-22,San Benito,069,59416,1034,912,0,912,3
2020-08-22,San Bernardino,071,2135413,47909,44803,282,45085,719
2020-08-22,San Diego,073,3302833,38069,36205,309,36514,673
2020-08-22,San Francisco,075,870044,9242,8568,9,8577,80
2020-08-22,San Joaquin,077,732212,17968,16068,32,16100,305
2020-08-22,San Luis Obispo,079,281455,2931,2660,16,2676,20
2020-08-22,San Mateo,081,765935,8193,7361,8,7369,120
2020-08-22,Santa Barbara,083,443738,7991,7685,69,7754,90
2020-08-22,Santa Clara,085,1922200,17560,15590,36,15626,190
2020-08-22,Santa Cruz,087,273765,1782,1628,15,1643,6
2020-08-22,Shasta,089,179085,598,493,3,496,9
2020-08-22,Sierra,091,2930,6,6,0,6,0
2020-08-22,Siskiyou,093,43540,123,106,8,114,0
2020-08-22,Solano,095,438530,5283,4944,33,4977,32
2020-08-22,Sonoma,097,501317,5543,4891,19,4910,57
2020-08-22,Stanislaus,099,539301,14715,13380,268,13648,170
2020-08-22,Sutter,101,95872,1304,1189,1,1190,8
2020-08-22,Tehama,103,63373,405,368,2,370,1
2020-08-22,Trinity,105,12862,44,8,6,14,0
2020-08-22,Tulare,107,460477,14137,13196,53,13249,222
2020-08-22,Tuolumne,109,53932,193,162,3,165,1
2020-08-22,Ventura,111,848112,10948,9959,72,10031,99
2020-08-22,Yolo,113,214977,2365,2188,4,2192,47
2020-08-22,Yuba,115,75493,800,738,3,741,1
2020-08-21,Alameda,001,1643700,17951,16413,122,16535,232
2020-08-21,Alpine,003,1148,2,2,0,2,0
2020-08-21,Amador,005,37829,266,223,0,223,11
2020-08-21,Butte,007,227075,1801,1582,18,1600,19
2020-08-21,Calaveras,009,45235,218,182,0,182,1
2020-08-21,Colusa,011,21464,438,418,0,418,5
2020-08-21,Contra Costa,013,1133247,13779,12333,46,12379,149
2020-08-21,Del Norte,015,27424,112,78,0,78,1
2020-08-21,El Dorado,017,186661,978,885,0,885,2
2020-08-21,Fresno,019,978130,26648,22840,288,23128,232
2020-08-21,Glenn,021,27897,432,418,0,418,2
2020-08-21,Humboldt,023,135768,363,331,1,332,4
2020-08-21,Imperial,025,180216,11104,9166,8,9174,204
2020-08-21,Inyo,027,18085,168,144,3,147,1
2020-08-21,Kern,029,883053,29199,27567,204,27771,269
2020-08-21,Kings,031,150075,6053,5391,35,5426,60
2020-08-21,Lake,033,64148,321,281,0,281,2
2020-08-21,Lassen,035,31185,720,693,2,695,0
2020-08-21,Los Angeles,037,10098052,235246,229235,1052,230287,5494
2020-08-21,Madera,039,155013,3758,3271,24,3295,31
2020-08-21,Marin,041,260295,6010,5762,14,5776,49
2020-08-21,Mariposa,043,17540,71,66,0,66,2
2020-08-21,Mendocino,045,87422,586,505,0,505,10
2020-08-21,Merced,047,269075,7742,7357,8,7365,69
2020-08-21,Modoc,049,8938,7,5,0,5,0
2020-08-21,Mono,051,14174,163,128,2,130,1
2020-08-21,Monterey,053,433212,7621,6974,21,6995,49
2020-08-21,Napa,055,140530,1421,1317,5,1322,10
2020-08-21,Nevada,057,99092,438,406,13,419,2
2020-08-21,Orange,059,3164182,49049,44625,1103,45728,875
2020-08-21,Placer,061,380077,2932,2698,6,2704,30
2020-08-21,Plumas,063,18699,39,36,0,36,0
2020-08-21,Riverside,065,2383286,52171,49409,55,49464,932
2020-08-21,Sacramento,067,1510023,17425,15247,15,15262,237
2020-08-21,San Benito,069,59416,1024,891,0,891,3
2020-08-21,San Bernardino,071,2135413,47789,44249,278,44527,668
2020-08-21,San Diego,073,3302833,37865,35914,292,36206,652
2020-08-21,San Francisco,075,870044,9192,8375,9,8384,80
2020-08-21,San Joaquin,077,732212,17885,15888,30,15918,301
2020-08-21,San Luis Obispo,079,281455,2908,2640,16,2656,19
2020-08-21,San Mateo,081,765935,8135,7253,8,7261,120
2020-08-21,Santa Barbara,083,443738,7950,7645,69,7714,86
2020-08-21,Santa Clara,085,1922200,17408,15399,36,15435,190
2020-08-21,Santa Cruz,087,273765,1770,1617,15,1632,6
2020-08-21,Shasta,089,179085,598,486,3,489,9
2020-08-21,Sierra,091,2930,6,6,0,6,0
2020-08-21,Siskiyou,093,43540,123,103,6,109,0
2020-08-21,Solano,095,438530,5260,4891,32,4923,32
2020-08-21,Sonoma,097,501317,5473,4816,19,4835,57
2020-08-21,Stanislaus,099,539301,14646,13282,253,13535,161
2020-08-21,Sutter,101,95872,1291,1173,1,1174,8
2020-08-21,Tehama,103,63373,403,357,2,359,1
2020-08-21,Trinity,105,12862,44,8,6,14,0
2020-08-21,Tulare,107,460477,14065,13002,52,13054,217
2020-08-21,Tuolumne,109,53932,185,161,3,164,1
2020-08-21,Ventura,111,848112,10883,9865,70,9935,98
2020-08-21,Yolo,113,214977,2349,2164,4,2168,46
2020-08-21,Yuba,115,75493,796,717,3,720,1
2020-08-20,Alameda,001,1643700,17792,16174,122,16296,229
2020-08-20,Alpine,003,1148,2,2,0,2,0
2020-08-20,Amador,005,37829,264,222,0,222,11
2020-08-20,Butte,007,227075,1750,1549,18,1567,18
2020-08-20,Calaveras,009,45235,215,179,0,179,1
2020-08-20,Colusa,011,21464,436,415,0,415,5
2020-08-20,Contra Costa,013,1133247,13651,12108,45,12153,144
2020-08-20,Del Norte,015,27424,112,78,0,78,1
2020-08-20,El Dorado,017,186661,974,881,0,881,2
2020-08-20,Fresno,019,978130,26466,22535,283,22818,228
2020-08-20,Glenn,021,27897,427,414,0,414,2
2020-08-20,Humboldt,023,135768,358,318,1,319,4
2020-08-20,Imperial,025,180216,11085,9086,8,9094,196
2020-08-20,Inyo,027,18085,167,144,3,147,1
2020-08-20,Kern,029,883053,29031,27337,193,27530,267
2020-08-20,Kings,031,150075,6013,5347,34,5381,59
2020-08-20,Lake,033,64148,316,280,0,280,2
2020-08-20,Lassen,035,31185,719,693,2,695,0
2020-08-20,Los Angeles,037,10098052,234022,227492,1033,228525,5445
2020-08-20,Madera,039,155013,3732,3197,24,3221,31
2020-08-20,Marin,041,260295,5992,5745,14,5759,47
2020-08-20,Mariposa,043,17540,71,67,0,67,2
2020-08-20,Mendocino,045,87422,575,497,0,497,10
2020-08-20,Merced,047,269075,7667,7173,8,7181,68
2020-08-20,Modoc,049,8938,7,5,0,5,0
2020-08-20,Mono,051,14174,163,128,2,130,1
2020-08-20,Monterey,053,433212,7550,6892,21,6913,47
2020-08-20,Napa,055,140530,1413,1306,5,1311,10
2020-08-20,Nevada,057,99092,437,401,13,414,2
2020-08-20,Orange,059,3164182,48822,44299,1092,45391,849
2020-08-20,Placer,061,380077,2916,2681,6,2687,30
2020-08-20,Plumas,063,18699,39,36,0,36,0
2020-08-20,Riverside,065,2383286,51952,48953,54,49007,927
2020-08-20,Sacramento,067,1510023,17183,14992,15,15007,231
2020-08-20,San Benito,069,59416,1011,866,0,866,3
2020-08-20,San Bernardino,071,2135413,47533,43627,274,43901,665
2020-08-20,San Diego,073,3302833,37645,35610,274,35884,644
2020-08-20,San Francisco,075,870044,9106,8262,9,8271,72
2020-08-20,San Joaquin,077,732212,17792,15778,30,15808,297
2020-08-20,San Luis Obispo,079,281455,2888,2590,16,2606,19
2020-08-20,San Mateo,081,765935,8070,7188,8,7196,120
2020-08-20,Santa Barbara,083,443738,7912,7571,69,7640,81
2020-08-20,Santa Clara,085,1922200,17235,15162,36,15198,190
2020-08-20,Santa Cruz,087,273765,1757,1581,15,1596,6
2020-08-20,Shasta,089,179085,597,478,3,481,9
2020-08-20,Sierra,091,2930,6,6,0,6,0
2020-08-20,Siskiyou,093,43540,122,102,1,103,0
2020-08-20,Solano,095,438530,5216,4843,32,4875,31
2020-08-20,Sonoma,097,501317,5401,4737,19,4756,54
2020-08-20,Stanislaus,099,539301,14550,13120,244,13364,161
2020-08-20,Sutter,101,95872,1267,1158,1,1159,8
2020-08-20,Tehama,103,63373,397,350,2,352,1
2020-08-20,Trinity,105,12862,44,8,6,14,0
2020-08-20,Tulare,107,460477,13957,12907,51,12958,217
2020-08-20,Tuolumne,109,53932,181,159,3,162,1
2020-08-20,Ventura,111,848112,10770,9744,69,9813,93
2020-08-20,Yolo,113,214977,2327,2150,4,2154,47
2020-08-20,Yuba,115,75493,779,709,3,712,1
2020-08-19,Alameda,001,1643700,17633,15874,121,15995,226
2020-08-19,Alpine,003,1148,2,2,0,2,0
2020-08-19,Amador,005,37829,263,219,0,219,9
2020-08-19,Butte,007,227075,1707,1517,18,1535,16
2020-08-19,Calaveras,009,45235,212,177,0,177,1
2020-08-19,Colusa,011,21464,435,415,0,415,5
2020-08-19,Contra Costa,013,1133247,13539,11895,43,11938,142
2020-08-19,Del Norte,015,27424,112,78,0,78,1
2020-08-19,El Dorado,017,186661,968,870,0,870,2
2020-08-19,Fresno,019,978130,26277,22167,274,22441,221
2020-08-19,Glenn,021,27897,425,414,0,414,2
2020-08-19,Humboldt,023,135768,355,316,1,317,4
2020-08-19,Imperial,025,180216,11057,9041,8,9049,192
2020-08-19,Inyo,027,18085,165,140,3,143,1
2020-08-19,Kern,029,883053,28914,27142,189,27331,263
2020-08-19,Kings,031,150075,5840,5301,32,5333,59
2020-08-19,Lake,033,64148,313,277,0,277,2
2020-08-19,Lassen,035,31185,711,693,2,695,0
2020-08-19,Los Angeles,037,10098052,232748,226006,993,226999,5399
2020-08-19,Madera,039,155013,3698,3158,22,3180,30
2020-08-19,Marin,041,260295,5968,5723,13,5736,46
2020-08-19,Mariposa,043,17540,71,64,0,64,2
2020-08-19,Mendocino,045,87422,559,495,0,495,8
2020-08-19,Merced,047,269075,7540,7082,5,7087,66
2020-08-19,Modoc,049,8938,7,5,0,5,0
2020-08-19,Mono,051,14174,163,128,2,130,1
2020-08-19,Monterey,053,433212,7450,6693,21,6714,45
2020-08-19,Napa,055,140530,1408,1293,5,1298,10
2020-08-19,Nevada,057,99092,430,398,13,411,2
2020-08-19,Orange,059,3164182,48617,43938,1089,45027,829
2020-08-19,Placer,061,380077,2894,2659,6,2665,28
2020-08-19,Plumas,063,18699,39,36,0,36,0
2020-08-19,Riverside,065,2383286,51703,48741,54,48795,922
2020-08-19,Sacramento,067,1510023,17002,14764,15,14779,229
2020-08-19,San Benito,069,59416,994,853,0,853,3
2020-08-19,San Bernardino,071,2135413,47234,43224,268,43492,661
2020-08-19,San Diego,073,3302833,37396,35378,259,35637,638
2020-08-19,San Francisco,075,870044,9041,8236,9,8245,72
2020-08-19,San Joaquin,077,732212,17666,15677,29,15706,296
2020-08-19,San Luis Obispo,079,281455,2848,2553,16,2569,19
2020-08-19,San Mateo,081,765935,8001,7146,8,7154,119
2020-08-19,Santa Barbara,083,443738,7863,7499,69,7568,80
2020-08-19,Santa Clara,085,1922200,17089,14994,36,15030,189
2020-08-19,Santa Cruz,087,273765,1731,1554,15,1569,6
2020-08-19,Shasta,089,179085,593,475,3,478,9
2020-08-19,Sierra,091,2930,6,6,0,6,0
2020-08-19,Siskiyou,093,43540,121,103,1,104,0
2020-08-19,Solano,095,438530,5175,4807,32,4839,31
2020-08-19,Sonoma,097,501317,5322,4614,19,4633,54
2020-08-19,Stanislaus,099,539301,14447,13084,222,13306,160
2020-08-19,Sutter,101,95872,1233,1146,1,1147,8
2020-08-19,Tehama,103,63373,391,342,2,344,1
2020-08-19,Trinity,105,12862,43,8,6,14,0
2020-08-19,Tulare,107,460477,13859,12756,51,12807,217
2020-08-19,Tuolumne,109,53932,178,159,3,162,1
2020-08-19,Ventura,111,848112,10678,9587,67,9654,91
2020-08-19,Yolo,113,214977,2305,2126,4,2130,47
2020-08-19,Yuba,115,75493,767,701,3,704,1
2020-08-18,Alameda,001,1643700,17456,15627,119,15746,223
2020-08-18,Alpine,003,1148,2,2,0,2,0
2020-08-18,Amador,005,37829,262,215,0,215,9
2020-08-18,Butte,007,227075,1674,1491,18,1509,16
2020-08-18,Calaveras,009,45235,208,174,0,174,1
2020-08-18,Colusa,011,21464,434,415,0,415,5
2020-08-18,Contra Costa,013,1133247,13419,11689,41,11730,141
2020-08-18,Del Norte,015,27424,111,78,0,78,0
2020-08-18,El Dorado,017,186661,963,866,0,866,2
2020-08-18,Fresno,019,978130,26056,21798,268,22066,212
2020-08-18,Glenn,021,27897,425,407,0,407,2
2020-08-18,Humboldt,023,135768,353,315,1,316,4
2020-08-18,Imperial,025,180216,11023,8968,8,8976,189
2020-08-18,Inyo,027,18085,164,140,3,143,1
2020-08-18,Kern,029,883053,28761,26978,185,27163,263
2020-08-18,Kings,031,150075,5805,5269,31,5300,58
2020-08-18,Lake,033,64148,310,274,0,274,2
2020-08-18,Lassen,035,31185,711,693,2,695,0
2020-08-18,Los Angeles,037,10098052,231489,224218,956,225174,5339
2020-08-18,Madera,039,155013,3670,3125,22,3147,28
2020-08-18,Marin,041,260295,5938,5708,13,5721,47
2020-08-18,Mariposa,043,17540,71,61,0,61,2
2020-08-18,Mendocino,045,87422,550,468,0,468,8
2020-08-18,Merced,047,269075,7492,6940,5,6945,66
2020-08-18,Modoc,049,8938,7,5,0,5,0
2020-08-18,Mono,051,14174,162,129,2,131,1
2020-08-18,Monterey,053,433212,7358,6691,20,6711,44
2020-08-18,Napa,055,140530,1405,1274,5,1279,10
2020-08-18,Nevada,057,99092,423,389,13,402,2
2020-08-18,Orange,059,3164182,48392,43659,1074,44733,809
2020-08-18,Placer,061,380077,2868,2644,5,2649,28
2020-08-18,Plumas,063,18699,39,34,0,34,0
2020-08-18,Riverside,065,2383286,51372,48447,54,48501,917
2020-08-18,Sacramento,067,1510023,16772,14610,14,14624,222
2020-08-18,San Benito,069,59416,974,836,0,836,3
2020-08-18,San Bernardino,071,2135413,46952,42827,262,43089,648
2020-08-18,San Diego,073,3302833,37103,35164,227,35391,633
2020-08-18,San Francisco,075,870044,8955,8016,9,8025,72
2020-08-18,San Joaquin,077,732212,17550,15509,28,15537,290
2020-08-18,San Luis Obispo,079,281455,2823,2535,15,2550,18
2020-08-18,San Mateo,081,765935,7939,7074,8,7082,119
2020-08-18,Santa Barbara,083,443738,7821,7472,69,7541,81
2020-08-18,Santa Clara,085,1922200,16916,14786,35,14821,184
2020-08-18,Santa Cruz,087,273765,1718,1509,15,1524,6
2020-08-18,Shasta,089,179085,589,468,3,471,9
2020-08-18,Sierra,091,2930,6,6,0,6,0
2020-08-18,Siskiyou,093,43540,120,103,1,104,0
2020-08-18,Solano,095,438530,5148,4700,32,4732,31
2020-08-18,Sonoma,097,501317,5253,4506,19,4525,48
2020-08-18,Stanislaus,099,539301,14349,12935,206,13141,149
2020-08-18,Sutter,101,95872,1214,1126,1,1127,8
2020-08-18,Tehama,103,63373,381,333,2,335,1
2020-08-18,Trinity,105,12862,41,8,6,14,0
2020-08-18,Tulare,107,460477,13728,12637,48,12685,212
2020-08-18,Tuolumne,109,53932,175,159,3,162,1
2020-08-18,Ventura,111,848112,10588,9536,62,9598,89
2020-08-18,Yolo,113,214977,2283,2102,4,2106,47
2020-08-18,Yuba,115,75493,759,679,3,682,1
2020-08-17,Alameda,001,1643700,17262,15454,118,15572,221
2020-08-17,Alpine,003,1148,2,2,0,2,0
2020-08-17,Amador,005,37829,262,215,0,215,9
2020-08-17,Butte,007,227075,1629,1463,18,1481,15
2020-08-17,Calaveras,009,45235,204,167,0,167,1
2020-08-17,Colusa,011,21464,431,408,0,408,5
2020-08-17,Contra Costa,013,1133247,13282,11442,41,11483,141
2020-08-17,Del Norte,015,27424,107,77,0,77,0
2020-08-17,El Dorado,017,186661,960,846,0,846,2
2020-08-17,Fresno,019,978130,25848,21316,261,21577,211
2020-08-17,Glenn,021,27897,424,402,0,402,2
2020-08-17,Humboldt,023,135768,349,302,1,303,4
2020-08-17,Imperial,025,180216,10982,8897,8,8905,188
2020-08-17,Inyo,027,18085,156,124,3,127,1
2020-08-17,Kern,029,883053,28614,26773,174,26947,249
2020-08-17,Kings,031,150075,5767,5249,31,5280,58
2020-08-17,Lake,033,64148,305,270,0,270,2
2020-08-17,Lassen,035,31185,711,666,2,668,0
2020-08-17,Los Angeles,037,10098052,229973,223418,909,224327,5282
2020-08-17,Madera,039,155013,3627,3050,21,3071,26
2020-08-17,Marin,041,260295,5915,5683,12,5695,46
2020-08-17,Mariposa,043,17540,71,61,0,61,2
2020-08-17,Mendocino,045,87422,532,454,0,454,8
2020-08-17,Merced,047,269075,7397,6814,5,6819,66
2020-08-17,Modoc,049,8938,7,5,0,5,0
2020-08-17,Mono,051,14174,162,126,2,128,1
2020-08-17,Monterey,053,433212,7258,6553,20,6573,44
2020-08-17,Napa,055,140530,1384,1255,5,1260,10
2020-08-17,Nevada,057,99092,418,383,13,396,2
2020-08-17,Orange,059,3164182,48182,43621,1061,44682,804
2020-08-17,Placer,061,380077,2843,2609,5,2614,28
2020-08-17,Plumas,063,18699,39,33,0,33,0
2020-08-17,Riverside,065,2383286,51040,48062,52,48114,916
2020-08-17,Sacramento,067,1510023,16552,14333,14,14347,219
2020-08-17,San Benito,069,59416,959,822,0,822,2
2020-08-17,San Bernardino,071,2135413,46607,42005,254,42259,604
2020-08-17,San Diego,073,3302833,36837,34962,213,35175,626
2020-08-17,San Francisco,075,870044,8884,7600,9,7609,72
2020-08-17,San Joaquin,077,732212,17387,15323,27,15350,280
2020-08-17,San Luis Obispo,079,281455,2790,2527,15,2542,18
2020-08-17,San Mateo,081,765935,7882,6987,7,6994,118
2020-08-17,Santa Barbara,083,443738,7779,7438,69,7507,80
2020-08-17,Santa Clara,085,1922200,16695,14546,35,14581,183
2020-08-17,Santa Cruz,087,273765,1702,1453,14,1467,6
2020-08-17,Shasta,089,179085,583,467,3,470,9
2020-08-17,Sierra,091,2930,6,6,0,6,0
2020-08-17,Siskiyou,093,43540,119,103,0,103,0
2020-08-17,Solano,095,438530,5091,4479,32,4511,31
2020-08-17,Sonoma,097,501317,5165,4402,17,4419,48
2020-08-17,Stanislaus,099,539301,14224,12745,199,12944,148
2020-08-17,Sutter,101,95872,1198,1071,1,1072,8
2020-08-17,Tehama,103,63373,372,324,2,326,1
2020-08-17,Trinity,105,12862,41,8,6,14,0
2020-08-17,Tulare,107,460477,13615,12487,47,12534,210
2020-08-17,Tuolumne,109,53932,172,157,3,160,1
2020-08-17,Ventura,111,848112,10465,9490,57,9547,89
2020-08-17,Yolo,113,214977,2256,2083,4,2087,47
2020-08-17,Yuba,115,75493,744,647,3,650,1
2020-08-16,Alameda,001,1643700,16971,15338,118,15456,221
2020-08-16,Alpine,003,1148,2,2,0,2,0
2020-08-16,Amador,005,37829,259,215,0,215,9
2020-08-16,Butte,007,227075,1591,1432,18,1450,15
2020-08-16,Calaveras,009,45235,197,167,0,167,1
2020-08-16,Colusa,011,21464,429,407,0,407,5
2020-08-16,Contra Costa,013,1133247,13096,11255,41,11296,140
2020-08-16,Del Norte,015,27424,103,77,0,77,0
2020-08-16,El Dorado,017,186661,948,843,0,843,2
2020-08-16,Fresno,019,978130,25627,21010,256,21266,211
2020-08-16,Glenn,021,27897,422,400,0,400,2
2020-08-16,Humboldt,023,135768,347,301,1,302,4
2020-08-16,Imperial,025,180216,10938,8883,8,8891,188
2020-08-16,Inyo,027,18085,149,125,2,127,1
2020-08-16,Kern,029,883053,28415,26520,166,26686,249
2020-08-16,Kings,031,150075,5736,5146,31,5177,58
2020-08-16,Lake,033,64148,301,269,0,269,2
2020-08-16,Lassen,035,31185,711,666,2,668,0
2020-08-16,Los Angeles,037,10098052,228403,222236,879,223115,5263
2020-08-16,Madera,039,155013,3582,3013,21,3034,26
2020-08-16,Marin,041,260295,5889,5664,12,5676,46
2020-08-16,Mariposa,043,17540,71,61,0,61,2
2020-08-16,Mendocino,045,87422,524,451,0,451,8
2020-08-16,Merced,047,269075,7315,6744,5,6749,66
2020-08-16,Modoc,049,8938,7,5,0,5,0
2020-08-16,Mono,051,14174,162,126,2,128,1
2020-08-16,Monterey,053,433212,7160,6516,19,6535,44
2020-08-16,Napa,055,140530,1366,1241,3,1244,10
2020-08-16,Nevada,057,99092,409,379,13,392,2
2020-08-16,Orange,059,3164182,47933,43303,1050,44353,803
2020-08-16,Placer,061,380077,2814,2583,4,2587,28
2020-08-16,Plumas,063,18699,39,33,0,33,0
2020-08-16,Riverside,065,2383286,50709,47669,51,47720,910
2020-08-16,Sacramento,067,1510023,16312,14210,14,14224,219
2020-08-16,San Benito,069,59416,930,815,0,815,2
2020-08-16,San Bernardino,071,2135413,46183,41724,246,41970,603
2020-08-16,San Diego,073,3302833,36573,34680,198,34878,626
2020-08-16,San Francisco,075,870044,8797,7602,9,7611,72
2020-08-16,San Joaquin,077,732212,17184,15288,27,15315,280
2020-08-16,San Luis Obispo,079,281455,2761,2494,15,2509,17
2020-08-16,San Mateo,081,765935,7807,6942,7,6949,118
2020-08-16,Santa Barbara,083,443738,7730,7368,69,7437,79
2020-08-16,Santa Clara,085,1922200,16497,14329,35,14364,183
2020-08-16,Santa Cruz,087,273765,1675,1449,13,1462,6
2020-08-16,Shasta,089,179085,576,465,3,468,9
2020-08-16,Sierra,091,2930,6,6,0,6,0
2020-08-16,Siskiyou,093,43540,118,102,0,102,0
2020-08-16,Solano,095,438530,5031,4479,32,4511,31
2020-08-16,Sonoma,097,501317,5061,4329,17,4346,46
2020-08-16,Stanislaus,099,539301,14066,12668,189,12857,148
2020-08-16,Sutter,101,95872,1180,1071,1,1072,8
2020-08-16,Tehama,103,63373,362,318,2,320,1
2020-08-16,Trinity,105,12862,38,8,6,14,0
2020-08-16,Tulare,107,460477,13483,12334,44,12378,211
2020-08-16,Tuolumne,109,53932,172,156,3,159,1
2020-08-16,Ventura,111,848112,10356,9408,52,9460,89
2020-08-16,Yolo,113,214977,2237,2057,4,2061,47
2020-08-16,Yuba,115,75493,735,647,2,649,1
2020-08-15,Alameda,001,1643700,16894,15165,118,15283,221
2020-08-15,Alpine,003,1148,2,2,0,2,0
2020-08-15,Amador,005,37829,259,210,0,210,9
2020-08-15,Butte,007,227075,1569,1409,18,1427,15
2020-08-15,Calaveras,009,45235,195,167,0,167,1
2020-08-15,Colusa,011,21464,428,401,0,401,5
2020-08-15,Contra Costa,013,1133247,13000,11106,41,11147,138
2020-08-15,Del Norte,015,27424,103,77,0,77,0
2020-08-15,El Dorado,017,186661,943,838,0,838,2
2020-08-15,Fresno,019,978130,25511,20603,254,20857,211
2020-08-15,Glenn,021,27897,422,398,0,398,2
2020-08-15,Humboldt,023,135768,346,301,1,302,4
2020-08-15,Imperial,025,180216,10918,8794,8,8802,188
2020-08-15,Inyo,027,18085,149,123,2,125,1
2020-08-15,Kern,029,883053,28327,26338,166,26504,249
2020-08-15,Kings,031,150075,5718,5039,31,5070,56
2020-08-15,Lake,033,64148,299,268,0,268,2
2020-08-15,Lassen,035,31185,711,666,2,668,0
2020-08-15,Los Angeles,037,10098052,227653,221043,869,221912,5252
2020-08-15,Madera,039,155013,3532,2950,21,2971,26
2020-08-15,Marin,041,260295,5882,5628,12,5640,46
2020-08-15,Mariposa,043,17540,71,61,0,61,2
2020-08-15,Mendocino,045,87422,520,444,0,444,8
2020-08-15,Merced,047,269075,7281,6656,5,6661,66
2020-08-15,Modoc,049,8938,7,5,0,5,0
2020-08-15,Mono,051,14174,162,126,2,128,1
2020-08-15,Monterey,053,433212,7115,6162,19,6181,44
2020-08-15,Napa,055,140530,1356,1232,3,1235,10
2020-08-15,Nevada,057,99092,409,376,13,389,2
2020-08-15,Orange,059,3164182,47820,42811,1039,43850,801
2020-08-15,Placer,061,380077,2793,2551,4,2555,27
2020-08-15,Plumas,063,18699,39,33,0,33,0
2020-08-15,Riverside,065,2383286,50558,46720,51,46771,910
2020-08-15,Sacramento,067,1510023,16202,14018,14,14032,219
2020-08-15,San Benito,069,59416,917,805,0,805,2
2020-08-15,San Bernardino,071,2135413,46031,41231,244,41475,602
2020-08-15,San Diego,073,3302833,36407,34346,184,34530,639
2020-08-15,San Francisco,075,870044,8733,7601,9,7610,69
2020-08-15,San Joaquin,077,732212,17111,15113,27,15140,280
2020-08-15,San Luis Obispo,079,281455,2744,2461,15,2476,17
2020-08-15,San Mateo,081,765935,7770,6860,7,6867,118
2020-08-15,Santa Barbara,083,443738,7702,7338,69,7407,79
2020-08-15,Santa Clara,085,1922200,16401,14105,35,14140,183
2020-08-15,Santa Cruz,087,273765,1654,1449,13,1462,6
2020-08-15,Shasta,089,179085,573,458,3,461,9
2020-08-15,Sierra,091,2930,6,6,0,6,0
2020-08-15,Siskiyou,093,43540,117,100,0,100,0
2020-08-15,Solano,095,438530,5009,4477,32,4509,31
2020-08-15,Sonoma,097,501317,5006,4134,17,4151,45
2020-08-15,Stanislaus,099,539301,14002,12541,188,12729,149
2020-08-15,Sutter,101,95872,1169,1046,1,1047,8
2020-08-15,Tehama,103,63373,361,312,2,314,1
2020-08-15,Trinity,105,12862,36,6,6,12,0
2020-08-15,Tulare,107,460477,13445,12262,44,12306,211
2020-08-15,Tuolumne,109,53932,172,155,3,158,1
2020-08-15,Ventura,111,848112,10297,9379,50,9429,89
2020-08-15,Yolo,113,214977,2225,2031,4,2035,46
2020-08-15,Yuba,115,75493,731,623,2,625,1
2020-08-14,Alameda,001,1643700,16755,14909,118,15027,221
2020-08-14,Alpine,003,1148,2,2,0,2,0
2020-08-14,Amador,005,37829,259,209,0,209,9
2020-08-14,Butte,007,227075,1560,1384,18,1402,15
2020-08-14,Calaveras,009,45235,191,165,0,165,1
2020-08-14,Colusa,011,21464,426,399,0,399,5
2020-08-14,Contra Costa,013,1133247,12888,10893,41,10934,137
2020-08-14,Del Norte,015,27424,103,76,0,76,0
2020-08-14,El Dorado,017,186661,935,827,0,827,2
2020-08-14,Fresno,019,978130,25377,19900,254,20154,208
2020-08-14,Glenn,021,27897,420,395,0,395,2
2020-08-14,Humboldt,023,135768,340,294,1,295,4
2020-08-14,Imperial,025,180216,10894,8756,8,8764,185
2020-08-14,Inyo,027,18085,148,115,2,117,1
2020-08-14,Kern,029,883053,28223,25893,165,26058,249
2020-08-14,Kings,031,150075,5704,4953,31,4984,56
2020-08-14,Lake,033,64148,290,267,0,267,2
2020-08-14,Lassen,035,31185,711,665,2,667,0
2020-08-14,Los Angeles,037,10098052,226486,219083,852,219935,5222
2020-08-14,Madera,039,155013,3502,2876,21,2897,26
2020-08-14,Marin,041,260295,5871,5601,12,5613,46
2020-08-14,Mariposa,043,17540,70,61,0,61,2
2020-08-14,Mendocino,045,87422,511,432,0,432,8
2020-08-14,Merced,047,269075,7251,6466,5,6471,67
2020-08-14,Modoc,049,8938,7,5,0,5,0
2020-08-14,Mono,051,14174,162,126,2,128,1
2020-08-14,Monterey,053,433212,7064,6121,19,6140,41
2020-08-14,Napa,055,140530,1346,1230,3,1233,10
2020-08-14,Nevada,057,99092,405,377,13,390,2
2020-08-14,Orange,059,3164182,47670,42399,1026,43425,798
2020-08-14,Placer,061,380077,2774,2546,4,2550,26
2020-08-14,Plumas,063,18699,38,33,0,33,0
2020-08-14,Riverside,065,2383286,50329,46456,51,46507,891
2020-08-14,Sacramento,067,1510023,16052,13645,14,13659,212
2020-08-14,San Benito,069,59416,900,783,0,783,2
2020-08-14,San Bernardino,071,2135413,45844,40442,241,40683,594
2020-08-14,San Diego,073,3302833,36213,34067,177,34244,622
2020-08-14,San Francisco,075,870044,8674,7467,9,7476,69
2020-08-14,San Joaquin,077,732212,17011,14925,27,14952,276
2020-08-14,San Luis Obispo,079,281455,2729,2422,15,2437,17
2020-08-14,San Mateo,081,765935,7711,6655,7,6662,118
2020-08-14,Santa Barbara,083,443738,7652,7302,69,7371,77
2020-08-14,Santa Clara,085,1922200,16235,13785,34,13819,183
2020-08-14,Santa Cruz,087,273765,1632,1418,12,1430,6
2020-08-14,Shasta,089,179085,568,446,3,449,9
2020-08-14,Sierra,091,2930,6,5,0,5,0
2020-08-14,Siskiyou,093,43540,117,98,0,98,0
2020-08-14,Solano,095,438530,4988,4421,32,4453,31
2020-08-14,Sonoma,097,501317,4946,4087,14,4101,45
2020-08-14,Stanislaus,099,539301,13924,12379,184,12563,140
2020-08-14,Sutter,101,95872,1161,1039,1,1040,8
2020-08-14,Tehama,103,63373,357,305,2,307,1
2020-08-14,Trinity,105,12862,36,6,6,12,0
2020-08-14,Tulare,107,460477,13368,12009,44,12053,211
2020-08-14,Tuolumne,109,53932,171,155,3,158,1
2020-08-14,Ventura,111,848112,10222,9313,50,9363,89
2020-08-14,Yolo,113,214977,2211,1991,4,1995,45
2020-08-14,Yuba,115,75493,715,606,2,608,1
2020-08-13,Alameda,001,1643700,16478,14385,118,14503,218
2020-08-13,Alpine,003,1148,2,2,0,2,0
2020-08-13,Amador,005,37829,259,198,0,198,8
2020-08-13,Butte,007,227075,1535,1345,18,1363,15
2020-08-13,Calaveras,009,45235,189,162,0,162,1
2020-08-13,Colusa,011,21464,426,395,0,395,5
2020-08-13,Contra Costa,013,1133247,12734,10545,40,10585,136
2020-08-13,Del Norte,015,27424,102,74,0,74,0
2020-08-13,El Dorado,017,186661,930,803,0,803,2
2020-08-13,Fresno,019,978130,25150,19157,248,19405,201
2020-08-13,Glenn,021,27897,416,392,0,392,1
2020-08-13,Humboldt,023,135768,332,281,1,282,4
2020-08-13,Imperial,025,180216,10863,8640,8,8648,170
2020-08-13,Inyo,027,18085,144,97,2,99,1
2020-08-13,Kern,029,883053,28056,25472,162,25634,242
2020-08-13,Kings,031,150075,5669,4824,31,4855,52
2020-08-13,Lake,033,64148,285,263,0,263,2
2020-08-13,Lassen,035,31185,711,652,2,654,0
2020-08-13,Los Angeles,037,10098052,225110,216497,831,217328,5179
2020-08-13,Madera,039,155013,3458,2675,20,2695,25
2020-08-13,Marin,041,260295,5855,5503,12,5515,44
2020-08-13,Mariposa,043,17540,69,61,0,61,2
2020-08-13,Mendocino,045,87422,506,401,0,401,8
2020-08-13,Merced,047,269075,7134,5945,5,5950,63
2020-08-13,Modoc,049,8938,7,5,0,5,0
2020-08-13,Mono,051,14174,162,124,2,126,1
2020-08-13,Monterey,053,433212,6981,5925,19,5944,38
2020-08-13,Napa,055,140530,1337,1179,3,1182,10
2020-08-13,Nevada,057,99092,401,362,13,375,1
2020-08-13,Orange,059,3164182,47431,42019,1014,43033,773
2020-08-13,Placer,061,380077,2751,2460,4,2464,26
2020-08-13,Plumas,063,18699,38,32,0,32,0
2020-08-13,Riverside,065,2383286,50033,45327,51,45378,885
2020-08-13,Sacramento,067,1510023,15850,13237,14,13251,197
2020-08-13,San Benito,069,59416,871,757,0,757,2
2020-08-13,San Bernardino,071,2135413,45449,39395,235,39630,591
2020-08-13,San Diego,073,3302833,35977,33661,159,33820,627
2020-08-13,San Francisco,075,870044,8580,7277,9,7286,69
2020-08-13,San Joaquin,077,732212,16856,14537,26,14563,261
2020-08-13,San Luis Obispo,079,281455,2707,2283,15,2298,16
2020-08-13,San Mateo,081,765935,7649,6503,7,6510,117
2020-08-13,Santa Barbara,083,443738,7607,7129,68,7197,74
2020-08-13,Santa Clara,085,1922200,16012,13257,34,13291,182
2020-08-13,Santa Cruz,087,273765,1607,1383,12,1395,6
2020-08-13,Shasta,089,179085,563,428,3,431,9
2020-08-13,Sierra,091,2930,6,5,0,5,0
2020-08-13,Siskiyou,093,43540,117,95,0,95,0
2020-08-13,Solano,095,438530,4951,4305,32,4337,31
2020-08-13,Sonoma,097,501317,4872,3902,14,3916,45
2020-08-13,Stanislaus,099,539301,13794,11953,168,12121,136
2020-08-13,Sutter,101,95872,1139,992,1,993,8
2020-08-13,Tehama,103,63373,348,302,2,304,1
2020-08-13,Trinity,105,12862,35,6,6,12,0
2020-08-13,Tulare,107,460477,13224,11692,41,11733,210
2020-08-13,Tuolumne,109,53932,170,152,3,155,1
2020-08-13,Ventura,111,848112,10133,9114,50,9164,90
2020-08-13,Yolo,113,214977,2184,1938,4,1942,44
2020-08-13,Yuba,115,75493,699,568,2,570,1
2020-08-12,Alameda,001,1643700,16265,14214,118,14332,215
2020-08-12,Alpine,003,1148,2,2,0,2,0
2020-08-12,Amador,005,37829,256,197,0,197,8
2020-08-12,Butte,007,227075,1507,1317,18,1335,15
2020-08-12,Calaveras,009,45235,186,157,0,157,1
2020-08-12,Colusa,011,21464,421,394,0,394,5
2020-08-12,Contra Costa,013,1133247,12589,10304,39,10343,134
2020-08-12,Del Norte,015,27424,101,74,0,74,0
2020-08-12,El Dorado,017,186661,912,794,0,794,2
2020-08-12,Fresno,019,978130,24920,18690,242,18932,194
2020-08-12,Glenn,021,27897,413,388,0,388,1
2020-08-12,Humboldt,023,135768,325,281,1,282,4
2020-08-12,Imperial,025,180216,10840,8566,8,8574,167
2020-08-12,Inyo,027,18085,127,97,2,99,1
2020-08-12,Kern,029,883053,27864,25191,160,25351,232
2020-08-12,Kings,031,150075,5630,4736,31,4767,50
2020-08-12,Lake,033,64148,283,253,0,253,2
2020-08-12,Lassen,035,31185,710,651,2,653,0
2020-08-12,Los Angeles,037,10098052,223710,214542,815,215357,5119
2020-08-12,Madera,039,155013,3424,2681,18,2699,23
2020-08-12,Marin,041,260295,5833,5423,12,5435,44
2020-08-12,Mariposa,043,17540,69,61,0,61,2
2020-08-12,Mendocino,045,87422,487,386,0,386,9
2020-08-12,Merced,047,269075,7072,5777,5,5782,66
2020-08-12,Modoc,049,8938,7,5,0,5,0
2020-08-12,Mono,051,14174,161,124,2,126,1
2020-08-12,Monterey,053,433212,6877,5919,19,5938,38
2020-08-12,Napa,055,140530,1327,1161,3,1164,10
2020-08-12,Nevada,057,99092,396,357,13,370,1
2020-08-12,Orange,059,3164182,47180,41576,990,42566,754
2020-08-12,Placer,061,380077,2719,2417,4,2421,25
2020-08-12,Plumas,063,18699,38,31,0,31,0
2020-08-12,Riverside,065,2383286,49685,44747,51,44798,867
2020-08-12,Sacramento,067,1510023,15638,12528,14,12542,189
2020-08-12,San Benito,069,59416,858,751,0,751,2
2020-08-12,San Bernardino,071,2135413,45106,38811,226,39037,589
2020-08-12,San Diego,073,3302833,35768,33395,139,33534,608
2020-08-12,San Francisco,075,870044,8497,7194,9,7203,66
2020-08-12,San Joaquin,077,732212,16710,14154,26,14180,253
2020-08-12,San Luis Obispo,079,281455,2682,2263,15,2278,15
2020-08-12,San Mateo,081,765935,7570,6427,7,6434,117
2020-08-12,Santa Barbara,083,443738,7547,7049,66,7115,74
2020-08-12,Santa Clara,085,1922200,15836,13002,34,13036,182
2020-08-12,Santa Cruz,087,273765,1578,1382,11,1393,6
2020-08-12,Shasta,089,179085,559,417,3,420,9
2020-08-12,Sierra,091,2930,5,4,0,4,0
2020-08-12,Siskiyou,093,43540,116,90,0,90,0
2020-08-12,Solano,095,438530,4906,4258,32,4290,31
2020-08-12,Sonoma,097,501317,4798,3847,14,3861,47
2020-08-12,Stanislaus,099,539301,13655,11682,160,11842,136
2020-08-12,Sutter,101,95872,1115,987,1,988,7
2020-08-12,Tehama,103,63373,338,289,2,291,1
2020-08-12,Trinity,105,12862,34,6,6,12,0
2020-08-12,Tulare,107,460477,13096,11460,41,11501,211
2020-08-12,Tuolumne,109,53932,169,150,3,153,1
2020-08-12,Ventura,111,848112,10046,9005,50,9055,87
2020-08-12,Yolo,113,214977,2160,1921,4,1925,44
2020-08-12,Yuba,115,75493,677,549,1,550,1
2020-08-11,Alameda,001,1643700,16004,13960,115,14075,204
2020-08-11,Alpine,003,1148,2,2,0,2,0
2020-08-11,Amador,005,37829,250,187,0,187,3
2020-08-11,Butte,007,227075,1480,1296,18,1314,15
2020-08-11,Calaveras,009,45235,184,161,0,161,1
2020-08-11,Colusa,011,21464,416,390,0,390,5
2020-08-11,Contra Costa,013,1133247,12400,10012,37,10049,131
2020-08-11,Del Norte,015,27424,100,73,0,73,0
2020-08-11,El Dorado,017,186661,905,786,0,786,2
2020-08-11,Fresno,019,978130,24598,18344,239,18583,187
2020-08-11,Glenn,021,27897,411,380,0,380,1
2020-08-11,Humboldt,023,135768,320,283,1,284,4
2020-08-11,Imperial,025,180216,10785,8518,8,8526,165
2020-08-11,Inyo,027,18085,122,97,2,99,1
2020-08-11,Kern,029,883053,27529,25042,158,25200,230
2020-08-11,Kings,031,150075,5439,4696,31,4727,50
2020-08-11,Lake,033,64148,280,243,0,243,2
2020-08-11,Lassen,035,31185,704,605,2,607,0
2020-08-11,Los Angeles,037,10098052,222210,212421,790,213211,5065
2020-08-11,Madera,039,155013,3370,2673,18,2691,22
2020-08-11,Marin,041,260295,5805,5287,11,5298,44
2020-08-11,Mariposa,043,17540,68,60,0,60,2
2020-08-11,Mendocino,045,87422,477,385,0,385,9
2020-08-11,Merced,047,269075,6977,5322,4,5326,65
2020-08-11,Modoc,049,8938,7,5,0,5,0
2020-08-11,Mono,051,14174,161,124,2,126,1
2020-08-11,Monterey,053,433212,6769,5624,19,5643,36
2020-08-11,Napa,055,140530,1316,1143,2,1145,11
2020-08-11,Nevada,057,99092,393,358,13,371,1
2020-08-11,Orange,059,3164182,46960,41205,968,42173,742
2020-08-11,Placer,061,380077,2687,2393,4,2397,24
2020-08-11,Plumas,063,18699,38,31,0,31,0
2020-08-11,Riverside,065,2383286,49328,44237,51,44288,836
2020-08-11,Sacramento,067,1510023,15347,12298,14,12312,182
2020-08-11,San Benito,069,59416,846,750,0,750,2
2020-08-11,San Bernardino,071,2135413,44765,38467,219,38686,584
2020-08-11,San Diego,073,3302833,35501,33159,120,33279,602
2020-08-11,San Francisco,075,870044,8401,6988,9,6997,66
2020-08-11,San Joaquin,077,732212,16532,13997,21,14018,251
2020-08-11,San Luis Obispo,079,281455,2625,2234,15,2249,15
2020-08-11,San Mateo,081,765935,7496,6339,7,6346,117
2020-08-11,Santa Barbara,083,443738,7498,6942,66,7008,70
2020-08-11,Santa Clara,085,1922200,15614,12920,34,12954,183
2020-08-11,Santa Cruz,087,273765,1555,1352,11,1363,4
2020-08-11,Shasta,089,179085,555,416,3,419,9
2020-08-11,Sierra,091,2930,5,4,0,4,0
2020-08-11,Siskiyou,093,43540,116,90,0,90,0
2020-08-11,Solano,095,438530,4858,4206,31,4237,31
2020-08-11,Sonoma,097,501317,4704,3752,14,3766,45
2020-08-11,Stanislaus,099,539301,13551,11592,148,11740,128
2020-08-11,Sutter,101,95872,1093,964,1,965,7
2020-08-11,Tehama,103,63373,334,289,2,291,1
2020-08-11,Trinity,105,12862,34,5,6,11,0
2020-08-11,Tulare,107,460477,12971,11392,40,11432,201
2020-08-11,Tuolumne,109,53932,164,146,3,149,1
2020-08-11,Ventura,111,848112,9978,8953,49,9002,88
2020-08-11,Yolo,113,214977,2138,1912,4,1916,44
2020-08-11,Yuba,115,75493,666,540,1,541,1
2020-08-10,Alameda,001,1643700,15764,13420,114,13534,203
2020-08-10,Alpine,003,1148,2,2,0,2,0
2020-08-10,Amador,005,37829,249,172,0,172,2
2020-08-10,Butte,007,227075,1456,1174,16,1190,15
2020-08-10,Calaveras,009,45235,174,121,0,121,1
2020-08-10,Colusa,011,21464,414,387,0,387,4
2020-08-10,Contra Costa,013,1133247,12247,9454,35,9489,130
2020-08-10,Del Norte,015,27424,98,69,0,69,0
2020-08-10,El Dorado,017,186661,893,771,0,771,2
2020-08-10,Fresno,019,978130,24317,17978,238,18216,183
2020-08-10,Glenn,021,27897,408,381,0,381,1
2020-08-10,Humboldt,023,135768,314,277,1,278,4
2020-08-10,Imperial,025,180216,10741,8465,8,8473,165
2020-08-10,Inyo,027,18085,122,97,2,99,1
2020-08-10,Kern,029,883053,27303,24499,157,24656,215
2020-08-10,Kings,031,150075,5333,4588,31,4619,50
2020-08-10,Lake,033,64148,273,239,0,239,2
2020-08-10,Lassen,035,31185,704,588,2,590,0
2020-08-10,Los Angeles,037,10098052,220635,211035,772,211807,5003
2020-08-10,Madera,039,155013,3337,2365,17,2382,22
2020-08-10,Marin,041,260295,5760,5242,10,5252,44
2020-08-10,Mariposa,043,17540,68,57,0,57,2
2020-08-10,Mendocino,045,87422,453,364,0,364,1
2020-08-10,Merced,047,269075,6896,4913,4,4917,51
2020-08-10,Modoc,049,8938,7,5,0,5,0
2020-08-10,Mono,051,14174,161,123,2,125,1
2020-08-10,Monterey,053,433212,6659,5358,19,5377,34
2020-08-10,Napa,055,140530,1298,1084,2,1086,8
2020-08-10,Nevada,057,99092,385,356,13,369,1
2020-08-10,Orange,059,3164182,46690,40445,950,41395,721
2020-08-10,Placer,061,380077,2648,2298,4,2302,21
2020-08-10,Plumas,063,18699,38,27,0,27,0
2020-08-10,Riverside,065,2383286,48944,43296,50,43346,830
2020-08-10,Sacramento,067,1510023,15036,12059,14,12073,168
2020-08-10,San Benito,069,59416,833,743,0,743,2
2020-08-10,San Bernardino,071,2135413,44388,37367,210,37577,579
2020-08-10,San Diego,073,3302833,35235,32977,104,33081,594
2020-08-10,San Francisco,075,870044,8311,6816,8,6824,66
2020-08-10,San Joaquin,077,732212,16350,13308,21,13329,240
2020-08-10,San Luis Obispo,079,281455,2526,2208,14,2222,15
2020-08-10,San Mateo,081,765935,7419,6222,7,6229,117
2020-08-10,Santa Barbara,083,443738,7443,6869,66,6935,66
2020-08-10,Santa Clara,085,1922200,15354,12615,33,12648,182
2020-08-10,Santa Cruz,087,273765,1535,1239,10,1249,4
2020-08-10,Shasta,089,179085,551,384,3,387,9
2020-08-10,Sierra,091,2930,5,3,0,3,0
2020-08-10,Siskiyou,093,43540,113,88,0,88,0
2020-08-10,Solano,095,438530,4798,4101,31,4132,31
2020-08-10,Sonoma,097,501317,4535,3640,10,3650,42
2020-08-10,Stanislaus,099,539301,13369,10855,131,10986,106
2020-08-10,Sutter,101,95872,1068,865,1,866,7
2020-08-10,Tehama,103,63373,327,282,2,284,1
2020-08-10,Trinity,105,12862,31,5,6,11,0
2020-08-10,Tulare,107,460477,12798,10750,38,10788,194
2020-08-10,Tuolumne,109,53932,164,143,2,145,1
2020-08-10,Ventura,111,848112,9894,8851,48,8899,85
2020-08-10,Yolo,113,214977,2115,1840,4,1844,45
2020-08-10,Yuba,115,75493,649,527,1,528,1
2020-08-09,Alameda,001,1643700,15484,13241,112,13353,203
2020-08-09,Alpine,003,1148,2,2,0,2,0
2020-08-09,Amador,005,37829,244,153,0,153,2
2020-08-09,Butte,007,227075,1412,1155,16,1171,15
2020-08-09,Calaveras,009,45235,169,122,0,122,1
2020-08-09,Colusa,011,21464,410,371,0,371,4
2020-08-09,Contra Costa,013,1133247,12019,9214,34,9248,130
2020-08-09,Del Norte,015,27424,98,69,0,69,0
2020-08-09,El Dorado,017,186661,885,748,0,748,2
2020-08-09,Fresno,019,978130,24008,17846,234,18080,183
2020-08-09,Glenn,021,27897,406,354,0,354,1
2020-08-09,Humboldt,023,135768,308,279,1,280,4
2020-08-09,Imperial,025,180216,10698,8310,7,8317,165
2020-08-09,Inyo,027,18085,117,86,1,87,1
2020-08-09,Kern,029,883053,27047,23680,157,23837,215
2020-08-09,Kings,031,150075,5290,4446,30,4476,50
2020-08-09,Lake,033,64148,266,225,0,225,2
2020-08-09,Lassen,035,31185,698,589,2,591,0
2020-08-09,Los Angeles,037,10098052,218575,208810,750,209560,4984
2020-08-09,Madera,039,155013,3278,2322,13,2335,22
2020-08-09,Marin,041,260295,5717,5204,10,5214,44
2020-08-09,Mariposa,043,17540,66,56,0,56,2
2020-08-09,Mendocino,045,87422,443,283,0,283,1
2020-08-09,Merced,047,269075,6799,4735,3,4738,51
2020-08-09,Modoc,049,8938,7,4,0,4,0
2020-08-09,Mono,051,14174,160,113,2,115,1
2020-08-09,Monterey,053,433212,6535,5199,19,5218,34
2020-08-09,Napa,055,140530,1279,1062,2,1064,8
2020-08-09,Nevada,057,99092,377,332,13,345,1
2020-08-09,Orange,059,3164182,46391,39244,935,40179,722
2020-08-09,Placer,061,380077,2619,2211,4,2215,20
2020-08-09,Plumas,063,18699,38,27,0,27,0
2020-08-09,Riverside,065,2383286,48598,41894,50,41944,828
2020-08-09,Sacramento,067,1510023,14756,11301,14,11315,167
2020-08-09,San Benito,069,59416,814,687,0,687,2
2020-08-09,San Bernardino,071,2135413,43913,36092,210,36302,579
2020-08-09,San Diego,073,3302833,34944,32749,93,32842,594
2020-08-09,San Francisco,075,870044,8196,6820,8,6828,66
2020-08-09,San Joaquin,077,732212,16146,12933,20,12953,240
2020-08-09,San Luis Obispo,079,281455,2490,2124,14,2138,15
2020-08-09,San Mateo,081,765935,7324,6094,7,6101,117
2020-08-09,Santa Barbara,083,443738,7355,6669,66,6735,66
2020-08-09,Santa Clara,085,1922200,15084,11878,33,11911,181
2020-08-09,Santa Cruz,087,273765,1511,1246,10,1256,4
2020-08-09,Shasta,089,179085,547,361,3,364,9
2020-08-09,Sierra,091,2930,5,3,0,3,0
2020-08-09,Siskiyou,093,43540,112,74,0,74,0
2020-08-09,Solano,095,438530,4745,3954,30,3984,31
2020-08-09,Sonoma,097,501317,4399,3531,8,3539,41
2020-08-09,Stanislaus,099,539301,13161,10264,118,10382,106
2020-08-09,Sutter,101,95872,1034,857,1,858,7
2020-08-09,Tehama,103,63373,319,265,2,267,1
2020-08-09,Trinity,105,12862,31,5,6,11,0
2020-08-09,Tulare,107,460477,12606,10630,35,10665,194
2020-08-09,Tuolumne,109,53932,161,143,2,145,1
2020-08-09,Ventura,111,848112,9746,8633,47,8680,85
2020-08-09,Yolo,113,214977,2084,1765,4,1769,44
2020-08-09,Yuba,115,75493,629,442,1,443,1
2020-08-08,Alameda,001,1643700,15374,13087,112,13199,204
2020-08-08,Alpine,003,1148,2,2,0,2,0
2020-08-08,Amador,005,37829,244,139,0,139,2
2020-08-08,Butte,007,227075,1394,1140,16,1156,15
2020-08-08,Calaveras,009,45235,168,122,0,122,1
2020-08-08,Colusa,011,21464,409,368,0,368,4
2020-08-08,Contra Costa,013,1133247,11910,9104,34,9138,129
2020-08-08,Del Norte,015,27424,97,69,0,69,0
2020-08-08,El Dorado,017,186661,878,734,0,734,2
2020-08-08,Fresno,019,978130,23871,17538,232,17770,183
2020-08-08,Glenn,021,27897,406,344,0,344,1
2020-08-08,Humboldt,023,135768,305,277,1,278,4
2020-08-08,Imperial,025,180216,10683,8213,7,8220,165
2020-08-08,Inyo,027,18085,113,86,1,87,1
2020-08-08,Kern,029,883053,26933,22803,157,22960,215
2020-08-08,Kings,031,150075,5276,4367,30,4397,49
2020-08-08,Lake,033,64148,264,221,0,221,2
2020-08-08,Lassen,035,31185,698,589,2,591,0
2020-08-08,Los Angeles,037,10098052,217690,206971,739,207710,4974
2020-08-08,Madera,039,155013,3247,2275,13,2288,22
2020-08-08,Marin,041,260295,5697,5118,10,5128,44
2020-08-08,Mariposa,043,17540,65,55,0,55,2
2020-08-08,Mendocino,045,87422,441,264,0,264,1
2020-08-08,Merced,047,269075,6759,4570,3,4573,51
2020-08-08,Modoc,049,8938,7,4,0,4,0
2020-08-08,Mono,051,14174,160,113,2,115,1
2020-08-08,Monterey,053,433212,6477,5101,19,5120,33
2020-08-08,Napa,055,140530,1271,1062,2,1064,8
2020-08-08,Nevada,057,99092,375,325,13,338,1
2020-08-08,Orange,059,3164182,46261,38688,926,39614,718
2020-08-08,Placer,061,380077,2602,2153,4,2157,20
2020-08-08,Plumas,063,18699,38,27,0,27,0
2020-08-08,Riverside,065,2383286,48394,41412,50,41462,823
2020-08-08,Sacramento,067,1510023,14627,11144,14,11158,166
2020-08-08,San Benito,069,59416,806,684,0,684,2
2020-08-08,San Bernardino,071,2135413,43717,35691,209,35900,531
2020-08-08,San Diego,073,3302833,34755,32332,84,32416,593
2020-08-08,San Francisco,075,870044,8130,6820,8,6828,66
2020-08-08,San Joaquin,077,732212,16065,12559,19,12578,240
2020-08-08,San Luis Obispo,079,281455,2467,2081,14,2095,15
2020-08-08,San Mateo,081,765935,7266,6021,7,6028,117
2020-08-08,Santa Barbara,083,443738,7317,6598,66,6664,66
2020-08-08,Santa Clara,085,1922200,14932,11615,33,11648,181
2020-08-08,Santa Cruz,087,273765,1497,1247,10,1257,4
2020-08-08,Shasta,089,179085,545,343,3,346,9
2020-08-08,Sierra,091,2930,5,3,0,3,0
2020-08-08,Siskiyou,093,43540,112,73,0,73,0
2020-08-08,Solano,095,438530,4724,3889,29,3918,31
2020-08-08,Sonoma,097,501317,4368,3399,8,3407,41
2020-08-08,Stanislaus,099,539301,13086,9963,113,10076,105
2020-08-08,Sutter,101,95872,1024,830,1,831,7
2020-08-08,Tehama,103,63373,318,251,2,253,1
2020-08-08,Trinity,105,12862,31,5,6,11,0
2020-08-08,Tulare,107,460477,12530,10505,35,10540,192
2020-08-08,Tuolumne,109,53932,161,143,2,145,1
2020-08-08,Ventura,111,848112,9691,8462,46,8508,85
2020-08-08,Yolo,113,214977,2071,1725,4,1729,44
2020-08-08,Yuba,115,75493,620,430,1,431,1
2020-08-07,Alameda,001,1643700,15263,12805,112,12917,204
2020-08-07,Alpine,003,1148,2,2,0,2,0
2020-08-07,Amador,005,37829,242,125,0,125,2
2020-08-07,Butte,007,227075,1376,1092,16,1108,13
2020-08-07,Calaveras,009,45235,168,119,0,119,1
2020-08-07,Colusa,011,21464,408,358,0,358,4
2020-08-07,Contra Costa,013,1133247,11762,8810,34,8844,126
2020-08-07,Del Norte,015,27424,97,69,0,69,0
2020-08-07,El Dorado,017,186661,873,724,0,724,2
2020-08-07,Fresno,019,978130,23711,17290,232,17522,171
2020-08-07,Glenn,021,27897,405,339,0,339,1
2020-08-07,Humboldt,023,135768,301,274,1,275,4
2020-08-07,Imperial,025,180216,10658,8085,7,8092,164
2020-08-07,Inyo,027,18085,112,81,1,82,1
2020-08-07,Kern,029,883053,26807,22143,154,22297,206
2020-08-07,Kings,031,150075,5259,4315,30,4345,48
2020-08-07,Lake,033,64148,262,215,0,215,1
2020-08-07,Lassen,035,31185,697,588,2,590,0
2020-08-07,Los Angeles,037,10098052,216224,204406,727,205133,4924
2020-08-07,Madera,039,155013,3215,2245,13,2258,20
2020-08-07,Marin,041,260295,5668,5094,10,5104,43
2020-08-07,Mariposa,043,17540,65,53,0,53,2
2020-08-07,Mendocino,045,87422,427,262,0,262,1
2020-08-07,Merced,047,269075,6716,4358,3,4361,30
2020-08-07,Modoc,049,8938,7,4,0,4,0
2020-08-07,Mono,051,14174,160,112,2,114,1
2020-08-07,Monterey,053,433212,6402,5041,19,5060,33
2020-08-07,Napa,055,140530,1266,1055,2,1057,8
2020-08-07,Nevada,057,99092,372,324,13,337,1
2020-08-07,Orange,059,3164182,46049,38459,909,39368,701
2020-08-07,Placer,061,380077,2584,2078,4,2082,20
2020-08-07,Plumas,063,18699,38,25,0,25,0
2020-08-07,Riverside,065,2383286,48131,40902,49,40951,810
2020-08-07,Sacramento,067,1510023,14482,10798,14,10812,160
2020-08-07,San Benito,069,59416,800,647,0,647,2
2020-08-07,San Bernardino,071,2135413,43470,35200,208,35408,524
2020-08-07,San Diego,073,3302833,34570,31781,81,31862,586
2020-08-07,San Francisco,075,870044,8052,6765,8,6773,66
2020-08-07,San Joaquin,077,732212,15980,12392,19,12411,223
2020-08-07,San Luis Obispo,079,281455,2436,2050,14,2064,14
2020-08-07,San Mateo,081,765935,7206,5948,7,5955,117
2020-08-07,Santa Barbara,083,443738,7266,6509,66,6575,66
2020-08-07,Santa Clara,085,1922200,14733,11409,33,11442,180
2020-08-07,Santa Cruz,087,273765,1479,1234,10,1244,5
2020-08-07,Shasta,089,179085,540,342,3,345,9
2020-08-07,Sierra,091,2930,5,3,0,3,0
2020-08-07,Siskiyou,093,43540,109,73,0,73,0
2020-08-07,Solano,095,438530,4692,3844,28,3872,31
2020-08-07,Sonoma,097,501317,4304,3329,8,3337,34
2020-08-07,Stanislaus,099,539301,12964,9665,103,9768,98
2020-08-07,Sutter,101,95872,1020,807,1,808,6
2020-08-07,Tehama,103,63373,314,246,2,248,1
2020-08-07,Trinity,105,12862,30,5,6,11,0
2020-08-07,Tulare,107,460477,12453,10292,35,10327,195
2020-08-07,Tuolumne,109,53932,160,136,2,138,1
2020-08-07,Ventura,111,848112,9631,8356,44,8400,84
2020-08-07,Yolo,113,214977,2044,1689,4,1693,37
2020-08-07,Yuba,115,75493,615,413,1,414,1
2020-08-06,Alameda,001,1643700,15041,12474,111,12585,200
2020-08-06,Alpine,003,1148,2,2,0,2,0
2020-08-06,Amador,005,37829,228,125,0,125,0
2020-08-06,Butte,007,227075,1357,1060,16,1076,13
2020-08-06,Calaveras,009,45235,166,117,0,117,1
2020-08-06,Colusa,011,21464,405,358,0,358,3
2020-08-06,Contra Costa,013,1133247,11568,8583,33,8616,124
2020-08-06,Del Norte,015,27424,97,69,0,69,0
2020-08-06,El Dorado,017,186661,862,703,0,703,1
2020-08-06,Fresno,019,978130,23413,17031,225,17256,161
2020-08-06,Glenn,021,27897,400,332,0,332,1
2020-08-06,Humboldt,023,135768,296,266,1,267,4
2020-08-06,Imperial,025,180216,10615,8064,7,8071,163
2020-08-06,Inyo,027,18085,104,83,1,84,1
2020-08-06,Kern,029,883053,26571,21843,153,21996,197
2020-08-06,Kings,031,150075,5197,4264,29,4293,47
2020-08-06,Lake,033,64148,259,209,0,209,1
2020-08-06,Lassen,035,31185,695,588,2,590,0
2020-08-06,Los Angeles,037,10098052,214154,201372,711,202083,4874
2020-08-06,Madera,039,155013,3167,2240,12,2252,19
2020-08-06,Marin,041,260295,5636,5058,10,5068,43
2020-08-06,Mariposa,043,17540,64,52,0,52,2
2020-08-06,Mendocino,045,87422,413,260,0,260,1
2020-08-06,Merced,047,269075,6615,4235,3,4238,30
2020-08-06,Modoc,049,8938,7,4,0,4,0
2020-08-06,Mono,051,14174,159,111,2,113,1
2020-08-06,Monterey,053,433212,6293,5001,18,5019,33
2020-08-06,Napa,055,140530,1252,1032,2,1034,8
2020-08-06,Nevada,057,99092,367,321,13,334,1
2020-08-06,Orange,059,3164182,45757,38399,904,39303,694
2020-08-06,Placer,061,380077,2558,2045,4,2049,20
2020-08-06,Plumas,063,18699,37,25,0,25,0
2020-08-06,Riverside,065,2383286,47736,40269,49,40318,781
2020-08-06,Sacramento,067,1510023,14253,10548,14,10562,153
2020-08-06,San Benito,069,59416,792,626,0,626,2
2020-08-06,San Bernardino,071,2135413,43065,34819,206,35025,516
2020-08-06,San Diego,073,3302833,34303,31129,74,31203,583
2020-08-06,San Francisco,075,870044,7959,6737,7,6744,60
2020-08-06,San Joaquin,077,732212,15820,12269,19,12288,203
2020-08-06,San Luis Obispo,079,281455,2412,2000,13,2013,13
2020-08-06,San Mateo,081,765935,7106,5885,7,5892,117
2020-08-06,Santa Barbara,083,443738,7206,6620,66,6686,65
2020-08-06,Santa Clara,085,1922200,14504,11280,33,11313,178
2020-08-06,Santa Cruz,087,273765,1458,1215,10,1225,4
2020-08-06,Shasta,089,179085,531,343,3,346,9
2020-08-06,Sierra,091,2930,5,3,0,3,0
2020-08-06,Siskiyou,093,43540,109,73,0,73,0
2020-08-06,Solano,095,438530,4649,3784,28,3812,29
2020-08-06,Sonoma,097,501317,4240,3259,8,3267,33
2020-08-06,Stanislaus,099,539301,12814,9566,87,9653,98
2020-08-06,Sutter,101,95872,989,797,1,798,6
2020-08-06,Tehama,103,63373,311,242,2,244,1
2020-08-06,Trinity,105,12862,27,5,6,11,0
2020-08-06,Tulare,107,460477,12294,10169,35,10204,195
2020-08-06,Tuolumne,109,53932,159,136,2,138,1
2020-08-06,Ventura,111,848112,9516,8245,41,8286,80
2020-08-06,Yolo,113,214977,2020,1662,4,1666,36
2020-08-06,Yuba,115,75493,606,407,0,407,1
2020-08-05,Alameda,001,1643700,14827,12140,111,12251,193
2020-08-05,Alpine,003,1148,2,2,0,2,0
2020-08-05,Amador,005,37829,218,123,0,123,0
2020-08-05,Butte,007,227075,1323,1038,15,1053,13
2020-08-05,Calaveras,009,45235,163,116,0,116,1
2020-08-05,Colusa,011,21464,401,354,0,354,3
2020-08-05,Contra Costa,013,1133247,11399,8362,33,8395,122
2020-08-05,Del Norte,015,27424,96,69,0,69,0
2020-08-05,El Dorado,017,186661,854,692,0,692,1
2020-08-05,Fresno,019,978130,23169,16625,220,16845,159
2020-08-05,Glenn,021,27897,397,330,0,330,1
2020-08-05,Humboldt,023,135768,294,249,1,250,4
2020-08-05,Imperial,025,180216,10580,8036,7,8043,163
2020-08-05,Inyo,027,18085,102,62,1,63,1
2020-08-05,Kern,029,883053,26383,21540,148,21688,194
2020-08-05,Kings,031,150075,5152,4192,27,4219,47
2020-08-05,Lake,033,64148,252,209,0,209,1
2020-08-05,Lassen,035,31185,648,557,2,559,0
2020-08-05,Los Angeles,037,10098052,212237,198355,691,199046,4832
2020-08-05,Madera,039,155013,3125,2172,12,2184,19
2020-08-05,Marin,041,260295,5604,5036,10,5046,43
2020-08-05,Mariposa,043,17540,64,52,0,52,2
2020-08-05,Mendocino,045,87422,401,248,0,248,1
2020-08-05,Merced,047,269075,6480,4119,3,4122,30
2020-08-05,Modoc,049,8938,7,3,0,3,0
2020-08-05,Mono,051,14174,159,104,2,106,1
2020-08-05,Monterey,053,433212,6178,4936,18,4954,32
2020-08-05,Napa,055,140530,1240,1020,2,1022,8
2020-08-05,Nevada,057,99092,358,327,13,340,2
2020-08-05,Orange,059,3164182,45448,37907,896,38803,663
2020-08-05,Placer,061,380077,2517,1989,4,1993,18
2020-08-05,Plumas,063,18699,36,25,0,25,0
2020-08-05,Riverside,065,2383286,47344,39454,47,39501,761
2020-08-05,Sacramento,067,1510023,14034,10261,13,10274,151
2020-08-05,San Benito,069,59416,783,613,0,613,2
2020-08-05,San Bernardino,071,2135413,42603,34442,201,34643,504
2020-08-05,San Diego,073,3302833,34079,30866,58,30924,578
2020-08-05,San Francisco,075,870044,7866,6701,7,6708,60
2020-08-05,San Joaquin,077,732212,15657,12148,19,12167,199
2020-08-05,San Luis Obispo,079,281455,2388,1928,13,1941,13
2020-08-05,San Mateo,081,765935,7010,5695,7,5702,116
2020-08-05,Santa Barbara,083,443738,7146,6597,66,6663,63
2020-08-05,Santa Clara,085,1922200,14270,11074,33,11107,176
2020-08-05,Santa Cruz,087,273765,1438,1192,8,1200,4
2020-08-05,Shasta,089,179085,525,338,3,341,9
2020-08-05,Sierra,091,2930,5,3,0,3,0
2020-08-05,Siskiyou,093,43540,105,72,0,72,0
2020-08-05,Solano,095,438530,4598,3750,27,3777,29
2020-08-05,Sonoma,097,501317,4157,3173,8,3181,33
2020-08-05,Stanislaus,099,539301,12655,9408,82,9490,97
2020-08-05,Sutter,101,95872,978,780,1,781,6
2020-08-05,Tehama,103,63373,308,231,2,233,1
2020-08-05,Trinity,105,12862,27,5,6,11,0
2020-08-05,Tulare,107,460477,12154,9924,35,9959,192
2020-08-05,Tuolumne,109,53932,159,137,2,139,0
2020-08-05,Ventura,111,848112,9400,8162,37,8199,75
2020-08-05,Yolo,113,214977,1992,1634,4,1638,36
2020-08-05,Yuba,115,75493,589,400,0,400,1
2020-08-04,Alameda,001,1643700,14610,11983,110,12093,192
2020-08-04,Alpine,003,1148,2,2,0,2,0
2020-08-04,Amador,005,37829,203,123,0,123,0
2020-08-04,Butte,007,227075,1299,1011,15,1026,10
2020-08-04,Calaveras,009,45235,159,116,0,116,1
2020-08-04,Colusa,011,21464,396,354,0,354,3
2020-08-04,Contra Costa,013,1133247,11232,8210,33,8243,122
2020-08-04,Del Norte,015,27424,94,69,0,69,0
2020-08-04,El Dorado,017,186661,844,668,0,668,1
2020-08-04,Fresno,019,978130,22885,16272,213,16485,154
2020-08-04,Glenn,021,27897,396,325,0,325,1
2020-08-04,Humboldt,023,135768,284,241,1,242,4
2020-08-04,Imperial,025,180216,10543,7974,7,7981,163
2020-08-04,Inyo,027,18085,88,59,1,60,1
2020-08-04,Kern,029,883053,26100,21403,148,21551,190
2020-08-04,Kings,031,150075,5087,4163,27,4190,47
2020-08-04,Lake,033,64148,252,206,0,206,1
2020-08-04,Lassen,035,31185,645,556,2,558,0
2020-08-04,Los Angeles,037,10098052,210309,196014,660,196674,4764
2020-08-04,Madera,039,155013,3082,2161,8,2169,19
2020-08-04,Marin,041,260295,5573,5020,9,5029,43
2020-08-04,Mariposa,043,17540,64,51,0,51,2
2020-08-04,Mendocino,045,87422,376,248,0,248,1
2020-08-04,Merced,047,269075,6366,4085,3,4088,30
2020-08-04,Modoc,049,8938,7,3,0,3,0
2020-08-04,Mono,051,14174,158,104,1,105,1
2020-08-04,Monterey,053,433212,6064,4892,18,4910,32
2020-08-04,Napa,055,140530,1227,994,0,994,8
2020-08-04,Nevada,057,99092,357,322,13,335,2
2020-08-04,Orange,059,3164182,45072,37844,890,38734,659
2020-08-04,Placer,061,380077,2480,1964,4,1968,17
2020-08-04,Plumas,063,18699,36,25,0,25,0
2020-08-04,Riverside,065,2383286,46959,38991,46,39037,743
2020-08-04,Sacramento,067,1510023,13816,10205,13,10218,146
2020-08-04,San Benito,069,59416,767,608,0,608,2
2020-08-04,San Bernardino,071,2135413,42053,34215,196,34411,495
2020-08-04,San Diego,073,3302833,33786,30518,46,30564,568
2020-08-04,San Francisco,075,870044,7778,6568,7,6575,60
2020-08-04,San Joaquin,077,732212,15528,12087,16,12103,189
2020-08-04,San Luis Obispo,079,281455,2358,1886,13,1899,13
2020-08-04,San Mateo,081,765935,6904,5690,7,5697,116
2020-08-04,Santa Barbara,083,443738,7086,6591,66,6657,61
2020-08-04,Santa Clara,085,1922200,13969,10986,32,11018,175
2020-08-04,Santa Cruz,087,273765,1419,1202,8,1210,4
2020-08-04,Shasta,089,179085,519,335,3,338,9
2020-08-04,Sierra,091,2930,5,1,0,1,0
2020-08-04,Siskiyou,093,43540,103,71,0,71,0
2020-08-04,Solano,095,438530,4527,3690,27,3717,29
2020-08-04,Sonoma,097,501317,4090,3108,8,3116,33
2020-08-04,Stanislaus,099,539301,12487,9359,74,9433,97
2020-08-04,Sutter,101,95872,964,761,1,762,6
2020-08-04,Tehama,103,63373,301,226,2,228,1
2020-08-04,Trinity,105,12862,27,5,6,11,0
2020-08-04,Tulare,107,460477,11974,9866,35,9901,192
2020-08-04,Tuolumne,109,53932,158,127,2,129,0
2020-08-04,Ventura,111,848112,9286,8134,35,8169,75
2020-08-04,Yolo,113,214977,1966,1626,4,1630,37
2020-08-04,Yuba,115,75493,574,398,0,398,1
2020-08-03,Alameda,001,1643700,14426,11817,106,11923,189
2020-08-03,Alpine,003,1148,2,2,0,2,0
2020-08-03,Amador,005,37829,199,119,0,119,0
2020-08-03,Butte,007,227075,1253,989,14,1003,9
2020-08-03,Calaveras,009,45235,156,117,0,117,1
2020-08-03,Colusa,011,21464,392,336,0,336,2
2020-08-03,Contra Costa,013,1133247,11035,8069,30,8099,120
2020-08-03,Del Norte,015,27424,90,68,0,68,0
2020-08-03,El Dorado,017,186661,833,645,0,645,1
2020-08-03,Fresno,019,978130,22591,15945,207,16152,151
2020-08-03,Glenn,021,27897,389,316,0,316,1
2020-08-03,Humboldt,023,135768,277,234,1,235,4
2020-08-03,Imperial,025,180216,10488,7953,7,7960,161
2020-08-03,Inyo,027,18085,85,57,1,58,1
2020-08-03,Kern,029,883053,25733,21285,141,21426,176
2020-08-03,Kings,031,150075,4975,4107,26,4133,47
2020-08-03,Lake,033,64148,245,201,0,201,1
2020-08-03,Lassen,035,31185,645,555,2,557,0
2020-08-03,Los Angeles,037,10098052,208279,194103,629,194732,4706
2020-08-03,Madera,039,155013,3033,2143,7,2150,18
2020-08-03,Marin,041,260295,5526,5001,9,5010,43
2020-08-03,Mariposa,043,17540,63,52,0,52,2
2020-08-03,Mendocino,045,87422,353,248,0,248,1
2020-08-03,Merced,047,269075,6244,4028,3,4031,29
2020-08-03,Modoc,049,8938,7,2,0,2,0
2020-08-03,Mono,051,14174,158,104,1,105,1
2020-08-03,Monterey,053,433212,5913,4806,15,4821,28
2020-08-03,Napa,055,140530,1213,973,0,973,8
2020-08-03,Nevada,057,99092,352,315,13,328,2
2020-08-03,Orange,059,3164182,44678,37705,880,38585,651
2020-08-03,Placer,061,380077,2425,1947,3,1950,16
2020-08-03,Plumas,063,18699,36,25,0,25,0
2020-08-03,Riverside,065,2383286,46491,38642,46,38688,740
2020-08-03,Sacramento,067,1510023,13621,10143,13,10156,142
2020-08-03,San Benito,069,59416,755,603,0,603,2
2020-08-03,San Bernardino,071,2135413,41526,33979,190,34169,444
2020-08-03,San Diego,073,3302833,33472,30228,36,30264,565
2020-08-03,San Francisco,075,870044,7684,6319,7,6326,60
2020-08-03,San Joaquin,077,732212,15331,12007,15,12022,189
2020-08-03,San Luis Obispo,079,281455,2316,1863,10,1873,14
2020-08-03,San Mateo,081,765935,6823,5661,7,5668,115
2020-08-03,Santa Barbara,083,443738,7042,6580,66,6646,59
2020-08-03,Santa Clara,085,1922200,13693,10747,32,10779,172
2020-08-03,Santa Cruz,087,273765,1399,1154,8,1162,4
2020-08-03,Shasta,089,179085,512,322,3,325,9
2020-08-03,Sierra,091,2930,5,1,0,1,0
2020-08-03,Siskiyou,093,43540,99,67,0,67,0
2020-08-03,Solano,095,438530,4458,3610,26,3636,29
2020-08-03,Sonoma,097,501317,3989,3079,7,3086,33
2020-08-03,Stanislaus,099,539301,12278,9308,66,9374,96
2020-08-03,Sutter,101,95872,940,713,1,714,6
2020-08-03,Tehama,103,63373,293,225,2,227,1
2020-08-03,Trinity,105,12862,27,5,6,11,0
2020-08-03,Tulare,107,460477,11790,9703,35,9738,188
2020-08-03,Tuolumne,109,53932,158,123,2,125,0
2020-08-03,Ventura,111,848112,9195,8084,32,8116,74
2020-08-03,Yolo,113,214977,1931,1598,3,1601,37
2020-08-03,Yuba,115,75493,550,393,0,393,1
2020-08-02,Alameda,001,1643700,14180,11696,94,11790,188
2020-08-02,Alpine,003,1148,2,2,0,2,0
2020-08-02,Amador,005,37829,194,117,0,117,0
2020-08-02,Butte,007,227075,1218,987,14,1001,9
2020-08-02,Calaveras,009,45235,153,116,0,116,1
2020-08-02,Colusa,011,21464,387,335,0,335,2
2020-08-02,Contra Costa,013,1133247,10796,7995,30,8025,118
2020-08-02,Del Norte,015,27424,89,68,0,68,0
2020-08-02,El Dorado,017,186661,823,643,0,643,1
2020-08-02,Fresno,019,978130,22316,15759,201,15960,151
2020-08-02,Glenn,021,27897,388,315,0,315,1
2020-08-02,Humboldt,023,135768,272,232,1,233,4
2020-08-02,Imperial,025,180216,10425,7919,7,7926,157
2020-08-02,Inyo,027,18085,84,45,1,46,1
2020-08-02,Kern,029,883053,25435,21162,139,21301,176
2020-08-02,Kings,031,150075,4913,3964,25,3989,47
2020-08-02,Lake,033,64148,240,201,0,201,1
2020-08-02,Lassen,035,31185,645,555,2,557,0
2020-08-02,Los Angeles,037,10098052,206194,192480,611,193091,4698
2020-08-02,Madera,039,155013,2967,2123,5,2128,18
2020-08-02,Marin,041,260295,5491,4985,9,4994,43
2020-08-02,Mariposa,043,17540,61,52,0,52,2
2020-08-02,Mendocino,045,87422,343,247,0,247,1
2020-08-02,Merced,047,269075,6102,4011,3,4014,29
2020-08-02,Modoc,049,8938,7,2,0,2,0
2020-08-02,Mono,051,14174,151,104,1,105,1
2020-08-02,Monterey,053,433212,5787,4698,15,4713,28
2020-08-02,Napa,055,140530,1198,956,0,956,8
2020-08-02,Nevada,057,99092,349,314,13,327,2
2020-08-02,Orange,059,3164182,44297,37266,869,38135,651
2020-08-02,Placer,061,380077,2386,1920,3,1923,15
2020-08-02,Plumas,063,18699,36,25,0,25,0
2020-08-02,Riverside,065,2383286,46058,38507,45,38552,735
2020-08-02,Sacramento,067,1510023,13342,10099,13,10112,142
2020-08-02,San Benito,069,59416,741,599,0,599,2
2020-08-02,San Bernardino,071,2135413,40924,33643,186,33829,443
2020-08-02,San Diego,073,3302833,33132,29885,27,29912,565
2020-08-02,San Francisco,075,870044,7566,6297,7,6304,60
2020-08-02,San Joaquin,077,732212,15045,11937,13,11950,189
2020-08-02,San Luis Obispo,079,281455,2253,1821,10,1831,14
2020-08-02,San Mateo,081,765935,6708,5618,7,5625,115
2020-08-02,Santa Barbara,083,443738,6952,6532,66,6598,59
2020-08-02,Santa Clara,085,1922200,13475,10577,32,10609,172
2020-08-02,Santa Cruz,087,273765,1379,1162,8,1170,4
2020-08-02,Shasta,089,179085,508,318,3,321,9
2020-08-02,Sierra,091,2930,4,1,0,1,0
2020-08-02,Siskiyou,093,43540,99,65,0,65,0
2020-08-02,Solano,095,438530,4399,3609,26,3635,29
2020-08-02,Sonoma,097,501317,3905,3005,7,3012,33
2020-08-02,Stanislaus,099,539301,12063,9277,61,9338,96
2020-08-02,Sutter,101,95872,905,714,1,715,6
2020-08-02,Tehama,103,63373,287,222,2,224,1
2020-08-02,Trinity,105,12862,27,5,6,11,0
2020-08-02,Tulare,107,460477,11581,9593,35,9628,188
2020-08-02,Tuolumne,109,53932,155,123,2,125,0
2020-08-02,Ventura,111,848112,9048,8014,32,8046,73
2020-08-02,Yolo,113,214977,1906,1588,3,1591,37
2020-08-02,Yuba,115,75493,530,393,0,393,1
2020-08-01,Alameda,001,1643700,14068,11590,94,11684,188
2020-08-01,Alpine,003,1148,2,2,0,2,0
2020-08-01,Amador,005,37829,190,109,0,109,0
2020-08-01,Butte,007,227075,1204,976,14,990,9
2020-08-01,Calaveras,009,45235,149,116,0,116,1
2020-08-01,Colusa,011,21464,386,327,0,327,2
2020-08-01,Contra Costa,013,1133247,10663,7867,29,7896,116
2020-08-01,Del Norte,015,27424,89,68,0,68,0
2020-08-01,El Dorado,017,186661,820,637,0,637,1
2020-08-01,Fresno,019,978130,22179,15448,201,15649,149
2020-08-01,Glenn,021,27897,387,311,0,311,1
2020-08-01,Humboldt,023,135768,271,232,1,233,4
2020-08-01,Imperial,025,180216,10389,7919,7,7926,156
2020-08-01,Inyo,027,18085,82,45,1,46,1
2020-08-01,Kern,029,883053,25277,20796,135,20931,176
2020-08-01,Kings,031,150075,4887,3948,25,3973,47
2020-08-01,Lake,033,64148,238,194,0,194,1
2020-08-01,Lassen,035,31185,644,555,2,557,0
2020-08-01,Los Angeles,037,10098052,205301,191023,584,191607,4674
2020-08-01,Madera,039,155013,2928,2103,5,2108,18
2020-08-01,Marin,041,260295,5476,4945,9,4954,43
2020-08-01,Mariposa,043,17540,61,50,0,50,2
2020-08-01,Mendocino,045,87422,336,243,0,243,1
2020-08-01,Merced,047,269075,6054,3972,3,3975,29
2020-08-01,Modoc,049,8938,7,2,0,2,0
2020-08-01,Mono,051,14174,150,104,1,105,1
2020-08-01,Monterey,053,433212,5720,4611,14,4625,28
2020-08-01,Napa,055,140530,1189,923,0,923,8
2020-08-01,Nevada,057,99092,345,305,13,318,2
2020-08-01,Orange,059,3164182,44070,36703,863,37566,648
2020-08-01,Placer,061,380077,2352,1891,3,1894,14
2020-08-01,Plumas,063,18699,35,25,0,25,0
2020-08-01,Riverside,065,2383286,45846,38216,43,38259,704
2020-08-01,Sacramento,067,1510023,13191,10044,13,10057,141
2020-08-01,San Benito,069,59416,730,579,0,579,2
2020-08-01,San Bernardino,071,2135413,40688,32947,185,33132,440
2020-08-01,San Diego,073,3302833,32915,29579,19,29598,565
2020-08-01,San Francisco,075,870044,7504,6296,7,6303,60
2020-08-01,San Joaquin,077,732212,14972,11807,12,11819,189
2020-08-01,San Luis Obispo,079,281455,2224,1798,10,1808,13
2020-08-01,San Mateo,081,765935,6654,5520,7,5527,115
2020-08-01,Santa Barbara,083,443738,6912,6465,66,6531,59
2020-08-01,Santa Clara,085,1922200,13324,10281,31,10312,171
2020-08-01,Santa Cruz,087,273765,1363,1164,8,1172,4
2020-08-01,Shasta,089,179085,503,312,3,315,9
2020-08-01,Sierra,091,2930,3,1,0,1,0
2020-08-01,Siskiyou,093,43540,99,64,0,64,0
2020-08-01,Solano,095,438530,4365,3591,25,3616,29
2020-08-01,Sonoma,097,501317,3859,2890,7,2897,29
2020-08-01,Stanislaus,099,539301,11945,9221,53,9274,96
2020-08-01,Sutter,101,95872,901,714,1,715,6
2020-08-01,Tehama,103,63373,284,220,2,222,1
2020-08-01,Trinity,105,12862,27,5,6,11,0
2020-08-01,Tulare,107,460477,11513,9520,35,9555,188
2020-08-01,Tuolumne,109,53932,155,123,2,125,0
2020-08-01,Ventura,111,848112,9002,7819,32,7851,73
2020-08-01,Yolo,113,214977,1896,1557,3,1560,37
2020-08-01,Yuba,115,75493,525,387,0,387,1
2020-07-31,Alameda,001,1643700,13937,11441,94,11535,187
2020-07-31,Alpine,003,1148,2,2,0,2,0
2020-07-31,Amador,005,37829,189,98,0,98,0
2020-07-31,Butte,007,227075,1181,925,14,939,7
2020-07-31,Calaveras,009,45235,149,112,0,112,1
2020-07-31,Colusa,011,21464,376,319,0,319,2
2020-07-31,Contra Costa,013,1133247,10515,7697,28,7725,113
2020-07-31,Del Norte,015,27424,88,68,0,68,0
2020-07-31,El Dorado,017,186661,809,616,0,616,1
2020-07-31,Fresno,019,978130,21959,15083,201,15284,133
2020-07-31,Glenn,021,27897,380,304,0,304,1
2020-07-31,Humboldt,023,135768,264,229,1,230,4
2020-07-31,Imperial,025,180216,10357,7886,7,7893,155
2020-07-31,Inyo,027,18085,72,45,1,46,1
2020-07-31,Kern,029,883053,25036,20061,131,20192,173
2020-07-31,Kings,031,150075,4859,3807,25,3832,45
2020-07-31,Lake,033,64148,237,191,0,191,1
2020-07-31,Lassen,035,31185,639,544,2,546,0
2020-07-31,Los Angeles,037,10098052,203701,188688,571,189259,4628
2020-07-31,Madera,039,155013,2881,2036,5,2041,19
2020-07-31,Marin,041,260295,5432,4885,6,4891,43
2020-07-31,Mariposa,043,17540,61,49,0,49,2
2020-07-31,Mendocino,045,87422,321,232,0,232,1
2020-07-31,Merced,047,269075,5971,3789,3,3792,30
2020-07-31,Modoc,049,8938,6,0,0,0,0
2020-07-31,Mono,051,14174,149,104,1,105,1
2020-07-31,Monterey,053,433212,5628,4493,14,4507,24
2020-07-31,Napa,055,140530,1177,897,0,897,7
2020-07-31,Nevada,057,99092,343,302,13,315,2
2020-07-31,Orange,059,3164182,43771,36196,848,37044,620
2020-07-31,Placer,061,380077,2327,1853,3,1856,14
2020-07-31,Plumas,063,18699,34,25,0,25,0
2020-07-31,Riverside,065,2383286,45456,37612,42,37654,694
2020-07-31,Sacramento,067,1510023,13013,9872,13,9885,132
2020-07-31,San Benito,069,59416,722,567,0,567,2
2020-07-31,San Bernardino,071,2135413,40358,32332,184,32516,434
2020-07-31,San Diego,073,3302833,32681,29050,11,29061,561
2020-07-31,San Francisco,075,870044,7405,6126,7,6133,60
2020-07-31,San Joaquin,077,732212,14832,11561,12,11573,177
2020-07-31,San Luis Obispo,079,281455,2155,1746,10,1756,12
2020-07-31,San Mateo,081,765935,6582,5416,7,5423,115
2020-07-31,Santa Barbara,083,443738,6845,6375,66,6441,58
2020-07-31,Santa Clara,085,1922200,13103,9863,31,9894,171
2020-07-31,Santa Cruz,087,273765,1340,1118,8,1126,4
2020-07-31,Shasta,089,179085,493,305,3,308,9
2020-07-31,Sierra,091,2930,3,1,0,1,0
2020-07-31,Siskiyou,093,43540,97,61,0,61,0
2020-07-31,Solano,095,438530,4318,3510,24,3534,29
2020-07-31,Sonoma,097,501317,3801,2745,7,2752,27
2020-07-31,Stanislaus,099,539301,11838,9061,48,9109,94
2020-07-31,Sutter,101,95872,896,714,1,715,6
2020-07-31,Tehama,103,63373,281,213,2,215,1
2020-07-31,Trinity,105,12862,27,5,6,11,0
2020-07-31,Tulare,107,460477,11392,9365,35,9400,184
2020-07-31,Tuolumne,109,53932,155,120,2,122,0
2020-07-31,Ventura,111,848112,8927,7521,32,7553,71
2020-07-31,Yolo,113,214977,1870,1522,3,1525,38
2020-07-31,Yuba,115,75493,516,369,0,369,1
2020-07-30,Alameda,001,1643700,13734,11303,54,11357,185
2020-07-30,Alpine,003,1148,2,2,0,2,0
2020-07-30,Amador,005,37829,171,97,0,97,0
2020-07-30,Butte,007,227075,1165,915,14,929,7
2020-07-30,Calaveras,009,45235,145,111,0,111,1
2020-07-30,Colusa,011,21464,373,315,0,315,2
2020-07-30,Contra Costa,013,1133247,10330,7615,27,7642,112
2020-07-30,Del Norte,015,27424,88,68,0,68,0
2020-07-30,El Dorado,017,186661,802,608,0,608,1
2020-07-30,Fresno,019,978130,21623,14793,195,14988,133
2020-07-30,Glenn,021,27897,373,297,0,297,1
2020-07-30,Humboldt,023,135768,262,228,1,229,4
2020-07-30,Imperial,025,180216,10298,7849,7,7856,151
2020-07-30,Inyo,027,18085,68,44,1,45,1
2020-07-30,Kern,029,883053,24743,19552,127,19679,171
2020-07-30,Kings,031,150075,4755,3785,25,3810,43
2020-07-30,Lake,033,64148,231,181,0,181,1
2020-07-30,Lassen,035,31185,636,544,2,546,0
2020-07-30,Los Angeles,037,10098052,201672,186177,539,186716,4564
2020-07-30,Madera,039,155013,2811,2007,5,2012,18
2020-07-30,Marin,041,260295,5390,4835,5,4840,39
2020-07-30,Mariposa,043,17540,61,49,0,49,1
2020-07-30,Mendocino,045,87422,314,232,0,232,1
2020-07-30,Merced,047,269075,5806,3695,3,3698,30
2020-07-30,Modoc,049,8938,6,0,0,0,0
2020-07-30,Mono,051,14174,148,104,1,105,1
2020-07-30,Monterey,053,433212,5516,4352,14,4366,24
2020-07-30,Napa,055,140530,1160,874,0,874,7
2020-07-30,Nevada,057,99092,338,292,13,305,2
2020-07-30,Orange,059,3164182,43356,36105,823,36928,607
2020-07-30,Placer,061,380077,2276,1821,3,1824,14
2020-07-30,Plumas,063,18699,33,25,0,25,0
2020-07-30,Riverside,065,2383286,44915,37308,42,37350,685
2020-07-30,Sacramento,067,1510023,12794,9704,13,9717,126
2020-07-30,San Benito,069,59416,709,558,0,558,2
2020-07-30,San Bernardino,071,2135413,39835,32010,184,32194,427
2020-07-30,San Diego,073,3302833,32334,28670,9,28679,558
2020-07-30,San Francisco,075,870044,7305,6107,7,6114,59
2020-07-30,San Joaquin,077,732212,14638,11435,12,11447,161
2020-07-30,San Luis Obispo,079,281455,2119,1703,10,1713,12
2020-07-30,San Mateo,081,765935,6487,5369,7,5376,115
2020-07-30,Santa Barbara,083,443738,6765,6273,66,6339,52
2020-07-30,Santa Clara,085,1922200,12867,9708,30,9738,170
2020-07-30,Santa Cruz,087,273765,1312,1087,8,1095,4
2020-07-30,Shasta,089,179085,489,306,3,309,8
2020-07-30,Sierra,091,2930,3,1,0,1,0
2020-07-30,Siskiyou,093,43540,96,60,0,60,0
2020-07-30,Solano,095,438530,4267,3463,24,3487,29
2020-07-30,Sonoma,097,501317,3729,2684,7,2691,25
2020-07-30,Stanislaus,099,539301,11625,8890,40,8930,94
2020-07-30,Sutter,101,95872,877,698,1,699,6
2020-07-30,Tehama,103,63373,278,208,2,210,1
2020-07-30,Trinity,105,12862,26,4,6,10,0
2020-07-30,Tulare,107,460477,11263,9167,35,9202,177
2020-07-30,Tuolumne,109,53932,154,119,2,121,0
2020-07-30,Ventura,111,848112,8815,7304,30,7334,69
2020-07-30,Yolo,113,214977,1850,1511,3,1514,37
2020-07-30,Yuba,115,75493,503,362,0,362,1
2020-07-29,Alameda,001,1643700,13515,11177,49,11226,180
2020-07-29,Alpine,003,1148,2,2,0,2,0
2020-07-29,Amador,005,37829,163,80,0,80,0
2020-07-29,Butte,007,227075,1139,889,12,901,7
2020-07-29,Calaveras,009,45235,139,107,0,107,1
2020-07-29,Colusa,011,21464,369,302,0,302,2
2020-07-29,Contra Costa,013,1133247,10126,7520,27,7547,108
2020-07-29,Del Norte,015,27424,88,68,0,68,0
2020-07-29,El Dorado,017,186661,792,588,0,588,1
2020-07-29,Fresno,019,978130,21331,14312,195,14507,125
2020-07-29,Glenn,021,27897,366,294,0,294,1
2020-07-29,Humboldt,023,135768,259,221,1,222,4
2020-07-29,Imperial,025,180216,10250,7825,7,7832,147
2020-07-29,Inyo,027,18085,63,44,1,45,1
2020-07-29,Kern,029,883053,24405,19073,124,19197,162
2020-07-29,Kings,031,150075,4707,3755,25,3780,43
2020-07-29,Lake,033,64148,229,179,0,179,1
2020-07-29,Lassen,035,31185,621,513,2,515,0
2020-07-29,Los Angeles,037,10098052,199647,183600,522,184122,4523
2020-07-29,Madera,039,155013,2757,1941,5,1946,18
2020-07-29,Marin,041,260295,5352,4747,5,4752,34
2020-07-29,Mariposa,043,17540,60,47,0,47,1
2020-07-29,Mendocino,045,87422,306,228,0,228,0
2020-07-29,Merced,047,269075,5666,3605,3,3608,25
2020-07-29,Modoc,049,8938,5,0,0,0,0
2020-07-29,Mono,051,14174,145,102,1,103,1
2020-07-29,Monterey,053,433212,5417,4252,14,4266,24
2020-07-29,Napa,055,140530,1132,866,0,866,7
2020-07-29,Nevada,057,99092,334,288,13,301,1
2020-07-29,Orange,059,3164182,42922,35339,811,36150,589
2020-07-29,Placer,061,380077,2244,1798,3,1801,14
2020-07-29,Plumas,063,18699,33,25,0,25,0
2020-07-29,Riverside,065,2383286,44323,36968,42,37010,678
2020-07-29,Sacramento,067,1510023,12548,9538,13,9551,122
2020-07-29,San Benito,069,59416,694,537,0,537,2
2020-07-29,San Bernardino,071,2135413,39346,31168,173,31341,417
2020-07-29,San Diego,073,3302833,32009,28289,8,28297,552
2020-07-29,San Francisco,075,870044,7211,6041,7,6048,56
2020-07-29,San Joaquin,077,732212,14390,11249,9,11258,154
2020-07-29,San Luis Obispo,079,281455,2098,1673,10,1683,11
2020-07-29,San Mateo,081,765935,6399,5305,7,5312,114
2020-07-29,Santa Barbara,083,443738,6698,6215,66,6281,31
2020-07-29,Santa Clara,085,1922200,12660,9567,30,9597,165
2020-07-29,Santa Cruz,087,273765,1288,1051,8,1059,4
2020-07-29,Shasta,089,179085,477,297,3,300,8
2020-07-29,Sierra,091,2930,2,1,0,1,0
2020-07-29,Siskiyou,093,43540,94,58,0,58,0
2020-07-29,Solano,095,438530,4213,3380,24,3404,29
2020-07-29,Sonoma,097,501317,3652,2598,7,2605,26
2020-07-29,Stanislaus,099,539301,11404,8745,34,8779,94
2020-07-29,Sutter,101,95872,849,678,1,679,6
2020-07-29,Tehama,103,63373,274,206,2,208,1
2020-07-29,Trinity,105,12862,26,4,6,10,0
2020-07-29,Tulare,107,460477,11092,9028,35,9063,156
2020-07-29,Tuolumne,109,53932,154,118,2,120,0
2020-07-29,Ventura,111,848112,8710,7161,30,7191,68
2020-07-29,Yolo,113,214977,1824,1488,3,1491,36
2020-07-29,Yuba,115,75493,487,350,0,350,1
2020-07-28,Alameda,001,1643700,13287,10875,48,10923,180
2020-07-28,Alpine,003,1148,2,2,0,2,0
2020-07-28,Amador,005,37829,153,77,0,77,0
2020-07-28,Butte,007,227075,1104,857,12,869,7
2020-07-28,Calaveras,009,45235,138,105,0,105,1
2020-07-28,Colusa,011,21464,363,290,0,290,2
2020-07-28,Contra Costa,013,1133247,9904,7426,27,7453,107
2020-07-28,Del Norte,015,27424,87,68,0,68,0
2020-07-28,El Dorado,017,186661,777,558,0,558,1
2020-07-28,Fresno,019,978130,20995,13933,189,14122,125
2020-07-28,Glenn,021,27897,364,289,0,289,1
2020-07-28,Humboldt,023,135768,258,218,1,219,4
2020-07-28,Imperial,025,180216,10214,7804,7,7811,145
2020-07-28,Inyo,027,18085,61,43,1,44,1
2020-07-28,Kern,029,883053,24042,18834,118,18952,155
2020-07-28,Kings,031,150075,4661,3721,25,3746,41
2020-07-28,Lake,033,64148,225,179,0,179,1
2020-07-28,Lassen,035,31185,615,508,2,510,0
2020-07-28,Los Angeles,037,10098052,197418,179107,499,179606,4435
2020-07-28,Madera,039,155013,2691,1889,5,1894,18
2020-07-28,Marin,041,260295,5283,4698,5,4703,23
2020-07-28,Mariposa,043,17540,58,45,0,45,1
2020-07-28,Mendocino,045,87422,295,222,0,222,0
2020-07-28,Merced,047,269075,5521,3446,3,3449,23
2020-07-28,Modoc,049,8938,4,0,0,0,0
2020-07-28,Mono,051,14174,144,102,1,103,1
2020-07-28,Monterey,053,433212,5296,4047,14,4061,22
2020-07-28,Napa,055,140530,1110,824,0,824,6
2020-07-28,Nevada,057,99092,329,278,13,291,1
2020-07-28,Orange,059,3164182,42464,34832,798,35630,582
2020-07-28,Placer,061,380077,2209,1759,3,1762,14
2020-07-28,Plumas,063,18699,33,22,0,22,0
2020-07-28,Riverside,065,2383286,43721,36458,42,36500,668
2020-07-28,Sacramento,067,1510023,12289,9429,12,9441,117
2020-07-28,San Benito,069,59416,684,503,0,503,2
2020-07-28,San Bernardino,071,2135413,38822,30493,169,30662,412
2020-07-28,San Diego,073,3302833,31659,28007,6,28013,547
2020-07-28,San Francisco,075,870044,7098,5888,7,5895,56
2020-07-28,San Joaquin,077,732212,14107,10958,7,10965,141
2020-07-28,San Luis Obispo,079,281455,2065,1636,10,1646,9
2020-07-28,San Mateo,081,765935,6325,5171,7,5178,114
2020-07-28,Santa Barbara,083,443738,6635,6110,64,6174,31
2020-07-28,Santa Clara,085,1922200,12425,9307,30,9337,165
2020-07-28,Santa Cruz,087,273765,1261,1018,8,1026,4
2020-07-28,Shasta,089,179085,465,275,3,278,8
2020-07-28,Sierra,091,2930,2,1,0,1,0
2020-07-28,Siskiyou,093,43540,90,57,0,57,0
2020-07-28,Solano,095,438530,4166,3292,23,3315,29
2020-07-28,Sonoma,097,501317,3578,2553,7,2560,20
2020-07-28,Stanislaus,099,539301,11182,8492,26,8518,92
2020-07-28,Sutter,101,95872,812,653,0,653,2
2020-07-28,Tehama,103,63373,269,199,2,201,1
2020-07-28,Trinity,105,12862,26,3,6,9,0
2020-07-28,Tulare,107,460477,10905,8787,35,8822,96
2020-07-28,Tuolumne,109,53932,153,116,2,118,0
2020-07-28,Ventura,111,848112,8584,7045,29,7074,68
2020-07-28,Yolo,113,214977,1796,1459,3,1462,36
2020-07-28,Yuba,115,75493,470,333,0,333,1
2020-07-27,Alameda,001,1643700,13060,10645,45,10690,176
2020-07-27,Alpine,003,1148,2,2,0,2,0
2020-07-27,Amador,005,37829,148,72,0,72,0
2020-07-27,Butte,007,227075,1077,843,12,855,7
2020-07-27,Calaveras,009,45235,134,103,0,103,1
2020-07-27,Colusa,011,21464,356,271,0,271,2
2020-07-27,Contra Costa,013,1133247,9682,7256,27,7283,104
2020-07-27,Del Norte,015,27424,86,67,0,67,0
2020-07-27,El Dorado,017,186661,765,548,0,548,1
2020-07-27,Fresno,019,978130,20648,13485,183,13668,117
2020-07-27,Glenn,021,27897,362,277,0,277,1
2020-07-27,Humboldt,023,135768,253,218,1,219,4
2020-07-27,Imperial,025,180216,10164,7789,7,7796,144
2020-07-27,Inyo,027,18085,61,43,1,44,1
2020-07-27,Kern,029,883053,23540,17994,112,18106,148
2020-07-27,Kings,031,150075,4412,3685,25,3710,39
2020-07-27,Lake,033,64148,221,176,0,176,1
2020-07-27,Lassen,035,31185,615,503,2,505,0
2020-07-27,Los Angeles,037,10098052,194997,176351,481,176832,4379
2020-07-27,Madera,039,155013,2626,1793,5,1798,17
2020-07-27,Marin,041,260295,5195,4669,5,4674,22
2020-07-27,Mariposa,043,17540,58,43,0,43,1
2020-07-27,Mendocino,045,87422,282,209,0,209,0
2020-07-27,Merced,047,269075,5381,3292,3,3295,23
2020-07-27,Modoc,049,8938,3,0,0,0,0
2020-07-27,Mono,051,14174,140,99,1,100,1
2020-07-27,Monterey,053,433212,5106,3960,14,3974,21
2020-07-27,Napa,055,140530,1095,769,0,769,6
2020-07-27,Nevada,057,99092,325,268,13,281,1
2020-07-27,Orange,059,3164182,42024,34649,782,35431,566
2020-07-27,Placer,061,380077,2159,1679,3,1682,12
2020-07-27,Plumas,063,18699,33,22,0,22,0
2020-07-27,Riverside,065,2383286,43041,35822,42,35864,667
2020-07-27,Sacramento,067,1510023,11996,9091,12,9103,114
2020-07-27,San Benito,069,59416,669,498,0,498,2
2020-07-27,San Bernardino,071,2135413,38230,29928,159,30087,401
2020-07-27,San Diego,073,3302833,31285,27509,5,27514,533
2020-07-27,San Francisco,075,870044,7011,5825,7,5832,55
2020-07-27,San Joaquin,077,732212,13818,10728,7,10735,129
2020-07-27,San Luis Obispo,079,281455,2020,1612,10,1622,9
2020-07-27,San Mateo,081,765935,6216,5108,7,5115,113
2020-07-27,Santa Barbara,083,443738,6556,6026,62,6088,30
2020-07-27,Santa Clara,085,1922200,12156,9157,29,9186,166
2020-07-27,Santa Cruz,087,273765,1238,984,8,992,4
2020-07-27,Shasta,089,179085,458,275,3,278,8
2020-07-27,Sierra,091,2930,2,1,0,1,0
2020-07-27,Siskiyou,093,43540,88,54,0,54,0
2020-07-27,Solano,095,438530,4099,3198,22,3220,29
2020-07-27,Sonoma,097,501317,3487,2504,7,2511,20
2020-07-27,Stanislaus,099,539301,10955,8288,18,8306,84
2020-07-27,Sutter,101,95872,786,620,0,620,2
2020-07-27,Tehama,103,63373,261,192,2,194,1
2020-07-27,Trinity,105,12862,26,3,6,9,0
2020-07-27,Tulare,107,460477,10687,8462,35,8497,172
2020-07-27,Tuolumne,109,53932,150,115,2,117,0
2020-07-27,Ventura,111,848112,8456,6998,28,7026,68
2020-07-27,Yolo,113,214977,1751,1439,3,1442,33
2020-07-27,Yuba,115,75493,450,328,0,328,1
2020-07-26,Alameda,001,1643700,12822,10489,44,10533,176
2020-07-26,Alpine,003,1148,2,2,0,2,0
2020-07-26,Amador,005,37829,142,67,0,67,0
2020-07-26,Butte,007,227075,1040,822,12,834,5
2020-07-26,Calaveras,009,45235,131,103,0,103,1
2020-07-26,Colusa,011,21464,347,270,0,270,2
2020-07-26,Contra Costa,013,1133247,9445,7095,27,7122,104
2020-07-26,Del Norte,015,27424,84,67,0,67,0
2020-07-26,El Dorado,017,186661,747,539,0,539,1
2020-07-26,Fresno,019,978130,20257,13209,175,13384,117
2020-07-26,Glenn,021,27897,354,265,0,265,1
2020-07-26,Humboldt,023,135768,247,214,1,215,4
2020-07-26,Imperial,025,180216,10091,7781,7,7788,144
2020-07-26,Inyo,027,18085,56,43,1,44,1
2020-07-26,Kern,029,883053,23016,17394,109,17503,148
2020-07-26,Kings,031,150075,4353,3591,25,3616,39
2020-07-26,Lake,033,64148,213,174,0,174,1
2020-07-26,Lassen,035,31185,574,503,2,505,0
2020-07-26,Los Angeles,037,10098052,192430,174322,463,174785,4364
2020-07-26,Madera,039,155013,2539,1744,5,1749,17
2020-07-26,Marin,041,260295,5149,4595,5,4600,22
2020-07-26,Mariposa,043,17540,56,43,0,43,1
2020-07-26,Mendocino,045,87422,273,206,0,206,0
2020-07-26,Merced,047,269075,5201,3251,2,3253,23
2020-07-26,Modoc,049,8938,3,0,0,0,0
2020-07-26,Mono,051,14174,136,82,1,83,1
2020-07-26,Monterey,053,433212,4940,3901,14,3915,21
2020-07-26,Napa,055,140530,1076,769,0,769,6
2020-07-26,Nevada,057,99092,322,261,13,274,1
2020-07-26,Orange,059,3164182,41499,34352,750,35102,564
2020-07-26,Placer,061,380077,2095,1628,3,1631,12
2020-07-26,Plumas,063,18699,33,22,0,22,0
2020-07-26,Riverside,065,2383286,42480,35636,42,35678,665
2020-07-26,Sacramento,067,1510023,11691,8972,12,8984,114
2020-07-26,San Benito,069,59416,657,495,0,495,2
2020-07-26,San Bernardino,071,2135413,37591,29545,150,29695,400
2020-07-26,San Diego,073,3302833,30889,26986,4,26990,533
2020-07-26,San Francisco,075,870044,6903,5823,7,5830,55
2020-07-26,San Joaquin,077,732212,13525,10637,7,10644,129
2020-07-26,San Luis Obispo,079,281455,1977,1565,10,1575,8
2020-07-26,San Mateo,081,765935,6110,5078,7,5085,113
2020-07-26,Santa Barbara,083,443738,6455,5939,62,6001,30
2020-07-26,Santa Clara,085,1922200,11927,8986,29,9015,166
2020-07-26,Santa Cruz,087,273765,1211,970,8,978,4
2020-07-26,Shasta,089,179085,451,265,3,268,8
2020-07-26,Sierra,091,2930,2,1,0,1,0
2020-07-26,Siskiyou,093,43540,86,54,0,54,0
2020-07-26,Solano,095,438530,4019,3197,20,3217,29
2020-07-26,Sonoma,097,501317,3398,2503,6,2509,20
2020-07-26,Stanislaus,099,539301,10694,8228,17,8245,84
2020-07-26,Sutter,101,95872,772,612,0,612,2
2020-07-26,Tehama,103,63373,254,175,2,177,1
2020-07-26,Trinity,105,12862,26,3,6,9,0
2020-07-26,Tulare,107,460477,10480,8392,35,8427,172
2020-07-26,Tuolumne,109,53932,145,113,2,115,0
2020-07-26,Ventura,111,848112,8249,6844,28,6872,67
2020-07-26,Yolo,113,214977,1720,1408,3,1411,33
2020-07-26,Yuba,115,75493,431,313,0,313,1
2020-07-25,Alameda,001,1643700,12725,10361,42,10403,176
2020-07-25,Alpine,003,1148,2,2,0,2,0
2020-07-25,Amador,005,37829,139,67,0,67,0
2020-07-25,Butte,007,227075,1031,810,12,822,5
2020-07-25,Calaveras,009,45235,127,103,0,103,1
2020-07-25,Colusa,011,21464,340,265,0,265,2
2020-07-25,Contra Costa,013,1133247,9300,6920,27,6947,104
2020-07-25,Del Norte,015,27424,84,67,0,67,0
2020-07-25,El Dorado,017,186661,736,528,0,528,1
2020-07-25,Fresno,019,978130,20071,12866,175,13041,117
2020-07-25,Glenn,021,27897,352,260,0,260,1
2020-07-25,Humboldt,023,135768,244,212,1,213,4
2020-07-25,Imperial,025,180216,10065,7727,7,7734,144
2020-07-25,Inyo,027,18085,55,43,1,44,1
2020-07-25,Kern,029,883053,22798,16910,108,17018,148
2020-07-25,Kings,031,150075,4336,3516,25,3541,39
2020-07-25,Lake,033,64148,211,173,0,173,1
2020-07-25,Lassen,035,31185,574,503,2,505,0
2020-07-25,Los Angeles,037,10098052,191300,172611,456,173067,4357
2020-07-25,Madera,039,155013,2507,1724,5,1729,17
2020-07-25,Marin,041,260295,5133,4562,5,4567,22
2020-07-25,Mariposa,043,17540,55,43,0,43,1
2020-07-25,Mendocino,045,87422,267,190,0,190,0
2020-07-25,Merced,047,269075,5122,3176,2,3178,23
2020-07-25,Modoc,049,8938,3,0,0,0,0
2020-07-25,Mono,051,14174,136,82,1,83,1
2020-07-25,Monterey,053,433212,4863,3805,14,3819,21
2020-07-25,Napa,055,140530,1063,746,0,746,6
2020-07-25,Nevada,057,99092,320,257,13,270,1
2020-07-25,Orange,059,3164182,41279,33978,729,34707,561
2020-07-25,Placer,061,380077,2079,1596,3,1599,12
2020-07-25,Plumas,063,18699,33,22,0,22,0
2020-07-25,Riverside,065,2383286,42211,34921,42,34963,655
2020-07-25,Sacramento,067,1510023,11545,8674,12,8686,113
2020-07-25,San Benito,069,59416,641,492,0,492,2
2020-07-25,San Bernardino,071,2135413,37313,29265,147,29412,394
2020-07-25,San Diego,073,3302833,30628,26703,3,26706,533
2020-07-25,San Francisco,075,870044,6845,5644,7,5651,55
2020-07-25,San Joaquin,077,732212,13399,10347,6,10353,129
2020-07-25,San Luis Obispo,079,281455,1957,1530,9,1539,8
2020-07-25,San Mateo,081,765935,6047,5023,7,5030,113
2020-07-25,Santa Barbara,083,443738,6420,5880,62,5942,30
2020-07-25,Santa Clara,085,1922200,11793,8767,29,8796,166
2020-07-25,Santa Cruz,087,273765,1194,939,8,947,4
2020-07-25,Shasta,089,179085,446,263,1,264,8
2020-07-25,Sierra,091,2930,2,1,0,1,0
2020-07-25,Siskiyou,093,43540,84,54,0,54,0
2020-07-25,Solano,095,438530,3979,3107,18,3125,29
2020-07-25,Sonoma,097,501317,3359,2412,6,2418,20
2020-07-25,Stanislaus,099,539301,10591,7994,14,8008,84
2020-07-25,Sutter,101,95872,753,603,0,603,2
2020-07-25,Tehama,103,63373,253,169,2,171,1
2020-07-25,Trinity,105,12862,26,3,6,9,0
2020-07-25,Tulare,107,460477,10380,8310,35,8345,172
2020-07-25,Tuolumne,109,53932,144,99,2,101,0
2020-07-25,Ventura,111,848112,8176,6662,28,6690,62
2020-07-25,Yolo,113,214977,1705,1357,3,1360,35
2020-07-25,Yuba,115,75493,425,312,0,312,1
2020-07-24,Alameda,001,1643700,12583,10216,39,10255,176
2020-07-24,Alpine,003,1148,2,2,0,2,0
2020-07-24,Amador,005,37829,137,66,0,66,0
2020-07-24,Butte,007,227075,1019,751,12,763,5
2020-07-24,Calaveras,009,45235,123,102,0,102,0
2020-07-24,Colusa,011,21464,337,255,0,255,2
2020-07-24,Contra Costa,013,1133247,9154,6814,27,6841,100
2020-07-24,Del Norte,015,27424,84,66,0,66,0
2020-07-24,El Dorado,017,186661,714,516,0,516,1
2020-07-24,Fresno,019,978130,19845,12564,175,12739,115
2020-07-24,Glenn,021,27897,349,251,0,251,1
2020-07-24,Humboldt,023,135768,241,210,1,211,4
2020-07-24,Imperial,025,180216,10043,7686,7,7693,141
2020-07-24,Inyo,027,18085,55,41,1,42,1
2020-07-24,Kern,029,883053,22557,16124,108,16232,143
2020-07-24,Kings,031,150075,4306,3471,25,3496,39
2020-07-24,Lake,033,64148,209,167,0,167,1
2020-07-24,Lassen,035,31185,574,503,2,505,0
2020-07-24,Los Angeles,037,10098052,189281,169078,445,169523,4302
2020-07-24,Madera,039,155013,2474,1679,5,1684,16
2020-07-24,Marin,041,260295,5106,4517,5,4522,22
2020-07-24,Mariposa,043,17540,55,41,0,41,1
2020-07-24,Mendocino,045,87422,260,188,0,188,0
2020-07-24,Merced,047,269075,5037,3100,2,3102,23
2020-07-24,Modoc,049,8938,3,0,0,0,0
2020-07-24,Mono,051,14174,135,82,1,83,1
2020-07-24,Monterey,053,433212,4791,3748,14,3762,21
2020-07-24,Napa,055,140530,1050,741,0,741,6
2020-07-24,Nevada,057,99092,317,255,13,268,1
2020-07-24,Orange,059,3164182,40992,33530,713,34243,557
2020-07-24,Placer,061,380077,2048,1551,3,1554,12
2020-07-24,Plumas,063,18699,33,22,0,22,0
2020-07-24,Riverside,065,2383286,41788,34513,41,34554,631
2020-07-24,Sacramento,067,1510023,11357,8570,12,8582,110
2020-07-24,San Benito,069,59416,634,485,0,485,2
2020-07-24,San Bernardino,071,2135413,36940,28990,142,29132,386
2020-07-24,San Diego,073,3302833,30328,26100,3,26103,524
2020-07-24,San Francisco,075,870044,6751,5611,7,5618,55
2020-07-24,San Joaquin,077,732212,13250,10190,6,10196,118
2020-07-24,San Luis Obispo,079,281455,1933,1476,9,1485,8
2020-07-24,San Mateo,081,765935,5984,4954,7,4961,112
2020-07-24,Santa Barbara,083,443738,6367,5776,60,5836,30
2020-07-24,Santa Clara,085,1922200,11628,8658,29,8687,165
2020-07-24,Santa Cruz,087,273765,1174,930,8,938,4
2020-07-24,Shasta,089,179085,438,262,1,263,8
2020-07-24,Sierra,091,2930,2,1,0,1,0
2020-07-24,Siskiyou,093,43540,84,53,0,53,0
2020-07-24,Solano,095,438530,3943,3062,15,3077,29
2020-07-24,Sonoma,097,501317,3307,2345,6,2351,20
2020-07-24,Stanislaus,099,539301,10419,7861,11,7872,82
2020-07-24,Sutter,101,95872,742,593,0,593,2
2020-07-24,Tehama,103,63373,245,170,2,172,1
2020-07-24,Trinity,105,12862,25,3,6,9,0
2020-07-24,Tulare,107,460477,10286,8167,33,8200,167
2020-07-24,Tuolumne,109,53932,138,99,2,101,0
2020-07-24,Ventura,111,848112,8091,6553,28,6581,60
2020-07-24,Yolo,113,214977,1691,1329,3,1332,35
2020-07-24,Yuba,115,75493,410,307,0,307,1
2020-07-23,Alameda,001,1643700,12342,9924,39,9963,171
2020-07-23,Alpine,003,1148,2,2,0,2,0
2020-07-23,Amador,005,37829,120,61,0,61,0
2020-07-23,Butte,007,227075,1004,726,11,737,5
2020-07-23,Calaveras,009,45235,116,102,0,102,0
2020-07-23,Colusa,011,21464,329,242,0,242,2
2020-07-23,Contra Costa,013,1133247,8954,6619,25,6644,98
2020-07-23,Del Norte,015,27424,84,66,0,66,0
2020-07-23,El Dorado,017,186661,703,491,0,491,1
2020-07-23,Fresno,019,978130,19489,12164,172,12336,112
2020-07-23,Glenn,021,27897,344,246,0,246,1
2020-07-23,Humboldt,023,135768,240,208,1,209,4
2020-07-23,Imperial,025,180216,9993,7604,7,7611,138
2020-07-23,Inyo,027,18085,53,38,1,39,1
2020-07-23,Kern,029,883053,22150,14491,104,14595,128
2020-07-23,Kings,031,150075,4194,3371,25,3396,39
2020-07-23,Lake,033,64148,200,160,0,160,1
2020-07-23,Lassen,035,31185,571,503,2,505,0
2020-07-23,Los Angeles,037,10098052,186736,167198,418,167616,4265
2020-07-23,Madera,039,155013,2408,1659,4,1663,13
2020-07-23,Marin,041,260295,5054,4423,5,4428,22
2020-07-23,Mariposa,043,17540,55,40,0,40,1
2020-07-23,Mendocino,045,87422,250,178,0,178,0
2020-07-23,Merced,047,269075,4880,2972,2,2974,22
2020-07-23,Modoc,049,8938,3,0,0,0,0
2020-07-23,Mono,051,14174,131,82,1,83,1
2020-07-23,Monterey,053,433212,4673,3655,14,3669,21
2020-07-23,Napa,055,140530,1026,713,0,713,5
2020-07-23,Nevada,057,99092,314,247,13,260,1
2020-07-23,Orange,059,3164182,40495,32863,683,33546,544
2020-07-23,Placer,061,380077,2005,1519,3,1522,12
2020-07-23,Plumas,063,18699,32,21,0,21,0
2020-07-23,Riverside,065,2383286,41183,33833,41,33874,630
2020-07-23,Sacramento,067,1510023,11125,8222,12,8234,108
2020-07-23,San Benito,069,59416,619,478,0,478,2
2020-07-23,San Bernardino,071,2135413,36420,28121,136,28257,369
2020-07-23,San Diego,073,3302833,29954,25109,3,25112,505
2020-07-23,San Francisco,075,870044,6650,5543,7,5550,55
2020-07-23,San Joaquin,077,732212,13031,9861,6,9867,111
2020-07-23,San Luis Obispo,079,281455,1904,1438,9,1447,7
2020-07-23,San Mateo,081,765935,5879,4895,7,4902,113
2020-07-23,Santa Barbara,083,443738,6294,5628,60,5688,30
2020-07-23,Santa Clara,085,1922200,11410,8458,29,8487,165
2020-07-23,Santa Cruz,087,273765,1138,887,8,895,3
2020-07-23,Shasta,089,179085,427,254,1,255,9
2020-07-23,Sierra,091,2930,2,1,0,1,0
2020-07-23,Siskiyou,093,43540,82,53,0,53,0
2020-07-23,Solano,095,438530,3879,2962,13,2975,29
2020-07-23,Sonoma,097,501317,3231,2289,6,2295,18
2020-07-23,Stanislaus,099,539301,10177,7603,11,7614,71
2020-07-23,Sutter,101,95872,709,570,0,570,2
2020-07-23,Tehama,103,63373,239,158,2,160,1
2020-07-23,Trinity,105,12862,24,3,6,9,0
2020-07-23,Tulare,107,460477,10097,7898,33,7931,168
2020-07-23,Tuolumne,109,53932,138,93,2,95,0
2020-07-23,Ventura,111,848112,7967,6303,28,6331,56
2020-07-23,Yolo,113,214977,1672,1279,3,1282,35
2020-07-23,Yuba,115,75493,390,297,0,297,1
2020-07-22,Alameda,001,1643700,12123,9678,38,9716,169
2020-07-22,Alpine,003,1148,2,2,0,2,0
2020-07-22,Amador,005,37829,118,58,0,58,0
2020-07-22,Butte,007,227075,968,694,11,705,5
2020-07-22,Calaveras,009,45235,116,98,0,98,0
2020-07-22,Colusa,011,21464,322,236,0,236,0
2020-07-22,Contra Costa,013,1133247,8728,6401,25,6426,98
2020-07-22,Del Norte,015,27424,84,66,0,66,0
2020-07-22,El Dorado,017,186661,690,466,0,466,1
2020-07-22,Fresno,019,978130,19126,11756,166,11922,110
2020-07-22,Glenn,021,27897,338,236,0,236,1
2020-07-22,Humboldt,023,135768,238,201,1,202,4
2020-07-22,Imperial,025,180216,9933,7533,7,7540,134
2020-07-22,Inyo,027,18085,49,38,1,39,1
2020-07-22,Kern,029,883053,21718,13513,97,13610,127
2020-07-22,Kings,031,150075,4138,3271,25,3296,38
2020-07-22,Lake,033,64148,197,160,0,160,1
2020-07-22,Lassen,035,31185,568,500,2,502,0
2020-07-22,Los Angeles,037,10098052,184088,165242,395,165637,4218
2020-07-22,Madera,039,155013,2333,1578,4,1582,10
2020-07-22,Marin,041,260295,4998,4373,5,4378,23
2020-07-22,Mariposa,043,17540,55,38,0,38,1
2020-07-22,Mendocino,045,87422,243,166,0,166,0
2020-07-22,Merced,047,269075,4753,2828,2,2830,15
2020-07-22,Modoc,049,8938,3,0,0,0,0
2020-07-22,Mono,051,14174,128,82,1,83,1
2020-07-22,Monterey,053,433212,4572,3533,14,3547,20
2020-07-22,Napa,055,140530,1004,687,0,687,5
2020-07-22,Nevada,057,99092,308,239,12,251,1
2020-07-22,Orange,059,3164182,39996,32047,674,32721,522
2020-07-22,Placer,061,380077,1949,1469,3,1472,12
2020-07-22,Plumas,063,18699,31,20,0,20,0
2020-07-22,Riverside,065,2383286,40547,33093,41,33134,612
2020-07-22,Sacramento,067,1510023,10862,8028,11,8039,106
2020-07-22,San Benito,069,59416,605,465,0,465,2
2020-07-22,San Bernardino,071,2135413,35898,26820,125,26945,348
2020-07-22,San Diego,073,3302833,29566,25109,2,25111,505
2020-07-22,San Francisco,075,870044,6546,5473,6,5479,53
2020-07-22,San Joaquin,077,732212,12755,9628,6,9634,102
2020-07-22,San Luis Obispo,079,281455,1858,1373,9,1382,7
2020-07-22,San Mateo,081,765935,5790,4796,7,4803,112
2020-07-22,Santa Barbara,083,443738,6210,5508,58,5566,29
2020-07-22,Santa Clara,085,1922200,11164,8266,29,8295,166
2020-07-22,Santa Cruz,087,273765,1115,866,8,874,3
2020-07-22,Shasta,089,179085,417,246,1,247,9
2020-07-22,Sierra,091,2930,1,1,0,1,0
2020-07-22,Siskiyou,093,43540,81,52,0,52,0
2020-07-22,Solano,095,438530,3818,2839,12,2851,29
2020-07-22,Sonoma,097,501317,3154,2255,6,2261,17
2020-07-22,Stanislaus,099,539301,10006,7401,11,7412,71
2020-07-22,Sutter,101,95872,685,551,0,551,2
2020-07-22,Tehama,103,63373,231,155,2,157,1
2020-07-22,Trinity,105,12862,23,3,6,9,0
2020-07-22,Tulare,107,460477,9864,7640,33,7673,167
2020-07-22,Tuolumne,109,53932,134,91,2,93,0
2020-07-22,Ventura,111,848112,7839,6223,26,6249,56
2020-07-22,Yolo,113,214977,1629,1233,3,1236,34
2020-07-22,Yuba,115,75493,375,288,0,288,1
2020-07-21,Alameda,001,1643700,11909,9390,38,9428,166
2020-07-21,Alpine,003,1148,2,2,0,2,0
2020-07-21,Amador,005,37829,113,55,0,55,0
2020-07-21,Butte,007,227075,923,659,10,669,5
2020-07-21,Calaveras,009,45235,110,96,0,96,0
2020-07-21,Colusa,011,21464,298,227,0,227,0
2020-07-21,Contra Costa,013,1133247,8486,6210,25,6235,98
2020-07-21,Del Norte,015,27424,84,66,0,66,0
2020-07-21,El Dorado,017,186661,682,440,0,440,1
2020-07-21,Fresno,019,978130,18727,11412,160,11572,107
2020-07-21,Glenn,021,27897,331,229,0,229,1
2020-07-21,Humboldt,023,135768,236,198,1,199,4
2020-07-21,Imperial,025,180216,9884,7458,7,7465,128
2020-07-21,Inyo,027,18085,48,38,1,39,1
2020-07-21,Kern,029,883053,21296,11998,91,12089,119
2020-07-21,Kings,031,150075,4073,3187,24,3211,38
2020-07-21,Lake,033,64148,197,157,0,157,1
2020-07-21,Lassen,035,31185,566,474,2,476,0
2020-07-21,Los Angeles,037,10098052,181104,162205,372,162577,4159
2020-07-21,Madera,039,155013,2268,1508,3,1511,10
2020-07-21,Marin,041,260295,4926,4318,5,4323,21
2020-07-21,Mariposa,043,17540,54,37,0,37,1
2020-07-21,Mendocino,045,87422,232,160,0,160,0
2020-07-21,Merced,047,269075,4574,2725,2,2727,15
2020-07-21,Modoc,049,8938,3,0,0,0,0
2020-07-21,Mono,051,14174,124,79,1,80,1
2020-07-21,Monterey,053,433212,4440,3404,13,3417,20
2020-07-21,Napa,055,140530,977,660,0,660,5
2020-07-21,Nevada,057,99092,306,228,10,238,1
2020-07-21,Orange,059,3164182,39499,31356,642,31998,515
2020-07-21,Placer,061,380077,1908,1413,3,1416,11
2020-07-21,Plumas,063,18699,31,19,0,19,0
2020-07-21,Riverside,065,2383286,39845,32231,41,32272,583
2020-07-21,Sacramento,067,1510023,10590,7789,10,7799,102
2020-07-21,San Benito,069,59416,594,444,0,444,2
2020-07-21,San Bernardino,071,2135413,35249,25323,118,25441,343
2020-07-21,San Diego,073,3302833,29117,24522,2,24524,487
2020-07-21,San Francisco,075,870044,6437,5377,6,5383,53
2020-07-21,San Joaquin,077,732212,12426,9150,6,9156,99
2020-07-21,San Luis Obispo,079,281455,1809,1338,9,1347,7
2020-07-21,San Mateo,081,765935,5698,4733,7,4740,111
2020-07-21,Santa Barbara,083,443738,6130,5422,57,5479,29
2020-07-21,Santa Clara,085,1922200,10901,7989,29,8018,164
2020-07-21,Santa Cruz,087,273765,1082,835,8,843,3
2020-07-21,Shasta,089,179085,409,241,1,242,9
2020-07-21,Sierra,091,2930,1,1,0,1,0
2020-07-21,Siskiyou,093,43540,81,48,0,48,0
2020-07-21,Solano,095,438530,3745,2727,12,2739,27
2020-07-21,Sonoma,097,501317,3097,2200,6,2206,17
2020-07-21,Stanislaus,099,539301,9743,6984,11,6995,69
2020-07-21,Sutter,101,95872,669,533,0,533,2
2020-07-21,Tehama,103,63373,221,150,2,152,1
2020-07-21,Trinity,105,12862,23,2,6,8,0
2020-07-21,Tulare,107,460477,9662,7447,33,7480,167
2020-07-21,Tuolumne,109,53932,132,75,2,77,0
2020-07-21,Ventura,111,848112,7707,6131,26,6157,55
2020-07-21,Yolo,113,214977,1575,1204,3,1207,34
2020-07-21,Yuba,115,75493,369,269,0,269,1
2020-07-20,Alameda,001,1643700,11655,9244,37,9281,162
2020-07-20,Alpine,003,1148,2,2,0,2,0
2020-07-20,Amador,005,37829,110,53,0,53,0
2020-07-20,Butte,007,227075,885,586,10,596,4
2020-07-20,Calaveras,009,45235,107,90,0,90,0
2020-07-20,Colusa,011,21464,287,217,0,217,0
2020-07-20,Contra Costa,013,1133247,8278,5823,25,5848,97
2020-07-20,Del Norte,015,27424,84,61,0,61,0
2020-07-20,El Dorado,017,186661,659,407,0,407,0
2020-07-20,Fresno,019,978130,18286,10891,159,11050,106
2020-07-20,Glenn,021,27897,323,225,0,225,1
2020-07-20,Humboldt,023,135768,229,194,1,195,4
2020-07-20,Imperial,025,180216,9844,7337,7,7344,124
2020-07-20,Inyo,027,18085,46,38,1,39,1
2020-07-20,Kern,029,883053,20786,10908,87,10995,118
2020-07-20,Kings,031,150075,4023,3093,24,3117,37
2020-07-20,Lake,033,64148,194,147,0,147,1
2020-07-20,Lassen,035,31185,564,474,2,476,0
2020-07-20,Los Angeles,037,10098052,178145,159202,345,159547,4108
2020-07-20,Madera,039,155013,2193,1433,3,1436,10
2020-07-20,Marin,041,260295,4844,4255,5,4260,21
2020-07-20,Mariposa,043,17540,53,36,0,36,1
2020-07-20,Mendocino,045,87422,219,153,0,153,0
2020-07-20,Merced,047,269075,4404,2584,2,2586,15
2020-07-20,Modoc,049,8938,3,0,0,0,0
2020-07-20,Mono,051,14174,118,78,1,79,1
2020-07-20,Monterey,053,433212,4334,3205,13,3218,19
2020-07-20,Napa,055,140530,942,632,0,632,5
2020-07-20,Nevada,057,99092,298,218,10,228,1
2020-07-20,Orange,059,3164182,38889,30337,612,30949,507
2020-07-20,Placer,061,380077,1856,1364,3,1367,11
2020-07-20,Plumas,063,18699,30,17,0,17,0
2020-07-20,Riverside,065,2383286,39014,31163,41,31204,581
2020-07-20,Sacramento,067,1510023,10262,7369,10,7379,99
2020-07-20,San Benito,069,59416,576,433,0,433,2
2020-07-20,San Bernardino,071,2135413,34438,24226,114,24340,338
2020-07-20,San Diego,073,3302833,28675,24137,2,24139,478
2020-07-20,San Francisco,075,870044,6316,5090,6,5096,53
2020-07-20,San Joaquin,077,732212,12070,8583,6,8589,97
2020-07-20,San Luis Obispo,079,281455,1767,1282,9,1291,6
2020-07-20,San Mateo,081,765935,5597,4609,7,4616,111
2020-07-20,Santa Barbara,083,443738,6020,5266,55,5321,29
2020-07-20,Santa Clara,085,1922200,10672,7711,28,7739,164
2020-07-20,Santa Cruz,087,273765,1050,758,8,766,3
2020-07-20,Shasta,089,179085,394,233,1,234,9
2020-07-20,Sierra,091,2930,1,1,0,1,0
2020-07-20,Siskiyou,093,43540,77,42,0,42,0
2020-07-20,Solano,095,438530,3662,2537,12,2549,26
2020-07-20,Sonoma,097,501317,2989,2148,6,2154,17
2020-07-20,Stanislaus,099,539301,9460,6835,11,6846,58
2020-07-20,Sutter,101,95872,636,507,0,507,2
2020-07-20,Tehama,103,63373,211,146,2,148,1
2020-07-20,Trinity,105,12862,23,2,6,8,0
2020-07-20,Tulare,107,460477,9428,6974,33,7007,166
2020-07-20,Tuolumne,109,53932,131,75,2,77,0
2020-07-20,Ventura,111,848112,7573,5912,26,5938,52
2020-07-20,Yolo,113,214977,1535,1155,3,1158,30
2020-07-20,Yuba,115,75493,349,258,0,258,1
2020-07-19,Alameda,001,1643700,11416,9227,31,9258,162
2020-07-19,Alpine,003,1148,2,2,0,2,0
2020-07-19,Amador,005,37829,103,51,0,51,0
2020-07-19,Butte,007,227075,860,555,10,565,4
2020-07-19,Calaveras,009,45235,105,89,0,89,0
2020-07-19,Colusa,011,21464,279,187,0,187,0
2020-07-19,Contra Costa,013,1133247,7987,5691,23,5714,95
2020-07-19,Del Norte,015,27424,83,61,0,61,0
2020-07-19,El Dorado,017,186661,641,385,0,385,0
2020-07-19,Fresno,019,978130,17762,10639,147,10786,106
2020-07-19,Glenn,021,27897,309,215,0,215,0
2020-07-19,Humboldt,023,135768,221,195,1,196,4
2020-07-19,Imperial,025,180216,9753,7280,7,7287,124
2020-07-19,Inyo,027,18085,42,38,1,39,1
2020-07-19,Kern,029,883053,20169,10094,80,10174,115
2020-07-19,Kings,031,150075,3937,3035,24,3059,37
2020-07-19,Lake,033,64148,189,144,0,144,1
2020-07-19,Lassen,035,31185,545,474,2,476,0
2020-07-19,Los Angeles,037,10098052,174703,156039,322,156361,4100
2020-07-19,Madera,039,155013,2116,1301,3,1304,10
2020-07-19,Marin,041,260295,4789,4172,5,4177,21
2020-07-19,Mariposa,043,17540,49,35,0,35,1
2020-07-19,Mendocino,045,87422,214,137,0,137,0
2020-07-19,Merced,047,269075,4197,2460,2,2462,15
2020-07-19,Modoc,049,8938,3,0,0,0,0
2020-07-19,Mono,051,14174,107,63,1,64,1
2020-07-19,Monterey,053,433212,4214,3079,13,3092,18
2020-07-19,Napa,055,140530,913,612,0,612,5
2020-07-19,Nevada,057,99092,292,210,10,220,1
2020-07-19,Orange,059,3164182,38325,29941,599,30540,505
2020-07-19,Placer,061,380077,1808,1246,3,1249,11
2020-07-19,Plumas,063,18699,30,17,0,17,0
2020-07-19,Riverside,065,2383286,38309,30340,41,30381,581
2020-07-19,Sacramento,067,1510023,9870,6985,10,6995,97
2020-07-19,San Benito,069,59416,560,412,0,412,2
2020-07-19,San Bernardino,071,2135413,33664,23928,102,24030,337
2020-07-19,San Diego,073,3302833,28174,23684,2,23686,478
2020-07-19,San Francisco,075,870044,6169,5094,6,5100,52
2020-07-19,San Joaquin,077,732212,11664,8308,6,8314,93
2020-07-19,San Luis Obispo,079,281455,1723,1262,8,1270,6
2020-07-19,San Mateo,081,765935,5491,4522,7,4529,110
2020-07-19,Santa Barbara,083,443738,5918,5145,52,5197,29
2020-07-19,Santa Clara,085,1922200,10428,7403,28,7431,164
2020-07-19,Santa Cruz,087,273765,1006,753,8,761,3
2020-07-19,Shasta,089,179085,381,218,1,219,9
2020-07-19,Sierra,091,2930,1,1,0,1,0
2020-07-19,Siskiyou,093,43540,75,42,0,42,0
2020-07-19,Solano,095,438530,3557,2551,12,2563,26
2020-07-19,Sonoma,097,501317,2889,2074,6,2080,17
2020-07-19,Stanislaus,099,539301,9164,6508,11,6519,58
2020-07-19,Sutter,101,95872,605,480,0,480,2
2020-07-19,Tehama,103,63373,207,138,2,140,1
2020-07-19,Trinity,105,12862,23,2,6,8,0
2020-07-19,Tulare,107,460477,9180,6856,33,6889,166
2020-07-19,Tuolumne,109,53932,126,75,2,77,0
2020-07-19,Ventura,111,848112,7383,5706,26,5732,52
2020-07-19,Yolo,113,214977,1495,1127,3,1130,30
2020-07-19,Yuba,115,75493,329,240,0,240,1
2020-07-18,Alameda,001,1643700,11279,9089,30,9119,162
2020-07-18,Alpine,003,1148,2,2,0,2,0
2020-07-18,Amador,005,37829,99,49,0,49,0
2020-07-18,Butte,007,227075,851,551,10,561,4
2020-07-18,Calaveras,009,45235,101,89,0,89,0
2020-07-18,Colusa,011,21464,274,182,0,182,0
2020-07-18,Contra Costa,013,1133247,7853,5617,23,5640,95
2020-07-18,Del Norte,015,27424,83,61,0,61,0
2020-07-18,El Dorado,017,186661,638,385,0,385,0
2020-07-18,Fresno,019,978130,17513,10381,145,10526,106
2020-07-18,Glenn,021,27897,303,212,0,212,0
2020-07-18,Humboldt,023,135768,218,189,1,190,4
2020-07-18,Imperial,025,180216,9722,7268,7,7275,124
2020-07-18,Inyo,027,18085,42,38,1,39,1
2020-07-18,Kern,029,883053,19866,9250,77,9327,114
2020-07-18,Kings,031,150075,3897,2996,23,3019,37
2020-07-18,Lake,033,64148,186,142,0,142,1
2020-07-18,Lassen,035,31185,544,474,2,476,0
2020-07-18,Los Angeles,037,10098052,173259,153265,311,153576,4088
2020-07-18,Madera,039,155013,2070,1260,3,1263,9
2020-07-18,Marin,041,260295,4760,4089,5,4094,21
2020-07-18,Mariposa,043,17540,49,35,0,35,1
2020-07-18,Mendocino,045,87422,208,137,0,137,0
2020-07-18,Merced,047,269075,4078,2424,2,2426,15
2020-07-18,Modoc,049,8938,3,0,0,0,0
2020-07-18,Mono,051,14174,105,54,1,55,1
2020-07-18,Monterey,053,433212,4146,3020,13,3033,17
2020-07-18,Napa,055,140530,902,609,0,609,5
2020-07-18,Nevada,057,99092,288,204,9,213,1
2020-07-18,Orange,059,3164182,38006,29603,578,30181,493
2020-07-18,Placer,061,380077,1785,1233,3,1236,11
2020-07-18,Plumas,063,18699,30,17,0,17,0
2020-07-18,Riverside,065,2383286,37955,30245,40,30285,581
2020-07-18,Sacramento,067,1510023,9625,6739,10,6749,95
2020-07-18,San Benito,069,59416,545,407,0,407,2
2020-07-18,San Bernardino,071,2135413,33204,23680,95,23775,336
2020-07-18,San Diego,073,3302833,27871,23116,2,23118,478
2020-07-18,San Francisco,075,870044,6067,5051,6,5057,52
2020-07-18,San Joaquin,077,732212,11451,8118,6,8124,93
2020-07-18,San Luis Obispo,079,281455,1688,1234,8,1242,6
2020-07-18,San Mateo,081,765935,5431,4488,7,4495,110
2020-07-18,Santa Barbara,083,443738,5858,5110,50,5160,29
2020-07-18,Santa Clara,085,1922200,10278,7255,27,7282,164
2020-07-18,Santa Cruz,087,273765,989,751,8,759,3
2020-07-18,Shasta,089,179085,372,216,1,217,9
2020-07-18,Sierra,091,2930,1,1,0,1,0
2020-07-18,Siskiyou,093,43540,71,42,0,42,0
2020-07-18,Solano,095,438530,3516,2503,12,2515,26
2020-07-18,Sonoma,097,501317,2838,2019,6,2025,15
2020-07-18,Stanislaus,099,539301,9029,6344,11,6355,58
2020-07-18,Sutter,101,95872,599,473,0,473,2
2020-07-18,Tehama,103,63373,202,136,2,138,1
2020-07-18,Trinity,105,12862,23,2,6,8,0
2020-07-18,Tulare,107,460477,9089,6810,32,6842,167
2020-07-18,Tuolumne,109,53932,123,75,2,77,0
2020-07-18,Ventura,111,848112,7301,5630,26,5656,52
2020-07-18,Yolo,113,214977,1467,1077,3,1080,30
2020-07-18,Yuba,115,75493,318,237,0,237,1
2020-07-17,Alameda,001,1643700,11138,8893,29,8922,160
2020-07-17,Alpine,003,1148,2,1,0,1,0
2020-07-17,Amador,005,37829,97,48,0,48,0
2020-07-17,Butte,007,227075,837,497,10,507,4
2020-07-17,Calaveras,009,45235,99,86,0,86,0
2020-07-17,Colusa,011,21464,272,146,0,146,0
2020-07-17,Contra Costa,013,1133247,7705,5483,23,5506,93
2020-07-17,Del Norte,015,27424,82,60,0,60,0
2020-07-17,El Dorado,017,186661,622,368,0,368,0
2020-07-17,Fresno,019,978130,17215,9954,145,10099,104
2020-07-17,Glenn,021,27897,296,203,0,203,0
2020-07-17,Humboldt,023,135768,217,185,1,186,4
2020-07-17,Imperial,025,180216,9700,7193,7,7200,120
2020-07-17,Inyo,027,18085,42,38,1,39,1
2020-07-17,Kern,029,883053,19546,8291,76,8367,113
2020-07-17,Kings,031,150075,3858,2978,23,3001,37
2020-07-17,Lake,033,64148,184,139,0,139,1
2020-07-17,Lassen,035,31185,525,391,2,393,0
2020-07-17,Los Angeles,037,10098052,170887,150481,299,150780,4052
2020-07-17,Madera,039,155013,2026,1214,3,1217,9
2020-07-17,Marin,041,260295,4723,3839,5,3844,21
2020-07-17,Mariposa,043,17540,47,35,0,35,1
2020-07-17,Mendocino,045,87422,200,126,0,126,0
2020-07-17,Merced,047,269075,4003,2328,2,2330,12
2020-07-17,Modoc,049,8938,2,0,0,0,0
2020-07-17,Mono,051,14174,100,54,1,55,1
2020-07-17,Monterey,053,433212,4017,2922,13,2935,18
2020-07-17,Napa,055,140530,888,598,0,598,5
2020-07-17,Nevada,057,99092,281,200,9,209,1
2020-07-17,Orange,059,3164182,37543,28962,545,29507,485
2020-07-17,Placer,061,380077,1756,1207,3,1210,11
2020-07-17,Plumas,063,18699,27,16,0,16,0
2020-07-17,Riverside,065,2383286,37356,29639,40,29679,580
2020-07-17,Sacramento,067,1510023,9381,6563,10,6573,95
2020-07-17,San Benito,069,59416,530,399,0,399,2
2020-07-17,San Bernardino,071,2135413,32684,23057,92,23149,322
2020-07-17,San Diego,073,3302833,27482,22491,2,22493,472
2020-07-17,San Francisco,075,870044,5973,4967,6,4973,52
2020-07-17,San Joaquin,077,732212,11207,7925,6,7931,86
2020-07-17,San Luis Obispo,079,281455,1651,1190,8,1198,6
2020-07-17,San Mateo,081,765935,5334,4407,7,4414,110
2020-07-17,Santa Barbara,083,443738,5786,5001,49,5050,29
2020-07-17,Santa Clara,085,1922200,10060,7080,27,7107,164
2020-07-17,Santa Cruz,087,273765,967,716,8,724,3
2020-07-17,Shasta,089,179085,360,213,1,214,8
2020-07-17,Sierra,091,2930,1,1,0,1,0
2020-07-17,Siskiyou,093,43540,70,40,0,40,0
2020-07-17,Solano,095,438530,3467,2452,12,2464,26
2020-07-17,Sonoma,097,501317,2790,1982,6,1988,15
2020-07-17,Stanislaus,099,539301,8854,6220,11,6231,56
2020-07-17,Sutter,101,95872,586,458,0,458,2
2020-07-17,Tehama,103,63373,198,128,2,130,1
2020-07-17,Trinity,105,12862,23,2,6,8,0
2020-07-17,Tulare,107,460477,8953,6671,32,6703,166
2020-07-17,Tuolumne,109,53932,122,73,2,75,0
2020-07-17,Ventura,111,848112,7217,5451,26,5477,51
2020-07-17,Yolo,113,214977,1443,1055,3,1058,30
2020-07-17,Yuba,115,75493,308,231,0,231,1
2020-07-16,Alameda,001,1643700,10904,8719,24,8743,153
2020-07-16,Alpine,003,1148,2,1,0,1,0
2020-07-16,Amador,005,37829,94,46,0,46,0
2020-07-16,Butte,007,227075,800,465,9,474,4
2020-07-16,Calaveras,009,45235,97,82,0,82,0
2020-07-16,Colusa,011,21464,263,140,0,140,0
2020-07-16,Contra Costa,013,1133247,7493,5338,17,5355,91
2020-07-16,Del Norte,015,27424,82,60,0,60,0
2020-07-16,El Dorado,017,186661,605,357,0,357,0
2020-07-16,Fresno,019,978130,16704,9481,136,9617,101
2020-07-16,Glenn,021,27897,287,190,0,190,0
2020-07-16,Humboldt,023,135768,215,184,1,185,4
2020-07-16,Imperial,025,180216,9605,7148,7,7155,113
2020-07-16,Inyo,027,18085,42,38,1,39,1
2020-07-16,Kern,029,883053,19024,7435,74,7509,112
2020-07-16,Kings,031,150075,3691,2937,23,2960,37
2020-07-16,Lake,033,64148,179,128,0,128,1
2020-07-16,Lassen,035,31185,524,355,2,357,0
2020-07-16,Los Angeles,037,10098052,167669,147759,274,148033,3994
2020-07-16,Madera,039,155013,1962,1192,3,1195,8
2020-07-16,Marin,041,260295,4651,3546,5,3551,21
2020-07-16,Mariposa,043,17540,45,34,0,34,1
2020-07-16,Mendocino,045,87422,195,121,0,121,0
2020-07-16,Merced,047,269075,3841,2228,2,2230,12
2020-07-16,Modoc,049,8938,1,0,0,0,0
2020-07-16,Mono,051,14174,97,53,1,54,1
2020-07-16,Monterey,053,433212,3913,2857,12,2869,18
2020-07-16,Napa,055,140530,859,581,0,581,5
2020-07-16,Nevada,057,99092,278,191,9,200,1
2020-07-16,Orange,059,3164182,36842,28525,509,29034,471
2020-07-16,Placer,061,380077,1708,1168,3,1171,11
2020-07-16,Plumas,063,18699,25,16,0,16,0
2020-07-16,Riverside,065,2383286,36611,28904,38,28942,577
2020-07-16,Sacramento,067,1510023,9068,6440,9,6449,91
2020-07-16,San Benito,069,59416,513,389,0,389,2
2020-07-16,San Bernardino,071,2135413,31823,22355,74,22429,321
2020-07-16,San Diego,073,3302833,26995,21857,2,21859,465
2020-07-16,San Francisco,075,870044,5832,4838,6,4844,52
2020-07-16,San Joaquin,077,732212,10844,7713,6,7719,82
2020-07-16,San Luis Obispo,079,281455,1607,1146,8,1154,6
2020-07-16,San Mateo,081,765935,5230,4336,7,4343,110
2020-07-16,Santa Barbara,083,443738,5691,4872,48,4920,28
2020-07-16,Santa Clara,085,1922200,9780,6990,25,7015,164
2020-07-16,Santa Cruz,087,273765,926,698,8,706,3
2020-07-16,Shasta,089,179085,345,208,1,209,7
2020-07-16,Sierra,091,2930,1,1,0,1,0
2020-07-16,Siskiyou,093,43540,67,39,0,39,0
2020-07-16,Solano,095,438530,3373,2372,12,2384,25
2020-07-16,Sonoma,097,501317,2700,1954,6,1960,14
2020-07-16,Stanislaus,099,539301,8571,6077,10,6087,56
2020-07-16,Sutter,101,95872,570,444,0,444,2
2020-07-16,Tehama,103,63373,188,126,2,128,1
2020-07-16,Trinity,105,12862,23,2,5,7,0
2020-07-16,Tulare,107,460477,8737,6467,31,6498,163
2020-07-16,Tuolumne,109,53932,117,71,2,73,0
2020-07-16,Ventura,111,848112,7055,5231,26,5257,50
2020-07-16,Yolo,113,214977,1401,1034,3,1037,29
2020-07-16,Yuba,115,75493,290,221,0,221,1
2020-07-15,Alameda,001,1643700,10699,8615,19,8634,153
2020-07-15,Alpine,003,1148,2,1,0,1,0
2020-07-15,Amador,005,37829,73,44,0,44,0
2020-07-15,Butte,007,227075,758,420,9,429,4
2020-07-15,Calaveras,009,45235,97,75,0,75,0
2020-07-15,Colusa,011,21464,258,135,0,135,0
2020-07-15,Contra Costa,013,1133247,7262,5246,17,5263,90
2020-07-15,Del Norte,015,27424,81,60,0,60,0
2020-07-15,El Dorado,017,186661,581,339,0,339,0
2020-07-15,Fresno,019,978130,16230,9124,129,9253,101
2020-07-15,Glenn,021,27897,278,184,0,184,0
2020-07-15,Humboldt,023,135768,213,181,1,182,4
2020-07-15,Imperial,025,180216,9538,7110,7,7117,110
2020-07-15,Inyo,027,18085,42,36,1,37,1
2020-07-15,Kern,029,883053,18404,7155,71,7226,108
2020-07-15,Kings,031,150075,3630,2906,23,2929,37
2020-07-15,Lake,033,64148,177,122,0,122,1
2020-07-15,Lassen,035,31185,520,319,2,321,0
2020-07-15,Los Angeles,037,10098052,164205,143343,259,143602,3946
2020-07-15,Madera,039,155013,1893,1147,3,1150,4
2020-07-15,Marin,041,260295,4596,3458,5,3463,21
2020-07-15,Mariposa,043,17540,45,34,0,34,1
2020-07-15,Mendocino,045,87422,192,119,0,119,0
2020-07-15,Merced,047,269075,3692,2156,2,2158,12
2020-07-15,Modoc,049,8938,1,0,0,0,0
2020-07-15,Mono,051,14174,95,52,1,53,1
2020-07-15,Monterey,053,433212,3801,2780,12,2792,18
2020-07-15,Napa,055,140530,833,573,0,573,5
2020-07-15,Nevada,057,99092,274,185,7,192,1
2020-07-15,Orange,059,3164182,36042,27718,475,28193,454
2020-07-15,Placer,061,380077,1650,1145,3,1148,11
2020-07-15,Plumas,063,18699,25,16,0,16,0
2020-07-15,Riverside,065,2383286,35828,28492,36,28528,568
2020-07-15,Sacramento,067,1510023,8687,6217,9,6226,91
2020-07-15,San Benito,069,59416,504,388,0,388,2
2020-07-15,San Bernardino,071,2135413,31034,21508,58,21566,317
2020-07-15,San Diego,073,3302833,26528,21448,2,21450,448
2020-07-15,San Francisco,075,870044,5718,4757,6,4763,50
2020-07-15,San Joaquin,077,732212,10412,7381,5,7386,75
2020-07-15,San Luis Obispo,079,281455,1564,1097,8,1105,6
2020-07-15,San Mateo,081,765935,5117,4258,7,4265,109
2020-07-15,Santa Barbara,083,443738,5577,4733,48,4781,28
2020-07-15,Santa Clara,085,1922200,9476,6900,25,6925,164
2020-07-15,Santa Cruz,087,273765,890,660,7,667,3
2020-07-15,Shasta,089,179085,336,193,1,194,7
2020-07-15,Sierra,091,2930,1,1,0,1,0
2020-07-15,Siskiyou,093,43540,66,38,0,38,0
2020-07-15,Solano,095,438530,3278,2343,12,2355,25
2020-07-15,Sonoma,097,501317,2602,1920,6,1926,14
2020-07-15,Stanislaus,099,539301,8274,5777,10,5787,56
2020-07-15,Sutter,101,95872,544,433,0,433,2
2020-07-15,Tehama,103,63373,180,126,2,128,1
2020-07-15,Trinity,105,12862,22,2,5,7,0
2020-07-15,Tulare,107,460477,8526,6320,30,6350,156
2020-07-15,Tuolumne,109,53932,110,68,2,70,0
2020-07-15,Ventura,111,848112,6878,5087,26,5113,50
2020-07-15,Yolo,113,214977,1368,1002,3,1005,27
2020-07-15,Yuba,115,75493,278,221,0,221,1
2020-07-14,Alameda,001,1643700,10357,8388,13,8401,151
2020-07-14,Alpine,003,1148,2,1,0,1,0
2020-07-14,Amador,005,37829,69,44,0,44,0
2020-07-14,Butte,007,227075,712,382,9,391,4
2020-07-14,Calaveras,009,45235,95,74,0,74,0
2020-07-14,Colusa,011,21464,248,128,0,128,0
2020-07-14,Contra Costa,013,1133247,7025,5110,15,5125,90
2020-07-14,Del Norte,015,27424,80,60,0,60,0
2020-07-14,El Dorado,017,186661,566,324,0,324,0
2020-07-14,Fresno,019,978130,15810,8941,124,9065,98
2020-07-14,Glenn,021,27897,268,177,0,177,0
2020-07-14,Humboldt,023,135768,210,175,1,176,4
2020-07-14,Imperial,025,180216,9410,7095,7,7102,109
2020-07-14,Inyo,027,18085,42,35,1,36,1
2020-07-14,Kern,029,883053,17645,6979,58,7037,107
2020-07-14,Kings,031,150075,3563,2867,22,2889,37
2020-07-14,Lake,033,64148,171,120,0,120,1
2020-07-14,Lassen,035,31185,503,263,2,265,0
2020-07-14,Los Angeles,037,10098052,161072,140632,229,140861,3900
2020-07-14,Madera,039,155013,1819,1118,3,1121,4
2020-07-14,Marin,041,260295,4482,3451,5,3456,21
2020-07-14,Mariposa,043,17540,41,32,0,32,1
2020-07-14,Mendocino,045,87422,184,110,0,110,0
2020-07-14,Merced,047,269075,3513,2084,2,2086,12
2020-07-14,Modoc,049,8938,1,0,0,0,0
2020-07-14,Mono,051,14174,85,48,1,49,1
2020-07-14,Monterey,053,433212,3687,2724,12,2736,18
2020-07-14,Napa,055,140530,777,557,0,557,4
2020-07-14,Nevada,057,99092,257,180,6,186,1
2020-07-14,Orange,059,3164182,35162,26915,428,27343,432
2020-07-14,Placer,061,380077,1592,1122,3,1125,11
2020-07-14,Plumas,063,18699,24,14,0,14,0
2020-07-14,Riverside,065,2383286,35071,27850,35,27885,547
2020-07-14,Sacramento,067,1510023,8333,5978,9,5987,87
2020-07-14,San Benito,069,59416,485,360,0,360,2
2020-07-14,San Bernardino,071,2135413,30183,20489,48,20537,316
2020-07-14,San Diego,073,3302833,25908,20887,2,20889,436
2020-07-14,San Francisco,075,870044,5568,4659,5,4664,50
2020-07-14,San Joaquin,077,732212,9984,7143,5,7148,75
2020-07-14,San Luis Obispo,079,281455,1526,1060,8,1068,5
2020-07-14,San Mateo,081,765935,5024,4173,7,4180,108
2020-07-14,Santa Barbara,083,443738,5453,4641,46,4687,28
2020-07-14,Santa Clara,085,1922200,9148,6686,22,6708,164
2020-07-14,Santa Cruz,087,273765,851,639,7,646,3
2020-07-14,Shasta,089,179085,327,190,1,191,7
2020-07-14,Sierra,091,2930,1,1,0,1,0
2020-07-14,Siskiyou,093,43540,65,38,0,38,0
2020-07-14,Solano,095,438530,3178,2266,10,2276,25
2020-07-14,Sonoma,097,501317,2509,1866,6,1872,14
2020-07-14,Stanislaus,099,539301,7900,5631,9,5640,53
2020-07-14,Sutter,101,95872,525,405,0,405,2
2020-07-14,Tehama,103,63373,168,123,2,125,1
2020-07-14,Trinity,105,12862,21,2,5,7,0
2020-07-14,Tulare,107,460477,8280,6199,30,6229,156
2020-07-14,Tuolumne,109,53932,105,68,2,70,0
2020-07-14,Ventura,111,848112,6717,4950,26,4976,50
2020-07-14,Yolo,113,214977,1320,966,3,969,27
2020-07-14,Yuba,115,75493,261,210,0,210,1
2020-07-13,Alameda,001,1643700,10048,8115,13,8128,148
2020-07-13,Alpine,003,1148,2,1,0,1,0
2020-07-13,Amador,005,37829,65,42,0,42,0
2020-07-13,Butte,007,227075,676,354,9,363,4
2020-07-13,Calaveras,009,45235,87,63,0,63,0
2020-07-13,Colusa,011,21464,242,116,0,116,0
2020-07-13,Contra Costa,013,1133247,6753,4882,13,4895,88
2020-07-13,Del Norte,015,27424,74,59,0,59,0
2020-07-13,El Dorado,017,186661,535,298,0,298,0
2020-07-13,Fresno,019,978130,15379,8666,119,8785,95
2020-07-13,Glenn,021,27897,261,168,0,168,0
2020-07-13,Humboldt,023,135768,205,174,1,175,4
2020-07-13,Imperial,025,180216,9325,7052,7,7059,109
2020-07-13,Inyo,027,18085,41,35,1,36,1
2020-07-13,Kern,029,883053,16960,6808,53,6861,107
2020-07-13,Kings,031,150075,3512,2824,22,2846,37
2020-07-13,Lake,033,64148,166,118,0,118,1
2020-07-13,Lassen,035,31185,498,237,2,239,0
2020-07-13,Los Angeles,037,10098052,157840,136368,215,136583,3829
2020-07-13,Madera,039,155013,1750,1059,3,1062,4
2020-07-13,Marin,041,260295,4378,3402,5,3407,21
2020-07-13,Mariposa,043,17540,40,31,0,31,1
2020-07-13,Mendocino,045,87422,180,87,0,87,0
2020-07-13,Merced,047,269075,3364,2007,2,2009,12
2020-07-13,Modoc,049,8938,1,0,0,0,0
2020-07-13,Mono,051,14174,81,47,0,47,1
2020-07-13,Monterey,053,433212,3564,2613,9,2622,18
2020-07-13,Napa,055,140530,741,534,0,534,4
2020-07-13,Nevada,057,99092,243,172,6,178,1
2020-07-13,Orange,059,3164182,34297,25978,395,26373,423
2020-07-13,Placer,061,380077,1547,1096,3,1099,11
2020-07-13,Plumas,063,18699,22,14,0,14,0
2020-07-13,Riverside,065,2383286,34146,27136,33,27169,545
2020-07-13,Sacramento,067,1510023,8036,5747,9,5756,85
2020-07-13,San Benito,069,59416,472,343,0,343,2
2020-07-13,San Bernardino,071,2135413,29305,19610,42,19652,313
2020-07-13,San Diego,073,3302833,25341,20348,2,20350,422
2020-07-13,San Francisco,075,870044,5440,4534,4,4538,50
2020-07-13,San Joaquin,077,732212,9568,6927,5,6932,71
2020-07-13,San Luis Obispo,079,281455,1495,989,8,997,5
2020-07-13,San Mateo,081,765935,4893,4057,7,4064,108
2020-07-13,Santa Barbara,083,443738,5339,4441,45,4486,28
2020-07-13,Santa Clara,085,1922200,8825,6488,21,6509,164
2020-07-13,Santa Cruz,087,273765,813,574,7,581,3
2020-07-13,Shasta,089,179085,316,185,1,186,6
2020-07-13,Sierra,091,2930,1,1,0,1,0
2020-07-13,Siskiyou,093,43540,61,37,0,37,0
2020-07-13,Solano,095,438530,3066,2046,10,2056,23
2020-07-13,Sonoma,097,501317,2398,1818,6,1824,14
2020-07-13,Stanislaus,099,539301,7597,5324,8,5332,53
2020-07-13,Sutter,101,95872,487,379,0,379,2
2020-07-13,Tehama,103,63373,155,112,2,114,1
2020-07-13,Trinity,105,12862,21,2,5,7,0
2020-07-13,Tulare,107,460477,8019,5930,28,5958,147
2020-07-13,Tuolumne,109,53932,97,56,2,58,0
2020-07-13,Ventura,111,848112,6527,4800,23,4823,50
2020-07-13,Yolo,113,214977,1274,941,3,944,27
2020-07-13,Yuba,115,75493,246,194,0,194,1
2020-07-12,Alameda,001,1643700,9777,8056,13,8069,148
2020-07-12,Alpine,003,1148,2,1,0,1,0
2020-07-12,Amador,005,37829,55,40,0,40,0
2020-07-12,Butte,007,227075,626,341,8,349,4
2020-07-12,Calaveras,009,45235,87,62,0,62,0
2020-07-12,Colusa,011,21464,208,116,0,116,0
2020-07-12,Contra Costa,013,1133247,6482,4708,11,4719,88
2020-07-12,Del Norte,015,27424,63,59,0,59,0
2020-07-12,El Dorado,017,186661,513,290,0,290,0
2020-07-12,Fresno,019,978130,14953,8407,114,8521,95
2020-07-12,Glenn,021,27897,248,166,0,166,0
2020-07-12,Humboldt,023,135768,201,174,1,175,4
2020-07-12,Imperial,025,180216,9207,6999,7,7006,109
2020-07-12,Inyo,027,18085,39,35,1,36,1
2020-07-12,Kern,029,883053,16216,6662,50,6712,105
2020-07-12,Kings,031,150075,3450,2779,22,2801,34
2020-07-12,Lake,033,64148,157,114,0,114,1
2020-07-12,Lassen,035,31185,491,237,2,239,0
2020-07-12,Los Angeles,037,10098052,154423,133830,186,134016,3816
2020-07-12,Madera,039,155013,1695,1025,3,1028,4
2020-07-12,Marin,041,260295,4301,3358,5,3363,21
2020-07-12,Mariposa,043,17540,39,31,0,31,1
2020-07-12,Mendocino,045,87422,161,88,0,88,0
2020-07-12,Merced,047,269075,3234,1908,2,1910,12
2020-07-12,Modoc,049,8938,1,0,0,0,0
2020-07-12,Mono,051,14174,71,45,0,45,1
2020-07-12,Monterey,053,433212,3449,2521,9,2530,18
2020-07-12,Napa,055,140530,709,519,0,519,4
2020-07-12,Nevada,057,99092,233,166,6,172,1
2020-07-12,Orange,059,3164182,33422,25399,386,25785,422
2020-07-12,Placer,061,380077,1491,1058,3,1061,11
2020-07-12,Plumas,063,18699,21,14,0,14,0
2020-07-12,Riverside,065,2383286,33386,26404,33,26437,542
2020-07-12,Sacramento,067,1510023,7724,5515,7,5522,85
2020-07-12,San Benito,069,59416,457,324,0,324,2
2020-07-12,San Bernardino,071,2135413,28393,19042,37,19079,312
2020-07-12,San Diego,073,3302833,24710,19929,2,19931,422
2020-07-12,San Francisco,075,870044,5290,4535,4,4539,50
2020-07-12,San Joaquin,077,732212,9206,6703,5,6708,71
2020-07-12,San Luis Obispo,079,281455,1448,972,7,979,5
2020-07-12,San Mateo,081,765935,4775,3988,7,3995,108
2020-07-12,Santa Barbara,083,443738,5209,4353,44,4397,28
2020-07-12,Santa Clara,085,1922200,8587,6252,20,6272,164
2020-07-12,Santa Cruz,087,273765,771,573,5,578,3
2020-07-12,Shasta,089,179085,310,173,1,174,6
2020-07-12,Sierra,091,2930,1,1,0,1,0
2020-07-12,Siskiyou,093,43540,59,36,0,36,0
2020-07-12,Solano,095,438530,2941,2037,10,2047,23
2020-07-12,Sonoma,097,501317,2304,1743,6,1749,13
2020-07-12,Stanislaus,099,539301,7293,5177,8,5185,53
2020-07-12,Sutter,101,95872,469,362,0,362,2
2020-07-12,Tehama,103,63373,148,111,2,113,1
2020-07-12,Trinity,105,12862,21,2,5,7,0
2020-07-12,Tulare,107,460477,7764,5864,27,5891,146
2020-07-12,Tuolumne,109,53932,89,52,2,54,0
2020-07-12,Ventura,111,848112,6311,4724,22,4746,50
2020-07-12,Yolo,113,214977,1233,889,3,892,27
2020-07-12,Yuba,115,75493,235,188,0,188,1
2020-07-11,Alameda,001,1643700,9675,7845,13,7858,148
2020-07-11,Alpine,003,1148,2,1,0,1,0
2020-07-11,Amador,005,37829,51,37,0,37,0
2020-07-11,Butte,007,227075,610,325,8,333,4
2020-07-11,Calaveras,009,45235,84,62,0,62,0
2020-07-11,Colusa,011,21464,203,110,0,110,0
2020-07-11,Contra Costa,013,1133247,6365,4650,11,4661,87
2020-07-11,Del Norte,015,27424,63,59,0,59,0
2020-07-11,El Dorado,017,186661,502,283,0,283,0
2020-07-11,Fresno,019,978130,14693,8086,112,8198,95
2020-07-11,Glenn,021,27897,240,161,0,161,0
2020-07-11,Humboldt,023,135768,200,174,1,175,4
2020-07-11,Imperial,025,180216,9168,6884,7,6891,109
2020-07-11,Inyo,027,18085,39,35,1,36,1
2020-07-11,Kern,029,883053,15859,6509,49,6558,103
2020-07-11,Kings,031,150075,3423,2753,22,2775,33
2020-07-11,Lake,033,64148,156,110,0,110,1
2020-07-11,Lassen,035,31185,490,237,2,239,0
2020-07-11,Los Angeles,037,10098052,152706,130479,176,130655,3802
2020-07-11,Madera,039,155013,1654,988,3,991,4
2020-07-11,Marin,041,260295,4273,3191,5,3196,21
2020-07-11,Mariposa,043,17540,39,31,0,31,1
2020-07-11,Mendocino,045,87422,157,88,0,88,0
2020-07-11,Merced,047,269075,3153,1851,2,1853,12
2020-07-11,Modoc,049,8938,1,0,0,0,0
2020-07-11,Mono,051,14174,68,45,0,45,1
2020-07-11,Monterey,053,433212,3360,2376,8,2384,18
2020-07-11,Napa,055,140530,697,509,0,509,4
2020-07-11,Nevada,057,99092,224,163,5,168,1
2020-07-11,Orange,059,3164182,33045,24430,372,24802,422
2020-07-11,Placer,061,380077,1456,1029,3,1032,11
2020-07-11,Plumas,063,18699,21,12,0,12,0
2020-07-11,Riverside,065,2383286,32995,25994,33,26027,538
2020-07-11,Sacramento,067,1510023,7550,5367,7,5374,84
2020-07-11,San Benito,069,59416,442,314,0,314,2
2020-07-11,San Bernardino,071,2135413,27956,18907,35,18942,310
2020-07-11,San Diego,073,3302833,24321,19371,2,19373,422
2020-07-11,San Francisco,075,870044,5194,4430,3,4433,50
2020-07-11,San Joaquin,077,732212,9028,6518,5,6523,72
2020-07-11,San Luis Obispo,079,281455,1400,930,7,937,4
2020-07-11,San Mateo,081,765935,4707,3956,7,3963,108
2020-07-11,Santa Barbara,083,443738,5140,4283,43,4326,28
2020-07-11,Santa Clara,085,1922200,8428,5959,20,5979,164
2020-07-11,Santa Cruz,087,273765,740,571,5,576,3
2020-07-11,Shasta,089,179085,303,168,1,169,6
2020-07-11,Sierra,091,2930,1,1,0,1,0
2020-07-11,Siskiyou,093,43540,59,36,0,36,0
2020-07-11,Solano,095,438530,2900,2034,10,2044,23
2020-07-11,Sonoma,097,501317,2266,1690,6,1696,13
2020-07-11,Stanislaus,099,539301,7152,4911,8,4919,51
2020-07-11,Sutter,101,95872,453,352,0,352,2
2020-07-11,Tehama,103,63373,146,111,2,113,1
2020-07-11,Trinity,105,12862,21,2,5,7,0
2020-07-11,Tulare,107,460477,7658,5780,27,5807,149
2020-07-11,Tuolumne,109,53932,87,50,2,52,0
2020-07-11,Ventura,111,848112,6215,4545,21,4566,49
2020-07-11,Yolo,113,214977,1204,833,3,836,27
2020-07-11,Yuba,115,75493,225,175,0,175,1
2020-07-10,Alameda,001,1643700,9518,7551,13,7564,147
2020-07-10,Alpine,003,1148,2,1,0,1,0
2020-07-10,Amador,005,37829,47,37,0,37,0
2020-07-10,Butte,007,227075,599,318,8,326,4
2020-07-10,Calaveras,009,45235,84,61,0,61,0
2020-07-10,Colusa,011,21464,197,103,0,103,0
2020-07-10,Contra Costa,013,1133247,6222,4482,11,4493,86
2020-07-10,Del Norte,015,27424,63,57,0,57,0
2020-07-10,El Dorado,017,186661,484,266,0,266,0
2020-07-10,Fresno,019,978130,14361,7760,109,7869,93
2020-07-10,Glenn,021,27897,235,157,0,157,0
2020-07-10,Humboldt,023,135768,199,168,1,169,4
2020-07-10,Imperial,025,180216,9123,6878,6,6884,98
2020-07-10,Inyo,027,18085,39,35,1,36,1
2020-07-10,Kern,029,883053,15426,6344,48,6392,102
2020-07-10,Kings,031,150075,3387,2707,22,2729,33
2020-07-10,Lake,033,64148,149,104,0,104,1
2020-07-10,Lassen,035,31185,489,235,2,237,0
2020-07-10,Los Angeles,037,10098052,150288,127503,170,127673,3750
2020-07-10,Madera,039,155013,1608,914,3,917,4
2020-07-10,Marin,041,260295,4210,3101,5,3106,21
2020-07-10,Mariposa,043,17540,38,31,0,31,1
2020-07-10,Mendocino,045,87422,149,88,0,88,0
2020-07-10,Merced,047,269075,3074,1802,2,1804,12
2020-07-10,Modoc,049,8938,1,0,0,0,0
2020-07-10,Mono,051,14174,67,45,0,45,1
2020-07-10,Monterey,053,433212,3281,2285,8,2293,18
2020-07-10,Napa,055,140530,686,496,0,496,4
2020-07-10,Nevada,057,99092,219,161,5,166,1
2020-07-10,Orange,059,3164182,32458,23692,369,24061,416
2020-07-10,Placer,061,380077,1414,1002,3,1005,11
2020-07-10,Plumas,063,18699,19,12,0,12,0
2020-07-10,Riverside,065,2383286,32478,25481,33,25514,533
2020-07-10,Sacramento,067,1510023,7295,5181,7,5188,81
2020-07-10,San Benito,069,59416,433,302,0,302,2
2020-07-10,San Bernardino,071,2135413,27431,18242,32,18274,308
2020-07-10,San Diego,073,3302833,23936,18862,2,18864,420
2020-07-10,San Francisco,075,870044,5103,4305,3,4308,50
2020-07-10,San Joaquin,077,732212,8795,6225,5,6230,67
2020-07-10,San Luis Obispo,079,281455,1362,891,7,898,4
2020-07-10,San Mateo,081,765935,4642,3844,7,3851,107
2020-07-10,Santa Barbara,083,443738,5043,4177,42,4219,28
2020-07-10,Santa Clara,085,1922200,8204,5819,20,5839,164
2020-07-10,Santa Cruz,087,273765,713,540,5,545,3
2020-07-10,Shasta,089,179085,299,158,1,159,6
2020-07-10,Sierra,091,2930,1,1,0,1,0
2020-07-10,Siskiyou,093,43540,59,31,0,31,0
2020-07-10,Solano,095,438530,2853,1950,10,1960,23
2020-07-10,Sonoma,097,501317,2219,1606,5,1611,13
2020-07-10,Stanislaus,099,539301,6982,4781,8,4789,46
2020-07-10,Sutter,101,95872,446,338,0,338,2
2020-07-10,Tehama,103,63373,145,107,2,109,1
2020-07-10,Trinity,105,12862,21,2,5,7,0
2020-07-10,Tulare,107,460477,7521,5677,27,5704,150
2020-07-10,Tuolumne,109,53932,86,49,2,51,0
2020-07-10,Ventura,111,848112,6101,4416,21,4437,48
2020-07-10,Yolo,113,214977,1180,794,3,797,27
2020-07-10,Yuba,115,75493,211,164,0,164,1
2020-07-09,Alameda,001,1643700,9282,7433,13,7446,146
2020-07-09,Alpine,003,1148,2,1,0,1,0
2020-07-09,Amador,005,37829,44,36,0,36,0
2020-07-09,Butte,007,227075,567,295,8,303,4
2020-07-09,Calaveras,009,45235,83,59,0,59,0
2020-07-09,Colusa,011,21464,189,97,0,97,0
2020-07-09,Contra Costa,013,1133247,5979,4388,11,4399,86
2020-07-09,Del Norte,015,27424,63,57,0,57,0
2020-07-09,El Dorado,017,186661,459,255,0,255,0
2020-07-09,Fresno,019,978130,13907,7385,106,7491,90
2020-07-09,Glenn,021,27897,225,150,0,150,0
2020-07-09,Humboldt,023,135768,196,166,1,167,4
2020-07-09,Imperial,025,180216,9028,6778,6,6784,87
2020-07-09,Inyo,027,18085,37,35,1,36,1
2020-07-09,Kern,029,883053,14781,6100,46,6146,95
2020-07-09,Kings,031,150075,3323,2686,21,2707,33
2020-07-09,Lake,033,64148,146,99,0,99,1
2020-07-09,Lassen,035,31185,433,221,2,223,0
2020-07-09,Los Angeles,037,10098052,147030,125062,146,125208,3698
2020-07-09,Madera,039,155013,1531,850,3,853,4
2020-07-09,Marin,041,260295,4058,2975,4,2979,20
2020-07-09,Mariposa,043,17540,38,32,0,32,1
2020-07-09,Mendocino,045,87422,145,88,0,88,0
2020-07-09,Merced,047,269075,2941,1728,2,1730,11
2020-07-09,Modoc,049,8938,1,0,0,0,0
2020-07-09,Mono,051,14174,63,45,0,45,1
2020-07-09,Monterey,053,433212,3156,2223,8,2231,17
2020-07-09,Napa,055,140530,669,468,0,468,4
2020-07-09,Nevada,057,99092,213,156,5,161,1
2020-07-09,Orange,059,3164182,31487,22960,351,23311,407
2020-07-09,Placer,061,380077,1372,982,3,985,11
2020-07-09,Plumas,063,18699,19,12,0,12,0
2020-07-09,Riverside,065,2383286,31585,24980,32,25012,529
2020-07-09,Sacramento,067,1510023,6968,4950,7,4957,81
2020-07-09,San Benito,069,59416,417,295,0,295,2
2020-07-09,San Bernardino,071,2135413,26558,17339,26,17365,307
2020-07-09,San Diego,073,3302833,23343,18404,2,18406,415
2020-07-09,San Francisco,075,870044,4971,4143,3,4146,50
2020-07-09,San Joaquin,077,732212,8436,6004,5,6009,66
2020-07-09,San Luis Obispo,079,281455,1322,869,7,876,3
2020-07-09,San Mateo,081,765935,4515,3792,7,3799,106
2020-07-09,Santa Barbara,083,443738,4911,4068,42,4110,28
2020-07-09,Santa Clara,085,1922200,7947,5638,19,5657,164
2020-07-09,Santa Cruz,087,273765,686,526,5,531,3
2020-07-09,Shasta,089,179085,293,155,1,156,5
2020-07-09,Sierra,091,2930,1,1,0,1,0
2020-07-09,Siskiyou,093,43540,55,31,0,31,0
2020-07-09,Solano,095,438530,2755,1892,10,1902,23
2020-07-09,Sonoma,097,501317,2133,1584,5,1589,13
2020-07-09,Stanislaus,099,539301,6666,4633,7,4640,46
2020-07-09,Sutter,101,95872,429,321,0,321,2
2020-07-09,Tehama,103,63373,140,102,2,104,1
2020-07-09,Trinity,105,12862,21,2,5,7,0
2020-07-09,Tulare,107,460477,7302,5501,26,5527,146
2020-07-09,Tuolumne,109,53932,85,47,2,49,0
2020-07-09,Ventura,111,848112,5933,4278,21,4299,47
2020-07-09,Yolo,113,214977,1133,764,3,767,27
2020-07-09,Yuba,115,75493,194,152,0,152,1
2020-07-08,Alameda,001,1643700,8990,7335,13,7348,142
2020-07-08,Alpine,003,1148,2,1,0,1,0
2020-07-08,Amador,005,37829,41,35,0,35,0
2020-07-08,Butte,007,227075,530,281,8,289,3
2020-07-08,Calaveras,009,45235,78,58,0,58,0
2020-07-08,Colusa,011,21464,176,90,0,90,0
2020-07-08,Contra Costa,013,1133247,5733,4268,9,4277,84
2020-07-08,Del Norte,015,27424,61,57,0,57,0
2020-07-08,El Dorado,017,186661,438,248,0,248,0
2020-07-08,Fresno,019,978130,13490,7102,98,7200,86
2020-07-08,Glenn,021,27897,214,146,0,146,0
2020-07-08,Humboldt,023,135768,193,162,1,163,4
2020-07-08,Imperial,025,180216,8941,6727,6,6733,76
2020-07-08,Inyo,027,18085,37,35,1,36,1
2020-07-08,Kern,029,883053,14203,5873,44,5917,91
2020-07-08,Kings,031,150075,3263,2629,18,2647,33
2020-07-08,Lake,033,64148,139,97,0,97,1
2020-07-08,Lassen,035,31185,337,221,2,223,0
2020-07-08,Los Angeles,037,10098052,143830,123462,119,123581,3650
2020-07-08,Madera,039,155013,1461,828,3,831,4
2020-07-08,Marin,041,260295,3959,2756,4,2760,17
2020-07-08,Mariposa,043,17540,38,31,0,31,1
2020-07-08,Mendocino,045,87422,132,84,0,84,0
2020-07-08,Merced,047,269075,2821,1578,2,1580,11
2020-07-08,Modoc,049,8938,1,0,0,0,0
2020-07-08,Mono,051,14174,60,45,0,45,1
2020-07-08,Monterey,053,433212,3038,2182,7,2189,17
2020-07-08,Napa,055,140530,647,468,0,468,4
2020-07-08,Nevada,057,99092,204,156,5,161,1
2020-07-08,Orange,059,3164182,30535,22088,346,22434,378
2020-07-08,Placer,061,380077,1325,948,3,951,11
2020-07-08,Plumas,063,18699,19,12,0,12,0
2020-07-08,Riverside,065,2383286,30621,24042,31,24073,508
2020-07-08,Sacramento,067,1510023,6680,4799,7,4806,80
2020-07-08,San Benito,069,59416,401,282,0,282,2
2020-07-08,San Bernardino,071,2135413,25704,16510,22,16532,296
2020-07-08,San Diego,073,3302833,22774,17844,2,17846,406
2020-07-08,San Francisco,075,870044,4882,4093,3,4096,50
2020-07-08,San Joaquin,077,732212,8093,5759,5,5764,61
2020-07-08,San Luis Obispo,079,281455,1270,825,7,832,2
2020-07-08,San Mateo,081,765935,4394,3733,7,3740,106
2020-07-08,Santa Barbara,083,443738,4792,3985,42,4027,28
2020-07-08,Santa Clara,085,1922200,7714,5510,19,5529,164
2020-07-08,Santa Cruz,087,273765,653,509,4,513,3
2020-07-08,Shasta,089,179085,284,148,1,149,6
2020-07-08,Sierra,091,2930,1,1,0,1,0
2020-07-08,Siskiyou,093,43540,55,31,0,31,0
2020-07-08,Solano,095,438530,2639,1821,10,1831,23
2020-07-08,Sonoma,097,501317,2058,1495,5,1500,9
2020-07-08,Stanislaus,099,539301,6366,4344,7,4351,46
2020-07-08,Sutter,101,95872,404,298,0,298,2
2020-07-08,Tehama,103,63373,134,100,2,102,1
2020-07-08,Trinity,105,12862,20,2,5,7,0
2020-07-08,Tulare,107,460477,7110,5307,21,5328,138
2020-07-08,Tuolumne,109,53932,81,42,2,44,0
2020-07-08,Ventura,111,848112,5768,4139,21,4160,47
2020-07-08,Yolo,113,214977,1089,727,3,730,26
2020-07-08,Yuba,115,75493,181,145,0,145,1
2020-07-07,Alameda,001,1643700,8670,7097,12,7109,141
2020-07-07,Alpine,003,1148,2,1,0,1,0
2020-07-07,Amador,005,37829,41,33,0,33,0
2020-07-07,Butte,007,227075,487,269,8,277,3
2020-07-07,Calaveras,009,45235,76,58,0,58,0
2020-07-07,Colusa,011,21464,143,84,0,84,0
2020-07-07,Contra Costa,013,1133247,5497,4131,8,4139,84
2020-07-07,Del Norte,015,27424,61,57,0,57,0
2020-07-07,El Dorado,017,186661,418,244,0,244,0
2020-07-07,Fresno,019,978130,13037,6738,98,6836,84
2020-07-07,Glenn,021,27897,205,145,0,145,0
2020-07-07,Humboldt,023,135768,190,150,1,151,4
2020-07-07,Imperial,025,180216,8842,6678,6,6684,51
2020-07-07,Inyo,027,18085,36,32,1,33,1
2020-07-07,Kern,029,883053,13504,5645,40,5685,88
2020-07-07,Kings,031,150075,3200,2623,16,2639,33
2020-07-07,Lake,033,64148,129,94,0,94,1
2020-07-07,Lassen,035,31185,266,219,2,221,0
2020-07-07,Los Angeles,037,10098052,140263,121026,111,121137,3588
2020-07-07,Madera,039,155013,1417,794,3,797,4
2020-07-07,Marin,041,260295,3870,2627,4,2631,17
2020-07-07,Mariposa,043,17540,38,31,0,31,1
2020-07-07,Mendocino,045,87422,124,82,0,82,0
2020-07-07,Merced,047,269075,2647,1531,2,1533,10
2020-07-07,Modoc,049,8938,1,0,0,0,0
2020-07-07,Mono,051,14174,59,42,0,42,1
2020-07-07,Monterey,053,433212,2895,2166,7,2173,17
2020-07-07,Napa,055,140530,628,459,0,459,4
2020-07-07,Nevada,057,99092,198,150,5,155,1
2020-07-07,Orange,059,3164182,29524,21741,332,22073,373
2020-07-07,Placer,061,380077,1284,930,3,933,11
2020-07-07,Plumas,063,18699,17,12,0,12,0
2020-07-07,Riverside,065,2383286,29606,23279,31,23310,499
2020-07-07,Sacramento,067,1510023,6336,4592,7,4599,76
2020-07-07,San Benito,069,59416,383,274,0,274,2
2020-07-07,San Bernardino,071,2135413,24833,16004,20,16024,277
2020-07-07,San Diego,073,3302833,22055,17580,2,17582,399
2020-07-07,San Francisco,075,870044,4789,4045,2,4047,50
2020-07-07,San Joaquin,077,732212,7751,5547,5,5552,59
2020-07-07,San Luis Obispo,079,281455,1209,795,7,802,2
2020-07-07,San Mateo,081,765935,4279,3691,7,3698,106
2020-07-07,Santa Barbara,083,443738,4664,3866,41,3907,27
2020-07-07,Santa Clara,085,1922200,7445,5438,19,5457,164
2020-07-07,Santa Cruz,087,273765,619,502,3,505,2
2020-07-07,Shasta,089,179085,271,144,1,145,6
2020-07-07,Sierra,091,2930,1,1,0,1,0
2020-07-07,Siskiyou,093,43540,54,30,0,30,0
2020-07-07,Solano,095,438530,2528,1776,9,1785,22
2020-07-07,Sonoma,097,501317,1988,1473,5,1478,8
2020-07-07,Stanislaus,099,539301,6027,4101,7,4108,46
2020-07-07,Sutter,101,95872,378,273,0,273,2
2020-07-07,Tehama,103,63373,125,95,2,97,1
2020-07-07,Trinity,105,12862,20,2,5,7,0
2020-07-07,Tulare,107,460477,6930,5189,19,5208,137
2020-07-07,Tuolumne,109,53932,75,40,2,42,0
2020-07-07,Ventura,111,848112,5599,3992,19,4011,46
2020-07-07,Yolo,113,214977,1022,706,3,709,26
2020-07-07,Yuba,115,75493,161,138,0,138,1
2020-07-06,Alameda,001,1643700,8432,6970,12,6982,141
2020-07-06,Alpine,003,1148,1,1,0,1,0
2020-07-06,Amador,005,37829,39,33,0,33,0
2020-07-06,Butte,007,227075,431,257,8,265,2
2020-07-06,Calaveras,009,45235,73,45,0,45,0
2020-07-06,Colusa,011,21464,134,80,0,80,0
2020-07-06,Contra Costa,013,1133247,5266,3901,7,3908,83
2020-07-06,Del Norte,015,27424,60,57,0,57,0
2020-07-06,El Dorado,017,186661,403,232,0,232,0
2020-07-06,Fresno,019,978130,12569,6364,92,6456,82
2020-07-06,Glenn,021,27897,197,129,0,129,0
2020-07-06,Humboldt,023,135768,188,148,1,149,3
2020-07-06,Imperial,025,180216,8723,6443,6,6449,47
2020-07-06,Inyo,027,18085,36,32,1,33,1
2020-07-06,Kern,029,883053,12698,5491,39,5530,82
2020-07-06,Kings,031,150075,3149,2583,11,2594,33
2020-07-06,Lake,033,64148,122,93,0,93,1
2020-07-06,Lassen,035,31185,264,219,2,221,0
2020-07-06,Los Angeles,037,10098052,136662,116707,97,116804,3541
2020-07-06,Madera,039,155013,1347,734,3,737,4
2020-07-06,Marin,041,260295,3630,2136,4,2140,17
2020-07-06,Mariposa,043,17540,36,31,0,31,1
2020-07-06,Mendocino,045,87422,107,72,0,72,0
2020-07-06,Merced,047,269075,2496,1396,2,1398,10
2020-07-06,Modoc,049,8938,1,0,0,0,0
2020-07-06,Mono,051,14174,58,40,0,40,1
2020-07-06,Monterey,053,433212,2805,2078,7,2085,15
2020-07-06,Napa,055,140530,610,454,0,454,4
2020-07-06,Nevada,057,99092,192,146,5,151,1
2020-07-06,Orange,059,3164182,28462,20167,295,20462,372
2020-07-06,Placer,061,380077,1222,904,3,907,11
2020-07-06,Plumas,063,18699,17,11,0,11,0
2020-07-06,Riverside,065,2383286,28552,22485,30,22515,477
2020-07-06,Sacramento,067,1510023,5985,4420,7,4427,71
2020-07-06,San Benito,069,59416,368,264,0,264,2
2020-07-06,San Bernardino,071,2135413,23979,15346,17,15363,272
2020-07-06,San Diego,073,3302833,21324,17002,2,17004,387
2020-07-06,San Francisco,075,870044,4668,3861,2,3863,50
2020-07-06,San Joaquin,077,732212,7381,5104,5,5109,57
2020-07-06,San Luis Obispo,079,281455,1151,751,7,758,2
2020-07-06,San Mateo,081,765935,4187,3650,6,3656,106
2020-07-06,Santa Barbara,083,443738,4527,3763,40,3803,27
2020-07-06,Santa Clara,085,1922200,7174,5369,19,5388,165
2020-07-06,Santa Cruz,087,273765,597,466,2,468,2
2020-07-06,Shasta,089,179085,261,143,1,144,6
2020-07-06,Sierra,091,2930,1,1,0,1,0
2020-07-06,Siskiyou,093,43540,50,30,0,30,0
2020-07-06,Solano,095,438530,2395,1668,9,1677,22
2020-07-06,Sonoma,097,501317,1924,1369,5,1374,8
2020-07-06,Stanislaus,099,539301,5625,3983,7,3990,46
2020-07-06,Sutter,101,95872,351,250,0,250,2
2020-07-06,Tehama,103,63373,122,95,2,97,1
2020-07-06,Trinity,105,12862,19,2,5,7,0
2020-07-06,Tulare,107,460477,6725,5039,17,5056,136
2020-07-06,Tuolumne,109,53932,72,30,2,32,0
2020-07-06,Ventura,111,848112,5406,3912,19,3931,44
2020-07-06,Yolo,113,214977,966,685,3,688,26
2020-07-06,Yuba,115,75493,147,124,0,124,1
2020-07-05,Alameda,001,1643700,8180,6861,12,6873,141
2020-07-05,Alpine,003,1148,1,1,0,1,0
2020-07-05,Amador,005,37829,37,31,0,31,0
2020-07-05,Butte,007,227075,396,248,8,256,2
2020-07-05,Calaveras,009,45235,69,45,0,45,0
2020-07-05,Colusa,011,21464,124,79,0,79,0
2020-07-05,Contra Costa,013,1133247,5026,3665,6,3671,80
2020-07-05,Del Norte,015,27424,60,57,0,57,0
2020-07-05,El Dorado,017,186661,385,227,0,227,0
2020-07-05,Fresno,019,978130,12003,6186,91,6277,82
2020-07-05,Glenn,021,27897,194,129,0,129,0
2020-07-05,Humboldt,023,135768,184,147,1,148,3
2020-07-05,Imperial,025,180216,8589,6441,6,6447,47
2020-07-05,Inyo,027,18085,35,32,1,33,1
2020-07-05,Kern,029,883053,11989,5351,39,5390,82
2020-07-05,Kings,031,150075,3066,2546,10,2556,31
2020-07-05,Lake,033,64148,122,92,0,92,1
2020-07-05,Lassen,035,31185,258,219,2,221,0
2020-07-05,Los Angeles,037,10098052,133441,115133,91,115224,3495
2020-07-05,Madera,039,155013,1269,564,3,567,4
2020-07-05,Marin,041,260295,3447,2080,4,2084,17
2020-07-05,Mariposa,043,17540,36,31,0,31,1
2020-07-05,Mendocino,045,87422,104,72,0,72,0
2020-07-05,Merced,047,269075,2351,1340,2,1342,10
2020-07-05,Modoc,049,8938,1,0,0,0,0
2020-07-05,Mono,051,14174,54,39,0,39,1
2020-07-05,Monterey,053,433212,2702,1994,7,2001,15
2020-07-05,Napa,055,140530,580,450,0,450,4
2020-07-05,Nevada,057,99092,186,141,5,146,1
2020-07-05,Orange,059,3164182,27521,19430,282,19712,372
2020-07-05,Placer,061,380077,1165,855,3,858,11
2020-07-05,Plumas,063,18699,16,11,0,11,0
2020-07-05,Riverside,065,2383286,27695,21511,30,21541,474
2020-07-05,Sacramento,067,1510023,5670,4265,6,4271,71
2020-07-05,San Benito,069,59416,349,258,0,258,2
2020-07-05,San Bernardino,071,2135413,23102,15026,17,15043,270
2020-07-05,San Diego,073,3302833,20633,16728,2,16730,387
2020-07-05,San Francisco,075,870044,4550,3861,2,3863,50
2020-07-05,San Joaquin,077,732212,7062,5015,5,5020,57
2020-07-05,San Luis Obispo,079,281455,1072,730,7,737,2
2020-07-05,San Mateo,081,765935,4076,3575,6,3581,106
2020-07-05,Santa Barbara,083,443738,4380,3671,37,3708,27
2020-07-05,Santa Clara,085,1922200,6882,5237,19,5256,162
2020-07-05,Santa Cruz,087,273765,579,467,0,467,2
2020-07-05,Shasta,089,179085,255,138,1,139,6
2020-07-05,Sierra,091,2930,1,1,0,1,0
2020-07-05,Siskiyou,093,43540,46,30,0,30,0
2020-07-05,Solano,095,438530,2275,1547,9,1556,22
2020-07-05,Sonoma,097,501317,1843,1369,5,1374,8
2020-07-05,Stanislaus,099,539301,5294,3777,6,3783,45
2020-07-05,Sutter,101,95872,323,241,0,241,2
2020-07-05,Tehama,103,63373,120,95,2,97,1
2020-07-05,Trinity,105,12862,19,2,5,7,0
2020-07-05,Tulare,107,460477,6466,4981,15,4996,135
2020-07-05,Tuolumne,109,53932,67,30,2,32,0
2020-07-05,Ventura,111,848112,5203,3866,19,3885,44
2020-07-05,Yolo,113,214977,926,644,3,647,26
2020-07-05,Yuba,115,75493,137,115,0,115,1
2020-07-04,Alameda,001,1643700,8068,6737,12,6749,141
2020-07-04,Alpine,003,1148,1,1,0,1,0
2020-07-04,Amador,005,37829,36,31,0,31,0
2020-07-04,Butte,007,227075,378,224,8,232,2
2020-07-04,Calaveras,009,45235,69,45,0,45,0
2020-07-04,Colusa,011,21464,123,76,0,76,0
2020-07-04,Contra Costa,013,1133247,4878,3583,6,3589,80
2020-07-04,Del Norte,015,27424,60,50,0,50,0
2020-07-04,El Dorado,017,186661,366,211,0,211,0
2020-07-04,Fresno,019,978130,11686,5999,89,6088,82
2020-07-04,Glenn,021,27897,187,128,0,128,0
2020-07-04,Humboldt,023,135768,177,144,1,145,3
2020-07-04,Imperial,025,180216,8540,6441,6,6447,47
2020-07-04,Inyo,027,18085,35,32,1,33,1
2020-07-04,Kern,029,883053,11685,5231,39,5270,81
2020-07-04,Kings,031,150075,3023,2509,10,2519,31
2020-07-04,Lake,033,64148,115,86,0,86,1
2020-07-04,Lassen,035,31185,258,219,2,221,0
2020-07-04,Los Angeles,037,10098052,131624,107256,80,107336,3462
2020-07-04,Madera,039,155013,1223,568,3,571,4
2020-07-04,Marin,041,260295,3418,1962,4,1966,17
2020-07-04,Mariposa,043,17540,36,28,0,28,1
2020-07-04,Mendocino,045,87422,104,72,0,72,0
2020-07-04,Merced,047,269075,2249,1252,2,1254,10
2020-07-04,Modoc,049,8938,1,0,0,0,0
2020-07-04,Mono,051,14174,54,37,0,37,1
2020-07-04,Monterey,053,433212,2622,1878,7,1885,15
2020-07-04,Napa,055,140530,571,426,0,426,4
2020-07-04,Nevada,057,99092,183,125,5,130,1
2020-07-04,Orange,059,3164182,27088,19247,269,19516,372
2020-07-04,Placer,061,380077,1130,796,3,799,11
2020-07-04,Plumas,063,18699,16,11,0,11,0
2020-07-04,Riverside,065,2383286,27328,21508,30,21538,474
2020-07-04,Sacramento,067,1510023,5499,4039,6,4045,71
2020-07-04,San Benito,069,59416,336,255,0,255,2
2020-07-04,San Bernardino,071,2135413,22676,14636,15,14651,270
2020-07-04,San Diego,073,3302833,20173,16166,2,16168,387
2020-07-04,San Francisco,075,870044,4458,3861,2,3863,50
2020-07-04,San Joaquin,077,732212,6849,4807,5,4812,57
2020-07-04,San Luis Obispo,079,281455,1032,699,7,706,2
2020-07-04,San Mateo,081,765935,4013,3532,6,3538,106
2020-07-04,Santa Barbara,083,443738,4305,3520,35,3555,27
2020-07-04,Santa Clara,085,1922200,6690,5045,18,5063,161
2020-07-04,Santa Cruz,087,273765,569,466,0,466,2
2020-07-04,Shasta,089,179085,252,135,1,136,6
2020-07-04,Sierra,091,2930,1,1,0,1,0
2020-07-04,Siskiyou,093,43540,39,30,0,30,0
2020-07-04,Solano,095,438530,2239,1548,9,1557,22
2020-07-04,Sonoma,097,501317,1817,1370,5,1375,8
2020-07-04,Stanislaus,099,539301,5135,3572,6,3578,44
2020-07-04,Sutter,101,95872,304,225,0,225,2
2020-07-04,Tehama,103,63373,117,92,2,94,1
2020-07-04,Trinity,105,12862,19,2,5,7,0
2020-07-04,Tulare,107,460477,6354,4802,14,4816,135
2020-07-04,Tuolumne,109,53932,63,30,2,32,0
2020-07-04,Ventura,111,848112,5079,3687,19,3706,44
2020-07-04,Yolo,113,214977,901,615,3,618,26
2020-07-04,Yuba,115,75493,130,102,0,102,1
2020-07-03,Alameda,001,1643700,7947,6486,12,6498,141
2020-07-03,Alpine,003,1148,1,1,0,1,0
2020-07-03,Amador,005,37829,36,25,0,25,0
2020-07-03,Butte,007,227075,366,212,8,220,2
2020-07-03,Calaveras,009,45235,69,44,0,44,0
2020-07-03,Colusa,011,21464,117,70,0,70,0
2020-07-03,Contra Costa,013,1133247,4744,3447,6,3453,78
2020-07-03,Del Norte,015,27424,60,50,0,50,0
2020-07-03,El Dorado,017,186661,354,201,0,201,0
2020-07-03,Fresno,019,978130,11381,5783,87,5870,81
2020-07-03,Glenn,021,27897,182,122,0,122,0
2020-07-03,Humboldt,023,135768,173,143,1,144,3
2020-07-03,Imperial,025,180216,8492,6345,6,6351,47
2020-07-03,Inyo,027,18085,35,32,1,33,1
2020-07-03,Kern,029,883053,11424,5213,39,5252,81
2020-07-03,Kings,031,150075,2987,2492,10,2502,31
2020-07-03,Lake,033,64148,108,83,0,83,0
2020-07-03,Lassen,035,31185,258,219,2,221,0
2020-07-03,Los Angeles,037,10098052,130107,107236,76,107312,3461
2020-07-03,Madera,039,155013,1178,565,3,568,4
2020-07-03,Marin,041,260295,3390,1776,4,1780,17
2020-07-03,Mariposa,043,17540,36,28,0,28,1
2020-07-03,Mendocino,045,87422,103,72,0,72,0
2020-07-03,Merced,047,269075,2183,1188,2,1190,10
2020-07-03,Modoc,049,8938,1,0,0,0,0
2020-07-03,Mono,051,14174,54,37,0,37,1
2020-07-03,Monterey,053,433212,2551,1804,7,1811,15
2020-07-03,Napa,055,140530,553,388,0,388,4
2020-07-03,Nevada,057,99092,182,125,5,130,1
2020-07-03,Orange,059,3164182,26697,18819,261,19080,366
2020-07-03,Placer,061,380077,1103,745,3,748,11
2020-07-03,Plumas,063,18699,16,11,0,11,0
2020-07-03,Riverside,065,2383286,27022,21171,30,21201,472
2020-07-03,Sacramento,067,1510023,5365,3711,6,3717,71
2020-07-03,San Benito,069,59416,329,243,0,243,2
2020-07-03,San Bernardino,071,2135413,22287,14040,15,14055,269
2020-07-03,San Diego,073,3302833,19717,15698,2,15700,387
2020-07-03,San Francisco,075,870044,4411,3781,2,3783,50
2020-07-03,San Joaquin,077,732212,6711,4416,4,4420,56
2020-07-03,San Luis Obispo,079,281455,997,676,7,683,2
2020-07-03,San Mateo,081,765935,3956,3439,6,3445,106
2020-07-03,Santa Barbara,083,443738,4218,3406,34,3440,27
2020-07-03,Santa Clara,085,1922200,6577,4820,18,4838,161
2020-07-03,Santa Cruz,087,273765,556,436,0,436,2
2020-07-03,Shasta,089,179085,244,113,1,114,6
2020-07-03,Sierra,091,2930,1,1,0,1,0
2020-07-03,Siskiyou,093,43540,36,30,0,30,0
2020-07-03,Solano,095,438530,2195,1496,8,1504,22
2020-07-03,Sonoma,097,501317,1768,1282,5,1287,8
2020-07-03,Stanislaus,099,539301,5010,3021,6,3027,43
2020-07-03,Sutter,101,95872,294,205,0,205,2
2020-07-03,Tehama,103,63373,115,89,2,91,1
2020-07-03,Trinity,105,12862,19,2,5,7,0
2020-07-03,Tulare,107,460477,6239,4656,14,4670,134
2020-07-03,Tuolumne,109,53932,61,27,2,29,0
2020-07-03,Ventura,111,848112,4983,3536,19,3555,44
2020-07-03,Yolo,113,214977,867,586,3,589,25
2020-07-03,Yuba,115,75493,125,96,0,96,1
2020-07-02,Alameda,001,1643700,7821,6386,12,6398,139
2020-07-02,Alpine,003,1148,1,1,0,1,0
2020-07-02,Amador,005,37829,35,23,0,23,0
2020-07-02,Butte,007,227075,349,199,8,207,2
2020-07-02,Calaveras,009,45235,65,42,0,42,0
2020-07-02,Colusa,011,21464,109,60,0,60,0
2020-07-02,Contra Costa,013,1133247,4560,3347,6,3353,77
2020-07-02,Del Norte,015,27424,59,50,0,50,0
2020-07-02,El Dorado,017,186661,343,193,0,193,0
2020-07-02,Fresno,019,978130,10921,5402,86,5488,78
2020-07-02,Glenn,021,27897,176,114,0,114,0
2020-07-02,Humboldt,023,135768,169,138,1,139,3
2020-07-02,Imperial,025,180216,8391,6236,5,6241,47
2020-07-02,Inyo,027,18085,35,29,1,30,1
2020-07-02,Kern,029,883053,10888,5036,37,5073,78
2020-07-02,Kings,031,150075,2936,2419,10,2429,31
2020-07-02,Lake,033,64148,104,81,0,81,0
2020-07-02,Lassen,035,31185,256,218,2,220,0
2020-07-02,Los Angeles,037,10098052,128089,107144,53,107197,3458
2020-07-02,Madera,039,155013,1110,548,3,551,4
2020-07-02,Marin,041,260295,3304,1706,4,1710,17
2020-07-02,Mariposa,043,17540,35,28,0,28,1
2020-07-02,Mendocino,045,87422,99,71,0,71,0
2020-07-02,Merced,047,269075,2086,1122,2,1124,10
2020-07-02,Modoc,049,8938,1,0,0,0,0
2020-07-02,Mono,051,14174,54,37,0,37,1
2020-07-02,Monterey,053,433212,2491,1796,7,1803,15
2020-07-02,Napa,055,140530,536,352,0,352,4
2020-07-02,Nevada,057,99092,176,118,4,122,1
2020-07-02,Orange,059,3164182,25933,17056,248,17304,360
2020-07-02,Placer,061,380077,1079,740,3,743,11
2020-07-02,Plumas,063,18699,15,8,0,8,0
2020-07-02,Riverside,065,2383286,26449,20253,30,20283,458
2020-07-02,Sacramento,067,1510023,5138,3587,6,3593,70
2020-07-02,San Benito,069,59416,321,236,0,236,2
2020-07-02,San Bernardino,071,2135413,21751,13185,15,13200,260
2020-07-02,San Diego,073,3302833,19253,15208,2,15210,377
2020-07-02,San Francisco,075,870044,4316,3676,2,3678,50
2020-07-02,San Joaquin,077,732212,6364,4243,4,4247,56
2020-07-02,San Luis Obispo,079,281455,952,659,7,666,2
2020-07-02,San Mateo,081,765935,3876,3390,6,3396,107
2020-07-02,Santa Barbara,083,443738,4118,3385,32,3417,27
2020-07-02,Santa Clara,085,1922200,6451,4722,18,4740,160
2020-07-02,Santa Cruz,087,273765,533,414,0,414,2
2020-07-02,Shasta,089,179085,241,110,1,111,5
2020-07-02,Sierra,091,2930,1,1,0,1,0
2020-07-02,Siskiyou,093,43540,36,30,0,30,0
2020-07-02,Solano,095,438530,2112,1429,8,1437,21
2020-07-02,Sonoma,097,501317,1710,1244,5,1249,6
2020-07-02,Stanislaus,099,539301,4838,2850,6,2856,41
2020-07-02,Sutter,101,95872,282,195,0,195,2
2020-07-02,Tehama,103,63373,113,86,2,88,1
2020-07-02,Trinity,105,12862,19,2,5,7,0
2020-07-02,Tulare,107,460477,6072,4559,13,4572,132
2020-07-02,Tuolumne,109,53932,58,23,2,25,0
2020-07-02,Ventura,111,848112,4827,3394,19,3413,42
2020-07-02,Yolo,113,214977,835,554,3,557,24
2020-07-02,Yuba,115,75493,115,93,0,93,1
2020-07-01,Alameda,001,1643700,7599,6125,12,6137,137
2020-07-01,Alpine,003,1148,1,1,0,1,0
2020-07-01,Amador,005,37829,34,22,0,22,0
2020-07-01,Butte,007,227075,324,185,8,193,2
2020-07-01,Calaveras,009,45235,63,37,0,37,0
2020-07-01,Colusa,011,21464,103,53,0,53,0
2020-07-01,Contra Costa,013,1133247,4348,3259,6,3265,76
2020-07-01,Del Norte,015,27424,59,50,0,50,0
2020-07-01,El Dorado,017,186661,316,183,0,183,0
2020-07-01,Fresno,019,978130,10487,5111,83,5194,76
2020-07-01,Glenn,021,27897,170,110,0,110,0
2020-07-01,Humboldt,023,135768,164,134,0,134,3
2020-07-01,Imperial,025,180216,8294,6150,5,6155,46
2020-07-01,Inyo,027,18085,34,30,1,31,1
2020-07-01,Kern,029,883053,10255,4853,35,4888,78
2020-07-01,Kings,031,150075,2868,2360,10,2370,30
2020-07-01,Lake,033,64148,103,75,0,75,0
2020-07-01,Lassen,035,31185,255,217,2,219,0
2020-07-01,Los Angeles,037,10098052,124886,105325,44,105369,3408
2020-07-01,Madera,039,155013,1069,519,3,522,4
2020-07-01,Marin,041,260295,3147,1636,4,1640,17
2020-07-01,Mariposa,043,17540,35,29,0,29,1
2020-07-01,Mendocino,045,87422,95,70,0,70,0
2020-07-01,Merced,047,269075,1986,1052,2,1054,10
2020-07-01,Modoc,049,8938,1,0,0,0,0
2020-07-01,Mono,051,14174,51,37,0,37,1
2020-07-01,Monterey,053,433212,2383,1703,6,1709,15
2020-07-01,Napa,055,140530,513,347,0,347,4
2020-07-01,Nevada,057,99092,166,115,4,119,1
2020-07-01,Orange,059,3164182,25048,15662,227,15889,343
2020-07-01,Placer,061,380077,1032,713,3,716,11
2020-07-01,Plumas,063,18699,13,8,0,8,0
2020-07-01,Riverside,065,2383286,25607,19537,29,19566,457
2020-07-01,Sacramento,067,1510023,4883,3425,6,3431,64
2020-07-01,San Benito,069,59416,312,219,0,219,2
2020-07-01,San Bernardino,071,2135413,20856,12712,12,12724,253
2020-07-01,San Diego,073,3302833,18685,14624,2,14626,372
2020-07-01,San Francisco,075,870044,4223,3626,2,3628,50
2020-07-01,San Joaquin,077,732212,6006,3990,4,3994,54
2020-07-01,San Luis Obispo,079,281455,925,613,7,620,1
2020-07-01,San Mateo,081,765935,3814,3326,6,3332,84
2020-07-01,Santa Barbara,083,443738,3998,3268,31,3299,27
2020-07-01,Santa Clara,085,1922200,6263,4547,17,4564,159
2020-07-01,Santa Cruz,087,273765,511,398,0,398,2
2020-07-01,Shasta,089,179085,236,104,1,105,5
2020-07-01,Sierra,091,2930,1,1,0,1,0
2020-07-01,Siskiyou,093,43540,36,28,0,28,0
2020-07-01,Solano,095,438530,2023,1350,8,1358,21
2020-07-01,Sonoma,097,501317,1614,1178,5,1183,6
2020-07-01,Stanislaus,099,539301,4559,2619,6,2625,41
2020-07-01,Sutter,101,95872,269,188,0,188,2
2020-07-01,Tehama,103,63373,106,80,2,82,1
2020-07-01,Trinity,105,12862,19,2,4,6,0
2020-07-01,Tulare,107,460477,5894,4359,13,4372,128
2020-07-01,Tuolumne,109,53932,55,17,2,19,0
2020-07-01,Ventura,111,848112,4684,3224,17,3241,41
2020-07-01,Yolo,113,214977,784,526,3,529,24
2020-07-01,Yuba,115,75493,110,57,0,57,1
2020-06-30,Alameda,001,1643700,7350,5959,10,5969,137
2020-06-30,Alpine,003,1148,1,1,0,1,0
2020-06-30,Amador,005,37829,34,21,0,21,0
2020-06-30,Butte,007,227075,307,163,8,171,2
2020-06-30,Calaveras,009,45235,58,31,0,31,0
2020-06-30,Colusa,011,21464,94,33,0,33,0
2020-06-30,Contra Costa,013,1133247,4141,3140,6,3146,75
2020-06-30,Del Norte,015,27424,59,48,0,48,0
2020-06-30,El Dorado,017,186661,303,175,0,175,0
2020-06-30,Fresno,019,978130,10039,4826,77,4903,75
2020-06-30,Glenn,021,27897,165,96,0,96,0
2020-06-30,Humboldt,023,135768,160,132,0,132,3
2020-06-30,Imperial,025,180216,8196,5968,5,5973,45
2020-06-30,Inyo,027,18085,34,30,1,31,1
2020-06-30,Kern,029,883053,9608,4721,31,4752,75
2020-06-30,Kings,031,150075,2819,2315,7,2322,30
2020-06-30,Lake,033,64148,95,56,0,56,0
2020-06-30,Lassen,035,31185,248,215,2,217,0
2020-06-30,Los Angeles,037,10098052,121309,103640,41,103681,3378
2020-06-30,Madera,039,155013,1012,475,3,478,4
2020-06-30,Marin,041,260295,3076,1614,4,1618,17
2020-06-30,Mariposa,043,17540,34,27,0,27,1
2020-06-30,Mendocino,045,87422,90,65,0,65,0
2020-06-30,Merced,047,269075,1849,970,2,972,10
2020-06-30,Modoc,049,8938,1,0,0,0,0
2020-06-30,Mono,051,14174,49,36,0,36,1
2020-06-30,Monterey,053,433212,2285,1657,6,1663,15
2020-06-30,Napa,055,140530,488,342,0,342,4
2020-06-30,Nevada,057,99092,158,113,4,117,1
2020-06-30,Orange,059,3164182,24117,14354,217,14571,335
2020-06-30,Placer,061,380077,1005,667,3,670,11
2020-06-30,Plumas,063,18699,12,8,0,8,0
2020-06-30,Riverside,065,2383286,24890,18656,28,18684,449
2020-06-30,Sacramento,067,1510023,4594,3246,6,3252,64
2020-06-30,San Benito,069,59416,301,200,0,200,2
2020-06-30,San Bernardino,071,2135413,19873,12375,11,12386,249
2020-06-30,San Diego,073,3302833,17980,14150,2,14152,365
2020-06-30,San Francisco,075,870044,4118,3555,1,3556,50
2020-06-30,San Joaquin,077,732212,5631,3744,4,3748,52
2020-06-30,San Luis Obispo,079,281455,887,583,7,590,1
2020-06-30,San Mateo,081,765935,3736,3268,6,3274,84
2020-06-30,Santa Barbara,083,443738,3882,3102,31,3133,25
2020-06-30,Santa Clara,085,1922200,6061,4346,17,4363,157
2020-06-30,Santa Cruz,087,273765,486,379,0,379,2
2020-06-30,Shasta,089,179085,220,100,1,101,5
2020-06-30,Sierra,091,2930,1,1,0,1,0
2020-06-30,Siskiyou,093,43540,35,26,0,26,0
2020-06-30,Solano,095,438530,1931,1256,8,1264,21
2020-06-30,Sonoma,097,501317,1549,1122,5,1127,6
2020-06-30,Stanislaus,099,539301,4261,2578,6,2584,41
2020-06-30,Sutter,101,95872,246,168,0,168,2
2020-06-30,Tehama,103,63373,104,75,2,77,1
2020-06-30,Trinity,105,12862,19,2,4,6,0
2020-06-30,Tulare,107,460477,5685,4207,13,4220,117
2020-06-30,Tuolumne,109,53932,51,16,2,18,0
2020-06-30,Ventura,111,848112,4550,3030,17,3047,40
2020-06-30,Yolo,113,214977,746,515,3,518,24
2020-06-30,Yuba,115,75493,106,55,0,55,1
2020-06-29,Alameda,001,1643700,7140,5766,10,5776,135
2020-06-29,Alpine,003,1148,1,1,0,1,0
2020-06-29,Amador,005,37829,31,20,0,20,0
2020-06-29,Butte,007,227075,286,157,8,165,2
2020-06-29,Calaveras,009,45235,56,30,0,30,0
2020-06-29,Colusa,011,21464,89,17,0,17,0
2020-06-29,Contra Costa,013,1133247,3978,2976,5,2981,75
2020-06-29,Del Norte,015,27424,59,47,0,47,0
2020-06-29,El Dorado,017,186661,289,163,0,163,0
2020-06-29,Fresno,019,978130,9691,4531,75,4606,74
2020-06-29,Glenn,021,27897,156,77,0,77,0
2020-06-29,Humboldt,023,135768,159,128,0,128,3
2020-06-29,Imperial,025,180216,8065,5512,5,5517,45
2020-06-29,Inyo,027,18085,33,29,0,29,1
2020-06-29,Kern,029,883053,8945,4613,29,4642,73
2020-06-29,Kings,031,150075,2754,2280,7,2287,20
2020-06-29,Lake,033,64148,88,53,0,53,0
2020-06-29,Lassen,035,31185,240,77,2,79,0
2020-06-29,Los Angeles,037,10098052,118270,100846,35,100881,3337
2020-06-29,Madera,039,155013,955,422,3,425,4
2020-06-29,Marin,041,260295,3000,1517,4,1521,17
2020-06-29,Mariposa,043,17540,32,25,0,25,1
2020-06-29,Mendocino,045,87422,87,63,0,63,0
2020-06-29,Merced,047,269075,1743,848,2,850,10
2020-06-29,Modoc,049,8938,1,0,0,0,0
2020-06-29,Mono,051,14174,47,35,0,35,1
2020-06-29,Monterey,053,433212,2213,1614,6,1620,14
2020-06-29,Napa,055,140530,466,317,0,317,4
2020-06-29,Nevada,057,99092,155,107,3,110,1
2020-06-29,Orange,059,3164182,23127,13682,201,13883,324
2020-06-29,Placer,061,380077,969,628,3,631,11
2020-06-29,Plumas,063,18699,12,6,0,6,0
2020-06-29,Riverside,065,2383286,23856,17683,28,17711,432
2020-06-29,Sacramento,067,1510023,4307,2985,6,2991,62
2020-06-29,San Benito,069,59416,286,193,0,193,2
2020-06-29,San Bernardino,071,2135413,18912,11643,11,11654,245
2020-06-29,San Diego,073,3302833,17402,13834,2,13836,361
2020-06-29,San Francisco,075,870044,4041,3389,1,3390,50
2020-06-29,San Joaquin,077,732212,5273,3202,4,3206,52
2020-06-29,San Luis Obispo,079,281455,853,544,7,551,1
2020-06-29,San Mateo,081,765935,3682,3170,6,3176,84
2020-06-29,Santa Barbara,083,443738,3773,2933,30,2963,25
2020-06-29,Santa Clara,085,1922200,5890,4231,17,4248,157
2020-06-29,Santa Cruz,087,273765,468,348,0,348,2
2020-06-29,Shasta,089,179085,212,94,1,95,5
2020-06-29,Sierra,091,2930,1,1,0,1,0
2020-06-29,Siskiyou,093,43540,35,25,0,25,0
2020-06-29,Solano,095,438530,1829,1077,8,1085,21
2020-06-29,Sonoma,097,501317,1477,1103,5,1108,5
2020-06-29,Stanislaus,099,539301,4055,2400,5,2405,36
2020-06-29,Sutter,101,95872,224,152,0,152,2
2020-06-29,Tehama,103,63373,100,63,2,65,1
2020-06-29,Trinity,105,12862,18,2,4,6,0
2020-06-29,Tulare,107,460477,5530,3906,12,3918,117
2020-06-29,Tuolumne,109,53932,47,16,2,18,0
2020-06-29,Ventura,111,848112,4403,2794,17,2811,40
2020-06-29,Yolo,113,214977,712,483,3,486,24
2020-06-29,Yuba,115,75493,93,55,0,55,1
2020-06-28,Alameda,001,1643700,6881,5698,10,5708,135
2020-06-28,Alpine,003,1148,1,1,0,1,0
2020-06-28,Amador,005,37829,29,20,0,20,0
2020-06-28,Butte,007,227075,266,150,8,158,2
2020-06-28,Calaveras,009,45235,51,30,0,30,0
2020-06-28,Colusa,011,21464,74,17,0,17,0
2020-06-28,Contra Costa,013,1133247,3788,2803,4,2807,73
2020-06-28,Del Norte,015,27424,58,47,0,47,0
2020-06-28,El Dorado,017,186661,277,162,0,162,0
2020-06-28,Fresno,019,978130,9329,4365,75,4440,74
2020-06-28,Glenn,021,27897,148,77,0,77,0
2020-06-28,Humboldt,023,135768,156,127,0,127,3
2020-06-28,Imperial,025,180216,7877,5513,4,5517,45
2020-06-28,Inyo,027,18085,33,29,0,29,1
2020-06-28,Kern,029,883053,8394,4541,27,4568,72
2020-06-28,Kings,031,150075,2694,2234,7,2241,18
2020-06-28,Lake,033,64148,84,53,0,53,0
2020-06-28,Lassen,035,31185,240,77,2,79,0
2020-06-28,Los Angeles,037,10098052,115068,98003,31,98034,3316
2020-06-28,Madera,039,155013,907,424,3,427,4
2020-06-28,Marin,041,260295,2654,1473,4,1477,17
2020-06-28,Mariposa,043,17540,32,24,0,24,1
2020-06-28,Mendocino,045,87422,85,63,0,63,0
2020-06-28,Merced,047,269075,1630,814,2,816,10
2020-06-28,Modoc,049,8938,1,0,0,0,0
2020-06-28,Mono,051,14174,47,35,0,35,1
2020-06-28,Monterey,053,433212,2131,1560,6,1566,13
2020-06-28,Napa,055,140530,432,307,0,307,4
2020-06-28,Nevada,057,99092,144,102,3,105,1
2020-06-28,Orange,059,3164182,22153,13213,183,13396,324
2020-06-28,Placer,061,380077,930,618,3,621,11
2020-06-28,Plumas,063,18699,11,6,0,6,0
2020-06-28,Riverside,065,2383286,23028,16848,27,16875,432
2020-06-28,Sacramento,067,1510023,4079,2803,6,2809,63
2020-06-28,San Benito,069,59416,275,190,0,190,2
2020-06-28,San Bernardino,071,2135413,18159,11344,10,11354,245
2020-06-28,San Diego,073,3302833,16857,13333,2,13335,361
2020-06-28,San Francisco,075,870044,3962,3388,1,3389,50
2020-06-28,San Joaquin,077,732212,4936,3201,4,3205,52
2020-06-28,San Luis Obispo,079,281455,814,531,6,537,1
2020-06-28,San Mateo,081,765935,3604,3124,6,3130,84
2020-06-28,Santa Barbara,083,443738,3628,2872,30,2902,25
2020-06-28,Santa Clara,085,1922200,5728,4131,17,4148,156
2020-06-28,Santa Cruz,087,273765,445,349,0,349,2
2020-06-28,Shasta,089,179085,199,89,0,89,5
2020-06-28,Sierra,091,2930,1,1,0,1,0
2020-06-28,Siskiyou,093,43540,35,25,0,25,0
2020-06-28,Solano,095,438530,1754,1077,8,1085,21
2020-06-28,Sonoma,097,501317,1424,1084,5,1089,5
2020-06-28,Stanislaus,099,539301,3849,2376,5,2381,36
2020-06-28,Sutter,101,95872,198,145,0,145,2
2020-06-28,Tehama,103,63373,93,63,2,65,1
2020-06-28,Trinity,105,12862,17,2,4,6,0
2020-06-28,Tulare,107,460477,5362,3812,12,3824,117
2020-06-28,Tuolumne,109,53932,42,14,2,16,0
2020-06-28,Ventura,111,848112,4245,2650,17,2667,40
2020-06-28,Yolo,113,214977,677,468,3,471,24
2020-06-28,Yuba,115,75493,89,39,0,39,1
2020-06-27,Alameda,001,1643700,6785,5581,10,5591,135
2020-06-27,Alpine,003,1148,1,1,0,1,0
2020-06-27,Amador,005,37829,27,20,0,20,0
2020-06-27,Butte,007,227075,258,137,8,145,2
2020-06-27,Calaveras,009,45235,49,30,0,30,0
2020-06-27,Colusa,011,21464,68,17,0,17,0
2020-06-27,Contra Costa,013,1133247,3693,2717,3,2720,72
2020-06-27,Del Norte,015,27424,58,47,0,47,0
2020-06-27,El Dorado,017,186661,271,159,0,159,0
2020-06-27,Fresno,019,978130,9083,4238,75,4313,74
2020-06-27,Glenn,021,27897,144,77,0,77,0
2020-06-27,Humboldt,023,135768,154,127,0,127,3
2020-06-27,Imperial,025,180216,7816,5513,4,5517,45
2020-06-27,Inyo,027,18085,33,29,0,29,1
2020-06-27,Kern,029,883053,8130,4411,26,4437,70
2020-06-27,Kings,031,150075,2668,2187,7,2194,18
2020-06-27,Lake,033,64148,81,42,0,42,0
2020-06-27,Lassen,035,31185,240,33,2,35,0
2020-06-27,Los Angeles,037,10098052,113326,95341,28,95369,3291
2020-06-27,Madera,039,155013,864,427,2,429,4
2020-06-27,Marin,041,260295,2609,1423,4,1427,17
2020-06-27,Mariposa,043,17540,31,22,0,22,1
2020-06-27,Mendocino,045,87422,85,63,0,63,0
2020-06-27,Merced,047,269075,1572,807,1,808,10
2020-06-27,Modoc,049,8938,1,0,0,0,0
2020-06-27,Mono,051,14174,46,35,0,35,1
2020-06-27,Monterey,053,433212,2067,1455,6,1461,12
2020-06-27,Napa,055,140530,422,282,0,282,3
2020-06-27,Nevada,057,99092,140,102,2,104,1
2020-06-27,Orange,059,3164182,21642,12951,178,13129,320
2020-06-27,Placer,061,380077,909,584,3,587,10
2020-06-27,Plumas,063,18699,11,6,0,6,0
2020-06-27,Riverside,065,2383286,22639,16209,27,16236,432
2020-06-27,Sacramento,067,1510023,3962,2685,6,2691,63
2020-06-27,San Benito,069,59416,268,182,0,182,2
2020-06-27,San Bernardino,071,2135413,17780,11238,10,11248,243
2020-06-27,San Diego,073,3302833,16492,12836,2,12838,360
2020-06-27,San Francisco,075,870044,3907,3332,1,3333,49
2020-06-27,San Joaquin,077,732212,4770,2995,4,2999,52
2020-06-27,San Luis Obispo,079,281455,791,505,6,511,1
2020-06-27,San Mateo,081,765935,3547,3083,6,3089,83
2020-06-27,Santa Barbara,083,443738,3556,2799,30,2829,25
2020-06-27,Santa Clara,085,1922200,5622,4006,17,4023,157
2020-06-27,Santa Cruz,087,273765,438,347,0,347,2
2020-06-27,Shasta,089,179085,193,87,0,87,5
2020-06-27,Sierra,091,2930,1,1,0,1,0
2020-06-27,Siskiyou,093,43540,35,25,0,25,0
2020-06-27,Solano,095,438530,1721,1076,8,1084,21
2020-06-27,Sonoma,097,501317,1393,1004,5,1009,5
2020-06-27,Stanislaus,099,539301,3749,2164,5,2169,36
2020-06-27,Sutter,101,95872,191,141,0,141,2
2020-06-27,Tehama,103,63373,90,63,2,65,1
2020-06-27,Trinity,105,12862,17,2,4,6,0
2020-06-27,Tulare,107,460477,5266,3810,12,3822,117
2020-06-27,Tuolumne,109,53932,41,13,2,15,0
2020-06-27,Ventura,111,848112,4145,2471,17,2488,40
2020-06-27,Yolo,113,214977,653,432,3,435,24
2020-06-27,Yuba,115,75493,81,39,0,39,1
2020-06-26,Alameda,001,1643700,6699,5502,9,5511,132
2020-06-26,Alpine,003,1148,1,1,0,1,0
2020-06-26,Amador,005,37829,26,20,0,20,0
2020-06-26,Butte,007,227075,243,135,8,143,2
2020-06-26,Calaveras,009,45235,47,30,0,30,0
2020-06-26,Colusa,011,21464,63,17,0,17,0
2020-06-26,Contra Costa,013,1133247,3580,2676,3,2679,72
2020-06-26,Del Norte,015,27424,57,47,0,47,0
2020-06-26,El Dorado,017,186661,263,159,0,159,0
2020-06-26,Fresno,019,978130,8857,4166,75,4241,74
2020-06-26,Glenn,021,27897,137,71,0,71,0
2020-06-26,Humboldt,023,135768,152,126,0,126,3
2020-06-26,Imperial,025,180216,7753,5400,4,5404,44
2020-06-26,Inyo,027,18085,32,29,0,29,1
2020-06-26,Kern,029,883053,7800,4366,26,4392,70
2020-06-26,Kings,031,150075,2636,2176,6,2182,18
2020-06-26,Lake,033,64148,80,42,0,42,0
2020-06-26,Lassen,035,31185,239,30,2,32,0
2020-06-26,Los Angeles,037,10098052,111159,93328,28,93356,3275
2020-06-26,Madera,039,155013,832,409,2,411,4
2020-06-26,Marin,041,260295,2572,1406,4,1410,17
2020-06-26,Mariposa,043,17540,30,21,0,21,1
2020-06-26,Mendocino,045,87422,82,63,0,63,0
2020-06-26,Merced,047,269075,1526,797,1,798,10
2020-06-26,Modoc,049,8938,1,0,0,0,0
2020-06-26,Mono,051,14174,45,35,0,35,1
2020-06-26,Monterey,053,433212,2015,1449,6,1455,12
2020-06-26,Napa,055,140530,412,277,0,277,3
2020-06-26,Nevada,057,99092,136,101,1,102,1
2020-06-26,Orange,059,3164182,20966,12659,175,12834,320
2020-06-26,Placer,061,380077,880,584,3,587,10
2020-06-26,Plumas,063,18699,11,6,0,6,0
2020-06-26,Riverside,065,2383286,22176,15858,27,15885,430
2020-06-26,Sacramento,067,1510023,3797,2687,6,2693,63
2020-06-26,San Benito,069,59416,264,176,0,176,2
2020-06-26,San Bernardino,071,2135413,17403,11111,10,11121,243
2020-06-26,San Diego,073,3302833,16127,12402,2,12404,358
2020-06-26,San Francisco,075,870044,3852,3330,1,3331,49
2020-06-26,San Joaquin,077,732212,4556,2943,4,2947,52
2020-06-26,San Luis Obispo,079,281455,776,498,6,504,1
2020-06-26,San Mateo,081,765935,3495,3055,6,3061,83
2020-06-26,Santa Barbara,083,443738,3466,2784,28,2812,25
2020-06-26,Santa Clara,085,1922200,5521,3968,17,3985,156
2020-06-26,Santa Cruz,087,273765,431,344,0,344,2
2020-06-26,Shasta,089,179085,186,86,0,86,5
2020-06-26,Sierra,091,2930,1,1,0,1,0
2020-06-26,Siskiyou,093,43540,34,24,0,24,0
2020-06-26,Solano,095,438530,1679,1068,8,1076,21
2020-06-26,Sonoma,097,501317,1361,977,5,982,5
2020-06-26,Stanislaus,099,539301,3636,2157,5,2162,36
2020-06-26,Sutter,101,95872,184,138,0,138,2
2020-06-26,Tehama,103,63373,87,63,2,65,1
2020-06-26,Trinity,105,12862,17,2,4,6,0
2020-06-26,Tulare,107,460477,5177,3720,12,3732,117
2020-06-26,Tuolumne,109,53932,39,10,2,12,0
2020-06-26,Ventura,111,848112,4059,2444,17,2461,40
2020-06-26,Yolo,113,214977,630,418,3,421,24
2020-06-26,Yuba,115,75493,75,38,0,38,1
2020-06-25,Alameda,001,1643700,6510,5398,9,5407,130
2020-06-25,Alpine,003,1148,1,1,0,1,0
2020-06-25,Amador,005,37829,25,18,0,18,0
2020-06-25,Butte,007,227075,238,127,8,135,1
2020-06-25,Calaveras,009,45235,42,26,0,26,0
2020-06-25,Colusa,011,21464,53,14,0,14,0
2020-06-25,Contra Costa,013,1133247,3395,2591,3,2594,71
2020-06-25,Del Norte,015,27424,55,47,0,47,0
2020-06-25,El Dorado,017,186661,255,150,0,150,0
2020-06-25,Fresno,019,978130,8544,3938,74,4012,71
2020-06-25,Glenn,021,27897,132,59,0,59,0
2020-06-25,Humboldt,023,135768,151,121,0,121,3
2020-06-25,Imperial,025,180216,7624,5192,4,5196,44
2020-06-25,Inyo,027,18085,29,27,0,27,1
2020-06-25,Kern,029,883053,7375,4236,23,4259,69
2020-06-25,Kings,031,150075,2584,2110,6,2116,17
2020-06-25,Lake,033,64148,79,42,0,42,0
2020-06-25,Lassen,035,31185,233,13,2,15,0
2020-06-25,Los Angeles,037,10098052,108393,91524,28,91552,3239
2020-06-25,Madera,039,155013,788,380,2,382,4
2020-06-25,Marin,041,260295,2470,1321,4,1325,17
2020-06-25,Mariposa,043,17540,29,20,0,20,1
2020-06-25,Mendocino,045,87422,79,61,0,61,0
2020-06-25,Merced,047,269075,1439,747,1,748,10
2020-06-25,Modoc,049,8938,1,0,0,0,0
2020-06-25,Mono,051,14174,44,35,0,35,1
2020-06-25,Monterey,053,433212,1927,1426,5,1431,12
2020-06-25,Napa,055,140530,394,260,0,260,3
2020-06-25,Nevada,057,99092,128,92,1,93,1
2020-06-25,Orange,059,3164182,20044,12221,173,12394,311
2020-06-25,Placer,061,380077,826,574,3,577,10
2020-06-25,Plumas,063,18699,10,6,0,6,0
2020-06-25,Riverside,065,2383286,21421,15224,26,15250,427
2020-06-25,Sacramento,067,1510023,3574,2519,6,2525,62
2020-06-25,San Benito,069,59416,256,174,0,174,2
2020-06-25,San Bernardino,071,2135413,16652,10590,10,10600,242
2020-06-25,San Diego,073,3302833,15588,11963,2,11965,352
2020-06-25,San Francisco,075,870044,3786,3252,1,3253,48
2020-06-25,San Joaquin,077,732212,4283,2803,4,2807,50
2020-06-25,San Luis Obispo,079,281455,744,473,6,479,1
2020-06-25,San Mateo,081,765935,3427,2996,6,3002,82
2020-06-25,Santa Barbara,083,443738,3361,2622,27,2649,25
2020-06-25,Santa Clara,085,1922200,5372,3871,17,3888,156
2020-06-25,Santa Cruz,087,273765,419,335,0,335,2
2020-06-25,Shasta,089,179085,176,84,0,84,5
2020-06-25,Sierra,091,2930,1,1,0,1,0
2020-06-25,Siskiyou,093,43540,33,24,0,24,0
2020-06-25,Solano,095,438530,1626,1034,8,1042,21
2020-06-25,Sonoma,097,501317,1314,953,4,957,5
2020-06-25,Stanislaus,099,539301,3424,2130,5,2135,36
2020-06-25,Sutter,101,95872,172,126,0,126,2
2020-06-25,Tehama,103,63373,83,59,2,61,1
2020-06-25,Trinity,105,12862,17,2,4,6,0
2020-06-25,Tulare,107,460477,5046,3656,12,3668,117
2020-06-25,Tuolumne,109,53932,38,10,1,11,0
2020-06-25,Ventura,111,848112,3877,2346,16,2362,40
2020-06-25,Yolo,113,214977,601,397,3,400,24
2020-06-25,Yuba,115,75493,64,38,0,38,1
2020-06-24,Alameda,001,1643700,6348,5242,9,5251,123
2020-06-24,Alpine,003,1148,1,1,0,1,0
2020-06-24,Amador,005,37829,23,16,0,16,0
2020-06-24,Butte,007,227075,222,119,7,126,1
2020-06-24,Calaveras,009,45235,40,26,0,26,0
2020-06-24,Colusa,011,21464,44,11,0,11,0
2020-06-24,Contra Costa,013,1133247,3240,2520,3,2523,66
2020-06-24,Del Norte,015,27424,49,47,0,47,0
2020-06-24,El Dorado,017,186661,239,149,0,149,0
2020-06-24,Fresno,019,978130,8213,3765,74,3839,71
2020-06-24,Glenn,021,27897,124,54,0,54,0
2020-06-24,Humboldt,023,135768,151,117,0,117,3
2020-06-24,Imperial,025,180216,7506,5138,4,5142,38
2020-06-24,Inyo,027,18085,29,28,0,28,1
2020-06-24,Kern,029,883053,6982,4155,21,4176,67
2020-06-24,Kings,031,150075,2520,2063,6,2069,16
2020-06-24,Lake,033,64148,66,40,0,40,0
2020-06-24,Lassen,035,31185,232,9,2,11,0
2020-06-24,Los Angeles,037,10098052,105633,89566,28,89594,3186
2020-06-24,Madera,039,155013,766,373,2,375,4
2020-06-24,Marin,041,260295,2242,1261,4,1265,17
2020-06-24,Mariposa,043,17540,28,19,0,19,1
2020-06-24,Mendocino,045,87422,79,60,0,60,0
2020-06-24,Merced,047,269075,1353,696,1,697,8
2020-06-24,Modoc,049,8938,1,0,0,0,0
2020-06-24,Mono,051,14174,42,35,0,35,1
2020-06-24,Monterey,053,433212,1850,1407,5,1412,12
2020-06-24,Napa,055,140530,377,258,0,258,3
2020-06-24,Nevada,057,99092,122,92,1,93,1
2020-06-24,Orange,059,3164182,19047,11804,154,11958,303
2020-06-24,Placer,061,380077,787,548,3,551,10
2020-06-24,Plumas,063,18699,10,6,0,6,0
2020-06-24,Riverside,065,2383286,20574,14946,26,14972,410
2020-06-24,Sacramento,067,1510023,3370,2446,5,2451,62
2020-06-24,San Benito,069,59416,252,171,0,171,2
2020-06-24,San Bernardino,071,2135413,15838,10211,10,10221,239
2020-06-24,San Diego,073,3302833,15085,11628,2,11630,347
2020-06-24,San Francisco,075,870044,3723,3216,1,3217,48
2020-06-24,San Joaquin,077,732212,4062,2680,4,2684,49
2020-06-24,San Luis Obispo,079,281455,713,461,5,466,1
2020-06-24,San Mateo,081,765935,3370,2964,6,2970,82
2020-06-24,Santa Barbara,083,443738,3242,2569,25,2594,22
2020-06-24,Santa Clara,085,1922200,5241,3812,17,3829,155
2020-06-24,Santa Cruz,087,273765,407,329,0,329,2
2020-06-24,Shasta,089,179085,168,83,0,83,5
2020-06-24,Sierra,091,2930,1,1,0,1,0
2020-06-24,Siskiyou,093,43540,32,24,0,24,0
2020-06-24,Solano,095,438530,1536,979,7,986,21
2020-06-24,Sonoma,097,501317,1265,933,4,937,4
2020-06-24,Stanislaus,099,539301,3245,2039,5,2044,36
2020-06-24,Sutter,101,95872,159,118,0,118,2
2020-06-24,Tehama,103,63373,81,55,2,57,1
2020-06-24,Trinity,105,12862,16,2,3,5,0
2020-06-24,Tulare,107,460477,4891,3541,10,3551,116
2020-06-24,Tuolumne,109,53932,33,9,1,10,0
2020-06-24,Ventura,111,848112,3536,2314,16,2330,42
2020-06-24,Yolo,113,214977,566,376,3,379,24
2020-06-24,Yuba,115,75493,58,37,0,37,1
2020-06-23,Alameda,001,1643700,6167,5159,9,5168,121
2020-06-23,Alpine,003,1148,1,1,0,1,0
2020-06-23,Amador,005,37829,22,13,0,13,0
2020-06-23,Butte,007,227075,204,111,7,118,1
2020-06-23,Calaveras,009,45235,40,26,0,26,0
2020-06-23,Colusa,011,21464,40,7,0,7,0
2020-06-23,Contra Costa,013,1133247,3114,2453,3,2456,60
2020-06-23,Del Norte,015,27424,48,46,0,46,0
2020-06-23,El Dorado,017,186661,230,142,0,142,0
2020-06-23,Fresno,019,978130,7561,3569,72,3641,67
2020-06-23,Glenn,021,27897,120,47,0,47,0
2020-06-23,Humboldt,023,135768,151,110,0,110,3
2020-06-23,Imperial,025,180216,7343,5025,4,5029,38
2020-06-23,Inyo,027,18085,29,26,0,26,1
2020-06-23,Kern,029,883053,6614,4087,18,4105,64
2020-06-23,Kings,031,150075,2455,1727,6,1733,16
2020-06-23,Lake,033,64148,60,40,0,40,0
2020-06-23,Lassen,035,31185,228,9,2,11,0
2020-06-23,Los Angeles,037,10098052,102693,88433,27,88460,3152
2020-06-23,Madera,039,155013,727,369,2,371,4
2020-06-23,Marin,041,260295,1974,1139,4,1143,17
2020-06-23,Mariposa,043,17540,26,18,0,18,1
2020-06-23,Mendocino,045,87422,78,61,0,61,0
2020-06-23,Merced,047,269075,1255,656,1,657,8
2020-06-23,Modoc,049,8938,1,0,0,0,0
2020-06-23,Mono,051,14174,42,35,0,35,1
2020-06-23,Monterey,053,433212,1780,1346,5,1351,12
2020-06-23,Napa,055,140530,362,230,0,230,3
2020-06-23,Nevada,057,99092,116,81,1,82,1
2020-06-23,Orange,059,3164182,18078,11071,151,11222,278
2020-06-23,Placer,061,380077,761,525,3,528,10
2020-06-23,Plumas,063,18699,9,6,0,6,0
2020-06-23,Riverside,065,2383286,19554,14469,26,14495,406
2020-06-23,Sacramento,067,1510023,3191,2374,5,2379,62
2020-06-23,San Benito,069,59416,238,167,0,167,2
2020-06-23,San Bernardino,071,2135413,15058,9771,10,9781,229
2020-06-23,San Diego,073,3302833,14565,11296,2,11298,341
2020-06-23,San Francisco,075,870044,3649,3177,1,3178,48
2020-06-23,San Joaquin,077,732212,3803,2502,4,2506,48
2020-06-23,San Luis Obispo,079,281455,682,445,5,450,1
2020-06-23,San Mateo,081,765935,3305,2907,6,2913,81
2020-06-23,Santa Barbara,083,443738,3147,2498,25,2523,22
2020-06-23,Santa Clara,085,1922200,5095,3700,17,3717,155
2020-06-23,Santa Cruz,087,273765,397,313,0,313,2
2020-06-23,Shasta,089,179085,159,81,0,81,5
2020-06-23,Sierra,091,2930,1,1,0,1,0
2020-06-23,Siskiyou,093,43540,30,24,0,24,0
2020-06-23,Solano,095,438530,1479,941,6,947,21
2020-06-23,Sonoma,097,501317,1212,912,4,916,4
2020-06-23,Stanislaus,099,539301,3069,1850,5,1855,35
2020-06-23,Sutter,101,95872,149,112,0,112,2
2020-06-23,Tehama,103,63373,79,50,2,52,1
2020-06-23,Trinity,105,12862,16,2,3,5,0
2020-06-23,Tulare,107,460477,4769,3456,10,3466,111
2020-06-23,Tuolumne,109,53932,28,9,0,9,0
2020-06-23,Ventura,111,848112,3376,2209,15,2224,40
2020-06-23,Yolo,113,214977,540,350,0,350,24
2020-06-23,Yuba,115,75493,55,35,0,35,1
2020-06-22,Alameda,001,1643700,6016,4944,9,4953,121
2020-06-22,Alpine,003,1148,1,1,0,1,0
2020-06-22,Amador,005,37829,19,12,0,12,0
2020-06-22,Butte,007,227075,185,104,7,111,1
2020-06-22,Calaveras,009,45235,38,20,0,20,0
2020-06-22,Colusa,011,21464,37,7,0,7,0
2020-06-22,Contra Costa,013,1133247,2972,2363,3,2366,60
2020-06-22,Del Norte,015,27424,48,46,0,46,0
2020-06-22,El Dorado,017,186661,221,137,0,137,0
2020-06-22,Fresno,019,978130,7029,3425,72,3497,67
2020-06-22,Glenn,021,27897,111,40,0,40,0
2020-06-22,Humboldt,023,135768,148,110,0,110,3
2020-06-22,Imperial,025,180216,7186,4700,4,4704,38
2020-06-22,Inyo,027,18085,29,26,0,26,1
2020-06-22,Kern,029,883053,6262,3982,16,3998,60
2020-06-22,Kings,031,150075,2406,1513,6,1519,13
2020-06-22,Lake,033,64148,54,37,0,37,0
2020-06-22,Lassen,035,31185,118,7,2,9,0
2020-06-22,Los Angeles,037,10098052,99796,85925,25,85950,3117
2020-06-22,Madera,039,155013,702,333,2,335,4
2020-06-22,Marin,041,260295,1717,1029,4,1033,17
2020-06-22,Mariposa,043,17540,25,18,0,18,1
2020-06-22,Mendocino,045,87422,73,48,0,48,0
2020-06-22,Merced,047,269075,1166,619,1,620,8
2020-06-22,Modoc,049,8938,1,0,0,0,0
2020-06-22,Mono,051,14174,42,34,0,34,1
2020-06-22,Monterey,053,433212,1719,1293,5,1298,12
2020-06-22,Napa,055,140530,338,222,0,222,3
2020-06-22,Nevada,057,99092,111,79,1,80,1
2020-06-22,Orange,059,3164182,17146,10711,148,10859,275
2020-06-22,Placer,061,380077,735,512,3,515,9
2020-06-22,Plumas,063,18699,7,6,0,6,0
2020-06-22,Riverside,065,2383286,18582,13948,26,13974,403
2020-06-22,Sacramento,067,1510023,2974,2243,5,2248,62
2020-06-22,San Benito,069,59416,229,164,0,164,2
2020-06-22,San Bernardino,071,2135413,14284,9133,10,9143,229
2020-06-22,San Diego,073,3302833,14073,11098,2,11100,338
2020-06-22,San Francisco,075,870044,3556,3000,1,3001,47
2020-06-22,San Joaquin,077,732212,3555,2332,4,2336,48
2020-06-22,San Luis Obispo,079,281455,649,422,5,427,1
2020-06-22,San Mateo,081,765935,3232,2813,5,2818,81
2020-06-22,Santa Barbara,083,443738,3055,2447,25,2472,21
2020-06-22,Santa Clara,085,1922200,4932,3580,17,3597,155
2020-06-22,Santa Cruz,087,273765,384,290,0,290,3
2020-06-22,Shasta,089,179085,156,77,0,77,5
2020-06-22,Sierra,091,2930,1,1,0,1,0
2020-06-22,Siskiyou,093,43540,30,23,0,23,0
2020-06-22,Solano,095,438530,1401,784,5,789,21
2020-06-22,Sonoma,097,501317,1167,860,2,862,4
2020-06-22,Stanislaus,099,539301,2884,1784,5,1789,35
2020-06-22,Sutter,101,95872,140,100,0,100,2
2020-06-22,Tehama,103,63373,75,38,2,40,1
2020-06-22,Trinity,105,12862,16,2,3,5,0
2020-06-22,Tulare,107,460477,4632,3185,10,3195,111
2020-06-22,Tuolumne,109,53932,19,8,0,8,0
2020-06-22,Ventura,111,848112,3227,2065,15,2080,39
2020-06-22,Yolo,113,214977,514,333,0,333,24
2020-06-22,Yuba,115,75493,50,36,0,36,1
2020-06-21,Alameda,001,1643700,5821,4835,9,4844,121
2020-06-21,Alpine,003,1148,1,1,0,1,0
2020-06-21,Amador,005,37829,14,12,0,12,0
2020-06-21,Butte,007,227075,171,97,7,104,1
2020-06-21,Calaveras,009,45235,38,20,0,20,0
2020-06-21,Colusa,011,21464,29,7,0,7,0
2020-06-21,Contra Costa,013,1133247,2846,2282,3,2285,60
2020-06-21,Del Norte,015,27424,47,46,0,46,0
2020-06-21,El Dorado,017,186661,212,132,0,132,0
2020-06-21,Fresno,019,978130,6458,3296,70,3366,67
2020-06-21,Glenn,021,27897,102,40,0,40,0
2020-06-21,Humboldt,023,135768,143,108,0,108,3
2020-06-21,Imperial,025,180216,7003,4701,4,4705,38
2020-06-21,Inyo,027,18085,27,26,0,26,1
2020-06-21,Kern,029,883053,5970,3918,14,3932,60
2020-06-21,Kings,031,150075,2342,1334,6,1340,11
2020-06-21,Lake,033,64148,49,36,0,36,0
2020-06-21,Lassen,035,31185,25,7,2,9,0
2020-06-21,Los Angeles,037,10098052,96914,83383,24,83407,3101
2020-06-21,Madera,039,155013,668,319,2,321,4
2020-06-21,Marin,041,260295,1560,907,4,911,17
2020-06-21,Mariposa,043,17540,22,18,0,18,1
2020-06-21,Mendocino,045,87422,70,48,0,48,0
2020-06-21,Merced,047,269075,1071,577,1,578,8
2020-06-21,Modoc,049,8938,1,0,0,0,0
2020-06-21,Mono,051,14174,42,34,0,34,1
2020-06-21,Monterey,053,433212,1646,1227,5,1232,12
2020-06-21,Napa,055,140530,323,218,0,218,3
2020-06-21,Nevada,057,99092,108,79,1,80,1
2020-06-21,Orange,059,3164182,16314,10563,144,10707,275
2020-06-21,Placer,061,380077,695,498,3,501,9
2020-06-21,Plumas,063,18699,7,6,0,6,0
2020-06-21,Riverside,065,2383286,17876,13528,25,13553,402
2020-06-21,Sacramento,067,1510023,2773,2156,4,2160,62
2020-06-21,San Benito,069,59416,215,151,0,151,2
2020-06-21,San Bernardino,071,2135413,13510,8925,9,8934,229
2020-06-21,San Diego,073,3302833,13527,10796,2,10798,338
2020-06-21,San Francisco,075,870044,3450,3000,1,3001,47
2020-06-21,San Joaquin,077,732212,3319,2188,4,2192,48
2020-06-21,San Luis Obispo,079,281455,623,418,5,423,1
2020-06-21,San Mateo,081,765935,3174,2781,5,2786,81
2020-06-21,Santa Barbara,083,443738,2948,2430,24,2454,21
2020-06-21,Santa Clara,085,1922200,4794,3514,17,3531,154
2020-06-21,Santa Cruz,087,273765,374,290,0,290,3
2020-06-21,Shasta,089,179085,146,75,0,75,5
2020-06-21,Sierra,091,2930,1,1,0,1,0
2020-06-21,Siskiyou,093,43540,30,23,0,23,0
2020-06-21,Solano,095,438530,1301,783,4,787,21
2020-06-21,Sonoma,097,501317,1117,836,2,838,4
2020-06-21,Stanislaus,099,539301,2698,1688,5,1693,35
2020-06-21,Sutter,101,95872,132,96,0,96,2
2020-06-21,Tehama,103,63373,64,35,2,37,1
2020-06-21,Trinity,105,12862,15,2,3,5,0
2020-06-21,Tulare,107,460477,4463,3173,10,3183,111
2020-06-21,Tuolumne,109,53932,17,8,0,8,0
2020-06-21,Ventura,111,848112,3049,2021,15,2036,39
2020-06-21,Yolo,113,214977,482,323,0,323,24
2020-06-21,Yuba,115,75493,46,35,0,35,1
2020-06-20,Alameda,001,1643700,5759,4758,9,4767,119
2020-06-20,Alpine,003,1148,1,1,0,1,0
2020-06-20,Amador,005,37829,14,12,0,12,0
2020-06-20,Butte,007,227075,164,94,7,101,1
2020-06-20,Calaveras,009,45235,38,20,0,20,0
2020-06-20,Colusa,011,21464,26,7,0,7,0
2020-06-20,Contra Costa,013,1133247,2787,2231,3,2234,54
2020-06-20,Del Norte,015,27424,47,46,0,46,0
2020-06-20,El Dorado,017,186661,207,130,0,130,0
2020-06-20,Fresno,019,978130,6332,3222,67,3289,67
2020-06-20,Glenn,021,27897,97,40,0,40,0
2020-06-20,Humboldt,023,135768,143,108,0,108,3
2020-06-20,Imperial,025,180216,6922,4616,4,4620,37
2020-06-20,Inyo,027,18085,27,26,0,26,1
2020-06-20,Kern,029,883053,5805,3836,14,3850,59
2020-06-20,Kings,031,150075,2318,1331,6,1337,9
2020-06-20,Lake,033,64148,49,37,0,37,0
2020-06-20,Lassen,035,31185,24,7,2,9,0
2020-06-20,Los Angeles,037,10098052,95343,81604,23,81627,3093
2020-06-20,Madera,039,155013,635,321,2,323,4
2020-06-20,Marin,041,260295,1540,879,4,883,17
2020-06-20,Mariposa,043,17540,22,18,0,18,1
2020-06-20,Mendocino,045,87422,69,48,0,48,0
2020-06-20,Merced,047,269075,1031,566,1,567,8
2020-06-20,Modoc,049,8938,1,0,0,0,0
2020-06-20,Mono,051,14174,42,34,0,34,1
2020-06-20,Monterey,053,433212,1610,1181,5,1186,12
2020-06-20,Napa,055,140530,314,212,0,212,3
2020-06-20,Nevada,057,99092,105,73,1,74,1
2020-06-20,Orange,059,3164182,15964,10284,140,10424,273
2020-06-20,Placer,061,380077,670,483,3,486,9
2020-06-20,Plumas,063,18699,6,6,0,6,0
2020-06-20,Riverside,065,2383286,17577,13021,25,13046,402
2020-06-20,Sacramento,067,1510023,2702,2069,4,2073,63
2020-06-20,San Benito,069,59416,211,139,0,139,2
2020-06-20,San Bernardino,071,2135413,13148,8718,9,8727,229
2020-06-20,San Diego,073,3302833,13204,10486,2,10488,338
2020-06-20,San Francisco,075,870044,3406,2999,1,3000,47
2020-06-20,San Joaquin,077,732212,3237,2046,4,2050,48
2020-06-20,San Luis Obispo,079,281455,610,405,5,410,1
2020-06-20,San Mateo,081,765935,3126,2755,5,2760,81
2020-06-20,Santa Barbara,083,443738,2891,2358,23,2381,21
2020-06-20,Santa Clara,085,1922200,4720,3435,17,3452,154
2020-06-20,Santa Cruz,087,273765,372,287,0,287,3
2020-06-20,Shasta,089,179085,140,66,0,66,5
2020-06-20,Sierra,091,2930,1,1,0,1,0
2020-06-20,Siskiyou,093,43540,29,22,0,22,0
2020-06-20,Solano,095,438530,1277,784,4,788,21
2020-06-20,Sonoma,097,501317,1081,806,2,808,4
2020-06-20,Stanislaus,099,539301,2590,1598,5,1603,35
2020-06-20,Sutter,101,95872,130,89,0,89,2
2020-06-20,Tehama,103,63373,62,35,2,37,1
2020-06-20,Trinity,105,12862,15,2,3,5,0
2020-06-20,Tulare,107,460477,4390,3172,10,3182,111
2020-06-20,Tuolumne,109,53932,14,8,0,8,0
2020-06-20,Ventura,111,848112,2984,1946,15,1961,37
2020-06-20,Yolo,113,214977,466,309,0,309,24
2020-06-20,Yuba,115,75493,44,34,0,34,1
2020-06-19,Alameda,001,1643700,5688,4646,9,4655,119
2020-06-19,Alpine,003,1148,1,1,0,1,0
2020-06-19,Amador,005,37829,14,12,0,12,0
2020-06-19,Butte,007,227075,159,91,7,98,1
2020-06-19,Calaveras,009,45235,37,20,0,20,0
2020-06-19,Colusa,011,21464,24,7,0,7,0
2020-06-19,Contra Costa,013,1133247,2707,2106,3,2109,54
2020-06-19,Del Norte,015,27424,47,46,0,46,0
2020-06-19,El Dorado,017,186661,198,124,0,124,0
2020-06-19,Fresno,019,978130,6170,3109,65,3174,61
2020-06-19,Glenn,021,27897,91,40,0,40,0
2020-06-19,Humboldt,023,135768,141,106,0,106,3
2020-06-19,Imperial,025,180216,6831,4504,4,4508,36
2020-06-19,Inyo,027,18085,27,26,0,26,1
2020-06-19,Kern,029,883053,5582,3742,13,3755,57
2020-06-19,Kings,031,150075,2297,1285,6,1291,9
2020-06-19,Lake,033,64148,46,36,0,36,0
2020-06-19,Lassen,035,31185,23,7,2,9,0
2020-06-19,Los Angeles,037,10098052,93364,79572,22,79594,3047
2020-06-19,Madera,039,155013,616,300,2,302,4
2020-06-19,Marin,041,260295,1511,829,4,833,17
2020-06-19,Mariposa,043,17540,21,18,0,18,1
2020-06-19,Mendocino,045,87422,68,48,0,48,0
2020-06-19,Merced,047,269075,986,529,1,530,8
2020-06-19,Modoc,049,8938,1,0,0,0,0
2020-06-19,Mono,051,14174,42,34,0,34,1
2020-06-19,Monterey,053,433212,1581,1159,5,1164,12
2020-06-19,Napa,055,140530,304,209,0,209,3
2020-06-19,Nevada,057,99092,102,71,1,72,1
2020-06-19,Orange,059,3164182,15431,9972,133,10105,260
2020-06-19,Placer,061,380077,652,464,3,467,9
2020-06-19,Plumas,063,18699,6,5,0,5,0
2020-06-19,Riverside,065,2383286,17172,12710,25,12735,398
2020-06-19,Sacramento,067,1510023,2619,1976,4,1980,64
2020-06-19,San Benito,069,59416,210,136,0,136,2
2020-06-19,San Bernardino,071,2135413,12743,8454,8,8462,226
2020-06-19,San Diego,073,3302833,12841,10352,2,10354,332
2020-06-19,San Francisco,075,870044,3351,2968,1,2969,47
2020-06-19,San Joaquin,077,732212,3114,1969,4,1973,48
2020-06-19,San Luis Obispo,079,281455,594,392,5,397,1
2020-06-19,San Mateo,081,765935,3087,2713,5,2718,81
2020-06-19,Santa Barbara,083,443738,2818,2284,21,2305,21
2020-06-19,Santa Clara,085,1922200,4646,3376,17,3393,154
2020-06-19,Santa Cruz,087,273765,362,283,0,283,3
2020-06-19,Shasta,089,179085,137,58,0,58,5
2020-06-19,Sierra,091,2930,1,1,0,1,0
2020-06-19,Siskiyou,093,43540,29,21,0,21,0
2020-06-19,Solano,095,438530,1239,755,4,759,21
2020-06-19,Sonoma,097,501317,1054,803,2,805,4
2020-06-19,Stanislaus,099,539301,2480,1549,5,1554,35
2020-06-19,Sutter,101,95872,129,89,0,89,2
2020-06-19,Tehama,103,63373,61,35,2,37,1
2020-06-19,Trinity,105,12862,15,2,3,5,0
2020-06-19,Tulare,107,460477,4319,3053,10,3063,107
2020-06-19,Tuolumne,109,53932,13,8,0,8,0
2020-06-19,Ventura,111,848112,2900,1865,15,1880,37
2020-06-19,Yolo,113,214977,447,303,0,303,24
2020-06-19,Yuba,115,75493,43,33,0,33,1
2020-06-18,Alameda,001,1643700,5558,4589,9,4598,118
2020-06-18,Alpine,003,1148,1,1,0,1,0
2020-06-18,Amador,005,37829,13,12,0,12,0
2020-06-18,Butte,007,227075,154,88,7,95,1
2020-06-18,Calaveras,009,45235,37,20,0,20,0
2020-06-18,Colusa,011,21464,20,7,0,7,0
2020-06-18,Contra Costa,013,1133247,2601,2072,3,2075,53
2020-06-18,Del Norte,015,27424,47,46,0,46,0
2020-06-18,El Dorado,017,186661,194,121,0,121,0
2020-06-18,Fresno,019,978130,5903,2947,64,3011,57
2020-06-18,Glenn,021,27897,82,35,0,35,0
2020-06-18,Humboldt,023,135768,140,106,0,106,3
2020-06-18,Imperial,025,180216,6681,4366,4,4370,36
2020-06-18,Inyo,027,18085,26,25,0,25,1
2020-06-18,Kern,029,883053,5364,3634,13,3647,57
2020-06-18,Kings,031,150075,2238,1141,6,1147,8
2020-06-18,Lake,033,64148,45,36,0,36,0
2020-06-18,Lassen,035,31185,22,5,2,7,0
2020-06-18,Los Angeles,037,10098052,91096,78244,22,78266,3009
2020-06-18,Madera,039,155013,581,288,2,290,4
2020-06-18,Marin,041,260295,1448,819,4,823,17
2020-06-18,Mariposa,043,17540,19,18,0,18,1
2020-06-18,Mendocino,045,87422,64,45,0,45,0
2020-06-18,Merced,047,269075,934,486,1,487,7
2020-06-18,Modoc,049,8938,1,0,0,0,0
2020-06-18,Mono,051,14174,42,34,0,34,1
2020-06-18,Monterey,053,433212,1513,1127,5,1132,12
2020-06-18,Napa,055,140530,289,205,0,205,3
2020-06-18,Nevada,057,99092,98,68,1,69,1
2020-06-18,Orange,059,3164182,14776,9597,114,9711,255
2020-06-18,Placer,061,380077,629,457,3,460,9
2020-06-18,Plumas,063,18699,6,5,0,5,0
2020-06-18,Riverside,065,2383286,16556,12410,25,12435,392
2020-06-18,Sacramento,067,1510023,2503,1938,4,1942,63
2020-06-18,San Benito,069,59416,204,134,0,134,2
2020-06-18,San Bernardino,071,2135413,12103,8141,8,8149,226
2020-06-18,San Diego,073,3302833,12419,10094,2,10096,331
2020-06-18,San Francisco,075,870044,3302,2951,1,2952,47
2020-06-18,San Joaquin,077,732212,2962,1908,4,1912,47
2020-06-18,San Luis Obispo,079,281455,574,378,5,383,1
2020-06-18,San Mateo,081,765935,3048,2674,5,2679,78
2020-06-18,Santa Barbara,083,443738,2744,2201,21,2222,19
2020-06-18,Santa Clara,085,1922200,4543,3338,17,3355,152
2020-06-18,Santa Cruz,087,273765,345,275,0,275,3
2020-06-18,Shasta,089,179085,126,51,0,51,4
2020-06-18,Sierra,091,2930,1,1,0,1,0
2020-06-18,Siskiyou,093,43540,29,18,0,18,0
2020-06-18,Solano,095,438530,1201,735,4,739,21
2020-06-18,Sonoma,097,501317,1012,789,2,791,4
2020-06-18,Stanislaus,099,539301,2346,1495,5,1500,35
2020-06-18,Sutter,101,95872,125,85,0,85,2
2020-06-18,Tehama,103,63373,56,31,2,33,1
2020-06-18,Trinity,105,12862,15,2,3,5,0
2020-06-18,Tulare,107,460477,4197,3005,10,3015,107
2020-06-18,Tuolumne,109,53932,12,8,0,8,0
2020-06-18,Ventura,111,848112,2774,1781,15,1796,37
2020-06-18,Yolo,113,214977,414,294,0,294,24
2020-06-18,Yuba,115,75493,42,32,0,32,1
2020-06-17,Alameda,001,1643700,5435,4485,9,4494,117
2020-06-17,Alpine,003,1148,1,1,0,1,0
2020-06-17,Amador,005,37829,12,10,0,10,0
2020-06-17,Butte,007,227075,145,81,7,88,1
2020-06-17,Calaveras,009,45235,37,20,0,20,0
2020-06-17,Colusa,011,21464,19,7,0,7,0
2020-06-17,Contra Costa,013,1133247,2504,2020,3,2023,45
2020-06-17,Del Norte,015,27424,47,45,0,45,0
2020-06-17,El Dorado,017,186661,187,116,0,116,0
2020-06-17,Fresno,019,978130,5677,2801,61,2862,56
2020-06-17,Glenn,021,27897,75,31,0,31,0
2020-06-17,Humboldt,023,135768,138,105,0,105,3
2020-06-17,Imperial,025,180216,6508,4108,4,4112,36
2020-06-17,Inyo,027,18085,25,25,0,25,1
2020-06-17,Kern,029,883053,5163,3547,13,3560,56
2020-06-17,Kings,031,150075,2208,1097,6,1103,7
2020-06-17,Lake,033,64148,44,32,0,32,0
2020-06-17,Lassen,035,31185,18,5,2,7,0
2020-06-17,Los Angeles,037,10098052,88789,77166,22,77188,2973
2020-06-17,Madera,039,155013,559,258,2,260,4
2020-06-17,Marin,041,260295,1256,771,3,774,17
2020-06-17,Mariposa,043,17540,18,18,0,18,1
2020-06-17,Mendocino,045,87422,62,42,0,42,0
2020-06-17,Merced,047,269075,862,460,1,461,7
2020-06-17,Modoc,049,8938,1,0,0,0,0
2020-06-17,Mono,051,14174,42,34,0,34,1
2020-06-17,Monterey,053,433212,1461,1077,5,1082,12
2020-06-17,Napa,055,140530,274,202,0,202,3
2020-06-17,Nevada,057,99092,94,57,1,58,1
2020-06-17,Orange,059,3164182,14170,9278,108,9386,230
2020-06-17,Placer,061,380077,609,427,3,430,9
2020-06-17,Plumas,063,18699,6,5,0,5,0
2020-06-17,Riverside,065,2383286,15920,11859,25,11884,370
2020-06-17,Sacramento,067,1510023,2396,1889,4,1893,63
2020-06-17,San Benito,069,59416,199,116,0,116,2
2020-06-17,San Bernardino,071,2135413,11553,7670,8,7678,225
2020-06-17,San Diego,073,3302833,12040,9856,2,9858,327
2020-06-17,San Francisco,075,870044,3263,2906,1,2907,46
2020-06-17,San Joaquin,077,732212,2789,1825,4,1829,46
2020-06-17,San Luis Obispo,079,281455,555,362,5,367,1
2020-06-17,San Mateo,081,765935,3001,2649,5,2654,78
2020-06-17,Santa Barbara,083,443738,2671,2147,19,2166,19
2020-06-17,Santa Clara,085,1922200,4450,3264,16,3280,148
2020-06-17,Santa Cruz,087,273765,339,265,0,265,2
2020-06-17,Shasta,089,179085,124,51,0,51,4
2020-06-17,Sierra,091,2930,1,1,0,1,0
2020-06-17,Siskiyou,093,43540,28,16,0,16,0
2020-06-17,Solano,095,438530,1151,722,4,726,21
2020-06-17,Sonoma,097,501317,986,748,2,750,4
2020-06-17,Stanislaus,099,539301,2223,1387,5,1392,35
2020-06-17,Sutter,101,95872,119,79,0,79,2
2020-06-17,Tehama,103,63373,41,24,2,26,1
2020-06-17,Trinity,105,12862,14,2,3,5,0
2020-06-17,Tulare,107,460477,4087,2882,10,2892,106
2020-06-17,Tuolumne,109,53932,12,7,0,7,0
2020-06-17,Ventura,111,848112,2674,1729,15,1744,37
2020-06-17,Yolo,113,214977,394,277,0,277,24
2020-06-17,Yuba,115,75493,41,30,0,30,1
2020-06-16,Alameda,001,1643700,5317,4428,9,4437,113
2020-06-16,Alpine,003,1148,1,1,0,1,0
2020-06-16,Amador,005,37829,12,10,0,10,0
2020-06-16,Butte,007,227075,141,79,7,86,1
2020-06-16,Calaveras,009,45235,34,19,0,19,0
2020-06-16,Colusa,011,21464,16,7,0,7,0
2020-06-16,Contra Costa,013,1133247,2413,1971,2,1973,45
2020-06-16,Del Norte,015,27424,47,45,0,45,0
2020-06-16,El Dorado,017,186661,181,115,0,115,0
2020-06-16,Fresno,019,978130,5439,2731,59,2790,50
2020-06-16,Glenn,021,27897,71,30,0,30,0
2020-06-16,Humboldt,023,135768,135,105,0,105,3
2020-06-16,Imperial,025,180216,6349,3939,4,3943,36
2020-06-16,Inyo,027,18085,25,24,0,24,1
2020-06-16,Kern,029,883053,4940,3496,13,3509,55
2020-06-16,Kings,031,150075,2162,1044,6,1050,6
2020-06-16,Lake,033,64148,44,31,0,31,0
2020-06-16,Lassen,035,31185,15,5,2,7,0
2020-06-16,Los Angeles,037,10098052,86467,75051,22,75073,2942
2020-06-16,Madera,039,155013,533,239,2,241,3
2020-06-16,Marin,041,260295,1203,725,3,728,17
2020-06-16,Mariposa,043,17540,18,17,0,17,1
2020-06-16,Mendocino,045,87422,61,35,0,35,0
2020-06-16,Merced,047,269075,814,436,1,437,7
2020-06-16,Modoc,049,8938,1,0,0,0,0
2020-06-16,Mono,051,14174,42,34,0,34,1
2020-06-16,Monterey,053,433212,1413,1019,5,1024,12
2020-06-16,Napa,055,140530,259,196,0,196,3
2020-06-16,Nevada,057,99092,91,53,1,54,1
2020-06-16,Orange,059,3164182,13586,9163,104,9267,223
2020-06-16,Placer,061,380077,577,392,3,395,9
2020-06-16,Plumas,063,18699,6,5,0,5,0
2020-06-16,Riverside,065,2383286,15245,11638,25,11663,364
2020-06-16,Sacramento,067,1510023,2286,1825,4,1829,60
2020-06-16,San Benito,069,59416,191,110,0,110,2
2020-06-16,San Bernardino,071,2135413,11009,7463,8,7471,225
2020-06-16,San Diego,073,3302833,11678,9732,1,9733,323
2020-06-16,San Francisco,075,870044,3212,2893,1,2894,46
2020-06-16,San Joaquin,077,732212,2636,1718,4,1722,47
2020-06-16,San Luis Obispo,079,281455,531,343,5,348,1
2020-06-16,San Mateo,081,765935,2947,2618,5,2623,77
2020-06-16,Santa Barbara,083,443738,2604,2090,19,2109,16
2020-06-16,Santa Clara,085,1922200,4339,3228,15,3243,148
2020-06-16,Santa Cruz,087,273765,323,257,0,257,2
2020-06-16,Shasta,089,179085,115,51,0,51,4
2020-06-16,Sierra,091,2930,1,1,0,1,0
2020-06-16,Siskiyou,093,43540,27,15,0,15,0
2020-06-16,Solano,095,438530,1061,694,4,698,19
2020-06-16,Sonoma,097,501317,954,739,2,741,4
2020-06-16,Stanislaus,099,539301,2070,1278,5,1283,36
2020-06-16,Sutter,101,95872,112,73,0,73,2
2020-06-16,Tehama,103,63373,37,24,2,26,1
2020-06-16,Trinity,105,12862,14,2,3,5,0
2020-06-16,Tulare,107,460477,3968,2802,10,2812,96
2020-06-16,Tuolumne,109,53932,12,7,0,7,0
2020-06-16,Ventura,111,848112,2573,1676,15,1691,37
2020-06-16,Yolo,113,214977,371,262,0,262,24
2020-06-16,Yuba,115,75493,39,29,0,29,1
2020-06-15,Alameda,001,1643700,5191,4323,9,4332,112
2020-06-15,Alpine,003,1148,1,1,0,1,0
2020-06-15,Amador,005,37829,12,10,0,10,0
2020-06-15,Butte,007,227075,133,78,7,85,1
2020-06-15,Calaveras,009,45235,34,18,0,18,0
2020-06-15,Colusa,011,21464,14,7,0,7,0
2020-06-15,Contra Costa,013,1133247,2336,1918,2,1920,43
2020-06-15,Del Norte,015,27424,47,45,0,45,0
2020-06-15,El Dorado,017,186661,171,114,0,114,0
2020-06-15,Fresno,019,978130,5227,2616,58,2674,48
2020-06-15,Glenn,021,27897,66,21,0,21,0
2020-06-15,Humboldt,023,135768,133,105,0,105,3
2020-06-15,Imperial,025,180216,6174,3726,4,3730,36
2020-06-15,Inyo,027,18085,25,23,0,23,1
2020-06-15,Kern,029,883053,4716,3417,13,3430,55
2020-06-15,Kings,031,150075,2085,1022,6,1028,6
2020-06-15,Lake,033,64148,44,31,0,31,0
2020-06-15,Lassen,035,31185,15,5,2,7,0
2020-06-15,Los Angeles,037,10098052,84278,73705,22,73727,2908
2020-06-15,Madera,039,155013,511,203,2,205,3
2020-06-15,Marin,041,260295,1036,708,3,711,17
2020-06-15,Mariposa,043,17540,18,17,0,17,1
2020-06-15,Mendocino,045,87422,52,33,0,33,0
2020-06-15,Merced,047,269075,768,414,1,415,7
2020-06-15,Modoc,049,8938,1,0,0,0,0
2020-06-15,Mono,051,14174,42,34,0,34,1
2020-06-15,Monterey,053,433212,1347,998,5,1003,12
2020-06-15,Napa,055,140530,251,187,0,187,3
2020-06-15,Nevada,057,99092,85,52,1,53,1
2020-06-15,Orange,059,3164182,13018,8944,96,9040,212
2020-06-15,Placer,061,380077,555,386,3,389,9
2020-06-15,Plumas,063,18699,6,4,0,4,0
2020-06-15,Riverside,065,2383286,14627,11376,24,11400,364
2020-06-15,Sacramento,067,1510023,2170,1791,4,1795,60
2020-06-15,San Benito,069,59416,185,108,0,108,2
2020-06-15,San Bernardino,071,2135413,10506,7189,8,7197,224
2020-06-15,San Diego,073,3302833,11338,9612,1,9613,320
2020-06-15,San Francisco,075,870044,3168,2833,1,2834,45
2020-06-15,San Joaquin,077,732212,2500,1667,4,1671,43
2020-06-15,San Luis Obispo,079,281455,516,332,5,337,1
2020-06-15,San Mateo,081,765935,2900,2591,5,2596,75
2020-06-15,Santa Barbara,083,443738,2536,2054,19,2073,16
2020-06-15,Santa Clara,085,1922200,4239,3204,15,3219,148
2020-06-15,Santa Cruz,087,273765,312,254,0,254,2
2020-06-15,Shasta,089,179085,109,50,0,50,4
2020-06-15,Sierra,091,2930,1,1,0,1,0
2020-06-15,Siskiyou,093,43540,26,14,0,14,0
2020-06-15,Solano,095,438530,1001,638,4,642,19
2020-06-15,Sonoma,097,501317,925,726,2,728,4
2020-06-15,Stanislaus,099,539301,1953,1253,5,1258,35
2020-06-15,Sutter,101,95872,102,71,0,71,2
2020-06-15,Tehama,103,63373,37,17,2,19,1
2020-06-15,Trinity,105,12862,13,2,3,5,0
2020-06-15,Tulare,107,460477,3854,2662,10,2672,96
2020-06-15,Tuolumne,109,53932,11,7,0,7,0
2020-06-15,Ventura,111,848112,2492,1656,15,1671,37
2020-06-15,Yolo,113,214977,351,255,0,255,24
2020-06-15,Yuba,115,75493,39,28,0,28,1
2020-06-14,Alameda,001,1643700,5046,4271,9,4280,112
2020-06-14,Alpine,003,1148,1,1,0,1,0
2020-06-14,Amador,005,37829,12,10,0,10,0
2020-06-14,Butte,007,227075,125,78,7,85,1
2020-06-14,Calaveras,009,45235,33,18,0,18,0
2020-06-14,Colusa,011,21464,13,7,0,7,0
2020-06-14,Contra Costa,013,1133247,2267,1893,2,1895,43
2020-06-14,Del Norte,015,27424,47,45,0,45,0
2020-06-14,El Dorado,017,186661,167,110,0,110,0
2020-06-14,Fresno,019,978130,5042,2585,57,2642,48
2020-06-14,Glenn,021,27897,51,21,0,21,0
2020-06-14,Humboldt,023,135768,129,105,0,105,3
2020-06-14,Imperial,025,180216,5943,3730,4,3734,36
2020-06-14,Inyo,027,18085,24,23,0,23,1
2020-06-14,Kern,029,883053,4505,3328,13,3341,55
2020-06-14,Kings,031,150075,2034,1022,5,1027,6
2020-06-14,Lake,033,64148,41,31,0,31,0
2020-06-14,Lassen,035,31185,15,5,2,7,0
2020-06-14,Los Angeles,037,10098052,81951,72932,21,72953,2887
2020-06-14,Madera,039,155013,492,203,2,205,3
2020-06-14,Marin,041,260295,871,689,2,691,17
2020-06-14,Mariposa,043,17540,18,16,0,16,1
2020-06-14,Mendocino,045,87422,49,33,0,33,0
2020-06-14,Merced,047,269075,717,403,1,404,7
2020-06-14,Modoc,049,8938,1,0,0,0,0
2020-06-14,Mono,051,14174,42,34,0,34,1
2020-06-14,Monterey,053,433212,1286,949,5,954,12
2020-06-14,Napa,055,140530,229,181,0,181,3
2020-06-14,Nevada,057,99092,81,52,1,53,1
2020-06-14,Orange,059,3164182,12591,8744,91,8835,211
2020-06-14,Placer,061,380077,529,369,3,372,9
2020-06-14,Plumas,063,18699,5,4,0,4,0
2020-06-14,Riverside,065,2383286,14185,11218,24,11242,364
2020-06-14,Sacramento,067,1510023,2083,1750,4,1754,60
2020-06-14,San Benito,069,59416,174,104,0,104,2
2020-06-14,San Bernardino,071,2135413,9966,7015,8,7023,224
2020-06-14,San Diego,073,3302833,10963,9442,1,9443,319
2020-06-14,San Francisco,075,870044,3128,2834,1,2835,45
2020-06-14,San Joaquin,077,732212,2349,1603,4,1607,43
2020-06-14,San Luis Obispo,079,281455,501,330,5,335,1
2020-06-14,San Mateo,081,765935,2842,2571,5,2576,75
2020-06-14,Santa Barbara,083,443738,2459,2049,19,2068,17
2020-06-14,Santa Clara,085,1922200,4144,3178,15,3193,148
2020-06-14,Santa Cruz,087,273765,298,254,0,254,2
2020-06-14,Shasta,089,179085,103,48,0,48,4
2020-06-14,Sierra,091,2930,1,1,0,1,0
2020-06-14,Siskiyou,093,43540,25,13,0,13,0
2020-06-14,Solano,095,438530,952,638,4,642,19
2020-06-14,Sonoma,097,501317,897,724,2,726,4
2020-06-14,Stanislaus,099,539301,1805,1159,5,1164,35
2020-06-14,Sutter,101,95872,97,63,0,63,2
2020-06-14,Tehama,103,63373,34,17,2,19,1
2020-06-14,Trinity,105,12862,13,2,3,5,0
2020-06-14,Tulare,107,460477,3720,2646,10,2656,96
2020-06-14,Tuolumne,109,53932,11,7,0,7,0
2020-06-14,Ventura,111,848112,2393,1610,14,1624,37
2020-06-14,Yolo,113,214977,335,254,0,254,24
2020-06-14,Yuba,115,75493,38,28,0,28,1
2020-06-13,Alameda,001,1643700,4983,4196,9,4205,112
2020-06-13,Alpine,003,1148,1,1,0,1,0
2020-06-13,Amador,005,37829,11,10,0,10,0
2020-06-13,Butte,007,227075,116,72,7,79,1
2020-06-13,Calaveras,009,45235,31,18,0,18,0
2020-06-13,Colusa,011,21464,12,7,0,7,0
2020-06-13,Contra Costa,013,1133247,2231,1868,2,1870,43
2020-06-13,Del Norte,015,27424,47,45,0,45,0
2020-06-13,El Dorado,017,186661,163,110,0,110,0
2020-06-13,Fresno,019,978130,4944,2499,57,2556,48
2020-06-13,Glenn,021,27897,49,21,0,21,0
2020-06-13,Humboldt,023,135768,128,104,0,104,3
2020-06-13,Imperial,025,180216,5870,3646,4,3650,36
2020-06-13,Inyo,027,18085,24,23,0,23,1
2020-06-13,Kern,029,883053,4396,3239,13,3252,55
2020-06-13,Kings,031,150075,2014,1023,5,1028,6
2020-06-13,Lake,033,64148,40,29,0,29,0
2020-06-13,Lassen,035,31185,15,5,2,7,0
2020-06-13,Los Angeles,037,10098052,80913,71938,21,71959,2874
2020-06-13,Madera,039,155013,488,203,2,205,3
2020-06-13,Marin,041,260295,840,677,2,679,17
2020-06-13,Mariposa,043,17540,18,16,0,16,1
2020-06-13,Mendocino,045,87422,49,33,0,33,0
2020-06-13,Merced,047,269075,699,376,1,377,7
2020-06-13,Modoc,049,8938,1,0,0,0,0
2020-06-13,Mono,051,14174,42,35,0,35,1
2020-06-13,Monterey,053,433212,1248,900,5,905,11
2020-06-13,Napa,055,140530,226,171,0,171,3
2020-06-13,Nevada,057,99092,79,52,1,53,1
2020-06-13,Orange,059,3164182,12347,8581,88,8669,211
2020-06-13,Placer,061,380077,512,346,3,349,9
2020-06-13,Plumas,063,18699,5,4,0,4,0
2020-06-13,Riverside,065,2383286,13906,10931,24,10955,364
2020-06-13,Sacramento,067,1510023,2028,1713,4,1717,60
2020-06-13,San Benito,069,59416,167,99,0,99,2
2020-06-13,San Bernardino,071,2135413,9742,6885,8,6893,224
2020-06-13,San Diego,073,3302833,10791,9316,1,9317,319
2020-06-13,San Francisco,075,870044,3108,2834,1,2835,44
2020-06-13,San Joaquin,077,732212,2268,1461,4,1465,43
2020-06-13,San Luis Obispo,079,281455,490,326,5,331,1
2020-06-13,San Mateo,081,765935,2819,2551,5,2556,75
2020-06-13,Santa Barbara,083,443738,2401,1999,19,2018,15
2020-06-13,Santa Clara,085,1922200,4101,3141,15,3156,148
2020-06-13,Santa Cruz,087,273765,292,254,0,254,2
2020-06-13,Shasta,089,179085,101,48,0,48,4
2020-06-13,Sierra,091,2930,1,1,0,1,0
2020-06-13,Siskiyou,093,43540,25,13,0,13,0
2020-06-13,Solano,095,438530,924,637,4,641,19
2020-06-13,Sonoma,097,501317,882,711,2,713,4
2020-06-13,Stanislaus,099,539301,1748,1122,5,1127,33
2020-06-13,Sutter,101,95872,96,62,0,62,2
2020-06-13,Tehama,103,63373,33,17,2,19,1
2020-06-13,Trinity,105,12862,13,2,3,5,0
2020-06-13,Tulare,107,460477,3688,2626,10,2636,96
2020-06-13,Tuolumne,109,53932,10,7,0,7,0
2020-06-13,Ventura,111,848112,2347,1567,14,1581,37
2020-06-13,Yolo,113,214977,315,251,0,251,24
2020-06-13,Yuba,115,75493,38,28,0,28,1
2020-06-12,Alameda,001,1643700,4910,4167,9,4176,109
2020-06-12,Alpine,003,1148,1,1,0,1,0
2020-06-12,Amador,005,37829,11,10,0,10,0
2020-06-12,Butte,007,227075,112,71,7,78,1
2020-06-12,Calaveras,009,45235,28,18,0,18,0
2020-06-12,Colusa,011,21464,12,7,0,7,0
2020-06-12,Contra Costa,013,1133247,2194,1827,2,1829,43
2020-06-12,Del Norte,015,27424,47,45,0,45,0
2020-06-12,El Dorado,017,186661,163,110,0,110,0
2020-06-12,Fresno,019,978130,4806,2428,57,2485,47
2020-06-12,Glenn,021,27897,46,21,0,21,0
2020-06-12,Humboldt,023,135768,126,105,0,105,3
2020-06-12,Imperial,025,180216,5786,3543,4,3547,36
2020-06-12,Inyo,027,18085,24,23,0,23,1
2020-06-12,Kern,029,883053,4279,3152,13,3165,54
2020-06-12,Kings,031,150075,2001,987,5,992,6
2020-06-12,Lake,033,64148,39,29,0,29,0
2020-06-12,Lassen,035,31185,15,5,2,7,0
2020-06-12,Los Angeles,037,10098052,79508,70385,21,70406,2814
2020-06-12,Madera,039,155013,463,187,2,189,3
2020-06-12,Marin,041,260295,837,649,2,651,17
2020-06-12,Mariposa,043,17540,18,16,0,16,1
2020-06-12,Mendocino,045,87422,49,33,0,33,0
2020-06-12,Merced,047,269075,665,372,1,373,7
2020-06-12,Modoc,049,8938,1,0,0,0,0
2020-06-12,Mono,051,14174,39,35,0,35,1
2020-06-12,Monterey,053,433212,1207,864,4,868,11
2020-06-12,Napa,055,140530,223,162,0,162,3
2020-06-12,Nevada,057,99092,73,52,1,53,1
2020-06-12,Orange,059,3164182,12041,8440,87,8527,203
2020-06-12,Placer,061,380077,495,333,3,336,9
2020-06-12,Plumas,063,18699,5,4,0,4,0
2020-06-12,Riverside,065,2383286,13569,10616,24,10640,364
2020-06-12,Sacramento,067,1510023,1973,1702,4,1706,60
2020-06-12,San Benito,069,59416,160,96,0,96,2
2020-06-12,San Bernardino,071,2135413,9474,6707,8,6715,223
2020-06-12,San Diego,073,3302833,10621,9132,1,9133,313
2020-06-12,San Francisco,075,870044,3074,2823,1,2824,44
2020-06-12,San Joaquin,077,732212,2188,1406,4,1410,43
2020-06-12,San Luis Obispo,079,281455,474,321,5,326,1
2020-06-12,San Mateo,081,765935,2784,2533,5,2538,75
2020-06-12,Santa Barbara,083,443738,2347,1969,19,1988,14
2020-06-12,Santa Clara,085,1922200,4057,3099,15,3114,149
2020-06-12,Santa Cruz,087,273765,284,251,0,251,2
2020-06-12,Shasta,089,179085,94,48,0,48,5
2020-06-12,Sierra,091,2930,1,1,0,1,0
2020-06-12,Siskiyou,093,43540,25,13,0,13,0
2020-06-12,Solano,095,438530,910,620,4,624,19
2020-06-12,Sonoma,097,501317,863,696,2,698,4
2020-06-12,Stanislaus,099,539301,1689,1092,5,1097,33
2020-06-12,Sutter,101,95872,95,56,0,56,2
2020-06-12,Tehama,103,63373,32,13,2,15,1
2020-06-12,Trinity,105,12862,13,2,3,5,0
2020-06-12,Tulare,107,460477,3634,2552,10,2562,95
2020-06-12,Tuolumne,109,53932,10,7,0,7,0
2020-06-12,Ventura,111,848112,2295,1534,14,1548,35
2020-06-12,Yolo,113,214977,303,243,0,243,24
2020-06-12,Yuba,115,75493,36,27,0,27,1
2020-06-11,Alameda,001,1643700,4780,4073,8,4081,108
2020-06-11,Alpine,003,1148,1,1,0,1,0
2020-06-11,Amador,005,37829,10,10,0,10,0
2020-06-11,Butte,007,227075,106,72,7,79,1
2020-06-11,Calaveras,009,45235,27,16,0,16,0
2020-06-11,Colusa,011,21464,12,7,0,7,0
2020-06-11,Contra Costa,013,1133247,2141,1797,2,1799,43
2020-06-11,Del Norte,015,27424,47,45,0,45,0
2020-06-11,El Dorado,017,186661,155,109,0,109,0
2020-06-11,Fresno,019,978130,4652,2338,57,2395,45
2020-06-11,Glenn,021,27897,42,21,0,21,0
2020-06-11,Humboldt,023,135768,122,113,0,113,3
2020-06-11,Imperial,025,180216,5630,3463,4,3467,36
2020-06-11,Inyo,027,18085,22,23,0,23,1
2020-06-11,Kern,029,883053,4127,3047,11,3058,54
2020-06-11,Kings,031,150075,1968,963,5,968,6
2020-06-11,Lake,033,64148,39,28,0,28,0
2020-06-11,Lassen,035,31185,15,5,2,7,0
2020-06-11,Los Angeles,037,10098052,77842,68807,20,68827,2800
2020-06-11,Madera,039,155013,445,178,2,180,3
2020-06-11,Marin,041,260295,789,637,2,639,17
2020-06-11,Mariposa,043,17540,18,16,0,16,1
2020-06-11,Mendocino,045,87422,40,35,0,35,0
2020-06-11,Merced,047,269075,625,370,1,371,7
2020-06-11,Modoc,049,8938,1,0,0,0,0
2020-06-11,Mono,051,14174,39,35,0,35,1
2020-06-11,Monterey,053,433212,1160,813,4,817,11
2020-06-11,Napa,055,140530,214,162,0,162,3
2020-06-11,Nevada,057,99092,67,50,1,51,1
2020-06-11,Orange,059,3164182,11733,8304,86,8390,188
2020-06-11,Placer,061,380077,476,321,3,324,9
2020-06-11,Plumas,063,18699,5,4,0,4,0
2020-06-11,Riverside,065,2383286,13216,10014,24,10038,361
2020-06-11,Sacramento,067,1510023,1925,1669,4,1673,60
2020-06-11,San Benito,069,59416,154,94,0,94,2
2020-06-11,San Bernardino,071,2135413,9177,6509,8,6517,221
2020-06-11,San Diego,073,3302833,10391,9000,0,9000,308
2020-06-11,San Francisco,075,870044,3045,2766,1,2767,44
2020-06-11,San Joaquin,077,732212,2076,1351,4,1355,43
2020-06-11,San Luis Obispo,079,281455,460,307,5,312,1
2020-06-11,San Mateo,081,765935,2746,2499,5,2504,74
2020-06-11,Santa Barbara,083,443738,2286,1895,19,1914,14
2020-06-11,Santa Clara,085,1922200,3990,3049,15,3064,149
2020-06-11,Santa Cruz,087,273765,280,247,0,247,2
2020-06-11,Shasta,089,179085,87,47,0,47,5
2020-06-11,Sierra,091,2930,1,1,0,1,0
2020-06-11,Siskiyou,093,43540,25,14,0,14,0
2020-06-11,Solano,095,438530,884,616,4,620,19
2020-06-11,Sonoma,097,501317,840,682,2,684,4
2020-06-11,Stanislaus,099,539301,1598,1062,5,1067,30
2020-06-11,Sutter,101,95872,92,56,0,56,2
2020-06-11,Tehama,103,63373,27,10,2,12,1
2020-06-11,Trinity,105,12862,11,2,3,5,0
2020-06-11,Tulare,107,460477,3535,2473,10,2483,95
2020-06-11,Tuolumne,109,53932,10,7,0,7,0
2020-06-11,Ventura,111,848112,2218,1491,13,1504,34
2020-06-11,Yolo,113,214977,295,230,0,230,24
2020-06-11,Yuba,115,75493,36,27,0,27,1
2020-06-10,Alameda,001,1643700,4680,4027,7,4034,107
2020-06-10,Alpine,003,1148,1,1,0,1,0
2020-06-10,Amador,005,37829,10,10,0,10,0
2020-06-10,Butte,007,227075,102,71,7,78,1
2020-06-10,Calaveras,009,45235,27,16,0,16,0
2020-06-10,Colusa,011,21464,11,7,0,7,0
2020-06-10,Contra Costa,013,1133247,2097,1778,2,1780,43
2020-06-10,Del Norte,015,27424,47,45,0,45,0
2020-06-10,El Dorado,017,186661,152,109,0,109,0
2020-06-10,Fresno,019,978130,4475,2324,57,2381,45
2020-06-10,Glenn,021,27897,39,21,0,21,0
2020-06-10,Humboldt,023,135768,118,112,0,112,3
2020-06-10,Imperial,025,180216,5482,3454,4,3458,36
2020-06-10,Inyo,027,18085,22,23,0,23,1
2020-06-10,Kern,029,883053,4002,3000,10,3010,54
2020-06-10,Kings,031,150075,1922,952,4,956,6
2020-06-10,Lake,033,64148,39,28,0,28,0
2020-06-10,Lassen,035,31185,15,5,2,7,0
2020-06-10,Los Angeles,037,10098052,76321,67018,20,67038,2752
2020-06-10,Madera,039,155013,431,176,1,177,3
2020-06-10,Marin,041,260295,757,633,2,635,17
2020-06-10,Mariposa,043,17540,17,16,0,16,1
2020-06-10,Mendocino,045,87422,39,35,0,35,0
2020-06-10,Merced,047,269075,592,370,1,371,7
2020-06-10,Modoc,049,8938,1,0,0,0,0
2020-06-10,Mono,051,14174,39,35,0,35,1
2020-06-10,Monterey,053,433212,1106,791,4,795,11
2020-06-10,Napa,055,140530,211,159,0,159,3
2020-06-10,Nevada,057,99092,65,50,1,51,1
2020-06-10,Orange,059,3164182,11457,8222,83,8305,184
2020-06-10,Placer,061,380077,451,309,3,312,9
2020-06-10,Plumas,063,18699,5,4,0,4,0
2020-06-10,Riverside,065,2383286,12893,9857,24,9881,361
2020-06-10,Sacramento,067,1510023,1886,1643,2,1645,59
2020-06-10,San Benito,069,59416,145,94,0,94,2
2020-06-10,San Bernardino,071,2135413,8884,6438,8,6446,219
2020-06-10,San Diego,073,3302833,10227,8839,0,8839,305
2020-06-10,San Francisco,075,870044,3020,2774,1,2775,44
2020-06-10,San Joaquin,077,732212,1947,1282,4,1286,41
2020-06-10,San Luis Obispo,079,281455,440,306,5,311,1
2020-06-10,San Mateo,081,765935,2706,2492,5,2497,74
2020-06-10,Santa Barbara,083,443738,2230,1878,19,1897,13
2020-06-10,Santa Clara,085,1922200,3939,3032,15,3047,149
2020-06-10,Santa Cruz,087,273765,276,242,0,242,2
2020-06-10,Shasta,089,179085,82,45,0,45,5
2020-06-10,Sierra,091,2930,1,1,0,1,0
2020-06-10,Siskiyou,093,43540,25,14,0,14,0
2020-06-10,Solano,095,438530,848,608,4,612,19
2020-06-10,Sonoma,097,501317,822,673,2,675,4
2020-06-10,Stanislaus,099,539301,1508,1030,5,1035,29
2020-06-10,Sutter,101,95872,91,56,0,56,2
2020-06-10,Tehama,103,63373,25,10,2,12,1
2020-06-10,Trinity,105,12862,11,2,3,5,0
2020-06-10,Tulare,107,460477,3442,2455,10,2465,95
2020-06-10,Tuolumne,109,53932,10,7,0,7,0
2020-06-10,Ventura,111,848112,2172,1446,12,1458,34
2020-06-10,Yolo,113,214977,287,226,0,226,24
2020-06-10,Yuba,115,75493,35,27,0,27,1
2020-06-09,Alameda,001,1643700,4570,3963,7,3970,103
2020-06-09,Alpine,003,1148,1,1,0,1,0
2020-06-09,Amador,005,37829,10,10,0,10,0
2020-06-09,Butte,007,227075,101,70,6,76,1
2020-06-09,Calaveras,009,45235,27,16,0,16,0
2020-06-09,Colusa,011,21464,10,7,0,7,0
2020-06-09,Contra Costa,013,1133247,2056,1744,2,1746,42
2020-06-09,Del Norte,015,27424,47,45,0,45,0
2020-06-09,El Dorado,017,186661,142,108,0,108,0
2020-06-09,Fresno,019,978130,4323,2278,57,2335,43
2020-06-09,Glenn,021,27897,38,19,0,19,0
2020-06-09,Humboldt,023,135768,116,113,0,113,2
2020-06-09,Imperial,025,180216,5330,3067,4,3071,36
2020-06-09,Inyo,027,18085,22,22,0,22,1
2020-06-09,Kern,029,883053,3874,2920,10,2930,51
2020-06-09,Kings,031,150075,1890,934,4,938,6
2020-06-09,Lake,033,64148,39,28,0,28,0
2020-06-09,Lassen,035,31185,15,5,2,7,0
2020-06-09,Los Angeles,037,10098052,74663,65827,20,65847,2692
2020-06-09,Madera,039,155013,416,172,1,173,3
2020-06-09,Marin,041,260295,721,616,2,618,17
2020-06-09,Mariposa,043,17540,17,16,0,16,1
2020-06-09,Mendocino,045,87422,35,35,0,35,0
2020-06-09,Merced,047,269075,563,349,1,350,7
2020-06-09,Modoc,049,8938,1,0,0,0,0
2020-06-09,Mono,051,14174,39,35,0,35,1
2020-06-09,Monterey,053,433212,1065,772,4,776,11
2020-06-09,Napa,055,140530,201,156,0,156,3
2020-06-09,Nevada,057,99092,57,50,1,51,1
2020-06-09,Orange,059,3164182,11216,7991,81,8072,174
2020-06-09,Placer,061,380077,438,301,3,304,9
2020-06-09,Plumas,063,18699,5,4,0,4,0
2020-06-09,Riverside,065,2383286,12515,9511,24,9535,354
2020-06-09,Sacramento,067,1510023,1832,1625,2,1627,59
2020-06-09,San Benito,069,59416,139,95,0,95,2
2020-06-09,San Bernardino,071,2135413,8560,6268,6,6274,217
2020-06-09,San Diego,073,3302833,10042,8731,0,8731,301
2020-06-09,San Francisco,075,870044,2995,2749,1,2750,44
2020-06-09,San Joaquin,077,732212,1841,1240,4,1244,41
2020-06-09,San Luis Obispo,079,281455,427,301,4,305,1
2020-06-09,San Mateo,081,765935,2675,2463,5,2468,74
2020-06-09,Santa Barbara,083,443738,2174,1854,19,1873,13
2020-06-09,Santa Clara,085,1922200,3871,3006,14,3020,147
2020-06-09,Santa Cruz,087,273765,270,237,0,237,2
2020-06-09,Shasta,089,179085,78,44,0,44,4
2020-06-09,Sierra,091,2930,1,1,0,1,0
2020-06-09,Siskiyou,093,43540,20,10,0,10,0
2020-06-09,Solano,095,438530,813,596,4,600,18
2020-06-09,Sonoma,097,501317,799,661,2,663,4
2020-06-09,Stanislaus,099,539301,1407,993,5,998,25
2020-06-09,Sutter,101,95872,88,56,0,56,2
2020-06-09,Tehama,103,63373,25,9,2,11,1
2020-06-09,Trinity,105,12862,10,2,3,5,0
2020-06-09,Tulare,107,460477,3376,2393,10,2403,91
2020-06-09,Tuolumne,109,53932,10,8,0,8,0
2020-06-09,Ventura,111,848112,2106,1407,12,1419,34
2020-06-09,Yolo,113,214977,276,226,0,226,24
2020-06-09,Yuba,115,75493,34,27,0,27,1
2020-06-08,Alameda,001,1643700,4489,3937,7,3944,103
2020-06-08,Alpine,003,1148,1,1,0,1,0
2020-06-08,Amador,005,37829,10,10,0,10,0
2020-06-08,Butte,007,227075,97,68,6,74,1
2020-06-08,Calaveras,009,45235,27,16,0,16,0
2020-06-08,Colusa,011,21464,9,7,0,7,0
2020-06-08,Contra Costa,013,1133247,2013,1714,2,1716,41
2020-06-08,Del Norte,015,27424,47,45,0,45,0
2020-06-08,El Dorado,017,186661,138,107,0,107,0
2020-06-08,Fresno,019,978130,4199,2194,56,2250,42
2020-06-08,Glenn,021,27897,36,17,0,17,0
2020-06-08,Humboldt,023,135768,116,112,0,112,2
2020-06-08,Imperial,025,180216,5178,3051,4,3055,21
2020-06-08,Inyo,027,18085,22,22,0,22,1
2020-06-08,Kern,029,883053,3743,2853,9,2862,49
2020-06-08,Kings,031,150075,1814,892,4,896,6
2020-06-08,Lake,033,64148,39,28,0,28,0
2020-06-08,Lassen,035,31185,15,4,2,6,0
2020-06-08,Los Angeles,037,10098052,73202,64634,20,64654,2640
2020-06-08,Madera,039,155013,386,154,1,155,3
2020-06-08,Marin,041,260295,680,596,2,598,17
2020-06-08,Mariposa,043,17540,16,16,0,16,1
2020-06-08,Mendocino,045,87422,33,32,0,32,0
2020-06-08,Merced,047,269075,529,331,1,332,7
2020-06-08,Modoc,049,8938,1,0,0,0,0
2020-06-08,Mono,051,14174,39,35,0,35,1
2020-06-08,Monterey,053,433212,1014,751,3,754,10
2020-06-08,Napa,055,140530,185,151,0,151,3
2020-06-08,Nevada,057,99092,56,50,1,51,1
2020-06-08,Orange,059,3164182,10965,7786,79,7865,160
2020-06-08,Placer,061,380077,421,290,3,293,9
2020-06-08,Plumas,063,18699,5,4,0,4,0
2020-06-08,Riverside,065,2383286,12146,9246,24,9270,347
2020-06-08,Sacramento,067,1510023,1782,1591,2,1593,59
2020-06-08,San Benito,069,59416,132,93,0,93,2
2020-06-08,San Bernardino,071,2135413,8241,6122,6,6128,214
2020-06-08,San Diego,073,3302833,9885,8621,0,8621,296
2020-06-08,San Francisco,075,870044,2968,2715,1,2716,43
2020-06-08,San Joaquin,077,732212,1734,1198,4,1202,40
2020-06-08,San Luis Obispo,079,281455,421,300,4,304,1
2020-06-08,San Mateo,081,765935,2644,2431,4,2435,74
2020-06-08,Santa Barbara,083,443738,2119,1824,17,1841,13
2020-06-08,Santa Clara,085,1922200,3825,2971,14,2985,146
2020-06-08,Santa Cruz,087,273765,269,234,0,234,2
2020-06-08,Shasta,089,179085,74,43,0,43,4
2020-06-08,Sierra,091,2930,1,1,0,1,0
2020-06-08,Siskiyou,093,43540,20,8,0,8,0
2020-06-08,Solano,095,438530,786,560,4,564,19
2020-06-08,Sonoma,097,501317,783,654,2,656,4
2020-06-08,Stanislaus,099,539301,1325,956,5,961,28
2020-06-08,Sutter,101,95872,81,55,0,55,2
2020-06-08,Tehama,103,63373,19,8,2,10,1
2020-06-08,Trinity,105,12862,10,2,3,5,0
2020-06-08,Tulare,107,460477,3293,2301,10,2311,91
2020-06-08,Tuolumne,109,53932,9,8,0,8,0
2020-06-08,Ventura,111,848112,2048,1382,12,1394,30
2020-06-08,Yolo,113,214977,265,228,0,228,24
2020-06-08,Yuba,115,75493,32,27,0,27,1
2020-06-07,Alameda,001,1643700,4376,3866,7,3873,102
2020-06-07,Alpine,003,1148,1,1,0,1,0
2020-06-07,Amador,005,37829,10,10,0,10,0
2020-06-07,Butte,007,227075,95,64,5,69,1
2020-06-07,Calaveras,009,45235,25,16,0,16,0
2020-06-07,Colusa,011,21464,9,7,0,7,0
2020-06-07,Contra Costa,013,1133247,1962,1653,1,1654,38
2020-06-07,Del Norte,015,27424,45,45,0,45,0
2020-06-07,El Dorado,017,186661,138,104,0,104,0
2020-06-07,Fresno,019,978130,4069,2144,56,2200,41
2020-06-07,Glenn,021,27897,29,16,0,16,0
2020-06-07,Humboldt,023,135768,116,112,0,112,2
2020-06-07,Imperial,025,180216,5027,3048,4,3052,19
2020-06-07,Inyo,027,18085,22,21,0,21,1
2020-06-07,Kern,029,883053,3612,2771,9,2780,46
2020-06-07,Kings,031,150075,1765,882,4,886,6
2020-06-07,Lake,033,64148,36,28,0,28,0
2020-06-07,Lassen,035,31185,14,4,2,6,0
2020-06-07,Los Angeles,037,10098052,71499,63750,20,63770,2629
2020-06-07,Madera,039,155013,369,149,1,150,3
2020-06-07,Marin,041,260295,666,584,2,586,17
2020-06-07,Mariposa,043,17540,16,16,0,16,1
2020-06-07,Mendocino,045,87422,33,32,0,32,0
2020-06-07,Merced,047,269075,496,318,1,319,7
2020-06-07,Modoc,049,8938,1,0,0,0,0
2020-06-07,Mono,051,14174,39,35,0,35,1
2020-06-07,Monterey,053,433212,968,732,3,735,10
2020-06-07,Napa,055,140530,177,142,0,142,3
2020-06-07,Nevada,057,99092,55,50,1,51,1
2020-06-07,Orange,059,3164182,10708,7643,77,7720,158
2020-06-07,Placer,061,380077,400,273,2,275,9
2020-06-07,Plumas,063,18699,5,4,0,4,0
2020-06-07,Riverside,065,2383286,11850,9105,24,9129,344
2020-06-07,Sacramento,067,1510023,1734,1568,2,1570,59
2020-06-07,San Benito,069,59416,129,92,0,92,2
2020-06-07,San Bernardino,071,2135413,7955,6033,6,6039,214
2020-06-07,San Diego,073,3302833,9706,8478,0,8478,296
2020-06-07,San Francisco,075,870044,2924,2674,0,2674,43
2020-06-07,San Joaquin,077,732212,1633,1126,4,1130,37
2020-06-07,San Luis Obispo,079,281455,411,296,4,300,1
2020-06-07,San Mateo,081,765935,2617,2399,4,2403,73
2020-06-07,Santa Barbara,083,443738,2064,1818,17,1835,13
2020-06-07,Santa Clara,085,1922200,3773,2947,14,2961,146
2020-06-07,Santa Cruz,087,273765,261,230,0,230,2
2020-06-07,Shasta,089,179085,73,41,0,41,4
2020-06-07,Sierra,091,2930,1,1,0,1,0
2020-06-07,Siskiyou,093,43540,20,8,0,8,0
2020-06-07,Solano,095,438530,763,560,4,564,19
2020-06-07,Sonoma,097,501317,752,639,2,641,4
2020-06-07,Stanislaus,099,539301,1245,905,5,910,28
2020-06-07,Sutter,101,95872,73,55,0,55,2
2020-06-07,Tehama,103,63373,16,8,2,10,1
2020-06-07,Trinity,105,12862,8,2,3,5,0
2020-06-07,Tulare,107,460477,3171,2219,10,2229,90
2020-06-07,Tuolumne,109,53932,9,4,0,4,0
2020-06-07,Ventura,111,848112,1982,1337,12,1349,30
2020-06-07,Yolo,113,214977,255,224,0,224,24
2020-06-07,Yuba,115,75493,32,27,0,27,1
2020-06-06,Alameda,001,1643700,4331,3801,7,3808,102
2020-06-06,Alpine,003,1148,1,1,0,1,0
2020-06-06,Amador,005,37829,10,10,0,10,0
2020-06-06,Butte,007,227075,94,63,5,68,1
2020-06-06,Calaveras,009,45235,23,16,0,16,0
2020-06-06,Colusa,011,21464,9,7,0,7,0
2020-06-06,Contra Costa,013,1133247,1941,1619,1,1620,37
2020-06-06,Del Norte,015,27424,45,45,0,45,0
2020-06-06,El Dorado,017,186661,133,104,0,104,0
2020-06-06,Fresno,019,978130,4014,2117,56,2173,41
2020-06-06,Glenn,021,27897,27,16,0,16,0
2020-06-06,Humboldt,023,135768,116,112,0,112,2
2020-06-06,Imperial,025,180216,4951,3047,4,3051,19
2020-06-06,Inyo,027,18085,22,21,0,21,1
2020-06-06,Kern,029,883053,3541,2695,9,2704,46
2020-06-06,Kings,031,150075,1746,882,4,886,6
2020-06-06,Lake,033,64148,36,28,0,28,0
2020-06-06,Lassen,035,31185,14,4,2,6,0
2020-06-06,Los Angeles,037,10098052,70752,62269,20,62289,2607
2020-06-06,Madera,039,155013,360,149,1,150,3
2020-06-06,Marin,041,260295,661,556,2,558,17
2020-06-06,Mariposa,043,17540,16,16,0,16,1
2020-06-06,Mendocino,045,87422,33,32,0,32,0
2020-06-06,Merced,047,269075,495,315,1,316,7
2020-06-06,Modoc,049,8938,1,0,0,0,0
2020-06-06,Mono,051,14174,39,35,0,35,1
2020-06-06,Monterey,053,433212,944,679,3,682,10
2020-06-06,Napa,055,140530,171,136,0,136,3
2020-06-06,Nevada,057,99092,54,50,1,51,1
2020-06-06,Orange,059,3164182,10549,7576,76,7652,157
2020-06-06,Placer,061,380077,388,270,2,272,9
2020-06-06,Plumas,063,18699,5,4,0,4,0
2020-06-06,Riverside,065,2383286,11672,8935,24,8959,345
2020-06-06,Sacramento,067,1510023,1711,1533,2,1535,59
2020-06-06,San Benito,069,59416,119,92,0,92,2
2020-06-06,San Bernardino,071,2135413,7807,5946,6,5952,214
2020-06-06,San Diego,073,3302833,9585,8347,0,8347,296
2020-06-06,San Francisco,075,870044,2909,2674,0,2674,43
2020-06-06,San Joaquin,077,732212,1593,1076,4,1080,37
2020-06-06,San Luis Obispo,079,281455,405,295,4,299,1
2020-06-06,San Mateo,081,765935,2602,2342,4,2346,72
2020-06-06,Santa Barbara,083,443738,2025,1815,17,1832,13
2020-06-06,Santa Clara,085,1922200,3732,2934,14,2948,144
2020-06-06,Santa Cruz,087,273765,259,226,0,226,2
2020-06-06,Shasta,089,179085,73,40,0,40,4
2020-06-06,Sierra,091,2930,1,1,0,1,0
2020-06-06,Siskiyou,093,43540,18,8,0,8,0
2020-06-06,Solano,095,438530,748,560,4,564,19
2020-06-06,Sonoma,097,501317,740,622,2,624,4
2020-06-06,Stanislaus,099,539301,1211,858,5,863,27
2020-06-06,Sutter,101,95872,73,51,0,51,2
2020-06-06,Tehama,103,63373,15,8,2,10,1
2020-06-06,Trinity,105,12862,8,2,2,4,0
2020-06-06,Tulare,107,460477,3138,2213,10,2223,90
2020-06-06,Tuolumne,109,53932,9,4,0,4,0
2020-06-06,Ventura,111,848112,1958,1303,12,1315,30
2020-06-06,Yolo,113,214977,253,223,0,223,24
2020-06-06,Yuba,115,75493,32,27,0,27,1
2020-06-05,Alameda,001,1643700,4280,3734,7,3741,102
2020-06-05,Alpine,003,1148,1,1,0,1,0
2020-06-05,Amador,005,37829,10,10,0,10,0
2020-06-05,Butte,007,227075,91,61,5,66,1
2020-06-05,Calaveras,009,45235,22,16,0,16,0
2020-06-05,Colusa,011,21464,9,7,0,7,0
2020-06-05,Contra Costa,013,1133247,1926,1575,1,1576,37
2020-06-05,Del Norte,015,27424,45,45,0,45,0
2020-06-05,El Dorado,017,186661,131,101,0,101,0
2020-06-05,Fresno,019,978130,3950,2051,55,2106,38
2020-06-05,Glenn,021,27897,25,16,0,16,0
2020-06-05,Humboldt,023,135768,115,111,0,111,2
2020-06-05,Imperial,025,180216,4845,2778,4,2782,19
2020-06-05,Inyo,027,18085,22,21,0,21,1
2020-06-05,Kern,029,883053,3452,2624,9,2633,46
2020-06-05,Kings,031,150075,1731,865,4,869,6
2020-06-05,Lake,033,64148,35,28,0,28,0
2020-06-05,Lassen,035,31185,13,4,2,6,0
2020-06-05,Los Angeles,037,10098052,69605,60955,20,60975,2553
2020-06-05,Madera,039,155013,338,144,1,145,3
2020-06-05,Marin,041,260295,652,546,2,548,17
2020-06-05,Mariposa,043,17540,16,16,0,16,1
2020-06-05,Mendocino,045,87422,33,32,0,32,0
2020-06-05,Merced,047,269075,493,309,1,310,7
2020-06-05,Modoc,049,8938,1,0,0,0,0
2020-06-05,Mono,051,14174,39,35,0,35,1
2020-06-05,Monterey,053,433212,912,649,3,652,10
2020-06-05,Napa,055,140530,168,123,0,123,3
2020-06-05,Nevada,057,99092,54,50,1,51,1
2020-06-05,Orange,059,3164182,10353,7391,74,7465,153
2020-06-05,Placer,061,380077,378,265,2,267,9
2020-06-05,Plumas,063,18699,5,4,0,4,0
2020-06-05,Riverside,065,2383286,11413,8700,24,8724,345
2020-06-05,Sacramento,067,1510023,1689,1514,2,1516,59
2020-06-05,San Benito,069,59416,117,92,0,92,2
2020-06-05,San Bernardino,071,2135413,7625,5869,5,5874,212
2020-06-05,San Diego,073,3302833,9470,8182,0,8182,294
2020-06-05,San Francisco,075,870044,2891,2675,0,2675,43
2020-06-05,San Joaquin,077,732212,1514,1046,4,1050,36
2020-06-05,San Luis Obispo,079,281455,398,293,4,297,1
2020-06-05,San Mateo,081,765935,2577,2331,4,2335,72
2020-06-05,Santa Barbara,083,443738,1994,1795,17,1812,13
2020-06-05,Santa Clara,085,1922200,3697,2902,14,2916,144
2020-06-05,Santa Cruz,087,273765,256,222,0,222,2
2020-06-05,Shasta,089,179085,72,40,0,40,4
2020-06-05,Sierra,091,2930,1,1,0,1,0
2020-06-05,Siskiyou,093,43540,16,8,0,8,0
2020-06-05,Solano,095,438530,741,558,4,562,19
2020-06-05,Sonoma,097,501317,719,618,2,620,4
2020-06-05,Stanislaus,099,539301,1178,842,5,847,27
2020-06-05,Sutter,101,95872,73,49,0,49,2
2020-06-05,Tehama,103,63373,15,7,2,9,1
2020-06-05,Trinity,105,12862,8,1,2,3,0
2020-06-05,Tulare,107,460477,3089,2180,10,2190,90
2020-06-05,Tuolumne,109,53932,9,4,0,4,0
2020-06-05,Ventura,111,848112,1925,1274,12,1286,30
2020-06-05,Yolo,113,214977,252,216,0,216,24
2020-06-05,Yuba,115,75493,32,27,0,27,1
2020-06-04,Alameda,001,1643700,4181,3643,7,3650,99
2020-06-04,Alpine,003,1148,1,1,0,1,0
2020-06-04,Amador,005,37829,10,10,0,10,0
2020-06-04,Butte,007,227075,87,57,4,61,1
2020-06-04,Calaveras,009,45235,22,15,0,15,0
2020-06-04,Colusa,011,21464,9,7,0,7,0
2020-06-04,Contra Costa,013,1133247,1868,1551,1,1552,37
2020-06-04,Del Norte,015,27424,45,45,0,45,0
2020-06-04,El Dorado,017,186661,129,101,0,101,0
2020-06-04,Fresno,019,978130,3844,2007,54,2061,35
2020-06-04,Glenn,021,27897,22,16,0,16,0
2020-06-04,Humboldt,023,135768,115,109,0,109,2
2020-06-04,Imperial,025,180216,4663,2631,4,2635,19
2020-06-04,Inyo,027,18085,22,20,0,20,1
2020-06-04,Kern,029,883053,3336,2530,9,2539,46
2020-06-04,Kings,031,150075,1661,842,4,846,6
2020-06-04,Lake,033,64148,34,27,0,27,0
2020-06-04,Lassen,035,31185,11,4,2,6,0
2020-06-04,Los Angeles,037,10098052,68139,59596,20,59616,2515
2020-06-04,Madera,039,155013,330,127,1,128,3
2020-06-04,Marin,041,260295,630,533,2,535,14
2020-06-04,Mariposa,043,17540,16,16,0,16,1
2020-06-04,Mendocino,045,87422,33,29,0,29,0
2020-06-04,Merced,047,269075,473,304,1,305,7
2020-06-04,Modoc,049,8938,1,0,0,0,0
2020-06-04,Mono,051,14174,39,35,0,35,1
2020-06-04,Monterey,053,433212,877,621,2,623,10
2020-06-04,Napa,055,140530,164,117,0,117,3
2020-06-04,Nevada,057,99092,53,49,1,50,1
2020-06-04,Orange,059,3164182,10099,7192,73,7265,148
2020-06-04,Placer,061,380077,362,256,2,258,9
2020-06-04,Plumas,063,18699,4,4,0,4,0
2020-06-04,Riverside,065,2383286,11135,8473,24,8497,341
2020-06-04,Sacramento,067,1510023,1662,1492,2,1494,58
2020-06-04,San Benito,069,59416,115,88,0,88,2
2020-06-04,San Bernardino,071,2135413,7357,5726,5,5731,207
2020-06-04,San Diego,073,3302833,9307,7942,0,7942,288
2020-06-04,San Francisco,075,870044,2858,2636,0,2636,43
2020-06-04,San Joaquin,077,732212,1452,1016,4,1020,36
2020-06-04,San Luis Obispo,079,281455,387,288,4,292,1
2020-06-04,San Mateo,081,765935,2550,2284,4,2288,72
2020-06-04,Santa Barbara,083,443738,1963,1750,16,1766,13
2020-06-04,Santa Clara,085,1922200,3663,2871,14,2885,144
2020-06-04,Santa Cruz,087,273765,250,218,0,218,2
2020-06-04,Shasta,089,179085,66,40,0,40,4
2020-06-04,Sierra,091,2930,1,1,0,1,0
2020-06-04,Siskiyou,093,43540,15,8,0,8,0
2020-06-04,Solano,095,438530,724,551,4,555,19
2020-06-04,Sonoma,097,501317,700,591,1,592,4
2020-06-04,Stanislaus,099,539301,1102,806,5,811,28
2020-06-04,Sutter,101,95872,68,46,0,46,2
2020-06-04,Tehama,103,63373,14,6,1,7,1
2020-06-04,Trinity,105,12862,8,1,2,3,0
2020-06-04,Tulare,107,460477,2972,2086,10,2096,90
2020-06-04,Tuolumne,109,53932,8,4,0,4,0
2020-06-04,Ventura,111,848112,1881,1236,11,1247,30
2020-06-04,Yolo,113,214977,247,216,0,216,24
2020-06-04,Yuba,115,75493,31,27,0,27,1
2020-06-03,Alameda,001,1643700,4122,3589,6,3595,99
2020-06-03,Alpine,003,1148,1,1,0,1,0
2020-06-03,Amador,005,37829,10,10,0,10,0
2020-06-03,Butte,007,227075,85,53,4,57,1
2020-06-03,Calaveras,009,45235,21,15,0,15,0
2020-06-03,Colusa,011,21464,9,7,0,7,0
2020-06-03,Contra Costa,013,1133247,1820,1511,1,1512,37
2020-06-03,Del Norte,015,27424,45,39,0,39,0
2020-06-03,El Dorado,017,186661,126,90,0,90,0
2020-06-03,Fresno,019,978130,3745,1943,54,1997,35
2020-06-03,Glenn,021,27897,22,16,0,16,0
2020-06-03,Humboldt,023,135768,115,103,0,103,2
2020-06-03,Imperial,025,180216,4490,2540,4,2544,19
2020-06-03,Inyo,027,18085,22,20,0,20,1
2020-06-03,Kern,029,883053,3240,2452,8,2460,44
2020-06-03,Kings,031,150075,1596,744,4,748,6
2020-06-03,Lake,033,64148,32,26,0,26,0
2020-06-03,Lassen,035,31185,11,4,2,6,0
2020-06-03,Los Angeles,037,10098052,66530,58166,20,58186,2472
2020-06-03,Madera,039,155013,322,117,1,118,3
2020-06-03,Marin,041,260295,612,527,2,529,14
2020-06-03,Mariposa,043,17540,16,16,0,16,1
2020-06-03,Mendocino,045,87422,32,29,0,29,0
2020-06-03,Merced,047,269075,459,299,1,300,7
2020-06-03,Modoc,049,8938,1,0,0,0,0
2020-06-03,Mono,051,14174,39,35,0,35,1
2020-06-03,Monterey,053,433212,849,592,2,594,10
2020-06-03,Napa,055,140530,163,116,0,116,3
2020-06-03,Nevada,057,99092,52,43,1,44,1
2020-06-03,Orange,059,3164182,9873,6939,72,7011,145
2020-06-03,Placer,061,380077,342,243,2,245,9
2020-06-03,Plumas,063,18699,4,4,0,4,0
2020-06-03,Riverside,065,2383286,10860,8208,24,8232,335
2020-06-03,Sacramento,067,1510023,1632,1457,2,1459,58
2020-06-03,San Benito,069,59416,109,88,0,88,2
2020-06-03,San Bernardino,071,2135413,7134,5565,5,5570,203
2020-06-03,San Diego,073,3302833,9159,7800,0,7800,283
2020-06-03,San Francisco,075,870044,2827,2608,0,2608,43
2020-06-03,San Joaquin,077,732212,1388,1004,4,1008,35
2020-06-03,San Luis Obispo,079,281455,382,279,4,283,1
2020-06-03,San Mateo,081,765935,2522,2243,4,2247,71
2020-06-03,Santa Barbara,083,443738,1929,1722,15,1737,12
2020-06-03,Santa Clara,085,1922200,3621,2836,14,2850,144
2020-06-03,Santa Cruz,087,273765,244,217,0,217,2
2020-06-03,Shasta,089,179085,63,40,0,40,4
2020-06-03,Sierra,091,2930,1,1,0,1,0
2020-06-03,Siskiyou,093,43540,14,8,0,8,0
2020-06-03,Solano,095,438530,699,543,2,545,18
2020-06-03,Sonoma,097,501317,688,578,1,579,4
2020-06-03,Stanislaus,099,539301,1062,780,5,785,27
2020-06-03,Sutter,101,95872,60,45,0,45,2
2020-06-03,Tehama,103,63373,14,6,1,7,1
2020-06-03,Trinity,105,12862,8,1,2,3,0
2020-06-03,Tulare,107,460477,2903,2041,10,2051,88
2020-06-03,Tuolumne,109,53932,6,4,0,4,0
2020-06-03,Ventura,111,848112,1814,1202,11,1213,30
2020-06-03,Yolo,113,214977,243,213,0,213,24
2020-06-03,Yuba,115,75493,31,27,0,27,1
2020-06-02,Alameda,001,1643700,4046,3517,6,3523,99
2020-06-02,Alpine,003,1148,1,1,0,1,0
2020-06-02,Amador,005,37829,10,10,0,10,0
2020-06-02,Butte,007,227075,81,51,3,54,1
2020-06-02,Calaveras,009,45235,21,15,0,15,0
2020-06-02,Colusa,011,21464,9,7,0,7,0
2020-06-02,Contra Costa,013,1133247,1788,1505,1,1506,37
2020-06-02,Del Norte,015,27424,45,39,0,39,0
2020-06-02,El Dorado,017,186661,125,88,0,88,0
2020-06-02,Fresno,019,978130,3632,1917,54,1971,34
2020-06-02,Glenn,021,27897,21,16,0,16,0
2020-06-02,Humboldt,023,135768,115,101,0,101,2
2020-06-02,Imperial,025,180216,4297,2459,4,2463,19
2020-06-02,Inyo,027,18085,20,20,0,20,1
2020-06-02,Kern,029,883053,3141,2406,6,2412,41
2020-06-02,Kings,031,150075,1568,720,4,724,5
2020-06-02,Lake,033,64148,32,25,0,25,0
2020-06-02,Lassen,035,31185,10,4,2,6,0
2020-06-02,Los Angeles,037,10098052,65128,57144,20,57164,2430
2020-06-02,Madera,039,155013,301,110,1,111,2
2020-06-02,Marin,041,260295,585,509,2,511,14
2020-06-02,Mariposa,043,17540,16,16,0,16,1
2020-06-02,Mendocino,045,87422,32,29,0,29,0
2020-06-02,Merced,047,269075,443,297,1,298,6
2020-06-02,Modoc,049,8938,1,0,0,0,0
2020-06-02,Mono,051,14174,39,35,0,35,1
2020-06-02,Monterey,053,433212,819,582,2,584,10
2020-06-02,Napa,055,140530,154,116,0,116,3
2020-06-02,Nevada,057,99092,51,41,1,42,1
2020-06-02,Orange,059,3164182,9672,6790,71,6861,142
2020-06-02,Placer,061,380077,328,226,2,228,9
2020-06-02,Plumas,063,18699,4,4,0,4,0
2020-06-02,Riverside,065,2383286,10564,8091,22,8113,330
2020-06-02,Sacramento,067,1510023,1603,1428,2,1430,58
2020-06-02,San Benito,069,59416,108,86,0,86,2
2020-06-02,San Bernardino,071,2135413,6927,5438,5,5443,202
2020-06-02,San Diego,073,3302833,9013,7676,0,7676,276
2020-06-02,San Francisco,075,870044,2792,2554,0,2554,43
2020-06-02,San Joaquin,077,732212,1322,985,4,989,35
2020-06-02,San Luis Obispo,079,281455,377,275,4,279,1
2020-06-02,San Mateo,081,765935,2487,2203,4,2207,71
2020-06-02,Santa Barbara,083,443738,1889,1703,15,1718,12
2020-06-02,Santa Clara,085,1922200,3571,2819,14,2833,144
2020-06-02,Santa Cruz,087,273765,239,215,0,215,2
2020-06-02,Shasta,089,179085,62,38,0,38,4
2020-06-02,Sierra,091,2930,1,1,0,1,0
2020-06-02,Siskiyou,093,43540,13,8,0,8,0
2020-06-02,Solano,095,438530,684,537,1,538,18
2020-06-02,Sonoma,097,501317,677,571,1,572,4
2020-06-02,Stanislaus,099,539301,1003,772,5,777,27
2020-06-02,Sutter,101,95872,57,43,0,43,2
2020-06-02,Tehama,103,63373,14,6,1,7,1
2020-06-02,Trinity,105,12862,8,1,2,3,0
2020-06-02,Tulare,107,460477,2823,2012,10,2022,86
2020-06-02,Tuolumne,109,53932,6,4,0,4,0
2020-06-02,Ventura,111,848112,1761,1178,11,1189,30
2020-06-02,Yolo,113,214977,241,213,0,213,24
2020-06-02,Yuba,115,75493,31,27,0,27,1
2020-06-01,Alameda,001,1643700,3980,3460,6,3466,98
2020-06-01,Alpine,003,1148,1,1,0,1,0
2020-06-01,Amador,005,37829,10,10,0,10,0
2020-06-01,Butte,007,227075,80,50,2,52,1
2020-06-01,Calaveras,009,45235,21,15,0,15,0
2020-06-01,Colusa,011,21464,9,7,0,7,0
2020-06-01,Contra Costa,013,1133247,1752,1486,1,1487,37
2020-06-01,Del Norte,015,27424,45,38,0,38,0
2020-06-01,El Dorado,017,186661,123,88,0,88,0
2020-06-01,Fresno,019,978130,3537,1854,52,1906,33
2020-06-01,Glenn,021,27897,21,16,0,16,0
2020-06-01,Humboldt,023,135768,115,98,0,98,2
2020-06-01,Imperial,025,180216,4075,2366,4,2370,14
2020-06-01,Inyo,027,18085,20,20,0,20,1
2020-06-01,Kern,029,883053,3058,2366,6,2372,38
2020-06-01,Kings,031,150075,1300,703,4,707,4
2020-06-01,Lake,033,64148,32,22,0,22,0
2020-06-01,Lassen,035,31185,10,4,2,6,0
2020-06-01,Los Angeles,037,10098052,63664,55899,20,55919,2367
2020-06-01,Madera,039,155013,289,103,1,104,2
2020-06-01,Marin,041,260295,544,495,2,497,14
2020-06-01,Mariposa,043,17540,16,16,0,16,1
2020-06-01,Mendocino,045,87422,32,28,0,28,0
2020-06-01,Merced,047,269075,424,289,1,290,6
2020-06-01,Modoc,049,8938,1,0,0,0,0
2020-06-01,Mono,051,14174,39,35,0,35,1
2020-06-01,Monterey,053,433212,795,554,2,556,10
2020-06-01,Napa,055,140530,151,114,0,114,3
2020-06-01,Nevada,057,99092,51,41,1,42,1
2020-06-01,Orange,059,3164182,9475,6640,70,6710,135
2020-06-01,Placer,061,380077,316,218,2,220,9
2020-06-01,Plumas,063,18699,4,4,0,4,0
2020-06-01,Riverside,065,2383286,10112,7921,21,7942,322
2020-06-01,Sacramento,067,1510023,1564,1415,2,1417,58
2020-06-01,San Benito,069,59416,105,86,0,86,2
2020-06-01,San Bernardino,071,2135413,6721,5310,5,5315,202
2020-06-01,San Diego,073,3302833,8833,7556,0,7556,269
2020-06-01,San Francisco,075,870044,2755,2546,0,2546,43
2020-06-01,San Joaquin,077,732212,1257,957,4,961,35
2020-06-01,San Luis Obispo,079,281455,373,275,4,279,1
2020-06-01,San Mateo,081,765935,2457,2190,4,2194,71
2020-06-01,Santa Barbara,083,443738,1855,1671,14,1685,10
2020-06-01,Santa Clara,085,1922200,3533,2797,13,2810,142
2020-06-01,Santa Cruz,087,273765,235,215,0,215,2
2020-06-01,Shasta,089,179085,62,38,0,38,4
2020-06-01,Sierra,091,2930,1,1,0,1,0
2020-06-01,Siskiyou,093,43540,13,7,0,7,0
2020-06-01,Solano,095,438530,660,529,1,530,17
2020-06-01,Sonoma,097,501317,661,565,1,566,4
2020-06-01,Stanislaus,099,539301,966,758,5,763,27
2020-06-01,Sutter,101,95872,52,43,0,43,2
2020-06-01,Tehama,103,63373,11,5,1,6,1
2020-06-01,Trinity,105,12862,7,1,2,3,0
2020-06-01,Tulare,107,460477,2708,1976,10,1986,84
2020-06-01,Tuolumne,109,53932,5,4,0,4,0
2020-06-01,Ventura,111,848112,1708,1163,11,1174,29
2020-06-01,Yolo,113,214977,238,212,0,212,24
2020-06-01,Yuba,115,75493,30,26,0,26,1
2020-05-31,Alameda,001,1643700,3875,3362,6,3368,98
2020-05-31,Alpine,003,1148,1,1,0,1,0
2020-05-31,Amador,005,37829,10,10,0,10,0
2020-05-31,Butte,007,227075,78,51,2,53,0
2020-05-31,Calaveras,009,45235,18,15,0,15,0
2020-05-31,Colusa,011,21464,9,5,0,5,0
2020-05-31,Contra Costa,013,1133247,1718,1458,1,1459,37
2020-05-31,Del Norte,015,27424,45,37,0,37,0
2020-05-31,El Dorado,017,186661,119,88,0,88,0
2020-05-31,Fresno,019,978130,3372,1780,46,1826,31
2020-05-31,Glenn,021,27897,20,16,0,16,0
2020-05-31,Humboldt,023,135768,113,98,0,98,2
2020-05-31,Imperial,025,180216,3808,2197,4,2201,14
2020-05-31,Inyo,027,18085,20,20,0,20,1
2020-05-31,Kern,029,883053,2923,2300,6,2306,38
2020-05-31,Kings,031,150075,1263,703,4,707,3
2020-05-31,Lake,033,64148,32,19,0,19,0
2020-05-31,Lassen,035,31185,10,4,2,6,0
2020-05-31,Los Angeles,037,10098052,62374,54925,20,54945,2344
2020-05-31,Madera,039,155013,271,101,1,102,2
2020-05-31,Marin,041,260295,534,486,2,488,14
2020-05-31,Mariposa,043,17540,16,16,0,16,1
2020-05-31,Mendocino,045,87422,32,24,0,24,0
2020-05-31,Merced,047,269075,397,288,0,288,6
2020-05-31,Modoc,049,8938,0,0,0,0,0
2020-05-31,Mono,051,14174,39,34,0,34,1
2020-05-31,Monterey,053,433212,721,545,2,547,10
2020-05-31,Napa,055,140530,149,114,0,114,3
2020-05-31,Nevada,057,99092,50,41,1,42,1
2020-05-31,Orange,059,3164182,9265,6532,69,6601,135
2020-05-31,Placer,061,380077,294,215,2,217,9
2020-05-31,Plumas,063,18699,4,4,0,4,0
2020-05-31,Riverside,065,2383286,9856,7704,21,7725,321
2020-05-31,Sacramento,067,1510023,1533,1398,2,1400,57
2020-05-31,San Benito,069,59416,99,85,0,85,2
2020-05-31,San Bernardino,071,2135413,6453,5185,5,5190,198
2020-05-31,San Diego,073,3302833,8639,7483,0,7483,269
2020-05-31,San Francisco,075,870044,2719,2501,0,2501,43
2020-05-31,San Joaquin,077,732212,1192,888,4,892,34
2020-05-31,San Luis Obispo,079,281455,363,271,4,275,1
2020-05-31,San Mateo,081,765935,2411,2169,4,2173,71
2020-05-31,Santa Barbara,083,443738,1804,1662,13,1675,9
2020-05-31,Santa Clara,085,1922200,3489,2785,13,2798,142
2020-05-31,Santa Cruz,087,273765,232,210,0,210,2
2020-05-31,Shasta,089,179085,60,38,0,38,4
2020-05-31,Sierra,091,2930,1,1,0,1,0
2020-05-31,Siskiyou,093,43540,12,7,0,7,0
2020-05-31,Solano,095,438530,634,512,1,513,6
2020-05-31,Sonoma,097,501317,641,555,1,556,4
2020-05-31,Stanislaus,099,539301,912,738,5,743,27
2020-05-31,Sutter,101,95872,50,42,0,42,2
2020-05-31,Tehama,103,63373,10,4,1,5,1
2020-05-31,Trinity,105,12862,7,1,2,3,0
2020-05-31,Tulare,107,460477,2635,1884,10,1894,82
2020-05-31,Tuolumne,109,53932,5,4,0,4,0
2020-05-31,Ventura,111,848112,1647,1151,11,1162,30
2020-05-31,Yolo,113,214977,232,211,0,211,24
2020-05-31,Yuba,115,75493,30,26,0,26,1
2020-05-30,Alameda,001,1643700,3849,3304,6,3310,96
2020-05-30,Alpine,003,1148,1,1,0,1,0
2020-05-30,Amador,005,37829,10,10,0,10,0
2020-05-30,Butte,007,227075,77,44,2,46,0
2020-05-30,Calaveras,009,45235,17,15,0,15,0
2020-05-30,Colusa,011,21464,8,5,0,5,0
2020-05-30,Contra Costa,013,1133247,1702,1429,1,1430,37
2020-05-30,Del Norte,015,27424,45,37,0,37,0
2020-05-30,El Dorado,017,186661,118,86,0,86,0
2020-05-30,Fresno,019,978130,3311,1744,45,1789,31
2020-05-30,Glenn,021,27897,19,16,0,16,0
2020-05-30,Humboldt,023,135768,112,98,0,98,2
2020-05-30,Imperial,025,180216,3718,2091,4,2095,14
2020-05-30,Inyo,027,18085,20,20,0,20,1
2020-05-30,Kern,029,883053,2854,2217,6,2223,38
2020-05-30,Kings,031,150075,1249,703,4,707,3
2020-05-30,Lake,033,64148,31,18,0,18,0
2020-05-30,Lassen,035,31185,10,4,2,6,0
2020-05-30,Los Angeles,037,10098052,61838,53627,20,53647,2319
2020-05-30,Madera,039,155013,266,101,1,102,2
2020-05-30,Marin,041,260295,534,462,2,464,14
2020-05-30,Mariposa,043,17540,16,16,0,16,1
2020-05-30,Mendocino,045,87422,32,24,0,24,0
2020-05-30,Merced,047,269075,396,285,0,285,6
2020-05-30,Modoc,049,8938,0,0,0,0,0
2020-05-30,Mono,051,14174,39,34,0,34,1
2020-05-30,Monterey,053,433212,705,520,2,522,10
2020-05-30,Napa,055,140530,147,113,0,113,3
2020-05-30,Nevada,057,99092,50,41,1,42,1
2020-05-30,Orange,059,3164182,9108,6354,69,6423,134
2020-05-30,Placer,061,380077,286,199,1,200,9
2020-05-30,Plumas,063,18699,4,4,0,4,0
2020-05-30,Riverside,065,2383286,9712,7492,21,7513,316
2020-05-30,Sacramento,067,1510023,1522,1384,2,1386,57
2020-05-30,San Benito,069,59416,98,85,0,85,2
2020-05-30,San Bernardino,071,2135413,6344,5122,5,5127,198
2020-05-30,San Diego,073,3302833,8546,7387,0,7387,269
2020-05-30,San Francisco,075,870044,2694,2496,0,2496,41
2020-05-30,San Joaquin,077,732212,1154,888,4,892,34
2020-05-30,San Luis Obispo,079,281455,358,270,4,274,1
2020-05-30,San Mateo,081,765935,2387,2129,4,2133,71
2020-05-30,Santa Barbara,083,443738,1785,1660,13,1673,9
2020-05-30,Santa Clara,085,1922200,3473,2741,13,2754,141
2020-05-30,Santa Cruz,087,273765,232,206,0,206,2
2020-05-30,Shasta,089,179085,60,36,0,36,4
2020-05-30,Sierra,091,2930,1,1,0,1,0
2020-05-30,Siskiyou,093,43540,11,7,0,7,0
2020-05-30,Solano,095,438530,627,512,1,513,6
2020-05-30,Sonoma,097,501317,631,551,1,552,4
2020-05-30,Stanislaus,099,539301,895,712,5,717,27
2020-05-30,Sutter,101,95872,49,40,0,40,2
2020-05-30,Tehama,103,63373,10,4,1,5,1
2020-05-30,Trinity,105,12862,7,1,2,3,0
2020-05-30,Tulare,107,460477,2598,1879,10,1889,81
2020-05-30,Tuolumne,109,53932,5,4,0,4,0
2020-05-30,Ventura,111,848112,1630,1116,11,1127,30
2020-05-30,Yolo,113,214977,228,210,0,210,24
2020-05-30,Yuba,115,75493,30,25,0,25,1
2020-05-29,Alameda,001,1643700,3814,3209,6,3215,96
2020-05-29,Alpine,003,1148,1,1,0,1,0
2020-05-29,Amador,005,37829,10,10,0,10,0
2020-05-29,Butte,007,227075,72,41,2,43,0
2020-05-29,Calaveras,009,45235,17,15,0,15,0
2020-05-29,Colusa,011,21464,8,5,0,5,0
2020-05-29,Contra Costa,013,1133247,1686,1411,1,1412,37
2020-05-29,Del Norte,015,27424,45,37,0,37,0
2020-05-29,El Dorado,017,186661,117,85,0,85,0
2020-05-29,Fresno,019,978130,3261,1687,45,1732,31
2020-05-29,Glenn,021,27897,19,14,0,14,0
2020-05-29,Humboldt,023,135768,111,98,0,98,2
2020-05-29,Imperial,025,180216,3600,1607,4,1611,14
2020-05-29,Inyo,027,18085,20,20,0,20,1
2020-05-29,Kern,029,883053,2796,2128,6,2134,36
2020-05-29,Kings,031,150075,1238,693,4,697,3
2020-05-29,Lake,033,64148,30,17,0,17,0
2020-05-29,Lassen,035,31185,10,0,2,2,0
2020-05-29,Los Angeles,037,10098052,60883,51578,20,51598,2273
2020-05-29,Madera,039,155013,251,98,1,99,2
2020-05-29,Marin,041,260295,526,448,2,450,14
2020-05-29,Mariposa,043,17540,16,16,0,16,1
2020-05-29,Mendocino,045,87422,30,25,0,25,0
2020-05-29,Merced,047,269075,391,285,0,285,7
2020-05-29,Modoc,049,8938,0,0,0,0,0
2020-05-29,Mono,051,14174,38,34,0,34,1
2020-05-29,Monterey,053,433212,675,479,2,481,10
2020-05-29,Napa,055,140530,144,113,0,113,3
2020-05-29,Nevada,057,99092,50,41,1,42,1
2020-05-29,Orange,059,3164182,8923,6176,67,6243,133
2020-05-29,Placer,061,380077,264,199,1,200,9
2020-05-29,Plumas,063,18699,4,4,0,4,0
2020-05-29,Riverside,065,2383286,9526,7376,21,7397,313
2020-05-29,Sacramento,067,1510023,1499,1360,2,1362,57
2020-05-29,San Benito,069,59416,98,84,0,84,2
2020-05-29,San Bernardino,071,2135413,6236,4983,5,4988,196
2020-05-29,San Diego,073,3302833,8423,7242,0,7242,266
2020-05-29,San Francisco,075,870044,2670,2453,0,2453,41
2020-05-29,San Joaquin,077,732212,1117,855,4,859,34
2020-05-29,San Luis Obispo,079,281455,354,270,4,274,1
2020-05-29,San Mateo,081,765935,2371,2103,4,2107,71
2020-05-29,Santa Barbara,083,443738,1758,1656,13,1669,9
2020-05-29,Santa Clara,085,1922200,3445,2707,13,2720,141
2020-05-29,Santa Cruz,087,273765,229,203,0,203,2
2020-05-29,Shasta,089,179085,60,36,0,36,4
2020-05-29,Sierra,091,2930,1,1,0,1,0
2020-05-29,Siskiyou,093,43540,11,7,0,7,0
2020-05-29,Solano,095,438530,619,498,1,499,6
2020-05-29,Sonoma,097,501317,620,537,1,538,4
2020-05-29,Stanislaus,099,539301,865,698,5,703,27
2020-05-29,Sutter,101,95872,47,40,0,40,2
2020-05-29,Tehama,103,63373,9,4,1,5,1
2020-05-29,Trinity,105,12862,7,1,2,3,0
2020-05-29,Tulare,107,460477,2560,1852,10,1862,80
2020-05-29,Tuolumne,109,53932,5,4,0,4,0
2020-05-29,Ventura,111,848112,1606,1093,11,1104,29
2020-05-29,Yolo,113,214977,224,211,0,211,24
2020-05-29,Yuba,115,75493,29,25,0,25,1
2020-05-28,Alameda,001,1643700,3714,3083,6,3089,94
2020-05-28,Alpine,003,1148,1,1,0,1,0
2020-05-28,Amador,005,37829,10,10,0,10,0
2020-05-28,Butte,007,227075,71,40,2,42,0
2020-05-28,Calaveras,009,45235,16,15,0,15,0
2020-05-28,Colusa,011,21464,8,5,0,5,0
2020-05-28,Contra Costa,013,1133247,1647,1392,1,1393,37
2020-05-28,Del Norte,015,27424,45,37,0,37,0
2020-05-28,El Dorado,017,186661,114,82,0,82,0
2020-05-28,Fresno,019,978130,3180,1653,44,1697,31
2020-05-28,Glenn,021,27897,18,14,0,14,0
2020-05-28,Humboldt,023,135768,110,97,0,97,2
2020-05-28,Imperial,025,180216,3405,1430,4,1434,14
2020-05-28,Inyo,027,18085,20,20,0,20,1
2020-05-28,Kern,029,883053,2718,2069,6,2075,36
2020-05-28,Kings,031,150075,901,626,4,630,3
2020-05-28,Lake,033,64148,29,17,0,17,0
2020-05-28,Lassen,035,31185,10,0,2,2,0
2020-05-28,Los Angeles,037,10098052,59304,49861,20,49881,2222
2020-05-28,Madera,039,155013,233,93,1,94,2
2020-05-28,Marin,041,260295,501,443,2,445,14
2020-05-28,Mariposa,043,17540,16,16,0,16,1
2020-05-28,Mendocino,045,87422,28,24,0,24,0
2020-05-28,Merced,047,269075,382,283,0,283,7
2020-05-28,Modoc,049,8938,0,0,0,0,0
2020-05-28,Mono,051,14174,38,34,0,34,1
2020-05-28,Monterey,053,433212,643,471,2,473,10
2020-05-28,Napa,055,140530,141,113,0,113,3
2020-05-28,Nevada,057,99092,45,41,1,42,1
2020-05-28,Orange,059,3164182,8727,6045,67,6112,130
2020-05-28,Placer,061,380077,257,196,1,197,9
2020-05-28,Plumas,063,18699,4,4,0,4,0
2020-05-28,Riverside,065,2383286,9123,7240,20,7260,304
2020-05-28,Sacramento,067,1510023,1479,1339,2,1341,57
2020-05-28,San Benito,069,59416,97,82,0,82,2
2020-05-28,San Bernardino,071,2135413,6071,4831,5,4836,191
2020-05-28,San Diego,073,3302833,8266,7102,0,7102,260
2020-05-28,San Francisco,075,870044,2636,2417,0,2417,40
2020-05-28,San Joaquin,077,732212,1082,840,4,844,34
2020-05-28,San Luis Obispo,079,281455,351,267,4,271,1
2020-05-28,San Mateo,081,765935,2344,2070,4,2074,71
2020-05-28,Santa Barbara,083,443738,1729,1642,12,1654,9
2020-05-28,Santa Clara,085,1922200,3405,2698,13,2711,140
2020-05-28,Santa Cruz,087,273765,228,201,0,201,2
2020-05-28,Shasta,089,179085,58,36,0,36,4
2020-05-28,Sierra,091,2930,1,1,0,1,0
2020-05-28,Siskiyou,093,43540,9,6,0,6,0
2020-05-28,Solano,095,438530,602,489,1,490,6
2020-05-28,Sonoma,097,501317,598,529,1,530,4
2020-05-28,Stanislaus,099,539301,824,684,5,689,27
2020-05-28,Sutter,101,95872,47,40,0,40,2
2020-05-28,Tehama,103,63373,9,4,1,5,1
2020-05-28,Trinity,105,12862,6,1,2,3,0
2020-05-28,Tulare,107,460477,2524,1832,10,1842,79
2020-05-28,Tuolumne,109,53932,5,4,0,4,0
2020-05-28,Ventura,111,848112,1573,1083,11,1094,29
2020-05-28,Yolo,113,214977,221,206,0,206,22
2020-05-28,Yuba,115,75493,28,24,0,24,1
2020-05-27,Alameda,001,1643700,3631,3037,6,3043,94
2020-05-27,Alpine,003,1148,1,1,0,1,0
2020-05-27,Amador,005,37829,10,10,0,10,0
2020-05-27,Butte,007,227075,68,40,1,41,0
2020-05-27,Calaveras,009,45235,15,15,0,15,0
2020-05-27,Colusa,011,21464,8,5,0,5,0
2020-05-27,Contra Costa,013,1133247,1607,1373,1,1374,37
2020-05-27,Del Norte,015,27424,45,34,0,34,0
2020-05-27,El Dorado,017,186661,113,82,0,82,0
2020-05-27,Fresno,019,978130,3092,1620,44,1664,27
2020-05-27,Glenn,021,27897,18,14,0,14,0
2020-05-27,Humboldt,023,135768,110,86,0,86,2
2020-05-27,Imperial,025,180216,3225,1369,4,1373,14
2020-05-27,Inyo,027,18085,20,20,0,20,1
2020-05-27,Kern,029,883053,2653,1999,6,2005,37
2020-05-27,Kings,031,150075,874,586,4,590,3
2020-05-27,Lake,033,64148,29,13,0,13,0
2020-05-27,Lassen,035,31185,10,0,2,2,0
2020-05-27,Los Angeles,037,10098052,57929,48711,20,48731,2177
2020-05-27,Madera,039,155013,224,91,1,92,2
2020-05-27,Marin,041,260295,472,439,2,441,14
2020-05-27,Mariposa,043,17540,16,16,0,16,1
2020-05-27,Mendocino,045,87422,27,21,0,21,0
2020-05-27,Merced,047,269075,378,278,0,278,7
2020-05-27,Modoc,049,8938,0,0,0,0,0
2020-05-27,Mono,051,14174,38,34,0,34,1
2020-05-27,Monterey,053,433212,603,443,1,444,8
2020-05-27,Napa,055,140530,136,112,0,112,3
2020-05-27,Nevada,057,99092,44,41,1,42,1
2020-05-27,Orange,059,3164182,8572,5849,67,5916,121
2020-05-27,Placer,061,380077,238,196,0,196,9
2020-05-27,Plumas,063,18699,4,4,0,4,0
2020-05-27,Riverside,065,2383286,8744,7156,20,7176,299
2020-05-27,Sacramento,067,1510023,1451,1318,2,1320,50
2020-05-27,San Benito,069,59416,94,74,0,74,2
2020-05-27,San Bernardino,071,2135413,5887,4708,5,4713,183
2020-05-27,San Diego,073,3302833,8115,6985,0,6985,255
2020-05-27,San Francisco,075,870044,2607,2394,0,2394,40
2020-05-27,San Joaquin,077,732212,1040,825,4,829,34
2020-05-27,San Luis Obispo,079,281455,346,266,4,270,1
2020-05-27,San Mateo,081,765935,2304,2045,4,2049,71
2020-05-27,Santa Barbara,083,443738,1714,1629,12,1641,9
2020-05-27,Santa Clara,085,1922200,3372,2680,13,2693,140
2020-05-27,Santa Cruz,087,273765,224,202,0,202,2
2020-05-27,Shasta,089,179085,55,36,0,36,4
2020-05-27,Sierra,091,2930,1,1,0,1,0
2020-05-27,Siskiyou,093,43540,9,6,0,6,0
2020-05-27,Solano,095,438530,582,477,1,478,5
2020-05-27,Sonoma,097,501317,584,521,1,522,4
2020-05-27,Stanislaus,099,539301,799,675,5,680,27
2020-05-27,Sutter,101,95872,46,40,0,40,2
2020-05-27,Tehama,103,63373,9,3,1,4,1
2020-05-27,Trinity,105,12862,6,1,2,3,0
2020-05-27,Tulare,107,460477,2472,1817,10,1827,77
2020-05-27,Tuolumne,109,53932,5,4,0,4,0
2020-05-27,Ventura,111,848112,1548,1065,11,1076,28
2020-05-27,Yolo,113,214977,220,204,0,204,22
2020-05-27,Yuba,115,75493,28,24,0,24,1
2020-05-26,Alameda,001,1643700,3536,2956,6,2962,92
2020-05-26,Alpine,003,1148,1,1,0,1,0
2020-05-26,Amador,005,37829,10,10,0,10,0
2020-05-26,Butte,007,227075,66,37,1,38,0
2020-05-26,Calaveras,009,45235,15,13,0,13,0
2020-05-26,Colusa,011,21464,8,4,0,4,0
2020-05-26,Contra Costa,013,1133247,1572,1352,1,1353,37
2020-05-26,Del Norte,015,27424,44,30,0,30,0
2020-05-26,El Dorado,017,186661,109,79,0,79,0
2020-05-26,Fresno,019,978130,3005,1496,44,1540,22
2020-05-26,Glenn,021,27897,16,12,0,12,0
2020-05-26,Humboldt,023,135768,108,81,0,81,2
2020-05-26,Imperial,025,180216,3010,1369,4,1373,14
2020-05-26,Inyo,027,18085,20,20,0,20,1
2020-05-26,Kern,029,883053,2575,1890,6,1896,31
2020-05-26,Kings,031,150075,806,449,3,452,2
2020-05-26,Lake,033,64148,27,12,0,12,0
2020-05-26,Lassen,035,31185,9,0,2,2,0
2020-05-26,Los Angeles,037,10098052,56462,47760,20,47780,2121
2020-05-26,Madera,039,155013,209,83,1,84,2
2020-05-26,Marin,041,260295,460,424,2,426,14
2020-05-26,Mariposa,043,17540,16,16,0,16,1
2020-05-26,Mendocino,045,87422,25,20,0,20,0
2020-05-26,Merced,047,269075,363,266,0,266,7
2020-05-26,Modoc,049,8938,0,1,0,1,0
2020-05-26,Mono,051,14174,37,34,0,34,1
2020-05-26,Monterey,053,433212,575,424,0,424,8
2020-05-26,Napa,055,140530,131,109,0,109,3
2020-05-26,Nevada,057,99092,43,41,1,42,1
2020-05-26,Orange,059,3164182,8302,5651,66,5717,115
2020-05-26,Placer,061,380077,233,188,0,188,9
2020-05-26,Plumas,063,18699,4,4,0,4,0
2020-05-26,Riverside,065,2383286,8297,6917,20,6937,284
2020-05-26,Sacramento,067,1510023,1425,1298,2,1300,50
2020-05-26,San Benito,069,59416,89,69,0,69,2
2020-05-26,San Bernardino,071,2135413,5719,4430,5,4435,175
2020-05-26,San Diego,073,3302833,7972,6884,0,6884,249
2020-05-26,San Francisco,075,870044,2574,2363,0,2363,40
2020-05-26,San Joaquin,077,732212,993,760,4,764,33
2020-05-26,San Luis Obispo,079,281455,344,260,4,264,1
2020-05-26,San Mateo,081,765935,2266,1967,3,1970,71
2020-05-26,Santa Barbara,083,443738,1697,1590,11,1601,9
2020-05-26,Santa Clara,085,1922200,3340,2659,13,2672,139
2020-05-26,Santa Cruz,087,273765,222,197,0,197,2
2020-05-26,Shasta,089,179085,55,36,0,36,4
2020-05-26,Sierra,091,2930,1,1,0,1,0
2020-05-26,Siskiyou,093,43540,8,6,0,6,0
2020-05-26,Solano,095,438530,564,470,1,471,5
2020-05-26,Sonoma,097,501317,576,509,0,509,4
2020-05-26,Stanislaus,099,539301,779,663,5,668,27
2020-05-26,Sutter,101,95872,45,39,0,39,2
2020-05-26,Tehama,103,63373,8,2,1,3,1
2020-05-26,Trinity,105,12862,6,1,2,3,0
2020-05-26,Tulare,107,460477,2416,1768,10,1778,76
2020-05-26,Tuolumne,109,53932,5,2,0,2,0
2020-05-26,Ventura,111,848112,1511,1033,8,1041,27
2020-05-26,Yolo,113,214977,214,198,0,198,22
2020-05-26,Yuba,115,75493,27,24,0,24,1
2020-05-25,Alameda,001,1643700,3443,2900,5,2905,92
2020-05-25,Alpine,003,1148,1,1,0,1,0
2020-05-25,Amador,005,37829,10,10,0,10,0
2020-05-25,Butte,007,227075,63,37,1,38,0
2020-05-25,Calaveras,009,45235,15,13,0,13,0
2020-05-25,Colusa,011,21464,7,4,0,4,0
2020-05-25,Contra Costa,013,1133247,1539,1348,1,1349,37
2020-05-25,Del Norte,015,27424,44,20,0,20,0
2020-05-25,El Dorado,017,186661,101,78,0,78,0
2020-05-25,Fresno,019,978130,2901,1496,42,1538,22
2020-05-25,Glenn,021,27897,16,12,0,12,0
2020-05-25,Humboldt,023,135768,107,81,0,81,2
2020-05-25,Imperial,025,180216,2799,1369,4,1373,14
2020-05-25,Inyo,027,18085,19,20,0,20,1
2020-05-25,Kern,029,883053,2504,1890,6,1896,31
2020-05-25,Kings,031,150075,776,447,3,450,2
2020-05-25,Lake,033,64148,25,13,0,13,0
2020-05-25,Lassen,035,31185,9,0,2,2,0
2020-05-25,Los Angeles,037,10098052,54652,45952,19,45971,2094
2020-05-25,Madera,039,155013,196,83,1,84,2
2020-05-25,Marin,041,260295,442,415,2,417,14
2020-05-25,Mariposa,043,17540,16,15,0,15,1
2020-05-25,Mendocino,045,87422,22,19,0,19,0
2020-05-25,Merced,047,269075,356,262,0,262,6
2020-05-25,Modoc,049,8938,0,1,0,1,0
2020-05-25,Mono,051,14174,37,34,0,34,1
2020-05-25,Monterey,053,433212,545,418,0,418,8
2020-05-25,Napa,055,140530,131,107,0,107,3
2020-05-25,Nevada,057,99092,43,41,1,42,1
2020-05-25,Orange,059,3164182,8080,5601,65,5666,115
2020-05-25,Placer,061,380077,229,186,0,186,9
2020-05-25,Plumas,063,18699,4,4,0,4,0
2020-05-25,Riverside,065,2383286,8066,6900,20,6920,284
2020-05-25,Sacramento,067,1510023,1405,1290,1,1291,50
2020-05-25,San Benito,069,59416,88,70,0,70,2
2020-05-25,San Bernardino,071,2135413,5529,4393,4,4397,175
2020-05-25,San Diego,073,3302833,7796,6799,0,6799,249
2020-05-25,San Francisco,075,870044,2537,2358,0,2358,40
2020-05-25,San Joaquin,077,732212,967,760,4,764,33
2020-05-25,San Luis Obispo,079,281455,341,260,4,264,1
2020-05-25,San Mateo,081,765935,2229,1938,3,1941,71
2020-05-25,Santa Barbara,083,443738,1687,1590,11,1601,9
2020-05-25,Santa Clara,085,1922200,3307,2647,13,2660,139
2020-05-25,Santa Cruz,087,273765,220,191,0,191,2
2020-05-25,Shasta,089,179085,54,36,0,36,4
2020-05-25,Sierra,091,2930,1,1,0,1,0
2020-05-25,Siskiyou,093,43540,8,6,0,6,0
2020-05-25,Solano,095,438530,550,437,1,438,5
2020-05-25,Sonoma,097,501317,564,496,0,496,4
2020-05-25,Stanislaus,099,539301,749,651,5,656,27
2020-05-25,Sutter,101,95872,45,38,0,38,2
2020-05-25,Tehama,103,63373,7,2,1,3,1
2020-05-25,Trinity,105,12862,6,1,2,3,0
2020-05-25,Tulare,107,460477,2352,1747,10,1757,76
2020-05-25,Tuolumne,109,53932,5,2,0,2,0
2020-05-25,Ventura,111,848112,1470,1020,8,1028,27
2020-05-25,Yolo,113,214977,212,197,0,197,22
2020-05-25,Yuba,115,75493,26,24,0,24,1
2020-05-24,Alameda,001,1643700,3370,2830,5,2835,92
2020-05-24,Alpine,003,1148,1,1,0,1,0
2020-05-24,Amador,005,37829,10,9,0,9,0
2020-05-24,Butte,007,227075,61,35,1,36,0
2020-05-24,Calaveras,009,45235,15,13,0,13,0
2020-05-24,Colusa,011,21464,7,4,0,4,0
2020-05-24,Contra Costa,013,1133247,1511,1325,1,1326,37
2020-05-24,Del Norte,015,27424,43,16,0,16,0
2020-05-24,El Dorado,017,186661,100,76,0,76,0
2020-05-24,Fresno,019,978130,2834,1455,41,1496,22
2020-05-24,Glenn,021,27897,15,12,0,12,0
2020-05-24,Humboldt,023,135768,107,81,0,81,2
2020-05-24,Imperial,025,180216,2673,1369,4,1373,14
2020-05-24,Inyo,027,18085,19,20,0,20,1
2020-05-24,Kern,029,883053,2431,1861,5,1866,31
2020-05-24,Kings,031,150075,765,446,3,449,2
2020-05-24,Lake,033,64148,24,12,0,12,0
2020-05-24,Lassen,035,31185,8,0,2,2,0
2020-05-24,Los Angeles,037,10098052,53637,44954,19,44973,2085
2020-05-24,Madera,039,155013,190,83,1,84,2
2020-05-24,Marin,041,260295,440,401,2,403,14
2020-05-24,Mariposa,043,17540,16,15,0,15,1
2020-05-24,Mendocino,045,87422,21,19,0,19,0
2020-05-24,Merced,047,269075,355,258,0,258,6
2020-05-24,Modoc,049,8938,0,0,0,0,0
2020-05-24,Mono,051,14174,37,34,0,34,1
2020-05-24,Monterey,053,433212,517,405,0,405,8
2020-05-24,Napa,055,140530,129,104,0,104,3
2020-05-24,Nevada,057,99092,43,41,1,42,1
2020-05-24,Orange,059,3164182,7926,5439,64,5503,113
2020-05-24,Placer,061,380077,221,184,0,184,9
2020-05-24,Plumas,063,18699,4,4,0,4,0
2020-05-24,Riverside,065,2383286,7925,6571,20,6591,284
2020-05-24,Sacramento,067,1510023,1389,1283,1,1284,50
2020-05-24,San Benito,069,59416,87,67,0,67,2
2020-05-24,San Bernardino,071,2135413,5421,4262,4,4266,175
2020-05-24,San Diego,073,3302833,7653,6703,0,6703,249
2020-05-24,San Francisco,075,870044,2513,2318,0,2318,40
2020-05-24,San Joaquin,077,732212,948,760,4,764,33
2020-05-24,San Luis Obispo,079,281455,339,257,4,261,1
2020-05-24,San Mateo,081,765935,2194,1925,3,1928,71
2020-05-24,Santa Barbara,083,443738,1675,1573,11,1584,9
2020-05-24,Santa Clara,085,1922200,3287,2623,13,2636,139
2020-05-24,Santa Cruz,087,273765,217,185,0,185,2
2020-05-24,Shasta,089,179085,53,36,0,36,4
2020-05-24,Sierra,091,2930,1,1,0,1,0
2020-05-24,Siskiyou,093,43540,7,6,0,6,0
2020-05-24,Solano,095,438530,542,436,0,436,5
2020-05-24,Sonoma,097,501317,553,485,0,485,4
2020-05-24,Stanislaus,099,539301,729,634,5,639,27
2020-05-24,Sutter,101,95872,45,38,0,38,2
2020-05-24,Tehama,103,63373,5,2,1,3,1
2020-05-24,Trinity,105,12862,6,1,2,3,0
2020-05-24,Tulare,107,460477,2306,1684,10,1694,74
2020-05-24,Tuolumne,109,53932,5,2,0,2,0
2020-05-24,Ventura,111,848112,1458,982,8,990,27
2020-05-24,Yolo,113,214977,210,192,0,192,22
2020-05-24,Yuba,115,75493,26,24,0,24,1
2020-05-23,Alameda,001,1643700,3329,2783,5,2788,91
2020-05-23,Alpine,003,1148,1,1,0,1,0
2020-05-23,Amador,005,37829,10,9,0,9,0
2020-05-23,Butte,007,227075,60,34,1,35,0
2020-05-23,Calaveras,009,45235,15,13,0,13,0
2020-05-23,Colusa,011,21464,7,4,0,4,0
2020-05-23,Contra Costa,013,1133247,1500,1302,1,1303,36
2020-05-23,Del Norte,015,27424,43,10,0,10,0
2020-05-23,El Dorado,017,186661,100,74,0,74,0
2020-05-23,Fresno,019,978130,2814,1447,41,1488,21
2020-05-23,Glenn,021,27897,15,12,0,12,0
2020-05-23,Humboldt,023,135768,105,80,0,80,2
2020-05-23,Imperial,025,180216,2585,1283,4,1287,14
2020-05-23,Inyo,027,18085,19,20,0,20,1
2020-05-23,Kern,029,883053,2388,1806,5,1811,31
2020-05-23,Kings,031,150075,761,444,3,447,2
2020-05-23,Lake,033,64148,23,10,0,10,0
2020-05-23,Lassen,035,31185,8,0,2,2,0
2020-05-23,Los Angeles,037,10098052,53095,44029,19,44048,2069
2020-05-23,Madera,039,155013,186,83,1,84,2
2020-05-23,Marin,041,260295,440,393,1,394,14
2020-05-23,Mariposa,043,17540,16,15,0,15,1
2020-05-23,Mendocino,045,87422,21,13,0,13,0
2020-05-23,Merced,047,269075,352,247,0,247,6
2020-05-23,Modoc,049,8938,0,0,0,0,0
2020-05-23,Mono,051,14174,36,34,0,34,1
2020-05-23,Monterey,053,433212,503,397,0,397,8
2020-05-23,Napa,055,140530,125,101,0,101,3
2020-05-23,Nevada,057,99092,43,41,1,42,1
2020-05-23,Orange,059,3164182,7767,5313,63,5376,113
2020-05-23,Placer,061,380077,215,184,0,184,9
2020-05-23,Plumas,063,18699,4,4,0,4,0
2020-05-23,Riverside,065,2383286,7834,6460,20,6480,284
2020-05-23,Sacramento,067,1510023,1373,1275,1,1276,50
2020-05-23,San Benito,069,59416,82,67,0,67,2
2020-05-23,San Bernardino,071,2135413,5327,4172,4,4176,175
2020-05-23,San Diego,073,3302833,7562,6561,0,6561,249
2020-05-23,San Francisco,075,870044,2494,2312,0,2312,40
2020-05-23,San Joaquin,077,732212,933,759,4,763,33
2020-05-23,San Luis Obispo,079,281455,335,256,4,260,1
2020-05-23,San Mateo,081,765935,2166,1862,3,1865,71
2020-05-23,Santa Barbara,083,443738,1667,1566,11,1577,9
2020-05-23,Santa Clara,085,1922200,3273,2593,12,2605,139
2020-05-23,Santa Cruz,087,273765,215,177,0,177,2
2020-05-23,Shasta,089,179085,53,35,0,35,4
2020-05-23,Sierra,091,2930,1,1,0,1,0
2020-05-23,Siskiyou,093,43540,7,6,0,6,0
2020-05-23,Solano,095,438530,537,435,0,435,5
2020-05-23,Sonoma,097,501317,539,462,0,462,4
2020-05-23,Stanislaus,099,539301,721,625,5,630,27
2020-05-23,Sutter,101,95872,44,38,0,38,2
2020-05-23,Tehama,103,63373,5,2,1,3,1
2020-05-23,Trinity,105,12862,6,1,2,3,0
2020-05-23,Tulare,107,460477,2285,1682,10,1692,73
2020-05-23,Tuolumne,109,53932,5,2,0,2,0
2020-05-23,Ventura,111,848112,1438,961,8,969,27
2020-05-23,Yolo,113,214977,209,188,0,188,22
2020-05-23,Yuba,115,75493,26,24,0,24,1
2020-05-22,Alameda,001,1643700,3275,2722,5,2727,91
2020-05-22,Alpine,003,1148,1,1,0,1,0
2020-05-22,Amador,005,37829,10,9,0,9,0
2020-05-22,Butte,007,227075,58,34,1,35,0
2020-05-22,Calaveras,009,45235,15,13,0,13,0
2020-05-22,Colusa,011,21464,7,4,0,4,0
2020-05-22,Contra Costa,013,1133247,1488,1272,1,1273,36
2020-05-22,Del Norte,015,27424,41,9,0,9,0
2020-05-22,El Dorado,017,186661,97,74,0,74,0
2020-05-22,Fresno,019,978130,2755,1399,40,1439,20
2020-05-22,Glenn,021,27897,15,12,0,12,0
2020-05-22,Humboldt,023,135768,105,80,0,80,2
2020-05-22,Imperial,025,180216,2484,1214,4,1218,14
2020-05-22,Inyo,027,18085,19,20,0,20,1
2020-05-22,Kern,029,883053,2339,1749,5,1754,28
2020-05-22,Kings,031,150075,758,428,3,431,2
2020-05-22,Lake,033,64148,22,10,0,10,0
2020-05-22,Lassen,035,31185,6,0,2,2,0
2020-05-22,Los Angeles,037,10098052,52303,43025,19,43044,2027
2020-05-22,Madera,039,155013,182,82,1,83,2
2020-05-22,Marin,041,260295,436,372,1,373,14
2020-05-22,Mariposa,043,17540,16,15,0,15,1
2020-05-22,Mendocino,045,87422,20,13,0,13,0
2020-05-22,Merced,047,269075,352,233,0,233,6
2020-05-22,Modoc,049,8938,0,0,0,0,0
2020-05-22,Mono,051,14174,36,34,0,34,1
2020-05-22,Monterey,053,433212,492,372,0,372,8
2020-05-22,Napa,055,140530,123,97,0,97,3
2020-05-22,Nevada,057,99092,42,41,1,42,1
2020-05-22,Orange,059,3164182,7570,5144,61,5205,113
2020-05-22,Placer,061,380077,215,181,0,181,9
2020-05-22,Plumas,063,18699,4,4,0,4,0
2020-05-22,Riverside,065,2383286,7719,6351,20,6371,283
2020-05-22,Sacramento,067,1510023,1357,1262,1,1263,50
2020-05-22,San Benito,069,59416,81,64,0,64,2
2020-05-22,San Bernardino,071,2135413,5252,4107,4,4111,173
2020-05-22,San Diego,073,3302833,7476,6436,0,6436,242
2020-05-22,San Francisco,075,870044,2476,2251,0,2251,40
2020-05-22,San Joaquin,077,732212,920,747,4,751,33
2020-05-22,San Luis Obispo,079,281455,335,254,4,258,1
2020-05-22,San Mateo,081,765935,2147,1847,3,1850,71
2020-05-22,Santa Barbara,083,443738,1657,1554,11,1565,9
2020-05-22,Santa Clara,085,1922200,3253,2537,12,2549,139
2020-05-22,Santa Cruz,087,273765,212,171,0,171,2
2020-05-22,Shasta,089,179085,53,34,0,34,4
2020-05-22,Sierra,091,2930,1,0,0,0,0
2020-05-22,Siskiyou,093,43540,7,6,0,6,0
2020-05-22,Solano,095,438530,534,431,0,431,4
2020-05-22,Sonoma,097,501317,535,444,0,444,4
2020-05-22,Stanislaus,099,539301,711,616,5,621,27
2020-05-22,Sutter,101,95872,44,38,0,38,2
2020-05-22,Tehama,103,63373,5,2,0,2,1
2020-05-22,Trinity,105,12862,6,1,2,3,0
2020-05-22,Tulare,107,460477,2255,1662,10,1672,73
2020-05-22,Tuolumne,109,53932,5,2,0,2,0
2020-05-22,Ventura,111,848112,1420,937,8,945,27
2020-05-22,Yolo,113,214977,207,187,0,187,22
2020-05-22,Yuba,115,75493,26,24,0,24,1
2020-05-21,Alameda,001,1643700,3210,2606,5,2611,89
2020-05-21,Alpine,003,1148,1,1,0,1,0
2020-05-21,Amador,005,37829,10,9,0,9,0
2020-05-21,Butte,007,227075,57,31,1,32,0
2020-05-21,Calaveras,009,45235,14,13,0,13,0
2020-05-21,Colusa,011,21464,7,4,0,4,0
2020-05-21,Contra Costa,013,1133247,1452,1243,1,1244,36
2020-05-21,Del Norte,015,27424,38,9,0,9,0
2020-05-21,El Dorado,017,186661,95,67,0,67,0
2020-05-21,Fresno,019,978130,2663,1362,39,1401,20
2020-05-21,Glenn,021,27897,14,12,0,12,0
2020-05-21,Humboldt,023,135768,104,79,0,79,0
2020-05-21,Imperial,025,180216,2323,1096,4,1100,14
2020-05-21,Inyo,027,18085,19,20,0,20,1
2020-05-21,Kern,029,883053,2263,1684,4,1688,27
2020-05-21,Kings,031,150075,737,417,2,419,2
2020-05-21,Lake,033,64148,17,10,0,10,0
2020-05-21,Lassen,035,31185,6,0,2,2,0
2020-05-21,Los Angeles,037,10098052,51269,42063,19,42082,1996
2020-05-21,Madera,039,155013,179,82,1,83,2
2020-05-21,Marin,041,260295,425,359,1,360,14
2020-05-21,Mariposa,043,17540,16,15,0,15,1
2020-05-21,Mendocino,045,87422,20,12,0,12,0
2020-05-21,Merced,047,269075,341,226,0,226,6
2020-05-21,Modoc,049,8938,0,0,0,0,0
2020-05-21,Mono,051,14174,36,33,0,33,1
2020-05-21,Monterey,053,433212,481,363,0,363,8
2020-05-21,Napa,055,140530,121,96,0,96,3
2020-05-21,Nevada,057,99092,42,41,1,42,1
2020-05-21,Orange,059,3164182,7367,4975,60,5035,106
2020-05-21,Placer,061,380077,208,176,0,176,8
2020-05-21,Plumas,063,18699,4,4,0,4,0
2020-05-21,Riverside,065,2383286,7533,6245,20,6265,279
2020-05-21,Sacramento,067,1510023,1344,1258,1,1259,56
2020-05-21,San Benito,069,59416,78,61,0,61,2
2020-05-21,San Bernardino,071,2135413,5105,3950,4,3954,167
2020-05-21,San Diego,073,3302833,7340,6317,0,6317,241
2020-05-21,San Francisco,075,870044,2452,2248,0,2248,37
2020-05-21,San Joaquin,077,732212,884,730,4,734,33
2020-05-21,San Luis Obispo,079,281455,335,251,3,254,1
2020-05-21,San Mateo,081,765935,2111,1791,3,1794,74
2020-05-21,Santa Barbara,083,443738,1642,1541,11,1552,10
2020-05-21,Santa Clara,085,1922200,3230,2520,12,2532,138
2020-05-21,Santa Cruz,087,273765,204,164,0,164,3
2020-05-21,Shasta,089,179085,51,34,0,34,4
2020-05-21,Sierra,091,2930,1,0,0,0,0
2020-05-21,Siskiyou,093,43540,7,6,0,6,0
2020-05-21,Solano,095,438530,525,424,0,424,4
2020-05-21,Sonoma,097,501317,517,427,0,427,4
2020-05-21,Stanislaus,099,539301,700,602,5,607,27
2020-05-21,Sutter,101,95872,43,38,0,38,2
2020-05-21,Tehama,103,63373,4,2,0,2,1
2020-05-21,Trinity,105,12862,5,1,2,3,0
2020-05-21,Tulare,107,460477,2205,1606,8,1614,73
2020-05-21,Tuolumne,109,53932,3,2,0,2,0
2020-05-21,Ventura,111,848112,1371,907,8,915,30
2020-05-21,Yolo,113,214977,204,185,0,185,22
2020-05-21,Yuba,115,75493,26,24,0,24,1
2020-05-20,Alameda,001,1643700,3137,2554,5,2559,89
2020-05-20,Alpine,003,1148,1,1,0,1,0
2020-05-20,Amador,005,37829,10,9,0,9,0
2020-05-20,Butte,007,227075,54,30,1,31,0
2020-05-20,Calaveras,009,45235,14,13,0,13,0
2020-05-20,Colusa,011,21464,7,3,0,3,0
2020-05-20,Contra Costa,013,1133247,1422,1223,1,1224,33
2020-05-20,Del Norte,015,27424,31,9,0,9,0
2020-05-20,El Dorado,017,186661,94,67,0,67,0
2020-05-20,Fresno,019,978130,2590,1329,38,1367,17
2020-05-20,Glenn,021,27897,13,12,0,12,0
2020-05-20,Humboldt,023,135768,101,73,0,73,0
2020-05-20,Imperial,025,180216,2210,1047,4,1051,14
2020-05-20,Inyo,027,18085,19,20,0,20,1
2020-05-20,Kern,029,883053,2200,1639,3,1642,27
2020-05-20,Kings,031,150075,593,403,2,405,2
2020-05-20,Lake,033,64148,17,9,0,9,0
2020-05-20,Lassen,035,31185,5,0,2,2,0
2020-05-20,Los Angeles,037,10098052,50275,40932,19,40951,1955
2020-05-20,Madera,039,155013,177,82,1,83,2
2020-05-20,Marin,041,260295,398,348,1,349,14
2020-05-20,Mariposa,043,17540,16,15,0,15,1
2020-05-20,Mendocino,045,87422,20,12,0,12,0
2020-05-20,Merced,047,269075,334,225,0,225,6
2020-05-20,Modoc,049,8938,0,0,0,0,0
2020-05-20,Mono,051,14174,36,33,0,33,1
2020-05-20,Monterey,053,433212,467,356,0,356,8
2020-05-20,Napa,055,140530,114,93,0,93,3
2020-05-20,Nevada,057,99092,42,41,1,42,1
2020-05-20,Orange,059,3164182,7159,4866,58,4924,96
2020-05-20,Placer,061,380077,206,176,0,176,8
2020-05-20,Plumas,063,18699,4,4,0,4,0
2020-05-20,Riverside,065,2383286,7390,6090,20,6110,265
2020-05-20,Sacramento,067,1510023,1334,1244,1,1245,56
2020-05-20,San Benito,069,59416,77,61,0,61,2
2020-05-20,San Bernardino,071,2135413,4977,3771,4,3775,161
2020-05-20,San Diego,073,3302833,7223,6142,0,6142,230
2020-05-20,San Francisco,075,870044,2429,2199,0,2199,37
2020-05-20,San Joaquin,077,732212,848,713,4,717,33
2020-05-20,San Luis Obispo,079,281455,328,249,3,252,1
2020-05-20,San Mateo,081,765935,2058,1739,3,1742,74
2020-05-20,Santa Barbara,083,443738,1623,1524,11,1535,10
2020-05-20,Santa Clara,085,1922200,3209,2508,11,2519,138
2020-05-20,Santa Cruz,087,273765,201,163,0,163,3
2020-05-20,Shasta,089,179085,51,34,0,34,4
2020-05-20,Sierra,091,2930,1,0,0,0,0
2020-05-20,Siskiyou,093,43540,7,6,0,6,0
2020-05-20,Solano,095,438530,520,418,0,418,4
2020-05-20,Sonoma,097,501317,508,411,0,411,4
2020-05-20,Stanislaus,099,539301,684,584,4,588,25
2020-05-20,Sutter,101,95872,43,38,0,38,2
2020-05-20,Tehama,103,63373,4,2,0,2,1
2020-05-20,Trinity,105,12862,4,1,1,2,0
2020-05-20,Tulare,107,460477,2164,1585,8,1593,71
2020-05-20,Tuolumne,109,53932,3,2,0,2,0
2020-05-20,Ventura,111,848112,1335,879,8,887,29
2020-05-20,Yolo,113,214977,201,184,0,184,22
2020-05-20,Yuba,115,75493,26,23,0,23,1
2020-05-19,Alameda,001,1643700,3060,2493,3,2496,88
2020-05-19,Alpine,003,1148,1,1,0,1,0
2020-05-19,Amador,005,37829,10,9,0,9,0
2020-05-19,Butte,007,227075,52,25,1,26,0
2020-05-19,Calaveras,009,45235,14,13,0,13,0
2020-05-19,Colusa,011,21464,5,3,0,3,0
2020-05-19,Contra Costa,013,1133247,1399,1205,1,1206,33
2020-05-19,Del Norte,015,27424,28,8,0,8,0
2020-05-19,El Dorado,017,186661,91,67,0,67,0
2020-05-19,Fresno,019,978130,2476,1288,37,1325,15
2020-05-19,Glenn,021,27897,13,12,0,12,0
2020-05-19,Humboldt,023,135768,101,72,0,72,0
2020-05-19,Imperial,025,180216,2048,1012,4,1016,14
2020-05-19,Inyo,027,18085,19,20,0,20,1
2020-05-19,Kern,029,883053,2102,1601,3,1604,26
2020-05-19,Kings,031,150075,582,393,2,395,2
2020-05-19,Lake,033,64148,14,11,0,11,0
2020-05-19,Lassen,035,31185,5,0,2,2,0
2020-05-19,Los Angeles,037,10098052,49069,39670,19,39689,1906
2020-05-19,Madera,039,155013,173,80,1,81,2
2020-05-19,Marin,041,260295,374,340,1,341,14
2020-05-19,Mariposa,043,17540,16,15,0,15,1
2020-05-19,Mendocino,045,87422,20,12,0,12,0
2020-05-19,Merced,047,269075,326,222,0,222,5
2020-05-19,Modoc,049,8938,0,0,0,0,0
2020-05-19,Mono,051,14174,36,33,0,33,1
2020-05-19,Monterey,053,433212,455,350,0,350,8
2020-05-19,Napa,055,140530,113,93,0,93,3
2020-05-19,Nevada,057,99092,42,41,1,42,1
2020-05-19,Orange,059,3164182,6965,4746,56,4802,90
2020-05-19,Placer,061,380077,204,177,0,177,8
2020-05-19,Plumas,063,18699,4,5,0,5,0
2020-05-19,Riverside,065,2383286,7230,5963,19,5982,265
2020-05-19,Sacramento,067,1510023,1320,1239,1,1240,57
2020-05-19,San Benito,069,59416,75,59,0,59,2
2020-05-19,San Bernardino,071,2135413,4827,3656,4,3660,158
2020-05-19,San Diego,073,3302833,7079,6028,0,6028,222
2020-05-19,San Francisco,075,870044,2395,2186,0,2186,37
2020-05-19,San Joaquin,077,732212,826,705,4,709,33
2020-05-19,San Luis Obispo,079,281455,327,245,3,248,1
2020-05-19,San Mateo,081,765935,2017,1704,3,1707,71
2020-05-19,Santa Barbara,083,443738,1609,1521,11,1532,10
2020-05-19,Santa Clara,085,1922200,3159,2480,11,2491,138
2020-05-19,Santa Cruz,087,273765,190,161,0,161,3
2020-05-19,Shasta,089,179085,51,34,0,34,4
2020-05-19,Sierra,091,2930,0,0,0,0,0
2020-05-19,Siskiyou,093,43540,7,6,0,6,0
2020-05-19,Solano,095,438530,506,415,0,415,4
2020-05-19,Sonoma,097,501317,497,389,0,389,4
2020-05-19,Stanislaus,099,539301,670,582,4,586,25
2020-05-19,Sutter,101,95872,43,38,0,38,2
2020-05-19,Tehama,103,63373,4,2,0,2,1
2020-05-19,Trinity,105,12862,3,1,0,1,0
2020-05-19,Tulare,107,460477,2116,1551,8,1559,68
2020-05-19,Tuolumne,109,53932,3,2,0,2,0
2020-05-19,Ventura,111,848112,1294,861,7,868,28
2020-05-19,Yolo,113,214977,199,183,0,183,22
2020-05-19,Yuba,115,75493,26,23,0,23,1
2020-05-18,Alameda,001,1643700,2987,2442,3,2445,84
2020-05-18,Alpine,003,1148,1,1,0,1,0
2020-05-18,Amador,005,37829,10,8,0,8,0
2020-05-18,Butte,007,227075,50,24,1,25,0
2020-05-18,Calaveras,009,45235,14,13,0,13,0
2020-05-18,Colusa,011,21464,5,3,0,3,0
2020-05-18,Contra Costa,013,1133247,1368,1173,1,1174,33
2020-05-18,Del Norte,015,27424,23,8,0,8,0
2020-05-18,El Dorado,017,186661,89,67,0,67,0
2020-05-18,Fresno,019,978130,2398,1244,36,1280,14
2020-05-18,Glenn,021,27897,13,11,0,11,0
2020-05-18,Humboldt,023,135768,101,70,0,70,0
2020-05-18,Imperial,025,180216,1895,767,4,771,14
2020-05-18,Inyo,027,18085,19,20,0,20,1
2020-05-18,Kern,029,883053,2053,1566,3,1569,26
2020-05-18,Kings,031,150075,551,381,2,383,2
2020-05-18,Lake,033,64148,13,9,0,9,0
2020-05-18,Lassen,035,31185,5,0,2,2,0
2020-05-18,Los Angeles,037,10098052,48048,38477,19,38496,1825
2020-05-18,Madera,039,155013,167,74,1,75,2
2020-05-18,Marin,041,260295,361,329,1,330,14
2020-05-18,Mariposa,043,17540,16,15,0,15,1
2020-05-18,Mendocino,045,87422,15,12,0,12,0
2020-05-18,Merced,047,269075,317,217,0,217,5
2020-05-18,Modoc,049,8938,0,0,0,0,0
2020-05-18,Mono,051,14174,36,33,0,33,1
2020-05-18,Monterey,053,433212,444,345,0,345,8
2020-05-18,Napa,055,140530,109,92,0,92,3
2020-05-18,Nevada,057,99092,42,41,1,42,1
2020-05-18,Orange,059,3164182,6776,4558,54,4612,88
2020-05-18,Placer,061,380077,202,176,0,176,8
2020-05-18,Plumas,063,18699,4,5,0,5,0
2020-05-18,Riverside,065,2383286,7030,5873,18,5891,253
2020-05-18,Sacramento,067,1510023,1314,1233,0,1233,57
2020-05-18,San Benito,069,59416,73,59,0,59,2
2020-05-18,San Bernardino,071,2135413,4680,3558,4,3562,156
2020-05-18,San Diego,073,3302833,6946,5948,0,5948,211
2020-05-18,San Francisco,075,870044,2372,2183,0,2183,36
2020-05-18,San Joaquin,077,732212,814,697,4,701,33
2020-05-18,San Luis Obispo,079,281455,323,243,3,246,1
2020-05-18,San Mateo,081,765935,1979,1701,3,1704,68
2020-05-18,Santa Barbara,083,443738,1598,1501,11,1512,10
2020-05-18,Santa Clara,085,1922200,3126,2468,11,2479,137
2020-05-18,Santa Cruz,087,273765,188,160,0,160,3
2020-05-18,Shasta,089,179085,50,34,0,34,4
2020-05-18,Sierra,091,2930,0,0,0,0,0
2020-05-18,Siskiyou,093,43540,7,6,0,6,0
2020-05-18,Solano,095,438530,496,398,0,398,4
2020-05-18,Sonoma,097,501317,479,387,0,387,4
2020-05-18,Stanislaus,099,539301,658,572,4,576,25
2020-05-18,Sutter,101,95872,43,38,0,38,2
2020-05-18,Tehama,103,63373,4,2,0,2,1
2020-05-18,Trinity,105,12862,3,1,0,1,0
2020-05-18,Tulare,107,460477,2072,1491,8,1499,63
2020-05-18,Tuolumne,109,53932,3,2,0,2,0
2020-05-18,Ventura,111,848112,1271,850,6,856,27
2020-05-18,Yolo,113,214977,194,183,0,183,22
2020-05-18,Yuba,115,75493,26,23,0,23,1
2020-05-17,Alameda,001,1643700,2892,2389,3,2392,83
2020-05-17,Alpine,003,1148,1,1,0,1,0
2020-05-17,Amador,005,37829,10,8,0,8,0
2020-05-17,Butte,007,227075,49,23,1,24,0
2020-05-17,Calaveras,009,45235,14,13,0,13,0
2020-05-17,Colusa,011,21464,3,3,0,3,0
2020-05-17,Contra Costa,013,1133247,1329,1155,1,1156,33
2020-05-17,Del Norte,015,27424,23,7,0,7,0
2020-05-17,El Dorado,017,186661,89,65,0,65,0
2020-05-17,Fresno,019,978130,2292,1213,33,1246,14
2020-05-17,Glenn,021,27897,13,9,0,9,0
2020-05-17,Humboldt,023,135768,94,70,0,70,0
2020-05-17,Imperial,025,180216,1747,715,4,719,14
2020-05-17,Inyo,027,18085,19,20,0,20,1
2020-05-17,Kern,029,883053,1975,1546,3,1549,26
2020-05-17,Kings,031,150075,504,356,2,358,2
2020-05-17,Lake,033,64148,13,7,0,7,0
2020-05-17,Lassen,035,31185,5,0,2,2,0
2020-05-17,Los Angeles,037,10098052,46810,37996,19,38015,1807
2020-05-17,Madera,039,155013,165,69,1,70,2
2020-05-17,Marin,041,260295,350,315,1,316,14
2020-05-17,Mariposa,043,17540,15,15,0,15,1
2020-05-17,Mendocino,045,87422,14,10,0,10,0
2020-05-17,Merced,047,269075,306,214,0,214,5
2020-05-17,Modoc,049,8938,0,0,0,0,0
2020-05-17,Mono,051,14174,36,32,0,32,1
2020-05-17,Monterey,053,433212,424,342,0,342,8
2020-05-17,Napa,055,140530,105,89,0,89,3
2020-05-17,Nevada,057,99092,42,41,1,42,1
2020-05-17,Orange,059,3164182,6597,4466,53,4519,88
2020-05-17,Placer,061,380077,197,175,0,175,8
2020-05-17,Plumas,063,18699,4,4,0,4,0
2020-05-17,Riverside,065,2383286,6857,5776,18,5794,245
2020-05-17,Sacramento,067,1510023,1303,1224,0,1224,56
2020-05-17,San Benito,069,59416,72,59,0,59,2
2020-05-17,San Bernardino,071,2135413,4530,3467,4,3471,155
2020-05-17,San Diego,073,3302833,6814,5838,0,5838,209
2020-05-17,San Francisco,075,870044,2345,2132,0,2132,36
2020-05-17,San Joaquin,077,732212,784,688,4,692,32
2020-05-17,San Luis Obispo,079,281455,321,242,3,245,1
2020-05-17,San Mateo,081,765935,1942,1680,3,1683,68
2020-05-17,Santa Barbara,083,443738,1577,1457,11,1468,10
2020-05-17,Santa Clara,085,1922200,3088,2453,11,2464,135
2020-05-17,Santa Cruz,087,273765,177,155,0,155,3
2020-05-17,Shasta,089,179085,49,34,0,34,4
2020-05-17,Sierra,091,2930,0,0,0,0,0
2020-05-17,Siskiyou,093,43540,7,6,0,6,0
2020-05-17,Solano,095,438530,484,392,0,392,4
2020-05-17,Sonoma,097,501317,458,376,0,376,4
2020-05-17,Stanislaus,099,539301,647,566,4,570,25
2020-05-17,Sutter,101,95872,42,38,0,38,2
2020-05-17,Tehama,103,63373,3,2,0,2,1
2020-05-17,Trinity,105,12862,2,1,0,1,0
2020-05-17,Tulare,107,460477,1996,1430,7,1437,63
2020-05-17,Tuolumne,109,53932,3,2,0,2,0
2020-05-17,Ventura,111,848112,1226,838,6,844,27
2020-05-17,Yolo,113,214977,192,182,0,182,22
2020-05-17,Yuba,115,75493,26,21,0,21,1
2020-05-16,Alameda,001,1643700,2842,2327,3,2330,83
2020-05-16,Alpine,003,1148,1,1,0,1,0
2020-05-16,Amador,005,37829,10,8,0,8,0
2020-05-16,Butte,007,227075,44,22,1,23,0
2020-05-16,Calaveras,009,45235,14,13,0,13,0
2020-05-16,Colusa,011,21464,3,3,0,3,0
2020-05-16,Contra Costa,013,1133247,1311,1136,1,1137,33
2020-05-16,Del Norte,015,27424,19,4,0,4,0
2020-05-16,El Dorado,017,186661,89,65,0,65,0
2020-05-16,Fresno,019,978130,2235,1177,33,1210,14
2020-05-16,Glenn,021,27897,13,9,0,9,0
2020-05-16,Humboldt,023,135768,92,69,0,69,0
2020-05-16,Imperial,025,180216,1683,712,4,716,14
2020-05-16,Inyo,027,18085,19,20,0,20,1
2020-05-16,Kern,029,883053,1939,1509,3,1512,26
2020-05-16,Kings,031,150075,494,356,2,358,2
2020-05-16,Lake,033,64148,13,7,0,7,0
2020-05-16,Lassen,035,31185,4,0,2,2,0
2020-05-16,Los Angeles,037,10098052,46233,37352,19,37371,1778
2020-05-16,Madera,039,155013,163,70,1,71,2
2020-05-16,Marin,041,260295,346,297,1,298,14
2020-05-16,Mariposa,043,17540,15,15,0,15,1
2020-05-16,Mendocino,045,87422,14,10,0,10,0
2020-05-16,Merced,047,269075,304,201,0,201,5
2020-05-16,Modoc,049,8938,0,0,0,0,0
2020-05-16,Mono,051,14174,36,32,0,32,1
2020-05-16,Monterey,053,433212,409,329,0,329,8
2020-05-16,Napa,055,140530,105,86,0,86,3
2020-05-16,Nevada,057,99092,42,41,1,42,1
2020-05-16,Orange,059,3164182,6521,4396,53,4449,87
2020-05-16,Placer,061,380077,195,174,0,174,8
2020-05-16,Plumas,063,18699,4,4,0,4,0
2020-05-16,Riverside,065,2383286,6772,5633,18,5651,243
2020-05-16,Sacramento,067,1510023,1296,1209,0,1209,55
2020-05-16,San Benito,069,59416,67,58,0,58,2
2020-05-16,San Bernardino,071,2135413,4458,3362,4,3366,155
2020-05-16,San Diego,073,3302833,6728,5664,0,5664,209
2020-05-16,San Francisco,075,870044,2322,2094,0,2094,36
2020-05-16,San Joaquin,077,732212,776,668,4,672,32
2020-05-16,San Luis Obispo,079,281455,320,240,3,243,1
2020-05-16,San Mateo,081,765935,1927,1652,3,1655,68
2020-05-16,Santa Barbara,083,443738,1566,1422,10,1432,10
2020-05-16,Santa Clara,085,1922200,3070,2420,11,2431,135
2020-05-16,Santa Cruz,087,273765,174,154,0,154,3
2020-05-16,Shasta,089,179085,49,33,0,33,4
2020-05-16,Sierra,091,2930,0,0,0,0,0
2020-05-16,Siskiyou,093,43540,7,6,0,6,0
2020-05-16,Solano,095,438530,479,392,0,392,4
2020-05-16,Sonoma,097,501317,445,356,0,356,4
2020-05-16,Stanislaus,099,539301,638,546,4,550,24
2020-05-16,Sutter,101,95872,42,35,0,35,2
2020-05-16,Tehama,103,63373,3,2,0,2,1
2020-05-16,Trinity,105,12862,2,1,0,1,0
2020-05-16,Tulare,107,460477,1978,1426,7,1433,63
2020-05-16,Tuolumne,109,53932,3,2,0,2,0
2020-05-16,Ventura,111,848112,1200,813,6,819,25
2020-05-16,Yolo,113,214977,191,181,0,181,22
2020-05-16,Yuba,115,75493,26,21,0,21,1
2020-05-15,Alameda,001,1643700,2808,2289,3,2292,83
2020-05-15,Alpine,003,1148,1,1,0,1,0
2020-05-15,Amador,005,37829,10,8,0,8,0
2020-05-15,Butte,007,227075,42,22,1,23,0
2020-05-15,Calaveras,009,45235,14,13,0,13,0
2020-05-15,Colusa,011,21464,3,3,0,3,0
2020-05-15,Contra Costa,013,1133247,1293,1106,1,1107,33
2020-05-15,Del Norte,015,27424,14,4,0,4,0
2020-05-15,El Dorado,017,186661,89,64,0,64,0
2020-05-15,Fresno,019,978130,2168,1126,33,1159,14
2020-05-15,Glenn,021,27897,13,9,0,9,0
2020-05-15,Humboldt,023,135768,91,60,0,60,0
2020-05-15,Imperial,025,180216,1599,680,0,680,14
2020-05-15,Inyo,027,18085,19,20,0,20,1
2020-05-15,Kern,029,883053,1883,1472,3,1475,25
2020-05-15,Kings,031,150075,491,347,2,349,2
2020-05-15,Lake,033,64148,13,7,0,7,0
2020-05-15,Lassen,035,31185,4,0,2,2,0
2020-05-15,Los Angeles,037,10098052,45447,36317,19,36336,1734
2020-05-15,Madera,039,155013,162,71,1,72,2
2020-05-15,Marin,041,260295,338,295,1,296,14
2020-05-15,Mariposa,043,17540,15,15,0,15,1
2020-05-15,Mendocino,045,87422,14,10,0,10,0
2020-05-15,Merced,047,269075,301,191,0,191,5
2020-05-15,Modoc,049,8938,0,0,0,0,0
2020-05-15,Mono,051,14174,36,31,0,31,1
2020-05-15,Monterey,053,433212,403,321,0,321,8
2020-05-15,Napa,055,140530,105,83,0,83,3
2020-05-15,Nevada,057,99092,42,41,1,42,1
2020-05-15,Orange,059,3164182,6348,4281,53,4334,87
2020-05-15,Placer,061,380077,193,174,0,174,8
2020-05-15,Plumas,063,18699,4,4,0,4,0
2020-05-15,Riverside,065,2383286,6658,5496,18,5514,233
2020-05-15,Sacramento,067,1510023,1286,1203,0,1203,55
2020-05-15,San Benito,069,59416,64,57,0,57,2
2020-05-15,San Bernardino,071,2135413,4380,3225,4,3229,153
2020-05-15,San Diego,073,3302833,6621,5525,0,5525,208
2020-05-15,San Francisco,075,870044,2306,2062,0,2062,36
2020-05-15,San Joaquin,077,732212,770,656,4,660,32
2020-05-15,San Luis Obispo,079,281455,318,237,3,240,1
2020-05-15,San Mateo,081,765935,1905,1612,3,1615,68
2020-05-15,Santa Barbara,083,443738,1557,1409,9,1418,10
2020-05-15,Santa Clara,085,1922200,3027,2395,10,2405,135
2020-05-15,Santa Cruz,087,273765,173,146,0,146,3
2020-05-15,Shasta,089,179085,48,33,0,33,4
2020-05-15,Sierra,091,2930,0,0,0,0,0
2020-05-15,Siskiyou,093,43540,6,5,0,5,0
2020-05-15,Solano,095,438530,475,388,0,388,4
2020-05-15,Sonoma,097,501317,437,349,0,349,4
2020-05-15,Stanislaus,099,539301,631,540,4,544,23
2020-05-15,Sutter,101,95872,41,35,0,35,2
2020-05-15,Tehama,103,63373,3,1,0,1,1
2020-05-15,Trinity,105,12862,2,1,0,1,0
2020-05-15,Tulare,107,460477,1950,1356,7,1363,61
2020-05-15,Tuolumne,109,53932,3,2,0,2,0
2020-05-15,Ventura,111,848112,1182,789,5,794,25
2020-05-15,Yolo,113,214977,190,182,0,182,22
2020-05-15,Yuba,115,75493,26,21,0,21,1
2020-05-14,Alameda,001,1643700,2715,2255,3,2258,80
2020-05-14,Alpine,003,1148,1,1,0,1,0
2020-05-14,Amador,005,37829,10,8,0,8,0
2020-05-14,Butte,007,227075,40,22,1,23,0
2020-05-14,Calaveras,009,45235,14,13,0,13,0
2020-05-14,Colusa,011,21464,3,3,0,3,0
2020-05-14,Contra Costa,013,1133247,1267,1090,1,1091,32
2020-05-14,Del Norte,015,27424,14,4,0,4,0
2020-05-14,El Dorado,017,186661,80,59,0,59,0
2020-05-14,Fresno,019,978130,2108,1038,29,1067,12
2020-05-14,Glenn,021,27897,12,8,0,8,0
2020-05-14,Humboldt,023,135768,89,59,0,59,0
2020-05-14,Imperial,025,180216,1482,652,0,652,13
2020-05-14,Inyo,027,18085,19,20,0,20,1
2020-05-14,Kern,029,883053,1841,1430,3,1433,21
2020-05-14,Kings,031,150075,475,342,2,344,1
2020-05-14,Lake,033,64148,13,7,0,7,0
2020-05-14,Lassen,035,31185,4,0,2,2,0
2020-05-14,Los Angeles,037,10098052,44272,35427,19,35446,1693
2020-05-14,Madera,039,155013,153,69,1,70,2
2020-05-14,Marin,041,260295,320,283,1,284,14
2020-05-14,Mariposa,043,17540,15,15,0,15,0
2020-05-14,Mendocino,045,87422,13,10,0,10,0
2020-05-14,Merced,047,269075,290,182,0,182,3
2020-05-14,Modoc,049,8938,0,0,0,0,0
2020-05-14,Mono,051,14174,36,31,0,31,1
2020-05-14,Monterey,053,433212,393,317,0,317,7
2020-05-14,Napa,055,140530,103,83,0,83,3
2020-05-14,Nevada,057,99092,41,41,1,42,1
2020-05-14,Orange,059,3164182,6172,4163,51,4214,83
2020-05-14,Placer,061,380077,193,172,0,172,8
2020-05-14,Plumas,063,18699,4,4,0,4,0
2020-05-14,Riverside,065,2383286,6474,5339,18,5357,224
2020-05-14,Sacramento,067,1510023,1274,1181,0,1181,55
2020-05-14,San Benito,069,59416,62,56,0,56,2
2020-05-14,San Bernardino,071,2135413,4201,3149,4,3153,149
2020-05-14,San Diego,073,3302833,6486,5393,0,5393,200
2020-05-14,San Francisco,075,870044,2273,2029,0,2029,36
2020-05-14,San Joaquin,077,732212,755,643,4,647,31
2020-05-14,San Luis Obispo,079,281455,315,236,3,239,1
2020-05-14,San Mateo,081,765935,1873,1588,3,1591,67
2020-05-14,Santa Barbara,083,443738,1545,1395,9,1404,11
2020-05-14,Santa Clara,085,1922200,3004,2380,10,2390,134
2020-05-14,Santa Cruz,087,273765,171,145,0,145,3
2020-05-14,Shasta,089,179085,48,33,0,33,4
2020-05-14,Sierra,091,2930,0,0,0,0,0
2020-05-14,Siskiyou,093,43540,6,5,0,5,0
2020-05-14,Solano,095,438530,466,372,0,372,4
2020-05-14,Sonoma,097,501317,420,333,0,333,4
2020-05-14,Stanislaus,099,539301,612,533,4,537,23
2020-05-14,Sutter,101,95872,41,34,0,34,2
2020-05-14,Tehama,103,63373,3,1,0,1,1
2020-05-14,Trinity,105,12862,2,1,0,1,0
2020-05-14,Tulare,107,460477,1911,1317,7,1324,55
2020-05-14,Tuolumne,109,53932,3,2,0,2,0
2020-05-14,Ventura,111,848112,1151,760,5,765,25
2020-05-14,Yolo,113,214977,190,180,0,180,22
2020-05-14,Yuba,115,75493,26,21,0,21,1
2020-05-13,Alameda,001,1643700,2657,2181,3,2184,78
2020-05-13,Alpine,003,1148,1,1,0,1,0
2020-05-13,Amador,005,37829,10,8,0,8,0
2020-05-13,Butte,007,227075,40,21,1,22,0
2020-05-13,Calaveras,009,45235,14,13,0,13,0
2020-05-13,Colusa,011,21464,3,3,0,3,0
2020-05-13,Contra Costa,013,1133247,1245,1082,1,1083,32
2020-05-13,Del Norte,015,27424,13,4,0,4,0
2020-05-13,El Dorado,017,186661,79,58,0,58,0
2020-05-13,Fresno,019,978130,2011,993,29,1022,10
2020-05-13,Glenn,021,27897,11,6,0,6,0
2020-05-13,Humboldt,023,135768,83,58,0,58,0
2020-05-13,Imperial,025,180216,1412,610,0,610,11
2020-05-13,Inyo,027,18085,19,20,0,20,1
2020-05-13,Kern,029,883053,1795,1390,3,1393,19
2020-05-13,Kings,031,150075,461,314,2,316,1
2020-05-13,Lake,033,64148,13,7,0,7,0
2020-05-13,Lassen,035,31185,4,0,2,2,0
2020-05-13,Los Angeles,037,10098052,42966,34574,19,34593,1643
2020-05-13,Madera,039,155013,144,69,1,70,2
2020-05-13,Marin,041,260295,307,278,1,279,14
2020-05-13,Mariposa,043,17540,15,15,0,15,0
2020-05-13,Mendocino,045,87422,13,10,0,10,0
2020-05-13,Merced,047,269075,287,176,0,176,3
2020-05-13,Modoc,049,8938,0,0,0,0,0
2020-05-13,Mono,051,14174,35,31,0,31,1
2020-05-13,Monterey,053,433212,383,309,0,309,6
2020-05-13,Napa,055,140530,103,81,0,81,3
2020-05-13,Nevada,057,99092,41,41,1,42,1
2020-05-13,Orange,059,3164182,5926,4025,49,4074,79
2020-05-13,Placer,061,380077,192,170,0,170,8
2020-05-13,Plumas,063,18699,4,4,0,4,0
2020-05-13,Riverside,065,2383286,6351,5204,18,5222,216
2020-05-13,Sacramento,067,1510023,1259,1173,0,1173,53
2020-05-13,San Benito,069,59416,62,55,0,55,2
2020-05-13,San Bernardino,071,2135413,3945,3064,3,3067,140
2020-05-13,San Diego,073,3302833,6350,5280,0,5280,194
2020-05-13,San Francisco,075,870044,2245,2004,0,2004,35
2020-05-13,San Joaquin,077,732212,734,639,3,642,31
2020-05-13,San Luis Obispo,079,281455,313,231,3,234,1
2020-05-13,San Mateo,081,765935,1841,1550,3,1553,66
2020-05-13,Santa Barbara,083,443738,1534,1382,9,1391,10
2020-05-13,Santa Clara,085,1922200,2984,2370,10,2380,132
2020-05-13,Santa Cruz,087,273765,167,142,0,142,2
2020-05-13,Shasta,089,179085,48,32,0,32,4
2020-05-13,Sierra,091,2930,0,0,0,0,0
2020-05-13,Siskiyou,093,43540,6,5,0,5,0
2020-05-13,Solano,095,438530,453,368,0,368,4
2020-05-13,Sonoma,097,501317,410,330,0,330,4
2020-05-13,Stanislaus,099,539301,603,521,4,525,15
2020-05-13,Sutter,101,95872,41,33,0,33,2
2020-05-13,Tehama,103,63373,3,1,0,1,1
2020-05-13,Trinity,105,12862,2,2,0,2,0
2020-05-13,Tulare,107,460477,1878,1283,7,1290,54
2020-05-13,Tuolumne,109,53932,3,2,0,2,0
2020-05-13,Ventura,111,848112,1120,742,5,747,25
2020-05-13,Yolo,113,214977,188,178,0,178,22
2020-05-13,Yuba,115,75493,24,19,0,19,1
2020-05-12,Alameda,001,1643700,2592,2146,3,2149,74
2020-05-12,Alpine,003,1148,1,1,0,1,0
2020-05-12,Amador,005,37829,10,8,0,8,0
2020-05-12,Butte,007,227075,38,20,1,21,0
2020-05-12,Calaveras,009,45235,13,13,0,13,0
2020-05-12,Colusa,011,21464,3,3,0,3,0
2020-05-12,Contra Costa,013,1133247,1214,1067,1,1068,32
2020-05-12,Del Norte,015,27424,10,3,0,3,0
2020-05-12,El Dorado,017,186661,76,56,0,56,0
2020-05-12,Fresno,019,978130,1927,978,27,1005,9
2020-05-12,Glenn,021,27897,10,6,0,6,0
2020-05-12,Humboldt,023,135768,80,58,0,58,0
2020-05-12,Imperial,025,180216,1281,602,0,602,9
2020-05-12,Inyo,027,18085,19,20,0,20,1
2020-05-12,Kern,029,883053,1754,1363,3,1366,18
2020-05-12,Kings,031,150075,440,302,2,304,1
2020-05-12,Lake,033,64148,13,7,0,7,0
2020-05-12,Lassen,035,31185,4,0,2,2,0
2020-05-12,Los Angeles,037,10098052,41972,33281,18,33299,1601
2020-05-12,Madera,039,155013,138,69,1,70,2
2020-05-12,Marin,041,260295,302,274,1,275,14
2020-05-12,Mariposa,043,17540,15,15,0,15,0
2020-05-12,Mendocino,045,87422,13,10,0,10,0
2020-05-12,Merced,047,269075,276,175,0,175,3
2020-05-12,Modoc,049,8938,0,0,0,0,0
2020-05-12,Mono,051,14174,35,31,0,31,1
2020-05-12,Monterey,053,433212,376,298,0,298,6
2020-05-12,Napa,055,140530,101,80,0,80,3
2020-05-12,Nevada,057,99092,41,41,1,42,1
2020-05-12,Orange,059,3164182,5743,3843,47,3890,78
2020-05-12,Placer,061,380077,191,170,0,170,8
2020-05-12,Plumas,063,18699,4,4,0,4,0
2020-05-12,Riverside,065,2383286,6229,5134,18,5152,210
2020-05-12,Sacramento,067,1510023,1239,1166,0,1166,52
2020-05-12,San Benito,069,59416,62,55,0,55,2
2020-05-12,San Bernardino,071,2135413,3793,2997,3,3000,131
2020-05-12,San Diego,073,3302833,6206,3,0,3,0
2020-05-12,San Francisco,075,870044,2210,1981,0,1981,35
2020-05-12,San Joaquin,077,732212,719,625,3,628,30
2020-05-12,San Luis Obispo,079,281455,310,226,3,229,1
2020-05-12,San Mateo,081,765935,1815,1533,3,1536,66
2020-05-12,Santa Barbara,083,443738,1503,1377,9,1386,10
2020-05-12,Santa Clara,085,1922200,2954,2362,10,2372,131
2020-05-12,Santa Cruz,087,273765,165,141,0,141,2
2020-05-12,Shasta,089,179085,47,33,0,33,4
2020-05-12,Sierra,091,2930,0,0,0,0,0
2020-05-12,Siskiyou,093,43540,6,5,0,5,0
2020-05-12,Solano,095,438530,445,361,0,361,4
2020-05-12,Sonoma,097,501317,387,308,0,308,4
2020-05-12,Stanislaus,099,539301,596,515,4,519,15
2020-05-12,Sutter,101,95872,41,33,0,33,2
2020-05-12,Tehama,103,63373,3,1,0,1,1
2020-05-12,Trinity,105,12862,2,1,0,1,0
2020-05-12,Tulare,107,460477,1846,1261,7,1268,52
2020-05-12,Tuolumne,109,53932,3,2,0,2,0
2020-05-12,Ventura,111,848112,1064,718,5,723,20
2020-05-12,Yolo,113,214977,187,176,0,176,22
2020-05-12,Yuba,115,75493,24,19,0,19,1
2020-05-11,Alameda,001,1643700,2542,2103,3,2106,71
2020-05-11,Alpine,003,1148,1,1,0,1,0
2020-05-11,Amador,005,37829,10,8,0,8,0
2020-05-11,Butte,007,227075,37,19,1,20,0
2020-05-11,Calaveras,009,45235,13,13,0,13,0
2020-05-11,Colusa,011,21464,3,3,0,3,0
2020-05-11,Contra Costa,013,1133247,1200,1052,1,1053,32
2020-05-11,Del Norte,015,27424,8,3,0,3,0
2020-05-11,El Dorado,017,186661,76,55,0,55,0
2020-05-11,Fresno,019,978130,1835,937,26,963,8
2020-05-11,Glenn,021,27897,10,6,0,6,0
2020-05-11,Humboldt,023,135768,77,56,0,56,0
2020-05-11,Imperial,025,180216,1175,562,0,562,9
2020-05-11,Inyo,027,18085,19,20,0,20,1
2020-05-11,Kern,029,883053,1702,1331,3,1334,17
2020-05-11,Kings,031,150075,417,289,1,290,1
2020-05-11,Lake,033,64148,12,7,0,7,0
2020-05-11,Lassen,035,31185,4,0,2,2,0
2020-05-11,Los Angeles,037,10098052,40793,32279,18,32297,1553
2020-05-11,Madera,039,155013,129,68,1,69,2
2020-05-11,Marin,041,260295,293,271,1,272,14
2020-05-11,Mariposa,043,17540,15,15,0,15,0
2020-05-11,Mendocino,045,87422,13,10,0,10,0
2020-05-11,Merced,047,269075,261,158,0,158,3
2020-05-11,Modoc,049,8938,0,0,0,0,0
2020-05-11,Mono,051,14174,35,30,0,30,1
2020-05-11,Monterey,053,433212,373,286,0,286,6
2020-05-11,Napa,055,140530,95,79,0,79,2
2020-05-11,Nevada,057,99092,41,41,1,42,1
2020-05-11,Orange,059,3164182,5528,3699,40,3739,77
2020-05-11,Placer,061,380077,191,170,0,170,8
2020-05-11,Plumas,063,18699,4,4,0,4,0
2020-05-11,Riverside,065,2383286,6071,5082,17,5099,203
2020-05-11,Sacramento,067,1510023,1224,1160,0,1160,52
2020-05-11,San Benito,069,59416,60,52,0,52,2
2020-05-11,San Bernardino,071,2135413,3683,2945,3,2948,124
2020-05-11,San Diego,073,3302833,6053,5067,0,5067,175
2020-05-11,San Francisco,075,870044,2163,1974,0,1974,35
2020-05-11,San Joaquin,077,732212,709,620,3,623,30
2020-05-11,San Luis Obispo,079,281455,308,224,3,227,1
2020-05-11,San Mateo,081,765935,1789,1499,2,1501,66
2020-05-11,Santa Barbara,083,443738,1492,1372,8,1380,10
2020-05-11,Santa Clara,085,1922200,2937,2340,10,2350,129
2020-05-11,Santa Cruz,087,273765,162,140,0,140,2
2020-05-11,Shasta,089,179085,47,31,0,31,4
2020-05-11,Sierra,091,2930,0,0,0,0,0
2020-05-11,Siskiyou,093,43540,6,5,0,5,0
2020-05-11,Solano,095,438530,440,354,0,354,4
2020-05-11,Sonoma,097,501317,377,303,0,303,3
2020-05-11,Stanislaus,099,539301,586,507,4,511,14
2020-05-11,Sutter,101,95872,40,32,0,32,2
2020-05-11,Tehama,103,63373,3,1,0,1,1
2020-05-11,Trinity,105,12862,2,1,0,1,0
2020-05-11,Tulare,107,460477,1797,1203,7,1210,49
2020-05-11,Tuolumne,109,53932,3,2,0,2,0
2020-05-11,Ventura,111,848112,1003,698,4,702,19
2020-05-11,Yolo,113,214977,187,174,0,174,20
2020-05-11,Yuba,115,75493,24,18,0,18,1
2020-05-10,Alameda,001,1643700,2465,2047,3,2050,71
2020-05-10,Alpine,003,1148,1,1,0,1,0
2020-05-10,Amador,005,37829,10,8,0,8,0
2020-05-10,Butte,007,227075,32,18,1,19,0
2020-05-10,Calaveras,009,45235,13,13,0,13,0
2020-05-10,Colusa,011,21464,3,3,0,3,0
2020-05-10,Contra Costa,013,1133247,1186,1046,0,1046,31
2020-05-10,Del Norte,015,27424,7,3,0,3,0
2020-05-10,El Dorado,017,186661,76,55,0,55,0
2020-05-10,Fresno,019,978130,1750,894,26,920,8
2020-05-10,Glenn,021,27897,10,6,0,6,0
2020-05-10,Humboldt,023,135768,73,56,0,56,0
2020-05-10,Imperial,025,180216,1080,509,0,509,7
2020-05-10,Inyo,027,18085,19,20,0,20,1
2020-05-10,Kern,029,883053,1651,1300,2,1302,16
2020-05-10,Kings,031,150075,404,266,1,267,1
2020-05-10,Lake,033,64148,12,7,0,7,0
2020-05-10,Lassen,035,31185,4,0,2,2,0
2020-05-10,Los Angeles,037,10098052,39535,31711,18,31729,1514
2020-05-10,Madera,039,155013,127,65,1,66,2
2020-05-10,Marin,041,260295,285,267,1,268,14
2020-05-10,Mariposa,043,17540,15,15,0,15,0
2020-05-10,Mendocino,045,87422,12,10,0,10,0
2020-05-10,Merced,047,269075,246,154,0,154,3
2020-05-10,Modoc,049,8938,0,0,0,0,0
2020-05-10,Mono,051,14174,35,27,0,27,1
2020-05-10,Monterey,053,433212,359,282,0,282,6
2020-05-10,Napa,055,140530,89,79,0,79,2
2020-05-10,Nevada,057,99092,41,41,1,42,1
2020-05-10,Orange,059,3164182,5385,3627,40,3667,76
2020-05-10,Placer,061,380077,190,168,0,168,8
2020-05-10,Plumas,063,18699,4,4,0,4,0
2020-05-10,Riverside,065,2383286,5949,4951,17,4968,193
2020-05-10,Sacramento,067,1510023,1208,1152,0,1152,52
2020-05-10,San Benito,069,59416,60,52,0,52,2
2020-05-10,San Bernardino,071,2135413,3585,2910,3,2913,121
2020-05-10,San Diego,073,3302833,5901,4928,0,4928,175
2020-05-10,San Francisco,075,870044,2145,1953,0,1953,35
2020-05-10,San Joaquin,077,732212,694,611,3,614,29
2020-05-10,San Luis Obispo,079,281455,305,218,3,221,1
2020-05-10,San Mateo,081,765935,1767,1463,2,1465,65
2020-05-10,Santa Barbara,083,443738,1481,1323,8,1331,10
2020-05-10,Santa Clara,085,1922200,2910,2331,10,2341,129
2020-05-10,Santa Cruz,087,273765,161,139,0,139,2
2020-05-10,Shasta,089,179085,47,31,0,31,4
2020-05-10,Sierra,091,2930,0,0,0,0,0
2020-05-10,Siskiyou,093,43540,5,5,0,5,0
2020-05-10,Solano,095,438530,430,322,0,322,4
2020-05-10,Sonoma,097,501317,367,290,0,290,3
2020-05-10,Stanislaus,099,539301,579,498,4,502,14
2020-05-10,Sutter,101,95872,37,31,0,31,2
2020-05-10,Tehama,103,63373,3,1,0,1,1
2020-05-10,Trinity,105,12862,2,1,0,1,0
2020-05-10,Tulare,107,460477,1726,1143,7,1150,47
2020-05-10,Tuolumne,109,53932,3,2,0,2,0
2020-05-10,Ventura,111,848112,945,690,2,692,19
2020-05-10,Yolo,113,214977,187,173,0,173,20
2020-05-10,Yuba,115,75493,23,17,0,17,1
2020-05-09,Alameda,001,1643700,2422,2011,3,2014,71
2020-05-09,Alpine,003,1148,1,1,0,1,0
2020-05-09,Amador,005,37829,9,8,0,8,0
2020-05-09,Butte,007,227075,31,18,1,19,0
2020-05-09,Calaveras,009,45235,13,13,0,13,0
2020-05-09,Colusa,011,21464,3,3,0,3,0
2020-05-09,Contra Costa,013,1133247,1172,1039,0,1039,31
2020-05-09,Del Norte,015,27424,7,3,0,3,0
2020-05-09,El Dorado,017,186661,73,54,0,54,0
2020-05-09,Fresno,019,978130,1712,861,25,886,8
2020-05-09,Glenn,021,27897,9,6,0,6,0
2020-05-09,Humboldt,023,135768,71,55,0,55,0
2020-05-09,Imperial,025,180216,1024,474,0,474,7
2020-05-09,Inyo,027,18085,19,20,0,20,1
2020-05-09,Kern,029,883053,1615,1262,1,1263,15
2020-05-09,Kings,031,150075,399,264,1,265,1
2020-05-09,Lake,033,64148,12,7,0,7,0
2020-05-09,Lassen,035,31185,4,0,2,2,0
2020-05-09,Los Angeles,037,10098052,38913,31268,18,31286,1499
2020-05-09,Madera,039,155013,126,61,1,62,2
2020-05-09,Marin,041,260295,284,261,1,262,14
2020-05-09,Mariposa,043,17540,15,15,0,15,0
2020-05-09,Mendocino,045,87422,12,10,0,10,0
2020-05-09,Merced,047,269075,242,153,0,153,3
2020-05-09,Modoc,049,8938,0,0,0,0,0
2020-05-09,Mono,051,14174,35,27,0,27,1
2020-05-09,Monterey,053,433212,352,273,0,273,6
2020-05-09,Napa,055,140530,88,78,0,78,2
2020-05-09,Nevada,057,99092,41,41,1,42,1
2020-05-09,Orange,059,3164182,5303,3506,39,3545,75
2020-05-09,Placer,061,380077,189,168,0,168,8
2020-05-09,Plumas,063,18699,4,4,0,4,0
2020-05-09,Riverside,065,2383286,5854,4871,17,4888,183
2020-05-09,Sacramento,067,1510023,1204,1150,0,1150,52
2020-05-09,San Benito,069,59416,59,52,0,52,2
2020-05-09,San Bernardino,071,2135413,3529,2825,3,2828,121
2020-05-09,San Diego,073,3302833,5789,4778,0,4778,175
2020-05-09,San Francisco,075,870044,2130,1944,0,1944,34
2020-05-09,San Joaquin,077,732212,685,605,3,608,28
2020-05-09,San Luis Obispo,079,281455,301,213,3,216,1
2020-05-09,San Mateo,081,765935,1748,1453,2,1455,65
2020-05-09,Santa Barbara,083,443738,1473,1245,8,1253,10
2020-05-09,Santa Clara,085,1922200,2896,2317,10,2327,128
2020-05-09,Santa Cruz,087,273765,160,138,0,138,2
2020-05-09,Shasta,089,179085,47,31,0,31,4
2020-05-09,Sierra,091,2930,0,0,0,0,0
2020-05-09,Siskiyou,093,43540,5,5,0,5,0
2020-05-09,Solano,095,438530,424,321,0,321,4
2020-05-09,Sonoma,097,501317,363,288,0,288,3
2020-05-09,Stanislaus,099,539301,571,491,4,495,12
2020-05-09,Sutter,101,95872,37,31,0,31,2
2020-05-09,Tehama,103,63373,2,1,0,1,1
2020-05-09,Trinity,105,12862,2,1,0,1,0
2020-05-09,Tulare,107,460477,1698,1083,7,1090,47
2020-05-09,Tuolumne,109,53932,3,2,0,2,0
2020-05-09,Ventura,111,848112,924,679,2,681,19
2020-05-09,Yolo,113,214977,187,172,0,172,18
2020-05-09,Yuba,115,75493,23,17,0,17,1
2020-05-08,Alameda,001,1643700,2379,1955,3,1958,70
2020-05-08,Alpine,003,1148,1,1,0,1,0
2020-05-08,Amador,005,37829,9,8,0,8,0
2020-05-08,Butte,007,227075,31,18,1,19,0
2020-05-08,Calaveras,009,45235,13,13,0,13,0
2020-05-08,Colusa,011,21464,3,3,0,3,0
2020-05-08,Contra Costa,013,1133247,1160,1024,0,1024,29
2020-05-08,Del Norte,015,27424,7,3,0,3,0
2020-05-08,El Dorado,017,186661,72,54,0,54,0
2020-05-08,Fresno,019,978130,1670,838,23,861,8
2020-05-08,Glenn,021,27897,8,6,0,6,0
2020-05-08,Humboldt,023,135768,68,54,0,54,0
2020-05-08,Imperial,025,180216,979,467,0,467,7
2020-05-08,Inyo,027,18085,19,20,0,20,1
2020-05-08,Kern,029,883053,1584,1214,1,1215,13
2020-05-08,Kings,031,150075,390,236,1,237,1
2020-05-08,Lake,033,64148,12,7,0,7,0
2020-05-08,Lassen,035,31185,4,0,2,2,0
2020-05-08,Los Angeles,037,10098052,38180,30357,18,30375,1447
2020-05-08,Madera,039,155013,123,57,1,58,2
2020-05-08,Marin,041,260295,284,257,1,258,14
2020-05-08,Mariposa,043,17540,15,15,0,15,0
2020-05-08,Mendocino,045,87422,12,10,0,10,0
2020-05-08,Merced,047,269075,241,151,0,151,3
2020-05-08,Modoc,049,8938,0,0,0,0,0
2020-05-08,Mono,051,14174,32,27,0,27,1
2020-05-08,Monterey,053,433212,344,265,0,265,6
2020-05-08,Napa,055,140530,87,78,0,78,2
2020-05-08,Nevada,057,99092,41,41,1,42,1
2020-05-08,Orange,059,3164182,5157,3395,39,3434,72
2020-05-08,Placer,061,380077,187,166,0,166,8
2020-05-08,Plumas,063,18699,4,4,0,4,0
2020-05-08,Riverside,065,2383286,5754,4672,16,4688,181
2020-05-08,Sacramento,067,1510023,1199,1145,0,1145,51
2020-05-08,San Benito,069,59416,59,51,0,51,2
2020-05-08,San Bernardino,071,2135413,3481,2631,3,2634,119
2020-05-08,San Diego,073,3302833,5682,4664,0,4664,169
2020-05-08,San Francisco,075,870044,2112,1890,0,1890,33
2020-05-08,San Joaquin,077,732212,678,595,3,598,28
2020-05-08,San Luis Obispo,079,281455,298,210,3,213,1
2020-05-08,San Mateo,081,765935,1663,1423,2,1425,62
2020-05-08,Santa Barbara,083,443738,1464,1054,6,1060,8
2020-05-08,Santa Clara,085,1922200,2873,2285,10,2295,128
2020-05-08,Santa Cruz,087,273765,156,137,0,137,2
2020-05-08,Shasta,089,179085,47,31,0,31,4
2020-05-08,Sierra,091,2930,0,0,0,0,0
2020-05-08,Siskiyou,093,43540,5,5,0,5,0
2020-05-08,Solano,095,438530,419,314,0,314,4
2020-05-08,Sonoma,097,501317,358,285,0,285,3
2020-05-08,Stanislaus,099,539301,557,487,4,491,12
2020-05-08,Sutter,101,95872,37,30,0,30,2
2020-05-08,Tehama,103,63373,2,1,0,1,1
2020-05-08,Trinity,105,12862,2,0,0,0,0
2020-05-08,Tulare,107,460477,1653,1050,6,1056,43
2020-05-08,Tuolumne,109,53932,3,2,0,2,0
2020-05-08,Ventura,111,848112,906,665,2,667,19
2020-05-08,Yolo,113,214977,186,172,0,172,18
2020-05-08,Yuba,115,75493,22,16,0,16,1
2020-05-07,Alameda,001,1643700,2319,1914,3,1917,68
2020-05-07,Alpine,003,1148,1,1,0,1,0
2020-05-07,Amador,005,37829,9,8,0,8,0
2020-05-07,Butte,007,227075,31,19,1,20,0
2020-05-07,Calaveras,009,45235,13,13,0,13,0
2020-05-07,Colusa,011,21464,3,3,0,3,0
2020-05-07,Contra Costa,013,1133247,1146,1005,0,1005,29
2020-05-07,Del Norte,015,27424,6,3,0,3,0
2020-05-07,El Dorado,017,186661,71,54,0,54,0
2020-05-07,Fresno,019,978130,1584,812,22,834,8
2020-05-07,Glenn,021,27897,8,5,0,5,0
2020-05-07,Humboldt,023,135768,67,54,0,54,0
2020-05-07,Imperial,025,180216,916,442,0,442,6
2020-05-07,Inyo,027,18085,19,20,0,20,1
2020-05-07,Kern,029,883053,1540,1176,1,1177,13
2020-05-07,Kings,031,150075,367,219,1,220,1
2020-05-07,Lake,033,64148,11,7,0,7,0
2020-05-07,Lassen,035,31185,4,0,2,2,0
2020-05-07,Los Angeles,037,10098052,37059,29544,18,29562,1399
2020-05-07,Madera,039,155013,119,54,1,55,2
2020-05-07,Marin,041,260295,277,252,1,253,14
2020-05-07,Mariposa,043,17540,15,15,0,15,0
2020-05-07,Mendocino,045,87422,12,10,0,10,0
2020-05-07,Merced,047,269075,233,146,0,146,3
2020-05-07,Modoc,049,8938,0,0,0,0,0
2020-05-07,Mono,051,14174,32,26,0,26,1
2020-05-07,Monterey,053,433212,336,249,0,249,6
2020-05-07,Napa,055,140530,87,78,0,78,2
2020-05-07,Nevada,057,99092,41,41,1,42,1
2020-05-07,Orange,059,3164182,4972,3283,38,3321,69
2020-05-07,Placer,061,380077,187,165,0,165,8
2020-05-07,Plumas,063,18699,4,4,0,4,0
2020-05-07,Riverside,065,2383286,5638,4608,16,4624,170
2020-05-07,Sacramento,067,1510023,1193,1139,0,1139,50
2020-05-07,San Benito,069,59416,59,50,0,50,2
2020-05-07,San Bernardino,071,2135413,3389,2522,3,2525,115
2020-05-07,San Diego,073,3302833,5525,4431,0,4431,165
2020-05-07,San Francisco,075,870044,2081,1852,0,1852,33
2020-05-07,San Joaquin,077,732212,665,583,3,586,28
2020-05-07,San Luis Obispo,079,281455,287,209,3,212,1
2020-05-07,San Mateo,081,765935,1641,1398,2,1400,58
2020-05-07,Santa Barbara,083,443738,1437,720,5,725,8
2020-05-07,Santa Clara,085,1922200,2835,2281,10,2291,127
2020-05-07,Santa Cruz,087,273765,153,136,0,136,2
2020-05-07,Shasta,089,179085,46,31,0,31,4
2020-05-07,Sierra,091,2930,0,0,0,0,0
2020-05-07,Siskiyou,093,43540,5,5,0,5,0
2020-05-07,Solano,095,438530,413,307,0,307,4
2020-05-07,Sonoma,097,501317,346,282,0,282,3
2020-05-07,Stanislaus,099,539301,548,466,4,470,10
2020-05-07,Sutter,101,95872,37,29,0,29,2
2020-05-07,Tehama,103,63373,2,1,0,1,1
2020-05-07,Trinity,105,12862,2,0,0,0,0
2020-05-07,Tulare,107,460477,1585,1001,6,1007,41
2020-05-07,Tuolumne,109,53932,3,2,0,2,0
2020-05-07,Ventura,111,848112,882,647,1,648,19
2020-05-07,Yolo,113,214977,185,172,0,172,18
2020-05-07,Yuba,115,75493,22,16,0,16,1
2020-05-06,Alameda,001,1643700,2281,1864,3,1867,67
2020-05-06,Alpine,003,1148,1,1,0,1,0
2020-05-06,Amador,005,37829,9,8,0,8,0
2020-05-06,Butte,007,227075,30,19,1,20,0
2020-05-06,Calaveras,009,45235,13,13,0,13,0
2020-05-06,Colusa,011,21464,3,3,0,3,0
2020-05-06,Contra Costa,013,1133247,1125,990,0,990,29
2020-05-06,Del Norte,015,27424,6,3,0,3,0
2020-05-06,El Dorado,017,186661,69,53,0,53,0
2020-05-06,Fresno,019,978130,1521,773,20,793,8
2020-05-06,Glenn,021,27897,8,3,0,3,0
2020-05-06,Humboldt,023,135768,66,54,0,54,0
2020-05-06,Imperial,025,180216,848,399,0,399,6
2020-05-06,Inyo,027,18085,19,20,0,20,1
2020-05-06,Kern,029,883053,1484,1112,1,1113,12
2020-05-06,Kings,031,150075,349,208,1,209,1
2020-05-06,Lake,033,64148,11,7,0,7,0
2020-05-06,Lassen,035,31185,4,0,2,2,0
2020-05-06,Los Angeles,037,10098052,36054,28687,18,28705,1347
2020-05-06,Madera,039,155013,117,55,1,56,2
2020-05-06,Marin,041,260295,270,244,1,245,14
2020-05-06,Mariposa,043,17540,15,14,0,14,0
2020-05-06,Mendocino,045,87422,12,10,0,10,0
2020-05-06,Merced,047,269075,226,140,0,140,3
2020-05-06,Modoc,049,8938,0,0,0,0,0
2020-05-06,Mono,051,14174,32,26,0,26,1
2020-05-06,Monterey,053,433212,328,246,0,246,6
2020-05-06,Napa,055,140530,86,78,0,78,2
2020-05-06,Nevada,057,99092,41,41,1,42,1
2020-05-06,Orange,059,3164182,4788,3156,37,3193,66
2020-05-06,Placer,061,380077,184,164,0,164,8
2020-05-06,Plumas,063,18699,4,4,0,4,0
2020-05-06,Riverside,065,2383286,5494,4535,16,4551,163
2020-05-06,Sacramento,067,1510023,1187,1135,0,1135,49
2020-05-06,San Benito,069,59416,58,50,0,50,2
2020-05-06,San Bernardino,071,2135413,3267,2426,2,2428,110
2020-05-06,San Diego,073,3302833,5392,4321,0,4321,158
2020-05-06,San Francisco,075,870044,2056,1804,0,1804,32
2020-05-06,San Joaquin,077,732212,652,581,3,584,28
2020-05-06,San Luis Obispo,079,281455,284,207,3,210,1
2020-05-06,San Mateo,081,765935,1610,1348,2,1350,57
2020-05-06,Santa Barbara,083,443738,1396,565,4,569,8
2020-05-06,Santa Clara,085,1922200,2818,2270,9,2279,127
2020-05-06,Santa Cruz,087,273765,149,135,0,135,2
2020-05-06,Shasta,089,179085,45,31,0,31,4
2020-05-06,Sierra,091,2930,0,0,0,0,0
2020-05-06,Siskiyou,093,43540,5,5,0,5,0
2020-05-06,Solano,095,438530,403,300,0,300,4
2020-05-06,Sonoma,097,501317,330,269,0,269,3
2020-05-06,Stanislaus,099,539301,532,434,4,438,9
2020-05-06,Sutter,101,95872,37,29,0,29,2
2020-05-06,Tehama,103,63373,2,1,0,1,1
2020-05-06,Trinity,105,12862,2,0,0,0,0
2020-05-06,Tulare,107,460477,1537,963,6,969,40
2020-05-06,Tuolumne,109,53932,3,2,0,2,0
2020-05-06,Ventura,111,848112,855,619,1,620,19
2020-05-06,Yolo,113,214977,184,172,0,172,18
2020-05-06,Yuba,115,75493,22,15,0,15,1
2020-05-05,Alameda,001,1643700,2238,1819,3,1822,67
2020-05-05,Alpine,003,1148,1,1,0,1,0
2020-05-05,Amador,005,37829,9,8,0,8,0
2020-05-05,Butte,007,227075,29,19,1,20,0
2020-05-05,Calaveras,009,45235,13,13,0,13,0
2020-05-05,Colusa,011,21464,3,3,0,3,0
2020-05-05,Contra Costa,013,1133247,1107,976,0,976,29
2020-05-05,Del Norte,015,27424,6,3,0,3,0
2020-05-05,El Dorado,017,186661,67,54,0,54,0
2020-05-05,Fresno,019,978130,1448,726,18,744,8
2020-05-05,Glenn,021,27897,8,3,0,3,0
2020-05-05,Humboldt,023,135768,63,54,0,54,0
2020-05-05,Imperial,025,180216,793,389,0,389,6
2020-05-05,Inyo,027,18085,19,20,0,20,1
2020-05-05,Kern,029,883053,1432,1084,1,1085,11
2020-05-05,Kings,031,150075,331,187,1,188,1
2020-05-05,Lake,033,64148,10,7,0,7,0
2020-05-05,Lassen,035,31185,4,0,2,2,0
2020-05-05,Los Angeles,037,10098052,34982,27867,18,27885,1289
2020-05-05,Madera,039,155013,113,53,1,54,2
2020-05-05,Marin,041,260295,264,244,1,245,14
2020-05-05,Mariposa,043,17540,15,14,0,14,0
2020-05-05,Mendocino,045,87422,12,10,0,10,0
2020-05-05,Merced,047,269075,221,141,0,141,3
2020-05-05,Modoc,049,8938,0,0,0,0,0
2020-05-05,Mono,051,14174,32,25,0,25,1
2020-05-05,Monterey,053,433212,314,240,0,240,6
2020-05-05,Napa,055,140530,86,74,0,74,2
2020-05-05,Nevada,057,99092,41,41,1,42,1
2020-05-05,Orange,059,3164182,4664,3041,37,3078,63
2020-05-05,Placer,061,380077,184,162,0,162,8
2020-05-05,Plumas,063,18699,4,4,0,4,0
2020-05-05,Riverside,065,2383286,5384,4309,16,4325,161
2020-05-05,Sacramento,067,1510023,1180,1125,0,1125,48
2020-05-05,San Benito,069,59416,57,50,0,50,2
2020-05-05,San Bernardino,071,2135413,3174,2345,2,2347,104
2020-05-05,San Diego,073,3302833,5249,4162,0,4162,150
2020-05-05,San Francisco,075,870044,2021,1779,0,1779,31
2020-05-05,San Joaquin,077,732212,643,577,3,580,26
2020-05-05,San Luis Obispo,079,281455,282,203,3,206,1
2020-05-05,San Mateo,081,765935,1578,1335,2,1337,56
2020-05-05,Santa Barbara,083,443738,1175,541,4,545,7
2020-05-05,Santa Clara,085,1922200,2772,2249,8,2257,124
2020-05-05,Santa Cruz,087,273765,146,134,0,134,2
2020-05-05,Shasta,089,179085,44,31,0,31,4
2020-05-05,Sierra,091,2930,0,0,0,0,0
2020-05-05,Siskiyou,093,43540,5,5,0,5,0
2020-05-05,Solano,095,438530,387,299,0,299,4
2020-05-05,Sonoma,097,501317,327,263,0,263,3
2020-05-05,Stanislaus,099,539301,520,430,4,434,9
2020-05-05,Sutter,101,95872,36,29,0,29,2
2020-05-05,Tehama,103,63373,2,1,0,1,1
2020-05-05,Trinity,105,12862,2,0,0,0,0
2020-05-05,Tulare,107,460477,1439,869,6,875,40
2020-05-05,Tuolumne,109,53932,3,2,0,2,0
2020-05-05,Ventura,111,848112,831,607,1,608,19
2020-05-05,Yolo,113,214977,182,171,0,171,18
2020-05-05,Yuba,115,75493,22,15,0,15,1
2020-05-04,Alameda,001,1643700,2179,1762,3,1765,65
2020-05-04,Alpine,003,1148,1,1,0,1,0
2020-05-04,Amador,005,37829,8,8,0,8,0
2020-05-04,Butte,007,227075,28,16,1,17,0
2020-05-04,Calaveras,009,45235,13,13,0,13,0
2020-05-04,Colusa,011,21464,3,3,0,3,0
2020-05-04,Contra Costa,013,1133247,1089,949,0,949,28
2020-05-04,Del Norte,015,27424,5,3,0,3,0
2020-05-04,El Dorado,017,186661,66,51,0,51,0
2020-05-04,Fresno,019,978130,1378,680,17,697,8
2020-05-04,Glenn,021,27897,8,4,0,4,0
2020-05-04,Humboldt,023,135768,61,54,0,54,0
2020-05-04,Imperial,025,180216,741,351,0,351,6
2020-05-04,Inyo,027,18085,19,20,0,20,1
2020-05-04,Kern,029,883053,1390,1047,1,1048,8
2020-05-04,Kings,031,150075,314,153,1,154,1
2020-05-04,Lake,033,64148,9,7,0,7,0
2020-05-04,Lassen,035,31185,3,0,2,2,0
2020-05-04,Los Angeles,037,10098052,33685,26243,16,26259,1235
2020-05-04,Madera,039,155013,110,52,1,53,2
2020-05-04,Marin,041,260295,259,244,1,245,13
2020-05-04,Mariposa,043,17540,15,13,0,13,0
2020-05-04,Mendocino,045,87422,12,10,0,10,0
2020-05-04,Merced,047,269075,221,138,0,138,3
2020-05-04,Modoc,049,8938,0,0,0,0,0
2020-05-04,Mono,051,14174,32,25,0,25,1
2020-05-04,Monterey,053,433212,303,237,0,237,6
2020-05-04,Napa,055,140530,86,72,0,72,2
2020-05-04,Nevada,057,99092,41,41,1,42,1
2020-05-04,Orange,059,3164182,4526,2931,34,2965,57
2020-05-04,Placer,061,380077,182,162,0,162,8
2020-05-04,Plumas,063,18699,4,4,0,4,0
2020-05-04,Riverside,065,2383286,5290,4221,16,4237,147
2020-05-04,Sacramento,067,1510023,1170,1119,0,1119,44
2020-05-04,San Benito,069,59416,55,49,0,49,2
2020-05-04,San Bernardino,071,2135413,3034,2184,2,2186,99
2020-05-04,San Diego,073,3302833,5108,4022,0,4022,144
2020-05-04,San Francisco,075,870044,1983,1760,0,1760,31
2020-05-04,San Joaquin,077,732212,629,574,3,577,26
2020-05-04,San Luis Obispo,079,281455,279,202,3,205,1
2020-05-04,San Mateo,081,765935,1553,1313,2,1315,53
2020-05-04,Santa Barbara,083,443738,927,524,4,528,7
2020-05-04,Santa Clara,085,1922200,2757,2238,8,2246,119
2020-05-04,Santa Cruz,087,273765,145,133,0,133,2
2020-05-04,Shasta,089,179085,42,31,0,31,4
2020-05-04,Sierra,091,2930,0,0,0,0,0
2020-05-04,Siskiyou,093,43540,5,5,0,5,0
2020-05-04,Solano,095,438530,373,293,0,293,4
2020-05-04,Sonoma,097,501317,313,256,0,256,4
2020-05-04,Stanislaus,099,539301,514,422,4,426,8
2020-05-04,Sutter,101,95872,33,28,0,28,2
2020-05-04,Tehama,103,63373,2,1,0,1,1
2020-05-04,Trinity,105,12862,1,0,0,0,0
2020-05-04,Tulare,107,460477,1360,760,6,766,40
2020-05-04,Tuolumne,109,53932,3,3,0,3,0
2020-05-04,Ventura,111,848112,810,590,1,591,19
2020-05-04,Yolo,113,214977,181,171,0,171,18
2020-05-04,Yuba,115,75493,19,16,0,16,1
2020-05-03,Alameda,001,1643700,2122,1731,3,1734,64
2020-05-03,Alpine,003,1148,1,1,0,1,0
2020-05-03,Amador,005,37829,8,8,0,8,0
2020-05-03,Butte,007,227075,28,17,1,18,0
2020-05-03,Calaveras,009,45235,13,13,0,13,0
2020-05-03,Colusa,011,21464,3,3,0,3,0
2020-05-03,Contra Costa,013,1133247,1073,945,0,945,28
2020-05-03,Del Norte,015,27424,5,3,0,3,0
2020-05-03,El Dorado,017,186661,64,49,0,49,0
2020-05-03,Fresno,019,978130,1286,646,15,661,8
2020-05-03,Glenn,021,27897,7,5,0,5,0
2020-05-03,Humboldt,023,135768,60,54,0,54,0
2020-05-03,Imperial,025,180216,685,351,0,351,6
2020-05-03,Inyo,027,18085,19,20,0,20,1
2020-05-03,Kern,029,883053,1335,1025,1,1026,8
2020-05-03,Kings,031,150075,294,137,1,138,1
2020-05-03,Lake,033,64148,9,7,0,7,0
2020-05-03,Lassen,035,31185,3,0,2,2,0
2020-05-03,Los Angeles,037,10098052,32699,25708,16,25724,1210
2020-05-03,Madera,039,155013,103,46,1,47,2
2020-05-03,Marin,041,260295,254,243,1,244,13
2020-05-03,Mariposa,043,17540,15,13,0,13,0
2020-05-03,Mendocino,045,87422,12,10,0,10,0
2020-05-03,Merced,047,269075,213,134,0,134,3
2020-05-03,Modoc,049,8938,0,0,0,0,0
2020-05-03,Mono,051,14174,32,25,0,25,1
2020-05-03,Monterey,053,433212,294,235,0,235,6
2020-05-03,Napa,055,140530,86,72,0,72,2
2020-05-03,Nevada,057,99092,41,41,1,42,1
2020-05-03,Orange,059,3164182,4352,2859,33,2892,55
2020-05-03,Placer,061,380077,182,161,0,161,8
2020-05-03,Plumas,063,18699,4,4,0,4,0
2020-05-03,Riverside,065,2383286,5185,4034,16,4050,139
2020-05-03,Sacramento,067,1510023,1161,1109,0,1109,43
2020-05-03,San Benito,069,59416,55,49,0,49,2
2020-05-03,San Bernardino,071,2135413,2973,2123,2,2125,99
2020-05-03,San Diego,073,3302833,4970,3929,0,3929,142
2020-05-03,San Francisco,075,870044,1954,1692,0,1692,30
2020-05-03,San Joaquin,077,732212,622,570,3,573,26
2020-05-03,San Luis Obispo,079,281455,276,200,3,203,1
2020-05-03,San Mateo,081,765935,1525,1277,2,1279,53
2020-05-03,Santa Barbara,083,443738,568,512,4,516,7
2020-05-03,Santa Clara,085,1922200,2720,2235,8,2243,116
2020-05-03,Santa Cruz,087,273765,145,133,0,133,2
2020-05-03,Shasta,089,179085,40,31,0,31,4
2020-05-03,Sierra,091,2930,0,0,0,0,0
2020-05-03,Siskiyou,093,43540,5,5,0,5,0
2020-05-03,Solano,095,438530,363,266,0,266,4
2020-05-03,Sonoma,097,501317,304,254,0,254,4
2020-05-03,Stanislaus,099,539301,486,411,4,415,8
2020-05-03,Sutter,101,95872,31,28,0,28,2
2020-05-03,Tehama,103,63373,2,1,0,1,1
2020-05-03,Trinity,105,12862,1,0,0,0,0
2020-05-03,Tulare,107,460477,1281,736,6,742,40
2020-05-03,Tuolumne,109,53932,3,3,0,3,0
2020-05-03,Ventura,111,848112,776,583,1,584,19
2020-05-03,Yolo,113,214977,180,171,0,171,18
2020-05-03,Yuba,115,75493,19,16,0,16,1
2020-05-02,Alameda,001,1643700,2085,1678,3,1681,63
2020-05-02,Alpine,003,1148,1,1,0,1,0
2020-05-02,Amador,005,37829,8,8,0,8,0
2020-05-02,Butte,007,227075,28,17,1,18,0
2020-05-02,Calaveras,009,45235,13,13,0,13,0
2020-05-02,Colusa,011,21464,3,3,0,3,0
2020-05-02,Contra Costa,013,1133247,1055,929,0,929,28
2020-05-02,Del Norte,015,27424,5,3,0,3,0
2020-05-02,El Dorado,017,186661,64,47,0,47,0
2020-05-02,Fresno,019,978130,1260,629,14,643,8
2020-05-02,Glenn,021,27897,7,5,0,5,0
2020-05-02,Humboldt,023,135768,60,54,0,54,0
2020-05-02,Imperial,025,180216,658,345,0,345,6
2020-05-02,Inyo,027,18085,19,20,0,20,1
2020-05-02,Kern,029,883053,1309,1007,1,1008,8
2020-05-02,Kings,031,150075,291,120,1,121,1
2020-05-02,Lake,033,64148,9,7,0,7,0
2020-05-02,Lassen,035,31185,3,0,2,2,0
2020-05-02,Los Angeles,037,10098052,32170,24955,16,24971,1192
2020-05-02,Madera,039,155013,103,46,1,47,2
2020-05-02,Marin,041,260295,253,243,1,244,13
2020-05-02,Mariposa,043,17540,15,13,0,13,0
2020-05-02,Mendocino,045,87422,12,10,0,10,0
2020-05-02,Merced,047,269075,210,131,0,131,3
2020-05-02,Modoc,049,8938,0,0,0,0,0
2020-05-02,Mono,051,14174,32,25,0,25,1
2020-05-02,Monterey,053,433212,288,225,0,225,5
2020-05-02,Napa,055,140530,86,71,0,71,2
2020-05-02,Nevada,057,99092,41,41,1,42,1
2020-05-02,Orange,059,3164182,4238,2774,33,2807,52
2020-05-02,Placer,061,380077,180,150,0,150,8
2020-05-02,Plumas,063,18699,4,4,0,4,0
2020-05-02,Riverside,065,2383286,5119,3997,16,4013,137
2020-05-02,Sacramento,067,1510023,1158,1097,0,1097,43
2020-05-02,San Benito,069,59416,55,49,0,49,2
2020-05-02,San Bernardino,071,2135413,2934,2124,2,2126,99
2020-05-02,San Diego,073,3302833,4868,3844,0,3844,138
2020-05-02,San Francisco,075,870044,1931,1632,0,1632,29
2020-05-02,San Joaquin,077,732212,614,559,3,562,25
2020-05-02,San Luis Obispo,079,281455,270,193,3,196,1
2020-05-02,San Mateo,081,765935,1509,1272,2,1274,52
2020-05-02,Santa Barbara,083,443738,560,506,4,510,7
2020-05-02,Santa Clara,085,1922200,2710,2203,8,2211,115
2020-05-02,Santa Cruz,087,273765,144,131,0,131,2
2020-05-02,Shasta,089,179085,40,31,0,31,4
2020-05-02,Sierra,091,2930,0,0,0,0,0
2020-05-02,Siskiyou,093,43540,5,5,0,5,0
2020-05-02,Solano,095,438530,356,267,0,267,4
2020-05-02,Sonoma,097,501317,301,250,0,250,3
2020-05-02,Stanislaus,099,539301,478,388,4,392,8
2020-05-02,Sutter,101,95872,31,28,0,28,2
2020-05-02,Tehama,103,63373,2,1,0,1,1
2020-05-02,Trinity,105,12862,1,0,0,0,0
2020-05-02,Tulare,107,460477,1238,711,6,717,35
2020-05-02,Tuolumne,109,53932,3,3,0,3,0
2020-05-02,Ventura,111,848112,762,564,1,565,19
2020-05-02,Yolo,113,214977,180,169,0,169,17
2020-05-02,Yuba,115,75493,19,16,0,16,1
2020-05-01,Alameda,001,1643700,2048,1630,3,1633,63
2020-05-01,Alpine,003,1148,1,1,0,1,0
2020-05-01,Amador,005,37829,8,8,0,8,0
2020-05-01,Butte,007,227075,28,17,1,18,0
2020-05-01,Calaveras,009,45235,13,13,0,13,0
2020-05-01,Colusa,011,21464,3,3,0,3,0
2020-05-01,Contra Costa,013,1133247,1041,915,0,915,28
2020-05-01,Del Norte,015,27424,5,3,0,3,0
2020-05-01,El Dorado,017,186661,64,47,0,47,0
2020-05-01,Fresno,019,978130,1229,617,14,631,7
2020-05-01,Glenn,021,27897,7,4,0,4,0
2020-05-01,Humboldt,023,135768,60,54,0,54,0
2020-05-01,Imperial,025,180216,621,337,0,337,6
2020-05-01,Inyo,027,18085,19,20,0,20,1
2020-05-01,Kern,029,883053,1282,972,1,973,8
2020-05-01,Kings,031,150075,274,112,1,113,1
2020-05-01,Lake,033,64148,9,6,0,6,0
2020-05-01,Lassen,035,31185,3,0,2,2,0
2020-05-01,Los Angeles,037,10098052,31414,24306,16,24322,1155
2020-05-01,Madera,039,155013,99,46,1,47,2
2020-05-01,Marin,041,260295,253,242,1,243,13
2020-05-01,Mariposa,043,17540,15,10,0,10,0
2020-05-01,Mendocino,045,87422,12,11,0,11,0
2020-05-01,Merced,047,269075,207,131,0,131,3
2020-05-01,Modoc,049,8938,0,0,0,0,0
2020-05-01,Mono,051,14174,32,25,0,25,1
2020-05-01,Monterey,053,433212,284,222,0,222,5
2020-05-01,Napa,055,140530,86,69,0,69,2
2020-05-01,Nevada,057,99092,41,41,1,42,1
2020-05-01,Orange,059,3164182,4161,2660,31,2691,51
2020-05-01,Placer,061,380077,179,149,0,149,8
2020-05-01,Plumas,063,18699,4,4,0,4,0
2020-05-01,Riverside,065,2383286,5055,3893,16,3909,132
2020-05-01,Sacramento,067,1510023,1153,1081,0,1081,43
2020-05-01,San Benito,069,59416,55,49,0,49,2
2020-05-01,San Bernardino,071,2135413,2879,2084,2,2086,98
2020-05-01,San Diego,073,3302833,4777,3713,0,3713,134
2020-05-01,San Francisco,075,870044,1887,1552,0,1552,29
2020-05-01,San Joaquin,077,732212,610,554,3,557,25
2020-05-01,San Luis Obispo,079,281455,267,186,3,189,1
2020-05-01,San Mateo,081,765935,1487,1222,2,1224,52
2020-05-01,Santa Barbara,083,443738,554,499,3,502,7
2020-05-01,Santa Clara,085,1922200,2698,2176,8,2184,112
2020-05-01,Santa Cruz,087,273765,144,127,0,127,2
2020-05-01,Shasta,089,179085,40,31,0,31,4
2020-05-01,Sierra,091,2930,0,0,0,0,0
2020-05-01,Siskiyou,093,43540,5,5,0,5,0
2020-05-01,Solano,095,438530,348,266,0,266,4
2020-05-01,Sonoma,097,501317,298,242,0,242,3
2020-05-01,Stanislaus,099,539301,473,384,4,388,8
2020-05-01,Sutter,101,95872,31,28,0,28,2
2020-05-01,Tehama,103,63373,2,1,0,1,1
2020-05-01,Trinity,105,12862,1,0,0,0,0
2020-05-01,Tulare,107,460477,1194,685,6,691,32
2020-05-01,Tuolumne,109,53932,3,3,0,3,0
2020-05-01,Ventura,111,848112,749,556,1,557,18
2020-05-01,Yolo,113,214977,180,165,0,165,18
2020-05-01,Yuba,115,75493,19,16,0,16,1
2020-04-30,Alameda,001,1643700,1988,1599,3,1602,60
2020-04-30,Alpine,003,1148,1,1,0,1,0
2020-04-30,Amador,005,37829,8,8,0,8,0
2020-04-30,Butte,007,227075,28,16,1,17,0
2020-04-30,Calaveras,009,45235,13,13,0,13,0
2020-04-30,Colusa,011,21464,3,3,0,3,0
2020-04-30,Contra Costa,013,1133247,1019,900,0,900,25
2020-04-30,Del Norte,015,27424,4,3,0,3,0
2020-04-30,El Dorado,017,186661,64,44,0,44,0
2020-04-30,Fresno,019,978130,1163,562,11,573,7
2020-04-30,Glenn,021,27897,7,4,0,4,0
2020-04-30,Humboldt,023,135768,60,54,0,54,0
2020-04-30,Imperial,025,180216,575,322,0,322,6
2020-04-30,Inyo,027,18085,19,20,0,20,1
2020-04-30,Kern,029,883053,1250,941,1,942,8
2020-04-30,Kings,031,150075,262,87,1,88,1
2020-04-30,Lake,033,64148,9,6,0,6,0
2020-04-30,Lassen,035,31185,3,0,2,2,0
2020-04-30,Los Angeles,037,10098052,30407,23284,16,23300,1099
2020-04-30,Madera,039,155013,88,46,1,47,2
2020-04-30,Marin,041,260295,253,240,1,241,13
2020-04-30,Mariposa,043,17540,15,3,0,3,0
2020-04-30,Mendocino,045,87422,12,11,0,11,0
2020-04-30,Merced,047,269075,200,122,0,122,3
2020-04-30,Modoc,049,8938,0,0,0,0,0
2020-04-30,Mono,051,14174,31,25,0,25,1
2020-04-30,Monterey,053,433212,274,213,0,213,5
2020-04-30,Napa,055,140530,84,69,0,69,2
2020-04-30,Nevada,057,99092,41,41,1,42,1
2020-04-30,Orange,059,3164182,3938,2591,28,2619,46
2020-04-30,Placer,061,380077,178,148,0,148,8
2020-04-30,Plumas,063,18699,4,4,0,4,0
2020-04-30,Riverside,065,2383286,4955,3820,15,3835,124
2020-04-30,Sacramento,067,1510023,1147,1071,0,1071,43
2020-04-30,San Benito,069,59416,55,48,0,48,2
2020-04-30,San Bernardino,071,2135413,2677,2020,2,2022,96
2020-04-30,San Diego,073,3302833,4606,3566,0,3566,124
2020-04-30,San Francisco,075,870044,1853,1518,0,1518,26
2020-04-30,San Joaquin,077,732212,602,548,3,551,25
2020-04-30,San Luis Obispo,079,281455,264,182,3,185,1
2020-04-30,San Mateo,081,765935,1457,1194,2,1196,52
2020-04-30,Santa Barbara,083,443738,542,490,3,493,7
2020-04-30,Santa Clara,085,1922200,2658,2172,8,2180,111
2020-04-30,Santa Cruz,087,273765,143,126,0,126,2
2020-04-30,Shasta,089,179085,39,31,0,31,4
2020-04-30,Sierra,091,2930,0,0,0,0,0
2020-04-30,Siskiyou,093,43540,5,5,0,5,0
2020-04-30,Solano,095,438530,338,262,0,262,4
2020-04-30,Sonoma,097,501317,289,233,0,233,3
2020-04-30,Stanislaus,099,539301,466,378,4,382,7
2020-04-30,Sutter,101,95872,31,28,0,28,2
2020-04-30,Tehama,103,63373,1,1,0,1,1
2020-04-30,Trinity,105,12862,1,0,0,0,0
2020-04-30,Tulare,107,460477,1128,637,6,643,31
2020-04-30,Tuolumne,109,53932,3,3,0,3,0
2020-04-30,Ventura,111,848112,721,547,1,548,18
2020-04-30,Yolo,113,214977,179,164,0,164,16
2020-04-30,Yuba,115,75493,19,15,0,15,1
2020-04-29,Alameda,001,1643700,1930,1564,2,1566,60
2020-04-29,Alpine,003,1148,1,1,0,1,0
2020-04-29,Amador,005,37829,8,8,0,8,0
2020-04-29,Butte,007,227075,28,16,1,17,0
2020-04-29,Calaveras,009,45235,13,13,0,13,0
2020-04-29,Colusa,011,21464,3,3,0,3,0
2020-04-29,Contra Costa,013,1133247,1000,885,0,885,25
2020-04-29,Del Norte,015,27424,4,3,0,3,0
2020-04-29,El Dorado,017,186661,62,44,0,44,0
2020-04-29,Fresno,019,978130,1111,544,11,555,7
2020-04-29,Glenn,021,27897,7,4,0,4,0
2020-04-29,Humboldt,023,135768,60,53,0,53,0
2020-04-29,Imperial,025,180216,545,300,0,300,6
2020-04-29,Inyo,027,18085,19,20,0,20,1
2020-04-29,Kern,029,883053,1207,910,1,911,6
2020-04-29,Kings,031,150075,243,80,1,81,1
2020-04-29,Lake,033,64148,9,6,0,6,0
2020-04-29,Lassen,035,31185,3,0,2,2,0
2020-04-29,Los Angeles,037,10098052,29429,22560,15,22575,1043
2020-04-29,Madera,039,155013,86,45,1,46,2
2020-04-29,Marin,041,260295,250,234,1,235,13
2020-04-29,Mariposa,043,17540,15,1,0,1,0
2020-04-29,Mendocino,045,87422,12,11,0,11,0
2020-04-29,Merced,047,269075,193,116,0,116,3
2020-04-29,Modoc,049,8938,0,0,0,0,0
2020-04-29,Mono,051,14174,31,25,0,25,1
2020-04-29,Monterey,053,433212,266,204,0,204,5
2020-04-29,Napa,055,140530,82,68,0,68,2
2020-04-29,Nevada,057,99092,41,41,1,42,1
2020-04-29,Orange,059,3164182,3802,2421,27,2448,43
2020-04-29,Placer,061,380077,176,145,0,145,8
2020-04-29,Plumas,063,18699,4,4,0,4,0
2020-04-29,Riverside,065,2383286,4878,3700,15,3715,116
2020-04-29,Sacramento,067,1510023,1125,1055,0,1055,41
2020-04-29,San Benito,069,59416,55,48,0,48,2
2020-04-29,San Bernardino,071,2135413,2590,1975,1,1976,91
2020-04-29,San Diego,073,3302833,4464,3434,0,3434,120
2020-04-29,San Francisco,075,870044,1825,1489,0,1489,23
2020-04-29,San Joaquin,077,732212,594,540,3,543,25
2020-04-29,San Luis Obispo,079,281455,262,181,3,184,1
2020-04-29,San Mateo,081,765935,1431,1170,2,1172,50
2020-04-29,Santa Barbara,083,443738,529,477,3,480,7
2020-04-29,Santa Clara,085,1922200,2631,2147,8,2155,108
2020-04-29,Santa Cruz,087,273765,142,124,0,124,2
2020-04-29,Shasta,089,179085,38,31,0,31,4
2020-04-29,Sierra,091,2930,0,0,0,0,0
2020-04-29,Siskiyou,093,43540,5,5,0,5,0
2020-04-29,Solano,095,438530,314,252,0,252,3
2020-04-29,Sonoma,097,501317,281,230,0,230,2
2020-04-29,Stanislaus,099,539301,453,374,4,378,5
2020-04-29,Sutter,101,95872,31,28,0,28,2
2020-04-29,Tehama,103,63373,1,1,0,1,1
2020-04-29,Trinity,105,12862,1,0,0,0,0
2020-04-29,Tulare,107,460477,1055,615,5,620,30
2020-04-29,Tuolumne,109,53932,3,4,0,4,0
2020-04-29,Ventura,111,848112,697,530,1,531,18
2020-04-29,Yolo,113,214977,176,161,0,161,11
2020-04-29,Yuba,115,75493,19,15,0,15,1
2020-04-28,Alameda,001,1643700,1873,1525,2,1527,55
2020-04-28,Alpine,003,1148,1,1,0,1,0
2020-04-28,Amador,005,37829,8,8,0,8,0
2020-04-28,Butte,007,227075,28,16,1,17,0
2020-04-28,Calaveras,009,45235,13,13,0,13,0
2020-04-28,Colusa,011,21464,3,3,0,3,0
2020-04-28,Contra Costa,013,1133247,993,866,0,866,25
2020-04-28,Del Norte,015,27424,4,3,0,3,0
2020-04-28,El Dorado,017,186661,61,43,0,43,0
2020-04-28,Fresno,019,978130,1060,525,9,534,7
2020-04-28,Glenn,021,27897,5,4,0,4,0
2020-04-28,Humboldt,023,135768,59,53,0,53,0
2020-04-28,Imperial,025,180216,511,295,0,295,6
2020-04-28,Inyo,027,18085,19,20,0,20,1
2020-04-28,Kern,029,883053,1164,882,1,883,5
2020-04-28,Kings,031,150075,230,57,1,58,1
2020-04-28,Lake,033,64148,9,6,0,6,0
2020-04-28,Lassen,035,31185,3,0,2,2,0
2020-04-28,Los Angeles,037,10098052,28364,21029,15,21044,984
2020-04-28,Madera,039,155013,86,44,1,45,2
2020-04-28,Marin,041,260295,249,228,1,229,12
2020-04-28,Mariposa,043,17540,15,0,0,0,0
2020-04-28,Mendocino,045,87422,12,10,0,10,0
2020-04-28,Merced,047,269075,186,108,0,108,3
2020-04-28,Modoc,049,8938,0,0,0,0,0
2020-04-28,Mono,051,14174,31,25,0,25,1
2020-04-28,Monterey,053,433212,260,191,0,191,5
2020-04-28,Napa,055,140530,81,67,0,67,2
2020-04-28,Nevada,057,99092,41,41,1,42,1
2020-04-28,Orange,059,3164182,3637,2324,25,2349,42
2020-04-28,Placer,061,380077,166,143,0,143,8
2020-04-28,Plumas,063,18699,4,4,0,4,0
2020-04-28,Riverside,065,2383286,4783,3504,15,3519,113
2020-04-28,Sacramento,067,1510023,1110,1044,0,1044,41
2020-04-28,San Benito,069,59416,53,46,0,46,2
2020-04-28,San Bernardino,071,2135413,2513,1891,1,1892,89
2020-04-28,San Diego,073,3302833,4334,3316,0,3316,118
2020-04-28,San Francisco,075,870044,1790,1471,0,1471,23
2020-04-28,San Joaquin,077,732212,588,532,3,535,25
2020-04-28,San Luis Obispo,079,281455,255,172,3,175,1
2020-04-28,San Mateo,081,765935,1418,1129,2,1131,48
2020-04-28,Santa Barbara,083,443738,524,469,2,471,7
2020-04-28,Santa Clara,085,1922200,2597,2130,8,2138,106
2020-04-28,Santa Cruz,087,273765,142,123,0,123,2
2020-04-28,Shasta,089,179085,38,29,0,29,4
2020-04-28,Sierra,091,2930,0,0,0,0,0
2020-04-28,Siskiyou,093,43540,5,5,0,5,0
2020-04-28,Solano,095,438530,295,246,0,246,3
2020-04-28,Sonoma,097,501317,278,226,0,226,1
2020-04-28,Stanislaus,099,539301,437,330,4,334,5
2020-04-28,Sutter,101,95872,31,25,0,25,2
2020-04-28,Tehama,103,63373,1,1,0,1,1
2020-04-28,Trinity,105,12862,1,0,0,0,0
2020-04-28,Tulare,107,460477,959,579,5,584,30
2020-04-28,Tuolumne,109,53932,3,4,0,4,0
2020-04-28,Ventura,111,848112,677,517,1,518,17
2020-04-28,Yolo,113,214977,176,160,0,160,10
2020-04-28,Yuba,115,75493,19,15,0,15,1
2020-04-27,Alameda,001,1643700,1813,1494,2,1496,53
2020-04-27,Alpine,003,1148,1,1,0,1,0
2020-04-27,Amador,005,37829,8,8,0,8,0
2020-04-27,Butte,007,227075,27,16,1,17,0
2020-04-27,Calaveras,009,45235,13,13,0,13,0
2020-04-27,Colusa,011,21464,3,3,0,3,0
2020-04-27,Contra Costa,013,1133247,981,843,0,843,25
2020-04-27,Del Norte,015,27424,4,3,0,3,0
2020-04-27,El Dorado,017,186661,60,43,0,43,0
2020-04-27,Fresno,019,978130,957,504,8,512,7
2020-04-27,Glenn,021,27897,5,4,0,4,0
2020-04-27,Humboldt,023,135768,59,52,0,52,0
2020-04-27,Imperial,025,180216,481,290,0,290,6
2020-04-27,Inyo,027,18085,19,20,0,20,1
2020-04-27,Kern,029,883053,1125,865,1,866,4
2020-04-27,Kings,031,150075,207,48,1,49,1
2020-04-27,Lake,033,64148,8,6,0,6,0
2020-04-27,Lassen,035,31185,3,0,2,2,0
2020-04-27,Los Angeles,037,10098052,27349,20456,15,20471,931
2020-04-27,Madera,039,155013,84,42,1,43,2
2020-04-27,Marin,041,260295,244,227,1,228,12
2020-04-27,Mariposa,043,17540,14,0,0,0,0
2020-04-27,Mendocino,045,87422,12,10,0,10,0
2020-04-27,Merced,047,269075,183,108,0,108,3
2020-04-27,Modoc,049,8938,0,0,0,0,0
2020-04-27,Mono,051,14174,31,23,0,23,1
2020-04-27,Monterey,053,433212,253,185,0,185,4
2020-04-27,Napa,055,140530,77,64,0,64,2
2020-04-27,Nevada,057,99092,41,39,1,40,1
2020-04-27,Orange,059,3164182,3468,2198,25,2223,42
2020-04-27,Placer,061,380077,166,142,0,142,8
2020-04-27,Plumas,063,18699,4,4,0,4,0
2020-04-27,Riverside,065,2383286,4660,3381,15,3396,100
2020-04-27,Sacramento,067,1510023,1095,1035,0,1035,41
2020-04-27,San Benito,069,59416,51,45,0,45,2
2020-04-27,San Bernardino,071,2135413,2399,1742,1,1743,82
2020-04-27,San Diego,073,3302833,4208,3143,0,3143,113
2020-04-27,San Francisco,075,870044,1736,1453,0,1453,23
2020-04-27,San Joaquin,077,732212,582,522,3,525,25
2020-04-27,San Luis Obispo,079,281455,247,166,3,169,1
2020-04-27,San Mateo,081,765935,1396,1092,2,1094,46
2020-04-27,Santa Barbara,083,443738,516,466,2,468,7
2020-04-27,Santa Clara,085,1922200,2572,2104,7,2111,105
2020-04-27,Santa Cruz,087,273765,142,123,0,123,2
2020-04-27,Shasta,089,179085,38,29,0,29,4
2020-04-27,Sierra,091,2930,0,0,0,0,0
2020-04-27,Siskiyou,093,43540,5,5,0,5,0
2020-04-27,Solano,095,438530,295,222,0,222,3
2020-04-27,Sonoma,097,501317,269,220,0,220,1
2020-04-27,Stanislaus,099,539301,421,316,4,320,5
2020-04-27,Sutter,101,95872,29,26,0,26,2
2020-04-27,Tehama,103,63373,1,1,0,1,1
2020-04-27,Trinity,105,12862,1,0,0,0,0
2020-04-27,Tulare,107,460477,888,535,5,540,28
2020-04-27,Tuolumne,109,53932,3,3,0,3,0
2020-04-27,Ventura,111,848112,658,513,1,514,17
2020-04-27,Yolo,113,214977,173,160,0,160,9
2020-04-27,Yuba,115,75493,19,15,0,15,1
2020-04-26,Alameda,001,1643700,1752,1449,2,1451,52
2020-04-26,Alpine,003,1148,1,1,0,1,0
2020-04-26,Amador,005,37829,8,8,0,8,0
2020-04-26,Butte,007,227075,27,16,1,17,0
2020-04-26,Calaveras,009,45235,13,13,0,13,0
2020-04-26,Colusa,011,21464,3,3,0,3,0
2020-04-26,Contra Costa,013,1133247,965,830,0,830,25
2020-04-26,Del Norte,015,27424,3,3,0,3,0
2020-04-26,El Dorado,017,186661,58,41,0,41,0
2020-04-26,Fresno,019,978130,863,476,7,483,7
2020-04-26,Glenn,021,27897,5,4,0,4,0
2020-04-26,Humboldt,023,135768,59,53,0,53,0
2020-04-26,Imperial,025,180216,447,272,0,272,6
2020-04-26,Inyo,027,18085,19,20,0,20,1
2020-04-26,Kern,029,883053,1075,831,1,832,4
2020-04-26,Kings,031,150075,182,33,1,34,1
2020-04-26,Lake,033,64148,8,6,0,6,0
2020-04-26,Lassen,035,31185,3,0,2,2,0
2020-04-26,Los Angeles,037,10098052,26196,19570,15,19585,901
2020-04-26,Madera,039,155013,82,39,1,40,2
2020-04-26,Marin,041,260295,238,225,1,226,12
2020-04-26,Mariposa,043,17540,14,0,0,0,0
2020-04-26,Mendocino,045,87422,12,5,0,5,0
2020-04-26,Merced,047,269075,166,104,0,104,3
2020-04-26,Modoc,049,8938,0,0,0,0,0
2020-04-26,Mono,051,14174,31,23,0,23,1
2020-04-26,Monterey,053,433212,246,182,0,182,4
2020-04-26,Napa,055,140530,76,62,0,62,2
2020-04-26,Nevada,057,99092,41,37,1,38,1
2020-04-26,Orange,059,3164182,3303,2124,25,2149,40
2020-04-26,Placer,061,380077,165,141,0,141,8
2020-04-26,Plumas,063,18699,4,4,0,4,0
2020-04-26,Riverside,065,2383286,4517,3301,15,3316,95
2020-04-26,Sacramento,067,1510023,1086,1027,0,1027,41
2020-04-26,San Benito,069,59416,51,45,0,45,2
2020-04-26,San Bernardino,071,2135413,2303,1681,1,1682,82
2020-04-26,San Diego,073,3302833,4066,3045,0,3045,111
2020-04-26,San Francisco,075,870044,1697,1403,0,1403,23
2020-04-26,San Joaquin,077,732212,574,514,3,517,25
2020-04-26,San Luis Obispo,079,281455,244,165,3,168,1
2020-04-26,San Mateo,081,765935,1370,1070,2,1072,46
2020-04-26,Santa Barbara,083,443738,509,464,2,466,7
2020-04-26,Santa Clara,085,1922200,2549,2097,6,2103,102
2020-04-26,Santa Cruz,087,273765,142,116,0,116,2
2020-04-26,Shasta,089,179085,35,29,0,29,4
2020-04-26,Sierra,091,2930,0,0,0,0,0
2020-04-26,Siskiyou,093,43540,5,5,0,5,0
2020-04-26,Solano,095,438530,286,205,0,205,3
2020-04-26,Sonoma,097,501317,258,216,0,216,1
2020-04-26,Stanislaus,099,539301,406,294,4,298,4
2020-04-26,Sutter,101,95872,29,26,0,26,2
2020-04-26,Tehama,103,63373,1,1,0,1,1
2020-04-26,Trinity,105,12862,1,0,0,0,0
2020-04-26,Tulare,107,460477,829,497,5,502,28
2020-04-26,Tuolumne,109,53932,3,3,0,3,0
2020-04-26,Ventura,111,848112,640,509,1,510,17
2020-04-26,Yolo,113,214977,172,158,0,158,8
2020-04-26,Yuba,115,75493,18,15,0,15,1
2020-04-25,Alameda,001,1643700,1727,1396,2,1398,52
2020-04-25,Alpine,003,1148,1,1,0,1,0
2020-04-25,Amador,005,37829,8,8,0,8,0
2020-04-25,Butte,007,227075,26,16,1,17,0
2020-04-25,Calaveras,009,45235,13,12,0,12,0
2020-04-25,Colusa,011,21464,3,3,0,3,0
2020-04-25,Contra Costa,013,1133247,951,821,0,821,24
2020-04-25,Del Norte,015,27424,2,2,0,2,0
2020-04-25,El Dorado,017,186661,57,41,0,41,0
2020-04-25,Fresno,019,978130,831,459,6,465,7
2020-04-25,Glenn,021,27897,5,4,0,4,0
2020-04-25,Humboldt,023,135768,59,53,0,53,0
2020-04-25,Imperial,025,180216,430,232,0,232,6
2020-04-25,Inyo,027,18085,19,20,0,20,1
2020-04-25,Kern,029,883053,1044,802,1,803,4
2020-04-25,Kings,031,150075,170,33,1,34,1
2020-04-25,Lake,033,64148,6,6,0,6,0
2020-04-25,Lassen,035,31185,3,0,2,2,0
2020-04-25,Los Angeles,037,10098052,25562,19144,15,19159,881
2020-04-25,Madera,039,155013,79,39,1,40,2
2020-04-25,Marin,041,260295,238,215,1,216,12
2020-04-25,Mariposa,043,17540,14,0,0,0,0
2020-04-25,Mendocino,045,87422,11,5,0,5,0
2020-04-25,Merced,047,269075,166,103,0,103,3
2020-04-25,Modoc,049,8938,0,0,0,0,0
2020-04-25,Mono,051,14174,31,23,0,23,1
2020-04-25,Monterey,053,433212,244,173,0,173,4
2020-04-25,Napa,055,140530,76,60,0,60,2
2020-04-25,Nevada,057,99092,41,37,1,38,1
2020-04-25,Orange,059,3164182,3195,2047,25,2072,40
2020-04-25,Placer,061,380077,165,137,0,137,8
2020-04-25,Plumas,063,18699,4,4,0,4,0
2020-04-25,Riverside,065,2383286,4427,3037,15,3052,93
2020-04-25,Sacramento,067,1510023,1084,1015,0,1015,41
2020-04-25,San Benito,069,59416,51,45,0,45,2
2020-04-25,San Bernardino,071,2135413,2258,1675,1,1676,82
2020-04-25,San Diego,073,3302833,3966,2945,0,2945,111
2020-04-25,San Francisco,075,870044,1672,1341,0,1341,22
2020-04-25,San Joaquin,077,732212,567,497,3,500,24
2020-04-25,San Luis Obispo,079,281455,243,159,3,162,1
2020-04-25,San Mateo,081,765935,1352,1054,2,1056,46
2020-04-25,Santa Barbara,083,443738,502,457,2,459,7
2020-04-25,Santa Clara,085,1922200,2527,2045,5,2050,99
2020-04-25,Santa Cruz,087,273765,142,112,0,112,2
2020-04-25,Shasta,089,179085,35,29,0,29,4
2020-04-25,Sierra,091,2930,0,0,0,0,0
2020-04-25,Siskiyou,093,43540,5,5,0,5,0
2020-04-25,Solano,095,438530,282,203,0,203,3
2020-04-25,Sonoma,097,501317,254,199,0,199,1
2020-04-25,Stanislaus,099,539301,398,276,4,280,4
2020-04-25,Sutter,101,95872,29,24,0,24,2
2020-04-25,Tehama,103,63373,1,1,0,1,1
2020-04-25,Trinity,105,12862,0,0,0,0,0
2020-04-25,Tulare,107,460477,796,478,5,483,28
2020-04-25,Tuolumne,109,53932,3,2,0,2,0
2020-04-25,Ventura,111,848112,626,494,1,495,16
2020-04-25,Yolo,113,214977,172,157,0,157,8
2020-04-25,Yuba,115,75493,17,15,0,15,1
2020-04-24,Alameda,001,1643700,1696,1385,2,1387,50
2020-04-24,Alpine,003,1148,1,1,0,1,0
2020-04-24,Amador,005,37829,8,8,0,8,0
2020-04-24,Butte,007,227075,25,15,1,16,0
2020-04-24,Calaveras,009,45235,13,12,0,12,0
2020-04-24,Colusa,011,21464,3,3,0,3,0
2020-04-24,Contra Costa,013,1133247,942,806,0,806,23
2020-04-24,Del Norte,015,27424,2,2,0,2,0
2020-04-24,El Dorado,017,186661,56,41,0,41,0
2020-04-24,Fresno,019,978130,808,449,6,455,7
2020-04-24,Glenn,021,27897,5,4,0,4,0
2020-04-24,Humboldt,023,135768,59,53,0,53,0
2020-04-24,Imperial,025,180216,414,232,0,232,6
2020-04-24,Inyo,027,18085,19,20,0,20,0
2020-04-24,Kern,029,883053,1020,770,1,771,4
2020-04-24,Kings,031,150075,141,30,1,31,1
2020-04-24,Lake,033,64148,6,6,0,6,0
2020-04-24,Lassen,035,31185,3,0,2,2,0
2020-04-24,Los Angeles,037,10098052,24631,18553,15,18568,836
2020-04-24,Madera,039,155013,79,39,1,40,2
2020-04-24,Marin,041,260295,238,211,1,212,11
2020-04-24,Mariposa,043,17540,8,0,0,0,0
2020-04-24,Mendocino,045,87422,11,5,0,5,0
2020-04-24,Merced,047,269075,163,102,0,102,3
2020-04-24,Modoc,049,8938,0,0,0,0,0
2020-04-24,Mono,051,14174,30,23,0,23,1
2020-04-24,Monterey,053,433212,237,167,0,167,4
2020-04-24,Napa,055,140530,75,59,0,59,2
2020-04-24,Nevada,057,99092,41,36,1,37,1
2020-04-24,Orange,059,3164182,3088,1945,25,1970,39
2020-04-24,Placer,061,380077,163,137,0,137,8
2020-04-24,Plumas,063,18699,4,4,0,4,0
2020-04-24,Riverside,065,2383286,4346,3044,15,3059,87
2020-04-24,Sacramento,067,1510023,1078,1009,0,1009,41
2020-04-24,San Benito,069,59416,51,45,0,45,2
2020-04-24,San Bernardino,071,2135413,2223,1667,1,1668,80
2020-04-24,San Diego,073,3302833,3855,2828,0,2828,102
2020-04-24,San Francisco,075,870044,1614,1345,0,1345,22
2020-04-24,San Joaquin,077,732212,560,484,3,487,24
2020-04-24,San Luis Obispo,079,281455,240,151,3,154,1
2020-04-24,San Mateo,081,765935,1329,1004,2,1006,43
2020-04-24,Santa Barbara,083,443738,496,450,2,452,6
2020-04-24,Santa Clara,085,1922200,2484,2026,5,2031,98
2020-04-24,Santa Cruz,087,273765,138,111,0,111,2
2020-04-24,Shasta,089,179085,35,28,0,28,4
2020-04-24,Sierra,091,2930,0,0,0,0,0
2020-04-24,Siskiyou,093,43540,5,5,0,5,0
2020-04-24,Solano,095,438530,280,203,0,203,3
2020-04-24,Sonoma,097,501317,250,199,0,199,1
2020-04-24,Stanislaus,099,539301,395,273,4,277,4
2020-04-24,Sutter,101,95872,28,24,0,24,2
2020-04-24,Tehama,103,63373,1,1,0,1,1
2020-04-24,Trinity,105,12862,0,0,0,0,0
2020-04-24,Tulare,107,460477,768,459,5,464,27
2020-04-24,Tuolumne,109,53932,3,2,0,2,0
2020-04-24,Ventura,111,848112,616,489,1,490,16
2020-04-24,Yolo,113,214977,171,155,0,155,8
2020-04-24,Yuba,115,75493,16,15,0,15,1
2020-04-23,Alameda,001,1643700,1658,1336,2,1338,46
2020-04-23,Alpine,003,1148,1,1,0,1,0
2020-04-23,Amador,005,37829,8,8,0,8,0
2020-04-23,Butte,007,227075,25,15,1,16,0
2020-04-23,Calaveras,009,45235,13,12,0,12,0
2020-04-23,Colusa,011,21464,3,3,0,3,0
2020-04-23,Contra Costa,013,1133247,921,786,0,786,23
2020-04-23,Del Norte,015,27424,2,2,0,2,0
2020-04-23,El Dorado,017,186661,55,39,0,39,0
2020-04-23,Fresno,019,978130,770,426,6,432,7
2020-04-23,Glenn,021,27897,5,3,0,3,0
2020-04-23,Humboldt,023,135768,59,53,0,53,0
2020-04-23,Imperial,025,180216,393,181,0,181,4
2020-04-23,Inyo,027,18085,19,19,0,19,0
2020-04-23,Kern,029,883053,972,732,1,733,4
2020-04-23,Kings,031,150075,126,28,1,29,1
2020-04-23,Lake,033,64148,6,6,0,6,0
2020-04-23,Lassen,035,31185,3,0,2,2,0
2020-04-23,Los Angeles,037,10098052,23571,17548,14,17562,784
2020-04-23,Madera,039,155013,77,37,1,38,2
2020-04-23,Marin,041,260295,225,209,1,210,11
2020-04-23,Mariposa,043,17540,7,0,0,0,0
2020-04-23,Mendocino,045,87422,9,5,0,5,0
2020-04-23,Merced,047,269075,159,98,0,98,3
2020-04-23,Modoc,049,8938,0,0,0,0,0
2020-04-23,Mono,051,14174,30,23,0,23,1
2020-04-23,Monterey,053,433212,233,161,0,161,4
2020-04-23,Napa,055,140530,68,59,0,59,2
2020-04-23,Nevada,057,99092,41,36,1,37,1
2020-04-23,Orange,059,3164182,2910,1841,24,1865,37
2020-04-23,Placer,061,380077,160,136,0,136,8
2020-04-23,Plumas,063,18699,4,4,0,4,0
2020-04-23,Riverside,065,2383286,4232,2935,14,2949,78
2020-04-23,Sacramento,067,1510023,1066,978,0,978,41
2020-04-23,San Benito,069,59416,48,43,0,43,2
2020-04-23,San Bernardino,071,2135413,2158,1604,1,1605,79
2020-04-23,San Diego,073,3302833,3694,2645,0,2645,100
2020-04-23,San Francisco,075,870044,1589,1312,0,1312,21
2020-04-23,San Joaquin,077,732212,550,479,3,482,20
2020-04-23,San Luis Obispo,079,281455,236,146,3,149,1
2020-04-23,San Mateo,081,765935,1290,970,2,972,42
2020-04-23,Santa Barbara,083,443738,490,445,2,447,6
2020-04-23,Santa Clara,085,1922200,2449,1996,5,2001,95
2020-04-23,Santa Cruz,087,273765,137,110,0,110,2
2020-04-23,Shasta,089,179085,35,27,0,27,3
2020-04-23,Sierra,091,2930,0,0,0,0,0
2020-04-23,Siskiyou,093,43540,5,5,0,5,0
2020-04-23,Solano,095,438530,266,196,0,196,3
2020-04-23,Sonoma,097,501317,238,187,0,187,1
2020-04-23,Stanislaus,099,539301,391,254,4,258,4
2020-04-23,Sutter,101,95872,28,24,0,24,2
2020-04-23,Tehama,103,63373,1,1,0,1,1
2020-04-23,Trinity,105,12862,0,0,0,0,0
2020-04-23,Tulare,107,460477,739,440,5,445,25
2020-04-23,Tuolumne,109,53932,3,2,0,2,0
2020-04-23,Ventura,111,848112,602,479,1,480,16
2020-04-23,Yolo,113,214977,168,151,0,151,8
2020-04-23,Yuba,115,75493,16,15,0,15,1
2020-04-22,Alameda,001,1643700,1609,1275,2,1277,46
2020-04-22,Alpine,003,1148,1,1,0,1,0
2020-04-22,Amador,005,37829,8,7,0,7,0
2020-04-22,Butte,007,227075,24,15,1,16,0
2020-04-22,Calaveras,009,45235,13,12,0,12,0
2020-04-22,Colusa,011,21464,3,3,0,3,0
2020-04-22,Contra Costa,013,1133247,906,772,0,772,22
2020-04-22,Del Norte,015,27424,2,2,0,2,0
2020-04-22,El Dorado,017,186661,55,39,0,39,0
2020-04-22,Fresno,019,978130,730,388,6,394,7
2020-04-22,Glenn,021,27897,5,3,0,3,0
2020-04-22,Humboldt,023,135768,59,53,0,53,0
2020-04-22,Imperial,025,180216,382,170,0,170,3
2020-04-22,Inyo,027,18085,19,18,0,18,0
2020-04-22,Kern,029,883053,950,713,1,714,4
2020-04-22,Kings,031,150075,105,28,1,29,1
2020-04-22,Lake,033,64148,6,6,0,6,0
2020-04-22,Lassen,035,31185,3,0,2,2,0
2020-04-22,Los Angeles,037,10098052,22544,16400,14,16414,715
2020-04-22,Madera,039,155013,75,37,1,38,2
2020-04-22,Marin,041,260295,223,202,1,203,11
2020-04-22,Mariposa,043,17540,6,0,0,0,0
2020-04-22,Mendocino,045,87422,6,5,0,5,0
2020-04-22,Merced,047,269075,147,92,0,92,3
2020-04-22,Modoc,049,8938,0,0,0,0,0
2020-04-22,Mono,051,14174,29,23,0,23,1
2020-04-22,Monterey,053,433212,226,154,0,154,4
2020-04-22,Napa,055,140530,67,58,0,58,2
2020-04-22,Nevada,057,99092,41,36,1,37,1
2020-04-22,Orange,059,3164182,2816,1785,23,1808,36
2020-04-22,Placer,061,380077,158,133,0,133,8
2020-04-22,Plumas,063,18699,4,4,0,4,0
2020-04-22,Riverside,065,2383286,4128,2822,14,2836,76
2020-04-22,Sacramento,067,1510023,1061,959,0,959,36
2020-04-22,San Benito,069,59416,47,43,0,43,2
2020-04-22,San Bernardino,071,2135413,2095,1564,1,1565,74
2020-04-22,San Diego,073,3302833,3566,2493,0,2493,96
2020-04-22,San Francisco,075,870044,1552,1255,0,1255,21
2020-04-22,San Joaquin,077,732212,539,462,3,465,20
2020-04-22,San Luis Obispo,079,281455,227,142,3,145,1
2020-04-22,San Mateo,081,765935,1267,945,2,947,40
2020-04-22,Santa Barbara,083,443738,485,437,2,439,6
2020-04-22,Santa Clara,085,1922200,2433,1969,5,1974,95
2020-04-22,Santa Cruz,087,273765,133,106,0,106,2
2020-04-22,Shasta,089,179085,34,26,0,26,3
2020-04-22,Sierra,091,2930,0,0,0,0,0
2020-04-22,Siskiyou,093,43540,5,5,0,5,0
2020-04-22,Solano,095,438530,247,195,0,195,3
2020-04-22,Sonoma,097,501317,235,185,0,185,1
2020-04-22,Stanislaus,099,539301,334,247,4,251,4
2020-04-22,Sutter,101,95872,28,22,0,22,2
2020-04-22,Tehama,103,63373,1,1,0,1,1
2020-04-22,Trinity,105,12862,0,0,0,0,0
2020-04-22,Tulare,107,460477,705,425,5,430,23
2020-04-22,Tuolumne,109,53932,3,2,0,2,0
2020-04-22,Ventura,111,848112,591,465,1,466,15
2020-04-22,Yolo,113,214977,168,147,0,147,8
2020-04-22,Yuba,115,75493,16,15,0,15,1
2020-04-21,Alameda,001,1643700,1579,1234,2,1236,46
2020-04-21,Alpine,003,1148,1,1,0,1,0
2020-04-21,Amador,005,37829,8,7,0,7,0
2020-04-21,Butte,007,227075,23,15,1,16,0
2020-04-21,Calaveras,009,45235,12,12,0,12,0
2020-04-21,Colusa,011,21464,3,3,0,3,0
2020-04-21,Contra Costa,013,1133247,892,766,0,766,22
2020-04-21,Del Norte,015,27424,2,2,0,2,0
2020-04-21,El Dorado,017,186661,54,36,0,36,0
2020-04-21,Fresno,019,978130,696,372,6,378,7
2020-04-21,Glenn,021,27897,5,3,0,3,0
2020-04-21,Humboldt,023,135768,58,53,0,53,0
2020-04-21,Imperial,025,180216,362,165,0,165,2
2020-04-21,Inyo,027,18085,19,18,0,18,0
2020-04-21,Kern,029,883053,908,676,1,677,4
2020-04-21,Kings,031,150075,91,28,1,29,1
2020-04-21,Lake,033,64148,6,6,0,6,0
2020-04-21,Lassen,035,31185,3,0,2,2,0
2020-04-21,Los Angeles,037,10098052,21685,15096,14,15110,650
2020-04-21,Madera,039,155013,75,37,1,38,2
2020-04-21,Marin,041,260295,217,202,1,203,10
2020-04-21,Mariposa,043,17540,5,0,0,0,0
2020-04-21,Mendocino,045,87422,6,5,0,5,0
2020-04-21,Merced,047,269075,143,89,0,89,3
2020-04-21,Modoc,049,8938,0,0,0,0,0
2020-04-21,Mono,051,14174,29,23,0,23,1
2020-04-21,Monterey,053,433212,223,151,0,151,4
2020-04-21,Napa,055,140530,66,58,0,58,2
2020-04-21,Nevada,057,99092,41,36,1,37,1
2020-04-21,Orange,059,3164182,2693,1717,22,1739,36
2020-04-21,Placer,061,380077,156,133,0,133,8
2020-04-21,Plumas,063,18699,4,4,0,4,0
2020-04-21,Riverside,065,2383286,3996,2631,14,2645,68
2020-04-21,Sacramento,067,1510023,1051,941,0,941,33
2020-04-21,San Benito,069,59416,45,43,0,43,2
2020-04-21,San Bernardino,071,2135413,2034,1499,1,1500,71
2020-04-21,San Diego,073,3302833,3410,2436,0,2436,87
2020-04-21,San Francisco,075,870044,1522,1232,0,1232,20
2020-04-21,San Joaquin,077,732212,529,447,3,450,20
2020-04-21,San Luis Obispo,079,281455,219,134,3,137,1
2020-04-21,San Mateo,081,765935,1221,933,2,935,34
2020-04-21,Santa Barbara,083,443738,476,414,2,416,5
2020-04-21,Santa Clara,085,1922200,2383,1943,5,1948,91
2020-04-21,Santa Cruz,087,273765,131,104,0,104,2
2020-04-21,Shasta,089,179085,33,26,0,26,3
2020-04-21,Sierra,091,2930,0,0,0,0,0
2020-04-21,Siskiyou,093,43540,5,5,0,5,0
2020-04-21,Solano,095,438530,239,193,0,193,3
2020-04-21,Sonoma,097,501317,225,182,0,182,1
2020-04-21,Stanislaus,099,539301,315,235,4,239,4
2020-04-21,Sutter,101,95872,28,22,0,22,2
2020-04-21,Tehama,103,63373,1,1,0,1,1
2020-04-21,Trinity,105,12862,0,0,0,0,0
2020-04-21,Tulare,107,460477,668,410,5,415,23
2020-04-21,Tuolumne,109,53932,3,2,0,2,0
2020-04-21,Ventura,111,848112,579,455,1,456,14
2020-04-21,Yolo,113,214977,166,143,0,143,8
2020-04-21,Yuba,115,75493,16,15,0,15,1
2020-04-20,Alameda,001,1643700,1546,1181,2,1183,42
2020-04-20,Alpine,003,1148,1,1,0,1,0
2020-04-20,Amador,005,37829,8,7,0,7,0
2020-04-20,Butte,007,227075,23,15,1,16,0
2020-04-20,Calaveras,009,45235,12,12,0,12,0
2020-04-20,Colusa,011,21464,3,3,0,3,0
2020-04-20,Contra Costa,013,1133247,882,753,0,753,22
2020-04-20,Del Norte,015,27424,2,2,0,2,0
2020-04-20,El Dorado,017,186661,54,36,0,36,0
2020-04-20,Fresno,019,978130,678,356,6,362,7
2020-04-20,Glenn,021,27897,4,3,0,3,0
2020-04-20,Humboldt,023,135768,58,53,0,53,0
2020-04-20,Imperial,025,180216,343,149,0,149,2
2020-04-20,Inyo,027,18085,19,17,0,17,0
2020-04-20,Kern,029,883053,876,651,1,652,3
2020-04-20,Kings,031,150075,80,19,1,20,1
2020-04-20,Lake,033,64148,6,6,0,6,0
2020-04-20,Lassen,035,31185,3,0,2,2,0
2020-04-20,Los Angeles,037,10098052,20769,13787,14,13801,608
2020-04-20,Madera,039,155013,74,35,1,36,2
2020-04-20,Marin,041,260295,213,200,1,201,10
2020-04-20,Mariposa,043,17540,5,0,0,0,0
2020-04-20,Mendocino,045,87422,6,5,0,5,0
2020-04-20,Merced,047,269075,136,88,0,88,3
2020-04-20,Modoc,049,8938,0,0,0,0,0
2020-04-20,Mono,051,14174,29,23,0,23,1
2020-04-20,Monterey,053,433212,214,147,0,147,4
2020-04-20,Napa,055,140530,66,55,0,55,2
2020-04-20,Nevada,057,99092,41,34,1,35,1
2020-04-20,Orange,059,3164182,2609,1679,22,1701,33
2020-04-20,Placer,061,380077,155,132,0,132,8
2020-04-20,Plumas,063,18699,4,4,0,4,0
2020-04-20,Riverside,065,2383286,3871,2477,14,2491,61
2020-04-20,Sacramento,067,1510023,1041,924,0,924,32
2020-04-20,San Benito,069,59416,45,43,0,43,2
2020-04-20,San Bernardino,071,2135413,1947,1344,1,1345,63
2020-04-20,San Diego,073,3302833,3268,2327,0,2327,72
2020-04-20,San Francisco,075,870044,1490,1223,0,1223,19
2020-04-20,San Joaquin,077,732212,525,422,3,425,17
2020-04-20,San Luis Obispo,079,281455,205,132,3,135,1
2020-04-20,San Mateo,081,765935,1198,890,2,892,31
2020-04-20,Santa Barbara,083,443738,469,388,2,390,4
2020-04-20,Santa Clara,085,1922200,2352,1920,5,1925,84
2020-04-20,Santa Cruz,087,273765,129,102,0,102,2
2020-04-20,Shasta,089,179085,33,26,0,26,3
2020-04-20,Sierra,091,2930,0,0,0,0,0
2020-04-20,Siskiyou,093,43540,5,5,0,5,0
2020-04-20,Solano,095,438530,236,185,0,185,2
2020-04-20,Sonoma,097,501317,217,178,0,178,1
2020-04-20,Stanislaus,099,539301,301,228,4,232,3
2020-04-20,Sutter,101,95872,27,22,0,22,2
2020-04-20,Tehama,103,63373,1,1,0,1,1
2020-04-20,Trinity,105,12862,0,0,0,0,0
2020-04-20,Tulare,107,460477,658,401,5,406,20
2020-04-20,Tuolumne,109,53932,3,2,0,2,0
2020-04-20,Ventura,111,848112,565,426,1,427,13
2020-04-20,Yolo,113,214977,165,125,0,125,5
2020-04-20,Yuba,115,75493,16,15,0,15,1
2020-04-19,Alameda,001,1643700,1496,1134,2,1136,41
2020-04-19,Alpine,003,1148,1,1,0,1,0
2020-04-19,Amador,005,37829,7,7,0,7,0
2020-04-19,Butte,007,227075,22,15,1,16,0
2020-04-19,Calaveras,009,45235,12,12,0,12,0
2020-04-19,Colusa,011,21464,3,3,0,3,0
2020-04-19,Contra Costa,013,1133247,866,731,0,731,20
2020-04-19,Del Norte,015,27424,2,2,0,2,0
2020-04-19,El Dorado,017,186661,54,36,0,36,0
2020-04-19,Fresno,019,978130,642,326,6,332,7
2020-04-19,Glenn,021,27897,4,3,0,3,0
2020-04-19,Humboldt,023,135768,58,53,0,53,0
2020-04-19,Imperial,025,180216,317,144,0,144,2
2020-04-19,Inyo,027,18085,19,17,0,17,0
2020-04-19,Kern,029,883053,851,629,1,630,3
2020-04-19,Kings,031,150075,70,17,1,18,1
2020-04-19,Lake,033,64148,6,6,0,6,0
2020-04-19,Lassen,035,31185,3,0,2,2,0
2020-04-19,Los Angeles,037,10098052,19774,12299,14,12313,589
2020-04-19,Madera,039,155013,72,34,1,35,2
2020-04-19,Marin,041,260295,212,194,1,195,10
2020-04-19,Mariposa,043,17540,2,0,0,0,0
2020-04-19,Mendocino,045,87422,6,4,0,4,0
2020-04-19,Merced,047,269075,131,85,0,85,3
2020-04-19,Modoc,049,8938,0,0,0,0,0
2020-04-19,Mono,051,14174,29,23,0,23,1
2020-04-19,Monterey,053,433212,205,140,0,140,4
2020-04-19,Napa,055,140530,64,49,0,49,2
2020-04-19,Nevada,057,99092,40,34,1,35,1
2020-04-19,Orange,059,3164182,2512,1591,21,1612,32
2020-04-19,Placer,061,380077,154,131,0,131,8
2020-04-19,Plumas,063,18699,4,4,0,4,0
2020-04-19,Riverside,065,2383286,3728,2316,14,2330,56
2020-04-19,Sacramento,067,1510023,1014,912,0,912,32
2020-04-19,San Benito,069,59416,43,40,0,40,2
2020-04-19,San Bernardino,071,2135413,1884,1262,1,1263,58
2020-04-19,San Diego,073,3302833,3101,2270,0,2270,71
2020-04-19,San Francisco,075,870044,1457,1153,0,1153,19
2020-04-19,San Joaquin,077,732212,507,404,3,407,17
2020-04-19,San Luis Obispo,079,281455,200,132,3,135,1
2020-04-19,San Mateo,081,765935,1162,845,2,847,31
2020-04-19,Santa Barbara,083,443738,462,377,2,379,3
2020-04-19,Santa Clara,085,1922200,2307,1878,5,1883,81
2020-04-19,Santa Cruz,087,273765,126,98,0,98,2
2020-04-19,Shasta,089,179085,31,26,0,26,3
2020-04-19,Sierra,091,2930,0,0,0,0,0
2020-04-19,Siskiyou,093,43540,5,5,0,5,0
2020-04-19,Solano,095,438530,228,174,0,174,2
2020-04-19,Sonoma,097,501317,211,172,0,172,1
2020-04-19,Stanislaus,099,539301,293,221,4,225,3
2020-04-19,Sutter,101,95872,26,21,0,21,2
2020-04-19,Tehama,103,63373,1,1,0,1,1
2020-04-19,Trinity,105,12862,0,0,0,0,0
2020-04-19,Tulare,107,460477,612,391,5,396,17
2020-04-19,Tuolumne,109,53932,3,2,0,2,0
2020-04-19,Ventura,111,848112,557,418,1,419,13
2020-04-19,Yolo,113,214977,165,120,0,120,5
2020-04-19,Yuba,115,75493,16,15,0,15,1
2020-04-18,Alameda,001,1643700,1471,1085,2,1087,40
2020-04-18,Alpine,003,1148,1,1,0,1,0
2020-04-18,Amador,005,37829,7,7,0,7,0
2020-04-18,Butte,007,227075,21,15,1,16,0
2020-04-18,Calaveras,009,45235,12,12,0,12,0
2020-04-18,Colusa,011,21464,3,3,0,3,0
2020-04-18,Contra Costa,013,1133247,854,721,0,721,17
2020-04-18,Del Norte,015,27424,2,2,0,2,0
2020-04-18,El Dorado,017,186661,54,36,0,36,0
2020-04-18,Fresno,019,978130,622,319,6,325,7
2020-04-18,Glenn,021,27897,4,3,0,3,0
2020-04-18,Humboldt,023,135768,58,52,0,52,0
2020-04-18,Imperial,025,180216,308,137,0,137,2
2020-04-18,Inyo,027,18085,19,17,0,17,0
2020-04-18,Kern,029,883053,829,626,1,627,3
2020-04-18,Kings,031,150075,69,17,1,18,1
2020-04-18,Lake,033,64148,6,6,0,6,0
2020-04-18,Lassen,035,31185,3,0,2,2,0
2020-04-18,Los Angeles,037,10098052,19248,11984,14,11998,566
2020-04-18,Madera,039,155013,71,34,1,35,2
2020-04-18,Marin,041,260295,210,193,1,194,10
2020-04-18,Mariposa,043,17540,2,0,0,0,0
2020-04-18,Mendocino,045,87422,6,4,0,4,0
2020-04-18,Merced,047,269075,129,82,0,82,3
2020-04-18,Modoc,049,8938,0,0,0,0,0
2020-04-18,Mono,051,14174,29,22,0,22,1
2020-04-18,Monterey,053,433212,201,135,0,135,3
2020-04-18,Napa,055,140530,64,49,0,49,2
2020-04-18,Nevada,057,99092,39,34,1,35,1
2020-04-18,Orange,059,3164182,2448,1569,20,1589,32
2020-04-18,Placer,061,380077,152,130,0,130,8
2020-04-18,Plumas,063,18699,4,4,0,4,0
2020-04-18,Riverside,065,2383286,3653,2257,14,2271,56
2020-04-18,Sacramento,067,1510023,1002,901,0,901,32
2020-04-18,San Benito,069,59416,43,40,0,40,2
2020-04-18,San Bernardino,071,2135413,1839,1255,1,1256,58
2020-04-18,San Diego,073,3302833,2999,2215,0,2215,71
2020-04-18,San Francisco,075,870044,1418,1144,0,1144,19
2020-04-18,San Joaquin,077,732212,498,392,3,395,17
2020-04-18,San Luis Obispo,079,281455,196,129,3,132,1
2020-04-18,San Mateo,081,765935,1140,821,2,823,31
2020-04-18,Santa Barbara,083,443738,456,372,2,374,3
2020-04-18,Santa Clara,085,1922200,2274,1862,5,1867,79
2020-04-18,Santa Cruz,087,273765,124,96,0,96,2
2020-04-18,Shasta,089,179085,31,26,0,26,3
2020-04-18,Sierra,091,2930,0,0,0,0,0
2020-04-18,Siskiyou,093,43540,5,5,0,5,0
2020-04-18,Solano,095,438530,225,175,0,175,2
2020-04-18,Sonoma,097,501317,207,168,0,168,1
2020-04-18,Stanislaus,099,539301,285,216,4,220,3
2020-04-18,Sutter,101,95872,26,21,0,21,2
2020-04-18,Tehama,103,63373,1,1,0,1,1
2020-04-18,Trinity,105,12862,0,0,0,0,0
2020-04-18,Tulare,107,460477,601,385,5,390,17
2020-04-18,Tuolumne,109,53932,3,2,0,2,0
2020-04-18,Ventura,111,848112,549,416,1,417,13
2020-04-18,Yolo,113,214977,163,118,0,118,5
2020-04-18,Yuba,115,75493,16,14,0,14,1
2020-04-17,Alameda,001,1643700,1415,1043,1,1044,40
2020-04-17,Alpine,003,1148,1,1,0,1,0
2020-04-17,Amador,005,37829,7,7,0,7,0
2020-04-17,Butte,007,227075,21,15,1,16,0
2020-04-17,Calaveras,009,45235,12,11,0,11,0
2020-04-17,Colusa,011,21464,3,3,0,3,0
2020-04-17,Contra Costa,013,1133247,843,687,0,687,15
2020-04-17,Del Norte,015,27424,2,2,0,2,0
2020-04-17,El Dorado,017,186661,54,35,0,35,0
2020-04-17,Fresno,019,978130,600,315,6,321,7
2020-04-17,Glenn,021,27897,4,3,0,3,0
2020-04-17,Humboldt,023,135768,57,52,0,52,0
2020-04-17,Imperial,025,180216,299,135,0,135,2
2020-04-17,Inyo,027,18085,19,17,0,17,0
2020-04-17,Kern,029,883053,809,612,1,613,3
2020-04-17,Kings,031,150075,67,15,1,16,1
2020-04-17,Lake,033,64148,6,6,0,6,0
2020-04-17,Lassen,035,31185,3,0,2,2,0
2020-04-17,Los Angeles,037,10098052,18607,11354,14,11368,489
2020-04-17,Madera,039,155013,71,34,1,35,2
2020-04-17,Marin,041,260295,207,189,1,190,10
2020-04-17,Mariposa,043,17540,1,0,0,0,0
2020-04-17,Mendocino,045,87422,6,4,0,4,0
2020-04-17,Merced,047,269075,128,80,0,80,3
2020-04-17,Modoc,049,8938,0,0,0,0,0
2020-04-17,Mono,051,14174,29,22,0,22,1
2020-04-17,Monterey,053,433212,196,119,0,119,3
2020-04-17,Napa,055,140530,62,46,0,46,2
2020-04-17,Nevada,057,99092,38,34,1,35,1
2020-04-17,Orange,059,3164182,2397,1496,20,1516,31
2020-04-17,Placer,061,380077,152,130,0,130,8
2020-04-17,Plumas,063,18699,4,4,0,4,0
2020-04-17,Riverside,065,2383286,3526,2080,14,2094,50
2020-04-17,Sacramento,067,1510023,995,882,0,882,32
2020-04-17,San Benito,069,59416,43,38,0,38,2
2020-04-17,San Bernardino,071,2135413,1800,1229,1,1230,57
2020-04-17,San Diego,073,3302833,2909,2160,0,2160,70
2020-04-17,San Francisco,075,870044,1392,1090,0,1090,19
2020-04-17,San Joaquin,077,732212,487,356,3,359,17
2020-04-17,San Luis Obispo,079,281455,189,116,3,119,1
2020-04-17,San Mateo,081,765935,1124,768,2,770,31
2020-04-17,Santa Barbara,083,443738,451,349,2,351,3
2020-04-17,Santa Clara,085,1922200,2238,1834,5,1839,74
2020-04-17,Santa Cruz,087,273765,123,94,0,94,2
2020-04-17,Shasta,089,179085,31,26,0,26,3
2020-04-17,Sierra,091,2930,0,0,0,0,0
2020-04-17,Siskiyou,093,43540,5,5,0,5,0
2020-04-17,Solano,095,438530,224,173,0,173,2
2020-04-17,Sonoma,097,501317,204,167,0,167,1
2020-04-17,Stanislaus,099,539301,283,201,4,205,3
2020-04-17,Sutter,101,95872,26,20,0,20,2
2020-04-17,Tehama,103,63373,1,1,0,1,1
2020-04-17,Trinity,105,12862,0,0,0,0,0
2020-04-17,Tulare,107,460477,594,370,5,375,17
2020-04-17,Tuolumne,109,53932,3,2,0,2,0
2020-04-17,Ventura,111,848112,544,398,1,399,13
2020-04-17,Yolo,113,214977,162,117,0,117,5
2020-04-17,Yuba,115,75493,16,14,0,14,1
2020-04-16,Alameda,001,1643700,1380,981,1,982,39
2020-04-16,Alpine,003,1148,1,1,0,1,0
2020-04-16,Amador,005,37829,7,7,0,7,0
2020-04-16,Butte,007,227075,20,15,1,16,0
2020-04-16,Calaveras,009,45235,12,10,0,10,0
2020-04-16,Colusa,011,21464,3,3,0,3,0
2020-04-16,Contra Costa,013,1133247,829,675,0,675,14
2020-04-16,Del Norte,015,27424,2,2,0,2,0
2020-04-16,El Dorado,017,186661,53,34,0,34,0
2020-04-16,Fresno,019,978130,570,289,6,295,7
2020-04-16,Glenn,021,27897,4,3,0,3,0
2020-04-16,Humboldt,023,135768,57,47,0,47,0
2020-04-16,Imperial,025,180216,285,132,0,132,2
2020-04-16,Inyo,027,18085,17,17,0,17,0
2020-04-16,Kern,029,883053,782,587,1,588,3
2020-04-16,Kings,031,150075,63,12,1,13,1
2020-04-16,Lake,033,64148,6,6,0,6,0
2020-04-16,Lassen,035,31185,3,0,2,2,0
2020-04-16,Los Angeles,037,10098052,17721,10786,14,10800,447
2020-04-16,Madera,039,155013,69,34,1,35,2
2020-04-16,Marin,041,260295,203,170,1,171,10
2020-04-16,Mariposa,043,17540,1,1,0,1,0
2020-04-16,Mendocino,045,87422,6,4,0,4,0
2020-04-16,Merced,047,269075,122,76,0,76,3
2020-04-16,Modoc,049,8938,0,0,0,0,0
2020-04-16,Mono,051,14174,29,22,0,22,1
2020-04-16,Monterey,053,433212,193,116,0,116,3
2020-04-16,Napa,055,140530,59,44,0,44,2
2020-04-16,Nevada,057,99092,38,34,1,35,1
2020-04-16,Orange,059,3164182,2332,1439,19,1458,28
2020-04-16,Placer,061,380077,150,129,0,129,7
2020-04-16,Plumas,063,18699,4,4,0,4,0
2020-04-16,Riverside,065,2383286,3406,1913,14,1927,45
2020-04-16,Sacramento,067,1510023,987,865,0,865,32
2020-04-16,San Benito,069,59416,43,36,0,36,2
2020-04-16,San Bernardino,071,2135413,1718,1143,0,1143,54
2020-04-16,San Diego,073,3302833,2801,2089,0,2089,63
2020-04-16,San Francisco,075,870044,1348,1039,0,1039,16
2020-04-16,San Joaquin,077,732212,472,345,3,348,17
2020-04-16,San Luis Obispo,079,281455,185,113,3,116,1
2020-04-16,San Mateo,081,765935,1095,745,2,747,29
2020-04-16,Santa Barbara,083,443738,440,331,2,333,3
2020-04-16,Santa Clara,085,1922200,2201,1789,5,1794,70
2020-04-16,Santa Cruz,087,273765,121,90,0,90,2
2020-04-16,Shasta,089,179085,31,25,0,25,3
2020-04-16,Sierra,091,2930,0,0,0,0,0
2020-04-16,Siskiyou,093,43540,5,5,0,5,0
2020-04-16,Solano,095,438530,221,162,0,162,2
2020-04-16,Sonoma,097,501317,199,145,0,145,1
2020-04-16,Stanislaus,099,539301,280,185,4,189,3
2020-04-16,Sutter,101,95872,25,21,0,21,2
2020-04-16,Tehama,103,63373,1,1,0,1,1
2020-04-16,Trinity,105,12862,0,0,0,0,0
2020-04-16,Tulare,107,460477,577,305,5,310,16
2020-04-16,Tuolumne,109,53932,3,1,0,1,0
2020-04-16,Ventura,111,848112,532,384,1,385,13
2020-04-16,Yolo,113,214977,160,98,0,98,4
2020-04-16,Yuba,115,75493,15,14,0,14,1
2020-04-15,Alameda,001,1643700,1330,915,1,916,38
2020-04-15,Alpine,003,1148,1,1,0,1,0
2020-04-15,Amador,005,37829,7,7,0,7,0
2020-04-15,Butte,007,227075,20,14,1,15,0
2020-04-15,Calaveras,009,45235,11,9,0,9,0
2020-04-15,Colusa,011,21464,3,3,0,3,0
2020-04-15,Contra Costa,013,1133247,807,645,0,645,14
2020-04-15,Del Norte,015,27424,2,2,0,2,0
2020-04-15,El Dorado,017,186661,51,33,0,33,0
2020-04-15,Fresno,019,978130,544,264,6,270,7
2020-04-15,Glenn,021,27897,4,3,0,3,0
2020-04-15,Humboldt,023,135768,57,47,0,47,0
2020-04-15,Imperial,025,180216,258,115,0,115,2
2020-04-15,Inyo,027,18085,17,12,0,12,0
2020-04-15,Kern,029,883053,760,500,1,501,3
2020-04-15,Kings,031,150075,59,12,1,13,1
2020-04-15,Lake,033,64148,6,4,0,4,0
2020-04-15,Lassen,035,31185,3,0,2,2,0
2020-04-15,Los Angeles,037,10098052,16901,10416,13,10429,394
2020-04-15,Madera,039,155013,69,30,1,31,2
2020-04-15,Marin,041,260295,200,162,1,163,10
2020-04-15,Mariposa,043,17540,0,0,0,0,0
2020-04-15,Mendocino,045,87422,5,4,0,4,0
2020-04-15,Merced,047,269075,120,74,0,74,3
2020-04-15,Modoc,049,8938,0,0,0,0,0
2020-04-15,Mono,051,14174,29,22,0,22,1
2020-04-15,Monterey,053,433212,185,106,0,106,3
2020-04-15,Napa,055,140530,56,34,0,34,2
2020-04-15,Nevada,057,99092,37,34,1,35,1
2020-04-15,Orange,059,3164182,2229,1377,19,1396,24
2020-04-15,Placer,061,380077,149,123,0,123,6
2020-04-15,Plumas,063,18699,4,4,0,4,0
2020-04-15,Riverside,065,2383286,3211,1723,14,1737,42
2020-04-15,Sacramento,067,1510023,978,839,0,839,32
2020-04-15,San Benito,069,59416,43,34,0,34,2
2020-04-15,San Bernardino,071,2135413,1648,1063,0,1063,45
2020-04-15,San Diego,073,3302833,2713,2014,0,2014,60
2020-04-15,San Francisco,075,870044,1312,1006,0,1006,16
2020-04-15,San Joaquin,077,732212,464,329,3,332,17
2020-04-15,San Luis Obispo,079,281455,177,112,3,115,1
2020-04-15,San Mateo,081,765935,1046,707,2,709,28
2020-04-15,Santa Barbara,083,443738,424,317,2,319,2
2020-04-15,Santa Clara,085,1922200,2162,1692,5,1697,69
2020-04-15,Santa Cruz,087,273765,117,92,0,92,2
2020-04-15,Shasta,089,179085,31,25,0,25,3
2020-04-15,Sierra,091,2930,0,0,0,0,0
2020-04-15,Siskiyou,093,43540,5,5,0,5,0
2020-04-15,Solano,095,438530,216,153,0,153,2
2020-04-15,Sonoma,097,501317,197,140,0,140,1
2020-04-15,Stanislaus,099,539301,273,174,4,178,3
2020-04-15,Sutter,101,95872,25,19,0,19,2
2020-04-15,Tehama,103,63373,1,1,0,1,1
2020-04-15,Trinity,105,12862,0,0,0,0,0
2020-04-15,Tulare,107,460477,559,289,5,294,14
2020-04-15,Tuolumne,109,53932,3,1,0,1,0
2020-04-15,Ventura,111,848112,517,365,1,366,13
2020-04-15,Yolo,113,214977,156,93,0,93,3
2020-04-15,Yuba,115,75493,15,15,0,15,1
2020-04-14,Alameda,001,1643700,1285,843,1,844,30
2020-04-14,Alpine,003,1148,1,1,0,1,0
2020-04-14,Amador,005,37829,7,6,0,6,0
2020-04-14,Butte,007,227075,20,13,1,14,0
2020-04-14,Calaveras,009,45235,11,5,0,5,0
2020-04-14,Colusa,011,21464,3,3,0,3,0
2020-04-14,Contra Costa,013,1133247,795,617,0,617,12
2020-04-14,Del Norte,015,27424,2,2,0,2,0
2020-04-14,El Dorado,017,186661,51,30,0,30,0
2020-04-14,Fresno,019,978130,521,244,6,250,6
2020-04-14,Glenn,021,27897,4,3,0,3,0
2020-04-14,Humboldt,023,135768,57,44,0,44,0
2020-04-14,Imperial,025,180216,238,86,0,86,2
2020-04-14,Inyo,027,18085,17,12,0,12,0
2020-04-14,Kern,029,883053,736,453,1,454,3
2020-04-14,Kings,031,150075,58,12,1,13,1
2020-04-14,Lake,033,64148,6,3,0,3,0
2020-04-14,Lassen,035,31185,3,0,2,2,0
2020-04-14,Los Angeles,037,10098052,16006,9948,12,9960,357
2020-04-14,Madera,039,155013,68,29,1,30,2
2020-04-14,Marin,041,260295,196,147,1,148,9
2020-04-14,Mariposa,043,17540,0,0,0,0,0
2020-04-14,Mendocino,045,87422,5,4,0,4,0
2020-04-14,Merced,047,269075,113,61,0,61,3
2020-04-14,Modoc,049,8938,0,0,0,0,0
2020-04-14,Mono,051,14174,29,22,0,22,1
2020-04-14,Monterey,053,433212,180,98,0,98,3
2020-04-14,Napa,055,140530,56,33,0,33,2
2020-04-14,Nevada,057,99092,37,34,1,35,1
2020-04-14,Orange,059,3164182,2127,1362,19,1381,24
2020-04-14,Placer,061,380077,148,117,0,117,5
2020-04-14,Plumas,063,18699,4,3,0,3,0
2020-04-14,Riverside,065,2383286,3076,1467,14,1481,40
2020-04-14,Sacramento,067,1510023,969,737,0,737,29
2020-04-14,San Benito,069,59416,40,34,0,34,2
2020-04-14,San Bernardino,071,2135413,1593,933,0,933,37
2020-04-14,San Diego,073,3302833,2618,1932,0,1932,53
2020-04-14,San Francisco,075,870044,1258,968,0,968,14
2020-04-14,San Joaquin,077,732212,454,280,3,283,17
2020-04-14,San Luis Obispo,079,281455,174,109,3,112,1
2020-04-14,San Mateo,081,765935,1012,681,2,683,28
2020-04-14,Santa Barbara,083,443738,400,292,2,294,2
2020-04-14,Santa Clara,085,1922200,2129,1561,5,1566,63
2020-04-14,Santa Cruz,087,273765,109,84,0,84,2
2020-04-14,Shasta,089,179085,31,24,0,24,3
2020-04-14,Sierra,091,2930,0,0,0,0,0
2020-04-14,Siskiyou,093,43540,5,5,0,5,0
2020-04-14,Solano,095,438530,213,140,0,140,2
2020-04-14,Sonoma,097,501317,193,133,0,133,1
2020-04-14,Stanislaus,099,539301,260,136,4,140,3
2020-04-14,Sutter,101,95872,24,19,0,19,2
2020-04-14,Tehama,103,63373,1,1,0,1,1
2020-04-14,Trinity,105,12862,0,0,0,0,0
2020-04-14,Tulare,107,460477,535,228,5,233,12
2020-04-14,Tuolumne,109,53932,3,0,0,0,0
2020-04-14,Ventura,111,848112,504,328,1,329,11
2020-04-14,Yolo,113,214977,153,81,0,81,3
2020-04-14,Yuba,115,75493,14,14,0,14,1
2020-04-13,Alameda,001,1643700,1246,821,1,822,23
2020-04-13,Alpine,003,1148,1,1,0,1,0
2020-04-13,Amador,005,37829,7,6,0,6,0
2020-04-13,Butte,007,227075,20,13,1,14,0
2020-04-13,Calaveras,009,45235,10,5,0,5,0
2020-04-13,Colusa,011,21464,3,3,0,3,0
2020-04-13,Contra Costa,013,1133247,779,569,0,569,12
2020-04-13,Del Norte,015,27424,2,2,0,2,0
2020-04-13,El Dorado,017,186661,49,29,0,29,0
2020-04-13,Fresno,019,978130,499,205,5,210,4
2020-04-13,Glenn,021,27897,4,3,0,3,0
2020-04-13,Humboldt,023,135768,57,44,0,44,0
2020-04-13,Imperial,025,180216,220,82,0,82,2
2020-04-13,Inyo,027,18085,17,12,0,12,0
2020-04-13,Kern,029,883053,711,346,1,347,3
2020-04-13,Kings,031,150075,54,9,1,10,0
2020-04-13,Lake,033,64148,6,3,0,3,0
2020-04-13,Lassen,035,31185,3,0,2,2,0
2020-04-13,Los Angeles,037,10098052,15292,9367,12,9379,317
2020-04-13,Madera,039,155013,66,29,1,30,2
2020-04-13,Marin,041,260295,192,144,1,145,6
2020-04-13,Mariposa,043,17540,0,0,0,0,0
2020-04-13,Mendocino,045,87422,5,4,0,4,0
2020-04-13,Merced,047,269075,112,60,0,60,3
2020-04-13,Modoc,049,8938,0,0,0,0,0
2020-04-13,Mono,051,14174,29,21,0,21,1
2020-04-13,Monterey,053,433212,173,86,0,86,3
2020-04-13,Napa,055,140530,55,30,0,30,2
2020-04-13,Nevada,057,99092,37,24,1,25,1
2020-04-13,Orange,059,3164182,2054,1313,19,1332,21
2020-04-13,Placer,061,380077,147,116,0,116,5
2020-04-13,Plumas,063,18699,4,3,0,3,0
2020-04-13,Riverside,065,2383286,2935,1460,13,1473,35
2020-04-13,Sacramento,067,1510023,957,723,0,723,25
2020-04-13,San Benito,069,59416,39,33,0,33,2
2020-04-13,San Bernardino,071,2135413,1518,920,0,920,30
2020-04-13,San Diego,073,3302833,2535,1849,0,1849,47
2020-04-13,San Francisco,075,870044,1220,948,0,948,12
2020-04-13,San Joaquin,077,732212,439,255,3,258,16
2020-04-13,San Luis Obispo,079,281455,169,106,3,109,1
2020-04-13,San Mateo,081,765935,972,679,2,681,25
2020-04-13,Santa Barbara,083,443738,381,271,1,272,2
2020-04-13,Santa Clara,085,1922200,2083,1540,5,1545,58
2020-04-13,Santa Cruz,087,273765,103,82,0,82,1
2020-04-13,Shasta,089,179085,30,24,0,24,3
2020-04-13,Sierra,091,2930,0,0,0,0,0
2020-04-13,Siskiyou,093,43540,5,5,0,5,0
2020-04-13,Solano,095,438530,210,136,0,136,2
2020-04-13,Sonoma,097,501317,186,133,0,133,1
2020-04-13,Stanislaus,099,539301,254,130,4,134,1
2020-04-13,Sutter,101,95872,24,18,0,18,2
2020-04-13,Tehama,103,63373,1,1,0,1,0
2020-04-13,Trinity,105,12862,0,0,0,0,0
2020-04-13,Tulare,107,460477,499,185,5,190,11
2020-04-13,Tuolumne,109,53932,3,0,0,0,0
2020-04-13,Ventura,111,848112,483,309,0,309,9
2020-04-13,Yolo,113,214977,147,81,0,81,3
2020-04-13,Yuba,115,75493,14,13,0,13,1
2020-04-12,Alameda,001,1643700,1203,774,1,775,23
2020-04-12,Alpine,003,1148,1,1,0,1,0
2020-04-12,Amador,005,37829,7,6,0,6,0
2020-04-12,Butte,007,227075,20,13,1,14,0
2020-04-12,Calaveras,009,45235,10,5,0,5,0
2020-04-12,Colusa,011,21464,3,3,0,3,0
2020-04-12,Contra Costa,013,1133247,766,553,0,553,12
2020-04-12,Del Norte,015,27424,2,2,0,2,0
2020-04-12,El Dorado,017,186661,49,28,0,28,0
2020-04-12,Fresno,019,978130,470,205,5,210,4
2020-04-12,Glenn,021,27897,4,3,0,3,0
2020-04-12,Humboldt,023,135768,57,43,0,43,0
2020-04-12,Imperial,025,180216,197,78,0,78,2
2020-04-12,Inyo,027,18085,15,12,0,12,0
2020-04-12,Kern,029,883053,679,319,0,319,3
2020-04-12,Kings,031,150075,52,9,1,10,0
2020-04-12,Lake,033,64148,6,3,0,3,0
2020-04-12,Lassen,035,31185,3,0,2,2,0
2020-04-12,Los Angeles,037,10098052,14579,9133,12,9145,294
2020-04-12,Madera,039,155013,65,29,1,30,2
2020-04-12,Marin,041,260295,181,138,1,139,6
2020-04-12,Mariposa,043,17540,0,0,0,0,0
2020-04-12,Mendocino,045,87422,5,4,0,4,0
2020-04-12,Merced,047,269075,106,58,0,58,3
2020-04-12,Modoc,049,8938,0,0,0,0,0
2020-04-12,Mono,051,14174,29,20,0,20,1
2020-04-12,Monterey,053,433212,159,85,0,85,3
2020-04-12,Napa,055,140530,53,29,0,29,2
2020-04-12,Nevada,057,99092,37,24,1,25,1
2020-04-12,Orange,059,3164182,1994,1283,18,1301,21
2020-04-12,Placer,061,380077,146,114,0,114,4
2020-04-12,Plumas,063,18699,4,3,0,3,0
2020-04-12,Riverside,065,2383286,2753,1330,13,1343,34
2020-04-12,Sacramento,067,1510023,920,689,0,689,25
2020-04-12,San Benito,069,59416,37,33,0,33,2
2020-04-12,San Bernardino,071,2135413,1441,827,0,827,30
2020-04-12,San Diego,073,3302833,2445,1806,0,1806,45
2020-04-12,San Francisco,075,870044,1193,886,0,886,11
2020-04-12,San Joaquin,077,732212,421,246,3,249,15
2020-04-12,San Luis Obispo,079,281455,166,102,2,104,1
2020-04-12,San Mateo,081,765935,946,664,2,666,25
2020-04-12,Santa Barbara,083,443738,362,261,1,262,2
2020-04-12,Santa Clara,085,1922200,2055,1461,5,1466,53
2020-04-12,Santa Cruz,087,273765,102,80,0,80,1
2020-04-12,Shasta,089,179085,30,24,0,24,3
2020-04-12,Sierra,091,2930,0,0,0,0,0
2020-04-12,Siskiyou,093,43540,5,5,0,5,0
2020-04-12,Solano,095,438530,204,136,0,136,2
2020-04-12,Sonoma,097,501317,183,131,0,131,1
2020-04-12,Stanislaus,099,539301,246,117,4,121,1
2020-04-12,Sutter,101,95872,23,18,0,18,2
2020-04-12,Tehama,103,63373,1,1,0,1,0
2020-04-12,Trinity,105,12862,0,0,0,0,0
2020-04-12,Tulare,107,460477,487,166,5,171,11
2020-04-12,Tuolumne,109,53932,3,0,0,0,0
2020-04-12,Ventura,111,848112,473,306,0,306,9
2020-04-12,Yolo,113,214977,135,67,0,67,3
2020-04-12,Yuba,115,75493,14,13,0,13,1
2020-04-11,Alameda,001,1643700,1162,751,1,752,23
2020-04-11,Alpine,003,1148,1,1,0,1,0
2020-04-11,Amador,005,37829,7,6,0,6,0
2020-04-11,Butte,007,227075,20,13,1,14,0
2020-04-11,Calaveras,009,45235,10,5,0,5,0
2020-04-11,Colusa,011,21464,3,3,0,3,0
2020-04-11,Contra Costa,013,1133247,757,550,0,550,12
2020-04-11,Del Norte,015,27424,2,2,0,2,0
2020-04-11,El Dorado,017,186661,48,29,0,29,0
2020-04-11,Fresno,019,978130,460,201,5,206,4
2020-04-11,Glenn,021,27897,4,3,0,3,0
2020-04-11,Humboldt,023,135768,57,38,0,38,0
2020-04-11,Imperial,025,180216,187,78,0,78,2
2020-04-11,Inyo,027,18085,15,12,0,12,0
2020-04-11,Kern,029,883053,651,304,0,304,3
2020-04-11,Kings,031,150075,49,9,1,10,0
2020-04-11,Lake,033,64148,6,3,0,3,0
2020-04-11,Lassen,035,31185,3,0,2,2,0
2020-04-11,Los Angeles,037,10098052,14108,8823,12,8835,262
2020-04-11,Madera,039,155013,64,29,1,30,2
2020-04-11,Marin,041,260295,178,136,1,137,6
2020-04-11,Mariposa,043,17540,0,0,0,0,0
2020-04-11,Mendocino,045,87422,5,4,0,4,0
2020-04-11,Merced,047,269075,103,59,0,59,3
2020-04-11,Modoc,049,8938,0,0,0,0,0
2020-04-11,Mono,051,14174,29,20,0,20,1
2020-04-11,Monterey,053,433212,153,78,0,78,3
2020-04-11,Napa,055,140530,53,29,0,29,2
2020-04-11,Nevada,057,99092,37,24,1,25,1
2020-04-11,Orange,059,3164182,1932,1267,18,1285,21
2020-04-11,Placer,061,380077,146,113,0,113,4
2020-04-11,Plumas,063,18699,4,3,0,3,0
2020-04-11,Riverside,065,2383286,2674,1260,13,1273,33
2020-04-11,Sacramento,067,1510023,909,685,0,685,25
2020-04-11,San Benito,069,59416,37,33,0,33,2
2020-04-11,San Bernardino,071,2135413,1405,826,0,826,28
2020-04-11,San Diego,073,3302833,2379,1763,0,1763,45
2020-04-11,San Francisco,075,870044,1171,860,0,860,11
2020-04-11,San Joaquin,077,732212,416,244,3,247,15
2020-04-11,San Luis Obispo,079,281455,166,100,1,101,1
2020-04-11,San Mateo,081,765935,934,662,2,664,25
2020-04-11,Santa Barbara,083,443738,354,258,1,259,2
2020-04-11,Santa Clara,085,1922200,1996,1441,5,1446,51
2020-04-11,Santa Cruz,087,273765,102,79,0,79,1
2020-04-11,Shasta,089,179085,30,24,0,24,3
2020-04-11,Sierra,091,2930,0,0,0,0,0
2020-04-11,Siskiyou,093,43540,5,5,0,5,0
2020-04-11,Solano,095,438530,200,138,0,138,2
2020-04-11,Sonoma,097,501317,181,131,0,131,1
2020-04-11,Stanislaus,099,539301,238,119,3,122,1
2020-04-11,Sutter,101,95872,23,18,0,18,2
2020-04-11,Tehama,103,63373,1,1,0,1,0
2020-04-11,Trinity,105,12862,0,0,0,0,0
2020-04-11,Tulare,107,460477,465,168,5,173,10
2020-04-11,Tuolumne,109,53932,3,0,0,0,0
2020-04-11,Ventura,111,848112,463,304,0,304,9
2020-04-11,Yolo,113,214977,132,67,0,67,3
2020-04-11,Yuba,115,75493,14,13,0,13,1
2020-04-10,Alameda,001,1643700,1121,706,1,707,21
2020-04-10,Alpine,003,1148,1,1,0,1,0
2020-04-10,Amador,005,37829,7,5,0,5,0
2020-04-10,Butte,007,227075,20,13,1,14,0
2020-04-10,Calaveras,009,45235,10,5,0,5,0
2020-04-10,Colusa,011,21464,3,3,0,3,0
2020-04-10,Contra Costa,013,1133247,744,537,0,537,10
2020-04-10,Del Norte,015,27424,2,2,0,2,0
2020-04-10,El Dorado,017,186661,48,26,0,26,0
2020-04-10,Fresno,019,978130,453,186,4,190,3
2020-04-10,Glenn,021,27897,4,3,0,3,0
2020-04-10,Humboldt,023,135768,57,36,0,36,0
2020-04-10,Imperial,025,180216,180,70,0,70,2
2020-04-10,Inyo,027,18085,13,11,0,11,0
2020-04-10,Kern,029,883053,627,272,0,272,3
2020-04-10,Kings,031,150075,46,7,1,8,0
2020-04-10,Lake,033,64148,6,3,0,3,0
2020-04-10,Lassen,035,31185,3,0,2,2,0
2020-04-10,Los Angeles,037,10098052,13594,8384,11,8395,239
2020-04-10,Madera,039,155013,63,29,1,30,2
2020-04-10,Marin,041,260295,173,128,1,129,6
2020-04-10,Mariposa,043,17540,0,0,0,0,0
2020-04-10,Mendocino,045,87422,5,4,0,4,0
2020-04-10,Merced,047,269075,100,56,0,56,3
2020-04-10,Modoc,049,8938,0,0,0,0,0
2020-04-10,Mono,051,14174,29,20,0,20,1
2020-04-10,Monterey,053,433212,142,78,0,78,3
2020-04-10,Napa,055,140530,50,28,0,28,2
2020-04-10,Nevada,057,99092,37,23,1,24,1
2020-04-10,Orange,059,3164182,1885,1167,18,1185,21
2020-04-10,Placer,061,380077,145,112,0,112,4
2020-04-10,Plumas,063,18699,4,3,0,3,0
2020-04-10,Riverside,065,2383286,2608,1162,13,1175,30
2020-04-10,Sacramento,067,1510023,900,642,0,642,24
2020-04-10,San Benito,069,59416,37,32,0,32,2
2020-04-10,San Bernardino,071,2135413,1357,779,0,779,27
2020-04-10,San Diego,073,3302833,2319,1695,0,1695,44
2020-04-10,San Francisco,075,870044,1140,797,0,797,10
2020-04-10,San Joaquin,077,732212,404,234,3,237,14
2020-04-10,San Luis Obispo,079,281455,166,97,1,98,1
2020-04-10,San Mateo,081,765935,918,642,2,644,24
2020-04-10,Santa Barbara,083,443738,346,254,1,255,2
2020-04-10,Santa Clara,085,1922200,1944,1351,5,1356,50
2020-04-10,Santa Cruz,087,273765,101,75,0,75,1
2020-04-10,Shasta,089,179085,30,24,0,24,3
2020-04-10,Sierra,091,2930,0,0,0,0,0
2020-04-10,Siskiyou,093,43540,5,5,0,5,0
2020-04-10,Solano,095,438530,197,129,0,129,2
2020-04-10,Sonoma,097,501317,180,129,0,129,1
2020-04-10,Stanislaus,099,539301,231,101,3,104,0
2020-04-10,Sutter,101,95872,23,18,0,18,2
2020-04-10,Tehama,103,63373,1,1,0,1,0
2020-04-10,Trinity,105,12862,0,0,0,0,0
2020-04-10,Tulare,107,460477,423,163,5,168,10
2020-04-10,Tuolumne,109,53932,3,0,0,0,0
2020-04-10,Ventura,111,848112,454,290,0,290,9
2020-04-10,Yolo,113,214977,130,62,0,62,3
2020-04-10,Yuba,115,75493,14,13,0,13,1
2020-04-09,Alameda,001,1643700,1071,641,1,642,17
2020-04-09,Alpine,003,1148,1,1,0,1,0
2020-04-09,Amador,005,37829,7,2,0,2,0
2020-04-09,Butte,007,227075,19,12,1,13,0
2020-04-09,Calaveras,009,45235,10,5,0,5,0
2020-04-09,Colusa,011,21464,3,3,0,3,0
2020-04-09,Contra Costa,013,1133247,701,505,0,505,7
2020-04-09,Del Norte,015,27424,2,2,0,2,0
2020-04-09,El Dorado,017,186661,47,25,0,25,0
2020-04-09,Fresno,019,978130,428,165,4,169,3
2020-04-09,Glenn,021,27897,4,2,0,2,0
2020-04-09,Humboldt,023,135768,57,36,0,36,0
2020-04-09,Imperial,025,180216,159,67,0,67,2
2020-04-09,Inyo,027,18085,12,11,0,11,0
2020-04-09,Kern,029,883053,591,241,0,241,2
2020-04-09,Kings,031,150075,43,5,1,6,0
2020-04-09,Lake,033,64148,5,1,0,1,0
2020-04-09,Lassen,035,31185,3,0,2,2,0
2020-04-09,Los Angeles,037,10098052,12966,7919,11,7930,220
2020-04-09,Madera,039,155013,63,28,1,29,2
2020-04-09,Marin,041,260295,171,126,1,127,7
2020-04-09,Mariposa,043,17540,0,0,0,0,0
2020-04-09,Mendocino,045,87422,5,4,0,4,0
2020-04-09,Merced,047,269075,97,41,0,41,3
2020-04-09,Modoc,049,8938,0,0,0,0,0
2020-04-09,Mono,051,14174,29,19,0,19,1
2020-04-09,Monterey,053,433212,124,70,0,70,3
2020-04-09,Napa,055,140530,46,27,0,27,2
2020-04-09,Nevada,057,99092,36,23,1,24,1
2020-04-09,Orange,059,3164182,1811,1105,18,1123,19
2020-04-09,Placer,061,380077,144,107,0,107,4
2020-04-09,Plumas,063,18699,4,3,0,3,0
2020-04-09,Riverside,065,2383286,2465,1083,13,1096,29
2020-04-09,Sacramento,067,1510023,877,601,0,601,21
2020-04-09,San Benito,069,59416,37,32,0,32,2
2020-04-09,San Bernardino,071,2135413,1288,717,0,717,27
2020-04-09,San Diego,073,3302833,2223,1630,0,1630,40
2020-04-09,San Francisco,075,870044,1120,748,0,748,8
2020-04-09,San Joaquin,077,732212,383,223,3,226,14
2020-04-09,San Luis Obispo,079,281455,158,93,1,94,1
2020-04-09,San Mateo,081,765935,902,630,2,632,23
2020-04-09,Santa Barbara,083,443738,336,232,1,233,2
2020-04-09,Santa Clara,085,1922200,1874,1301,5,1306,49
2020-04-09,Santa Cruz,087,273765,101,73,0,73,1
2020-04-09,Shasta,089,179085,30,22,0,22,3
2020-04-09,Sierra,091,2930,0,0,0,0,0
2020-04-09,Siskiyou,093,43540,5,4,0,4,0
2020-04-09,Solano,095,438530,188,118,0,118,2
2020-04-09,Sonoma,097,501317,176,113,0,113,1
2020-04-09,Stanislaus,099,539301,219,93,3,96,0
2020-04-09,Sutter,101,95872,23,17,0,17,2
2020-04-09,Tehama,103,63373,1,1,0,1,0
2020-04-09,Trinity,105,12862,0,0,0,0,0
2020-04-09,Tulare,107,460477,394,147,5,152,9
2020-04-09,Tuolumne,109,53932,3,0,0,0,0
2020-04-09,Ventura,111,848112,435,273,0,273,9
2020-04-09,Yolo,113,214977,121,59,0,59,3
2020-04-09,Yuba,115,75493,14,13,0,13,0
2020-04-08,Alameda,001,1643700,1029,594,1,595,15
2020-04-08,Alpine,003,1148,1,1,0,1,0
2020-04-08,Amador,005,37829,7,2,0,2,0
2020-04-08,Butte,007,227075,18,11,1,12,0
2020-04-08,Calaveras,009,45235,10,5,0,5,0
2020-04-08,Colusa,011,21464,3,3,0,3,0
2020-04-08,Contra Costa,013,1133247,688,481,0,481,7
2020-04-08,Del Norte,015,27424,2,2,0,2,0
2020-04-08,El Dorado,017,186661,47,25,0,25,0
2020-04-08,Fresno,019,978130,408,151,4,155,3
2020-04-08,Glenn,021,27897,4,2,0,2,0
2020-04-08,Humboldt,023,135768,57,40,0,40,0
2020-04-08,Imperial,025,180216,148,59,0,59,2
2020-04-08,Inyo,027,18085,12,11,0,11,0
2020-04-08,Kern,029,883053,550,198,0,198,2
2020-04-08,Kings,031,150075,43,5,1,6,0
2020-04-08,Lake,033,64148,5,1,0,1,0
2020-04-08,Lassen,035,31185,3,0,2,2,0
2020-04-08,Los Angeles,037,10098052,12364,7505,11,7516,196
2020-04-08,Madera,039,155013,62,28,1,29,2
2020-04-08,Marin,041,260295,165,125,1,126,7
2020-04-08,Mariposa,043,17540,0,0,0,0,0
2020-04-08,Mendocino,045,87422,5,4,0,4,0
2020-04-08,Merced,047,269075,82,35,0,35,1
2020-04-08,Modoc,049,8938,0,0,0,0,0
2020-04-08,Mono,051,14174,29,19,0,19,1
2020-04-08,Monterey,053,433212,115,68,0,68,3
2020-04-08,Napa,055,140530,44,21,0,21,2
2020-04-08,Nevada,057,99092,36,21,1,22,1
2020-04-08,Orange,059,3164182,1748,1034,18,1052,19
2020-04-08,Placer,061,380077,144,102,0,102,4
2020-04-08,Plumas,063,18699,4,3,0,3,0
2020-04-08,Riverside,065,2383286,2308,974,13,987,28
2020-04-08,Sacramento,067,1510023,843,565,0,565,21
2020-04-08,San Benito,069,59416,37,31,0,31,2
2020-04-08,San Bernardino,071,2135413,1231,635,0,635,22
2020-04-08,San Diego,073,3302833,2149,1532,0,1532,36
2020-04-08,San Francisco,075,870044,1053,687,0,687,7
2020-04-08,San Joaquin,077,732212,366,211,3,214,12
2020-04-08,San Luis Obispo,079,281455,156,90,1,91,1
2020-04-08,San Mateo,081,765935,887,608,2,610,22
2020-04-08,Santa Barbara,083,443738,319,221,1,222,2
2020-04-08,Santa Clara,085,1922200,1829,1257,5,1262,47
2020-04-08,Santa Cruz,087,273765,100,69,0,69,1
2020-04-08,Shasta,089,179085,30,18,0,18,3
2020-04-08,Sierra,091,2930,0,0,0,0,0
2020-04-08,Siskiyou,093,43540,5,4,0,4,0
2020-04-08,Solano,095,438530,175,111,0,111,2
2020-04-08,Sonoma,097,501317,171,107,0,107,1
2020-04-08,Stanislaus,099,539301,203,86,3,89,0
2020-04-08,Sutter,101,95872,22,17,0,17,2
2020-04-08,Tehama,103,63373,1,1,0,1,0
2020-04-08,Trinity,105,12862,0,0,0,0,0
2020-04-08,Tulare,107,460477,363,145,5,150,6
2020-04-08,Tuolumne,109,53932,3,0,0,0,0
2020-04-08,Ventura,111,848112,426,263,0,263,7
2020-04-08,Yolo,113,214977,104,56,0,56,3
2020-04-08,Yuba,115,75493,14,10,0,10,0
2020-04-07,Alameda,001,1643700,994,560,1,561,14
2020-04-07,Alpine,003,1148,1,1,0,1,0
2020-04-07,Amador,005,37829,7,2,0,2,0
2020-04-07,Butte,007,227075,17,11,1,12,0
2020-04-07,Calaveras,009,45235,9,5,0,5,0
2020-04-07,Colusa,011,21464,3,2,0,2,0
2020-04-07,Contra Costa,013,1133247,668,471,0,471,7
2020-04-07,Del Norte,015,27424,2,2,0,2,0
2020-04-07,El Dorado,017,186661,46,22,0,22,0
2020-04-07,Fresno,019,978130,393,138,4,142,3
2020-04-07,Glenn,021,27897,4,2,0,2,0
2020-04-07,Humboldt,023,135768,56,40,0,40,0
2020-04-07,Imperial,025,180216,129,53,0,53,2
2020-04-07,Inyo,027,18085,12,11,0,11,0
2020-04-07,Kern,029,883053,507,134,0,134,2
2020-04-07,Kings,031,150075,40,5,1,6,0
2020-04-07,Lake,033,64148,4,1,0,1,0
2020-04-07,Lassen,035,31185,3,0,2,2,0
2020-04-07,Los Angeles,037,10098052,11715,6885,11,6896,170
2020-04-07,Madera,039,155013,60,28,0,28,2
2020-04-07,Marin,041,260295,163,122,1,123,7
2020-04-07,Mariposa,043,17540,0,0,0,0,0
2020-04-07,Mendocino,045,87422,5,4,0,4,0
2020-04-07,Merced,047,269075,67,27,0,27,1
2020-04-07,Modoc,049,8938,0,0,0,0,0
2020-04-07,Mono,051,14174,28,18,0,18,1
2020-04-07,Monterey,053,433212,107,63,0,63,2
2020-04-07,Napa,055,140530,42,18,0,18,2
2020-04-07,Nevada,057,99092,36,20,1,21,1
2020-04-07,Orange,059,3164182,1701,971,16,987,19
2020-04-07,Placer,061,380077,139,94,0,94,3
2020-04-07,Plumas,063,18699,4,3,0,3,0
2020-04-07,Riverside,065,2383286,2151,905,13,918,25
2020-04-07,Sacramento,067,1510023,813,513,0,513,18
2020-04-07,San Benito,069,59416,37,26,0,26,2
2020-04-07,San Bernardino,071,2135413,1164,554,0,554,19
2020-04-07,San Diego,073,3302833,2072,1456,0,1456,31
2020-04-07,San Francisco,075,870044,993,636,0,636,6
2020-04-07,San Joaquin,077,732212,348,198,3,201,12
2020-04-07,San Luis Obispo,079,281455,149,87,1,88,1
2020-04-07,San Mateo,081,765935,866,573,2,575,22
2020-04-07,Santa Barbara,083,443738,305,209,1,210,2
2020-04-07,Santa Clara,085,1922200,1760,1193,4,1197,46
2020-04-07,Santa Cruz,087,273765,100,67,0,67,1
2020-04-07,Shasta,089,179085,29,16,0,16,3
2020-04-07,Sierra,091,2930,0,0,0,0,0
2020-04-07,Siskiyou,093,43540,5,4,0,4,0
2020-04-07,Solano,095,438530,170,99,0,99,1
2020-04-07,Sonoma,097,501317,168,102,0,102,1
2020-04-07,Stanislaus,099,539301,186,83,3,86,0
2020-04-07,Sutter,101,95872,22,16,0,16,2
2020-04-07,Tehama,103,63373,1,1,0,1,0
2020-04-07,Trinity,105,12862,0,0,0,0,0
2020-04-07,Tulare,107,460477,334,144,5,149,5
2020-04-07,Tuolumne,109,53932,3,1,0,1,0
2020-04-07,Ventura,111,848112,409,247,0,247,6
2020-04-07,Yolo,113,214977,97,51,0,51,2
2020-04-07,Yuba,115,75493,14,10,0,10,0
2020-04-06,Alameda,001,1643700,964,527,1,528,13
2020-04-06,Alpine,003,1148,1,1,0,1,0
2020-04-06,Amador,005,37829,6,2,0,2,0
2020-04-06,Butte,007,227075,16,11,1,12,0
2020-04-06,Calaveras,009,45235,9,4,0,4,0
2020-04-06,Colusa,011,21464,3,1,0,1,0
2020-04-06,Contra Costa,013,1133247,643,447,0,447,7
2020-04-06,Del Norte,015,27424,2,2,0,2,0
2020-04-06,El Dorado,017,186661,44,23,0,23,0
2020-04-06,Fresno,019,978130,371,122,4,126,1
2020-04-06,Glenn,021,27897,4,2,0,2,0
2020-04-06,Humboldt,023,135768,55,37,0,37,0
2020-04-06,Imperial,025,180216,122,47,0,47,1
2020-04-06,Inyo,027,18085,11,11,0,11,0
2020-04-06,Kern,029,883053,470,117,0,117,2
2020-04-06,Kings,031,150075,40,3,1,4,0
2020-04-06,Lake,033,64148,4,1,0,1,0
2020-04-06,Lassen,035,31185,3,0,2,2,0
2020-04-06,Los Angeles,037,10098052,10983,6346,11,6357,145
2020-04-06,Madera,039,155013,58,29,0,29,2
2020-04-06,Marin,041,260295,160,119,1,120,7
2020-04-06,Mariposa,043,17540,0,0,0,0,0
2020-04-06,Mendocino,045,87422,5,4,0,4,0
2020-04-06,Merced,047,269075,60,25,0,25,1
2020-04-06,Modoc,049,8938,0,0,0,0,0
2020-04-06,Mono,051,14174,28,18,0,18,1
2020-04-06,Monterey,053,433212,102,62,0,62,2
2020-04-06,Napa,055,140530,42,18,0,18,2
2020-04-06,Nevada,057,99092,36,19,1,20,1
2020-04-06,Orange,059,3164182,1657,910,15,925,17
2020-04-06,Placer,061,380077,139,90,0,90,3
2020-04-06,Plumas,063,18699,4,2,0,2,0
2020-04-06,Riverside,065,2383286,2025,854,13,867,17
2020-04-06,Sacramento,067,1510023,783,448,0,448,15
2020-04-06,San Benito,069,59416,35,25,0,25,1
2020-04-06,San Bernardino,071,2135413,1105,550,0,550,13
2020-04-06,San Diego,073,3302833,1990,1406,0,1406,19
2020-04-06,San Francisco,075,870044,953,586,0,586,6
2020-04-06,San Joaquin,077,732212,333,191,3,194,10
2020-04-06,San Luis Obispo,079,281455,147,85,1,86,1
2020-04-06,San Mateo,081,765935,848,569,2,571,20
2020-04-06,Santa Barbara,083,443738,296,189,1,190,2
2020-04-06,Santa Clara,085,1922200,1707,1128,4,1132,43
2020-04-06,Santa Cruz,087,273765,98,65,0,65,1
2020-04-06,Shasta,089,179085,29,16,0,16,3
2020-04-06,Sierra,091,2930,0,0,0,0,0
2020-04-06,Siskiyou,093,43540,4,4,0,4,0
2020-04-06,Solano,095,438530,163,95,0,95,1
2020-04-06,Sonoma,097,501317,167,102,0,102,1
2020-04-06,Stanislaus,099,539301,170,72,3,75,0
2020-04-06,Sutter,101,95872,22,14,0,14,2
2020-04-06,Tehama,103,63373,1,1,0,1,0
2020-04-06,Trinity,105,12862,0,0,0,0,0
2020-04-06,Tulare,107,460477,318,126,5,131,5
2020-04-06,Tuolumne,109,53932,3,1,0,1,0
2020-04-06,Ventura,111,848112,391,234,0,234,6
2020-04-06,Yolo,113,214977,93,43,0,43,1
2020-04-06,Yuba,115,75493,14,8,0,8,0
2020-04-05,Alameda,001,1643700,922,475,1,476,12
2020-04-05,Alpine,003,1148,1,1,0,1,0
2020-04-05,Amador,005,37829,6,2,0,2,0
2020-04-05,Butte,007,227075,16,10,1,11,0
2020-04-05,Calaveras,009,45235,9,3,0,3,0
2020-04-05,Colusa,011,21464,3,1,0,1,0
2020-04-05,Contra Costa,013,1133247,626,415,0,415,6
2020-04-05,Del Norte,015,27424,2,1,0,1,0
2020-04-05,El Dorado,017,186661,42,19,0,19,0
2020-04-05,Fresno,019,978130,337,102,4,106,1
2020-04-05,Glenn,021,27897,4,2,0,2,0
2020-04-05,Humboldt,023,135768,55,29,0,29,0
2020-04-05,Imperial,025,180216,114,42,0,42,1
2020-04-05,Inyo,027,18085,11,10,0,10,0
2020-04-05,Kern,029,883053,415,109,0,109,2
2020-04-05,Kings,031,150075,39,4,1,5,0
2020-04-05,Lake,033,64148,4,0,0,0,0
2020-04-05,Lassen,035,31185,3,0,2,2,0
2020-04-05,Los Angeles,037,10098052,10411,5892,11,5903,130
2020-04-05,Madera,039,155013,57,27,0,27,2
2020-04-05,Marin,041,260295,160,113,1,114,6
2020-04-05,Mariposa,043,17540,0,0,0,0,0
2020-04-05,Mendocino,045,87422,5,4,0,4,0
2020-04-05,Merced,047,269075,53,16,0,16,0
2020-04-05,Modoc,049,8938,0,0,0,0,0
2020-04-05,Mono,051,14174,28,18,0,18,1
2020-04-05,Monterey,053,433212,95,61,0,61,2
2020-04-05,Napa,055,140530,40,15,0,15,2
2020-04-05,Nevada,057,99092,36,19,1,20,1
2020-04-05,Orange,059,3164182,1600,820,15,835,15
2020-04-05,Placer,061,380077,136,86,0,86,3
2020-04-05,Plumas,063,18699,3,2,0,2,0
2020-04-05,Riverside,065,2383286,1896,669,13,682,17
2020-04-05,Sacramento,067,1510023,752,393,0,393,11
2020-04-05,San Benito,069,59416,35,22,0,22,1
2020-04-05,San Bernardino,071,2135413,1031,375,0,375,13
2020-04-05,San Diego,073,3302833,1908,1328,0,1328,19
2020-04-05,San Francisco,075,870044,906,559,0,559,6
2020-04-05,San Joaquin,077,732212,318,179,3,182,10
2020-04-05,San Luis Obispo,079,281455,145,83,1,84,1
2020-04-05,San Mateo,081,765935,828,528,2,530,19
2020-04-05,Santa Barbara,083,443738,280,171,1,172,1
2020-04-05,Santa Clara,085,1922200,1660,1052,4,1056,42
2020-04-05,Santa Cruz,087,273765,98,59,0,59,1
2020-04-05,Shasta,089,179085,28,11,0,11,2
2020-04-05,Sierra,091,2930,0,0,0,0,0
2020-04-05,Siskiyou,093,43540,4,3,0,3,0
2020-04-05,Solano,095,438530,159,78,0,78,1
2020-04-05,Sonoma,097,501317,165,88,0,88,1
2020-04-05,Stanislaus,099,539301,156,51,3,54,0
2020-04-05,Sutter,101,95872,22,14,0,14,1
2020-04-05,Tehama,103,63373,1,1,0,1,0
2020-04-05,Trinity,105,12862,0,0,0,0,0
2020-04-05,Tulare,107,460477,281,81,5,86,4
2020-04-05,Tuolumne,109,53932,3,1,0,1,0
2020-04-05,Ventura,111,848112,377,196,0,196,6
2020-04-05,Yolo,113,214977,75,37,0,37,2
2020-04-05,Yuba,115,75493,14,7,0,7,0
2020-04-04,Alameda,001,1643700,899,468,1,469,12
2020-04-04,Alpine,003,1148,1,1,0,1,0
2020-04-04,Amador,005,37829,5,2,0,2,0
2020-04-04,Butte,007,227075,16,10,1,11,0
2020-04-04,Calaveras,009,45235,9,3,0,3,0
2020-04-04,Colusa,011,21464,3,1,0,1,0
2020-04-04,Contra Costa,013,1133247,618,382,0,382,5
2020-04-04,Del Norte,015,27424,2,1,0,1,0
2020-04-04,El Dorado,017,186661,42,19,0,19,0
2020-04-04,Fresno,019,978130,327,102,4,106,1
2020-04-04,Glenn,021,27897,4,2,0,2,0
2020-04-04,Humboldt,023,135768,55,29,0,29,0
2020-04-04,Imperial,025,180216,113,42,0,42,1
2020-04-04,Inyo,027,18085,11,10,0,10,0
2020-04-04,Kern,029,883053,385,103,0,103,2
2020-04-04,Kings,031,150075,39,3,1,4,0
2020-04-04,Lake,033,64148,4,0,0,0,0
2020-04-04,Lassen,035,31185,3,0,2,2,0
2020-04-04,Los Angeles,037,10098052,9793,5275,11,5286,117
2020-04-04,Madera,039,155013,55,27,0,27,2
2020-04-04,Marin,041,260295,158,111,0,111,6
2020-04-04,Mariposa,043,17540,0,0,0,0,0
2020-04-04,Mendocino,045,87422,5,4,0,4,0
2020-04-04,Merced,047,269075,49,11,0,11,0
2020-04-04,Modoc,049,8938,0,0,0,0,0
2020-04-04,Mono,051,14174,28,18,0,18,1
2020-04-04,Monterey,053,433212,91,61,0,61,2
2020-04-04,Napa,055,140530,40,15,0,15,2
2020-04-04,Nevada,057,99092,36,19,1,20,1
2020-04-04,Orange,059,3164182,1558,781,14,795,15
2020-04-04,Placer,061,380077,135,87,0,87,2
2020-04-04,Plumas,063,18699,3,2,0,2,0
2020-04-04,Riverside,065,2383286,1795,652,13,665,15
2020-04-04,Sacramento,067,1510023,734,393,0,393,11
2020-04-04,San Benito,069,59416,35,22,0,22,1
2020-04-04,San Bernardino,071,2135413,983,373,0,373,13
2020-04-04,San Diego,073,3302833,1860,1211,0,1211,18
2020-04-04,San Francisco,075,870044,868,537,0,537,6
2020-04-04,San Joaquin,077,732212,295,171,3,174,10
2020-04-04,San Luis Obispo,079,281455,145,82,1,83,0
2020-04-04,San Mateo,081,765935,816,520,2,522,17
2020-04-04,Santa Barbara,083,443738,271,167,1,168,1
2020-04-04,Santa Clara,085,1922200,1608,1045,4,1049,39
2020-04-04,Santa Cruz,087,273765,98,56,0,56,1
2020-04-04,Shasta,089,179085,27,11,0,11,2
2020-04-04,Sierra,091,2930,0,0,0,0,0
2020-04-04,Siskiyou,093,43540,4,3,0,3,0
2020-04-04,Solano,095,438530,154,79,0,79,1
2020-04-04,Sonoma,097,501317,162,88,0,88,1
2020-04-04,Stanislaus,099,539301,145,51,3,54,0
2020-04-04,Sutter,101,95872,22,14,0,14,1
2020-04-04,Tehama,103,63373,1,1,0,1,0
2020-04-04,Trinity,105,12862,0,0,0,0,0
2020-04-04,Tulare,107,460477,267,79,5,84,4
2020-04-04,Tuolumne,109,53932,3,1,0,1,0
2020-04-04,Ventura,111,848112,364,194,0,194,6
2020-04-04,Yolo,113,214977,73,40,0,40,2
2020-04-04,Yuba,115,75493,13,7,0,7,0
2020-04-03,Alameda,001,1643700,863,395,1,396,11
2020-04-03,Alpine,003,1148,1,1,0,1,0
2020-04-03,Amador,005,37829,5,2,0,2,0
2020-04-03,Butte,007,227075,16,8,1,9,0
2020-04-03,Calaveras,009,45235,9,3,0,3,0
2020-04-03,Colusa,011,21464,3,1,0,1,0
2020-04-03,Contra Costa,013,1133247,595,327,0,327,5
2020-04-03,Del Norte,015,27424,2,1,0,1,0
2020-04-03,El Dorado,017,186661,40,16,0,16,0
2020-04-03,Fresno,019,978130,315,98,4,102,1
2020-04-03,Glenn,021,27897,4,2,0,2,0
2020-04-03,Humboldt,023,135768,55,34,0,34,0
2020-04-03,Imperial,025,180216,104,35,0,35,0
2020-04-03,Inyo,027,18085,11,10,0,10,0
2020-04-03,Kern,029,883053,359,87,0,87,1
2020-04-03,Kings,031,150075,37,3,1,4,0
2020-04-03,Lake,033,64148,3,0,0,0,0
2020-04-03,Lassen,035,31185,3,0,2,2,0
2020-04-03,Los Angeles,037,10098052,9178,4566,11,4577,91
2020-04-03,Madera,039,155013,54,28,0,28,2
2020-04-03,Marin,041,260295,156,106,0,106,6
2020-04-03,Mariposa,043,17540,0,0,0,0,0
2020-04-03,Mendocino,045,87422,5,4,0,4,0
2020-04-03,Merced,047,269075,46,9,0,9,0
2020-04-03,Modoc,049,8938,0,0,0,0,0
2020-04-03,Mono,051,14174,28,18,0,18,1
2020-04-03,Monterey,053,433212,88,58,0,58,2
2020-04-03,Napa,055,140530,39,13,0,13,1
2020-04-03,Nevada,057,99092,36,19,1,20,1
2020-04-03,Orange,059,3164182,1519,713,14,727,13
2020-04-03,Placer,061,380077,131,76,0,76,2
2020-04-03,Plumas,063,18699,3,2,0,2,0
2020-04-03,Riverside,065,2383286,1715,540,13,553,14
2020-04-03,Sacramento,067,1510023,713,363,0,363,11
2020-04-03,San Benito,069,59416,35,22,0,22,1
2020-04-03,San Bernardino,071,2135413,938,356,0,356,11
2020-04-03,San Diego,073,3302833,1800,1114,0,1114,17
2020-04-03,San Francisco,075,870044,844,506,0,506,6
2020-04-03,San Joaquin,077,732212,283,162,3,165,10
2020-04-03,San Luis Obispo,079,281455,144,82,1,83,0
2020-04-03,San Mateo,081,765935,799,474,2,476,13
2020-04-03,Santa Barbara,083,443738,260,154,1,155,1
2020-04-03,Santa Clara,085,1922200,1572,983,4,987,39
2020-04-03,Santa Cruz,087,273765,98,52,0,52,1
2020-04-03,Shasta,089,179085,27,10,0,10,1
2020-04-03,Sierra,091,2930,0,0,0,0,0
2020-04-03,Siskiyou,093,43540,4,3,0,3,0
2020-04-03,Solano,095,438530,146,72,0,72,1
2020-04-03,Sonoma,097,501317,162,84,0,84,1
2020-04-03,Stanislaus,099,539301,139,48,3,51,0
2020-04-03,Sutter,101,95872,22,12,0,12,1
2020-04-03,Tehama,103,63373,1,1,0,1,0
2020-04-03,Trinity,105,12862,0,0,0,0,0
2020-04-03,Tulare,107,460477,253,73,5,78,3
2020-04-03,Tuolumne,109,53932,3,1,0,1,0
2020-04-03,Ventura,111,848112,354,186,0,186,6
2020-04-03,Yolo,113,214977,72,33,0,33,1
2020-04-03,Yuba,115,75493,13,6,0,6,0
2020-04-02,Alameda,001,1643700,812,345,1,346,10
2020-04-02,Alpine,003,1148,1,1,0,1,0
2020-04-02,Amador,005,37829,5,2,0,2,0
2020-04-02,Butte,007,227075,16,7,0,7,0
2020-04-02,Calaveras,009,45235,7,3,0,3,0
2020-04-02,Colusa,011,21464,3,1,0,1,0
2020-04-02,Contra Costa,013,1133247,565,297,0,297,3
2020-04-02,Del Norte,015,27424,2,0,0,0,0
2020-04-02,El Dorado,017,186661,38,16,0,16,0
2020-04-02,Fresno,019,978130,299,92,4,96,0
2020-04-02,Glenn,021,27897,3,2,0,2,0
2020-04-02,Humboldt,023,135768,51,23,0,23,0
2020-04-02,Imperial,025,180216,100,24,0,24,0
2020-04-02,Inyo,027,18085,10,8,0,8,0
2020-04-02,Kern,029,883053,332,74,0,74,0
2020-04-02,Kings,031,150075,37,3,1,4,0
2020-04-02,Lake,033,64148,3,0,0,0,0
2020-04-02,Lassen,035,31185,3,0,2,2,0
2020-04-02,Los Angeles,037,10098052,8346,4040,11,4051,79
2020-04-02,Madera,039,155013,52,25,0,25,1
2020-04-02,Marin,041,260295,150,102,0,102,1
2020-04-02,Mariposa,043,17540,0,0,0,0,0
2020-04-02,Mendocino,045,87422,5,4,0,4,0
2020-04-02,Merced,047,269075,41,9,0,9,0
2020-04-02,Modoc,049,8938,0,0,0,0,0
2020-04-02,Mono,051,14174,28,16,0,16,1
2020-04-02,Monterey,053,433212,86,50,0,50,2
2020-04-02,Napa,055,140530,39,13,0,13,0
2020-04-02,Nevada,057,99092,35,17,1,18,0
2020-04-02,Orange,059,3164182,1467,640,13,653,12
2020-04-02,Placer,061,380077,130,72,0,72,2
2020-04-02,Plumas,063,18699,3,1,0,1,0
2020-04-02,Riverside,065,2383286,1598,438,13,451,13
2020-04-02,Sacramento,067,1510023,695,322,0,322,9
2020-04-02,San Benito,069,59416,33,18,0,18,1
2020-04-02,San Bernardino,071,2135413,883,335,0,335,8
2020-04-02,San Diego,073,3302833,1733,968,0,968,16
2020-04-02,San Francisco,075,870044,817,473,0,473,6
2020-04-02,San Joaquin,077,732212,264,148,3,151,9
2020-04-02,San Luis Obispo,079,281455,139,79,1,80,0
2020-04-02,San Mateo,081,765935,778,423,2,425,13
2020-04-02,Santa Barbara,083,443738,249,125,1,126,1
2020-04-02,Santa Clara,085,1922200,1521,908,4,912,38
2020-04-02,Santa Cruz,087,273765,96,49,0,49,1
2020-04-02,Shasta,089,179085,26,7,0,7,1
2020-04-02,Sierra,091,2930,0,0,0,0,0
2020-04-02,Siskiyou,093,43540,4,3,0,3,0
2020-04-02,Solano,095,438530,136,65,0,65,0
2020-04-02,Sonoma,097,501317,158,76,0,76,1
2020-04-02,Stanislaus,099,539301,128,40,3,43,0
2020-04-02,Sutter,101,95872,21,10,0,10,1
2020-04-02,Tehama,103,63373,1,1,0,1,0
2020-04-02,Trinity,105,12862,0,0,0,0,0
2020-04-02,Tulare,107,460477,219,64,5,69,1
2020-04-02,Tuolumne,109,53932,3,1,0,1,0
2020-04-02,Ventura,111,848112,336,178,0,178,5
2020-04-02,Yolo,113,214977,70,29,0,29,1
2020-04-02,Yuba,115,75493,10,5,0,5,0
2020-04-01,Alameda,001,1643700,785,287,1,288,8
2020-04-01,Alpine,003,1148,1,1,0,1,0
2020-04-01,Amador,005,37829,5,1,0,1,0
2020-04-01,Butte,007,227075,16,6,0,6,0
2020-04-01,Calaveras,009,45235,6,3,0,3,0
2020-04-01,Colusa,011,21464,3,1,0,1,0
2020-04-01,Contra Costa,013,1133247,521,267,0,267,3
2020-04-01,Del Norte,015,27424,2,0,0,0,0
2020-04-01,El Dorado,017,186661,37,14,0,14,0
2020-04-01,Fresno,019,978130,277,75,3,78,0
2020-04-01,Glenn,021,27897,3,2,0,2,0
2020-04-01,Humboldt,023,135768,51,19,0,19,0
2020-04-01,Imperial,025,180216,93,25,0,25,0
2020-04-01,Inyo,027,18085,10,8,0,8,0
2020-04-01,Kern,029,883053,305,53,0,53,0
2020-04-01,Kings,031,150075,35,3,1,4,0
2020-04-01,Lake,033,64148,3,0,0,0,0
2020-04-01,Lassen,035,31185,3,0,2,2,0
2020-04-01,Los Angeles,037,10098052,7696,3502,11,3513,66
2020-04-01,Madera,039,155013,50,17,0,17,1
2020-04-01,Marin,041,260295,146,87,0,87,1
2020-04-01,Mariposa,043,17540,0,0,0,0,0
2020-04-01,Mendocino,045,87422,5,4,0,4,0
2020-04-01,Merced,047,269075,38,7,0,7,0
2020-04-01,Modoc,049,8938,0,0,0,0,0
2020-04-01,Mono,051,14174,28,12,0,12,1
2020-04-01,Monterey,053,433212,85,47,0,47,2
2020-04-01,Napa,055,140530,36,11,0,11,0
2020-04-01,Nevada,057,99092,35,15,1,16,0
2020-04-01,Orange,059,3164182,1415,579,13,592,11
2020-04-01,Placer,061,380077,128,52,0,52,2
2020-04-01,Plumas,063,18699,3,1,0,1,0
2020-04-01,Riverside,065,2383286,1430,306,12,318,11
2020-04-01,Sacramento,067,1510023,662,299,0,299,8
2020-04-01,San Benito,069,59416,30,14,0,14,1
2020-04-01,San Bernardino,071,2135413,834,245,0,245,5
2020-04-01,San Diego,073,3302833,1663,851,0,851,11
2020-04-01,San Francisco,075,870044,789,432,0,432,6
2020-04-01,San Joaquin,077,732212,252,132,3,135,8
2020-04-01,San Luis Obispo,079,281455,133,69,1,70,0
2020-04-01,San Mateo,081,765935,760,354,2,356,13
2020-04-01,Santa Barbara,083,443738,236,103,1,104,0
2020-04-01,Santa Clara,085,1922200,1479,805,4,809,33
2020-04-01,Santa Cruz,087,273765,91,44,0,44,1
2020-04-01,Shasta,089,179085,25,5,0,5,1
2020-04-01,Sierra,091,2930,0,0,0,0,0
2020-04-01,Siskiyou,093,43540,4,3,0,3,0
2020-04-01,Solano,095,438530,131,57,0,57,0
2020-04-01,Sonoma,097,501317,154,60,0,60,1
2020-04-01,Stanislaus,099,539301,117,29,3,32,0
2020-04-01,Sutter,101,95872,21,9,0,9,1
2020-04-01,Tehama,103,63373,1,0,0,0,0
2020-04-01,Trinity,105,12862,0,0,0,0,0
2020-04-01,Tulare,107,460477,181,43,5,48,1
2020-04-01,Tuolumne,109,53932,3,1,0,1,0
2020-04-01,Ventura,111,848112,323,154,0,154,5
2020-04-01,Yolo,113,214977,65,22,0,22,1
2020-04-01,Yuba,115,75493,9,5,0,5,0
2020-03-31,Alameda,001,1643700,717,269,1,270,7
2020-03-31,Alpine,003,1148,1,1,0,1,0
2020-03-31,Amador,005,37829,5,1,0,1,0
2020-03-31,Butte,007,227075,16,6,0,6,0
2020-03-31,Calaveras,009,45235,6,3,0,3,0
2020-03-31,Colusa,011,21464,3,1,0,1,0
2020-03-31,Contra Costa,013,1133247,496,246,0,246,3
2020-03-31,Del Norte,015,27424,1,0,0,0,0
2020-03-31,El Dorado,017,186661,33,14,0,14,0
2020-03-31,Fresno,019,978130,252,59,3,62,0
2020-03-31,Glenn,021,27897,3,2,0,2,0
2020-03-31,Humboldt,023,135768,51,18,0,18,0
2020-03-31,Imperial,025,180216,88,17,0,17,0
2020-03-31,Inyo,027,18085,10,8,0,8,0
2020-03-31,Kern,029,883053,281,47,0,47,0
2020-03-31,Kings,031,150075,33,2,1,3,0
2020-03-31,Lake,033,64148,1,0,0,0,0
2020-03-31,Lassen,035,31185,3,0,2,2,0
2020-03-31,Los Angeles,037,10098052,7031,3001,11,3012,53
2020-03-31,Madera,039,155013,49,17,0,17,1
2020-03-31,Marin,041,260295,137,85,0,85,1
2020-03-31,Mariposa,043,17540,0,0,0,0,0
2020-03-31,Mendocino,045,87422,5,4,0,4,0
2020-03-31,Merced,047,269075,33,6,0,6,0
2020-03-31,Modoc,049,8938,0,0,0,0,0
2020-03-31,Mono,051,14174,26,12,0,12,0
2020-03-31,Monterey,053,433212,83,43,0,43,2
2020-03-31,Napa,055,140530,35,9,0,9,0
2020-03-31,Nevada,057,99092,35,15,1,16,0
2020-03-31,Orange,059,3164182,1345,506,13,519,7
2020-03-31,Placer,061,380077,121,49,0,49,2
2020-03-31,Plumas,063,18699,1,0,0,0,0
2020-03-31,Riverside,065,2383286,1284,284,12,296,8
2020-03-31,Sacramento,067,1510023,610,271,0,271,8
2020-03-31,San Benito,069,59416,30,14,0,14,1
2020-03-31,San Bernardino,071,2135413,749,193,0,193,5
2020-03-31,San Diego,073,3302833,1581,736,0,736,9
2020-03-31,San Francisco,075,870044,754,404,0,404,5
2020-03-31,San Joaquin,077,732212,236,122,3,125,7
2020-03-31,San Luis Obispo,079,281455,129,67,1,68,0
2020-03-31,San Mateo,081,765935,741,297,2,299,12
2020-03-31,Santa Barbara,083,443738,221,89,1,90,0
2020-03-31,Santa Clara,085,1922200,1429,777,4,781,30
2020-03-31,Santa Cruz,087,273765,84,40,0,40,1
2020-03-31,Shasta,089,179085,22,5,0,5,1
2020-03-31,Sierra,091,2930,0,0,0,0,0
2020-03-31,Siskiyou,093,43540,4,3,0,3,0
2020-03-31,Solano,095,438530,117,56,0,56,0
2020-03-31,Sonoma,097,501317,149,58,0,58,1
2020-03-31,Stanislaus,099,539301,102,28,3,31,0
2020-03-31,Sutter,101,95872,21,8,0,8,0
2020-03-31,Tehama,103,63373,1,0,0,0,0
2020-03-31,Trinity,105,12862,0,0,0,0,0
2020-03-31,Tulare,107,460477,158,42,4,46,1
2020-03-31,Tuolumne,109,53932,3,1,0,1,0
2020-03-31,Ventura,111,848112,312,143,0,143,4
2020-03-31,Yolo,113,214977,58,21,0,21,1
2020-03-31,Yuba,115,75493,9,5,0,5,0
2020-03-30,Alameda,001,1643700,677,250,1,251,7
2020-03-30,Alpine,003,1148,1,1,0,1,0
2020-03-30,Amador,005,37829,5,1,0,1,0
2020-03-30,Butte,007,227075,14,5,0,5,0
2020-03-30,Calaveras,009,45235,6,3,0,3,0
2020-03-30,Colusa,011,21464,3,1,0,1,0
2020-03-30,Contra Costa,013,1133247,470,212,0,212,3
2020-03-30,Del Norte,015,27424,0,0,0,0,0
2020-03-30,El Dorado,017,186661,33,11,0,11,0
2020-03-30,Fresno,019,978130,227,46,3,49,0
2020-03-30,Glenn,021,27897,3,2,0,2,0
2020-03-30,Humboldt,023,135768,49,11,0,11,0
2020-03-30,Imperial,025,180216,85,9,0,9,0
2020-03-30,Inyo,027,18085,10,5,0,5,0
2020-03-30,Kern,029,883053,248,30,0,30,0
2020-03-30,Kings,031,150075,33,1,1,2,0
2020-03-30,Lake,033,64148,1,0,0,0,0
2020-03-30,Lassen,035,31185,3,0,1,1,0
2020-03-30,Los Angeles,037,10098052,6375,2467,11,2478,44
2020-03-30,Madera,039,155013,48,14,0,14,1
2020-03-30,Marin,041,260295,130,78,0,78,0
2020-03-30,Mariposa,043,17540,0,0,0,0,0
2020-03-30,Mendocino,045,87422,5,2,0,2,0
2020-03-30,Merced,047,269075,29,6,0,6,0
2020-03-30,Modoc,049,8938,0,0,0,0,0
2020-03-30,Mono,051,14174,26,11,0,11,0
2020-03-30,Monterey,053,433212,78,41,0,41,1
2020-03-30,Napa,055,140530,34,9,0,9,0
2020-03-30,Nevada,057,99092,34,14,1,15,0
2020-03-30,Orange,059,3164182,1279,418,13,431,5
2020-03-30,Placer,061,380077,118,44,0,44,2
2020-03-30,Plumas,063,18699,1,0,0,0,0
2020-03-30,Riverside,065,2383286,1203,204,12,216,7
2020-03-30,Sacramento,067,1510023,586,238,0,238,8
2020-03-30,San Benito,069,59416,30,11,0,11,1
2020-03-30,San Bernardino,071,2135413,705,145,0,145,4
2020-03-30,San Diego,073,3302833,1511,605,0,605,7
2020-03-30,San Francisco,075,870044,714,368,0,368,5
2020-03-30,San Joaquin,077,732212,229,112,3,115,5
2020-03-30,San Luis Obispo,079,281455,126,62,1,63,0
2020-03-30,San Mateo,081,765935,717,257,2,259,11
2020-03-30,Santa Barbara,083,443738,212,79,1,80,0
2020-03-30,Santa Clara,085,1922200,1398,745,3,748,31
2020-03-30,Santa Cruz,087,273765,81,36,0,36,1
2020-03-30,Shasta,089,179085,21,4,0,4,1
2020-03-30,Sierra,091,2930,0,0,0,0,0
2020-03-30,Siskiyou,093,43540,4,2,0,2,0
2020-03-30,Solano,095,438530,111,50,0,50,0
2020-03-30,Sonoma,097,501317,146,57,0,57,1
2020-03-30,Stanislaus,099,539301,95,28,3,31,0
2020-03-30,Sutter,101,95872,20,6,0,6,0
2020-03-30,Tehama,103,63373,1,0,0,0,0
2020-03-30,Trinity,105,12862,0,0,0,0,0
2020-03-30,Tulare,107,460477,146,40,3,43,1
2020-03-30,Tuolumne,109,53932,3,1,0,1,0
2020-03-30,Ventura,111,848112,301,118,0,118,2
2020-03-30,Yolo,113,214977,55,17,0,17,1
2020-03-30,Yuba,115,75493,8,5,0,5,0
2020-03-29,Alameda,001,1643700,643,207,1,208,6
2020-03-29,Alpine,003,1148,1,0,0,0,0
2020-03-29,Amador,005,37829,5,1,0,1,0
2020-03-29,Butte,007,227075,14,4,0,4,0
2020-03-29,Calaveras,009,45235,6,2,0,2,0
2020-03-29,Colusa,011,21464,3,1,0,1,0
2020-03-29,Contra Costa,013,1133247,440,187,0,187,3
2020-03-29,Del Norte,015,27424,0,0,0,0,0
2020-03-29,El Dorado,017,186661,32,9,0,9,0
2020-03-29,Fresno,019,978130,203,31,3,34,0
2020-03-29,Glenn,021,27897,2,1,0,1,0
2020-03-29,Humboldt,023,135768,46,9,0,9,0
2020-03-29,Imperial,025,180216,79,9,0,9,0
2020-03-29,Inyo,027,18085,9,0,0,0,0
2020-03-29,Kern,029,883053,230,20,0,20,0
2020-03-29,Kings,031,150075,30,1,1,2,0
2020-03-29,Lake,033,64148,0,0,0,0,0
2020-03-29,Lassen,035,31185,3,0,1,1,0
2020-03-29,Los Angeles,037,10098052,5730,2119,11,2130,37
2020-03-29,Madera,039,155013,43,11,0,11,1
2020-03-29,Marin,041,260295,125,60,0,60,0
2020-03-29,Mariposa,043,17540,0,0,0,0,0
2020-03-29,Mendocino,045,87422,5,2,0,2,0
2020-03-29,Merced,047,269075,28,4,0,4,0
2020-03-29,Modoc,049,8938,0,0,0,0,0
2020-03-29,Mono,051,14174,26,8,0,8,0
2020-03-29,Monterey,053,433212,73,36,0,36,1
2020-03-29,Napa,055,140530,32,5,0,5,0
2020-03-29,Nevada,057,99092,32,13,1,14,0
2020-03-29,Orange,059,3164182,1206,343,13,356,2
2020-03-29,Placer,061,380077,117,35,0,35,2
2020-03-29,Plumas,063,18699,1,0,0,0,0
2020-03-29,Riverside,065,2383286,1079,122,12,134,7
2020-03-29,Sacramento,067,1510023,546,217,0,217,7
2020-03-29,San Benito,069,59416,29,10,0,10,1
2020-03-29,San Bernardino,071,2135413,653,94,0,94,2
2020-03-29,San Diego,073,3302833,1439,521,0,521,7
2020-03-29,San Francisco,075,870044,670,333,0,333,5
2020-03-29,San Joaquin,077,732212,220,86,3,89,4
2020-03-29,San Luis Obispo,079,281455,119,55,0,55,0
2020-03-29,San Mateo,081,765935,692,234,2,236,12
2020-03-29,Santa Barbara,083,443738,204,52,1,53,0
2020-03-29,Santa Clara,085,1922200,1341,591,3,594,30
2020-03-29,Santa Cruz,087,273765,81,33,0,33,1
2020-03-29,Shasta,089,179085,20,4,0,4,1
2020-03-29,Sierra,091,2930,0,0,0,0,0
2020-03-29,Siskiyou,093,43540,4,2,0,2,0
2020-03-29,Solano,095,438530,103,48,0,48,0
2020-03-29,Sonoma,097,501317,144,35,0,35,1
2020-03-29,Stanislaus,099,539301,90,19,3,22,0
2020-03-29,Sutter,101,95872,17,6,0,6,0
2020-03-29,Tehama,103,63373,1,0,0,0,0
2020-03-29,Trinity,105,12862,0,0,0,0,0
2020-03-29,Tulare,107,460477,121,24,3,27,1
2020-03-29,Tuolumne,109,53932,2,1,0,1,0
2020-03-29,Ventura,111,848112,274,92,0,92,2
2020-03-29,Yolo,113,214977,50,13,0,13,1
2020-03-29,Yuba,115,75493,8,3,0,3,0
2020-03-28,Alameda,001,1643700,616,410,1,411,12
2020-03-28,Alpine,003,1148,1,0,0,0,0
2020-03-28,Amador,005,37829,5,2,0,2,0
2020-03-28,Butte,007,227075,14,8,0,8,0
2020-03-28,Calaveras,009,45235,6,4,0,4,0
2020-03-28,Colusa,011,21464,3,2,0,2,0
2020-03-28,Contra Costa,013,1133247,417,350,0,350,4
2020-03-28,Del Norte,015,27424,0,0,0,0,0
2020-03-28,El Dorado,017,186661,31,18,0,18,0
2020-03-28,Fresno,019,978130,193,62,3,65,0
2020-03-28,Glenn,021,27897,2,2,0,2,0
2020-03-28,Humboldt,023,135768,46,18,0,18,0
2020-03-28,Imperial,025,180216,74,18,0,18,0
2020-03-28,Inyo,027,18085,9,0,0,0,0
2020-03-28,Kern,029,883053,213,40,0,40,0
2020-03-28,Kings,031,150075,29,2,1,3,0
2020-03-28,Lake,033,64148,0,0,0,0,0
2020-03-28,Lassen,035,31185,3,0,1,1,0
2020-03-28,Los Angeles,037,10098052,5344,3600,10,3610,64
2020-03-28,Madera,039,155013,43,22,0,22,2
2020-03-28,Marin,041,260295,120,116,0,116,0
2020-03-28,Mariposa,043,17540,0,0,0,0,0
2020-03-28,Mendocino,045,87422,5,4,0,4,0
2020-03-28,Merced,047,269075,27,8,0,8,0
2020-03-28,Modoc,049,8938,0,0,0,0,0
2020-03-28,Mono,051,14174,24,12,0,12,0
2020-03-28,Monterey,053,433212,72,64,0,64,2
2020-03-28,Napa,055,140530,27,10,0,10,0
2020-03-28,Nevada,057,99092,32,22,1,23,0
2020-03-28,Orange,059,3164182,1170,656,13,669,4
2020-03-28,Placer,061,380077,112,70,0,70,2
2020-03-28,Plumas,063,18699,1,0,0,0,0
2020-03-28,Riverside,065,2383286,1011,242,12,254,14
2020-03-28,Sacramento,067,1510023,528,406,0,406,14
2020-03-28,San Benito,069,59416,29,20,0,20,2
2020-03-28,San Bernardino,071,2135413,605,162,0,162,4
2020-03-28,San Diego,073,3302833,1380,980,0,980,14
2020-03-28,San Francisco,075,870044,646,600,0,600,6
2020-03-28,San Joaquin,077,732212,212,166,3,169,8
2020-03-28,San Luis Obispo,079,281455,117,104,0,104,0
2020-03-28,San Mateo,081,765935,672,462,2,464,17
2020-03-28,Santa Barbara,083,443738,194,98,1,99,0
2020-03-28,Santa Clara,085,1922200,1322,1174,3,1177,54
2020-03-28,Santa Cruz,087,273765,80,62,0,62,0
2020-03-28,Shasta,089,179085,20,8,0,8,2
2020-03-28,Sierra,091,2930,0,0,0,0,0
2020-03-28,Siskiyou,093,43540,4,4,0,4,0
2020-03-28,Solano,095,438530,99,96,0,96,0
2020-03-28,Sonoma,097,501317,142,70,0,70,2
2020-03-28,Stanislaus,099,539301,85,34,3,37,0
2020-03-28,Sutter,101,95872,17,6,0,6,0
2020-03-28,Tehama,103,63373,1,0,0,0,0
2020-03-28,Trinity,105,12862,0,0,0,0,0
2020-03-28,Tulare,107,460477,114,46,3,49,0
2020-03-28,Tuolumne,109,53932,2,2,0,2,0
2020-03-28,Ventura,111,848112,270,178,0,178,4
2020-03-28,Yolo,113,214977,49,26,0,26,2
2020-03-28,Yuba,115,75493,8,6,0,6,0
2020-03-27,Alameda,001,1643700,597,185,1,186,4
2020-03-27,Alpine,003,1148,1,0,0,0,0
2020-03-27,Amador,005,37829,4,1,0,1,0
2020-03-27,Butte,007,227075,12,4,0,4,0
2020-03-27,Calaveras,009,45235,6,2,0,2,0
2020-03-27,Colusa,011,21464,3,0,0,0,0
2020-03-27,Contra Costa,013,1133247,396,161,0,161,2
2020-03-27,Del Norte,015,27424,0,0,0,0,0
2020-03-27,El Dorado,017,186661,29,9,0,9,0
2020-03-27,Fresno,019,978130,181,29,2,31,0
2020-03-27,Glenn,021,27897,2,0,0,0,0
2020-03-27,Humboldt,023,135768,42,9,0,9,0
2020-03-27,Imperial,025,180216,69,9,0,9,0
2020-03-27,Inyo,027,18085,9,0,0,0,0
2020-03-27,Kern,029,883053,200,20,0,20,0
2020-03-27,Kings,031,150075,28,0,1,1,0
2020-03-27,Lake,033,64148,0,0,0,0,0
2020-03-27,Lassen,035,31185,3,0,1,1,0
2020-03-27,Los Angeles,037,10098052,4934,1474,10,1484,26
2020-03-27,Madera,039,155013,41,10,0,10,1
2020-03-27,Marin,041,260295,115,58,0,58,0
2020-03-27,Mariposa,043,17540,0,0,0,0,0
2020-03-27,Mendocino,045,87422,5,2,0,2,0
2020-03-27,Merced,047,269075,26,3,0,3,0
2020-03-27,Modoc,049,8938,0,0,0,0,0
2020-03-27,Mono,051,14174,24,6,0,6,0
2020-03-27,Monterey,053,433212,69,26,0,26,1
2020-03-27,Napa,055,140530,27,5,0,5,0
2020-03-27,Nevada,057,99092,32,6,1,7,0
2020-03-27,Orange,059,3164182,1120,299,13,312,2
2020-03-27,Placer,061,380077,109,33,0,33,1
2020-03-27,Plumas,063,18699,0,0,0,0,0
2020-03-27,Riverside,065,2383286,955,121,12,133,7
2020-03-27,Sacramento,067,1510023,505,163,0,163,6
2020-03-27,San Benito,069,59416,28,9,0,9,1
2020-03-27,San Bernardino,071,2135413,514,77,0,77,2
2020-03-27,San Diego,073,3302833,1323,419,0,419,5
2020-03-27,San Francisco,075,870044,621,285,0,285,2
2020-03-27,San Joaquin,077,732212,201,73,3,76,3
2020-03-27,San Luis Obispo,079,281455,115,46,0,46,0
2020-03-27,San Mateo,081,765935,646,213,2,215,7
2020-03-27,Santa Barbara,083,443738,180,37,1,38,0
2020-03-27,Santa Clara,085,1922200,1284,557,3,560,25
2020-03-27,Santa Cruz,087,273765,79,31,0,31,0
2020-03-27,Shasta,089,179085,17,3,0,3,1
2020-03-27,Sierra,091,2930,0,0,0,0,0
2020-03-27,Siskiyou,093,43540,4,2,0,2,0
2020-03-27,Solano,095,438530,93,48,0,48,0
2020-03-27,Sonoma,097,501317,134,35,0,35,1
2020-03-27,Stanislaus,099,539301,83,16,3,19,0
2020-03-27,Sutter,101,95872,16,2,0,2,0
2020-03-27,Tehama,103,63373,1,0,0,0,0
2020-03-27,Trinity,105,12862,0,0,0,0,0
2020-03-27,Tulare,107,460477,106,15,3,18,0
2020-03-27,Tuolumne,109,53932,2,1,0,1,0
2020-03-27,Ventura,111,848112,261,80,0,80,2
2020-03-27,Yolo,113,214977,48,13,0,13,1
2020-03-27,Yuba,115,75493,7,3,0,3,0
2020-03-26,Alameda,001,1643700,557,172,1,173,4
2020-03-26,Alpine,003,1148,1,0,0,0,0
2020-03-26,Amador,005,37829,4,1,0,1,0
2020-03-26,Butte,007,227075,12,4,0,4,0
2020-03-26,Calaveras,009,45235,6,2,0,2,0
2020-03-26,Colusa,011,21464,3,0,0,0,0
2020-03-26,Contra Costa,013,1133247,386,147,0,147,2
2020-03-26,Del Norte,015,27424,0,0,0,0,0
2020-03-26,El Dorado,017,186661,27,7,0,7,0
2020-03-26,Fresno,019,978130,172,25,2,27,0
2020-03-26,Glenn,021,27897,2,0,0,0,0
2020-03-26,Humboldt,023,135768,38,8,0,8,0
2020-03-26,Imperial,025,180216,65,8,0,8,0
2020-03-26,Inyo,027,18085,8,0,0,0,0
2020-03-26,Kern,029,883053,184,20,0,20,0
2020-03-26,Kings,031,150075,28,0,1,1,0
2020-03-26,Lake,033,64148,0,0,0,0,0
2020-03-26,Lassen,035,31185,3,0,1,1,0
2020-03-26,Los Angeles,037,10098052,4530,1075,10,1085,19
2020-03-26,Madera,039,155013,39,8,0,8,0
2020-03-26,Marin,041,260295,106,56,0,56,0
2020-03-26,Mariposa,043,17540,0,0,0,0,0
2020-03-26,Mendocino,045,87422,4,1,0,1,0
2020-03-26,Merced,047,269075,23,1,0,1,0
2020-03-26,Modoc,049,8938,0,0,0,0,0
2020-03-26,Mono,051,14174,23,5,0,5,0
2020-03-26,Monterey,053,433212,66,25,0,25,1
2020-03-26,Napa,055,140530,26,5,0,5,0
2020-03-26,Nevada,057,99092,32,7,1,8,0
2020-03-26,Orange,059,3164182,1058,279,11,290,1
2020-03-26,Placer,061,380077,106,34,0,34,1
2020-03-26,Plumas,063,18699,0,0,0,0,0
2020-03-26,Riverside,065,2383286,884,118,12,130,7
2020-03-26,Sacramento,067,1510023,472,147,0,147,5
2020-03-26,San Benito,069,59416,28,8,0,8,1
2020-03-26,San Bernardino,071,2135413,448,57,0,57,1
2020-03-26,San Diego,073,3302833,1256,299,0,299,2
2020-03-26,San Francisco,075,870044,594,261,0,261,1
2020-03-26,San Joaquin,077,732212,190,69,3,72,3
2020-03-26,San Luis Obispo,079,281455,110,38,0,38,0
2020-03-26,San Mateo,081,765935,612,122,2,124,5
2020-03-26,Santa Barbara,083,443738,167,33,1,34,0
2020-03-26,Santa Clara,085,1922200,1239,487,2,489,20
2020-03-26,Santa Cruz,087,273765,75,30,0,30,0
2020-03-26,Shasta,089,179085,17,3,0,3,1
2020-03-26,Sierra,091,2930,0,0,0,0,0
2020-03-26,Siskiyou,093,43540,4,2,0,2,0
2020-03-26,Solano,095,438530,85,41,0,41,0
2020-03-26,Sonoma,097,501317,129,33,0,33,1
2020-03-26,Stanislaus,099,539301,81,15,3,18,0
2020-03-26,Sutter,101,95872,12,2,0,2,0
2020-03-26,Tehama,103,63373,1,0,0,0,0
2020-03-26,Trinity,105,12862,0,0,0,0,0
2020-03-26,Tulare,107,460477,97,15,3,18,0
2020-03-26,Tuolumne,109,53932,2,0,0,0,0
2020-03-26,Ventura,111,848112,245,70,0,70,1
2020-03-26,Yolo,113,214977,44,13,0,13,1
2020-03-26,Yuba,115,75493,7,3,0,3,0
2020-03-25,Alameda,001,1643700,536,134,1,135,3
2020-03-25,Alpine,003,1148,1,0,0,0,0
2020-03-25,Amador,005,37829,4,1,0,1,0
2020-03-25,Butte,007,227075,12,4,0,4,0
2020-03-25,Calaveras,009,45235,6,2,0,2,0
2020-03-25,Colusa,011,21464,2,0,0,0,0
2020-03-25,Contra Costa,013,1133247,372,131,0,131,1
2020-03-25,Del Norte,015,27424,0,0,0,0,0
2020-03-25,El Dorado,017,186661,27,5,0,5,0
2020-03-25,Fresno,019,978130,152,21,2,23,0
2020-03-25,Glenn,021,27897,2,0,0,0,0
2020-03-25,Humboldt,023,135768,35,3,0,3,0
2020-03-25,Imperial,025,180216,57,8,0,8,0
2020-03-25,Inyo,027,18085,5,0,0,0,0
2020-03-25,Kern,029,883053,164,13,0,13,0
2020-03-25,Kings,031,150075,26,0,1,1,0
2020-03-25,Lake,033,64148,0,0,0,0,0
2020-03-25,Lassen,035,31185,3,0,1,1,0
2020-03-25,Los Angeles,037,10098052,4135,725,10,735,10
2020-03-25,Madera,039,155013,37,6,0,6,0
2020-03-25,Marin,041,260295,100,47,0,47,0
2020-03-25,Mariposa,043,17540,0,0,0,0,0
2020-03-25,Mendocino,045,87422,3,1,0,1,0
2020-03-25,Merced,047,269075,19,0,0,0,0
2020-03-25,Modoc,049,8938,0,0,0,0,0
2020-03-25,Mono,051,14174,22,4,0,4,0
2020-03-25,Monterey,053,433212,63,23,0,23,1
2020-03-25,Napa,055,140530,26,5,0,5,0
2020-03-25,Nevada,057,99092,31,5,1,6,0
2020-03-25,Orange,059,3164182,1000,214,9,223,1
2020-03-25,Placer,061,380077,100,30,0,30,1
2020-03-25,Plumas,063,18699,0,1,0,1,0
2020-03-25,Riverside,065,2383286,813,87,12,99,5
2020-03-25,Sacramento,067,1510023,446,114,0,114,5
2020-03-25,San Benito,069,59416,27,4,0,4,1
2020-03-25,San Bernardino,071,2135413,409,46,0,46,1
2020-03-25,San Diego,073,3302833,1194,238,0,238,2
2020-03-25,San Francisco,075,870044,553,212,0,212,1
2020-03-25,San Joaquin,077,732212,177,64,3,67,2
2020-03-25,San Luis Obispo,079,281455,105,35,0,35,0
2020-03-25,San Mateo,081,765935,577,111,2,113,5
2020-03-25,Santa Barbara,083,443738,157,25,1,26,0
2020-03-25,Santa Clara,085,1922200,1195,452,2,454,20
2020-03-25,Santa Cruz,087,273765,72,26,0,26,0
2020-03-25,Shasta,089,179085,16,3,0,3,1
2020-03-25,Sierra,091,2930,0,0,0,0,0
2020-03-25,Siskiyou,093,43540,4,2,0,2,0
2020-03-25,Solano,095,438530,80,39,0,39,0
2020-03-25,Sonoma,097,501317,124,31,0,31,1
2020-03-25,Stanislaus,099,539301,74,14,3,17,0
2020-03-25,Sutter,101,95872,9,1,0,1,0
2020-03-25,Tehama,103,63373,1,0,0,0,0
2020-03-25,Trinity,105,12862,0,0,0,0,0
2020-03-25,Tulare,107,460477,87,11,3,14,0
2020-03-25,Tuolumne,109,53932,2,0,0,0,0
2020-03-25,Ventura,111,848112,229,53,0,53,1
2020-03-25,Yolo,113,214977,42,9,0,9,1
2020-03-25,Yuba,115,75493,7,2,0,2,0
2020-03-24,Alameda,001,1643700,503,96,1,97,2
2020-03-24,Alpine,003,1148,1,0,0,0,0
2020-03-24,Amador,005,37829,2,1,0,1,0
2020-03-24,Butte,007,227075,11,3,0,3,0
2020-03-24,Calaveras,009,45235,5,2,0,2,0
2020-03-24,Colusa,011,21464,2,0,0,0,0
2020-03-24,Contra Costa,013,1133247,358,108,0,108,1
2020-03-24,Del Norte,015,27424,0,0,0,0,0
2020-03-24,El Dorado,017,186661,27,3,0,3,0
2020-03-24,Fresno,019,978130,133,18,2,20,0
2020-03-24,Glenn,021,27897,2,0,0,0,0
2020-03-24,Humboldt,023,135768,33,2,0,2,0
2020-03-24,Imperial,025,180216,54,3,0,3,0
2020-03-24,Inyo,027,18085,5,0,0,0,0
2020-03-24,Kern,029,883053,144,5,0,5,0
2020-03-24,Kings,031,150075,25,0,1,1,0
2020-03-24,Lake,033,64148,0,0,0,0,0
2020-03-24,Lassen,035,31185,3,0,1,1,0
2020-03-24,Los Angeles,037,10098052,3683,633,10,643,7
2020-03-24,Madera,039,155013,36,6,0,6,0
2020-03-24,Marin,041,260295,89,44,0,44,0
2020-03-24,Mariposa,043,17540,0,0,0,0,0
2020-03-24,Mendocino,045,87422,3,1,0,1,0
2020-03-24,Merced,047,269075,17,0,0,0,0
2020-03-24,Modoc,049,8938,0,0,0,0,0
2020-03-24,Mono,051,14174,21,1,0,1,0
2020-03-24,Monterey,053,433212,59,23,0,23,1
2020-03-24,Napa,055,140530,23,2,0,2,0
2020-03-24,Nevada,057,99092,30,4,1,5,0
2020-03-24,Orange,059,3164182,938,166,9,175,0
2020-03-24,Placer,061,380077,93,22,0,22,1
2020-03-24,Plumas,063,18699,0,1,0,1,0
2020-03-24,Riverside,065,2383286,746,56,12,68,5
2020-03-24,Sacramento,067,1510023,426,93,0,93,4
2020-03-24,San Benito,069,59416,26,4,0,4,1
2020-03-24,San Bernardino,071,2135413,365,27,0,27,0
2020-03-24,San Diego,073,3302833,1127,231,0,231,2
2020-03-24,San Francisco,075,870044,521,181,0,181,1
2020-03-24,San Joaquin,077,732212,166,52,3,55,2
2020-03-24,San Luis Obispo,079,281455,102,32,0,32,0
2020-03-24,San Mateo,081,765935,536,100,2,102,2
2020-03-24,Santa Barbara,083,443738,151,20,1,21,0
2020-03-24,Santa Clara,085,1922200,1126,389,2,391,17
2020-03-24,Santa Cruz,087,273765,67,22,0,22,0
2020-03-24,Shasta,089,179085,15,3,0,3,0
2020-03-24,Sierra,091,2930,0,0,0,0,0
2020-03-24,Siskiyou,093,43540,4,2,0,2,0
2020-03-24,Solano,095,438530,78,34,0,34,0
2020-03-24,Sonoma,097,501317,117,27,0,27,1
2020-03-24,Stanislaus,099,539301,65,13,3,16,0
2020-03-24,Sutter,101,95872,9,0,0,0,0
2020-03-24,Tehama,103,63373,1,0,0,0,0
2020-03-24,Trinity,105,12862,0,0,0,0,0
2020-03-24,Tulare,107,460477,77,10,3,13,0
2020-03-24,Tuolumne,109,53932,2,0,0,0,0
2020-03-24,Ventura,111,848112,213,44,0,44,1
2020-03-24,Yolo,113,214977,38,8,0,8,0
2020-03-24,Yuba,115,75493,7,2,0,2,0
2020-03-23,Alameda,001,1643700,472,88,1,89,1
2020-03-23,Alpine,003,1148,1,0,0,0,0
2020-03-23,Amador,005,37829,2,1,0,1,0
2020-03-23,Butte,007,227075,11,2,0,2,0
2020-03-23,Calaveras,009,45235,5,2,0,2,0
2020-03-23,Colusa,011,21464,1,0,0,0,0
2020-03-23,Contra Costa,013,1133247,338,91,0,91,2
2020-03-23,Del Norte,015,27424,0,0,0,0,0
2020-03-23,El Dorado,017,186661,26,3,0,3,0
2020-03-23,Fresno,019,978130,123,10,2,12,0
2020-03-23,Glenn,021,27897,2,0,0,0,0
2020-03-23,Humboldt,023,135768,31,2,0,2,0
2020-03-23,Imperial,025,180216,50,2,0,2,0
2020-03-23,Inyo,027,18085,3,0,0,0,0
2020-03-23,Kern,029,883053,130,5,0,5,0
2020-03-23,Kings,031,150075,25,0,1,1,0
2020-03-23,Lake,033,64148,0,0,0,0,0
2020-03-23,Lassen,035,31185,3,0,1,1,0
2020-03-23,Los Angeles,037,10098052,3379,389,10,399,4
2020-03-23,Madera,039,155013,36,4,0,4,0
2020-03-23,Marin,041,260295,84,30,0,30,0
2020-03-23,Mariposa,043,17540,0,0,0,0,0
2020-03-23,Mendocino,045,87422,3,1,0,1,0
2020-03-23,Merced,047,269075,11,0,0,0,0
2020-03-23,Modoc,049,8938,0,0,0,0,0
2020-03-23,Mono,051,14174,19,1,0,1,0
2020-03-23,Monterey,053,433212,54,14,0,14,1
2020-03-23,Napa,055,140530,21,1,0,1,0
2020-03-23,Nevada,057,99092,27,2,1,3,0
2020-03-23,Orange,059,3164182,883,138,7,145,0
2020-03-23,Placer,061,380077,90,19,0,19,1
2020-03-23,Plumas,063,18699,0,0,0,0,0
2020-03-23,Riverside,065,2383286,703,39,12,51,5
2020-03-23,Sacramento,067,1510023,393,87,0,87,4
2020-03-23,San Benito,069,59416,25,4,0,4,1
2020-03-23,San Bernardino,071,2135413,335,17,0,17,0
2020-03-23,San Diego,073,3302833,1068,178,0,178,1
2020-03-23,San Francisco,075,870044,492,152,0,152,0
2020-03-23,San Joaquin,077,732212,154,37,3,40,2
2020-03-23,San Luis Obispo,079,281455,96,23,0,23,0
2020-03-23,San Mateo,081,765935,497,88,2,90,1
2020-03-23,Santa Barbara,083,443738,133,18,1,19,0
2020-03-23,Santa Clara,085,1922200,1077,336,2,338,13
2020-03-23,Santa Cruz,087,273765,65,21,0,21,0
2020-03-23,Shasta,089,179085,13,2,0,2,0
2020-03-23,Sierra,091,2930,0,0,0,0,0
2020-03-23,Siskiyou,093,43540,4,2,0,2,0
2020-03-23,Solano,095,438530,74,33,0,33,0
2020-03-23,Sonoma,097,501317,105,19,0,19,1
2020-03-23,Stanislaus,099,539301,57,10,3,13,0
2020-03-23,Sutter,101,95872,9,0,0,0,0
2020-03-23,Tehama,103,63373,1,0,0,0,0
2020-03-23,Trinity,105,12862,0,0,0,0,0
2020-03-23,Tulare,107,460477,68,9,3,12,0
2020-03-23,Tuolumne,109,53932,2,0,0,0,0
2020-03-23,Ventura,111,848112,196,30,0,30,0
2020-03-23,Yolo,113,214977,37,8,0,8,0
2020-03-23,Yuba,115,75493,7,2,0,2,0
2020-03-22,Alameda,001,1643700,433,72,1,73,1
2020-03-22,Alpine,003,1148,1,0,0,0,0
2020-03-22,Amador,005,37829,2,1,0,1,0
2020-03-22,Butte,007,227075,8,1,0,1,0
2020-03-22,Calaveras,009,45235,4,2,0,2,0
2020-03-22,Colusa,011,21464,1,0,0,0,0
2020-03-22,Contra Costa,013,1133247,311,79,0,79,1
2020-03-22,Del Norte,015,27424,0,0,0,0,0
2020-03-22,El Dorado,017,186661,24,1,0,1,0
2020-03-22,Fresno,019,978130,103,8,2,10,0
2020-03-22,Glenn,021,27897,2,0,0,0,0
2020-03-22,Humboldt,023,135768,28,1,0,1,0
2020-03-22,Imperial,025,180216,48,2,0,2,0
2020-03-22,Inyo,027,18085,1,0,0,0,0
2020-03-22,Kern,029,883053,114,3,0,3,0
2020-03-22,Kings,031,150075,22,0,1,1,0
2020-03-22,Lake,033,64148,0,0,0,0,0
2020-03-22,Lassen,035,31185,3,0,1,1,0
2020-03-22,Los Angeles,037,10098052,3057,384,10,394,3
2020-03-22,Madera,039,155013,33,4,0,4,0
2020-03-22,Marin,041,260295,74,30,0,30,0
2020-03-22,Mariposa,043,17540,0,0,0,0,0
2020-03-22,Mendocino,045,87422,3,1,0,1,0
2020-03-22,Merced,047,269075,7,0,0,0,0
2020-03-22,Modoc,049,8938,0,0,0,0,0
2020-03-22,Mono,051,14174,14,1,0,1,0
2020-03-22,Monterey,053,433212,51,14,0,14,1
2020-03-22,Napa,055,140530,17,1,0,1,0
2020-03-22,Nevada,057,99092,23,2,1,3,0
2020-03-22,Orange,059,3164182,811,102,4,106,0
2020-03-22,Placer,061,380077,87,18,0,18,1
2020-03-22,Plumas,063,18699,0,0,0,0,0
2020-03-22,Riverside,065,2383286,613,26,8,34,5
2020-03-22,Sacramento,067,1510023,361,82,0,82,4
2020-03-22,San Benito,069,59416,20,4,0,4,1
2020-03-22,San Bernardino,071,2135413,292,16,0,16,0
2020-03-22,San Diego,073,3302833,980,161,0,161,0
2020-03-22,San Francisco,075,870044,455,134,0,134,0
2020-03-22,San Joaquin,077,732212,140,30,3,33,2
2020-03-22,San Luis Obispo,079,281455,89,19,0,19,0
2020-03-22,San Mateo,081,765935,464,82,2,84,1
2020-03-22,Santa Barbara,083,443738,119,16,1,17,0
2020-03-22,Santa Clara,085,1922200,1013,284,2,286,13
2020-03-22,Santa Cruz,087,273765,64,19,0,19,0
2020-03-22,Shasta,089,179085,13,1,0,1,0
2020-03-22,Sierra,091,2930,0,0,0,0,0
2020-03-22,Siskiyou,093,43540,4,2,0,2,0
2020-03-22,Solano,095,438530,65,30,0,30,0
2020-03-22,Sonoma,097,501317,100,18,0,18,1
2020-03-22,Stanislaus,099,539301,51,8,3,11,0
2020-03-22,Sutter,101,95872,8,0,0,0,0
2020-03-22,Tehama,103,63373,0,0,0,0,0
2020-03-22,Trinity,105,12862,0,0,0,0,0
2020-03-22,Tulare,107,460477,62,5,3,8,0
2020-03-22,Tuolumne,109,53932,2,0,0,0,0
2020-03-22,Ventura,111,848112,174,26,0,26,0
2020-03-22,Yolo,113,214977,31,6,0,6,0
2020-03-22,Yuba,115,75493,7,2,0,2,0
2020-03-21,Alameda,001,1643700,409,62,1,63,0
2020-03-21,Alpine,003,1148,1,0,0,0,0
2020-03-21,Amador,005,37829,2,1,0,1,0
2020-03-21,Butte,007,227075,7,1,0,1,0
2020-03-21,Calaveras,009,45235,4,2,0,2,0
2020-03-21,Colusa,011,21464,1,0,0,0,0
2020-03-21,Contra Costa,013,1133247,300,62,0,62,1
2020-03-21,Del Norte,015,27424,0,0,0,0,0
2020-03-21,El Dorado,017,186661,21,1,0,1,0
2020-03-21,Fresno,019,978130,99,8,2,10,0
2020-03-21,Glenn,021,27897,2,0,0,0,0
2020-03-21,Humboldt,023,135768,25,1,0,1,0
2020-03-21,Imperial,025,180216,44,2,0,2,0
2020-03-21,Inyo,027,18085,1,0,0,0,0
2020-03-21,Kern,029,883053,108,3,0,3,0
2020-03-21,Kings,031,150075,22,0,1,1,0
2020-03-21,Lake,033,64148,0,0,0,0,0
2020-03-21,Lassen,035,31185,3,0,1,1,0
2020-03-21,Los Angeles,037,10098052,2784,322,10,332,2
2020-03-21,Madera,039,155013,33,4,0,4,0
2020-03-21,Marin,041,260295,69,30,0,30,0
2020-03-21,Mariposa,043,17540,0,0,0,0,0
2020-03-21,Mendocino,045,87422,3,1,0,1,0
2020-03-21,Merced,047,269075,6,0,0,0,0
2020-03-21,Modoc,049,8938,0,0,0,0,0
2020-03-21,Mono,051,14174,14,1,0,1,0
2020-03-21,Monterey,053,433212,48,8,0,8,1
2020-03-21,Napa,055,140530,17,0,0,0,0
2020-03-21,Nevada,057,99092,23,2,1,3,0
2020-03-21,Orange,059,3164182,762,85,4,89,0
2020-03-21,Placer,061,380077,78,11,0,11,1
2020-03-21,Plumas,063,18699,0,0,0,0,0
2020-03-21,Riverside,065,2383286,566,20,8,28,3
2020-03-21,Sacramento,067,1510023,334,66,0,66,3
2020-03-21,San Benito,069,59416,18,4,0,4,1
2020-03-21,San Bernardino,071,2135413,272,13,0,13,0
2020-03-21,San Diego,073,3302833,903,121,0,121,0
2020-03-21,San Francisco,075,870044,419,106,0,106,0
2020-03-21,San Joaquin,077,732212,131,26,3,29,2
2020-03-21,San Luis Obispo,079,281455,84,16,0,16,0
2020-03-21,San Mateo,081,765935,426,78,2,80,1
2020-03-21,Santa Barbara,083,443738,109,8,1,9,0
2020-03-21,Santa Clara,085,1922200,951,269,2,271,10
2020-03-21,Santa Cruz,087,273765,62,17,0,17,0
2020-03-21,Shasta,089,179085,12,1,0,1,0
2020-03-21,Sierra,091,2930,0,0,0,0,0
2020-03-21,Siskiyou,093,43540,4,0,0,0,0
2020-03-21,Solano,095,438530,63,30,0,30,0
2020-03-21,Sonoma,097,501317,99,15,0,15,1
2020-03-21,Stanislaus,099,539301,45,7,3,10,0
2020-03-21,Sutter,101,95872,7,0,0,0,0
2020-03-21,Tehama,103,63373,0,0,0,0,0
2020-03-21,Trinity,105,12862,0,0,0,0,0
2020-03-21,Tulare,107,460477,54,5,3,8,0
2020-03-21,Tuolumne,109,53932,2,0,0,0,0
2020-03-21,Ventura,111,848112,166,22,0,22,0
2020-03-21,Yolo,113,214977,31,6,0,6,0
2020-03-21,Yuba,115,75493,7,1,0,1,0
2020-03-20,Alameda,001,1643700,388,42,1,43,0
2020-03-20,Alpine,003,1148,1,0,0,0,0
2020-03-20,Amador,005,37829,1,0,0,0,0
2020-03-20,Butte,007,227075,7,0,0,0,0
2020-03-20,Calaveras,009,45235,4,2,0,2,0
2020-03-20,Colusa,011,21464,1,0,0,0,0
2020-03-20,Contra Costa,013,1133247,270,52,0,52,1
2020-03-20,Del Norte,015,27424,0,0,0,0,0
2020-03-20,El Dorado,017,186661,20,1,0,1,0
2020-03-20,Fresno,019,978130,96,7,2,9,0
2020-03-20,Glenn,021,27897,1,0,0,0,0
2020-03-20,Humboldt,023,135768,25,1,0,1,0
2020-03-20,Imperial,025,180216,43,2,0,2,0
2020-03-20,Inyo,027,18085,0,0,0,0,0
2020-03-20,Kern,029,883053,93,3,0,3,0
2020-03-20,Kings,031,150075,21,0,1,1,0
2020-03-20,Lake,033,64148,0,0,0,0,0
2020-03-20,Lassen,035,31185,3,0,1,1,0
2020-03-20,Los Angeles,037,10098052,2558,267,9,276,1
2020-03-20,Madera,039,155013,32,4,0,4,0
2020-03-20,Marin,041,260295,66,30,0,30,0
2020-03-20,Mariposa,043,17540,0,0,0,0,0
2020-03-20,Mendocino,045,87422,3,1,0,1,0
2020-03-20,Merced,047,269075,6,0,0,0,0
2020-03-20,Modoc,049,8938,0,0,0,0,0
2020-03-20,Mono,051,14174,14,0,0,0,0
2020-03-20,Monterey,053,433212,47,4,0,4,0
2020-03-20,Napa,055,140530,16,0,0,0,0
2020-03-20,Nevada,057,99092,20,2,1,3,0
2020-03-20,Orange,059,3164182,715,71,4,75,2
2020-03-20,Placer,061,380077,72,9,0,9,1
2020-03-20,Plumas,063,18699,0,0,0,0,0
2020-03-20,Riverside,065,2383286,507,19,8,27,3
2020-03-20,Sacramento,067,1510023,313,56,0,56,4
2020-03-20,San Benito,069,59416,18,4,0,4,1
2020-03-20,San Bernardino,071,2135413,245,9,0,9,0
2020-03-20,San Diego,073,3302833,851,98,0,98,0
2020-03-20,San Francisco,075,870044,387,87,0,87,0
2020-03-20,San Joaquin,077,732212,116,18,3,21,2
2020-03-20,San Luis Obispo,079,281455,80,11,0,11,0
2020-03-20,San Mateo,081,765935,396,71,2,73,1
2020-03-20,Santa Barbara,083,443738,97,7,1,8,0
2020-03-20,Santa Clara,085,1922200,914,246,2,248,8
2020-03-20,Santa Cruz,087,273765,60,13,0,13,0
2020-03-20,Shasta,089,179085,11,1,0,1,0
2020-03-20,Sierra,091,2930,0,0,0,0,0
2020-03-20,Siskiyou,093,43540,4,0,0,0,0
2020-03-20,Solano,095,438530,59,29,0,29,0
2020-03-20,Sonoma,097,501317,91,7,0,7,0
2020-03-20,Stanislaus,099,539301,39,7,3,10,0
2020-03-20,Sutter,101,95872,7,0,0,0,0
2020-03-20,Tehama,103,63373,0,0,0,0,0
2020-03-20,Trinity,105,12862,0,0,0,0,0
2020-03-20,Tulare,107,460477,50,4,3,7,0
2020-03-20,Tuolumne,109,53932,2,0,0,0,0
2020-03-20,Ventura,111,848112,156,18,0,18,0
2020-03-20,Yolo,113,214977,29,5,0,5,0
2020-03-20,Yuba,115,75493,6,0,0,0,0
2020-03-19,Alameda,001,1643700,352,36,1,37,0
2020-03-19,Alpine,003,1148,1,0,0,0,0
2020-03-19,Amador,005,37829,1,0,0,0,0
2020-03-19,Butte,007,227075,5,0,0,0,0
2020-03-19,Calaveras,009,45235,4,2,0,2,0
2020-03-19,Colusa,011,21464,0,0,0,0,0
2020-03-19,Contra Costa,013,1133247,254,46,0,46,0
2020-03-19,Del Norte,015,27424,0,0,0,0,0
2020-03-19,El Dorado,017,186661,18,0,0,0,0
2020-03-19,Fresno,019,978130,87,6,2,8,0
2020-03-19,Glenn,021,27897,1,0,0,0,0
2020-03-19,Humboldt,023,135768,23,1,0,1,0
2020-03-19,Imperial,025,180216,36,2,0,2,0
2020-03-19,Inyo,027,18085,0,0,0,0,0
2020-03-19,Kern,029,883053,81,3,0,3,0
2020-03-19,Kings,031,150075,17,0,1,1,0
2020-03-19,Lake,033,64148,0,0,0,0,0
2020-03-19,Lassen,035,31185,2,0,1,1,0
2020-03-19,Los Angeles,037,10098052,2271,233,9,242,0
2020-03-19,Madera,039,155013,31,3,0,3,0
2020-03-19,Marin,041,260295,63,19,0,19,0
2020-03-19,Mariposa,043,17540,0,0,0,0,0
2020-03-19,Mendocino,045,87422,2,1,0,1,0
2020-03-19,Merced,047,269075,5,0,0,0,0
2020-03-19,Modoc,049,8938,0,0,0,0,0
2020-03-19,Mono,051,14174,12,0,0,0,0
2020-03-19,Monterey,053,433212,39,3,0,3,0
2020-03-19,Napa,055,140530,14,0,0,0,0
2020-03-19,Nevada,057,99092,18,2,1,3,0
2020-03-19,Orange,059,3164182,633,59,4,63,0
2020-03-19,Placer,061,380077,64,8,0,8,1
2020-03-19,Plumas,063,18699,0,0,0,0,0
2020-03-19,Riverside,065,2383286,396,14,6,20,3
2020-03-19,Sacramento,067,1510023,280,52,0,52,3
2020-03-19,San Benito,069,59416,15,3,0,3,0
2020-03-19,San Bernardino,071,2135413,215,7,0,7,0
2020-03-19,San Diego,073,3302833,768,68,0,68,0
2020-03-19,San Francisco,075,870044,351,80,0,80,0
2020-03-19,San Joaquin,077,732212,102,15,3,18,2
2020-03-19,San Luis Obispo,079,281455,77,6,0,6,0
2020-03-19,San Mateo,081,765935,361,58,2,60,1
2020-03-19,Santa Barbara,083,443738,85,5,0,5,0
2020-03-19,Santa Clara,085,1922200,847,183,2,185,8
2020-03-19,Santa Cruz,087,273765,57,13,0,13,0
2020-03-19,Shasta,089,179085,10,1,0,1,0
2020-03-19,Sierra,091,2930,0,0,0,0,0
2020-03-19,Siskiyou,093,43540,3,0,0,0,0
2020-03-19,Solano,095,438530,55,26,0,26,0
2020-03-19,Sonoma,097,501317,88,8,0,8,0
2020-03-19,Stanislaus,099,539301,38,7,3,10,0
2020-03-19,Sutter,101,95872,7,0,0,0,0
2020-03-19,Tehama,103,63373,0,0,0,0,0
2020-03-19,Trinity,105,12862,0,0,0,0,0
2020-03-19,Tulare,107,460477,44,3,3,6,0
2020-03-19,Tuolumne,109,53932,2,0,0,0,0
2020-03-19,Ventura,111,848112,134,15,0,15,0
2020-03-19,Yolo,113,214977,25,5,0,5,0
2020-03-19,Yuba,115,75493,5,0,0,0,0
2020-03-18,Alameda,001,1643700,324,29,1,30,0
2020-03-18,Alpine,003,1148,1,0,0,0,0
2020-03-18,Amador,005,37829,1,0,0,0,0
2020-03-18,Butte,007,227075,4,0,0,0,0
2020-03-18,Calaveras,009,45235,4,2,0,2,0
2020-03-18,Colusa,011,21464,0,0,0,0,0
2020-03-18,Contra Costa,013,1133247,232,44,0,44,0
2020-03-18,Del Norte,015,27424,0,0,0,0,0
2020-03-18,El Dorado,017,186661,17,0,0,0,0
2020-03-18,Fresno,019,978130,78,3,1,4,0
2020-03-18,Glenn,021,27897,1,0,0,0,0
2020-03-18,Humboldt,023,135768,19,1,0,1,0
2020-03-18,Imperial,025,180216,30,2,0,2,0
2020-03-18,Inyo,027,18085,0,0,0,0,0
2020-03-18,Kern,029,883053,66,1,0,1,0
2020-03-18,Kings,031,150075,15,0,1,1,0
2020-03-18,Lake,033,64148,0,0,0,0,0
2020-03-18,Lassen,035,31185,1,0,1,1,0
2020-03-18,Los Angeles,037,10098052,2033,47,9,56,0
2020-03-18,Madera,039,155013,30,2,0,2,0
2020-03-18,Marin,041,260295,58,10,0,10,0
2020-03-18,Mariposa,043,17540,0,0,0,0,0
2020-03-18,Mendocino,045,87422,2,0,0,0,0
2020-03-18,Merced,047,269075,5,0,0,0,0
2020-03-18,Modoc,049,8938,0,0,0,0,0
2020-03-18,Mono,051,14174,11,0,0,0,0
2020-03-18,Monterey,053,433212,31,1,0,1,0
2020-03-18,Napa,055,140530,11,0,0,0,0
2020-03-18,Nevada,057,99092,16,2,1,3,0
2020-03-18,Orange,059,3164182,576,38,4,42,0
2020-03-18,Placer,061,380077,57,8,0,8,1
2020-03-18,Plumas,063,18699,0,0,0,0,0
2020-03-18,Riverside,065,2383286,333,11,5,16,2
2020-03-18,Sacramento,067,1510023,257,46,0,46,3
2020-03-18,San Benito,069,59416,14,3,0,3,0
2020-03-18,San Bernardino,071,2135413,193,3,0,3,0
2020-03-18,San Diego,073,3302833,683,40,0,40,0
2020-03-18,San Francisco,075,870044,332,65,0,65,0
2020-03-18,San Joaquin,077,732212,90,14,3,17,2
2020-03-18,San Luis Obispo,079,281455,70,5,0,5,0
2020-03-18,San Mateo,081,765935,340,57,2,59,1
2020-03-18,Santa Barbara,083,443738,77,2,0,2,0
2020-03-18,Santa Clara,085,1922200,796,151,2,153,6
2020-03-18,Santa Cruz,087,273765,55,11,0,11,0
2020-03-18,Shasta,089,179085,9,1,0,1,0
2020-03-18,Sierra,091,2930,0,0,0,0,0
2020-03-18,Siskiyou,093,43540,3,0,0,0,0
2020-03-18,Solano,095,438530,51,26,0,26,0
2020-03-18,Sonoma,097,501317,79,6,0,6,0
2020-03-18,Stanislaus,099,539301,34,5,2,7,0
2020-03-18,Sutter,101,95872,5,0,0,0,0
2020-03-18,Tehama,103,63373,0,0,0,0,0
2020-03-18,Trinity,105,12862,0,0,0,0,0
2020-03-18,Tulare,107,460477,34,3,3,6,0
2020-03-18,Tuolumne,109,53932,2,0,0,0,0
2020-03-18,Ventura,111,848112,115,11,0,11,0
2020-03-18,Yolo,113,214977,22,4,0,4,0
2020-03-18,Yuba,115,75493,4,0,0,0,0
2020-03-17,Alameda,001,1643700,292,19,0,19,0
2020-03-17,Alpine,003,1148,0,0,0,0,0
2020-03-17,Amador,005,37829,1,0,0,0,0
2020-03-17,Butte,007,227075,4,0,0,0,0
2020-03-17,Calaveras,009,45235,4,2,0,2,0
2020-03-17,Colusa,011,21464,0,0,0,0,0
2020-03-17,Contra Costa,013,1133247,210,37,0,37,0
2020-03-17,Del Norte,015,27424,0,0,0,0,0
2020-03-17,El Dorado,017,186661,16,0,0,0,0
2020-03-17,Fresno,019,978130,68,2,1,3,0
2020-03-17,Glenn,021,27897,1,0,0,0,0
2020-03-17,Humboldt,023,135768,17,1,0,1,0
2020-03-17,Imperial,025,180216,24,2,0,2,0
2020-03-17,Inyo,027,18085,0,0,0,0,0
2020-03-17,Kern,029,883053,52,0,0,0,0
2020-03-17,Kings,031,150075,12,0,1,1,0
2020-03-17,Lake,033,64148,0,0,0,0,0
2020-03-17,Lassen,035,31185,1,0,1,1,0
2020-03-17,Los Angeles,037,10098052,1831,41,9,50,0
2020-03-17,Madera,039,155013,22,2,0,2,0
2020-03-17,Marin,041,260295,51,4,0,4,0
2020-03-17,Mariposa,043,17540,0,0,0,0,0
2020-03-17,Mendocino,045,87422,2,0,0,0,0
2020-03-17,Merced,047,269075,5,0,0,0,0
2020-03-17,Modoc,049,8938,0,0,0,0,0
2020-03-17,Mono,051,14174,9,0,0,0,0
2020-03-17,Monterey,053,433212,29,0,0,0,0
2020-03-17,Napa,055,140530,8,0,0,0,0
2020-03-17,Nevada,057,99092,15,1,1,2,0
2020-03-17,Orange,059,3164182,498,24,3,27,0
2020-03-17,Placer,061,380077,47,7,0,7,1
2020-03-17,Plumas,063,18699,0,0,0,0,0
2020-03-17,Riverside,065,2383286,271,11,5,16,0
2020-03-17,Sacramento,067,1510023,237,36,0,36,1
2020-03-17,San Benito,069,59416,12,2,0,2,0
2020-03-17,San Bernardino,071,2135413,165,2,0,2,0
2020-03-17,San Diego,073,3302833,616,17,0,17,0
2020-03-17,San Francisco,075,870044,305,46,0,46,0
2020-03-17,San Joaquin,077,732212,84,11,3,14,0
2020-03-17,San Luis Obispo,079,281455,62,1,0,1,0
2020-03-17,San Mateo,081,765935,308,46,2,48,1
2020-03-17,Santa Barbara,083,443738,65,0,0,0,0
2020-03-17,Santa Clara,085,1922200,738,121,2,123,4
2020-03-17,Santa Cruz,087,273765,52,10,0,10,0
2020-03-17,Shasta,089,179085,5,1,0,1,0
2020-03-17,Sierra,091,2930,0,0,0,0,0
2020-03-17,Siskiyou,093,43540,3,0,0,0,0
2020-03-17,Solano,095,438530,48,27,0,27,0
2020-03-17,Sonoma,097,501317,71,4,0,4,0
2020-03-17,Stanislaus,099,539301,31,4,2,6,0
2020-03-17,Sutter,101,95872,5,0,0,0,0
2020-03-17,Tehama,103,63373,0,0,0,0,0
2020-03-17,Trinity,105,12862,0,0,0,0,0
2020-03-17,Tulare,107,460477,29,2,3,5,0
2020-03-17,Tuolumne,109,53932,2,0,0,0,0
2020-03-17,Ventura,111,848112,98,7,0,7,0
2020-03-17,Yolo,113,214977,18,2,0,2,0
2020-03-17,Yuba,115,75493,4,0,0,0,0
2020-03-16,Alameda,001,1643700,263,17,0,17,0
2020-03-16,Alpine,003,1148,0,0,0,0,0
2020-03-16,Amador,005,37829,1,0,0,0,0
2020-03-16,Butte,007,227075,3,0,0,0,0
2020-03-16,Calaveras,009,45235,4,2,0,2,0
2020-03-16,Colusa,011,21464,0,0,0,0,0
2020-03-16,Contra Costa,013,1133247,186,36,0,36,0
2020-03-16,Del Norte,015,27424,0,0,0,0,0
2020-03-16,El Dorado,017,186661,15,0,0,0,0
2020-03-16,Fresno,019,978130,53,2,1,3,0
2020-03-16,Glenn,021,27897,0,0,0,0,0
2020-03-16,Humboldt,023,135768,13,1,0,1,0
2020-03-16,Imperial,025,180216,19,2,0,2,0
2020-03-16,Inyo,027,18085,0,0,0,0,0
2020-03-16,Kern,029,883053,43,0,0,0,0
2020-03-16,Kings,031,150075,11,0,1,1,0
2020-03-16,Lake,033,64148,0,0,0,0,0
2020-03-16,Lassen,035,31185,1,0,0,0,0
2020-03-16,Los Angeles,037,10098052,1596,43,9,52,0
2020-03-16,Madera,039,155013,21,2,0,2,0
2020-03-16,Marin,041,260295,48,4,0,4,0
2020-03-16,Mariposa,043,17540,0,0,0,0,0
2020-03-16,Mendocino,045,87422,2,0,0,0,0
2020-03-16,Merced,047,269075,5,0,0,0,0
2020-03-16,Modoc,049,8938,0,0,0,0,0
2020-03-16,Mono,051,14174,7,0,0,0,0
2020-03-16,Monterey,053,433212,28,0,0,0,0
2020-03-16,Napa,055,140530,7,0,0,0,0
2020-03-16,Nevada,057,99092,11,1,1,2,0
2020-03-16,Orange,059,3164182,415,18,3,21,0
2020-03-16,Placer,061,380077,39,7,0,7,1
2020-03-16,Plumas,063,18699,0,0,0,0,0
2020-03-16,Riverside,065,2383286,235,10,5,15,0
2020-03-16,Sacramento,067,1510023,210,34,0,34,1
2020-03-16,San Benito,069,59416,8,2,0,2,0
2020-03-16,San Bernardino,071,2135413,145,1,0,1,0
2020-03-16,San Diego,073,3302833,525,17,0,17,0
2020-03-16,San Francisco,075,870044,267,40,0,40,0
2020-03-16,San Joaquin,077,732212,74,9,3,12,0
2020-03-16,San Luis Obispo,079,281455,55,1,0,1,0
2020-03-16,San Mateo,081,765935,269,42,2,44,1
2020-03-16,Santa Barbara,083,443738,55,0,0,0,0
2020-03-16,Santa Clara,085,1922200,658,115,1,116,2
2020-03-16,Santa Cruz,087,273765,45,9,0,9,0
2020-03-16,Shasta,089,179085,5,1,0,1,0
2020-03-16,Sierra,091,2930,0,0,0,0,0
2020-03-16,Siskiyou,093,43540,2,0,0,0,0
2020-03-16,Solano,095,438530,43,27,0,27,0
2020-03-16,Sonoma,097,501317,63,4,0,4,0
2020-03-16,Stanislaus,099,539301,27,2,2,4,0
2020-03-16,Sutter,101,95872,3,0,0,0,0
2020-03-16,Tehama,103,63373,0,0,0,0,0
2020-03-16,Trinity,105,12862,0,0,0,0,0
2020-03-16,Tulare,107,460477,25,2,3,5,0
2020-03-16,Tuolumne,109,53932,2,0,0,0,0
2020-03-16,Ventura,111,848112,88,7,0,7,0
2020-03-16,Yolo,113,214977,17,2,0,2,0
2020-03-16,Yuba,115,75493,3,0,0,0,0
2020-03-15,Alameda,001,1643700,216,17,0,17,0
2020-03-15,Alpine,003,1148,0,0,0,0,0
2020-03-15,Amador,005,37829,1,0,0,0,0
2020-03-15,Butte,007,227075,3,0,0,0,0
2020-03-15,Calaveras,009,45235,2,2,0,2,0
2020-03-15,Colusa,011,21464,0,0,0,0,0
2020-03-15,Contra Costa,013,1133247,161,34,0,34,0
2020-03-15,Del Norte,015,27424,0,0,0,0,0
2020-03-15,El Dorado,017,186661,14,0,0,0,0
2020-03-15,Fresno,019,978130,33,1,1,2,0
2020-03-15,Glenn,021,27897,0,0,0,0,0
2020-03-15,Humboldt,023,135768,11,1,0,1,0
2020-03-15,Imperial,025,180216,14,2,0,2,0
2020-03-15,Inyo,027,18085,0,0,0,0,0
2020-03-15,Kern,029,883053,37,0,0,0,0
2020-03-15,Kings,031,150075,11,0,1,1,0
2020-03-15,Lake,033,64148,0,0,0,0,0
2020-03-15,Lassen,035,31185,1,0,0,0,0
2020-03-15,Los Angeles,037,10098052,1356,41,9,50,0
2020-03-15,Madera,039,155013,20,2,0,2,0
2020-03-15,Marin,041,260295,41,3,0,3,0
2020-03-15,Mariposa,043,17540,0,0,0,0,0
2020-03-15,Mendocino,045,87422,2,0,0,0,0
2020-03-15,Merced,047,269075,3,0,0,0,0
2020-03-15,Modoc,049,8938,0,0,0,0,0
2020-03-15,Mono,051,14174,6,0,0,0,0
2020-03-15,Monterey,053,433212,21,0,0,0,0
2020-03-15,Napa,055,140530,7,0,0,0,0
2020-03-15,Nevada,057,99092,11,0,1,1,0
2020-03-15,Orange,059,3164182,347,16,1,17,0
2020-03-15,Placer,061,380077,33,7,0,7,1
2020-03-15,Plumas,063,18699,0,0,0,0,0
2020-03-15,Riverside,065,2383286,183,10,5,15,0
2020-03-15,Sacramento,067,1510023,174,30,0,30,1
2020-03-15,San Benito,069,59416,8,2,0,2,0
2020-03-15,San Bernardino,071,2135413,123,0,0,0,0
2020-03-15,San Diego,073,3302833,438,16,0,16,0
2020-03-15,San Francisco,075,870044,209,31,0,31,0
2020-03-15,San Joaquin,077,732212,63,6,3,9,0
2020-03-15,San Luis Obispo,079,281455,45,1,0,1,0
2020-03-15,San Mateo,081,765935,235,29,1,30,1
2020-03-15,Santa Barbara,083,443738,46,0,0,0,0
2020-03-15,Santa Clara,085,1922200,586,79,1,80,2
2020-03-15,Santa Cruz,087,273765,38,8,0,8,0
2020-03-15,Shasta,089,179085,5,1,0,1,0
2020-03-15,Sierra,091,2930,0,0,0,0,0
2020-03-15,Siskiyou,093,43540,2,0,0,0,0
2020-03-15,Solano,095,438530,42,26,0,26,0
2020-03-15,Sonoma,097,501317,54,4,0,4,0
2020-03-15,Stanislaus,099,539301,26,2,2,4,0
2020-03-15,Sutter,101,95872,2,0,0,0,0
2020-03-15,Tehama,103,63373,0,0,0,0,0
2020-03-15,Trinity,105,12862,0,0,0,0,0
2020-03-15,Tulare,107,460477,19,2,3,5,0
2020-03-15,Tuolumne,109,53932,1,0,0,0,0
2020-03-15,Ventura,111,848112,77,5,0,5,0
2020-03-15,Yolo,113,214977,14,2,0,2,0
2020-03-15,Yuba,115,75493,2,0,0,0,0
2020-03-14,Alameda,001,1643700,197,11,0,11,0
2020-03-14,Alpine,003,1148,0,0,0,0,0
2020-03-14,Amador,005,37829,1,0,0,0,0
2020-03-14,Butte,007,227075,2,0,0,0,0
2020-03-14,Calaveras,009,45235,2,2,0,2,0
2020-03-14,Colusa,011,21464,0,0,0,0,0
2020-03-14,Contra Costa,013,1133247,139,30,0,30,0
2020-03-14,Del Norte,015,27424,0,0,0,0,0
2020-03-14,El Dorado,017,186661,12,0,0,0,0
2020-03-14,Fresno,019,978130,25,1,1,2,0
2020-03-14,Glenn,021,27897,0,0,0,0,0
2020-03-14,Humboldt,023,135768,7,1,0,1,0
2020-03-14,Imperial,025,180216,10,2,0,2,0
2020-03-14,Inyo,027,18085,0,0,0,0,0
2020-03-14,Kern,029,883053,32,0,0,0,0
2020-03-14,Kings,031,150075,11,0,1,1,0
2020-03-14,Lake,033,64148,0,0,0,0,0
2020-03-14,Lassen,035,31185,1,0,0,0,0
2020-03-14,Los Angeles,037,10098052,1178,35,9,44,0
2020-03-14,Madera,039,155013,19,2,0,2,0
2020-03-14,Marin,041,260295,37,3,0,3,0
2020-03-14,Mariposa,043,17540,0,0,0,0,0
2020-03-14,Mendocino,045,87422,2,0,0,0,0
2020-03-14,Merced,047,269075,3,0,0,0,0
2020-03-14,Modoc,049,8938,0,0,0,0,0
2020-03-14,Mono,051,14174,5,0,0,0,0
2020-03-14,Monterey,053,433212,15,0,0,0,0
2020-03-14,Napa,055,140530,5,0,0,0,0
2020-03-14,Nevada,057,99092,8,0,1,1,0
2020-03-14,Orange,059,3164182,308,14,0,14,0
2020-03-14,Placer,061,380077,29,6,0,6,1
2020-03-14,Plumas,063,18699,0,0,0,0,0
2020-03-14,Riverside,065,2383286,163,10,5,15,0
2020-03-14,Sacramento,067,1510023,152,31,0,31,1
2020-03-14,San Benito,069,59416,8,2,0,2,0
2020-03-14,San Bernardino,071,2135413,104,0,0,0,0
2020-03-14,San Diego,073,3302833,363,10,0,10,0
2020-03-14,San Francisco,075,870044,188,29,0,29,0
2020-03-14,San Joaquin,077,732212,54,6,3,9,0
2020-03-14,San Luis Obispo,079,281455,40,0,0,0,0
2020-03-14,San Mateo,081,765935,212,27,1,28,0
2020-03-14,Santa Barbara,083,443738,37,0,0,0,0
2020-03-14,Santa Clara,085,1922200,530,62,1,63,2
2020-03-14,Santa Cruz,087,273765,33,8,0,8,0
2020-03-14,Shasta,089,179085,5,1,0,1,0
2020-03-14,Sierra,091,2930,0,0,0,0,0
2020-03-14,Siskiyou,093,43540,1,0,0,0,0
2020-03-14,Solano,095,438530,40,26,0,26,0
2020-03-14,Sonoma,097,501317,41,2,0,2,0
2020-03-14,Stanislaus,099,539301,22,2,2,4,0
2020-03-14,Sutter,101,95872,2,0,0,0,0
2020-03-14,Tehama,103,63373,0,0,0,0,0
2020-03-14,Trinity,105,12862,0,0,0,0,0
2020-03-14,Tulare,107,460477,17,2,2,4,0
2020-03-14,Tuolumne,109,53932,1,0,0,0,0
2020-03-14,Ventura,111,848112,68,5,0,5,0
2020-03-14,Yolo,113,214977,14,2,0,2,0
2020-03-14,Yuba,115,75493,1,0,0,0,0
2020-03-13,Alameda,001,1643700,178,12,0,12,0
2020-03-13,Alpine,003,1148,0,0,0,0,0
2020-03-13,Amador,005,37829,1,0,0,0,0
2020-03-13,Butte,007,227075,0,0,0,0,0
2020-03-13,Calaveras,009,45235,2,2,0,2,0
2020-03-13,Colusa,011,21464,0,0,0,0,0
2020-03-13,Contra Costa,013,1133247,125,22,0,22,0
2020-03-13,Del Norte,015,27424,0,0,0,0,0
2020-03-13,El Dorado,017,186661,11,0,0,0,0
2020-03-13,Fresno,019,978130,20,1,1,2,0
2020-03-13,Glenn,021,27897,0,0,0,0,0
2020-03-13,Humboldt,023,135768,7,1,0,1,0
2020-03-13,Imperial,025,180216,9,2,0,2,0
2020-03-13,Inyo,027,18085,0,0,0,0,0
2020-03-13,Kern,029,883053,27,0,0,0,0
2020-03-13,Kings,031,150075,10,0,1,1,0
2020-03-13,Lake,033,64148,0,0,0,0,0
2020-03-13,Lassen,035,31185,1,0,0,0,0
2020-03-13,Los Angeles,037,10098052,1025,30,7,37,0
2020-03-13,Madera,039,155013,18,1,0,1,0
2020-03-13,Marin,041,260295,34,3,0,3,0
2020-03-13,Mariposa,043,17540,0,0,0,0,0
2020-03-13,Mendocino,045,87422,2,0,0,0,0
2020-03-13,Merced,047,269075,2,0,0,0,0
2020-03-13,Modoc,049,8938,0,0,0,0,0
2020-03-13,Mono,051,14174,3,0,0,0,0
2020-03-13,Monterey,053,433212,10,0,0,0,0
2020-03-13,Napa,055,140530,3,0,0,0,0
2020-03-13,Nevada,057,99092,7,0,1,1,0
2020-03-13,Orange,059,3164182,268,10,0,10,0
2020-03-13,Placer,061,380077,27,6,0,6,1
2020-03-13,Plumas,063,18699,0,0,0,0,0
2020-03-13,Riverside,065,2383286,133,5,4,9,0
2020-03-13,Sacramento,067,1510023,130,18,0,18,1
2020-03-13,San Benito,069,59416,6,2,0,2,0
2020-03-13,San Bernardino,071,2135413,97,0,0,0,0
2020-03-13,San Diego,073,3302833,313,8,0,8,0
2020-03-13,San Francisco,075,870044,174,28,0,28,0
2020-03-13,San Joaquin,077,732212,50,6,3,9,0
2020-03-13,San Luis Obispo,079,281455,33,0,0,0,0
2020-03-13,San Mateo,081,765935,191,24,1,25,0
2020-03-13,Santa Barbara,083,443738,33,0,0,0,0
2020-03-13,Santa Clara,085,1922200,468,59,1,60,1
2020-03-13,Santa Cruz,087,273765,32,7,0,7,0
2020-03-13,Shasta,089,179085,3,1,0,1,0
2020-03-13,Sierra,091,2930,0,0,0,0,0
2020-03-13,Siskiyou,093,43540,0,0,0,0,0
2020-03-13,Solano,095,438530,39,26,0,26,0
2020-03-13,Sonoma,097,501317,40,2,0,2,0
2020-03-13,Stanislaus,099,539301,17,2,2,4,0
2020-03-13,Sutter,101,95872,2,0,0,0,0
2020-03-13,Tehama,103,63373,0,0,0,0,0
2020-03-13,Trinity,105,12862,0,0,0,0,0
2020-03-13,Tulare,107,460477,14,2,2,4,0
2020-03-13,Tuolumne,109,53932,1,0,0,0,0
2020-03-13,Ventura,111,848112,54,5,0,5,0
2020-03-13,Yolo,113,214977,14,1,0,1,0
2020-03-13,Yuba,115,75493,1,0,0,0,0
2020-03-12,Alameda,001,1643700,152,9,0,9,0
2020-03-12,Alpine,003,1148,0,0,0,0,0
2020-03-12,Amador,005,37829,1,0,0,0,0
2020-03-12,Butte,007,227075,0,0,0,0,0
2020-03-12,Calaveras,009,45235,2,2,0,2,0
2020-03-12,Colusa,011,21464,0,0,0,0,0
2020-03-12,Contra Costa,013,1133247,108,18,0,18,0
2020-03-12,Del Norte,015,27424,0,0,0,0,0
2020-03-12,El Dorado,017,186661,9,0,0,0,0
2020-03-12,Fresno,019,978130,12,1,1,2,0
2020-03-12,Glenn,021,27897,0,0,0,0,0
2020-03-12,Humboldt,023,135768,6,1,0,1,0
2020-03-12,Imperial,025,180216,8,2,0,2,0
2020-03-12,Inyo,027,18085,0,0,0,0,0
2020-03-12,Kern,029,883053,18,0,0,0,0
2020-03-12,Kings,031,150075,7,0,1,1,0
2020-03-12,Lake,033,64148,0,0,0,0,0
2020-03-12,Lassen,035,31185,1,0,0,0,0
2020-03-12,Los Angeles,037,10098052,866,30,7,37,0
2020-03-12,Madera,039,155013,15,1,0,1,0
2020-03-12,Marin,041,260295,24,1,0,1,0
2020-03-12,Mariposa,043,17540,0,0,0,0,0
2020-03-12,Mendocino,045,87422,2,0,0,0,0
2020-03-12,Merced,047,269075,2,0,0,0,0
2020-03-12,Modoc,049,8938,0,0,0,0,0
2020-03-12,Mono,051,14174,3,0,0,0,0
2020-03-12,Monterey,053,433212,8,0,0,0,0
2020-03-12,Napa,055,140530,3,0,0,0,0
2020-03-12,Nevada,057,99092,4,0,1,1,0
2020-03-12,Orange,059,3164182,231,7,0,7,0
2020-03-12,Placer,061,380077,23,6,0,6,1
2020-03-12,Plumas,063,18699,0,0,0,0,0
2020-03-12,Riverside,065,2383286,107,5,2,7,0
2020-03-12,Sacramento,067,1510023,106,17,0,17,1
2020-03-12,San Benito,069,59416,5,2,0,2,0
2020-03-12,San Bernardino,071,2135413,81,0,0,0,0
2020-03-12,San Diego,073,3302833,258,9,0,9,0
2020-03-12,San Francisco,075,870044,149,20,0,20,0
2020-03-12,San Joaquin,077,732212,44,3,3,6,1
2020-03-12,San Luis Obispo,079,281455,26,0,0,0,0
2020-03-12,San Mateo,081,765935,157,21,1,22,0
2020-03-12,Santa Barbara,083,443738,22,0,0,0,0
2020-03-12,Santa Clara,085,1922200,410,51,1,52,1
2020-03-12,Santa Cruz,087,273765,29,5,0,5,0
2020-03-12,Shasta,089,179085,2,1,0,1,0
2020-03-12,Sierra,091,2930,0,0,0,0,0
2020-03-12,Siskiyou,093,43540,0,0,0,0,0
2020-03-12,Solano,095,438530,34,26,0,26,0
2020-03-12,Sonoma,097,501317,34,2,0,2,0
2020-03-12,Stanislaus,099,539301,15,2,2,4,0
2020-03-12,Sutter,101,95872,0,0,0,0,0
2020-03-12,Tehama,103,63373,0,0,0,0,0
2020-03-12,Trinity,105,12862,0,0,0,0,0
2020-03-12,Tulare,107,460477,12,1,1,2,0
2020-03-12,Tuolumne,109,53932,1,0,0,0,0
2020-03-12,Ventura,111,848112,45,3,0,3,0
2020-03-12,Yolo,113,214977,13,1,0,1,0
2020-03-12,Yuba,115,75493,1,0,0,0,0
2020-03-11,Alameda,001,1643700,120,5,0,5,0
2020-03-11,Alpine,003,1148,0,0,0,0,0
2020-03-11,Amador,005,37829,1,0,0,0,0
2020-03-11,Butte,007,227075,0,0,0,0,0
2020-03-11,Calaveras,009,45235,2,2,0,2,0
2020-03-11,Colusa,011,21464,0,0,0,0,0
2020-03-11,Contra Costa,013,1133247,93,16,0,16,0
2020-03-11,Del Norte,015,27424,0,0,0,0,0
2020-03-11,El Dorado,017,186661,8,0,0,0,0
2020-03-11,Fresno,019,978130,9,1,1,2,0
2020-03-11,Glenn,021,27897,0,0,0,0,0
2020-03-11,Humboldt,023,135768,6,1,0,1,0
2020-03-11,Imperial,025,180216,6,0,0,0,0
2020-03-11,Inyo,027,18085,0,0,0,0,0
2020-03-11,Kern,029,883053,16,0,0,0,0
2020-03-11,Kings,031,150075,5,0,1,1,0
2020-03-11,Lake,033,64148,0,0,0,0,0
2020-03-11,Lassen,035,31185,1,0,0,0,0
2020-03-11,Los Angeles,037,10098052,698,21,7,28,0
2020-03-11,Madera,039,155013,12,1,0,1,0
2020-03-11,Marin,041,260295,17,1,0,1,0
2020-03-11,Mariposa,043,17540,0,0,0,0,0
2020-03-11,Mendocino,045,87422,1,0,0,0,0
2020-03-11,Merced,047,269075,2,0,0,0,0
2020-03-11,Modoc,049,8938,0,0,0,0,0
2020-03-11,Mono,051,14174,3,0,0,0,0
2020-03-11,Monterey,053,433212,7,0,0,0,0
2020-03-11,Napa,055,140530,2,0,0,0,0
2020-03-11,Nevada,057,99092,4,0,1,1,0
2020-03-11,Orange,059,3164182,202,6,0,6,0
2020-03-11,Placer,061,380077,18,6,0,6,1
2020-03-11,Plumas,063,18699,0,0,0,0,0
2020-03-11,Riverside,065,2383286,81,4,1,5,0
2020-03-11,Sacramento,067,1510023,88,9,0,9,1
2020-03-11,San Benito,069,59416,5,2,0,2,0
2020-03-11,San Bernardino,071,2135413,74,0,0,0,0
2020-03-11,San Diego,073,3302833,208,4,0,4,0
2020-03-11,San Francisco,075,870044,124,17,0,17,0
2020-03-11,San Joaquin,077,732212,33,1,3,4,0
2020-03-11,San Luis Obispo,079,281455,23,0,0,0,0
2020-03-11,San Mateo,081,765935,139,16,0,16,0
2020-03-11,Santa Barbara,083,443738,13,0,0,0,0
2020-03-11,Santa Clara,085,1922200,370,48,1,49,1
2020-03-11,Santa Cruz,087,273765,26,2,0,2,0
2020-03-11,Shasta,089,179085,2,1,0,1,0
2020-03-11,Sierra,091,2930,0,0,0,0,0
2020-03-11,Siskiyou,093,43540,0,0,0,0,0
2020-03-11,Solano,095,438530,29,26,0,26,0
2020-03-11,Sonoma,097,501317,30,2,0,2,0
2020-03-11,Stanislaus,099,539301,15,2,2,4,0
2020-03-11,Sutter,101,95872,0,0,0,0,0
2020-03-11,Tehama,103,63373,0,0,0,0,0
2020-03-11,Trinity,105,12862,0,0,0,0,0
2020-03-11,Tulare,107,460477,10,0,1,1,0
2020-03-11,Tuolumne,109,53932,1,0,0,0,0
2020-03-11,Ventura,111,848112,37,3,0,3,0
2020-03-11,Yolo,113,214977,9,1,0,1,0
2020-03-11,Yuba,115,75493,1,0,0,0,0
2020-03-10,Alameda,001,1643700,99,4,0,4,0
2020-03-10,Alpine,003,1148,0,0,0,0,0
2020-03-10,Amador,005,37829,1,0,0,0,0
2020-03-10,Butte,007,227075,0,0,0,0,0
2020-03-10,Calaveras,009,45235,2,2,0,2,0
2020-03-10,Colusa,011,21464,0,0,0,0,0
2020-03-10,Contra Costa,013,1133247,84,11,0,11,0
2020-03-10,Del Norte,015,27424,0,0,0,0,0
2020-03-10,El Dorado,017,186661,7,0,0,0,0
2020-03-10,Fresno,019,978130,7,1,1,2,0
2020-03-10,Glenn,021,27897,0,0,0,0,0
2020-03-10,Humboldt,023,135768,6,1,0,1,0
2020-03-10,Imperial,025,180216,5,0,0,0,0
2020-03-10,Inyo,027,18085,0,0,0,0,0
2020-03-10,Kern,029,883053,11,0,0,0,0
2020-03-10,Kings,031,150075,5,0,1,1,0
2020-03-10,Lake,033,64148,0,0,0,0,0
2020-03-10,Lassen,035,31185,1,0,0,0,0
2020-03-10,Los Angeles,037,10098052,562,20,7,27,0
2020-03-10,Madera,039,155013,7,1,0,1,0
2020-03-10,Marin,041,260295,16,1,0,1,0
2020-03-10,Mariposa,043,17540,0,0,0,0,0
2020-03-10,Mendocino,045,87422,0,0,0,0,0
2020-03-10,Merced,047,269075,2,0,0,0,0
2020-03-10,Modoc,049,8938,0,0,0,0,0
2020-03-10,Mono,051,14174,3,0,0,0,0
2020-03-10,Monterey,053,433212,5,0,0,0,0
2020-03-10,Napa,055,140530,2,0,0,0,0
2020-03-10,Nevada,057,99092,3,0,1,1,0
2020-03-10,Orange,059,3164182,182,5,0,5,1
2020-03-10,Placer,061,380077,14,7,0,7,1
2020-03-10,Plumas,063,18699,0,0,0,0,0
2020-03-10,Riverside,065,2383286,59,4,1,5,0
2020-03-10,Sacramento,067,1510023,79,8,0,8,0
2020-03-10,San Benito,069,59416,5,2,0,2,0
2020-03-10,San Bernardino,071,2135413,66,0,0,0,0
2020-03-10,San Diego,073,3302833,165,3,0,3,0
2020-03-10,San Francisco,075,870044,92,16,0,16,0
2020-03-10,San Joaquin,077,732212,30,1,3,4,0
2020-03-10,San Luis Obispo,079,281455,15,0,0,0,0
2020-03-10,San Mateo,081,765935,123,11,0,11,0
2020-03-10,Santa Barbara,083,443738,10,0,0,0,0
2020-03-10,Santa Clara,085,1922200,322,45,1,46,1
2020-03-10,Santa Cruz,087,273765,22,2,0,2,0
2020-03-10,Shasta,089,179085,2,1,0,1,0
2020-03-10,Sierra,091,2930,0,0,0,0,0
2020-03-10,Siskiyou,093,43540,0,0,0,0,0
2020-03-10,Solano,095,438530,27,26,0,26,0
2020-03-10,Sonoma,097,501317,27,2,0,2,0
2020-03-10,Stanislaus,099,539301,11,0,2,2,0
2020-03-10,Sutter,101,95872,0,0,0,0,0
2020-03-10,Tehama,103,63373,0,0,0,0,0
2020-03-10,Trinity,105,12862,0,0,0,0,0
2020-03-10,Tulare,107,460477,9,0,1,1,0
2020-03-10,Tuolumne,109,53932,1,0,0,0,0
2020-03-10,Ventura,111,848112,29,1,0,1,0
2020-03-10,Yolo,113,214977,6,2,0,2,0
2020-03-10,Yuba,115,75493,1,0,0,0,0
2020-03-09,Alameda,001,1643700,71,4,0,4,0
2020-03-09,Alpine,003,1148,0,0,0,0,0
2020-03-09,Amador,005,37829,0,0,0,0,0
2020-03-09,Butte,007,227075,0,0,0,0,0
2020-03-09,Calaveras,009,45235,2,0,0,0,0
2020-03-09,Colusa,011,21464,0,0,0,0,0
2020-03-09,Contra Costa,013,1133247,72,9,0,9,0
2020-03-09,Del Norte,015,27424,0,0,0,0,0
2020-03-09,El Dorado,017,186661,5,0,0,0,0
2020-03-09,Fresno,019,978130,7,1,1,2,0
2020-03-09,Glenn,021,27897,0,0,0,0,0
2020-03-09,Humboldt,023,135768,5,1,0,1,0
2020-03-09,Imperial,025,180216,5,0,0,0,0
2020-03-09,Inyo,027,18085,0,0,0,0,0
2020-03-09,Kern,029,883053,8,0,0,0,0
2020-03-09,Kings,031,150075,4,0,1,1,0
2020-03-09,Lake,033,64148,0,0,0,0,0
2020-03-09,Lassen,035,31185,1,0,0,0,0
2020-03-09,Los Angeles,037,10098052,460,17,6,23,0
2020-03-09,Madera,039,155013,7,1,0,1,0
2020-03-09,Marin,041,260295,15,1,0,1,0
2020-03-09,Mariposa,043,17540,0,0,0,0,0
2020-03-09,Mendocino,045,87422,0,0,0,0,0
2020-03-09,Merced,047,269075,2,0,0,0,0
2020-03-09,Modoc,049,8938,0,0,0,0,0
2020-03-09,Mono,051,14174,3,0,0,0,0
2020-03-09,Monterey,053,433212,3,0,0,0,0
2020-03-09,Napa,055,140530,2,0,0,0,0
2020-03-09,Nevada,057,99092,2,0,1,1,0
2020-03-09,Orange,059,3164182,154,4,0,4,0
2020-03-09,Placer,061,380077,12,7,0,7,1
2020-03-09,Plumas,063,18699,0,0,0,0,0
2020-03-09,Riverside,065,2383286,49,4,1,5,0
2020-03-09,Sacramento,067,1510023,75,8,0,8,0
2020-03-09,San Benito,069,59416,3,2,0,2,0
2020-03-09,San Bernardino,071,2135413,55,0,0,0,0
2020-03-09,San Diego,073,3302833,126,2,0,2,0
2020-03-09,San Francisco,075,870044,72,14,0,14,0
2020-03-09,San Joaquin,077,732212,21,0,3,3,0
2020-03-09,San Luis Obispo,079,281455,15,0,0,0,0
2020-03-09,San Mateo,081,765935,109,6,0,6,0
2020-03-09,Santa Barbara,083,443738,8,0,0,0,0
2020-03-09,Santa Clara,085,1922200,278,42,1,43,1
2020-03-09,Santa Cruz,087,273765,19,2,0,2,0
2020-03-09,Shasta,089,179085,2,1,0,1,0
2020-03-09,Sierra,091,2930,0,0,0,0,0
2020-03-09,Siskiyou,093,43540,0,0,0,0,0
2020-03-09,Solano,095,438530,25,26,0,26,0
2020-03-09,Sonoma,097,501317,22,2,0,2,0
2020-03-09,Stanislaus,099,539301,11,0,2,2,0
2020-03-09,Sutter,101,95872,0,0,0,0,0
2020-03-09,Tehama,103,63373,0,0,0,0,0
2020-03-09,Trinity,105,12862,0,0,0,0,0
2020-03-09,Tulare,107,460477,9,0,1,1,0
2020-03-09,Tuolumne,109,53932,1,0,0,0,0
2020-03-09,Ventura,111,848112,25,1,0,1,0
2020-03-09,Yolo,113,214977,5,2,0,2,0
2020-03-09,Yuba,115,75493,0,0,0,0,0
2020-03-08,Alameda,001,1643700,46,4,0,4,0
2020-03-08,Alpine,003,1148,0,0,0,0,0
2020-03-08,Amador,005,37829,0,0,0,0,0
2020-03-08,Butte,007,227075,0,0,0,0,0
2020-03-08,Calaveras,009,45235,2,0,0,0,0
2020-03-08,Colusa,011,21464,0,0,0,0,0
2020-03-08,Contra Costa,013,1133247,58,9,0,9,0
2020-03-08,Del Norte,015,27424,0,0,0,0,0
2020-03-08,El Dorado,017,186661,5,0,0,0,0
2020-03-08,Fresno,019,978130,5,1,1,2,0
2020-03-08,Glenn,021,27897,0,0,0,0,0
2020-03-08,Humboldt,023,135768,5,1,0,1,0
2020-03-08,Imperial,025,180216,5,0,0,0,0
2020-03-08,Inyo,027,18085,0,0,0,0,0
2020-03-08,Kern,029,883053,8,0,0,0,0
2020-03-08,Kings,031,150075,3,0,1,1,0
2020-03-08,Lake,033,64148,0,0,0,0,0
2020-03-08,Lassen,035,31185,0,0,0,0,0
2020-03-08,Los Angeles,037,10098052,367,14,6,20,0
2020-03-08,Madera,039,155013,7,1,0,1,0
2020-03-08,Marin,041,260295,13,1,0,1,0
2020-03-08,Mariposa,043,17540,0,0,0,0,0
2020-03-08,Mendocino,045,87422,0,0,0,0,0
2020-03-08,Merced,047,269075,2,0,0,0,0
2020-03-08,Modoc,049,8938,0,0,0,0,0
2020-03-08,Mono,051,14174,3,0,0,0,0
2020-03-08,Monterey,053,433212,3,0,0,0,0
2020-03-08,Napa,055,140530,2,0,0,0,0
2020-03-08,Nevada,057,99092,1,0,1,1,0
2020-03-08,Orange,059,3164182,129,4,0,4,0
2020-03-08,Placer,061,380077,11,7,0,7,1
2020-03-08,Plumas,063,18699,0,0,0,0,0
2020-03-08,Riverside,065,2383286,41,1,1,2,0
2020-03-08,Sacramento,067,1510023,65,5,0,5,0
2020-03-08,San Benito,069,59416,3,2,0,2,0
2020-03-08,San Bernardino,071,2135413,44,0,0,0,0
2020-03-08,San Diego,073,3302833,92,2,0,2,0
2020-03-08,San Francisco,075,870044,53,9,0,9,0
2020-03-08,San Joaquin,077,732212,18,0,3,3,0
2020-03-08,San Luis Obispo,079,281455,9,0,0,0,0
2020-03-08,San Mateo,081,765935,96,4,0,4,0
2020-03-08,Santa Barbara,083,443738,5,0,0,0,0
2020-03-08,Santa Clara,085,1922200,236,36,1,37,0
2020-03-08,Santa Cruz,087,273765,17,1,0,1,0
2020-03-08,Shasta,089,179085,2,0,0,0,0
2020-03-08,Sierra,091,2930,0,0,0,0,0
2020-03-08,Siskiyou,093,43540,0,0,0,0,0
2020-03-08,Solano,095,438530,24,26,0,26,0
2020-03-08,Sonoma,097,501317,17,2,0,2,0
2020-03-08,Stanislaus,099,539301,10,0,2,2,0
2020-03-08,Sutter,101,95872,0,0,0,0,0
2020-03-08,Tehama,103,63373,0,0,0,0,0
2020-03-08,Trinity,105,12862,0,0,0,0,0
2020-03-08,Tulare,107,460477,9,0,0,0,0
2020-03-08,Tuolumne,109,53932,1,0,0,0,0
2020-03-08,Ventura,111,848112,21,1,0,1,0
2020-03-08,Yolo,113,214977,2,2,0,2,0
2020-03-08,Yuba,115,75493,0,0,0,0,0
2020-03-07,Alameda,001,1643700,41,3,0,3,0
2020-03-07,Alpine,003,1148,0,0,0,0,0
2020-03-07,Amador,005,37829,0,0,0,0,0
2020-03-07,Butte,007,227075,0,0,0,0,0
2020-03-07,Calaveras,009,45235,2,0,0,0,0
2020-03-07,Colusa,011,21464,0,0,0,0,0
2020-03-07,Contra Costa,013,1133247,55,4,0,4,0
2020-03-07,Del Norte,015,27424,0,0,0,0,0
2020-03-07,El Dorado,017,186661,4,0,0,0,0
2020-03-07,Fresno,019,978130,4,1,1,2,0
2020-03-07,Glenn,021,27897,0,0,0,0,0
2020-03-07,Humboldt,023,135768,5,1,0,1,0
2020-03-07,Imperial,025,180216,4,0,0,0,0
2020-03-07,Inyo,027,18085,0,0,0,0,0
2020-03-07,Kern,029,883053,7,0,0,0,0
2020-03-07,Kings,031,150075,3,0,1,1,0
2020-03-07,Lake,033,64148,0,0,0,0,0
2020-03-07,Lassen,035,31185,0,0,0,0,0
2020-03-07,Los Angeles,037,10098052,317,14,6,20,0
2020-03-07,Madera,039,155013,6,1,0,1,0
2020-03-07,Marin,041,260295,11,0,0,0,0
2020-03-07,Mariposa,043,17540,0,0,0,0,0
2020-03-07,Mendocino,045,87422,0,0,0,0,0
2020-03-07,Merced,047,269075,2,0,0,0,0
2020-03-07,Modoc,049,8938,0,0,0,0,0
2020-03-07,Mono,051,14174,3,0,0,0,0
2020-03-07,Monterey,053,433212,3,0,0,0,0
2020-03-07,Napa,055,140530,1,0,0,0,0
2020-03-07,Nevada,057,99092,1,0,1,1,0
2020-03-07,Orange,059,3164182,121,4,0,4,0
2020-03-07,Placer,061,380077,11,6,0,6,1
2020-03-07,Plumas,063,18699,0,0,0,0,0
2020-03-07,Riverside,065,2383286,31,0,1,1,0
2020-03-07,Sacramento,067,1510023,52,4,0,4,0
2020-03-07,San Benito,069,59416,3,2,0,2,0
2020-03-07,San Bernardino,071,2135413,42,0,0,0,0
2020-03-07,San Diego,073,3302833,74,2,0,2,0
2020-03-07,San Francisco,075,870044,47,9,0,9,0
2020-03-07,San Joaquin,077,732212,16,0,3,3,0
2020-03-07,San Luis Obispo,079,281455,6,0,0,0,0
2020-03-07,San Mateo,081,765935,86,1,0,1,0
2020-03-07,Santa Barbara,083,443738,5,0,0,0,0
2020-03-07,Santa Clara,085,1922200,206,31,1,32,0
2020-03-07,Santa Cruz,087,273765,17,1,0,1,0
2020-03-07,Shasta,089,179085,2,0,0,0,0
2020-03-07,Sierra,091,2930,0,0,0,0,0
2020-03-07,Siskiyou,093,43540,0,0,0,0,0
2020-03-07,Solano,095,438530,23,25,0,25,0
2020-03-07,Sonoma,097,501317,13,2,0,2,0
2020-03-07,Stanislaus,099,539301,9,0,2,2,0
2020-03-07,Sutter,101,95872,0,0,0,0,0
2020-03-07,Tehama,103,63373,0,0,0,0,0
2020-03-07,Trinity,105,12862,0,0,0,0,0
2020-03-07,Tulare,107,460477,6,0,0,0,0
2020-03-07,Tuolumne,109,53932,1,0,0,0,0
2020-03-07,Ventura,111,848112,18,1,0,1,0
2020-03-07,Yolo,113,214977,2,2,0,2,0
2020-03-07,Yuba,115,75493,0,0,0,0,0
2020-03-06,Alameda,001,1643700,39,3,0,3,0
2020-03-06,Alpine,003,1148,0,0,0,0,0
2020-03-06,Amador,005,37829,0,0,0,0,0
2020-03-06,Butte,007,227075,0,0,0,0,0
2020-03-06,Calaveras,009,45235,2,0,0,0,0
2020-03-06,Colusa,011,21464,0,0,0,0,0
2020-03-06,Contra Costa,013,1133247,46,4,0,4,0
2020-03-06,Del Norte,015,27424,0,0,0,0,0
2020-03-06,El Dorado,017,186661,3,0,0,0,0
2020-03-06,Fresno,019,978130,3,0,1,1,0
2020-03-06,Glenn,021,27897,0,0,0,0,0
2020-03-06,Humboldt,023,135768,4,1,0,1,0
2020-03-06,Imperial,025,180216,3,0,0,0,0
2020-03-06,Inyo,027,18085,0,0,0,0,0
2020-03-06,Kern,029,883053,6,0,0,0,0
2020-03-06,Kings,031,150075,3,0,1,1,0
2020-03-06,Lake,033,64148,0,0,0,0,0
2020-03-06,Lassen,035,31185,0,0,0,0,0
2020-03-06,Los Angeles,037,10098052,274,13,6,19,0
2020-03-06,Madera,039,155013,5,0,0,0,0
2020-03-06,Marin,041,260295,10,0,0,0,0
2020-03-06,Mariposa,043,17540,0,0,0,0,0
2020-03-06,Mendocino,045,87422,0,0,0,0,0
2020-03-06,Merced,047,269075,2,0,0,0,0
2020-03-06,Modoc,049,8938,0,0,0,0,0
2020-03-06,Mono,051,14174,1,0,0,0,0
2020-03-06,Monterey,053,433212,3,0,0,0,0
2020-03-06,Napa,055,140530,1,0,0,0,0
2020-03-06,Nevada,057,99092,1,0,1,1,0
2020-03-06,Orange,059,3164182,95,4,0,4,0
2020-03-06,Placer,061,380077,10,5,0,5,1
2020-03-06,Plumas,063,18699,0,0,0,0,0
2020-03-06,Riverside,065,2383286,30,0,1,1,0
2020-03-06,Sacramento,067,1510023,43,2,0,2,0
2020-03-06,San Benito,069,59416,3,2,0,2,0
2020-03-06,San Bernardino,071,2135413,40,0,0,0,0
2020-03-06,San Diego,073,3302833,61,2,0,2,0
2020-03-06,San Francisco,075,870044,41,2,0,2,0
2020-03-06,San Joaquin,077,732212,13,0,3,3,0
2020-03-06,San Luis Obispo,079,281455,4,0,0,0,0
2020-03-06,San Mateo,081,765935,78,1,0,1,0
2020-03-06,Santa Barbara,083,443738,3,0,0,0,0
2020-03-06,Santa Clara,085,1922200,188,20,1,21,0
2020-03-06,Santa Cruz,087,273765,15,0,0,0,0
2020-03-06,Shasta,089,179085,2,0,0,0,0
2020-03-06,Sierra,091,2930,0,0,0,0,0
2020-03-06,Siskiyou,093,43540,0,0,0,0,0
2020-03-06,Solano,095,438530,22,25,0,25,0
2020-03-06,Sonoma,097,501317,13,2,0,2,0
2020-03-06,Stanislaus,099,539301,5,0,2,2,0
2020-03-06,Sutter,101,95872,0,0,0,0,0
2020-03-06,Tehama,103,63373,0,0,0,0,0
2020-03-06,Trinity,105,12862,0,0,0,0,0
2020-03-06,Tulare,107,460477,6,0,0,0,0
2020-03-06,Tuolumne,109,53932,1,0,0,0,0
2020-03-06,Ventura,111,848112,15,1,0,1,0
2020-03-06,Yolo,113,214977,2,1,0,1,0
2020-03-06,Yuba,115,75493,0,0,0,0,0
2020-03-05,Alameda,001,1643700,34,2,0,2,0
2020-03-05,Alpine,003,1148,0,0,0,0,0
2020-03-05,Amador,005,37829,0,0,0,0,0
2020-03-05,Butte,007,227075,0,0,0,0,0
2020-03-05,Calaveras,009,45235,2,0,0,0,0
2020-03-05,Colusa,011,21464,0,0,0,0,0
2020-03-05,Contra Costa,013,1133247,39,1,0,1,0
2020-03-05,Del Norte,015,27424,0,0,0,0,0
2020-03-05,El Dorado,017,186661,1,0,0,0,0
2020-03-05,Fresno,019,978130,3,0,1,1,0
2020-03-05,Glenn,021,27897,0,0,0,0,0
2020-03-05,Humboldt,023,135768,4,1,0,1,0
2020-03-05,Imperial,025,180216,2,0,0,0,0
2020-03-05,Inyo,027,18085,0,0,0,0,0
2020-03-05,Kern,029,883053,6,0,0,0,0
2020-03-05,Kings,031,150075,3,0,1,1,0
2020-03-05,Lake,033,64148,0,0,0,0,0
2020-03-05,Lassen,035,31185,0,0,0,0,0
2020-03-05,Los Angeles,037,10098052,227,11,6,17,0
2020-03-05,Madera,039,155013,5,0,0,0,0
2020-03-05,Marin,041,260295,10,0,0,0,0
2020-03-05,Mariposa,043,17540,0,0,0,0,0
2020-03-05,Mendocino,045,87422,0,0,0,0,0
2020-03-05,Merced,047,269075,2,0,0,0,0
2020-03-05,Modoc,049,8938,0,0,0,0,0
2020-03-05,Mono,051,14174,1,0,0,0,0
2020-03-05,Monterey,053,433212,3,0,0,0,0
2020-03-05,Napa,055,140530,1,0,0,0,0
2020-03-05,Nevada,057,99092,0,0,1,1,0
2020-03-05,Orange,059,3164182,80,3,0,3,0
2020-03-05,Placer,061,380077,10,2,0,2,1
2020-03-05,Plumas,063,18699,0,0,0,0,0
2020-03-05,Riverside,065,2383286,27,0,1,1,0
2020-03-05,Sacramento,067,1510023,37,2,0,2,0
2020-03-05,San Benito,069,59416,1,2,0,2,0
2020-03-05,San Bernardino,071,2135413,35,0,0,0,0
2020-03-05,San Diego,073,3302833,54,2,0,2,0
2020-03-05,San Francisco,075,870044,31,2,0,2,0
2020-03-05,San Joaquin,077,732212,10,0,3,3,0
2020-03-05,San Luis Obispo,079,281455,4,0,0,0,0
2020-03-05,San Mateo,081,765935,65,1,0,1,0
2020-03-05,Santa Barbara,083,443738,2,0,0,0,0
2020-03-05,Santa Clara,085,1922200,164,14,1,15,0
2020-03-05,Santa Cruz,087,273765,13,0,0,0,0
2020-03-05,Shasta,089,179085,2,0,0,0,0
2020-03-05,Sierra,091,2930,0,0,0,0,0
2020-03-05,Siskiyou,093,43540,0,0,0,0,0
2020-03-05,Solano,095,438530,22,24,0,24,0
2020-03-05,Sonoma,097,501317,12,2,0,2,0
2020-03-05,Stanislaus,099,539301,4,0,2,2,0
2020-03-05,Sutter,101,95872,0,0,0,0,0
2020-03-05,Tehama,103,63373,0,0,0,0,0
2020-03-05,Trinity,105,12862,0,0,0,0,0
2020-03-05,Tulare,107,460477,6,0,0,0,0
2020-03-05,Tuolumne,109,53932,1,0,0,0,0
2020-03-05,Ventura,111,848112,13,0,0,0,0
2020-03-05,Yolo,113,214977,2,0,0,0,0
2020-03-05,Yuba,115,75493,0,0,0,0,0
2020-03-04,Alameda,001,1643700,30,2,0,2,0
2020-03-04,Alpine,003,1148,0,0,0,0,0
2020-03-04,Amador,005,37829,0,0,0,0,0
2020-03-04,Butte,007,227075,0,0,0,0,0
2020-03-04,Calaveras,009,45235,0,0,0,0,0
2020-03-04,Colusa,011,21464,0,0,0,0,0
2020-03-04,Contra Costa,013,1133247,34,1,0,1,0
2020-03-04,Del Norte,015,27424,0,0,0,0,0
2020-03-04,El Dorado,017,186661,1,0,0,0,0
2020-03-04,Fresno,019,978130,3,0,1,1,0
2020-03-04,Glenn,021,27897,0,0,0,0,0
2020-03-04,Humboldt,023,135768,1,1,0,1,0
2020-03-04,Imperial,025,180216,2,0,0,0,0
2020-03-04,Inyo,027,18085,0,0,0,0,0
2020-03-04,Kern,029,883053,6,0,0,0,0
2020-03-04,Kings,031,150075,3,0,1,1,0
2020-03-04,Lake,033,64148,0,0,0,0,0
2020-03-04,Lassen,035,31185,0,0,0,0,0
2020-03-04,Los Angeles,037,10098052,192,7,6,13,0
2020-03-04,Madera,039,155013,5,0,0,0,0
2020-03-04,Marin,041,260295,10,0,0,0,0
2020-03-04,Mariposa,043,17540,0,0,0,0,0
2020-03-04,Mendocino,045,87422,0,0,0,0,0
2020-03-04,Merced,047,269075,2,0,0,0,0
2020-03-04,Modoc,049,8938,0,0,0,0,0
2020-03-04,Mono,051,14174,1,0,0,0,0
2020-03-04,Monterey,053,433212,3,0,0,0,0
2020-03-04,Napa,055,140530,1,0,0,0,0
2020-03-04,Nevada,057,99092,0,0,1,1,0
2020-03-04,Orange,059,3164182,77,3,0,3,0
2020-03-04,Placer,061,380077,9,2,0,2,1
2020-03-04,Plumas,063,18699,0,0,0,0,0
2020-03-04,Riverside,065,2383286,23,0,1,1,0
2020-03-04,Sacramento,067,1510023,32,1,0,1,0
2020-03-04,San Benito,069,59416,1,2,0,2,0
2020-03-04,San Bernardino,071,2135413,32,0,0,0,0
2020-03-04,San Diego,073,3302833,41,2,0,2,0
2020-03-04,San Francisco,075,870044,26,0,0,0,0
2020-03-04,San Joaquin,077,732212,9,0,3,3,0
2020-03-04,San Luis Obispo,079,281455,4,0,0,0,0
2020-03-04,San Mateo,081,765935,60,1,0,1,0
2020-03-04,Santa Barbara,083,443738,2,0,0,0,0
2020-03-04,Santa Clara,085,1922200,147,12,1,13,0
2020-03-04,Santa Cruz,087,273765,13,0,0,0,0
2020-03-04,Shasta,089,179085,2,0,0,0,0
2020-03-04,Sierra,091,2930,0,0,0,0,0
2020-03-04,Siskiyou,093,43540,0,0,0,0,0
2020-03-04,Solano,095,438530,21,24,0,24,0
2020-03-04,Sonoma,097,501317,11,2,0,2,0
2020-03-04,Stanislaus,099,539301,4,0,2,2,0
2020-03-04,Sutter,101,95872,0,0,0,0,0
2020-03-04,Tehama,103,63373,0,0,0,0,0
2020-03-04,Trinity,105,12862,0,0,0,0,0
2020-03-04,Tulare,107,460477,6,0,0,0,0
2020-03-04,Tuolumne,109,53932,0,0,0,0,0
2020-03-04,Ventura,111,848112,12,0,0,0,0
2020-03-04,Yolo,113,214977,2,0,0,0,0
2020-03-04,Yuba,115,75493,0,0,0,0,0
2020-03-03,Alameda,001,1643700,24,2,0,2,0
2020-03-03,Alpine,003,1148,0,0,0,0,0
2020-03-03,Amador,005,37829,0,0,0,0,0
2020-03-03,Butte,007,227075,0,0,0,0,0
2020-03-03,Calaveras,009,45235,0,0,0,0,0
2020-03-03,Colusa,011,21464,0,0,0,0,0
2020-03-03,Contra Costa,013,1133247,30,0,0,0,0
2020-03-03,Del Norte,015,27424,0,0,0,0,0
2020-03-03,El Dorado,017,186661,1,0,0,0,0
2020-03-03,Fresno,019,978130,2,0,1,1,0
2020-03-03,Glenn,021,27897,0,0,0,0,0
2020-03-03,Humboldt,023,135768,1,1,0,1,0
2020-03-03,Imperial,025,180216,2,0,0,0,0
2020-03-03,Inyo,027,18085,0,0,0,0,0
2020-03-03,Kern,029,883053,4,0,0,0,0
2020-03-03,Kings,031,150075,3,0,1,1,0
2020-03-03,Lake,033,64148,0,0,0,0,0
2020-03-03,Lassen,035,31185,0,0,0,0,0
2020-03-03,Los Angeles,037,10098052,173,5,6,11,0
2020-03-03,Madera,039,155013,4,0,0,0,0
2020-03-03,Marin,041,260295,6,0,0,0,0
2020-03-03,Mariposa,043,17540,0,0,0,0,0
2020-03-03,Mendocino,045,87422,0,0,0,0,0
2020-03-03,Merced,047,269075,2,0,0,0,0
2020-03-03,Modoc,049,8938,0,0,0,0,0
2020-03-03,Mono,051,14174,1,0,0,0,0
2020-03-03,Monterey,053,433212,2,0,0,0,0
2020-03-03,Napa,055,140530,1,0,0,0,0
2020-03-03,Nevada,057,99092,0,0,1,1,0
2020-03-03,Orange,059,3164182,69,1,0,1,0
2020-03-03,Placer,061,380077,8,2,0,2,0
2020-03-03,Plumas,063,18699,0,0,0,0,0
2020-03-03,Riverside,065,2383286,20,0,1,1,0
2020-03-03,Sacramento,067,1510023,31,1,0,1,0
2020-03-03,San Benito,069,59416,1,2,0,2,0
2020-03-03,San Bernardino,071,2135413,29,0,0,0,0
2020-03-03,San Diego,073,3302833,34,2,0,2,0
2020-03-03,San Francisco,075,870044,24,0,0,0,0
2020-03-03,San Joaquin,077,732212,8,0,3,3,0
2020-03-03,San Luis Obispo,079,281455,2,0,0,0,0
2020-03-03,San Mateo,081,765935,53,1,0,1,0
2020-03-03,Santa Barbara,083,443738,1,0,0,0,0
2020-03-03,Santa Clara,085,1922200,132,11,1,12,0
2020-03-03,Santa Cruz,087,273765,10,0,0,0,0
2020-03-03,Shasta,089,179085,2,0,0,0,0
2020-03-03,Sierra,091,2930,0,0,0,0,0
2020-03-03,Siskiyou,093,43540,0,0,0,0,0
2020-03-03,Solano,095,438530,20,24,0,24,0
2020-03-03,Sonoma,097,501317,11,1,0,1,0
2020-03-03,Stanislaus,099,539301,4,0,2,2,0
2020-03-03,Sutter,101,95872,0,0,0,0,0
2020-03-03,Tehama,103,63373,0,0,0,0,0
2020-03-03,Trinity,105,12862,0,0,0,0,0
2020-03-03,Tulare,107,460477,6,0,0,0,0
2020-03-03,Tuolumne,109,53932,0,0,0,0,0
2020-03-03,Ventura,111,848112,11,0,0,0,0
2020-03-03,Yolo,113,214977,1,0,0,0,0
2020-03-03,Yuba,115,75493,0,0,0,0,0
2020-03-02,Alameda,001,1643700,21,1,0,1,0
2020-03-02,Alpine,003,1148,0,0,0,0,0
2020-03-02,Amador,005,37829,0,0,0,0,0
2020-03-02,Butte,007,227075,0,0,0,0,0
2020-03-02,Calaveras,009,45235,0,0,0,0,0
2020-03-02,Colusa,011,21464,0,0,0,0,0
2020-03-02,Contra Costa,013,1133247,27,0,0,0,0
2020-03-02,Del Norte,015,27424,0,0,0,0,0
2020-03-02,El Dorado,017,186661,1,0,0,0,0
2020-03-02,Fresno,019,978130,2,0,1,1,0
2020-03-02,Glenn,021,27897,0,0,0,0,0
2020-03-02,Humboldt,023,135768,1,1,0,1,0
2020-03-02,Imperial,025,180216,2,0,0,0,0
2020-03-02,Inyo,027,18085,0,0,0,0,0
2020-03-02,Kern,029,883053,4,0,0,0,0
2020-03-02,Kings,031,150075,3,0,1,1,0
2020-03-02,Lake,033,64148,0,0,0,0,0
2020-03-02,Lassen,035,31185,0,0,0,0,0
2020-03-02,Los Angeles,037,10098052,158,1,6,7,0
2020-03-02,Madera,039,155013,4,0,0,0,0
2020-03-02,Marin,041,260295,6,0,0,0,0
2020-03-02,Mariposa,043,17540,0,0,0,0,0
2020-03-02,Mendocino,045,87422,0,0,0,0,0
2020-03-02,Merced,047,269075,1,0,0,0,0
2020-03-02,Modoc,049,8938,0,0,0,0,0
2020-03-02,Mono,051,14174,1,0,0,0,0
2020-03-02,Monterey,053,433212,2,0,0,0,0
2020-03-02,Napa,055,140530,1,0,0,0,0
2020-03-02,Nevada,057,99092,0,0,1,1,0
2020-03-02,Orange,059,3164182,64,1,0,1,0
2020-03-02,Placer,061,380077,8,1,0,1,0
2020-03-02,Plumas,063,18699,0,0,0,0,0
2020-03-02,Riverside,065,2383286,19,0,1,1,0
2020-03-02,Sacramento,067,1510023,25,1,0,1,0
2020-03-02,San Benito,069,59416,1,2,0,2,0
2020-03-02,San Bernardino,071,2135413,29,0,0,0,0
2020-03-02,San Diego,073,3302833,28,2,0,2,0
2020-03-02,San Francisco,075,870044,17,0,0,0,0
2020-03-02,San Joaquin,077,732212,7,0,3,3,0
2020-03-02,San Luis Obispo,079,281455,2,0,0,0,0
2020-03-02,San Mateo,081,765935,44,1,0,1,0
2020-03-02,Santa Barbara,083,443738,1,0,0,0,0
2020-03-02,Santa Clara,085,1922200,110,7,1,8,0
2020-03-02,Santa Cruz,087,273765,9,0,0,0,0
2020-03-02,Shasta,089,179085,2,0,0,0,0
2020-03-02,Sierra,091,2930,0,0,0,0,0
2020-03-02,Siskiyou,093,43540,0,0,0,0,0
2020-03-02,Solano,095,438530,19,24,0,24,0
2020-03-02,Sonoma,097,501317,10,1,0,1,0
2020-03-02,Stanislaus,099,539301,2,0,2,2,0
2020-03-02,Sutter,101,95872,0,0,0,0,0
2020-03-02,Tehama,103,63373,0,0,0,0,0
2020-03-02,Trinity,105,12862,0,0,0,0,0
2020-03-02,Tulare,107,460477,6,0,0,0,0
2020-03-02,Tuolumne,109,53932,0,0,0,0,0
2020-03-02,Ventura,111,848112,10,0,0,0,0
2020-03-02,Yolo,113,214977,1,0,0,0,0
2020-03-02,Yuba,115,75493,0,0,0,0,0
2020-03-01,Alameda,001,1643700,20,1,0,1,0
2020-03-01,Alpine,003,1148,0,0,0,0,0
2020-03-01,Amador,005,37829,0,0,0,0,0
2020-03-01,Butte,007,227075,0,0,0,0,0
2020-03-01,Calaveras,009,45235,0,0,0,0,0
2020-03-01,Colusa,011,21464,0,0,0,0,0
2020-03-01,Contra Costa,013,1133247,24,0,0,0,0
2020-03-01,Del Norte,015,27424,0,0,0,0,0
2020-03-01,El Dorado,017,186661,1,0,0,0,0
2020-03-01,Fresno,019,978130,1,0,1,1,0
2020-03-01,Glenn,021,27897,0,0,0,0,0
2020-03-01,Humboldt,023,135768,1,1,0,1,0
2020-03-01,Imperial,025,180216,2,0,0,0,0
2020-03-01,Inyo,027,18085,0,0,0,0,0
2020-03-01,Kern,029,883053,2,0,0,0,0
2020-03-01,Kings,031,150075,3,0,1,1,0
2020-03-01,Lake,033,64148,0,0,0,0,0
2020-03-01,Lassen,035,31185,0,0,0,0,0
2020-03-01,Los Angeles,037,10098052,139,1,6,7,0
2020-03-01,Madera,039,155013,2,0,0,0,0
2020-03-01,Marin,041,260295,5,0,0,0,0
2020-03-01,Mariposa,043,17540,0,0,0,0,0
2020-03-01,Mendocino,045,87422,0,0,0,0,0
2020-03-01,Merced,047,269075,1,0,0,0,0
2020-03-01,Modoc,049,8938,0,0,0,0,0
2020-03-01,Mono,051,14174,1,0,0,0,0
2020-03-01,Monterey,053,433212,1,0,0,0,0
2020-03-01,Napa,055,140530,1,0,0,0,0
2020-03-01,Nevada,057,99092,0,0,1,1,0
2020-03-01,Orange,059,3164182,61,1,0,1,0
2020-03-01,Placer,061,380077,8,0,0,0,0
2020-03-01,Plumas,063,18699,0,0,0,0,0
2020-03-01,Riverside,065,2383286,18,0,1,1,0
2020-03-01,Sacramento,067,1510023,21,1,0,1,0
2020-03-01,San Benito,069,59416,0,2,0,2,0
2020-03-01,San Bernardino,071,2135413,27,0,0,0,0
2020-03-01,San Diego,073,3302833,21,2,0,2,0
2020-03-01,San Francisco,075,870044,13,0,0,0,0
2020-03-01,San Joaquin,077,732212,7,0,3,3,0
2020-03-01,San Luis Obispo,079,281455,2,0,0,0,0
2020-03-01,San Mateo,081,765935,36,0,0,0,0
2020-03-01,Santa Barbara,083,443738,1,0,0,0,0
2020-03-01,Santa Clara,085,1922200,97,6,1,7,0
2020-03-01,Santa Cruz,087,273765,8,0,0,0,0
2020-03-01,Shasta,089,179085,2,0,0,0,0
2020-03-01,Sierra,091,2930,0,0,0,0,0
2020-03-01,Siskiyou,093,43540,0,0,0,0,0
2020-03-01,Solano,095,438530,19,24,0,24,0
2020-03-01,Sonoma,097,501317,9,0,0,0,0
2020-03-01,Stanislaus,099,539301,2,0,2,2,0
2020-03-01,Sutter,101,95872,0,0,0,0,0
2020-03-01,Tehama,103,63373,0,0,0,0,0
2020-03-01,Trinity,105,12862,0,0,0,0,0
2020-03-01,Tulare,107,460477,6,0,0,0,0
2020-03-01,Tuolumne,109,53932,0,0,0,0,0
2020-03-01,Ventura,111,848112,8,0,0,0,0
2020-03-01,Yolo,113,214977,1,0,0,0,0
2020-03-01,Yuba,115,75493,0,0,0,0,0
2020-02-29,Alameda,001,1643700,16,0,0,0,0
2020-02-29,Alpine,003,1148,0,0,0,0,0
2020-02-29,Amador,005,37829,0,0,0,0,0
2020-02-29,Butte,007,227075,0,0,0,0,0
2020-02-29,Calaveras,009,45235,0,0,0,0,0
2020-02-29,Colusa,011,21464,0,0,0,0,0
2020-02-29,Contra Costa,013,1133247,20,0,0,0,0
2020-02-29,Del Norte,015,27424,0,0,0,0,0
2020-02-29,El Dorado,017,186661,1,0,0,0,0
2020-02-29,Fresno,019,978130,1,0,0,0,0
2020-02-29,Glenn,021,27897,0,0,0,0,0
2020-02-29,Humboldt,023,135768,1,1,0,1,0
2020-02-29,Imperial,025,180216,1,0,0,0,0
2020-02-29,Inyo,027,18085,0,0,0,0,0
2020-02-29,Kern,029,883053,2,0,0,0,0
2020-02-29,Kings,031,150075,3,0,1,1,0
2020-02-29,Lake,033,64148,0,0,0,0,0
2020-02-29,Lassen,035,31185,0,0,0,0,0
2020-02-29,Los Angeles,037,10098052,111,1,6,7,0
2020-02-29,Madera,039,155013,2,0,0,0,0
2020-02-29,Marin,041,260295,4,0,0,0,0
2020-02-29,Mariposa,043,17540,0,0,0,0,0
2020-02-29,Mendocino,045,87422,0,0,0,0,0
2020-02-29,Merced,047,269075,1,0,0,0,0
2020-02-29,Modoc,049,8938,0,0,0,0,0
2020-02-29,Mono,051,14174,1,0,0,0,0
2020-02-29,Monterey,053,433212,1,0,0,0,0
2020-02-29,Napa,055,140530,1,0,0,0,0
2020-02-29,Nevada,057,99092,0,0,1,1,0
2020-02-29,Orange,059,3164182,56,1,0,1,0
2020-02-29,Placer,061,380077,7,0,0,0,0
2020-02-29,Plumas,063,18699,0,0,0,0,0
2020-02-29,Riverside,065,2383286,15,0,1,1,0
2020-02-29,Sacramento,067,1510023,16,1,0,1,0
2020-02-29,San Benito,069,59416,0,2,0,2,0
2020-02-29,San Bernardino,071,2135413,25,0,0,0,0
2020-02-29,San Diego,073,3302833,16,2,0,2,0
2020-02-29,San Francisco,075,870044,12,0,0,0,0
2020-02-29,San Joaquin,077,732212,6,0,3,3,0
2020-02-29,San Luis Obispo,079,281455,2,0,0,0,0
2020-02-29,San Mateo,081,765935,29,0,0,0,0
2020-02-29,Santa Barbara,083,443738,0,0,0,0,0
2020-02-29,Santa Clara,085,1922200,75,3,1,4,0
2020-02-29,Santa Cruz,087,273765,8,0,0,0,0
2020-02-29,Shasta,089,179085,2,0,0,0,0
2020-02-29,Sierra,091,2930,0,0,0,0,0
2020-02-29,Siskiyou,093,43540,0,0,0,0,0
2020-02-29,Solano,095,438530,18,23,0,23,0
2020-02-29,Sonoma,097,501317,6,0,0,0,0
2020-02-29,Stanislaus,099,539301,2,0,2,2,0
2020-02-29,Sutter,101,95872,0,0,0,0,0
2020-02-29,Tehama,103,63373,0,0,0,0,0
2020-02-29,Trinity,105,12862,0,0,0,0,0
2020-02-29,Tulare,107,460477,4,0,0,0,0
2020-02-29,Tuolumne,109,53932,0,0,0,0,0
2020-02-29,Ventura,111,848112,6,0,0,0,0
2020-02-29,Yolo,113,214977,1,0,0,0,0
2020-02-29,Yuba,115,75493,0,0,0,0,0
2020-02-28,Alameda,001,1643700,14,0,0,0,0
2020-02-28,Alpine,003,1148,0,0,0,0,0
2020-02-28,Amador,005,37829,0,0,0,0,0
2020-02-28,Butte,007,227075,0,0,0,0,0
2020-02-28,Calaveras,009,45235,0,0,0,0,0
2020-02-28,Colusa,011,21464,0,0,0,0,0
2020-02-28,Contra Costa,013,1133247,20,0,0,0,0
2020-02-28,Del Norte,015,27424,0,0,0,0,0
2020-02-28,El Dorado,017,186661,0,0,0,0,0
2020-02-28,Fresno,019,978130,1,0,0,0,0
2020-02-28,Glenn,021,27897,0,0,0,0,0
2020-02-28,Humboldt,023,135768,1,1,0,1,0
2020-02-28,Imperial,025,180216,1,0,0,0,0
2020-02-28,Inyo,027,18085,0,0,0,0,0
2020-02-28,Kern,029,883053,2,0,0,0,0
2020-02-28,Kings,031,150075,3,0,1,1,0
2020-02-28,Lake,033,64148,0,0,0,0,0
2020-02-28,Lassen,035,31185,0,0,0,0,0
2020-02-28,Los Angeles,037,10098052,103,1,6,7,0
2020-02-28,Madera,039,155013,2,0,0,0,0
2020-02-28,Marin,041,260295,2,0,0,0,0
2020-02-28,Mariposa,043,17540,0,0,0,0,0
2020-02-28,Mendocino,045,87422,0,0,0,0,0
2020-02-28,Merced,047,269075,1,0,0,0,0
2020-02-28,Modoc,049,8938,0,0,0,0,0
2020-02-28,Mono,051,14174,0,0,0,0,0
2020-02-28,Monterey,053,433212,1,0,0,0,0
2020-02-28,Napa,055,140530,1,0,0,0,0
2020-02-28,Nevada,057,99092,0,0,1,1,0
2020-02-28,Orange,059,3164182,54,1,0,1,0
2020-02-28,Placer,061,380077,7,0,0,0,0
2020-02-28,Plumas,063,18699,0,0,0,0,0
2020-02-28,Riverside,065,2383286,13,0,1,1,0
2020-02-28,Sacramento,067,1510023,10,1,0,1,0
2020-02-28,San Benito,069,59416,0,2,0,2,0
2020-02-28,San Bernardino,071,2135413,25,0,0,0,0
2020-02-28,San Diego,073,3302833,13,2,0,2,0
2020-02-28,San Francisco,075,870044,10,0,0,0,0
2020-02-28,San Joaquin,077,732212,6,0,3,3,0
2020-02-28,San Luis Obispo,079,281455,2,0,0,0,0
2020-02-28,San Mateo,081,765935,24,0,0,0,0
2020-02-28,Santa Barbara,083,443738,0,0,0,0,0
2020-02-28,Santa Clara,085,1922200,70,3,1,4,0
2020-02-28,Santa Cruz,087,273765,8,0,0,0,0
2020-02-28,Shasta,089,179085,2,0,0,0,0
2020-02-28,Sierra,091,2930,0,0,0,0,0
2020-02-28,Siskiyou,093,43540,0,0,0,0,0
2020-02-28,Solano,095,438530,17,23,0,23,0
2020-02-28,Sonoma,097,501317,6,0,0,0,0
2020-02-28,Stanislaus,099,539301,2,0,2,2,0
2020-02-28,Sutter,101,95872,0,0,0,0,0
2020-02-28,Tehama,103,63373,0,0,0,0,0
2020-02-28,Trinity,105,12862,0,0,0,0,0
2020-02-28,Tulare,107,460477,3,0,0,0,0
2020-02-28,Tuolumne,109,53932,0,0,0,0,0
2020-02-28,Ventura,111,848112,6,0,0,0,0
2020-02-28,Yolo,113,214977,1,0,0,0,0
2020-02-28,Yuba,115,75493,0,0,0,0,0
2020-02-27,Alameda,001,1643700,13,0,0,0,0
2020-02-27,Alpine,003,1148,0,0,0,0,0
2020-02-27,Amador,005,37829,0,0,0,0,0
2020-02-27,Butte,007,227075,0,0,0,0,0
2020-02-27,Calaveras,009,45235,0,0,0,0,0
2020-02-27,Colusa,011,21464,0,0,0,0,0
2020-02-27,Contra Costa,013,1133247,14,0,0,0,0
2020-02-27,Del Norte,015,27424,0,0,0,0,0
2020-02-27,El Dorado,017,186661,0,0,0,0,0
2020-02-27,Fresno,019,978130,1,0,0,0,0
2020-02-27,Glenn,021,27897,0,0,0,0,0
2020-02-27,Humboldt,023,135768,1,1,0,1,0
2020-02-27,Imperial,025,180216,1,0,0,0,0
2020-02-27,Inyo,027,18085,0,0,0,0,0
2020-02-27,Kern,029,883053,2,0,0,0,0
2020-02-27,Kings,031,150075,3,0,1,1,0
2020-02-27,Lake,033,64148,0,0,0,0,0
2020-02-27,Lassen,035,31185,0,0,0,0,0
2020-02-27,Los Angeles,037,10098052,95,1,6,7,0
2020-02-27,Madera,039,155013,2,0,0,0,0
2020-02-27,Marin,041,260295,1,0,0,0,0
2020-02-27,Mariposa,043,17540,0,0,0,0,0
2020-02-27,Mendocino,045,87422,0,0,0,0,0
2020-02-27,Merced,047,269075,1,0,0,0,0
2020-02-27,Modoc,049,8938,0,0,0,0,0
2020-02-27,Mono,051,14174,0,0,0,0,0
2020-02-27,Monterey,053,433212,1,0,0,0,0
2020-02-27,Napa,055,140530,1,0,0,0,0
2020-02-27,Nevada,057,99092,0,0,1,1,0
2020-02-27,Orange,059,3164182,48,1,0,1,0
2020-02-27,Placer,061,380077,6,0,0,0,0
2020-02-27,Plumas,063,18699,0,0,0,0,0
2020-02-27,Riverside,065,2383286,12,0,1,1,0
2020-02-27,Sacramento,067,1510023,10,1,0,1,0
2020-02-27,San Benito,069,59416,0,2,0,2,0
2020-02-27,San Bernardino,071,2135413,25,0,0,0,0
2020-02-27,San Diego,073,3302833,12,2,0,2,0
2020-02-27,San Francisco,075,870044,9,0,0,0,0
2020-02-27,San Joaquin,077,732212,5,0,3,3,0
2020-02-27,San Luis Obispo,079,281455,2,0,0,0,0
2020-02-27,San Mateo,081,765935,20,0,0,0,0
2020-02-27,Santa Barbara,083,443738,0,0,0,0,0
2020-02-27,Santa Clara,085,1922200,59,2,1,3,0
2020-02-27,Santa Cruz,087,273765,6,0,0,0,0
2020-02-27,Shasta,089,179085,0,0,0,0,0
2020-02-27,Sierra,091,2930,0,0,0,0,0
2020-02-27,Siskiyou,093,43540,0,0,0,0,0
2020-02-27,Solano,095,438530,17,23,0,23,0
2020-02-27,Sonoma,097,501317,5,0,0,0,0
2020-02-27,Stanislaus,099,539301,2,0,2,2,0
2020-02-27,Sutter,101,95872,0,0,0,0,0
2020-02-27,Tehama,103,63373,0,0,0,0,0
2020-02-27,Trinity,105,12862,0,0,0,0,0
2020-02-27,Tulare,107,460477,3,0,0,0,0
2020-02-27,Tuolumne,109,53932,0,0,0,0,0
2020-02-27,Ventura,111,848112,4,0,0,0,0
2020-02-27,Yolo,113,214977,1,0,0,0,0
2020-02-27,Yuba,115,75493,0,0,0,0,0
2020-02-26,Alameda,001,1643700,13,0,0,0,0
2020-02-26,Alpine,003,1148,0,0,0,0,0
2020-02-26,Amador,005,37829,0,0,0,0,0
2020-02-26,Butte,007,227075,0,0,0,0,0
2020-02-26,Calaveras,009,45235,0,0,0,0,0
2020-02-26,Colusa,011,21464,0,0,0,0,0
2020-02-26,Contra Costa,013,1133247,13,0,0,0,0
2020-02-26,Del Norte,015,27424,0,0,0,0,0
2020-02-26,El Dorado,017,186661,0,0,0,0,0
2020-02-26,Fresno,019,978130,1,0,0,0,0
2020-02-26,Glenn,021,27897,0,0,0,0,0
2020-02-26,Humboldt,023,135768,1,1,0,1,0
2020-02-26,Imperial,025,180216,1,0,0,0,0
2020-02-26,Inyo,027,18085,0,0,0,0,0
2020-02-26,Kern,029,883053,2,0,0,0,0
2020-02-26,Kings,031,150075,3,0,1,1,0
2020-02-26,Lake,033,64148,0,0,0,0,0
2020-02-26,Lassen,035,31185,0,0,0,0,0
2020-02-26,Los Angeles,037,10098052,89,1,6,7,0
2020-02-26,Madera,039,155013,2,0,0,0,0
2020-02-26,Marin,041,260295,1,0,0,0,0
2020-02-26,Mariposa,043,17540,0,0,0,0,0
2020-02-26,Mendocino,045,87422,0,0,0,0,0
2020-02-26,Merced,047,269075,1,0,0,0,0
2020-02-26,Modoc,049,8938,0,0,0,0,0
2020-02-26,Mono,051,14174,0,0,0,0,0
2020-02-26,Monterey,053,433212,1,0,0,0,0
2020-02-26,Napa,055,140530,0,0,0,0,0
2020-02-26,Nevada,057,99092,0,0,1,1,0
2020-02-26,Orange,059,3164182,47,1,0,1,0
2020-02-26,Placer,061,380077,5,0,0,0,0
2020-02-26,Plumas,063,18699,0,0,0,0,0
2020-02-26,Riverside,065,2383286,10,0,1,1,0
2020-02-26,Sacramento,067,1510023,10,1,0,1,0
2020-02-26,San Benito,069,59416,0,2,0,2,0
2020-02-26,San Bernardino,071,2135413,23,0,0,0,0
2020-02-26,San Diego,073,3302833,11,2,0,2,0
2020-02-26,San Francisco,075,870044,9,0,0,0,0
2020-02-26,San Joaquin,077,732212,5,0,3,3,0
2020-02-26,San Luis Obispo,079,281455,2,0,0,0,0
2020-02-26,San Mateo,081,765935,18,0,0,0,0
2020-02-26,Santa Barbara,083,443738,0,0,0,0,0
2020-02-26,Santa Clara,085,1922200,50,2,1,3,0
2020-02-26,Santa Cruz,087,273765,6,0,0,0,0
2020-02-26,Shasta,089,179085,0,0,0,0,0
2020-02-26,Sierra,091,2930,0,0,0,0,0
2020-02-26,Siskiyou,093,43540,0,0,0,0,0
2020-02-26,Solano,095,438530,17,23,0,23,0
2020-02-26,Sonoma,097,501317,5,0,0,0,0
2020-02-26,Stanislaus,099,539301,2,0,2,2,0
2020-02-26,Sutter,101,95872,0,0,0,0,0
2020-02-26,Tehama,103,63373,0,0,0,0,0
2020-02-26,Trinity,105,12862,0,0,0,0,0
2020-02-26,Tulare,107,460477,3,0,0,0,0
2020-02-26,Tuolumne,109,53932,0,0,0,0,0
2020-02-26,Ventura,111,848112,4,0,0,0,0
2020-02-26,Yolo,113,214977,1,0,0,0,0
2020-02-26,Yuba,115,75493,0,0,0,0,0
2020-02-25,Alameda,001,1643700,13,0,0,0,0
2020-02-25,Alpine,003,1148,0,0,0,0,0
2020-02-25,Amador,005,37829,0,0,0,0,0
2020-02-25,Butte,007,227075,0,0,0,0,0
2020-02-25,Calaveras,009,45235,0,0,0,0,0
2020-02-25,Colusa,011,21464,0,0,0,0,0
2020-02-25,Contra Costa,013,1133247,11,0,0,0,0
2020-02-25,Del Norte,015,27424,0,0,0,0,0
2020-02-25,El Dorado,017,186661,0,0,0,0,0
2020-02-25,Fresno,019,978130,1,0,0,0,0
2020-02-25,Glenn,021,27897,0,0,0,0,0
2020-02-25,Humboldt,023,135768,1,1,0,1,0
2020-02-25,Imperial,025,180216,1,0,0,0,0
2020-02-25,Inyo,027,18085,0,0,0,0,0
2020-02-25,Kern,029,883053,2,0,0,0,0
2020-02-25,Kings,031,150075,3,0,1,1,0
2020-02-25,Lake,033,64148,0,0,0,0,0
2020-02-25,Lassen,035,31185,0,0,0,0,0
2020-02-25,Los Angeles,037,10098052,77,1,6,7,0
2020-02-25,Madera,039,155013,2,0,0,0,0
2020-02-25,Marin,041,260295,1,0,0,0,0
2020-02-25,Mariposa,043,17540,0,0,0,0,0
2020-02-25,Mendocino,045,87422,0,0,0,0,0
2020-02-25,Merced,047,269075,0,0,0,0,0
2020-02-25,Modoc,049,8938,0,0,0,0,0
2020-02-25,Mono,051,14174,0,0,0,0,0
2020-02-25,Monterey,053,433212,1,0,0,0,0
2020-02-25,Napa,055,140530,0,0,0,0,0
2020-02-25,Nevada,057,99092,0,0,1,1,0
2020-02-25,Orange,059,3164182,46,1,0,1,0
2020-02-25,Placer,061,380077,5,0,0,0,0
2020-02-25,Plumas,063,18699,0,0,0,0,0
2020-02-25,Riverside,065,2383286,10,0,1,1,0
2020-02-25,Sacramento,067,1510023,8,1,0,1,0
2020-02-25,San Benito,069,59416,0,2,0,2,0
2020-02-25,San Bernardino,071,2135413,21,0,0,0,0
2020-02-25,San Diego,073,3302833,7,2,0,2,0
2020-02-25,San Francisco,075,870044,7,0,0,0,0
2020-02-25,San Joaquin,077,732212,5,0,2,2,0
2020-02-25,San Luis Obispo,079,281455,2,0,0,0,0
2020-02-25,San Mateo,081,765935,17,0,0,0,0
2020-02-25,Santa Barbara,083,443738,0,0,0,0,0
2020-02-25,Santa Clara,085,1922200,40,2,1,3,0
2020-02-25,Santa Cruz,087,273765,5,0,0,0,0
2020-02-25,Shasta,089,179085,0,0,0,0,0
2020-02-25,Sierra,091,2930,0,0,0,0,0
2020-02-25,Siskiyou,093,43540,0,0,0,0,0
2020-02-25,Solano,095,438530,16,21,0,21,0
2020-02-25,Sonoma,097,501317,5,0,0,0,0
2020-02-25,Stanislaus,099,539301,2,0,2,2,0
2020-02-25,Sutter,101,95872,0,0,0,0,0
2020-02-25,Tehama,103,63373,0,0,0,0,0
2020-02-25,Trinity,105,12862,0,0,0,0,0
2020-02-25,Tulare,107,460477,3,0,0,0,0
2020-02-25,Tuolumne,109,53932,0,0,0,0,0
2020-02-25,Ventura,111,848112,4,0,0,0,0
2020-02-25,Yolo,113,214977,1,0,0,0,0
2020-02-25,Yuba,115,75493,0,0,0,0,0
2020-02-24,Alameda,001,1643700,13,0,0,0,0
2020-02-24,Alpine,003,1148,0,0,0,0,0
2020-02-24,Amador,005,37829,0,0,0,0,0
2020-02-24,Butte,007,227075,0,0,0,0,0
2020-02-24,Calaveras,009,45235,0,0,0,0,0
2020-02-24,Colusa,011,21464,0,0,0,0,0
2020-02-24,Contra Costa,013,1133247,9,0,0,0,0
2020-02-24,Del Norte,015,27424,0,0,0,0,0
2020-02-24,El Dorado,017,186661,0,0,0,0,0
2020-02-24,Fresno,019,978130,1,0,0,0,0
2020-02-24,Glenn,021,27897,0,0,0,0,0
2020-02-24,Humboldt,023,135768,1,1,0,1,0
2020-02-24,Imperial,025,180216,1,0,0,0,0
2020-02-24,Inyo,027,18085,0,0,0,0,0
2020-02-24,Kern,029,883053,2,0,0,0,0
2020-02-24,Kings,031,150075,3,0,1,1,0
2020-02-24,Lake,033,64148,0,0,0,0,0
2020-02-24,Lassen,035,31185,0,0,0,0,0
2020-02-24,Los Angeles,037,10098052,72,1,6,7,0
2020-02-24,Madera,039,155013,1,0,0,0,0
2020-02-24,Marin,041,260295,1,0,0,0,0
2020-02-24,Mariposa,043,17540,0,0,0,0,0
2020-02-24,Mendocino,045,87422,0,0,0,0,0
2020-02-24,Merced,047,269075,0,0,0,0,0
2020-02-24,Modoc,049,8938,0,0,0,0,0
2020-02-24,Mono,051,14174,0,0,0,0,0
2020-02-24,Monterey,053,433212,1,0,0,0,0
2020-02-24,Napa,055,140530,0,0,0,0,0
2020-02-24,Nevada,057,99092,0,0,1,1,0
2020-02-24,Orange,059,3164182,44,1,0,1,0
2020-02-24,Placer,061,380077,3,0,0,0,0
2020-02-24,Plumas,063,18699,0,0,0,0,0
2020-02-24,Riverside,065,2383286,9,0,1,1,0
2020-02-24,Sacramento,067,1510023,7,1,0,1,0
2020-02-24,San Benito,069,59416,0,2,0,2,0
2020-02-24,San Bernardino,071,2135413,21,0,0,0,0
2020-02-24,San Diego,073,3302833,7,2,0,2,0
2020-02-24,San Francisco,075,870044,6,0,0,0,0
2020-02-24,San Joaquin,077,732212,5,0,1,1,0
2020-02-24,San Luis Obispo,079,281455,2,0,0,0,0
2020-02-24,San Mateo,081,765935,13,0,0,0,0
2020-02-24,Santa Barbara,083,443738,0,0,0,0,0
2020-02-24,Santa Clara,085,1922200,38,2,1,3,0
2020-02-24,Santa Cruz,087,273765,5,0,0,0,0
2020-02-24,Shasta,089,179085,0,0,0,0,0
2020-02-24,Sierra,091,2930,0,0,0,0,0
2020-02-24,Siskiyou,093,43540,0,0,0,0,0
2020-02-24,Solano,095,438530,13,15,0,15,0
2020-02-24,Sonoma,097,501317,5,0,0,0,0
2020-02-24,Stanislaus,099,539301,2,0,2,2,0
2020-02-24,Sutter,101,95872,0,0,0,0,0
2020-02-24,Tehama,103,63373,0,0,0,0,0
2020-02-24,Trinity,105,12862,0,0,0,0,0
2020-02-24,Tulare,107,460477,3,0,0,0,0
2020-02-24,Tuolumne,109,53932,0,0,0,0,0
2020-02-24,Ventura,111,848112,4,0,0,0,0
2020-02-24,Yolo,113,214977,1,0,0,0,0
2020-02-24,Yuba,115,75493,0,0,0,0,0
2020-02-23,Alameda,001,1643700,11,0,0,0,0
2020-02-23,Alpine,003,1148,0,0,0,0,0
2020-02-23,Amador,005,37829,0,0,0,0,0
2020-02-23,Butte,007,227075,0,0,0,0,0
2020-02-23,Calaveras,009,45235,0,0,0,0,0
2020-02-23,Colusa,011,21464,0,0,0,0,0
2020-02-23,Contra Costa,013,1133247,6,0,0,0,0
2020-02-23,Del Norte,015,27424,0,0,0,0,0
2020-02-23,El Dorado,017,186661,0,0,0,0,0
2020-02-23,Fresno,019,978130,1,0,0,0,0
2020-02-23,Glenn,021,27897,0,0,0,0,0
2020-02-23,Humboldt,023,135768,1,1,0,1,0
2020-02-23,Imperial,025,180216,1,0,0,0,0
2020-02-23,Inyo,027,18085,0,0,0,0,0
2020-02-23,Kern,029,883053,2,0,0,0,0
2020-02-23,Kings,031,150075,3,0,1,1,0
2020-02-23,Lake,033,64148,0,0,0,0,0
2020-02-23,Lassen,035,31185,0,0,0,0,0
2020-02-23,Los Angeles,037,10098052,64,1,6,7,0
2020-02-23,Madera,039,155013,1,0,0,0,0
2020-02-23,Marin,041,260295,1,0,0,0,0
2020-02-23,Mariposa,043,17540,0,0,0,0,0
2020-02-23,Mendocino,045,87422,0,0,0,0,0
2020-02-23,Merced,047,269075,0,0,0,0,0
2020-02-23,Modoc,049,8938,0,0,0,0,0
2020-02-23,Mono,051,14174,0,0,0,0,0
2020-02-23,Monterey,053,433212,1,0,0,0,0
2020-02-23,Napa,055,140530,0,0,0,0,0
2020-02-23,Nevada,057,99092,0,0,1,1,0
2020-02-23,Orange,059,3164182,44,1,0,1,0
2020-02-23,Placer,061,380077,3,0,0,0,0
2020-02-23,Plumas,063,18699,0,0,0,0,0
2020-02-23,Riverside,065,2383286,9,0,0,0,0
2020-02-23,Sacramento,067,1510023,6,1,0,1,0
2020-02-23,San Benito,069,59416,0,2,0,2,0
2020-02-23,San Bernardino,071,2135413,20,0,0,0,0
2020-02-23,San Diego,073,3302833,6,2,0,2,0
2020-02-23,San Francisco,075,870044,5,0,0,0,0
2020-02-23,San Joaquin,077,732212,4,0,1,1,0
2020-02-23,San Luis Obispo,079,281455,2,0,0,0,0
2020-02-23,San Mateo,081,765935,10,0,0,0,0
2020-02-23,Santa Barbara,083,443738,0,0,0,0,0
2020-02-23,Santa Clara,085,1922200,26,2,1,3,0
2020-02-23,Santa Cruz,087,273765,2,0,0,0,0
2020-02-23,Shasta,089,179085,0,0,0,0,0
2020-02-23,Sierra,091,2930,0,0,0,0,0
2020-02-23,Siskiyou,093,43540,0,0,0,0,0
2020-02-23,Solano,095,438530,11,15,0,15,0
2020-02-23,Sonoma,097,501317,5,0,0,0,0
2020-02-23,Stanislaus,099,539301,2,0,2,2,0
2020-02-23,Sutter,101,95872,0,0,0,0,0
2020-02-23,Tehama,103,63373,0,0,0,0,0
2020-02-23,Trinity,105,12862,0,0,0,0,0
2020-02-23,Tulare,107,460477,2,0,0,0,0
2020-02-23,Tuolumne,109,53932,0,0,0,0,0
2020-02-23,Ventura,111,848112,4,0,0,0,0
2020-02-23,Yolo,113,214977,1,0,0,0,0
2020-02-23,Yuba,115,75493,0,0,0,0,0
2020-02-22,Alameda,001,1643700,10,0,0,0,0
2020-02-22,Alpine,003,1148,0,0,0,0,0
2020-02-22,Amador,005,37829,0,0,0,0,0
2020-02-22,Butte,007,227075,0,0,0,0,0
2020-02-22,Calaveras,009,45235,0,0,0,0,0
2020-02-22,Colusa,011,21464,0,0,0,0,0
2020-02-22,Contra Costa,013,1133247,5,0,0,0,0
2020-02-22,Del Norte,015,27424,0,0,0,0,0
2020-02-22,El Dorado,017,186661,0,0,0,0,0
2020-02-22,Fresno,019,978130,1,0,0,0,0
2020-02-22,Glenn,021,27897,0,0,0,0,0
2020-02-22,Humboldt,023,135768,1,1,0,1,0
2020-02-22,Imperial,025,180216,0,0,0,0,0
2020-02-22,Inyo,027,18085,0,0,0,0,0
2020-02-22,Kern,029,883053,2,0,0,0,0
2020-02-22,Kings,031,150075,3,0,1,1,0
2020-02-22,Lake,033,64148,0,0,0,0,0
2020-02-22,Lassen,035,31185,0,0,0,0,0
2020-02-22,Los Angeles,037,10098052,62,1,6,7,0
2020-02-22,Madera,039,155013,0,0,0,0,0
2020-02-22,Marin,041,260295,1,0,0,0,0
2020-02-22,Mariposa,043,17540,0,0,0,0,0
2020-02-22,Mendocino,045,87422,0,0,0,0,0
2020-02-22,Merced,047,269075,0,0,0,0,0
2020-02-22,Modoc,049,8938,0,0,0,0,0
2020-02-22,Mono,051,14174,0,0,0,0,0
2020-02-22,Monterey,053,433212,1,0,0,0,0
2020-02-22,Napa,055,140530,0,0,0,0,0
2020-02-22,Nevada,057,99092,0,0,1,1,0
2020-02-22,Orange,059,3164182,43,1,0,1,0
2020-02-22,Placer,061,380077,3,0,0,0,0
2020-02-22,Plumas,063,18699,0,0,0,0,0
2020-02-22,Riverside,065,2383286,9,0,0,0,0
2020-02-22,Sacramento,067,1510023,6,1,0,1,0
2020-02-22,San Benito,069,59416,0,2,0,2,0
2020-02-22,San Bernardino,071,2135413,18,0,0,0,0
2020-02-22,San Diego,073,3302833,5,2,0,2,0
2020-02-22,San Francisco,075,870044,3,0,0,0,0
2020-02-22,San Joaquin,077,732212,4,0,1,1,0
2020-02-22,San Luis Obispo,079,281455,2,0,0,0,0
2020-02-22,San Mateo,081,765935,8,0,0,0,0
2020-02-22,Santa Barbara,083,443738,0,0,0,0,0
2020-02-22,Santa Clara,085,1922200,23,2,1,3,0
2020-02-22,Santa Cruz,087,273765,2,0,0,0,0
2020-02-22,Shasta,089,179085,0,0,0,0,0
2020-02-22,Sierra,091,2930,0,0,0,0,0
2020-02-22,Siskiyou,093,43540,0,0,0,0,0
2020-02-22,Solano,095,438530,11,11,0,11,0
2020-02-22,Sonoma,097,501317,4,0,0,0,0
2020-02-22,Stanislaus,099,539301,2,0,2,2,0
2020-02-22,Sutter,101,95872,0,0,0,0,0
2020-02-22,Tehama,103,63373,0,0,0,0,0
2020-02-22,Trinity,105,12862,0,0,0,0,0
2020-02-22,Tulare,107,460477,2,0,0,0,0
2020-02-22,Tuolumne,109,53932,0,0,0,0,0
2020-02-22,Ventura,111,848112,4,0,0,0,0
2020-02-22,Yolo,113,214977,0,0,0,0,0
2020-02-22,Yuba,115,75493,0,0,0,0,0
2020-02-21,Alameda,001,1643700,9,0,0,0,0
2020-02-21,Alpine,003,1148,0,0,0,0,0
2020-02-21,Amador,005,37829,0,0,0,0,0
2020-02-21,Butte,007,227075,0,0,0,0,0
2020-02-21,Calaveras,009,45235,0,0,0,0,0
2020-02-21,Colusa,011,21464,0,0,0,0,0
2020-02-21,Contra Costa,013,1133247,4,0,0,0,0
2020-02-21,Del Norte,015,27424,0,0,0,0,0
2020-02-21,El Dorado,017,186661,0,0,0,0,0
2020-02-21,Fresno,019,978130,1,0,0,0,0
2020-02-21,Glenn,021,27897,0,0,0,0,0
2020-02-21,Humboldt,023,135768,1,1,0,1,0
2020-02-21,Imperial,025,180216,0,0,0,0,0
2020-02-21,Inyo,027,18085,0,0,0,0,0
2020-02-21,Kern,029,883053,2,0,0,0,0
2020-02-21,Kings,031,150075,3,0,1,1,0
2020-02-21,Lake,033,64148,0,0,0,0,0
2020-02-21,Lassen,035,31185,0,0,0,0,0
2020-02-21,Los Angeles,037,10098052,58,1,6,7,0
2020-02-21,Madera,039,155013,0,0,0,0,0
2020-02-21,Marin,041,260295,1,0,0,0,0
2020-02-21,Mariposa,043,17540,0,0,0,0,0
2020-02-21,Mendocino,045,87422,0,0,0,0,0
2020-02-21,Merced,047,269075,0,0,0,0,0
2020-02-21,Modoc,049,8938,0,0,0,0,0
2020-02-21,Mono,051,14174,0,0,0,0,0
2020-02-21,Monterey,053,433212,1,0,0,0,0
2020-02-21,Napa,055,140530,0,0,0,0,0
2020-02-21,Nevada,057,99092,0,0,1,1,0
2020-02-21,Orange,059,3164182,41,1,0,1,0
2020-02-21,Placer,061,380077,2,0,0,0,0
2020-02-21,Plumas,063,18699,0,0,0,0,0
2020-02-21,Riverside,065,2383286,9,0,0,0,0
2020-02-21,Sacramento,067,1510023,5,1,0,1,0
2020-02-21,San Benito,069,59416,0,2,0,2,0
2020-02-21,San Bernardino,071,2135413,17,0,0,0,0
2020-02-21,San Diego,073,3302833,5,2,0,2,0
2020-02-21,San Francisco,075,870044,3,0,0,0,0
2020-02-21,San Joaquin,077,732212,2,0,1,1,0
2020-02-21,San Luis Obispo,079,281455,2,0,0,0,0
2020-02-21,San Mateo,081,765935,8,0,0,0,0
2020-02-21,Santa Barbara,083,443738,0,0,0,0,0
2020-02-21,Santa Clara,085,1922200,21,2,1,3,0
2020-02-21,Santa Cruz,087,273765,2,0,0,0,0
2020-02-21,Shasta,089,179085,0,0,0,0,0
2020-02-21,Sierra,091,2930,0,0,0,0,0
2020-02-21,Siskiyou,093,43540,0,0,0,0,0
2020-02-21,Solano,095,438530,10,11,0,11,0
2020-02-21,Sonoma,097,501317,3,0,0,0,0
2020-02-21,Stanislaus,099,539301,2,0,2,2,0
2020-02-21,Sutter,101,95872,0,0,0,0,0
2020-02-21,Tehama,103,63373,0,0,0,0,0
2020-02-21,Trinity,105,12862,0,0,0,0,0
2020-02-21,Tulare,107,460477,2,0,0,0,0
2020-02-21,Tuolumne,109,53932,0,0,0,0,0
2020-02-21,Ventura,111,848112,4,0,0,0,0
2020-02-21,Yolo,113,214977,0,0,0,0,0
2020-02-21,Yuba,115,75493,0,0,0,0,0
2020-02-20,Alameda,001,1643700,7,0,0,0,0
2020-02-20,Alpine,003,1148,0,0,0,0,0
2020-02-20,Amador,005,37829,0,0,0,0,0
2020-02-20,Butte,007,227075,0,0,0,0,0
2020-02-20,Calaveras,009,45235,0,0,0,0,0
2020-02-20,Colusa,011,21464,0,0,0,0,0
2020-02-20,Contra Costa,013,1133247,3,0,0,0,0
2020-02-20,Del Norte,015,27424,0,0,0,0,0
2020-02-20,El Dorado,017,186661,0,0,0,0,0
2020-02-20,Fresno,019,978130,1,0,0,0,0
2020-02-20,Glenn,021,27897,0,0,0,0,0
2020-02-20,Humboldt,023,135768,1,1,0,1,0
2020-02-20,Imperial,025,180216,0,0,0,0,0
2020-02-20,Inyo,027,18085,0,0,0,0,0
2020-02-20,Kern,029,883053,2,0,0,0,0
2020-02-20,Kings,031,150075,3,0,1,1,0
2020-02-20,Lake,033,64148,0,0,0,0,0
2020-02-20,Lassen,035,31185,0,0,0,0,0
2020-02-20,Los Angeles,037,10098052,57,1,5,6,0
2020-02-20,Madera,039,155013,0,0,0,0,0
2020-02-20,Marin,041,260295,0,0,0,0,0
2020-02-20,Mariposa,043,17540,0,0,0,0,0
2020-02-20,Mendocino,045,87422,0,0,0,0,0
2020-02-20,Merced,047,269075,0,0,0,0,0
2020-02-20,Modoc,049,8938,0,0,0,0,0
2020-02-20,Mono,051,14174,0,0,0,0,0
2020-02-20,Monterey,053,433212,1,0,0,0,0
2020-02-20,Napa,055,140530,0,0,0,0,0
2020-02-20,Nevada,057,99092,0,0,1,1,0
2020-02-20,Orange,059,3164182,41,1,0,1,0
2020-02-20,Placer,061,380077,2,0,0,0,0
2020-02-20,Plumas,063,18699,0,0,0,0,0
2020-02-20,Riverside,065,2383286,7,0,0,0,0
2020-02-20,Sacramento,067,1510023,2,1,0,1,0
2020-02-20,San Benito,069,59416,0,2,0,2,0
2020-02-20,San Bernardino,071,2135413,15,0,0,0,0
2020-02-20,San Diego,073,3302833,5,2,0,2,0
2020-02-20,San Francisco,075,870044,3,0,0,0,0
2020-02-20,San Joaquin,077,732212,2,0,1,1,0
2020-02-20,San Luis Obispo,079,281455,2,0,0,0,0
2020-02-20,San Mateo,081,765935,7,0,0,0,0
2020-02-20,Santa Barbara,083,443738,0,0,0,0,0
2020-02-20,Santa Clara,085,1922200,17,2,1,3,0
2020-02-20,Santa Cruz,087,273765,2,0,0,0,0
2020-02-20,Shasta,089,179085,0,0,0,0,0
2020-02-20,Sierra,091,2930,0,0,0,0,0
2020-02-20,Siskiyou,093,43540,0,0,0,0,0
2020-02-20,Solano,095,438530,8,7,0,7,0
2020-02-20,Sonoma,097,501317,2,0,0,0,0
2020-02-20,Stanislaus,099,539301,2,0,2,2,0
2020-02-20,Sutter,101,95872,0,0,0,0,0
2020-02-20,Tehama,103,63373,0,0,0,0,0
2020-02-20,Trinity,105,12862,0,0,0,0,0
2020-02-20,Tulare,107,460477,2,0,0,0,0
2020-02-20,Tuolumne,109,53932,0,0,0,0,0
2020-02-20,Ventura,111,848112,4,0,0,0,0
2020-02-20,Yolo,113,214977,0,0,0,0,0
2020-02-20,Yuba,115,75493,0,0,0,0,0
2020-02-19,Alameda,001,1643700,6,0,0,0,0
2020-02-19,Alpine,003,1148,0,0,0,0,0
2020-02-19,Amador,005,37829,0,0,0,0,0
2020-02-19,Butte,007,227075,0,0,0,0,0
2020-02-19,Calaveras,009,45235,0,0,0,0,0
2020-02-19,Colusa,011,21464,0,0,0,0,0
2020-02-19,Contra Costa,013,1133247,3,0,0,0,0
2020-02-19,Del Norte,015,27424,0,0,0,0,0
2020-02-19,El Dorado,017,186661,0,0,0,0,0
2020-02-19,Fresno,019,978130,1,0,0,0,0
2020-02-19,Glenn,021,27897,0,0,0,0,0
2020-02-19,Humboldt,023,135768,1,0,0,0,0
2020-02-19,Imperial,025,180216,0,0,0,0,0
2020-02-19,Inyo,027,18085,0,0,0,0,0
2020-02-19,Kern,029,883053,2,0,0,0,0
2020-02-19,Kings,031,150075,3,0,1,1,0
2020-02-19,Lake,033,64148,0,0,0,0,0
2020-02-19,Lassen,035,31185,0,0,0,0,0
2020-02-19,Los Angeles,037,10098052,54,1,5,6,0
2020-02-19,Madera,039,155013,0,0,0,0,0
2020-02-19,Marin,041,260295,0,0,0,0,0
2020-02-19,Mariposa,043,17540,0,0,0,0,0
2020-02-19,Mendocino,045,87422,0,0,0,0,0
2020-02-19,Merced,047,269075,0,0,0,0,0
2020-02-19,Modoc,049,8938,0,0,0,0,0
2020-02-19,Mono,051,14174,0,0,0,0,0
2020-02-19,Monterey,053,433212,1,0,0,0,0
2020-02-19,Napa,055,140530,0,0,0,0,0
2020-02-19,Nevada,057,99092,0,0,1,1,0
2020-02-19,Orange,059,3164182,40,1,0,1,0
2020-02-19,Placer,061,380077,2,0,0,0,0
2020-02-19,Plumas,063,18699,0,0,0,0,0
2020-02-19,Riverside,065,2383286,5,0,0,0,0
2020-02-19,Sacramento,067,1510023,2,0,0,0,0
2020-02-19,San Benito,069,59416,0,2,0,2,0
2020-02-19,San Bernardino,071,2135413,14,0,0,0,0
2020-02-19,San Diego,073,3302833,4,2,0,2,0
2020-02-19,San Francisco,075,870044,2,0,0,0,0
2020-02-19,San Joaquin,077,732212,2,0,1,1,0
2020-02-19,San Luis Obispo,079,281455,2,0,0,0,0
2020-02-19,San Mateo,081,765935,6,0,0,0,0
2020-02-19,Santa Barbara,083,443738,0,0,0,0,0
2020-02-19,Santa Clara,085,1922200,15,2,1,3,0
2020-02-19,Santa Cruz,087,273765,0,0,0,0,0
2020-02-19,Shasta,089,179085,0,0,0,0,0
2020-02-19,Sierra,091,2930,0,0,0,0,0
2020-02-19,Siskiyou,093,43540,0,0,0,0,0
2020-02-19,Solano,095,438530,5,7,0,7,0
2020-02-19,Sonoma,097,501317,2,0,0,0,0
2020-02-19,Stanislaus,099,539301,1,0,2,2,0
2020-02-19,Sutter,101,95872,0,0,0,0,0
2020-02-19,Tehama,103,63373,0,0,0,0,0
2020-02-19,Trinity,105,12862,0,0,0,0,0
2020-02-19,Tulare,107,460477,2,0,0,0,0
2020-02-19,Tuolumne,109,53932,0,0,0,0,0
2020-02-19,Ventura,111,848112,2,0,0,0,0
2020-02-19,Yolo,113,214977,0,0,0,0,0
2020-02-19,Yuba,115,75493,0,0,0,0,0
2020-02-18,Alameda,001,1643700,6,0,0,0,0
2020-02-18,Alpine,003,1148,0,0,0,0,0
2020-02-18,Amador,005,37829,0,0,0,0,0
2020-02-18,Butte,007,227075,0,0,0,0,0
2020-02-18,Calaveras,009,45235,0,0,0,0,0
2020-02-18,Colusa,011,21464,0,0,0,0,0
2020-02-18,Contra Costa,013,1133247,3,0,0,0,0
2020-02-18,Del Norte,015,27424,0,0,0,0,0
2020-02-18,El Dorado,017,186661,0,0,0,0,0
2020-02-18,Fresno,019,978130,0,0,0,0,0
2020-02-18,Glenn,021,27897,0,0,0,0,0
2020-02-18,Humboldt,023,135768,1,0,0,0,0
2020-02-18,Imperial,025,180216,0,0,0,0,0
2020-02-18,Inyo,027,18085,0,0,0,0,0
2020-02-18,Kern,029,883053,2,0,0,0,0
2020-02-18,Kings,031,150075,3,0,1,1,0
2020-02-18,Lake,033,64148,0,0,0,0,0
2020-02-18,Lassen,035,31185,0,0,0,0,0
2020-02-18,Los Angeles,037,10098052,51,1,4,5,0
2020-02-18,Madera,039,155013,0,0,0,0,0
2020-02-18,Marin,041,260295,0,0,0,0,0
2020-02-18,Mariposa,043,17540,0,0,0,0,0
2020-02-18,Mendocino,045,87422,0,0,0,0,0
2020-02-18,Merced,047,269075,0,0,0,0,0
2020-02-18,Modoc,049,8938,0,0,0,0,0
2020-02-18,Mono,051,14174,0,0,0,0,0
2020-02-18,Monterey,053,433212,1,0,0,0,0
2020-02-18,Napa,055,140530,0,0,0,0,0
2020-02-18,Nevada,057,99092,0,0,1,1,0
2020-02-18,Orange,059,3164182,39,1,0,1,0
2020-02-18,Placer,061,380077,0,0,0,0,0
2020-02-18,Plumas,063,18699,0,0,0,0,0
2020-02-18,Riverside,065,2383286,5,0,0,0,0
2020-02-18,Sacramento,067,1510023,2,0,0,0,0
2020-02-18,San Benito,069,59416,0,2,0,2,0
2020-02-18,San Bernardino,071,2135413,13,0,0,0,0
2020-02-18,San Diego,073,3302833,4,2,0,2,0
2020-02-18,San Francisco,075,870044,2,0,0,0,0
2020-02-18,San Joaquin,077,732212,1,0,1,1,0
2020-02-18,San Luis Obispo,079,281455,2,0,0,0,0
2020-02-18,San Mateo,081,765935,5,0,0,0,0
2020-02-18,Santa Barbara,083,443738,0,0,0,0,0
2020-02-18,Santa Clara,085,1922200,14,2,1,3,0
2020-02-18,Santa Cruz,087,273765,0,0,0,0,0
2020-02-18,Shasta,089,179085,0,0,0,0,0
2020-02-18,Sierra,091,2930,0,0,0,0,0
2020-02-18,Siskiyou,093,43540,0,0,0,0,0
2020-02-18,Solano,095,438530,5,7,0,7,0
2020-02-18,Sonoma,097,501317,1,0,0,0,0
2020-02-18,Stanislaus,099,539301,1,0,2,2,0
2020-02-18,Sutter,101,95872,0,0,0,0,0
2020-02-18,Tehama,103,63373,0,0,0,0,0
2020-02-18,Trinity,105,12862,0,0,0,0,0
2020-02-18,Tulare,107,460477,2,0,0,0,0
2020-02-18,Tuolumne,109,53932,0,0,0,0,0
2020-02-18,Ventura,111,848112,2,0,0,0,0
2020-02-18,Yolo,113,214977,0,0,0,0,0
2020-02-18,Yuba,115,75493,0,0,0,0,0
2020-02-17,Alameda,001,1643700,6,0,0,0,0
2020-02-17,Alpine,003,1148,0,0,0,0,0
2020-02-17,Amador,005,37829,0,0,0,0,0
2020-02-17,Butte,007,227075,0,0,0,0,0
2020-02-17,Calaveras,009,45235,0,0,0,0,0
2020-02-17,Colusa,011,21464,0,0,0,0,0
2020-02-17,Contra Costa,013,1133247,3,0,0,0,0
2020-02-17,Del Norte,015,27424,0,0,0,0,0
2020-02-17,El Dorado,017,186661,0,0,0,0,0
2020-02-17,Fresno,019,978130,0,0,0,0,0
2020-02-17,Glenn,021,27897,0,0,0,0,0
2020-02-17,Humboldt,023,135768,1,0,0,0,0
2020-02-17,Imperial,025,180216,0,0,0,0,0
2020-02-17,Inyo,027,18085,0,0,0,0,0
2020-02-17,Kern,029,883053,2,0,0,0,0
2020-02-17,Kings,031,150075,3,0,0,0,0
2020-02-17,Lake,033,64148,0,0,0,0,0
2020-02-17,Lassen,035,31185,0,0,0,0,0
2020-02-17,Los Angeles,037,10098052,48,1,4,5,0
2020-02-17,Madera,039,155013,0,0,0,0,0
2020-02-17,Marin,041,260295,0,0,0,0,0
2020-02-17,Mariposa,043,17540,0,0,0,0,0
2020-02-17,Mendocino,045,87422,0,0,0,0,0
2020-02-17,Merced,047,269075,0,0,0,0,0
2020-02-17,Modoc,049,8938,0,0,0,0,0
2020-02-17,Mono,051,14174,0,0,0,0,0
2020-02-17,Monterey,053,433212,1,0,0,0,0
2020-02-17,Napa,055,140530,0,0,0,0,0
2020-02-17,Nevada,057,99092,0,0,1,1,0
2020-02-17,Orange,059,3164182,39,1,0,1,0
2020-02-17,Placer,061,380077,0,0,0,0,0
2020-02-17,Plumas,063,18699,0,0,0,0,0
2020-02-17,Riverside,065,2383286,5,0,0,0,0
2020-02-17,Sacramento,067,1510023,2,0,0,0,0
2020-02-17,San Benito,069,59416,0,2,0,2,0
2020-02-17,San Bernardino,071,2135413,11,0,0,0,0
2020-02-17,San Diego,073,3302833,4,2,0,2,0
2020-02-17,San Francisco,075,870044,2,0,0,0,0
2020-02-17,San Joaquin,077,732212,1,0,1,1,0
2020-02-17,San Luis Obispo,079,281455,1,0,0,0,0
2020-02-17,San Mateo,081,765935,5,0,0,0,0
2020-02-17,Santa Barbara,083,443738,0,0,0,0,0
2020-02-17,Santa Clara,085,1922200,12,2,1,3,0
2020-02-17,Santa Cruz,087,273765,0,0,0,0,0
2020-02-17,Shasta,089,179085,0,0,0,0,0
2020-02-17,Sierra,091,2930,0,0,0,0,0
2020-02-17,Siskiyou,093,43540,0,0,0,0,0
2020-02-17,Solano,095,438530,3,5,0,5,0
2020-02-17,Sonoma,097,501317,1,0,0,0,0
2020-02-17,Stanislaus,099,539301,1,0,2,2,0
2020-02-17,Sutter,101,95872,0,0,0,0,0
2020-02-17,Tehama,103,63373,0,0,0,0,0
2020-02-17,Trinity,105,12862,0,0,0,0,0
2020-02-17,Tulare,107,460477,2,0,0,0,0
2020-02-17,Tuolumne,109,53932,0,0,0,0,0
2020-02-17,Ventura,111,848112,2,0,0,0,0
2020-02-17,Yolo,113,214977,0,0,0,0,0
2020-02-17,Yuba,115,75493,0,0,0,0,0
2020-02-16,Alameda,001,1643700,5,0,0,0,0
2020-02-16,Alpine,003,1148,0,0,0,0,0
2020-02-16,Amador,005,37829,0,0,0,0,0
2020-02-16,Butte,007,227075,0,0,0,0,0
2020-02-16,Calaveras,009,45235,0,0,0,0,0
2020-02-16,Colusa,011,21464,0,0,0,0,0
2020-02-16,Contra Costa,013,1133247,3,0,0,0,0
2020-02-16,Del Norte,015,27424,0,0,0,0,0
2020-02-16,El Dorado,017,186661,0,0,0,0,0
2020-02-16,Fresno,019,978130,0,0,0,0,0
2020-02-16,Glenn,021,27897,0,0,0,0,0
2020-02-16,Humboldt,023,135768,1,0,0,0,0
2020-02-16,Imperial,025,180216,0,0,0,0,0
2020-02-16,Inyo,027,18085,0,0,0,0,0
2020-02-16,Kern,029,883053,2,0,0,0,0
2020-02-16,Kings,031,150075,3,0,0,0,0
2020-02-16,Lake,033,64148,0,0,0,0,0
2020-02-16,Lassen,035,31185,0,0,0,0,0
2020-02-16,Los Angeles,037,10098052,42,1,4,5,0
2020-02-16,Madera,039,155013,0,0,0,0,0
2020-02-16,Marin,041,260295,0,0,0,0,0
2020-02-16,Mariposa,043,17540,0,0,0,0,0
2020-02-16,Mendocino,045,87422,0,0,0,0,0
2020-02-16,Merced,047,269075,0,0,0,0,0
2020-02-16,Modoc,049,8938,0,0,0,0,0
2020-02-16,Mono,051,14174,0,0,0,0,0
2020-02-16,Monterey,053,433212,1,0,0,0,0
2020-02-16,Napa,055,140530,0,0,0,0,0
2020-02-16,Nevada,057,99092,0,0,0,0,0
2020-02-16,Orange,059,3164182,38,1,0,1,0
2020-02-16,Placer,061,380077,0,0,0,0,0
2020-02-16,Plumas,063,18699,0,0,0,0,0
2020-02-16,Riverside,065,2383286,5,0,0,0,0
2020-02-16,Sacramento,067,1510023,2,0,0,0,0
2020-02-16,San Benito,069,59416,0,2,0,2,0
2020-02-16,San Bernardino,071,2135413,10,0,0,0,0
2020-02-16,San Diego,073,3302833,4,2,0,2,0
2020-02-16,San Francisco,075,870044,2,0,0,0,0
2020-02-16,San Joaquin,077,732212,1,0,1,1,0
2020-02-16,San Luis Obispo,079,281455,1,0,0,0,0
2020-02-16,San Mateo,081,765935,4,0,0,0,0
2020-02-16,Santa Barbara,083,443738,0,0,0,0,0
2020-02-16,Santa Clara,085,1922200,10,2,1,3,0
2020-02-16,Santa Cruz,087,273765,0,0,0,0,0
2020-02-16,Shasta,089,179085,0,0,0,0,0
2020-02-16,Sierra,091,2930,0,0,0,0,0
2020-02-16,Siskiyou,093,43540,0,0,0,0,0
2020-02-16,Solano,095,438530,1,0,0,0,0
2020-02-16,Sonoma,097,501317,1,0,0,0,0
2020-02-16,Stanislaus,099,539301,1,0,2,2,0
2020-02-16,Sutter,101,95872,0,0,0,0,0
2020-02-16,Tehama,103,63373,0,0,0,0,0
2020-02-16,Trinity,105,12862,0,0,0,0,0
2020-02-16,Tulare,107,460477,2,0,0,0,0
2020-02-16,Tuolumne,109,53932,0,0,0,0,0
2020-02-16,Ventura,111,848112,2,0,0,0,0
2020-02-16,Yolo,113,214977,0,0,0,0,0
2020-02-16,Yuba,115,75493,0,0,0,0,0
2020-02-15,Alameda,001,1643700,5,0,0,0,0
2020-02-15,Alpine,003,1148,0,0,0,0,0
2020-02-15,Amador,005,37829,0,0,0,0,0
2020-02-15,Butte,007,227075,0,0,0,0,0
2020-02-15,Calaveras,009,45235,0,0,0,0,0
2020-02-15,Colusa,011,21464,0,0,0,0,0
2020-02-15,Contra Costa,013,1133247,3,0,0,0,0
2020-02-15,Del Norte,015,27424,0,0,0,0,0
2020-02-15,El Dorado,017,186661,0,0,0,0,0
2020-02-15,Fresno,019,978130,0,0,0,0,0
2020-02-15,Glenn,021,27897,0,0,0,0,0
2020-02-15,Humboldt,023,135768,1,0,0,0,0
2020-02-15,Imperial,025,180216,0,0,0,0,0
2020-02-15,Inyo,027,18085,0,0,0,0,0
2020-02-15,Kern,029,883053,2,0,0,0,0
2020-02-15,Kings,031,150075,3,0,0,0,0
2020-02-15,Lake,033,64148,0,0,0,0,0
2020-02-15,Lassen,035,31185,0,0,0,0,0
2020-02-15,Los Angeles,037,10098052,39,1,4,5,0
2020-02-15,Madera,039,155013,0,0,0,0,0
2020-02-15,Marin,041,260295,0,0,0,0,0
2020-02-15,Mariposa,043,17540,0,0,0,0,0
2020-02-15,Mendocino,045,87422,0,0,0,0,0
2020-02-15,Merced,047,269075,0,0,0,0,0
2020-02-15,Modoc,049,8938,0,0,0,0,0
2020-02-15,Mono,051,14174,0,0,0,0,0
2020-02-15,Monterey,053,433212,1,0,0,0,0
2020-02-15,Napa,055,140530,0,0,0,0,0
2020-02-15,Nevada,057,99092,0,0,0,0,0
2020-02-15,Orange,059,3164182,37,1,0,1,0
2020-02-15,Placer,061,380077,0,0,0,0,0
2020-02-15,Plumas,063,18699,0,0,0,0,0
2020-02-15,Riverside,065,2383286,4,0,0,0,0
2020-02-15,Sacramento,067,1510023,2,0,0,0,0
2020-02-15,San Benito,069,59416,0,2,0,2,0
2020-02-15,San Bernardino,071,2135413,9,0,0,0,0
2020-02-15,San Diego,073,3302833,4,2,0,2,0
2020-02-15,San Francisco,075,870044,2,0,0,0,0
2020-02-15,San Joaquin,077,732212,1,0,1,1,0
2020-02-15,San Luis Obispo,079,281455,1,0,0,0,0
2020-02-15,San Mateo,081,765935,4,0,0,0,0
2020-02-15,Santa Barbara,083,443738,0,0,0,0,0
2020-02-15,Santa Clara,085,1922200,10,2,1,3,0
2020-02-15,Santa Cruz,087,273765,0,0,0,0,0
2020-02-15,Shasta,089,179085,0,0,0,0,0
2020-02-15,Sierra,091,2930,0,0,0,0,0
2020-02-15,Siskiyou,093,43540,0,0,0,0,0
2020-02-15,Solano,095,438530,1,0,0,0,0
2020-02-15,Sonoma,097,501317,0,0,0,0,0
2020-02-15,Stanislaus,099,539301,1,0,2,2,0
2020-02-15,Sutter,101,95872,0,0,0,0,0
2020-02-15,Tehama,103,63373,0,0,0,0,0
2020-02-15,Trinity,105,12862,0,0,0,0,0
2020-02-15,Tulare,107,460477,2,0,0,0,0
2020-02-15,Tuolumne,109,53932,0,0,0,0,0
2020-02-15,Ventura,111,848112,2,0,0,0,0
2020-02-15,Yolo,113,214977,0,0,0,0,0
2020-02-15,Yuba,115,75493,0,0,0,0,0
2020-02-14,Alameda,001,1643700,4,0,0,0,0
2020-02-14,Alpine,003,1148,0,0,0,0,0
2020-02-14,Amador,005,37829,0,0,0,0,0
2020-02-14,Butte,007,227075,0,0,0,0,0
2020-02-14,Calaveras,009,45235,0,0,0,0,0
2020-02-14,Colusa,011,21464,0,0,0,0,0
2020-02-14,Contra Costa,013,1133247,3,0,0,0,0
2020-02-14,Del Norte,015,27424,0,0,0,0,0
2020-02-14,El Dorado,017,186661,0,0,0,0,0
2020-02-14,Fresno,019,978130,0,0,0,0,0
2020-02-14,Glenn,021,27897,0,0,0,0,0
2020-02-14,Humboldt,023,135768,1,0,0,0,0
2020-02-14,Imperial,025,180216,0,0,0,0,0
2020-02-14,Inyo,027,18085,0,0,0,0,0
2020-02-14,Kern,029,883053,2,0,0,0,0
2020-02-14,Kings,031,150075,1,0,0,0,0
2020-02-14,Lake,033,64148,0,0,0,0,0
2020-02-14,Lassen,035,31185,0,0,0,0,0
2020-02-14,Los Angeles,037,10098052,34,1,4,5,0
2020-02-14,Madera,039,155013,0,0,0,0,0
2020-02-14,Marin,041,260295,0,0,0,0,0
2020-02-14,Mariposa,043,17540,0,0,0,0,0
2020-02-14,Mendocino,045,87422,0,0,0,0,0
2020-02-14,Merced,047,269075,0,0,0,0,0
2020-02-14,Modoc,049,8938,0,0,0,0,0
2020-02-14,Mono,051,14174,0,0,0,0,0
2020-02-14,Monterey,053,433212,1,0,0,0,0
2020-02-14,Napa,055,140530,0,0,0,0,0
2020-02-14,Nevada,057,99092,0,0,0,0,0
2020-02-14,Orange,059,3164182,37,1,0,1,0
2020-02-14,Placer,061,380077,0,0,0,0,0
2020-02-14,Plumas,063,18699,0,0,0,0,0
2020-02-14,Riverside,065,2383286,4,0,0,0,0
2020-02-14,Sacramento,067,1510023,1,0,0,0,0
2020-02-14,San Benito,069,59416,0,2,0,2,0
2020-02-14,San Bernardino,071,2135413,9,0,0,0,0
2020-02-14,San Diego,073,3302833,3,2,0,2,0
2020-02-14,San Francisco,075,870044,2,0,0,0,0
2020-02-14,San Joaquin,077,732212,1,0,1,1,0
2020-02-14,San Luis Obispo,079,281455,0,0,0,0,0
2020-02-14,San Mateo,081,765935,3,0,0,0,0
2020-02-14,Santa Barbara,083,443738,0,0,0,0,0
2020-02-14,Santa Clara,085,1922200,8,2,1,3,0
2020-02-14,Santa Cruz,087,273765,0,0,0,0,0
2020-02-14,Shasta,089,179085,0,0,0,0,0
2020-02-14,Sierra,091,2930,0,0,0,0,0
2020-02-14,Siskiyou,093,43540,0,0,0,0,0
2020-02-14,Solano,095,438530,1,0,0,0,0
2020-02-14,Sonoma,097,501317,0,0,0,0,0
2020-02-14,Stanislaus,099,539301,1,0,2,2,0
2020-02-14,Sutter,101,95872,0,0,0,0,0
2020-02-14,Tehama,103,63373,0,0,0,0,0
2020-02-14,Trinity,105,12862,0,0,0,0,0
2020-02-14,Tulare,107,460477,2,0,0,0,0
2020-02-14,Tuolumne,109,53932,0,0,0,0,0
2020-02-14,Ventura,111,848112,2,0,0,0,0
2020-02-14,Yolo,113,214977,0,0,0,0,0
2020-02-14,Yuba,115,75493,0,0,0,0,0
2020-02-13,Alameda,001,1643700,4,0,0,0,0
2020-02-13,Alpine,003,1148,0,0,0,0,0
2020-02-13,Amador,005,37829,0,0,0,0,0
2020-02-13,Butte,007,227075,0,0,0,0,0
2020-02-13,Calaveras,009,45235,0,0,0,0,0
2020-02-13,Colusa,011,21464,0,0,0,0,0
2020-02-13,Contra Costa,013,1133247,3,0,0,0,0
2020-02-13,Del Norte,015,27424,0,0,0,0,0
2020-02-13,El Dorado,017,186661,0,0,0,0,0
2020-02-13,Fresno,019,978130,0,0,0,0,0
2020-02-13,Glenn,021,27897,0,0,0,0,0
2020-02-13,Humboldt,023,135768,1,0,0,0,0
2020-02-13,Imperial,025,180216,0,0,0,0,0
2020-02-13,Inyo,027,18085,0,0,0,0,0
2020-02-13,Kern,029,883053,2,0,0,0,0
2020-02-13,Kings,031,150075,1,0,0,0,0
2020-02-13,Lake,033,64148,0,0,0,0,0
2020-02-13,Lassen,035,31185,0,0,0,0,0
2020-02-13,Los Angeles,037,10098052,31,1,3,4,0
2020-02-13,Madera,039,155013,0,0,0,0,0
2020-02-13,Marin,041,260295,0,0,0,0,0
2020-02-13,Mariposa,043,17540,0,0,0,0,0
2020-02-13,Mendocino,045,87422,0,0,0,0,0
2020-02-13,Merced,047,269075,0,0,0,0,0
2020-02-13,Modoc,049,8938,0,0,0,0,0
2020-02-13,Mono,051,14174,0,0,0,0,0
2020-02-13,Monterey,053,433212,1,0,0,0,0
2020-02-13,Napa,055,140530,0,0,0,0,0
2020-02-13,Nevada,057,99092,0,0,0,0,0
2020-02-13,Orange,059,3164182,36,1,0,1,0
2020-02-13,Placer,061,380077,0,0,0,0,0
2020-02-13,Plumas,063,18699,0,0,0,0,0
2020-02-13,Riverside,065,2383286,4,0,0,0,0
2020-02-13,Sacramento,067,1510023,1,0,0,0,0
2020-02-13,San Benito,069,59416,0,2,0,2,0
2020-02-13,San Bernardino,071,2135413,8,0,0,0,0
2020-02-13,San Diego,073,3302833,2,2,0,2,0
2020-02-13,San Francisco,075,870044,2,0,0,0,0
2020-02-13,San Joaquin,077,732212,1,0,1,1,0
2020-02-13,San Luis Obispo,079,281455,0,0,0,0,0
2020-02-13,San Mateo,081,765935,2,0,0,0,0
2020-02-13,Santa Barbara,083,443738,0,0,0,0,0
2020-02-13,Santa Clara,085,1922200,7,2,0,2,0
2020-02-13,Santa Cruz,087,273765,0,0,0,0,0
2020-02-13,Shasta,089,179085,0,0,0,0,0
2020-02-13,Sierra,091,2930,0,0,0,0,0
2020-02-13,Siskiyou,093,43540,0,0,0,0,0
2020-02-13,Solano,095,438530,0,0,0,0,0
2020-02-13,Sonoma,097,501317,0,0,0,0,0
2020-02-13,Stanislaus,099,539301,1,0,1,1,0
2020-02-13,Sutter,101,95872,0,0,0,0,0
2020-02-13,Tehama,103,63373,0,0,0,0,0
2020-02-13,Trinity,105,12862,0,0,0,0,0
2020-02-13,Tulare,107,460477,2,0,0,0,0
2020-02-13,Tuolumne,109,53932,0,0,0,0,0
2020-02-13,Ventura,111,848112,2,0,0,0,0
2020-02-13,Yolo,113,214977,0,0,0,0,0
2020-02-13,Yuba,115,75493,0,0,0,0,0
2020-02-12,Alameda,001,1643700,4,0,0,0,0
2020-02-12,Alpine,003,1148,0,0,0,0,0
2020-02-12,Amador,005,37829,0,0,0,0,0
2020-02-12,Butte,007,227075,0,0,0,0,0
2020-02-12,Calaveras,009,45235,0,0,0,0,0
2020-02-12,Colusa,011,21464,0,0,0,0,0
2020-02-12,Contra Costa,013,1133247,3,0,0,0,0
2020-02-12,Del Norte,015,27424,0,0,0,0,0
2020-02-12,El Dorado,017,186661,0,0,0,0,0
2020-02-12,Fresno,019,978130,0,0,0,0,0
2020-02-12,Glenn,021,27897,0,0,0,0,0
2020-02-12,Humboldt,023,135768,1,0,0,0,0
2020-02-12,Imperial,025,180216,0,0,0,0,0
2020-02-12,Inyo,027,18085,0,0,0,0,0
2020-02-12,Kern,029,883053,2,0,0,0,0
2020-02-12,Kings,031,150075,1,0,0,0,0
2020-02-12,Lake,033,64148,0,0,0,0,0
2020-02-12,Lassen,035,31185,0,0,0,0,0
2020-02-12,Los Angeles,037,10098052,30,1,3,4,0
2020-02-12,Madera,039,155013,0,0,0,0,0
2020-02-12,Marin,041,260295,0,0,0,0,0
2020-02-12,Mariposa,043,17540,0,0,0,0,0
2020-02-12,Mendocino,045,87422,0,0,0,0,0
2020-02-12,Merced,047,269075,0,0,0,0,0
2020-02-12,Modoc,049,8938,0,0,0,0,0
2020-02-12,Mono,051,14174,0,0,0,0,0
2020-02-12,Monterey,053,433212,1,0,0,0,0
2020-02-12,Napa,055,140530,0,0,0,0,0
2020-02-12,Nevada,057,99092,0,0,0,0,0
2020-02-12,Orange,059,3164182,36,1,0,1,0
2020-02-12,Placer,061,380077,0,0,0,0,0
2020-02-12,Plumas,063,18699,0,0,0,0,0
2020-02-12,Riverside,065,2383286,4,0,0,0,0
2020-02-12,Sacramento,067,1510023,1,0,0,0,0
2020-02-12,San Benito,069,59416,0,2,0,2,0
2020-02-12,San Bernardino,071,2135413,8,0,0,0,0
2020-02-12,San Diego,073,3302833,2,2,0,2,0
2020-02-12,San Francisco,075,870044,2,0,0,0,0
2020-02-12,San Joaquin,077,732212,1,0,1,1,0
2020-02-12,San Luis Obispo,079,281455,0,0,0,0,0
2020-02-12,San Mateo,081,765935,2,0,0,0,0
2020-02-12,Santa Barbara,083,443738,0,0,0,0,0
2020-02-12,Santa Clara,085,1922200,6,2,0,2,0
2020-02-12,Santa Cruz,087,273765,0,0,0,0,0
2020-02-12,Shasta,089,179085,0,0,0,0,0
2020-02-12,Sierra,091,2930,0,0,0,0,0
2020-02-12,Siskiyou,093,43540,0,0,0,0,0
2020-02-12,Solano,095,438530,0,0,0,0,0
2020-02-12,Sonoma,097,501317,0,0,0,0,0
2020-02-12,Stanislaus,099,539301,1,0,1,1,0
2020-02-12,Sutter,101,95872,0,0,0,0,0
2020-02-12,Tehama,103,63373,0,0,0,0,0
2020-02-12,Trinity,105,12862,0,0,0,0,0
2020-02-12,Tulare,107,460477,2,0,0,0,0
2020-02-12,Tuolumne,109,53932,0,0,0,0,0
2020-02-12,Ventura,111,848112,2,0,0,0,0
2020-02-12,Yolo,113,214977,0,0,0,0,0
2020-02-12,Yuba,115,75493,0,0,0,0,0
2020-02-11,Alameda,001,1643700,4,0,0,0,0
2020-02-11,Alpine,003,1148,0,0,0,0,0
2020-02-11,Amador,005,37829,0,0,0,0,0
2020-02-11,Butte,007,227075,0,0,0,0,0
2020-02-11,Calaveras,009,45235,0,0,0,0,0
2020-02-11,Colusa,011,21464,0,0,0,0,0
2020-02-11,Contra Costa,013,1133247,3,0,0,0,0
2020-02-11,Del Norte,015,27424,0,0,0,0,0
2020-02-11,El Dorado,017,186661,0,0,0,0,0
2020-02-11,Fresno,019,978130,0,0,0,0,0
2020-02-11,Glenn,021,27897,0,0,0,0,0
2020-02-11,Humboldt,023,135768,1,0,0,0,0
2020-02-11,Imperial,025,180216,0,0,0,0,0
2020-02-11,Inyo,027,18085,0,0,0,0,0
2020-02-11,Kern,029,883053,2,0,0,0,0
2020-02-11,Kings,031,150075,1,0,0,0,0
2020-02-11,Lake,033,64148,0,0,0,0,0
2020-02-11,Lassen,035,31185,0,0,0,0,0
2020-02-11,Los Angeles,037,10098052,30,1,3,4,0
2020-02-11,Madera,039,155013,0,0,0,0,0
2020-02-11,Marin,041,260295,0,0,0,0,0
2020-02-11,Mariposa,043,17540,0,0,0,0,0
2020-02-11,Mendocino,045,87422,0,0,0,0,0
2020-02-11,Merced,047,269075,0,0,0,0,0
2020-02-11,Modoc,049,8938,0,0,0,0,0
2020-02-11,Mono,051,14174,0,0,0,0,0
2020-02-11,Monterey,053,433212,1,0,0,0,0
2020-02-11,Napa,055,140530,0,0,0,0,0
2020-02-11,Nevada,057,99092,0,0,0,0,0
2020-02-11,Orange,059,3164182,35,1,0,1,0
2020-02-11,Placer,061,380077,0,0,0,0,0
2020-02-11,Plumas,063,18699,0,0,0,0,0
2020-02-11,Riverside,065,2383286,4,0,0,0,0
2020-02-11,Sacramento,067,1510023,1,0,0,0,0
2020-02-11,San Benito,069,59416,0,2,0,2,0
2020-02-11,San Bernardino,071,2135413,8,0,0,0,0
2020-02-11,San Diego,073,3302833,2,1,0,1,0
2020-02-11,San Francisco,075,870044,2,0,0,0,0
2020-02-11,San Joaquin,077,732212,0,0,1,1,0
2020-02-11,San Luis Obispo,079,281455,0,0,0,0,0
2020-02-11,San Mateo,081,765935,2,0,0,0,0
2020-02-11,Santa Barbara,083,443738,0,0,0,0,0
2020-02-11,Santa Clara,085,1922200,5,2,0,2,0
2020-02-11,Santa Cruz,087,273765,0,0,0,0,0
2020-02-11,Shasta,089,179085,0,0,0,0,0
2020-02-11,Sierra,091,2930,0,0,0,0,0
2020-02-11,Siskiyou,093,43540,0,0,0,0,0
2020-02-11,Solano,095,438530,0,0,0,0,0
2020-02-11,Sonoma,097,501317,0,0,0,0,0
2020-02-11,Stanislaus,099,539301,1,0,1,1,0
2020-02-11,Sutter,101,95872,0,0,0,0,0
2020-02-11,Tehama,103,63373,0,0,0,0,0
2020-02-11,Trinity,105,12862,0,0,0,0,0
2020-02-11,Tulare,107,460477,2,0,0,0,0
2020-02-11,Tuolumne,109,53932,0,0,0,0,0
2020-02-11,Ventura,111,848112,2,0,0,0,0
2020-02-11,Yolo,113,214977,0,0,0,0,0
2020-02-11,Yuba,115,75493,0,0,0,0,0
2020-02-10,Alameda,001,1643700,4,0,0,0,0
2020-02-10,Alpine,003,1148,0,0,0,0,0
2020-02-10,Amador,005,37829,0,0,0,0,0
2020-02-10,Butte,007,227075,0,0,0,0,0
2020-02-10,Calaveras,009,45235,0,0,0,0,0
2020-02-10,Colusa,011,21464,0,0,0,0,0
2020-02-10,Contra Costa,013,1133247,3,0,0,0,0
2020-02-10,Del Norte,015,27424,0,0,0,0,0
2020-02-10,El Dorado,017,186661,0,0,0,0,0
2020-02-10,Fresno,019,978130,0,0,0,0,0
2020-02-10,Glenn,021,27897,0,0,0,0,0
2020-02-10,Humboldt,023,135768,0,0,0,0,0
2020-02-10,Imperial,025,180216,0,0,0,0,0
2020-02-10,Inyo,027,18085,0,0,0,0,0
2020-02-10,Kern,029,883053,2,0,0,0,0
2020-02-10,Kings,031,150075,1,0,0,0,0
2020-02-10,Lake,033,64148,0,0,0,0,0
2020-02-10,Lassen,035,31185,0,0,0,0,0
2020-02-10,Los Angeles,037,10098052,28,1,3,4,0
2020-02-10,Madera,039,155013,0,0,0,0,0
2020-02-10,Marin,041,260295,0,0,0,0,0
2020-02-10,Mariposa,043,17540,0,0,0,0,0
2020-02-10,Mendocino,045,87422,0,0,0,0,0
2020-02-10,Merced,047,269075,0,0,0,0,0
2020-02-10,Modoc,049,8938,0,0,0,0,0
2020-02-10,Mono,051,14174,0,0,0,0,0
2020-02-10,Monterey,053,433212,1,0,0,0,0
2020-02-10,Napa,055,140530,0,0,0,0,0
2020-02-10,Nevada,057,99092,0,0,0,0,0
2020-02-10,Orange,059,3164182,35,1,0,1,0
2020-02-10,Placer,061,380077,0,0,0,0,0
2020-02-10,Plumas,063,18699,0,0,0,0,0
2020-02-10,Riverside,065,2383286,4,0,0,0,0
2020-02-10,Sacramento,067,1510023,1,0,0,0,0
2020-02-10,San Benito,069,59416,0,2,0,2,0
2020-02-10,San Bernardino,071,2135413,7,0,0,0,0
2020-02-10,San Diego,073,3302833,2,0,0,0,0
2020-02-10,San Francisco,075,870044,2,0,0,0,0
2020-02-10,San Joaquin,077,732212,0,0,1,1,0
2020-02-10,San Luis Obispo,079,281455,0,0,0,0,0
2020-02-10,San Mateo,081,765935,2,0,0,0,0
2020-02-10,Santa Barbara,083,443738,0,0,0,0,0
2020-02-10,Santa Clara,085,1922200,5,2,0,2,0
2020-02-10,Santa Cruz,087,273765,0,0,0,0,0
2020-02-10,Shasta,089,179085,0,0,0,0,0
2020-02-10,Sierra,091,2930,0,0,0,0,0
2020-02-10,Siskiyou,093,43540,0,0,0,0,0
2020-02-10,Solano,095,438530,0,0,0,0,0
2020-02-10,Sonoma,097,501317,0,0,0,0,0
2020-02-10,Stanislaus,099,539301,1,0,0,0,0
2020-02-10,Sutter,101,95872,0,0,0,0,0
2020-02-10,Tehama,103,63373,0,0,0,0,0
2020-02-10,Trinity,105,12862,0,0,0,0,0
2020-02-10,Tulare,107,460477,2,0,0,0,0
2020-02-10,Tuolumne,109,53932,0,0,0,0,0
2020-02-10,Ventura,111,848112,2,0,0,0,0
2020-02-10,Yolo,113,214977,0,0,0,0,0
2020-02-10,Yuba,115,75493,0,0,0,0,0
2020-02-09,Alameda,001,1643700,4,0,0,0,0
2020-02-09,Alpine,003,1148,0,0,0,0,0
2020-02-09,Amador,005,37829,0,0,0,0,0
2020-02-09,Butte,007,227075,0,0,0,0,0
2020-02-09,Calaveras,009,45235,0,0,0,0,0
2020-02-09,Colusa,011,21464,0,0,0,0,0
2020-02-09,Contra Costa,013,1133247,3,0,0,0,0
2020-02-09,Del Norte,015,27424,0,0,0,0,0
2020-02-09,El Dorado,017,186661,0,0,0,0,0
2020-02-09,Fresno,019,978130,0,0,0,0,0
2020-02-09,Glenn,021,27897,0,0,0,0,0
2020-02-09,Humboldt,023,135768,0,0,0,0,0
2020-02-09,Imperial,025,180216,0,0,0,0,0
2020-02-09,Inyo,027,18085,0,0,0,0,0
2020-02-09,Kern,029,883053,2,0,0,0,0
2020-02-09,Kings,031,150075,1,0,0,0,0
2020-02-09,Lake,033,64148,0,0,0,0,0
2020-02-09,Lassen,035,31185,0,0,0,0,0
2020-02-09,Los Angeles,037,10098052,27,1,3,4,0
2020-02-09,Madera,039,155013,0,0,0,0,0
2020-02-09,Marin,041,260295,0,0,0,0,0
2020-02-09,Mariposa,043,17540,0,0,0,0,0
2020-02-09,Mendocino,045,87422,0,0,0,0,0
2020-02-09,Merced,047,269075,0,0,0,0,0
2020-02-09,Modoc,049,8938,0,0,0,0,0
2020-02-09,Mono,051,14174,0,0,0,0,0
2020-02-09,Monterey,053,433212,1,0,0,0,0
2020-02-09,Napa,055,140530,0,0,0,0,0
2020-02-09,Nevada,057,99092,0,0,0,0,0
2020-02-09,Orange,059,3164182,35,1,0,1,0
2020-02-09,Placer,061,380077,0,0,0,0,0
2020-02-09,Plumas,063,18699,0,0,0,0,0
2020-02-09,Riverside,065,2383286,4,0,0,0,0
2020-02-09,Sacramento,067,1510023,0,0,0,0,0
2020-02-09,San Benito,069,59416,0,2,0,2,0
2020-02-09,San Bernardino,071,2135413,7,0,0,0,0
2020-02-09,San Diego,073,3302833,2,0,0,0,0
2020-02-09,San Francisco,075,870044,1,0,0,0,0
2020-02-09,San Joaquin,077,732212,0,0,1,1,0
2020-02-09,San Luis Obispo,079,281455,0,0,0,0,0
2020-02-09,San Mateo,081,765935,2,0,0,0,0
2020-02-09,Santa Barbara,083,443738,0,0,0,0,0
2020-02-09,Santa Clara,085,1922200,4,2,0,2,0
2020-02-09,Santa Cruz,087,273765,0,0,0,0,0
2020-02-09,Shasta,089,179085,0,0,0,0,0
2020-02-09,Sierra,091,2930,0,0,0,0,0
2020-02-09,Siskiyou,093,43540,0,0,0,0,0
2020-02-09,Solano,095,438530,0,0,0,0,0
2020-02-09,Sonoma,097,501317,0,0,0,0,0
2020-02-09,Stanislaus,099,539301,0,0,0,0,0
2020-02-09,Sutter,101,95872,0,0,0,0,0
2020-02-09,Tehama,103,63373,0,0,0,0,0
2020-02-09,Trinity,105,12862,0,0,0,0,0
2020-02-09,Tulare,107,460477,2,0,0,0,0
2020-02-09,Tuolumne,109,53932,0,0,0,0,0
2020-02-09,Ventura,111,848112,1,0,0,0,0
2020-02-09,Yolo,113,214977,0,0,0,0,0
2020-02-09,Yuba,115,75493,0,0,0,0,0
2020-02-08,Alameda,001,1643700,3,0,0,0,0
2020-02-08,Alpine,003,1148,0,0,0,0,0
2020-02-08,Amador,005,37829,0,0,0,0,0
2020-02-08,Butte,007,227075,0,0,0,0,0
2020-02-08,Calaveras,009,45235,0,0,0,0,0
2020-02-08,Colusa,011,21464,0,0,0,0,0
2020-02-08,Contra Costa,013,1133247,2,0,0,0,0
2020-02-08,Del Norte,015,27424,0,0,0,0,0
2020-02-08,El Dorado,017,186661,0,0,0,0,0
2020-02-08,Fresno,019,978130,0,0,0,0,0
2020-02-08,Glenn,021,27897,0,0,0,0,0
2020-02-08,Humboldt,023,135768,0,0,0,0,0
2020-02-08,Imperial,025,180216,0,0,0,0,0
2020-02-08,Inyo,027,18085,0,0,0,0,0
2020-02-08,Kern,029,883053,2,0,0,0,0
2020-02-08,Kings,031,150075,1,0,0,0,0
2020-02-08,Lake,033,64148,0,0,0,0,0
2020-02-08,Lassen,035,31185,0,0,0,0,0
2020-02-08,Los Angeles,037,10098052,23,1,1,2,0
2020-02-08,Madera,039,155013,0,0,0,0,0
2020-02-08,Marin,041,260295,0,0,0,0,0
2020-02-08,Mariposa,043,17540,0,0,0,0,0
2020-02-08,Mendocino,045,87422,0,0,0,0,0
2020-02-08,Merced,047,269075,0,0,0,0,0
2020-02-08,Modoc,049,8938,0,0,0,0,0
2020-02-08,Mono,051,14174,0,0,0,0,0
2020-02-08,Monterey,053,433212,1,0,0,0,0
2020-02-08,Napa,055,140530,0,0,0,0,0
2020-02-08,Nevada,057,99092,0,0,0,0,0
2020-02-08,Orange,059,3164182,35,1,0,1,0
2020-02-08,Placer,061,380077,0,0,0,0,0
2020-02-08,Plumas,063,18699,0,0,0,0,0
2020-02-08,Riverside,065,2383286,4,0,0,0,0
2020-02-08,Sacramento,067,1510023,0,0,0,0,0
2020-02-08,San Benito,069,59416,0,2,0,2,0
2020-02-08,San Bernardino,071,2135413,7,0,0,0,0
2020-02-08,San Diego,073,3302833,1,0,0,0,0
2020-02-08,San Francisco,075,870044,1,0,0,0,0
2020-02-08,San Joaquin,077,732212,0,0,1,1,0
2020-02-08,San Luis Obispo,079,281455,0,0,0,0,0
2020-02-08,San Mateo,081,765935,2,0,0,0,0
2020-02-08,Santa Barbara,083,443738,0,0,0,0,0
2020-02-08,Santa Clara,085,1922200,4,2,0,2,0
2020-02-08,Santa Cruz,087,273765,0,0,0,0,0
2020-02-08,Shasta,089,179085,0,0,0,0,0
2020-02-08,Sierra,091,2930,0,0,0,0,0
2020-02-08,Siskiyou,093,43540,0,0,0,0,0
2020-02-08,Solano,095,438530,0,0,0,0,0
2020-02-08,Sonoma,097,501317,0,0,0,0,0
2020-02-08,Stanislaus,099,539301,0,0,0,0,0
2020-02-08,Sutter,101,95872,0,0,0,0,0
2020-02-08,Tehama,103,63373,0,0,0,0,0
2020-02-08,Trinity,105,12862,0,0,0,0,0
2020-02-08,Tulare,107,460477,2,0,0,0,0
2020-02-08,Tuolumne,109,53932,0,0,0,0,0
2020-02-08,Ventura,111,848112,1,0,0,0,0
2020-02-08,Yolo,113,214977,0,0,0,0,0
2020-02-08,Yuba,115,75493,0,0,0,0,0
2020-02-07,Alameda,001,1643700,3,0,0,0,0
2020-02-07,Alpine,003,1148,0,0,0,0,0
2020-02-07,Amador,005,37829,0,0,0,0,0
2020-02-07,Butte,007,227075,0,0,0,0,0
2020-02-07,Calaveras,009,45235,0,0,0,0,0
2020-02-07,Colusa,011,21464,0,0,0,0,0
2020-02-07,Contra Costa,013,1133247,2,0,0,0,0
2020-02-07,Del Norte,015,27424,0,0,0,0,0
2020-02-07,El Dorado,017,186661,0,0,0,0,0
2020-02-07,Fresno,019,978130,0,0,0,0,0
2020-02-07,Glenn,021,27897,0,0,0,0,0
2020-02-07,Humboldt,023,135768,0,0,0,0,0
2020-02-07,Imperial,025,180216,0,0,0,0,0
2020-02-07,Inyo,027,18085,0,0,0,0,0
2020-02-07,Kern,029,883053,2,0,0,0,0
2020-02-07,Kings,031,150075,1,0,0,0,0
2020-02-07,Lake,033,64148,0,0,0,0,0
2020-02-07,Lassen,035,31185,0,0,0,0,0
2020-02-07,Los Angeles,037,10098052,22,1,0,1,0
2020-02-07,Madera,039,155013,0,0,0,0,0
2020-02-07,Marin,041,260295,0,0,0,0,0
2020-02-07,Mariposa,043,17540,0,0,0,0,0
2020-02-07,Mendocino,045,87422,0,0,0,0,0
2020-02-07,Merced,047,269075,0,0,0,0,0
2020-02-07,Modoc,049,8938,0,0,0,0,0
2020-02-07,Mono,051,14174,0,0,0,0,0
2020-02-07,Monterey,053,433212,1,0,0,0,0
2020-02-07,Napa,055,140530,0,0,0,0,0
2020-02-07,Nevada,057,99092,0,0,0,0,0
2020-02-07,Orange,059,3164182,33,1,0,1,0
2020-02-07,Placer,061,380077,0,0,0,0,0
2020-02-07,Plumas,063,18699,0,0,0,0,0
2020-02-07,Riverside,065,2383286,4,0,0,0,0
2020-02-07,Sacramento,067,1510023,0,0,0,0,0
2020-02-07,San Benito,069,59416,0,2,0,2,0
2020-02-07,San Bernardino,071,2135413,4,0,0,0,0
2020-02-07,San Diego,073,3302833,1,0,0,0,0
2020-02-07,San Francisco,075,870044,1,0,0,0,0
2020-02-07,San Joaquin,077,732212,0,0,1,1,0
2020-02-07,San Luis Obispo,079,281455,0,0,0,0,0
2020-02-07,San Mateo,081,765935,1,0,0,0,0
2020-02-07,Santa Barbara,083,443738,0,0,0,0,0
2020-02-07,Santa Clara,085,1922200,4,2,0,2,0
2020-02-07,Santa Cruz,087,273765,0,0,0,0,0
2020-02-07,Shasta,089,179085,0,0,0,0,0
2020-02-07,Sierra,091,2930,0,0,0,0,0
2020-02-07,Siskiyou,093,43540,0,0,0,0,0
2020-02-07,Solano,095,438530,0,0,0,0,0
2020-02-07,Sonoma,097,501317,0,0,0,0,0
2020-02-07,Stanislaus,099,539301,0,0,0,0,0
2020-02-07,Sutter,101,95872,0,0,0,0,0
2020-02-07,Tehama,103,63373,0,0,0,0,0
2020-02-07,Trinity,105,12862,0,0,0,0,0
2020-02-07,Tulare,107,460477,2,0,0,0,0
2020-02-07,Tuolumne,109,53932,0,0,0,0,0
2020-02-07,Ventura,111,848112,1,0,0,0,0
2020-02-07,Yolo,113,214977,0,0,0,0,0
2020-02-07,Yuba,115,75493,0,0,0,0,0
2020-02-06,Alameda,001,1643700,3,0,0,0,0
2020-02-06,Alpine,003,1148,0,0,0,0,0
2020-02-06,Amador,005,37829,0,0,0,0,0
2020-02-06,Butte,007,227075,0,0,0,0,0
2020-02-06,Calaveras,009,45235,0,0,0,0,0
2020-02-06,Colusa,011,21464,0,0,0,0,0
2020-02-06,Contra Costa,013,1133247,2,0,0,0,0
2020-02-06,Del Norte,015,27424,0,0,0,0,0
2020-02-06,El Dorado,017,186661,0,0,0,0,0
2020-02-06,Fresno,019,978130,0,0,0,0,0
2020-02-06,Glenn,021,27897,0,0,0,0,0
2020-02-06,Humboldt,023,135768,0,0,0,0,0
2020-02-06,Imperial,025,180216,0,0,0,0,0
2020-02-06,Inyo,027,18085,0,0,0,0,0
2020-02-06,Kern,029,883053,2,0,0,0,0
2020-02-06,Kings,031,150075,0,0,0,0,0
2020-02-06,Lake,033,64148,0,0,0,0,0
2020-02-06,Lassen,035,31185,0,0,0,0,0
2020-02-06,Los Angeles,037,10098052,21,1,0,1,0
2020-02-06,Madera,039,155013,0,0,0,0,0
2020-02-06,Marin,041,260295,0,0,0,0,0
2020-02-06,Mariposa,043,17540,0,0,0,0,0
2020-02-06,Mendocino,045,87422,0,0,0,0,0
2020-02-06,Merced,047,269075,0,0,0,0,0
2020-02-06,Modoc,049,8938,0,0,0,0,0
2020-02-06,Mono,051,14174,0,0,0,0,0
2020-02-06,Monterey,053,433212,1,0,0,0,0
2020-02-06,Napa,055,140530,0,0,0,0,0
2020-02-06,Nevada,057,99092,0,0,0,0,0
2020-02-06,Orange,059,3164182,3,1,0,1,0
2020-02-06,Placer,061,380077,0,0,0,0,0
2020-02-06,Plumas,063,18699,0,0,0,0,0
2020-02-06,Riverside,065,2383286,4,0,0,0,0
2020-02-06,Sacramento,067,1510023,0,0,0,0,0
2020-02-06,San Benito,069,59416,0,2,0,2,0
2020-02-06,San Bernardino,071,2135413,4,0,0,0,0
2020-02-06,San Diego,073,3302833,1,0,0,0,0
2020-02-06,San Francisco,075,870044,1,0,0,0,0
2020-02-06,San Joaquin,077,732212,0,0,1,1,0
2020-02-06,San Luis Obispo,079,281455,0,0,0,0,0
2020-02-06,San Mateo,081,765935,1,0,0,0,0
2020-02-06,Santa Barbara,083,443738,0,0,0,0,0
2020-02-06,Santa Clara,085,1922200,4,2,0,2,0
2020-02-06,Santa Cruz,087,273765,0,0,0,0,0
2020-02-06,Shasta,089,179085,0,0,0,0,0
2020-02-06,Sierra,091,2930,0,0,0,0,0
2020-02-06,Siskiyou,093,43540,0,0,0,0,0
2020-02-06,Solano,095,438530,0,0,0,0,0
2020-02-06,Sonoma,097,501317,0,0,0,0,0
2020-02-06,Stanislaus,099,539301,0,0,0,0,0
2020-02-06,Sutter,101,95872,0,0,0,0,0
2020-02-06,Tehama,103,63373,0,0,0,0,0
2020-02-06,Trinity,105,12862,0,0,0,0,0
2020-02-06,Tulare,107,460477,2,0,0,0,0
2020-02-06,Tuolumne,109,53932,0,0,0,0,0
2020-02-06,Ventura,111,848112,1,0,0,0,0
2020-02-06,Yolo,113,214977,0,0,0,0,0
2020-02-06,Yuba,115,75493,0,0,0,0,0
2020-02-05,Alameda,001,1643700,3,0,0,0,0
2020-02-05,Alpine,003,1148,0,0,0,0,0
2020-02-05,Amador,005,37829,0,0,0,0,0
2020-02-05,Butte,007,227075,0,0,0,0,0
2020-02-05,Calaveras,009,45235,0,0,0,0,0
2020-02-05,Colusa,011,21464,0,0,0,0,0
2020-02-05,Contra Costa,013,1133247,2,0,0,0,0
2020-02-05,Del Norte,015,27424,0,0,0,0,0
2020-02-05,El Dorado,017,186661,0,0,0,0,0
2020-02-05,Fresno,019,978130,0,0,0,0,0
2020-02-05,Glenn,021,27897,0,0,0,0,0
2020-02-05,Humboldt,023,135768,0,0,0,0,0
2020-02-05,Imperial,025,180216,0,0,0,0,0
2020-02-05,Inyo,027,18085,0,0,0,0,0
2020-02-05,Kern,029,883053,1,0,0,0,0
2020-02-05,Kings,031,150075,0,0,0,0,0
2020-02-05,Lake,033,64148,0,0,0,0,0
2020-02-05,Lassen,035,31185,0,0,0,0,0
2020-02-05,Los Angeles,037,10098052,21,1,0,1,0
2020-02-05,Madera,039,155013,0,0,0,0,0
2020-02-05,Marin,041,260295,0,0,0,0,0
2020-02-05,Mariposa,043,17540,0,0,0,0,0
2020-02-05,Mendocino,045,87422,0,0,0,0,0
2020-02-05,Merced,047,269075,0,0,0,0,0
2020-02-05,Modoc,049,8938,0,0,0,0,0
2020-02-05,Mono,051,14174,0,0,0,0,0
2020-02-05,Monterey,053,433212,1,0,0,0,0
2020-02-05,Napa,055,140530,0,0,0,0,0
2020-02-05,Nevada,057,99092,0,0,0,0,0
2020-02-05,Orange,059,3164182,1,1,0,1,0
2020-02-05,Placer,061,380077,0,0,0,0,0
2020-02-05,Plumas,063,18699,0,0,0,0,0
2020-02-05,Riverside,065,2383286,4,0,0,0,0
2020-02-05,Sacramento,067,1510023,0,0,0,0,0
2020-02-05,San Benito,069,59416,0,2,0,2,0
2020-02-05,San Bernardino,071,2135413,4,0,0,0,0
2020-02-05,San Diego,073,3302833,0,0,0,0,0
2020-02-05,San Francisco,075,870044,1,0,0,0,0
2020-02-05,San Joaquin,077,732212,0,0,1,1,0
2020-02-05,San Luis Obispo,079,281455,0,0,0,0,0
2020-02-05,San Mateo,081,765935,1,0,0,0,0
2020-02-05,Santa Barbara,083,443738,0,0,0,0,0
2020-02-05,Santa Clara,085,1922200,2,2,0,2,0
2020-02-05,Santa Cruz,087,273765,0,0,0,0,0
2020-02-05,Shasta,089,179085,0,0,0,0,0
2020-02-05,Sierra,091,2930,0,0,0,0,0
2020-02-05,Siskiyou,093,43540,0,0,0,0,0
2020-02-05,Solano,095,438530,0,0,0,0,0
2020-02-05,Sonoma,097,501317,0,0,0,0,0
2020-02-05,Stanislaus,099,539301,0,0,0,0,0
2020-02-05,Sutter,101,95872,0,0,0,0,0
2020-02-05,Tehama,103,63373,0,0,0,0,0
2020-02-05,Trinity,105,12862,0,0,0,0,0
2020-02-05,Tulare,107,460477,2,0,0,0,0
2020-02-05,Tuolumne,109,53932,0,0,0,0,0
2020-02-05,Ventura,111,848112,0,0,0,0,0
2020-02-05,Yolo,113,214977,0,0,0,0,0
2020-02-05,Yuba,115,75493,0,0,0,0,0
2020-02-04,Alameda,001,1643700,3,0,0,0,0
2020-02-04,Alpine,003,1148,0,0,0,0,0
2020-02-04,Amador,005,37829,0,0,0,0,0
2020-02-04,Butte,007,227075,0,0,0,0,0
2020-02-04,Calaveras,009,45235,0,0,0,0,0
2020-02-04,Colusa,011,21464,0,0,0,0,0
2020-02-04,Contra Costa,013,1133247,2,0,0,0,0
2020-02-04,Del Norte,015,27424,0,0,0,0,0
2020-02-04,El Dorado,017,186661,0,0,0,0,0
2020-02-04,Fresno,019,978130,0,0,0,0,0
2020-02-04,Glenn,021,27897,0,0,0,0,0
2020-02-04,Humboldt,023,135768,0,0,0,0,0
2020-02-04,Imperial,025,180216,0,0,0,0,0
2020-02-04,Inyo,027,18085,0,0,0,0,0
2020-02-04,Kern,029,883053,0,0,0,0,0
2020-02-04,Kings,031,150075,0,0,0,0,0
2020-02-04,Lake,033,64148,0,0,0,0,0
2020-02-04,Lassen,035,31185,0,0,0,0,0
2020-02-04,Los Angeles,037,10098052,21,1,0,1,0
2020-02-04,Madera,039,155013,0,0,0,0,0
2020-02-04,Marin,041,260295,0,0,0,0,0
2020-02-04,Mariposa,043,17540,0,0,0,0,0
2020-02-04,Mendocino,045,87422,0,0,0,0,0
2020-02-04,Merced,047,269075,0,0,0,0,0
2020-02-04,Modoc,049,8938,0,0,0,0,0
2020-02-04,Mono,051,14174,0,0,0,0,0
2020-02-04,Monterey,053,433212,1,0,0,0,0
2020-02-04,Napa,055,140530,0,0,0,0,0
2020-02-04,Nevada,057,99092,0,0,0,0,0
2020-02-04,Orange,059,3164182,1,1,0,1,0
2020-02-04,Placer,061,380077,0,0,0,0,0
2020-02-04,Plumas,063,18699,0,0,0,0,0
2020-02-04,Riverside,065,2383286,4,0,0,0,0
2020-02-04,Sacramento,067,1510023,0,0,0,0,0
2020-02-04,San Benito,069,59416,0,2,0,2,0
2020-02-04,San Bernardino,071,2135413,3,0,0,0,0
2020-02-04,San Diego,073,3302833,0,0,0,0,0
2020-02-04,San Francisco,075,870044,1,0,0,0,0
2020-02-04,San Joaquin,077,732212,0,0,1,1,0
2020-02-04,San Luis Obispo,079,281455,0,0,0,0,0
2020-02-04,San Mateo,081,765935,0,0,0,0,0
2020-02-04,Santa Barbara,083,443738,0,0,0,0,0
2020-02-04,Santa Clara,085,1922200,2,2,0,2,0
2020-02-04,Santa Cruz,087,273765,0,0,0,0,0
2020-02-04,Shasta,089,179085,0,0,0,0,0
2020-02-04,Sierra,091,2930,0,0,0,0,0
2020-02-04,Siskiyou,093,43540,0,0,0,0,0
2020-02-04,Solano,095,438530,0,0,0,0,0
2020-02-04,Sonoma,097,501317,0,0,0,0,0
2020-02-04,Stanislaus,099,539301,0,0,0,0,0
2020-02-04,Sutter,101,95872,0,0,0,0,0
2020-02-04,Tehama,103,63373,0,0,0,0,0
2020-02-04,Trinity,105,12862,0,0,0,0,0
2020-02-04,Tulare,107,460477,2,0,0,0,0
2020-02-04,Tuolumne,109,53932,0,0,0,0,0
2020-02-04,Ventura,111,848112,0,0,0,0,0
2020-02-04,Yolo,113,214977,0,0,0,0,0
2020-02-04,Yuba,115,75493,0,0,0,0,0
2020-02-03,Alameda,001,1643700,3,0,0,0,0
2020-02-03,Alpine,003,1148,0,0,0,0,0
2020-02-03,Amador,005,37829,0,0,0,0,0
2020-02-03,Butte,007,227075,0,0,0,0,0
2020-02-03,Calaveras,009,45235,0,0,0,0,0
2020-02-03,Colusa,011,21464,0,0,0,0,0
2020-02-03,Contra Costa,013,1133247,2,0,0,0,0
2020-02-03,Del Norte,015,27424,0,0,0,0,0
2020-02-03,El Dorado,017,186661,0,0,0,0,0
2020-02-03,Fresno,019,978130,0,0,0,0,0
2020-02-03,Glenn,021,27897,0,0,0,0,0
2020-02-03,Humboldt,023,135768,0,0,0,0,0
2020-02-03,Imperial,025,180216,0,0,0,0,0
2020-02-03,Inyo,027,18085,0,0,0,0,0
2020-02-03,Kern,029,883053,0,0,0,0,0
2020-02-03,Kings,031,150075,0,0,0,0,0
2020-02-03,Lake,033,64148,0,0,0,0,0
2020-02-03,Lassen,035,31185,0,0,0,0,0
2020-02-03,Los Angeles,037,10098052,21,1,0,1,0
2020-02-03,Madera,039,155013,0,0,0,0,0
2020-02-03,Marin,041,260295,0,0,0,0,0
2020-02-03,Mariposa,043,17540,0,0,0,0,0
2020-02-03,Mendocino,045,87422,0,0,0,0,0
2020-02-03,Merced,047,269075,0,0,0,0,0
2020-02-03,Modoc,049,8938,0,0,0,0,0
2020-02-03,Mono,051,14174,0,0,0,0,0
2020-02-03,Monterey,053,433212,1,0,0,0,0
2020-02-03,Napa,055,140530,0,0,0,0,0
2020-02-03,Nevada,057,99092,0,0,0,0,0
2020-02-03,Orange,059,3164182,1,1,0,1,0
2020-02-03,Placer,061,380077,0,0,0,0,0
2020-02-03,Plumas,063,18699,0,0,0,0,0
2020-02-03,Riverside,065,2383286,4,0,0,0,0
2020-02-03,Sacramento,067,1510023,0,0,0,0,0
2020-02-03,San Benito,069,59416,0,2,0,2,0
2020-02-03,San Bernardino,071,2135413,3,0,0,0,0
2020-02-03,San Diego,073,3302833,0,0,0,0,0
2020-02-03,San Francisco,075,870044,1,0,0,0,0
2020-02-03,San Joaquin,077,732212,0,0,1,1,0
2020-02-03,San Luis Obispo,079,281455,0,0,0,0,0
2020-02-03,San Mateo,081,765935,0,0,0,0,0
2020-02-03,Santa Barbara,083,443738,0,0,0,0,0
2020-02-03,Santa Clara,085,1922200,2,2,0,2,0
2020-02-03,Santa Cruz,087,273765,0,0,0,0,0
2020-02-03,Shasta,089,179085,0,0,0,0,0
2020-02-03,Sierra,091,2930,0,0,0,0,0
2020-02-03,Siskiyou,093,43540,0,0,0,0,0
2020-02-03,Solano,095,438530,0,0,0,0,0
2020-02-03,Sonoma,097,501317,0,0,0,0,0
2020-02-03,Stanislaus,099,539301,0,0,0,0,0
2020-02-03,Sutter,101,95872,0,0,0,0,0
2020-02-03,Tehama,103,63373,0,0,0,0,0
2020-02-03,Trinity,105,12862,0,0,0,0,0
2020-02-03,Tulare,107,460477,2,0,0,0,0
2020-02-03,Tuolumne,109,53932,0,0,0,0,0
2020-02-03,Ventura,111,848112,0,0,0,0,0
2020-02-03,Yolo,113,214977,0,0,0,0,0
2020-02-03,Yuba,115,75493,0,0,0,0,0
2020-02-02,Alameda,001,1643700,3,0,0,0,0
2020-02-02,Alpine,003,1148,0,0,0,0,0
2020-02-02,Amador,005,37829,0,0,0,0,0
2020-02-02,Butte,007,227075,0,0,0,0,0
2020-02-02,Calaveras,009,45235,0,0,0,0,0
2020-02-02,Colusa,011,21464,0,0,0,0,0
2020-02-02,Contra Costa,013,1133247,1,0,0,0,0
2020-02-02,Del Norte,015,27424,0,0,0,0,0
2020-02-02,El Dorado,017,186661,0,0,0,0,0
2020-02-02,Fresno,019,978130,0,0,0,0,0
2020-02-02,Glenn,021,27897,0,0,0,0,0
2020-02-02,Humboldt,023,135768,0,0,0,0,0
2020-02-02,Imperial,025,180216,0,0,0,0,0
2020-02-02,Inyo,027,18085,0,0,0,0,0
2020-02-02,Kern,029,883053,0,0,0,0,0
2020-02-02,Kings,031,150075,0,0,0,0,0
2020-02-02,Lake,033,64148,0,0,0,0,0
2020-02-02,Lassen,035,31185,0,0,0,0,0
2020-02-02,Los Angeles,037,10098052,17,1,0,1,0
2020-02-02,Madera,039,155013,0,0,0,0,0
2020-02-02,Marin,041,260295,0,0,0,0,0
2020-02-02,Mariposa,043,17540,0,0,0,0,0
2020-02-02,Mendocino,045,87422,0,0,0,0,0
2020-02-02,Merced,047,269075,0,0,0,0,0
2020-02-02,Modoc,049,8938,0,0,0,0,0
2020-02-02,Mono,051,14174,0,0,0,0,0
2020-02-02,Monterey,053,433212,1,0,0,0,0
2020-02-02,Napa,055,140530,0,0,0,0,0
2020-02-02,Nevada,057,99092,0,0,0,0,0
2020-02-02,Orange,059,3164182,1,1,0,1,0
2020-02-02,Placer,061,380077,0,0,0,0,0
2020-02-02,Plumas,063,18699,0,0,0,0,0
2020-02-02,Riverside,065,2383286,3,0,0,0,0
2020-02-02,Sacramento,067,1510023,0,0,0,0,0
2020-02-02,San Benito,069,59416,0,2,0,2,0
2020-02-02,San Bernardino,071,2135413,2,0,0,0,0
2020-02-02,San Diego,073,3302833,0,0,0,0,0
2020-02-02,San Francisco,075,870044,1,0,0,0,0
2020-02-02,San Joaquin,077,732212,0,0,1,1,0
2020-02-02,San Luis Obispo,079,281455,0,0,0,0,0
2020-02-02,San Mateo,081,765935,0,0,0,0,0
2020-02-02,Santa Barbara,083,443738,0,0,0,0,0
2020-02-02,Santa Clara,085,1922200,2,2,0,2,0
2020-02-02,Santa Cruz,087,273765,0,0,0,0,0
2020-02-02,Shasta,089,179085,0,0,0,0,0
2020-02-02,Sierra,091,2930,0,0,0,0,0
2020-02-02,Siskiyou,093,43540,0,0,0,0,0
2020-02-02,Solano,095,438530,0,0,0,0,0
2020-02-02,Sonoma,097,501317,0,0,0,0,0
2020-02-02,Stanislaus,099,539301,0,0,0,0,0
2020-02-02,Sutter,101,95872,0,0,0,0,0
2020-02-02,Tehama,103,63373,0,0,0,0,0
2020-02-02,Trinity,105,12862,0,0,0,0,0
2020-02-02,Tulare,107,460477,2,0,0,0,0
2020-02-02,Tuolumne,109,53932,0,0,0,0,0
2020-02-02,Ventura,111,848112,0,0,0,0,0
2020-02-02,Yolo,113,214977,0,0,0,0,0
2020-02-02,Yuba,115,75493,0,0,0,0,0
2020-02-01,Alameda,001,1643700,3,0,0,0,0
2020-02-01,Alpine,003,1148,0,0,0,0,0
2020-02-01,Amador,005,37829,0,0,0,0,0
2020-02-01,Butte,007,227075,0,0,0,0,0
2020-02-01,Calaveras,009,45235,0,0,0,0,0
2020-02-01,Colusa,011,21464,0,0,0,0,0
2020-02-01,Contra Costa,013,1133247,0,0,0,0,0
2020-02-01,Del Norte,015,27424,0,0,0,0,0
2020-02-01,El Dorado,017,186661,0,0,0,0,0
2020-02-01,Fresno,019,978130,0,0,0,0,0
2020-02-01,Glenn,021,27897,0,0,0,0,0
2020-02-01,Humboldt,023,135768,0,0,0,0,0
2020-02-01,Imperial,025,180216,0,0,0,0,0
2020-02-01,Inyo,027,18085,0,0,0,0,0
2020-02-01,Kern,029,883053,0,0,0,0,0
2020-02-01,Kings,031,150075,0,0,0,0,0
2020-02-01,Lake,033,64148,0,0,0,0,0
2020-02-01,Lassen,035,31185,0,0,0,0,0
2020-02-01,Los Angeles,037,10098052,13,1,0,1,0
2020-02-01,Madera,039,155013,0,0,0,0,0
2020-02-01,Marin,041,260295,0,0,0,0,0
2020-02-01,Mariposa,043,17540,0,0,0,0,0
2020-02-01,Mendocino,045,87422,0,0,0,0,0
2020-02-01,Merced,047,269075,0,0,0,0,0
2020-02-01,Modoc,049,8938,0,0,0,0,0
2020-02-01,Mono,051,14174,0,0,0,0,0
2020-02-01,Monterey,053,433212,0,0,0,0,0
2020-02-01,Napa,055,140530,0,0,0,0,0
2020-02-01,Nevada,057,99092,0,0,0,0,0
2020-02-01,Orange,059,3164182,1,1,0,1,0
2020-02-01,Placer,061,380077,0,0,0,0,0
2020-02-01,Plumas,063,18699,0,0,0,0,0
2020-02-01,Riverside,065,2383286,2,0,0,0,0
2020-02-01,Sacramento,067,1510023,0,0,0,0,0
2020-02-01,San Benito,069,59416,0,0,0,0,0
2020-02-01,San Bernardino,071,2135413,1,0,0,0,0
2020-02-01,San Diego,073,3302833,0,0,0,0,0
2020-02-01,San Francisco,075,870044,1,0,0,0,0
2020-02-01,San Joaquin,077,732212,0,0,1,1,0
2020-02-01,San Luis Obispo,079,281455,0,0,0,0,0
2020-02-01,San Mateo,081,765935,0,0,0,0,0
2020-02-01,Santa Barbara,083,443738,0,0,0,0,0
2020-02-01,Santa Clara,085,1922200,2,1,0,1,0
2020-02-01,Santa Cruz,087,273765,0,0,0,0,0
2020-02-01,Shasta,089,179085,0,0,0,0,0
2020-02-01,Sierra,091,2930,0,0,0,0,0
2020-02-01,Siskiyou,093,43540,0,0,0,0,0
2020-02-01,Solano,095,438530,0,0,0,0,0
2020-02-01,Sonoma,097,501317,0,0,0,0,0
2020-02-01,Stanislaus,099,539301,0,0,0,0,0
2020-02-01,Sutter,101,95872,0,0,0,0,0
2020-02-01,Tehama,103,63373,0,0,0,0,0
2020-02-01,Trinity,105,12862,0,0,0,0,0
2020-02-01,Tulare,107,460477,1,0,0,0,0
2020-02-01,Tuolumne,109,53932,0,0,0,0,0
2020-02-01,Ventura,111,848112,0,0,0,0,0
2020-02-01,Yolo,113,214977,0,0,0,0,0
2020-02-01,Yuba,115,75493,0,0,0,0,0
